Threshold,Mob_Result,Act_Counter,Withdraw_Counter,Power_Exchange_Counter,Act_Against_Counter,Participation_Rate
10,Success,47,28,2,11,36
10,Success,44,34,0,14,30
10,Success,47,28,0,14,33
10,Success,47,22,7,13,34
10,Success,42,30,0,23,19
10,Success,44,31,0,14,30
10,Success,47,29,6,9,38
10,Success,49,32,0,7,42
10,Success,42,34,0,14,28
10,Success,46,32,2,7,39
10,Success,40,30,0,17,23
10,Success,47,27,0,15,32
10,Success,39,34,0,15,24
10,Success,43,38,0,13,30
10,Success,49,28,0,11,38
10,Success,43,26,11,12,31
10,Success,42,31,0,17,25
10,Success,54,23,0,13,41
10,Success,51,19,4,12,39
10,Success,44,22,6,21,23
10,Success,54,19,3,13,41
10,Success,49,24,0,15,34
10,Success,47,19,3,19,28
10,Success,52,28,0,10,42
10,Success,50,22,2,15,35
10,Success,45,39,0,7,38
10,Success,51,24,0,13,38
10,Success,43,22,7,14,29
10,Success,48,28,2,9,39
10,Success,45,26,1,17,28
10,Success,47,24,5,13,34
10,Success,49,19,5,16,33
10,Success,42,29,7,13,29
10,Success,52,20,2,13,39
10,Success,47,29,0,10,37
10,Success,45,24,1,13,32
10,Success,53,17,5,17,36
10,Success,54,31,0,5,49
10,Success,50,20,1,17,33
10,Success,49,29,0,10,39
10,Success,42,37,0,12,30
10,Success,53,15,6,13,40
10,Success,50,22,0,19,31
10,Success,51,24,0,12,39
10,Success,43,29,0,15,28
10,Success,49,33,0,8,41
10,Success,32,35,13,16,16
10,Success,49,35,0,11,38
10,Success,55,25,0,11,44
10,Success,48,26,0,17,31
10,Success,39,29,10,12,27
10,Success,49,28,0,13,36
10,Success,45,31,4,13,32
10,Success,49,34,0,10,39
10,Success,48,30,0,12,36
10,Success,42,30,0,15,27
10,Success,55,16,0,18,37
10,Success,43,30,0,12,31
10,Success,42,30,1,20,22
10,Success,48,33,0,13,35
10,Success,46,29,0,17,29
10,Success,44,30,0,13,31
10,Success,47,28,2,12,35
10,Success,47,26,3,11,36
10,Success,48,22,9,13,35
10,Success,47,32,0,9,38
10,Success,45,22,9,13,32
10,Success,42,34,0,13,29
10,Success,48,28,0,13,35
10,Success,52,25,0,15,37
10,Success,42,25,4,20,22
10,Success,41,26,3,16,25
10,Success,48,21,6,16,32
10,Success,47,20,8,16,31
10,Success,42,28,0,15,27
10,Success,48,33,0,7,41
10,Success,40,26,6,18,22
10,Success,56,19,2,12,44
10,Success,42,31,0,13,29
10,Success,56,19,2,13,43
10,Success,40,31,0,14,26
10,Success,49,25,0,13,36
10,Success,50,22,10,10,40
10,Success,43,31,2,15,28
10,Success,47,27,2,16,31
10,Success,40,31,9,16,24
10,Success,46,26,6,15,31
10,Success,42,31,8,14,28
10,Success,53,19,0,13,40
10,Success,48,22,4,16,32
10,Success,48,32,0,9,39
10,Success,53,20,6,8,45
10,Success,47,28,0,18,29
10,Success,50,25,0,15,35
10,Success,49,29,0,8,41
10,Success,46,27,0,15,31
10,Success,53,23,2,12,41
10,Success,45,25,0,19,26
10,Success,56,25,0,6,50
10,Success,52,24,4,14,38
10,Success,45,29,0,17,28
10,Success,46,30,0,12,34
10,Success,53,21,0,14,39
10,Success,50,15,7,15,35
10,Success,55,26,0,11,44
10,Success,42,27,0,18,24
10,Success,51,29,0,8,43
10,Success,46,22,6,14,32
10,Success,46,29,1,12,34
10,Success,43,36,0,15,28
10,Success,39,29,0,19,20
10,Success,50,19,1,12,38
10,Success,48,24,1,14,34
10,Success,46,28,0,14,32
10,Success,51,24,3,10,41
10,Success,43,30,0,13,30
10,Success,44,26,3,12,32
10,Success,45,38,0,9,36
10,Success,54,30,0,8,46
10,Success,56,20,0,10,46
10,Success,61,23,0,10,51
10,Success,42,29,8,14,28
10,Success,48,25,0,17,31
10,Success,51,31,0,7,44
10,Success,52,27,0,11,41
10,Success,47,28,0,13,34
10,Success,40,38,0,11,29
10,Success,52,21,0,17,35
10,Success,50,27,0,12,38
10,Success,39,30,8,15,24
10,Success,57,18,1,13,44
10,Success,54,22,1,8,46
10,Success,42,37,0,16,26
10,Success,51,28,0,9,42
10,Success,51,23,1,15,36
10,Success,47,32,0,14,33
10,Success,51,21,7,11,40
10,Success,51,18,7,13,38
10,Success,50,28,0,9,41
10,Success,48,23,0,16,32
10,Success,53,20,0,11,42
10,Success,50,29,1,9,41
10,Success,49,31,0,9,40
10,Success,39,35,0,15,24
10,Success,54,21,0,12,42
10,Success,48,26,0,13,35
10,Success,50,32,0,8,42
10,Success,36,34,0,20,16
10,Success,44,30,0,13,31
10,Success,59,17,1,10,49
10,Success,49,30,0,12,37
10,Success,45,28,0,11,34
10,Success,50,20,9,13,37
10,Success,42,36,0,13,29
10,Success,47,25,4,16,31
10,Success,43,34,0,15,28
10,Success,39,27,7,18,21
10,Success,53,22,7,9,44
10,Success,34,39,8,12,22
10,Success,39,32,3,16,23
10,Success,44,36,1,10,34
10,Success,45,29,0,16,29
10,Success,48,29,1,8,40
10,Success,46,30,2,8,38
10,Success,45,27,4,18,27
10,Success,47,33,0,13,34
10,Success,48,26,1,12,36
10,Success,48,27,2,14,34
10,Success,43,33,0,14,29
10,Success,51,24,6,13,38
10,Success,46,21,4,19,27
10,Success,44,34,0,12,32
10,Success,47,23,5,12,35
10,Success,47,32,0,12,35
10,Success,42,29,7,13,29
10,Success,52,24,2,10,42
10,Success,50,28,0,12,38
10,Success,46,22,8,17,29
10,Success,44,31,0,17,27
10,Success,49,27,6,9,40
10,Success,44,33,0,14,30
10,Success,52,24,0,13,39
10,Success,45,33,0,12,33
10,Success,49,26,0,18,31
10,Success,52,21,4,13,39
10,Success,60,19,0,13,47
10,Success,51,28,0,12,39
10,Success,45,38,0,11,34
10,Success,53,27,0,6,47
10,Success,50,24,0,15,35
10,Success,50,23,0,16,34
10,Success,40,30,9,15,25
10,Success,45,36,0,8,37
10,Success,54,20,1,11,43
10,Success,41,40,0,14,27
10,Success,45,30,0,13,32
10,Success,49,33,0,10,39
10,Success,42,28,9,13,29
10,Success,52,28,2,7,45
10,Success,37,33,8,14,23
10,Success,47,29,0,13,34
10,Success,52,24,1,12,40
10,Success,52,24,4,9,43
10,Success,46,26,0,14,32
10,Success,45,28,4,14,31
10,Success,50,20,0,19,31
10,Success,50,28,0,9,41
10,Success,48,28,2,12,36
10,Success,49,32,0,12,37
10,Success,40,39,0,11,29
10,Success,51,26,0,11,40
10,Success,49,32,2,9,40
10,Success,38,28,9,19,19
10,Success,47,23,0,20,27
10,Success,47,35,0,11,36
10,Success,47,24,4,14,33
10,Success,46,34,0,13,33
10,Success,47,25,4,11,36
10,Success,45,35,0,10,35
10,Success,46,34,0,15,31
10,Success,48,31,0,9,39
10,Success,45,35,0,13,32
10,Success,56,19,0,15,41
10,Success,42,26,4,19,23
10,Success,51,20,2,14,37
10,Success,46,24,11,14,32
10,Success,48,24,1,14,34
10,Success,49,25,3,12,37
10,Success,45,38,0,7,38
10,Success,47,24,2,15,32
10,Success,45,26,9,12,33
10,Success,55,19,0,16,39
10,Success,49,23,4,13,36
10,Success,46,32,0,11,35
10,Success,49,29,2,12,37
10,Success,43,26,9,12,31
10,Success,52,26,0,10,42
10,Success,52,25,0,13,39
10,Success,44,34,0,12,32
10,Success,48,32,0,13,35
10,Success,52,28,0,10,42
10,Success,54,24,0,13,41
10,Success,49,34,0,6,43
10,Success,45,25,4,16,29
10,Success,54,24,2,11,43
10,Success,52,29,1,6,46
10,Success,52,26,0,16,36
10,Success,42,33,0,12,30
10,Success,42,22,16,12,30
10,Success,40,26,3,22,18
10,Success,53,23,5,11,42
10,Success,49,30,1,6,43
10,Success,50,27,1,12,38
10,Success,44,25,0,19,25
10,Success,44,19,8,14,30
10,Success,56,23,0,10,46
10,Success,44,33,2,13,31
10,Success,47,27,0,13,34
10,Success,37,23,11,23,14
10,Success,50,27,0,12,38
10,Success,42,32,0,14,28
10,Success,48,21,1,15,33
10,Success,51,27,5,9,42
10,Success,52,25,2,10,42
10,Success,43,22,12,15,28
10,Success,55,22,3,13,42
10,Success,39,33,0,17,22
10,Success,50,30,5,7,43
10,Success,45,31,4,9,36
10,Success,47,31,0,13,34
10,Success,55,30,0,6,49
10,Success,57,16,6,13,44
10,Success,48,23,1,13,35
10,Success,48,30,0,9,39
10,Success,46,22,6,17,29
10,Success,51,19,0,16,35
10,Success,49,29,0,14,35
10,Success,47,34,0,12,35
10,Success,55,25,0,11,44
10,Success,54,23,7,8,46
10,Success,53,20,1,14,39
10,Success,51,20,0,15,36
10,Success,55,21,2,11,44
10,Success,48,28,1,11,37
10,Success,45,33,0,15,30
10,Success,45,24,2,17,28
10,Success,48,25,2,11,37
10,Success,49,31,0,7,42
10,Success,52,19,7,12,40
10,Success,44,28,8,12,32
10,Success,49,22,7,15,34
10,Success,47,34,0,14,33
10,Success,49,28,6,8,41
10,Success,47,29,0,12,35
10,Success,51,28,0,12,39
10,Success,42,32,0,19,23
10,Success,51,25,5,9,42
10,Success,51,21,1,15,36
10,Success,43,33,0,17,26
10,Success,50,28,0,13,37
10,Success,51,25,1,10,41
10,Success,58,22,3,10,48
10,Success,48,28,0,12,36
10,Success,46,30,0,13,33
10,Success,49,29,0,7,42
10,Success,45,20,4,20,25
10,Success,54,28,2,5,49
10,Success,55,28,3,4,51
10,Success,53,28,1,9,44
10,Success,42,42,0,12,30
10,Success,40,34,6,13,27
10,Success,54,18,3,14,40
10,Success,52,21,0,12,40
10,Success,35,44,0,13,22
10,Success,48,31,0,10,38
10,Success,51,30,5,5,46
10,Success,46,33,0,12,34
10,Success,54,22,2,8,46
10,Success,51,21,2,12,39
10,Success,51,28,0,11,40
10,Success,52,24,2,15,37
10,Success,52,24,3,9,43
10,Success,36,28,4,22,14
10,Success,52,21,2,15,37
10,Success,50,27,3,10,40
10,Success,48,25,0,16,32
10,Success,53,23,2,13,40
10,Success,51,25,1,12,39
10,Success,46,30,0,14,32
10,Success,49,16,13,12,37
10,Success,43,27,6,9,34
10,Success,50,24,2,14,36
10,Success,50,27,0,11,39
10,Success,53,23,0,12,41
10,Success,50,24,0,14,36
10,Success,57,22,0,11,46
10,Success,50,24,8,9,41
10,Success,53,26,0,10,43
10,Success,41,33,0,13,28
10,Success,47,33,0,12,35
10,Success,40,32,0,16,24
10,Success,41,30,6,14,27
10,Success,52,19,0,18,34
10,Success,46,29,0,13,33
10,Success,50,24,0,15,35
10,Success,48,31,0,13,35
10,Success,48,30,0,8,40
10,Success,48,26,0,15,33
10,Success,43,35,0,12,31
10,Success,46,24,9,9,37
10,Success,50,21,3,14,36
10,Success,46,33,0,8,38
10,Success,36,27,6,22,14
10,Success,51,30,0,14,37
10,Success,44,28,1,16,28
10,Success,49,26,0,14,35
10,Success,53,23,2,14,39
10,Success,53,15,5,12,41
10,Success,51,25,3,9,42
10,Success,54,21,2,12,42
10,Success,46,34,0,10,36
10,Success,45,39,0,6,39
10,Success,40,35,0,12,28
10,Success,51,24,0,11,40
10,Success,42,25,7,18,24
10,Success,48,27,0,13,35
10,Success,53,28,0,14,39
10,Success,46,28,0,14,32
10,Success,40,33,0,17,23
10,Success,50,26,1,12,38
10,Success,51,21,0,19,32
10,Success,53,21,1,13,40
10,Success,49,27,0,12,37
10,Success,45,29,6,8,37
10,Success,43,35,0,12,31
10,Success,49,30,0,9,40
10,Success,45,27,0,19,26
10,Success,54,27,1,7,47
10,Success,53,23,2,9,44
10,Success,48,30,0,9,39
10,Success,52,22,0,16,36
10,Success,54,23,4,8,46
10,Success,56,21,1,13,43
10,Success,50,18,10,15,35
10,Success,43,32,0,10,33
10,Success,46,27,1,12,34
10,Success,59,22,0,8,51
10,Success,47,32,0,11,36
10,Success,54,17,4,11,43
10,Success,48,24,1,15,33
10,Success,49,29,7,7,42
10,Success,46,34,0,15,31
10,Success,44,31,0,17,27
10,Success,46,36,0,11,35
10,Success,44,27,7,14,30
10,Success,44,29,3,15,29
10,Success,49,24,0,14,35
10,Success,51,21,6,10,41
10,Success,54,26,0,8,46
10,Success,45,25,3,12,33
10,Success,48,22,1,14,34
10,Success,47,27,6,8,39
10,Success,55,23,3,7,48
10,Success,45,25,2,14,31
10,Success,50,24,1,14,36
10,Success,59,19,0,11,48
10,Success,46,29,4,11,35
10,Success,41,28,0,15,26
10,Success,56,20,0,13,43
10,Success,49,28,0,12,37
10,Success,50,23,0,12,38
10,Success,41,36,0,14,27
10,Success,45,24,3,13,32
10,Success,62,15,0,13,49
10,Success,45,24,0,21,24
10,Success,56,17,0,12,44
10,Success,53,18,9,10,43
10,Success,52,19,8,12,40
10,Success,48,26,0,14,34
10,Success,56,16,0,9,47
10,Success,52,29,0,8,44
10,Success,49,27,0,8,41
10,Success,58,21,0,8,50
10,Success,51,26,0,10,41
10,Success,53,19,0,12,41
10,Success,54,25,0,10,44
10,Success,48,33,0,12,36
10,Success,52,21,4,10,42
10,Success,43,32,0,15,28
10,Success,49,30,0,10,39
10,Success,43,34,0,16,27
10,Success,43,27,0,18,25
10,Success,45,24,1,18,27
10,Success,53,21,2,12,41
10,Success,42,26,9,12,30
10,Success,45,21,5,19,26
10,Success,40,29,1,18,22
10,Success,53,30,0,8,45
10,Success,41,24,9,16,25
10,Success,49,36,0,10,39
10,Success,45,33,0,14,31
10,Success,42,27,4,16,26
10,Success,51,22,5,13,38
10,Success,43,25,2,18,25
10,Success,53,17,2,19,34
10,Success,59,21,0,12,47
10,Success,43,26,7,16,27
10,Success,44,35,0,11,33
10,Success,49,18,7,16,33
10,Success,47,29,0,14,33
10,Success,46,33,0,10,36
10,Success,50,27,0,15,35
10,Success,48,31,0,12,36
10,Success,57,19,0,12,45
10,Success,43,36,0,14,29
10,Success,36,36,0,18,18
10,Success,47,21,5,17,30
10,Success,55,27,0,10,45
10,Success,50,25,0,12,38
10,Success,49,32,1,4,45
10,Success,45,36,0,11,34
10,Success,49,24,0,13,36
10,Success,43,33,0,10,33
10,Success,52,17,6,16,36
10,Success,50,26,3,11,39
10,Success,50,19,1,18,32
10,Success,49,26,1,9,40
10,Success,47,24,4,15,32
10,Success,48,25,5,12,36
10,Success,38,34,0,21,17
10,Success,44,23,13,11,33
10,Success,46,21,0,16,30
10,Success,43,22,8,16,27
10,Success,51,24,2,13,38
10,Success,48,34,0,8,40
10,Success,45,28,0,16,29
10,Success,42,37,0,11,31
10,Success,53,27,0,11,42
10,Success,47,28,0,13,34
10,Success,52,25,1,7,45
10,Success,49,28,0,16,33
10,Success,52,26,0,9,43
10,Success,42,35,0,13,29
10,Success,47,25,1,18,29
10,Success,49,28,0,12,37
10,Success,48,27,2,12,36
10,Success,45,34,0,8,37
10,Success,48,25,7,11,37
10,Success,51,28,0,13,38
10,Success,45,26,1,13,32
10,Success,44,27,0,19,25
10,Success,54,23,1,12,42
10,Success,47,30,0,10,37
10,Success,51,21,10,8,43
10,Success,39,31,11,12,27
10,Success,55,20,1,16,39
10,Success,48,27,1,12,36
10,Success,52,18,0,15,37
10,Success,47,29,4,11,36
10,Success,41,28,1,18,23
10,Success,43,41,0,9,34
10,Success,56,20,1,12,44
10,Success,48,23,3,12,36
10,Success,44,31,0,16,28
10,Success,62,13,0,12,50
10,Success,47,32,0,14,33
10,Success,55,23,1,9,46
10,Success,48,35,0,9,39
10,Success,46,19,4,19,27
10,Success,59,21,0,12,47
10,Success,49,35,0,6,43
10,Success,43,33,2,13,30
10,Success,44,26,5,15,29
10,Success,41,33,0,14,27
10,Success,49,27,0,12,37
10,Success,46,32,1,12,34
10,Success,46,31,0,13,33
10,Success,45,38,0,8,37
10,Success,51,28,0,12,39
10,Success,54,22,0,10,44
10,Success,42,42,0,9,33
10,Success,51,27,1,8,43
10,Success,48,33,0,12,36
10,Success,45,34,0,9,36
10,Success,44,37,0,13,31
10,Success,51,25,0,15,36
10,Success,50,29,0,11,39
10,Success,46,33,0,12,34
10,Success,43,32,3,12,31
10,Success,55,21,0,9,46
10,Success,45,29,2,11,34
10,Success,47,32,0,12,35
10,Success,43,31,0,15,28
10,Success,51,28,2,9,42
10,Success,44,25,0,19,25
10,Success,54,22,0,13,41
10,Success,51,27,1,11,40
10,Success,47,23,0,17,30
10,Success,50,27,0,9,41
10,Success,48,28,3,13,35
10,Success,49,29,0,15,34
10,Success,52,23,0,12,40
10,Success,44,28,8,13,31
10,Success,44,29,0,18,26
10,Success,50,27,0,9,41
10,Success,58,22,0,9,49
10,Success,47,27,3,9,38
10,Success,53,21,0,15,38
10,Success,50,24,0,13,37
10,Success,51,20,14,10,41
10,Success,41,37,1,11,30
10,Success,44,26,3,14,30
10,Success,46,29,7,12,34
10,Success,46,37,0,10,36
10,Success,47,31,0,8,39
10,Success,58,20,2,11,47
10,Success,47,25,6,9,38
10,Success,45,29,0,13,32
10,Success,48,28,3,12,36
10,Success,54,26,0,7,47
10,Success,53,25,0,11,42
10,Success,52,19,8,11,41
10,Success,49,24,3,14,35
10,Success,49,28,1,14,35
10,Success,50,29,0,10,40
10,Success,38,35,4,16,22
10,Success,51,21,5,14,37
10,Success,42,31,2,21,21
10,Success,46,27,7,13,33
10,Success,56,23,0,8,48
10,Success,49,27,0,10,39
10,Success,47,25,0,16,31
10,Success,51,25,3,11,40
10,Success,46,23,6,16,30
10,Success,45,31,0,10,35
10,Success,53,27,0,7,46
10,Success,48,30,8,8,40
10,Success,48,31,0,10,38
10,Success,46,29,3,10,36
10,Success,44,31,0,11,33
10,Success,49,24,2,13,36
10,Success,46,32,0,16,30
10,Success,56,25,4,9,47
10,Success,52,23,3,12,40
10,Success,48,28,0,14,34
10,Success,55,17,6,11,44
10,Success,47,22,3,10,37
10,Success,47,27,5,10,37
10,Success,48,23,0,15,33
10,Success,49,29,0,10,39
10,Success,41,28,6,19,22
10,Success,58,22,0,14,44
10,Success,49,33,0,9,40
10,Success,54,31,1,4,50
10,Success,44,33,0,14,30
10,Success,44,31,8,8,36
10,Success,41,34,0,13,28
10,Success,47,25,2,17,30
10,Success,50,20,2,15,35
10,Success,51,27,0,8,43
10,Success,54,24,2,13,41
10,Success,43,26,0,15,28
10,Success,53,20,3,14,39
10,Success,46,24,6,16,30
10,Success,44,31,0,15,29
10,Success,50,29,0,9,41
10,Success,52,27,0,10,42
10,Success,53,30,0,7,46
10,Success,45,30,0,14,31
10,Success,45,30,1,11,34
10,Success,44,32,0,15,29
10,Success,51,21,0,14,37
10,Success,46,24,5,14,32
10,Success,56,25,0,8,48
10,Success,44,31,5,11,33
10,Success,47,25,7,14,33
10,Success,46,27,0,15,31
10,Success,45,26,4,11,34
10,Success,38,44,0,11,27
10,Success,42,33,2,13,29
10,Success,47,31,2,7,40
10,Success,52,25,0,11,41
10,Success,54,22,0,14,40
10,Success,47,34,0,11,36
10,Success,51,23,0,14,37
10,Success,52,25,6,11,41
10,Success,49,30,3,6,43
10,Success,49,21,1,11,38
10,Success,49,27,0,15,34
10,Success,50,25,0,13,37
10,Success,48,21,0,19,29
10,Success,43,41,0,10,33
10,Success,47,24,0,18,29
10,Success,42,38,0,12,30
10,Success,50,16,9,16,34
10,Success,49,31,0,12,37
10,Success,41,25,4,20,21
10,Success,44,36,0,12,32
10,Success,43,28,4,13,30
10,Success,47,30,0,16,31
10,Success,41,34,0,20,21
10,Success,41,27,10,14,27
10,Success,50,28,1,14,36
10,Success,53,22,2,11,42
10,Success,57,20,1,11,46
10,Success,53,27,0,10,43
10,Success,51,24,3,11,40
10,Success,48,22,3,15,33
10,Success,51,25,2,11,40
10,Success,52,23,0,13,39
10,Success,49,23,3,12,37
10,Success,46,34,0,8,38
10,Success,52,32,0,10,42
10,Success,49,31,0,11,38
10,Success,45,24,4,15,30
10,Success,57,21,3,6,51
10,Success,40,36,0,13,27
10,Success,47,34,0,10,37
10,Success,50,31,0,11,39
10,Success,49,28,0,13,36
10,Success,44,27,7,15,29
10,Success,50,19,6,15,35
10,Success,50,26,3,12,38
10,Success,41,33,5,10,31
10,Success,50,25,4,10,40
10,Success,59,28,0,9,50
10,Success,46,35,0,7,39
10,Success,52,20,0,13,39
10,Success,51,24,0,11,40
10,Success,46,28,0,17,29
10,Success,47,25,0,16,31
10,Success,49,24,3,11,38
10,Success,49,24,2,13,36
10,Success,45,27,11,11,34
10,Success,49,31,0,10,39
10,Success,44,29,6,13,31
10,Success,44,33,0,12,32
10,Success,51,24,1,12,39
10,Success,50,33,0,9,41
10,Success,48,33,0,13,35
10,Success,39,37,0,13,26
10,Success,41,40,0,14,27
10,Success,45,28,0,15,30
10,Success,51,22,4,10,41
10,Success,52,15,8,12,40
10,Success,51,24,0,14,37
10,Success,46,30,3,12,34
10,Success,50,23,6,12,38
10,Success,48,21,0,20,28
10,Success,50,24,0,13,37
10,Success,50,25,1,14,36
10,Success,55,18,6,10,45
10,Success,49,32,0,12,37
10,Success,49,30,0,10,39
10,Success,44,28,8,11,33
10,Success,44,31,0,15,29
10,Success,50,27,0,13,37
10,Success,46,32,0,12,34
10,Success,53,20,4,10,43
10,Success,47,33,0,11,36
10,Success,47,29,2,9,38
10,Success,56,27,0,7,49
10,Success,49,26,0,13,36
10,Success,51,29,0,10,41
10,Success,54,21,0,14,40
10,Success,44,32,0,15,29
10,Success,46,28,2,14,32
10,Success,47,26,6,14,33
10,Success,43,27,0,18,25
10,Success,46,26,0,17,29
10,Success,55,20,0,14,41
10,Success,35,44,0,12,23
10,Success,53,29,0,9,44
10,Success,39,35,0,17,22
10,Success,41,30,0,17,24
10,Success,47,26,1,11,36
10,Success,52,23,2,15,37
10,Success,51,22,3,13,38
10,Success,49,24,0,13,36
10,Success,47,28,2,10,37
10,Success,57,22,2,8,49
10,Success,53,22,0,14,39
10,Success,56,17,2,12,44
10,Success,45,32,0,13,32
10,Success,51,26,0,12,39
10,Success,51,29,0,11,40
10,Success,47,34,0,9,38
10,Success,56,23,0,9,47
10,Success,47,26,7,13,34
10,Success,44,22,4,21,23
10,Success,44,32,5,12,32
10,Success,46,33,0,11,35
10,Success,53,25,0,12,41
10,Success,45,25,0,17,28
10,Success,47,29,0,11,36
10,Success,49,22,5,14,35
10,Success,51,23,0,9,42
10,Success,52,32,0,8,44
10,Success,48,29,0,12,36
10,Success,52,22,4,9,43
10,Success,48,30,3,9,39
10,Success,36,42,0,16,20
10,Success,54,23,0,13,41
10,Success,52,22,1,16,36
10,Success,50,23,9,10,40
10,Success,49,20,2,16,33
10,Success,45,31,2,11,34
10,Success,52,25,0,10,42
10,Success,48,24,6,11,37
10,Success,41,29,1,19,22
10,Success,54,27,2,6,48
10,Success,46,27,0,16,30
10,Success,42,36,0,11,31
10,Success,46,19,3,19,27
10,Success,50,30,0,13,37
10,Success,49,27,0,13,36
10,Success,46,32,5,7,39
10,Success,51,22,5,12,39
10,Success,39,36,0,16,23
10,Success,45,28,4,15,30
10,Success,49,23,0,14,35
10,Success,51,27,0,12,39
10,Success,48,29,0,14,34
10,Success,51,31,0,6,45
10,Success,55,18,0,13,42
10,Success,51,24,0,11,40
10,Success,49,33,0,6,43
10,Success,52,23,1,10,42
10,Success,55,22,0,9,46
10,Success,58,18,1,9,49
10,Success,47,25,6,13,34
10,Success,51,29,0,8,43
10,Success,45,32,0,11,34
10,Success,51,23,3,11,40
10,Success,47,24,1,15,32
10,Success,46,26,8,11,35
10,Success,45,26,5,15,30
10,Success,43,23,11,14,29
10,Success,54,26,0,10,44
10,Success,46,36,0,10,36
10,Success,44,29,5,12,32
10,Success,52,22,0,14,38
10,Success,47,30,0,10,37
10,Success,51,32,1,5,46
10,Success,42,32,7,9,33
10,Success,51,37,0,6,45
10,Success,42,31,4,15,27
10,Success,46,24,1,17,29
10,Success,49,26,3,11,38
10,Success,53,23,0,16,37
10,Success,51,22,2,16,35
10,Success,43,24,4,16,27
10,Success,52,33,0,6,46
10,Success,51,26,1,11,40
10,Success,47,23,7,15,32
10,Success,50,29,1,9,41
10,Success,48,24,9,12,36
10,Success,45,21,0,20,25
10,Success,50,20,4,15,35
10,Success,47,32,0,12,35
10,Success,52,30,0,11,41
10,Success,45,25,6,17,28
10,Success,51,20,5,17,34
10,Success,44,31,0,13,31
10,Success,56,16,6,8,48
10,Success,49,27,0,14,35
10,Success,40,32,8,16,24
10,Success,52,21,6,10,42
10,Success,46,28,0,17,29
10,Success,40,31,6,16,24
10,Success,48,32,0,9,39
10,Success,44,28,14,7,37
10,Success,43,30,0,16,27
10,Success,51,26,2,9,42
10,Success,47,21,6,14,33
10,Success,48,31,0,10,38
10,Success,43,36,0,13,30
10,Success,46,35,0,11,35
10,Success,45,32,0,14,31
10,Success,46,32,2,11,35
10,Success,46,21,5,17,29
10,Success,48,26,0,14,34
10,Success,45,25,5,13,32
10,Success,51,21,3,11,40
10,Success,45,26,0,15,30
10,Success,50,21,3,15,35
10,Success,49,28,0,12,37
10,Success,45,27,7,11,34
10,Success,48,22,2,12,36
10,Success,49,18,6,18,31
10,Success,39,38,0,15,24
10,Success,47,35,0,8,39
10,Success,46,24,0,19,27
10,Success,50,26,1,11,39
10,Success,54,19,3,12,42
10,Success,54,26,1,8,46
10,Success,56,19,0,14,42
10,Success,50,18,4,12,38
10,Success,51,19,8,13,38
10,Success,44,29,0,12,32
10,Success,45,25,5,14,31
10,Success,47,25,5,11,36
10,Success,48,24,4,13,35
10,Success,44,24,6,15,29
10,Success,51,24,0,14,37
10,Success,41,36,0,12,29
10,Success,52,22,0,17,35
10,Success,52,23,0,15,37
10,Success,44,29,0,15,29
10,Success,50,25,0,13,37
10,Success,52,21,0,14,38
10,Success,54,26,0,9,45
10,Success,46,30,0,12,34
10,Success,56,17,2,16,40
10,Success,46,30,0,14,32
10,Success,42,31,7,11,31
10,Success,38,38,0,15,23
10,Success,42,31,4,10,32
10,Success,45,31,0,12,33
10,Success,51,22,4,13,38
10,Success,38,35,0,14,24
10,Success,50,27,2,11,39
10,Success,53,31,0,7,46
10,Success,49,22,5,12,37
10,Success,49,28,0,12,37
10,Success,50,29,0,9,41
10,Success,45,29,0,12,33
10,Success,52,29,0,10,42
10,Success,47,23,8,13,34
10,Success,52,25,0,15,37
10,Success,45,31,6,8,37
10,Success,45,37,0,11,34
10,Success,46,28,0,12,34
10,Success,45,37,0,5,40
10,Success,52,27,0,13,39
10,Success,47,25,0,12,35
10,Success,54,23,3,7,47
10,Success,49,27,0,12,37
10,Success,46,29,0,12,34
10,Success,47,26,0,12,35
10,Success,35,31,8,17,18
10,Success,43,32,0,12,31
10,Success,50,27,1,15,35
10,Success,45,33,0,12,33
10,Success,39,36,0,14,25
10,Success,49,28,0,9,40
10,Success,59,16,1,11,48
10,Success,40,36,0,16,24
10,Success,54,24,0,11,43
10,Success,48,27,0,14,34
10,Success,46,30,0,13,33
10,Success,43,31,5,12,31
10,Success,56,19,2,12,44
10,Success,42,33,0,11,31
10,Success,47,27,0,12,35
10,Success,51,24,2,13,38
10,Success,48,30,1,11,37
10,Success,48,26,1,12,36
10,Success,49,21,4,17,32
10,Success,48,21,5,15,33
10,Success,38,31,4,19,19
10,Success,49,30,0,12,37
10,Success,46,25,8,12,34
10,Success,45,33,6,7,38
10,Success,47,29,6,10,37
10,Success,49,21,0,14,35
10,Success,54,23,4,9,45
10,Success,47,27,4,9,38
10,Success,39,37,0,13,26
10,Success,51,28,0,10,41
10,Success,46,22,6,16,30
10,Success,46,31,0,12,34
10,Success,52,22,1,14,38
10,Success,43,37,0,8,35
10,Success,47,31,0,14,33
10,Success,45,36,0,5,40
10,Success,48,31,0,8,40
10,Success,44,29,7,8,36
10,Success,47,31,0,14,33
10,Success,55,24,3,9,46
10,Success,42,26,4,18,24
10,Success,50,22,1,15,35
10,Success,41,32,4,12,29
10,Success,51,23,3,15,36
10,Success,44,25,11,15,29
10,Success,47,38,0,10,37
10,Success,53,21,0,15,38
10,Success,43,36,1,10,33
10,Success,43,33,0,16,27
10,Success,47,27,5,12,35
10,Success,42,26,2,16,26
10,Success,49,25,2,12,37
10,Success,51,23,6,10,41
10,Success,50,30,2,10,40
10,Success,47,23,8,16,31
10,Success,49,19,5,13,36
10,Success,49,28,0,15,34
10,Success,44,26,4,15,29
10,Success,40,27,4,20,20
10,Success,35,34,9,14,21
10,Success,48,19,11,14,34
10,Success,54,25,0,12,42
10,Success,50,22,0,13,37
10,Success,49,27,1,11,38
10,Success,49,27,0,16,33
10,Success,49,25,5,14,35
10,Success,41,35,0,18,23
10,Success,44,32,2,13,31
10,Success,51,24,1,10,41
10,Success,46,23,4,17,29
10,Success,46,24,8,13,33
10,Success,53,24,12,5,48
10,Success,50,28,1,9,41
10,Success,44,29,4,12,32
10,Success,58,21,0,12,46
10,Success,51,23,0,12,39
10,Success,48,24,4,11,37
10,Success,49,25,5,12,37
10,Success,43,34,0,14,29
10,Success,46,35,0,9,37
10,Success,51,22,10,11,40
10,Success,51,24,3,15,36
10,Success,51,30,0,10,41
10,Success,43,33,0,15,28
10,Success,53,25,0,8,45
10,Success,54,24,0,10,44
10,Success,53,17,9,11,42
10,Success,51,28,1,12,39
10,Success,45,25,3,19,26
10,Success,43,19,8,21,22
10,Success,48,25,0,17,31
10,Success,34,42,0,16,18
10,Success,53,14,3,16,37
10,Success,48,25,0,17,31
10,Success,49,24,5,13,36
10,Success,49,29,0,14,35
10,Success,47,27,8,10,37
10,Success,46,31,5,6,40
10,Success,44,34,0,14,30
10,Success,43,26,6,16,27
10,Success,54,31,0,5,49
10,Success,46,33,0,13,33
10,Success,52,18,5,15,37
10,Success,46,24,0,17,29
10,Success,47,21,9,15,32
10,Success,53,26,1,11,42
10,Success,46,34,0,9,37
10,Success,57,17,3,9,48
10,Success,49,28,0,7,42
10,Success,56,19,2,11,45
10,Success,45,22,8,18,27
10,Success,56,22,0,8,48
10,Success,52,24,0,14,38
10,Success,52,22,3,15,37
10,Success,53,19,4,14,39
10,Success,48,26,0,13,35
10,Success,53,22,3,10,43
10,Success,49,30,0,10,39
10,Success,47,23,2,16,31
10,Success,49,31,0,10,39
10,Success,50,32,0,12,38
10,Success,53,20,0,12,41
10,Success,51,24,0,16,35
10,Success,47,26,0,11,36
10,Success,45,29,0,14,31
10,Success,53,19,6,11,42
10,Success,47,21,2,15,32
10,Success,55,22,0,10,45
10,Success,48,27,2,12,36
10,Success,42,26,9,13,29
10,Success,41,29,8,14,27
10,Success,54,23,4,9,45
10,Success,54,25,0,10,44
10,Success,51,24,0,10,41
10,Success,45,24,5,10,35
10,Success,55,21,1,11,44
10,Success,42,34,0,12,30
10,Success,41,32,5,12,29
10,Success,48,27,1,11,37
10,Success,45,31,0,14,31
10,Success,46,27,3,14,32
10,Success,50,23,2,9,41
10,Success,56,24,0,6,50
10,Success,56,16,5,10,46
10,Success,43,35,0,15,28
10,Success,47,27,0,14,33
10,Success,49,25,9,11,38
10,Success,44,30,0,19,25
10,Success,48,28,0,12,36
10,Success,55,23,0,8,47
10,Success,49,27,0,14,35
10,Success,56,25,0,9,47
10,Success,43,30,4,13,30
10,Success,53,26,1,11,42
10,Success,45,22,3,18,27
10,Success,53,19,1,16,37
10,Success,54,20,0,10,44
10,Success,46,22,0,16,30
10,Success,42,42,0,8,34
10,Success,50,27,1,8,42
10,Success,49,30,0,14,35
10,Success,49,20,0,16,33
10,Success,43,24,15,13,30
10,Success,41,32,6,13,28
10,Success,48,28,4,11,37
10,Success,57,24,0,8,49
10,Success,52,18,4,16,36
10,Success,44,27,7,13,31
10,Success,45,34,3,9,36
10,Success,47,30,0,12,35
10,Success,41,28,8,13,28
10,Success,56,23,0,9,47
10,Success,47,31,0,13,34
10,Success,58,20,0,8,50
10,Success,47,28,0,13,34
10,Success,49,23,0,15,34
10,Success,55,23,1,8,47
10,Success,45,28,5,12,33
10,Success,51,24,5,9,42
10,Success,44,25,0,16,28
10,Success,51,21,0,9,42
10,Success,48,20,4,14,34
10,Success,44,31,7,10,34
10,Success,52,23,1,10,42
10,Success,49,24,4,15,34
10,Success,40,25,5,19,21
10,Success,52,18,3,13,39
10,Success,51,31,0,8,43
10,Success,51,28,3,8,43
10,Success,45,31,0,16,29
10,Success,46,38,0,9,37
10,Success,49,23,4,14,35
10,Success,53,23,0,10,43
10,Success,48,29,0,12,36
10,Success,36,45,0,13,23
10,Success,37,35,4,16,21
10,Success,47,28,7,10,37
10,Success,40,28,1,18,22
10,Success,43,23,12,13,30
10,Success,48,22,7,14,34
10,Success,45,27,8,11,34
10,Success,42,28,6,15,27
10,Success,53,26,0,7,46
10,Success,54,21,4,11,43
10,Success,51,28,0,13,38
10,Success,43,27,4,13,30
10,Success,38,34,0,20,18
10,Success,48,22,0,18,30
10,Success,45,22,2,18,27
10,Success,41,29,0,16,25
10,Success,49,30,0,13,36
10,Success,49,26,0,15,34
10,Success,51,23,0,13,38
10,Success,51,27,2,10,41
10,Success,49,27,0,11,38
10,Success,48,23,1,13,35
10,Success,52,20,9,12,40
10,Success,50,29,1,8,42
10,Success,46,24,7,14,32
10,Success,50,24,3,13,37
10,Success,54,15,5,14,40
10,Success,48,29,0,14,34
10,Success,51,24,1,10,41
10,Success,42,33,1,15,27
10,Success,58,21,1,8,50
10,Success,44,25,1,16,28
10,Success,46,24,8,13,33
10,Success,51,20,0,15,36
10,Success,50,32,0,11,39
10,Success,41,32,0,13,28
10,Success,51,31,2,6,45
10,Success,44,36,0,10,34
10,Success,38,33,7,12,26
10,Success,52,17,0,18,34
10,Success,48,27,0,12,36
10,Success,39,39,7,12,27
10,Success,50,22,3,13,37
10,Success,47,22,1,15,32
10,Success,49,24,0,17,32
10,Success,52,25,6,9,43
10,Success,46,32,1,10,36
10,Success,41,38,0,10,31
10,Success,47,34,0,10,37
10,Success,49,23,2,13,36
10,Success,46,19,2,19,27
10,Success,46,25,8,10,36
10,Success,46,34,0,9,37
10,Success,51,24,2,13,38
10,Success,49,25,0,17,32
10,Success,48,22,1,19,29
10,Success,47,28,1,10,37
10,Success,45,27,0,14,31
10,Success,47,25,0,13,34
10,Success,46,31,2,11,35
10,Success,49,32,0,10,39
10,Success,49,26,0,13,36
10,Success,48,29,6,10,38
10,Success,46,22,10,13,33
10,Success,47,22,9,15,32
10,Success,42,33,2,9,33
10,Success,48,32,0,10,38
10,Success,48,18,4,18,30
10,Success,48,35,0,9,39
10,Success,46,25,7,11,35
10,Success,48,34,0,13,35
10,Success,56,23,4,8,48
10,Success,50,25,1,15,35
10,Success,44,23,7,16,28
10,Success,50,22,1,15,35
10,Success,39,41,0,12,27
10,Success,42,33,5,13,29
10,Success,51,24,0,12,39
10,Success,43,25,5,19,24
10,Success,56,22,0,13,43
10,Success,52,26,0,11,41
10,Success,51,30,0,8,43
10,Success,50,28,0,13,37
10,Success,52,29,0,9,43
10,Success,52,33,2,4,48
10,Success,49,29,0,11,38
10,Success,44,21,1,20,24
10,Success,51,26,0,9,42
10,Success,53,27,0,11,42
10,Success,48,29,1,9,39
10,Success,50,28,0,9,41
10,Success,48,24,0,13,35
10,Success,44,30,0,18,26
10,Success,49,26,2,13,36
10,Success,53,15,7,14,39
10,Success,47,28,0,14,33
10,Success,51,27,2,8,43
10,Success,54,28,0,10,44
10,Success,51,28,0,14,37
10,Success,45,23,5,15,30
10,Success,44,34,0,10,34
10,Success,51,24,1,14,37
10,Success,45,24,0,20,25
10,Success,48,33,0,12,36
10,Success,50,30,2,12,38
10,Success,53,26,2,7,46
10,Success,52,28,2,8,44
10,Success,47,23,5,15,32
10,Success,53,26,0,10,43
10,Success,47,24,2,15,32
10,Success,47,24,0,17,30
10,Success,42,26,3,17,25
10,Success,49,31,0,12,37
10,Success,44,29,5,11,33
10,Success,47,29,0,13,34
10,Success,54,22,0,13,41
10,Success,45,35,0,10,35
10,Success,55,14,10,14,41
10,Success,56,24,0,11,45
10,Success,45,35,2,9,36
10,Success,47,25,14,7,40
10,Success,45,32,0,12,33
10,Success,46,33,0,13,33
10,Success,43,33,0,14,29
10,Success,44,29,6,12,32
10,Success,51,21,1,13,38
10,Success,55,21,0,13,42
10,Success,60,15,0,11,49
10,Success,47,24,5,16,31
10,Success,46,33,0,13,33
10,Success,47,30,0,15,32
10,Success,42,26,11,12,30
10,Success,43,29,10,10,33
10,Success,49,28,0,8,41
10,Success,48,26,0,15,33
10,Success,50,22,0,19,31
10,Success,46,34,0,10,36
10,Success,58,21,0,10,48
10,Success,46,22,2,17,29
10,Success,45,31,0,13,32
10,Success,45,23,2,18,27
10,Success,50,21,9,13,37
10,Success,49,28,0,12,37
10,Success,47,22,10,12,35
10,Success,48,24,0,19,29
10,Success,48,24,6,13,35
10,Success,48,31,0,13,35
10,Success,45,41,0,7,38
10,Success,57,24,4,3,54
10,Success,50,17,2,20,30
10,Success,51,23,0,14,37
10,Success,52,21,3,12,40
10,Success,33,41,0,16,17
10,Success,44,28,1,14,30
10,Success,48,33,0,12,36
10,Success,46,32,0,8,38
10,Success,44,30,2,13,31
10,Success,58,14,0,15,43
10,Success,58,21,0,12,46
10,Success,42,32,0,16,26
10,Success,47,27,3,14,33
10,Success,47,29,6,8,39
10,Success,50,25,0,10,40
10,Success,45,32,0,16,29
10,Success,39,26,7,19,20
10,Success,42,37,0,11,31
10,Success,52,29,0,11,41
10,Success,47,35,0,10,37
10,Success,56,18,0,12,44
10,Success,44,31,0,11,33
10,Success,48,30,3,11,37
10,Success,51,20,0,16,35
10,Success,45,30,6,11,34
10,Success,45,29,0,15,30
10,Success,40,36,2,11,29
10,Success,50,18,5,16,34
10,Success,55,24,1,7,48
10,Success,42,29,5,15,27
10,Success,45,27,8,11,34
10,Success,45,25,0,18,27
10,Success,52,34,0,5,47
10,Success,44,26,8,14,30
10,Success,48,29,0,14,34
10,Success,48,28,0,12,36
10,Success,46,27,1,15,31
10,Success,44,37,0,9,35
10,Success,46,31,0,15,31
10,Success,46,35,0,12,34
10,Success,47,21,7,13,34
10,Success,48,24,0,17,31
10,Success,47,32,0,13,34
10,Success,44,26,10,11,33
10,Success,51,20,1,15,36
10,Success,55,21,0,10,45
10,Success,45,29,6,11,34
10,Success,45,26,7,15,30
10,Success,45,22,3,17,28
10,Success,49,24,0,12,37
10,Success,52,23,0,14,38
10,Success,46,25,5,16,30
10,Success,54,25,3,11,43
10,Success,43,35,1,14,29
10,Success,44,25,8,14,30
10,Success,39,38,0,14,25
10,Success,46,21,9,14,32
10,Success,47,23,7,11,36
10,Success,55,13,3,19,36
10,Success,50,22,1,16,34
10,Success,49,39,0,2,47
10,Success,50,25,0,17,33
10,Success,49,29,0,10,39
10,Success,50,35,0,7,43
10,Success,43,31,2,12,31
10,Success,56,21,0,13,43
10,Success,48,26,0,9,39
10,Success,44,29,1,15,29
10,Success,47,32,0,11,36
10,Success,57,29,0,4,53
10,Success,45,25,2,13,32
10,Success,44,30,0,14,30
10,Success,44,36,0,11,33
10,Success,48,24,0,12,36
10,Success,39,31,7,13,26
10,Success,51,28,0,10,41
10,Success,49,23,7,11,38
10,Success,53,19,3,15,38
10,Success,47,29,0,16,31
10,Success,47,30,3,10,37
10,Success,49,30,0,9,40
10,Success,46,31,0,13,33
10,Success,42,33,0,19,23
10,Success,56,23,4,9,47
10,Success,45,29,8,7,38
10,Success,43,38,0,13,30
10,Success,45,30,0,16,29
10,Success,55,22,6,8,47
10,Success,45,35,0,12,33
10,Success,50,30,2,9,41
10,Success,57,22,0,11,46
10,Success,54,25,2,10,44
10,Success,46,25,0,15,31
10,Success,48,26,2,12,36
10,Success,51,24,0,14,37
10,Success,57,20,0,12,45
10,Success,37,43,0,11,26
10,Success,47,22,3,18,29
10,Success,49,25,0,14,35
10,Success,40,33,7,12,28
10,Success,46,22,9,16,30
10,Success,43,29,0,16,27
10,Success,48,29,0,10,38
10,Success,42,31,0,17,25
10,Success,45,27,0,15,30
10,Success,40,32,0,17,23
10,Success,48,21,0,13,35
10,Success,46,27,1,18,28
10,Success,45,34,0,12,33
10,Success,46,30,0,12,34
10,Success,48,24,0,15,33
10,Success,52,22,4,14,38
10,Success,52,28,1,7,45
10,Success,48,29,0,10,38
10,Success,44,36,0,13,31
10,Success,43,30,1,15,28
10,Success,48,31,0,10,38
10,Success,44,32,0,12,32
10,Success,44,28,4,12,32
10,Success,50,23,0,17,33
10,Success,48,21,2,16,32
10,Success,49,28,2,9,40
10,Success,47,32,0,8,39
10,Success,50,18,7,12,38
10,Success,49,29,1,9,40
10,Success,40,29,3,17,23
10,Success,47,28,6,11,36
10,Success,55,19,4,12,43
10,Success,47,25,0,15,32
10,Success,49,22,7,12,37
10,Success,51,31,0,12,39
10,Success,46,25,11,8,38
10,Success,45,29,0,16,29
10,Success,44,34,0,12,32
10,Success,42,38,0,16,26
10,Success,46,26,0,16,30
10,Success,48,27,0,14,34
10,Success,51,31,0,8,43
10,Success,56,20,3,14,42
10,Success,49,22,0,14,35
10,Success,40,35,0,17,23
10,Success,44,41,0,4,40
10,Success,41,33,0,14,27
10,Success,49,26,0,15,34
10,Success,54,21,1,9,45
10,Success,50,26,9,7,43
10,Success,49,33,0,7,42
10,Success,48,23,1,12,36
10,Success,37,42,0,14,23
10,Success,47,22,2,19,28
10,Success,53,28,0,5,48
10,Success,54,22,3,9,45
10,Success,46,21,4,21,25
10,Success,46,22,6,16,30
10,Success,48,24,2,15,33
10,Success,43,28,5,15,28
10,Success,44,28,2,15,29
10,Success,50,23,9,9,41
10,Success,49,29,0,9,40
10,Success,53,24,4,8,45
10,Success,49,34,0,4,45
10,Success,55,27,0,7,48
10,Success,50,27,0,11,39
10,Success,49,33,0,8,41
10,Success,51,27,2,11,40
10,Success,52,19,0,13,39
10,Success,42,33,0,15,27
10,Success,44,33,3,12,32
10,Success,46,29,1,13,33
10,Success,50,26,0,13,37
10,Success,51,21,0,10,41
10,Success,46,22,0,18,28
10,Success,55,18,8,9,46
10,Success,40,40,0,9,31
10,Success,46,32,0,9,37
10,Success,46,33,5,5,41
10,Success,49,20,2,15,34
10,Success,46,26,0,17,29
10,Success,44,23,7,16,28
10,Success,44,26,8,11,33
10,Success,53,20,1,16,37
10,Success,51,28,0,10,41
10,Success,50,25,0,14,36
10,Success,49,22,1,18,31
10,Success,53,24,6,12,41
10,Success,41,33,0,16,25
10,Success,47,32,0,14,33
10,Success,55,23,2,8,47
10,Success,47,31,0,17,30
10,Success,42,33,0,11,31
10,Success,48,20,5,15,33
10,Success,50,30,0,12,38
10,Success,49,24,2,8,41
10,Success,52,25,0,9,43
10,Success,54,23,0,12,42
10,Success,57,24,1,6,51
10,Success,49,24,2,12,37
10,Success,46,31,0,12,34
10,Success,39,27,1,18,21
10,Success,43,31,0,13,30
10,Success,48,25,1,12,36
10,Success,44,26,0,19,25
10,Success,49,36,0,10,39
10,Success,45,33,0,12,33
10,Success,51,23,0,13,38
10,Success,45,31,3,14,31
10,Success,46,27,0,17,29
10,Success,49,30,0,10,39
10,Success,51,22,0,11,40
10,Success,44,36,0,12,32
10,Success,49,26,0,10,39
10,Success,41,41,0,11,30
10,Success,46,37,0,9,37
10,Success,47,28,7,9,38
10,Success,50,22,1,16,34
10,Success,35,34,14,12,23
10,Success,51,25,0,12,39
10,Success,44,28,0,15,29
10,Success,49,25,4,12,37
10,Success,50,24,0,10,40
10,Success,42,29,0,16,26
10,Success,47,33,0,10,37
10,Success,48,30,0,8,40
10,Success,50,29,0,13,37
10,Success,41,29,0,20,21
10,Success,45,30,6,12,33
10,Success,46,26,0,15,31
10,Success,48,35,0,8,40
10,Success,63,12,1,12,51
10,Success,38,29,6,16,22
10,Success,51,28,0,9,42
10,Success,42,35,3,9,33
10,Success,48,26,1,11,37
10,Success,47,28,0,14,33
10,Success,53,32,0,6,47
10,Success,42,31,0,14,28
10,Success,47,19,15,12,35
10,Success,45,27,2,13,32
10,Success,51,28,6,6,45
10,Success,52,21,0,13,39
10,Success,45,25,8,12,33
10,Success,45,36,0,12,33
10,Success,45,28,0,15,30
10,Success,51,32,0,11,40
10,Success,45,26,3,10,35
10,Success,49,28,7,8,41
10,Success,44,24,1,19,25
10,Success,49,24,0,13,36
10,Success,41,34,0,15,26
10,Success,47,35,0,8,39
10,Success,46,21,5,16,30
10,Success,51,32,1,3,48
10,Success,40,42,0,8,32
10,Success,49,27,0,11,38
10,Success,43,33,2,11,32
10,Success,45,37,0,11,34
10,Success,41,34,0,12,29
10,Success,47,25,6,11,36
10,Success,50,23,0,13,37
10,Success,49,19,0,17,32
10,Success,49,25,0,13,36
10,Success,46,30,5,11,35
10,Success,50,27,2,9,41
10,Success,48,29,9,9,39
10,Success,50,21,0,18,32
10,Success,49,30,0,12,37
10,Success,50,29,1,12,38
10,Success,45,33,0,16,29
10,Success,56,19,3,12,44
10,Success,42,32,0,13,29
10,Success,57,20,0,7,50
10,Success,48,22,0,17,31
10,Success,55,20,2,11,44
10,Success,55,22,0,9,46
10,Success,52,18,7,13,39
10,Success,48,23,2,13,35
10,Success,42,36,0,11,31
10,Success,53,23,0,13,40
10,Success,44,31,4,12,32
10,Success,51,23,8,11,40
10,Success,50,23,0,17,33
10,Success,55,20,4,12,43
10,Success,51,32,0,12,39
10,Success,49,26,6,9,40
10,Success,40,31,1,14,26
10,Success,46,38,0,10,36
10,Success,42,24,4,21,21
10,Success,54,18,6,12,42
10,Success,47,30,4,11,36
10,Success,48,28,0,17,31
10,Success,58,21,0,5,53
10,Success,48,27,7,11,37
10,Success,38,33,1,17,21
10,Success,50,24,1,11,39
10,Success,45,28,0,19,26
10,Success,50,25,0,11,39
10,Success,58,16,5,9,49
10,Success,52,25,8,8,44
10,Success,42,31,0,16,26
10,Success,54,25,0,13,41
10,Success,50,28,0,15,35
10,Success,49,26,0,14,35
10,Success,44,33,0,11,33
10,Success,52,23,3,11,41
10,Success,46,16,7,21,25
10,Success,54,21,2,11,43
10,Success,56,23,1,9,47
10,Success,52,27,0,11,41
10,Success,50,25,0,15,35
10,Success,41,31,0,18,23
10,Success,46,22,8,10,36
10,Success,48,30,0,10,38
10,Success,54,25,4,6,48
10,Success,47,33,0,12,35
10,Success,51,22,1,13,38
10,Success,47,27,0,17,30
10,Success,45,26,2,14,31
10,Success,52,28,0,13,39
10,Success,44,28,0,15,29
10,Success,48,29,5,9,39
10,Success,49,27,0,12,37
10,Success,49,30,0,7,42
10,Success,57,27,0,8,49
10,Success,50,25,0,12,38
10,Success,47,25,10,10,37
10,Success,50,27,0,13,37
10,Success,46,30,0,10,36
10,Success,46,22,9,16,30
10,Success,43,30,5,14,29
10,Success,49,25,0,16,33
10,Success,44,26,11,15,29
10,Success,48,21,8,14,34
10,Success,40,43,0,9,31
10,Success,51,24,1,16,35
10,Success,48,24,5,13,35
10,Success,51,29,0,9,42
10,Success,45,27,8,9,36
10,Success,49,31,0,14,35
10,Success,51,22,0,15,36
10,Success,47,23,0,14,33
10,Success,43,24,3,19,24
10,Success,47,31,0,10,37
10,Success,41,38,0,12,29
10,Success,52,26,0,9,43
10,Success,54,22,2,10,44
10,Success,45,29,8,6,39
10,Success,55,22,7,9,46
10,Success,52,21,0,16,36
10,Success,44,36,0,12,32
10,Success,52,35,0,6,46
10,Success,55,27,1,6,49
10,Success,48,28,0,11,37
10,Success,50,27,0,13,37
10,Success,57,22,1,9,48
10,Success,50,26,0,13,37
10,Success,48,24,2,11,37
10,Success,48,26,10,9,39
10,Success,46,34,0,12,34
10,Success,47,32,0,13,34
10,Success,53,22,4,11,42
10,Success,37,37,0,15,22
10,Success,41,35,1,10,31
10,Success,47,36,0,9,38
10,Success,43,33,0,12,31
10,Success,44,23,3,15,29
10,Success,50,24,3,13,37
10,Success,48,23,0,19,29
10,Success,46,25,0,15,31
10,Success,41,34,0,13,28
10,Success,44,27,6,16,28
10,Success,41,32,0,14,27
10,Success,47,24,0,14,33
10,Success,47,30,0,11,36
10,Success,51,23,3,12,39
10,Success,51,19,1,18,33
10,Success,48,28,0,10,38
10,Success,48,23,4,14,34
10,Success,48,24,3,18,30
10,Success,47,22,8,16,31
10,Success,44,30,0,15,29
10,Success,45,36,0,8,37
10,Success,47,31,0,12,35
10,Success,53,27,1,6,47
10,Success,54,25,0,8,46
10,Success,44,31,0,16,28
10,Success,49,25,4,9,40
10,Success,47,27,6,10,37
10,Success,50,32,0,8,42
10,Success,51,22,0,17,34
10,Success,52,26,0,13,39
10,Success,49,22,2,9,40
10,Success,52,27,0,9,43
10,Success,45,39,0,8,37
10,Success,37,35,0,17,20
10,Success,41,36,0,14,27
10,Success,44,38,0,10,34
10,Success,52,28,0,9,43
10,Success,50,25,9,7,43
10,Success,49,30,2,11,38
10,Success,42,25,10,13,29
10,Success,52,27,2,7,45
10,Success,48,23,9,10,38
10,Success,49,30,0,12,37
10,Success,46,29,0,13,33
10,Success,43,35,2,7,36
10,Success,47,31,0,9,38
10,Success,50,23,0,12,38
10,Success,44,23,5,15,29
10,Success,46,25,6,13,33
10,Success,43,30,0,18,25
10,Success,43,27,0,18,25
10,Success,43,31,0,16,27
10,Success,54,24,0,11,43
10,Success,43,35,9,8,35
10,Success,47,29,0,13,34
10,Success,41,25,9,17,24
10,Success,39,35,0,15,24
10,Success,59,20,0,10,49
10,Success,48,31,0,13,35
10,Success,53,20,1,19,34
10,Success,46,28,0,15,31
10,Success,56,18,4,12,44
10,Success,51,32,2,6,45
10,Success,47,23,0,15,32
10,Success,46,34,0,11,35
10,Success,45,25,0,18,27
10,Success,54,22,0,10,44
10,Success,45,30,3,12,33
10,Success,49,22,5,13,36
10,Success,48,32,0,10,38
10,Success,45,25,2,17,28
10,Success,46,23,6,14,32
10,Success,46,21,2,18,28
10,Success,49,26,0,15,34
10,Success,44,23,4,17,27
10,Success,51,29,0,10,41
10,Success,44,34,0,15,29
10,Success,52,23,0,12,40
10,Success,58,27,0,7,51
10,Success,45,36,0,8,37
10,Success,42,16,15,21,21
10,Success,50,26,0,12,38
10,Success,52,16,8,13,39
10,Success,39,36,0,15,24
10,Success,54,22,1,10,44
10,Success,34,36,10,15,19
10,Success,44,27,7,14,30
10,Success,45,24,1,19,26
10,Success,39,35,0,14,25
10,Success,49,24,6,11,38
10,Success,48,29,0,16,32
10,Success,41,32,3,13,28
10,Success,59,23,0,5,54
10,Success,46,25,0,15,31
10,Success,52,23,3,10,42
10,Success,43,29,5,13,30
10,Success,44,26,0,17,27
10,Success,47,24,0,18,29
10,Success,51,27,0,10,41
10,Success,51,25,0,15,36
10,Success,43,37,0,12,31
10,Success,47,23,4,17,30
10,Success,40,36,6,10,30
10,Success,52,28,0,12,40
10,Success,47,28,7,8,39
10,Success,39,31,8,15,24
10,Success,50,24,4,12,38
10,Success,49,28,6,11,38
10,Success,49,26,0,15,34
10,Success,47,29,0,11,36
10,Success,46,24,0,18,28
10,Success,46,40,0,7,39
10,Success,50,28,0,8,42
10,Success,48,26,0,9,39
10,Success,50,24,5,9,41
10,Success,57,21,4,10,47
10,Success,51,31,0,14,37
10,Success,58,18,0,11,47
10,Success,45,33,0,11,34
10,Success,53,24,2,6,47
10,Success,47,28,3,12,35
10,Success,47,31,0,12,35
10,Success,46,30,0,14,32
10,Success,45,30,0,16,29
10,Success,41,34,0,16,25
10,Success,41,30,0,20,21
10,Success,50,23,0,13,37
10,Success,51,21,0,13,38
10,Success,52,19,0,20,32
10,Success,49,30,0,8,41
10,Success,42,37,0,12,30
10,Success,48,27,0,16,32
10,Success,46,23,1,17,29
10,Success,44,29,0,20,24
10,Success,50,31,0,9,41
10,Success,40,27,0,16,24
10,Success,54,24,3,10,44
10,Success,52,22,4,11,41
10,Success,54,19,0,17,37
10,Success,50,19,5,15,35
10,Success,46,34,0,17,29
10,Success,45,23,0,22,23
10,Success,51,20,2,12,39
10,Success,44,33,0,14,30
10,Success,46,40,0,7,39
10,Success,45,34,5,9,36
10,Success,52,27,0,13,39
10,Success,42,31,0,18,24
10,Success,48,23,2,12,36
10,Success,51,21,2,12,39
10,Success,51,23,4,13,38
10,Success,52,24,0,10,42
10,Success,55,24,0,10,45
10,Success,46,24,0,19,27
10,Success,48,24,2,15,33
10,Success,37,32,3,16,21
10,Success,55,26,0,8,47
10,Success,42,36,0,12,30
10,Success,49,23,2,14,35
10,Success,52,26,0,16,36
10,Success,54,26,0,10,44
10,Success,50,20,8,11,39
10,Success,40,34,0,17,23
10,Success,53,28,0,8,45
10,Success,40,38,0,14,26
10,Success,43,30,0,18,25
10,Success,50,26,0,9,41
10,Success,59,25,0,5,54
10,Success,46,26,0,16,30
10,Success,43,25,5,15,28
10,Success,45,29,5,13,32
10,Success,40,39,0,13,27
10,Success,47,33,0,10,37
10,Success,49,27,0,15,34
10,Success,46,22,0,19,27
10,Success,45,33,0,12,33
10,Success,45,21,7,18,27
10,Success,42,27,4,17,25
10,Success,53,22,0,14,39
10,Success,42,31,0,12,30
10,Success,49,26,2,13,36
10,Success,39,27,0,22,17
10,Success,47,31,0,12,35
10,Success,50,23,1,16,34
10,Success,51,26,0,11,40
10,Success,54,27,0,11,43
10,Success,53,25,5,10,43
10,Success,50,28,1,9,41
10,Success,59,23,1,8,51
10,Success,49,29,0,11,38
10,Success,47,22,0,14,33
10,Success,53,21,6,11,42
10,Success,46,36,0,12,34
10,Success,42,42,0,8,34
10,Success,49,30,4,5,44
10,Success,53,23,0,13,40
10,Success,49,27,2,10,39
10,Success,46,30,0,14,32
10,Success,43,39,0,11,32
10,Success,45,26,6,11,34
10,Success,49,25,3,13,36
10,Success,56,22,0,10,46
10,Success,52,22,0,12,40
10,Success,43,27,1,16,27
10,Success,52,13,9,16,36
10,Success,41,35,4,14,27
10,Success,50,26,0,13,37
10,Success,52,22,4,12,40
10,Success,42,35,0,14,28
10,Success,54,24,0,8,46
10,Success,48,24,0,19,29
10,Success,48,29,0,10,38
10,Success,48,34,0,11,37
10,Success,50,25,0,12,38
10,Success,44,31,3,10,34
10,Success,52,19,0,16,36
10,Success,35,39,0,17,18
10,Success,49,25,6,9,40
10,Success,56,21,1,9,47
10,Success,49,29,0,15,34
10,Success,44,36,0,12,32
10,Success,51,24,4,14,37
10,Success,52,27,0,13,39
10,Success,49,18,3,13,36
10,Success,51,24,0,14,37
10,Success,52,22,0,17,35
10,Success,44,22,1,19,25
10,Success,47,24,7,7,40
10,Success,50,25,0,13,37
10,Success,43,24,8,18,25
10,Success,45,33,3,10,35
10,Success,50,25,7,8,42
10,Success,37,41,0,17,20
10,Success,50,26,0,13,37
10,Success,57,22,0,9,48
10,Success,47,34,0,9,38
10,Success,60,16,2,11,49
10,Success,45,29,0,12,33
10,Success,50,23,0,16,34
10,Success,46,25,5,14,32
10,Success,46,25,9,11,35
10,Success,47,23,7,13,34
10,Success,53,21,2,13,40
10,Success,50,21,0,10,40
10,Success,47,25,0,15,32
10,Success,50,22,7,13,37
10,Success,46,33,0,12,34
10,Success,45,30,0,12,33
10,Success,44,29,0,15,29
10,Success,39,31,0,20,19
10,Success,48,23,2,17,31
10,Success,44,34,0,13,31
10,Success,44,35,0,13,31
10,Success,40,36,0,15,25
10,Success,52,28,2,9,43
10,Success,49,21,1,19,30
10,Success,41,41,0,9,32
10,Success,55,26,0,8,47
10,Success,38,35,10,13,25
10,Success,40,28,5,19,21
10,Success,48,30,0,12,36
10,Success,48,29,0,12,36
10,Success,49,23,3,16,33
10,Success,52,26,0,11,41
10,Success,53,19,1,15,38
10,Success,53,20,10,10,43
10,Success,43,33,2,10,33
10,Success,49,21,2,12,37
10,Success,47,23,0,17,30
10,Success,50,23,2,14,36
10,Success,47,25,5,14,33
10,Success,42,37,2,8,34
10,Success,50,23,0,13,37
10,Success,52,21,3,14,38
10,Success,49,23,0,14,35
10,Success,40,41,0,10,30
10,Success,53,19,2,14,39
10,Success,48,32,0,9,39
10,Success,53,24,0,10,43
10,Success,52,20,7,11,41
10,Success,45,21,9,15,30
10,Success,52,24,3,9,43
10,Success,42,28,5,15,27
10,Success,50,25,0,12,38
10,Success,50,32,0,7,43
10,Success,47,28,2,10,37
10,Success,52,28,2,10,42
10,Success,50,28,6,11,39
10,Success,44,26,7,12,32
10,Success,46,27,4,10,36
10,Success,50,22,3,14,36
10,Success,44,31,0,20,24
10,Success,48,27,0,13,35
10,Success,48,30,4,8,40
10,Success,47,31,2,10,37
10,Success,51,24,4,11,40
10,Success,48,27,2,13,35
10,Success,49,28,0,14,35
10,Success,48,31,0,10,38
10,Success,46,32,0,12,34
10,Success,47,28,5,14,33
10,Success,48,24,0,17,31
10,Success,49,31,0,14,35
10,Success,52,24,0,14,38
10,Success,46,21,7,17,29
10,Success,49,25,8,9,40
10,Success,56,23,0,10,46
10,Success,50,28,0,11,39
10,Success,53,26,0,8,45
10,Success,54,23,0,13,41
10,Success,47,32,7,9,38
10,Success,49,26,0,14,35
10,Success,47,30,5,11,36
10,Success,51,25,0,16,35
10,Success,44,43,0,7,37
10,Success,44,30,9,10,34
10,Success,45,30,2,15,30
10,Success,53,22,0,13,40
10,Fail,31,40,0,24,7
10,Success,54,20,0,11,43
10,Success,53,25,0,11,42
10,Success,42,27,8,15,27
10,Success,49,22,9,10,39
10,Success,44,25,0,20,24
10,Success,53,30,0,11,42
10,Success,44,32,0,13,31
10,Success,52,24,1,10,42
10,Success,51,26,0,9,42
10,Success,49,27,0,16,33
10,Success,44,27,0,16,28
10,Success,46,19,5,18,28
10,Success,50,29,0,12,38
10,Success,38,39,0,15,23
10,Success,39,37,4,10,29
10,Success,44,30,0,14,30
10,Success,56,17,1,14,42
10,Success,48,35,0,7,41
10,Success,47,26,0,17,30
10,Success,46,22,5,17,29
10,Success,54,26,0,11,43
10,Success,46,22,8,15,31
10,Success,54,27,1,8,46
10,Success,44,26,5,16,28
10,Success,51,25,0,14,37
10,Success,44,35,0,6,38
10,Success,52,26,1,10,42
10,Success,47,27,8,11,36
10,Success,48,27,3,17,31
10,Success,50,28,0,12,38
10,Success,47,30,0,10,37
10,Success,43,24,11,16,27
10,Success,56,24,0,6,50
10,Success,57,19,4,10,47
10,Success,50,28,5,11,39
10,Success,45,25,5,12,33
10,Success,44,38,0,10,34
10,Success,53,23,0,13,40
10,Success,52,25,1,10,42
10,Success,44,25,2,16,28
10,Success,55,23,0,13,42
10,Success,52,22,4,11,41
10,Success,47,27,0,13,34
10,Success,48,25,4,10,38
10,Success,48,25,2,10,38
10,Success,49,29,0,9,40
10,Success,50,27,0,11,39
10,Success,51,24,0,13,38
10,Success,50,21,1,15,35
10,Success,48,32,0,13,35
10,Success,39,30,8,11,28
10,Success,46,29,2,12,34
10,Success,36,32,0,25,11
10,Success,43,42,0,10,33
10,Success,53,28,0,13,40
10,Success,52,19,0,16,36
10,Success,57,27,0,8,49
10,Success,51,24,1,13,38
10,Success,49,28,0,10,39
10,Success,45,37,0,15,30
10,Success,51,21,0,17,34
10,Success,48,30,3,8,40
10,Success,54,24,2,6,48
10,Success,50,24,0,17,33
10,Success,43,30,6,11,32
10,Success,49,28,4,8,41
10,Success,49,20,8,13,36
10,Success,40,33,5,14,26
10,Success,54,24,0,14,40
10,Success,50,21,6,12,38
10,Success,43,35,0,15,28
10,Success,50,30,0,11,39
10,Success,49,24,5,12,37
10,Success,50,25,2,12,38
10,Success,44,30,0,17,27
10,Success,49,28,5,10,39
10,Success,55,24,0,9,46
10,Success,40,36,0,14,26
10,Success,57,26,0,6,51
10,Success,43,25,7,14,29
10,Success,43,30,0,18,25
10,Success,42,32,0,15,27
10,Success,46,29,0,14,32
10,Success,48,28,4,9,39
10,Success,47,24,3,15,32
10,Success,42,28,0,20,22
10,Success,48,21,2,17,31
10,Success,56,17,2,8,48
10,Success,42,36,0,10,32
10,Success,48,29,0,14,34
10,Success,46,27,0,15,31
10,Success,53,26,0,13,40
10,Success,51,25,0,10,41
10,Success,40,28,8,18,22
10,Success,48,26,0,14,34
10,Success,48,25,2,13,35
10,Success,48,29,0,13,35
10,Success,60,17,3,10,50
10,Success,49,25,4,14,35
10,Success,54,21,0,12,42
10,Success,50,23,0,11,39
10,Success,41,32,6,11,30
10,Success,43,27,5,16,27
10,Success,58,28,0,6,52
10,Success,43,23,7,17,26
10,Success,55,22,0,14,41
10,Success,46,23,8,15,31
10,Success,47,22,8,11,36
10,Success,48,26,2,13,35
10,Success,47,31,0,10,37
10,Success,57,20,0,10,47
10,Success,50,28,0,11,39
10,Success,44,29,0,19,25
10,Success,51,22,9,11,40
10,Success,46,25,11,10,36
10,Success,58,17,0,12,46
10,Success,42,33,3,15,27
10,Success,45,36,0,10,35
10,Success,51,22,5,12,39
10,Success,53,20,0,14,39
10,Success,48,27,0,12,36
10,Success,48,30,0,11,37
10,Success,46,31,0,12,34
10,Success,48,25,10,12,36
10,Success,53,28,0,10,43
10,Success,46,27,4,13,33
10,Success,48,32,2,10,38
10,Success,47,35,0,6,41
10,Success,49,26,0,13,36
10,Success,51,21,5,11,40
10,Success,50,24,3,12,38
10,Success,48,32,0,10,38
10,Success,57,21,1,9,48
10,Success,49,30,0,12,37
10,Success,52,26,1,9,43
10,Success,48,30,0,9,39
10,Success,52,27,0,11,41
10,Success,44,27,1,13,31
10,Success,51,26,5,9,42
10,Success,53,26,0,8,45
10,Success,41,31,4,12,29
10,Success,48,30,0,11,37
10,Success,47,28,3,12,35
10,Success,43,35,0,12,31
10,Success,45,25,2,16,29
10,Success,52,18,7,11,41
10,Success,49,20,5,15,34
10,Success,46,28,0,14,32
10,Success,47,24,4,15,32
10,Success,51,26,2,12,39
10,Success,46,26,0,17,29
10,Success,42,18,16,17,25
10,Success,52,26,0,10,42
10,Success,52,20,5,14,38
10,Success,49,33,0,9,40
10,Success,50,26,0,12,38
10,Success,46,32,0,10,36
10,Success,46,27,0,15,31
10,Success,40,29,4,12,28
10,Success,44,33,0,14,30
10,Success,51,27,2,8,43
10,Success,48,30,2,9,39
10,Success,49,26,3,12,37
10,Success,54,22,0,13,41
10,Success,48,31,0,14,34
10,Success,50,30,0,12,38
10,Success,47,24,0,16,31
10,Success,48,29,0,14,34
10,Success,48,28,4,10,38
10,Success,40,39,0,9,31
10,Success,54,25,0,8,46
10,Success,44,29,0,16,28
10,Success,47,28,2,10,37
10,Success,52,17,0,20,32
10,Success,47,25,0,15,32
10,Success,48,24,4,15,33
10,Success,43,40,0,10,33
10,Success,55,24,0,10,45
10,Success,47,30,1,10,37
10,Success,47,31,0,11,36
10,Success,47,28,0,13,34
10,Success,52,21,8,10,42
10,Success,54,18,4,8,46
10,Success,46,26,8,13,33
10,Success,42,21,9,16,26
10,Success,48,26,7,8,40
10,Success,45,34,0,10,35
10,Success,52,19,0,19,33
10,Success,49,27,0,12,37
10,Success,46,26,0,18,28
10,Success,46,27,4,9,37
10,Success,43,32,0,16,27
10,Success,48,24,3,14,34
10,Success,49,28,0,13,36
10,Success,56,21,0,13,43
10,Success,51,27,0,14,37
10,Success,49,29,0,11,38
10,Success,48,25,0,14,34
10,Success,50,23,0,14,36
10,Success,51,27,0,13,38
10,Success,53,21,5,11,42
10,Success,46,27,0,16,30
10,Success,45,37,0,15,30
10,Success,51,21,2,17,34
10,Success,53,19,3,14,39
10,Success,43,35,0,12,31
10,Success,51,26,0,12,39
10,Success,44,23,8,19,25
10,Success,44,23,7,17,27
10,Success,49,28,5,9,40
10,Success,44,34,0,14,30
10,Success,50,23,1,15,35
10,Success,45,35,0,9,36
10,Success,46,31,0,13,33
10,Success,38,37,2,9,29
10,Success,50,24,0,13,37
10,Success,44,35,10,7,37
10,Success,52,22,6,12,40
10,Success,46,28,0,12,34
10,Success,46,27,0,13,33
10,Success,56,24,2,9,47
10,Success,54,26,0,5,49
10,Success,51,24,0,14,37
10,Success,44,35,0,8,36
10,Success,45,29,0,16,29
10,Success,51,19,0,18,33
10,Success,42,21,8,18,24
10,Success,45,28,2,16,29
10,Success,54,24,0,11,43
10,Success,45,25,0,19,26
10,Success,58,16,2,10,48
10,Success,60,23,0,7,53
10,Success,50,25,0,13,37
10,Success,52,27,2,12,40
10,Success,46,21,10,20,26
10,Success,49,27,4,9,40
10,Success,44,32,0,13,31
10,Success,49,28,0,13,36
10,Success,50,18,4,13,37
10,Success,51,22,4,14,37
10,Success,45,30,0,13,32
10,Success,51,19,6,12,39
10,Success,48,26,1,10,38
10,Success,56,23,1,10,46
10,Success,55,20,0,8,47
10,Success,51,22,0,15,36
10,Success,43,30,5,14,29
10,Success,60,25,0,7,53
10,Success,52,32,0,4,48
10,Success,51,28,4,9,42
10,Success,47,19,0,22,25
10,Success,48,24,0,12,36
10,Success,45,31,0,10,35
10,Success,46,27,0,12,34
10,Success,47,27,4,12,35
10,Success,55,19,0,14,41
10,Success,50,26,4,8,42
10,Success,50,22,1,15,35
10,Success,56,20,1,11,45
10,Success,45,30,0,13,32
10,Success,51,22,0,16,35
10,Success,37,32,7,19,18
10,Success,45,32,0,9,36
10,Success,46,29,3,12,34
10,Success,48,24,2,13,35
10,Success,50,29,0,10,40
10,Success,48,27,0,14,34
10,Success,43,37,0,13,30
10,Success,51,22,4,15,36
10,Success,40,28,7,18,22
10,Success,49,19,10,13,36
10,Success,54,26,0,7,47
10,Success,47,29,0,13,34
10,Success,39,34,0,17,22
10,Success,42,29,0,19,23
10,Success,47,25,2,16,31
10,Success,41,31,7,13,28
10,Success,42,25,7,15,27
10,Success,50,25,0,11,39
10,Success,55,22,2,9,46
10,Success,48,26,3,14,34
10,Success,50,27,3,10,40
10,Success,51,28,1,9,42
10,Success,41,33,0,12,29
10,Success,47,27,4,16,31
10,Success,47,19,1,24,23
10,Success,51,26,0,14,37
10,Success,46,27,10,11,35
10,Success,48,29,0,14,34
10,Success,52,24,3,9,43
10,Success,49,28,0,10,39
10,Success,43,29,0,19,24
10,Success,52,25,0,16,36
10,Success,50,27,0,10,40
10,Success,52,16,0,16,36
10,Success,51,22,5,15,36
10,Success,44,23,5,14,30
10,Success,49,25,4,8,41
10,Success,52,26,0,13,39
10,Success,47,20,4,17,30
10,Success,48,29,0,9,39
10,Success,47,29,2,12,35
10,Success,52,20,1,17,35
10,Success,51,20,0,12,39
10,Success,48,28,1,8,40
10,Success,46,27,2,14,32
10,Success,46,27,0,15,31
10,Success,46,31,0,11,35
10,Success,52,25,0,12,40
10,Success,43,27,1,16,27
10,Success,37,29,11,15,22
10,Success,46,31,2,13,33
10,Success,45,27,2,15,30
10,Success,48,27,0,15,33
10,Success,49,27,2,13,36
10,Success,42,36,0,14,28
10,Success,50,20,5,12,38
10,Success,46,23,0,17,29
10,Success,44,27,1,16,28
10,Success,52,31,0,7,45
10,Success,47,35,0,11,36
10,Success,45,33,0,13,32
10,Success,45,27,4,13,32
10,Success,43,29,0,16,27
10,Success,51,26,1,10,41
10,Success,48,32,0,9,39
10,Success,54,23,0,10,44
10,Success,47,24,6,12,35
10,Success,48,24,2,13,35
10,Success,55,22,0,11,44
10,Success,50,20,0,14,36
10,Success,46,30,5,9,37
10,Success,50,23,3,13,37
10,Success,44,27,6,16,28
10,Success,58,19,4,8,50
10,Success,50,28,1,11,39
10,Success,51,25,0,10,41
10,Success,37,38,0,18,19
10,Success,51,18,2,15,36
10,Success,54,22,0,13,41
10,Success,47,30,1,12,35
10,Success,44,28,6,11,33
10,Success,42,34,0,11,31
10,Success,50,29,0,12,38
10,Success,47,29,0,12,35
10,Success,46,29,2,12,34
10,Success,50,23,6,14,36
10,Success,42,40,0,11,31
10,Success,52,19,6,11,41
10,Success,46,25,0,16,30
10,Success,58,22,2,8,50
10,Success,50,35,0,7,43
10,Success,49,33,0,10,39
10,Success,51,29,0,11,40
10,Success,50,19,3,19,31
10,Success,44,31,5,12,32
10,Success,47,27,6,12,35
10,Success,47,21,0,20,27
10,Success,48,27,0,12,36
10,Success,39,24,9,18,21
10,Success,50,25,0,15,35
10,Success,41,25,4,17,24
10,Success,42,38,0,12,30
10,Success,49,28,0,13,36
10,Success,41,38,0,9,32
10,Success,52,21,0,14,38
10,Success,43,36,0,9,34
10,Success,46,22,2,14,32
10,Success,49,26,1,12,37
10,Success,46,32,0,15,31
10,Success,51,30,0,10,41
10,Success,43,36,0,12,31
10,Success,49,27,3,10,39
10,Success,40,38,0,10,30
10,Success,51,31,0,10,41
10,Success,45,31,0,16,29
10,Success,43,35,0,13,30
10,Success,44,31,0,13,31
10,Success,54,28,0,8,46
10,Success,47,30,0,13,34
10,Success,38,34,0,17,21
10,Success,48,35,0,8,40
10,Success,45,27,1,15,30
10,Success,45,25,0,17,28
10,Success,52,21,2,15,37
10,Success,38,43,0,13,25
10,Success,50,34,0,11,39
10,Success,47,30,0,12,35
10,Success,48,23,10,7,41
10,Success,40,32,3,12,28
10,Success,45,26,5,14,31
10,Success,42,30,4,18,24
10,Success,54,22,1,12,42
10,Success,39,34,6,14,25
10,Success,37,37,0,18,19
10,Success,44,27,6,13,31
10,Success,49,27,6,10,39
10,Success,51,26,0,14,37
10,Success,38,27,18,13,25
10,Success,46,23,9,14,32
10,Success,46,27,2,16,30
10,Success,45,30,0,11,34
10,Success,48,24,4,14,34
10,Success,50,30,0,11,39
10,Success,47,24,5,14,33
10,Success,47,26,0,15,32
10,Success,54,27,2,6,48
10,Success,55,24,3,9,46
10,Success,48,32,0,8,40
10,Success,54,23,1,11,43
10,Success,53,23,0,12,41
10,Success,47,33,0,12,35
10,Success,51,22,0,15,36
10,Success,37,38,7,12,25
10,Success,43,26,0,18,25
10,Success,45,28,6,12,33
10,Success,50,20,6,13,37
10,Success,41,24,4,18,23
10,Success,59,17,3,8,51
10,Success,54,25,0,12,42
10,Success,44,31,0,15,29
10,Success,42,27,0,19,23
10,Success,51,26,0,11,40
10,Success,50,29,3,10,40
10,Success,43,31,0,16,27
10,Success,47,27,0,13,34
10,Success,45,30,4,9,36
10,Success,48,33,0,7,41
10,Success,50,31,0,5,45
10,Success,47,27,3,13,34
10,Success,55,19,0,14,41
10,Success,47,24,0,19,28
10,Success,45,33,0,12,33
10,Success,47,23,3,16,31
10,Success,48,30,0,12,36
10,Success,48,34,0,12,36
10,Success,44,26,5,13,31
10,Success,45,37,0,13,32
10,Success,54,26,0,7,47
10,Success,46,24,2,18,28
10,Success,44,41,0,6,38
10,Success,47,29,0,13,34
10,Success,46,29,0,15,31
10,Success,43,24,7,14,29
10,Success,43,32,3,15,28
10,Success,46,29,0,15,31
10,Success,51,26,0,12,39
10,Success,51,20,7,16,35
10,Success,48,26,4,10,38
10,Success,47,30,0,11,36
10,Success,51,27,4,10,41
10,Success,53,27,0,9,44
10,Success,52,23,4,9,43
10,Success,41,29,12,10,31
10,Success,43,25,8,13,30
10,Success,44,23,7,19,25
10,Success,49,35,0,9,40
10,Success,51,27,4,11,40
10,Success,44,35,0,12,32
10,Success,44,28,0,14,30
10,Success,35,36,10,14,21
10,Success,44,29,0,18,26
10,Success,59,21,0,9,50
10,Success,40,36,0,14,26
10,Success,58,25,4,5,53
10,Success,47,28,0,15,32
10,Success,57,21,0,12,45
10,Success,39,27,5,17,22
10,Success,49,23,8,10,39
10,Success,49,21,2,14,35
10,Success,49,33,0,10,39
10,Success,42,25,15,13,29
10,Success,44,31,0,15,29
10,Success,50,25,3,11,39
10,Success,51,21,0,14,37
10,Success,49,27,0,12,37
10,Success,54,24,0,8,46
10,Success,49,26,2,15,34
10,Success,50,26,4,12,38
10,Success,53,25,0,16,37
10,Success,51,25,0,11,40
10,Success,48,32,0,10,38
10,Success,55,20,0,12,43
10,Success,40,41,0,13,27
10,Success,48,22,1,11,37
10,Success,49,32,1,6,43
10,Success,46,35,0,10,36
10,Success,46,37,0,9,37
10,Success,43,40,0,10,33
10,Success,44,28,0,16,28
10,Success,53,26,0,11,42
10,Success,51,28,0,11,40
10,Success,44,31,0,16,28
10,Success,56,15,5,12,44
10,Success,50,22,4,13,37
10,Success,47,21,2,19,28
10,Success,53,29,0,7,46
10,Success,45,26,0,17,28
10,Success,48,27,3,11,37
10,Success,50,24,0,16,34
10,Success,40,43,0,9,31
10,Success,49,29,0,12,37
10,Success,46,28,5,11,35
10,Success,50,24,0,15,35
10,Success,50,23,2,11,39
10,Success,51,23,1,10,41
10,Success,52,28,0,8,44
10,Success,43,32,0,15,28
10,Success,48,24,8,9,39
10,Success,49,25,0,12,37
10,Success,49,26,0,14,35
10,Success,46,32,0,12,34
10,Success,48,37,0,8,40
10,Success,47,27,0,17,30
10,Success,47,27,2,13,34
10,Success,55,29,0,8,47
10,Success,48,29,5,9,39
10,Success,49,23,0,16,33
10,Success,51,24,0,13,38
10,Success,51,29,0,12,39
10,Success,46,28,0,15,31
10,Success,47,25,3,12,35
10,Success,52,26,1,8,44
10,Success,52,20,4,13,39
10,Success,40,28,1,20,20
10,Success,52,24,1,9,43
10,Success,45,29,0,15,30
10,Success,46,29,0,13,33
10,Success,51,26,4,10,41
10,Success,43,31,0,14,29
10,Success,46,29,0,15,31
10,Success,46,33,0,11,35
10,Success,52,19,2,17,35
10,Success,53,22,0,10,43
10,Success,44,31,3,14,30
10,Success,41,29,5,17,24
10,Success,44,29,7,14,30
10,Success,45,27,14,7,38
10,Success,53,21,0,16,37
10,Success,50,28,0,10,40
10,Success,46,30,0,13,33
10,Success,53,19,0,12,41
10,Success,56,21,2,12,44
10,Success,51,22,0,16,35
10,Success,52,31,0,8,44
10,Success,51,24,1,11,40
10,Success,46,31,0,12,34
10,Success,44,33,0,13,31
10,Success,52,23,2,12,40
10,Success,48,33,0,12,36
10,Success,45,34,0,14,31
10,Success,51,17,3,14,37
10,Success,47,30,6,9,38
10,Success,47,21,2,18,29
10,Success,43,34,7,8,35
10,Success,47,26,2,14,33
10,Success,54,25,0,11,43
10,Success,53,21,3,15,38
10,Success,60,25,0,6,54
10,Success,43,27,0,19,24
10,Success,48,31,0,12,36
10,Success,39,38,0,15,24
10,Success,47,24,0,17,30
10,Success,53,25,0,9,44
10,Success,46,40,0,8,38
10,Success,56,20,0,10,46
10,Success,55,19,1,10,45
10,Success,49,32,0,10,39
10,Success,47,20,4,18,29
10,Success,53,22,5,7,46
10,Success,54,25,2,10,44
10,Success,49,27,0,11,38
10,Success,49,22,2,13,36
10,Success,60,21,2,7,53
10,Success,47,21,11,11,36
10,Success,45,34,0,14,31
10,Success,45,31,0,15,30
10,Success,45,24,4,14,31
10,Success,52,28,0,7,45
10,Success,47,34,0,12,35
10,Success,54,22,4,8,46
10,Success,50,29,5,9,41
10,Success,53,18,0,16,37
10,Success,46,28,0,14,32
10,Success,44,34,0,9,35
10,Success,45,27,4,14,31
10,Success,44,26,4,17,27
10,Success,51,28,1,8,43
10,Success,49,31,0,11,38
10,Success,49,22,3,16,33
10,Success,45,29,1,11,34
10,Success,45,30,0,14,31
10,Success,47,28,0,16,31
10,Success,45,37,0,12,33
10,Success,52,26,0,11,41
10,Success,50,29,0,13,37
10,Success,54,19,6,10,44
10,Success,49,21,0,18,31
10,Success,53,29,0,7,46
10,Success,44,33,0,15,29
10,Success,41,32,0,17,24
10,Success,48,28,0,17,31
10,Success,60,12,0,9,51
10,Success,48,32,0,9,39
10,Success,53,25,0,13,40
10,Success,48,22,6,13,35
10,Success,49,25,0,14,35
10,Success,49,30,0,8,41
10,Success,46,32,0,14,32
10,Success,46,28,6,12,34
10,Success,53,23,1,9,44
10,Success,43,24,14,14,29
10,Success,49,23,0,19,30
10,Success,53,24,1,10,43
10,Success,53,28,0,11,42
10,Success,44,36,0,12,32
10,Success,52,31,0,7,45
10,Success,51,29,0,12,39
10,Success,50,23,1,10,40
10,Success,52,32,0,7,45
10,Success,44,22,2,19,25
10,Success,39,26,0,24,15
10,Success,46,31,5,8,38
10,Success,51,30,0,10,41
10,Success,51,25,2,10,41
10,Success,47,23,1,19,28
10,Success,42,33,0,16,26
10,Success,50,26,0,14,36
10,Success,41,35,0,15,26
10,Success,54,23,1,7,47
10,Success,46,22,10,12,34
10,Success,47,32,0,10,37
10,Success,53,21,1,13,40
10,Success,42,32,7,10,32
10,Success,55,21,2,9,46
10,Success,47,33,0,10,37
10,Success,43,29,0,15,28
10,Success,45,30,0,15,30
10,Success,48,28,0,17,31
10,Success,46,32,0,11,35
10,Success,50,26,0,10,40
10,Success,55,16,8,14,41
10,Success,46,31,1,11,35
10,Success,46,27,0,16,30
10,Success,51,27,0,15,36
10,Success,49,31,0,10,39
10,Success,51,24,3,9,42
10,Success,56,20,3,13,43
10,Success,50,30,0,10,40
10,Success,52,25,0,15,37
10,Success,43,33,0,9,34
10,Success,57,22,0,11,46
10,Success,53,18,5,11,42
10,Success,41,32,0,19,22
10,Success,45,26,9,12,33
10,Success,49,28,0,11,38
10,Success,47,23,10,13,34
10,Success,41,33,0,12,29
10,Success,49,29,0,15,34
10,Success,52,22,0,17,35
10,Success,55,22,2,12,43
10,Success,50,33,0,9,41
10,Success,53,23,0,10,43
10,Success,40,27,9,16,24
10,Success,55,26,7,5,50
10,Success,47,28,4,13,34
10,Success,58,19,0,13,45
10,Success,43,21,8,20,23
10,Success,46,34,0,11,35
10,Success,55,24,0,11,44
10,Success,51,29,0,12,39
10,Success,50,16,0,18,32
10,Success,48,30,0,13,35
10,Success,48,30,3,9,39
10,Success,45,24,1,16,29
10,Success,45,33,0,11,34
10,Success,52,23,5,11,41
10,Success,39,36,0,18,21
10,Success,53,21,11,4,49
10,Success,49,21,1,18,31
10,Success,46,30,0,14,32
10,Success,47,22,1,12,35
10,Success,43,29,8,11,32
10,Success,47,21,9,10,37
10,Success,50,19,5,17,33
10,Success,45,33,0,8,37
10,Success,49,29,1,10,39
10,Success,51,27,0,12,39
10,Success,48,30,0,9,39
10,Success,50,26,2,11,39
10,Success,47,26,5,10,37
10,Success,42,20,3,17,25
10,Success,51,25,0,12,39
10,Success,49,20,3,12,37
10,Success,44,38,0,8,36
10,Success,53,20,3,13,40
10,Success,48,31,0,12,36
10,Success,45,23,10,14,31
10,Success,47,33,1,8,39
10,Success,49,29,0,11,38
10,Success,43,31,1,17,26
10,Success,50,27,4,8,42
10,Success,49,27,4,11,38
10,Success,49,28,0,10,39
10,Success,48,27,0,13,35
10,Success,47,30,0,12,35
10,Success,51,22,2,11,40
10,Success,54,19,0,16,38
10,Success,55,22,0,12,43
10,Success,45,24,0,20,25
10,Success,45,27,4,16,29
10,Success,52,22,3,14,38
10,Success,39,40,0,15,24
10,Success,51,29,2,9,42
10,Success,49,27,0,12,37
10,Success,47,22,6,17,30
10,Success,47,30,0,13,34
10,Success,41,29,6,14,27
10,Success,49,27,0,13,36
10,Success,54,20,0,14,40
10,Success,44,37,0,10,34
10,Success,50,28,0,12,38
10,Success,48,27,2,10,38
10,Success,53,22,0,17,36
10,Success,45,30,0,18,27
10,Success,49,24,1,13,36
10,Success,42,34,0,13,29
10,Success,54,26,0,10,44
10,Success,48,29,0,12,36
10,Success,44,24,0,20,24
10,Success,45,33,0,15,30
10,Success,52,26,2,10,42
10,Success,49,24,2,11,38
10,Success,54,24,6,7,47
10,Success,48,28,0,13,35
10,Success,49,32,0,10,39
10,Success,48,29,0,9,39
10,Success,50,31,0,8,42
10,Success,44,31,1,13,31
10,Success,46,29,5,11,35
10,Success,53,24,0,11,42
10,Success,43,22,8,17,26
10,Success,51,26,5,11,40
10,Success,51,21,4,15,36
10,Success,47,22,8,14,33
10,Success,45,27,0,13,32
10,Success,56,19,5,9,47
10,Success,58,18,2,11,47
10,Success,42,43,0,9,33
10,Success,45,24,8,15,30
10,Success,46,27,0,18,28
10,Success,46,21,10,16,30
10,Success,44,24,6,15,29
10,Success,49,15,6,15,34
10,Success,46,27,5,13,33
10,Success,49,28,5,10,39
10,Success,42,33,0,13,29
10,Success,49,28,0,15,34
10,Success,52,24,0,12,40
10,Success,48,23,3,17,31
10,Success,45,27,0,16,29
10,Success,49,19,8,15,34
10,Success,54,33,0,4,50
10,Success,52,23,0,11,41
10,Success,50,25,0,14,36
10,Success,44,33,0,16,28
10,Success,53,21,1,14,39
10,Success,50,31,1,11,39
10,Success,46,22,5,17,29
10,Success,51,23,0,15,36
10,Success,41,41,0,8,33
10,Success,49,21,10,12,37
10,Success,55,22,3,12,43
10,Success,47,28,0,15,32
10,Success,58,21,0,6,52
10,Success,48,21,3,14,34
10,Success,54,22,0,10,44
10,Success,51,30,4,8,43
10,Success,48,35,0,9,39
10,Success,52,24,0,14,38
10,Success,45,30,0,15,30
10,Success,58,20,1,7,51
10,Success,50,22,5,10,40
10,Success,54,25,0,12,42
10,Success,42,30,0,15,27
10,Success,52,28,0,10,42
10,Success,46,30,0,12,34
10,Success,46,31,2,13,33
10,Success,44,28,5,14,30
10,Success,51,23,2,11,40
10,Success,51,27,1,12,39
10,Success,47,28,0,13,34
10,Success,41,34,0,15,26
10,Success,41,33,0,18,23
10,Success,46,26,5,13,33
10,Success,50,24,0,17,33
10,Success,49,24,0,15,34
10,Success,47,23,8,11,36
10,Success,42,37,0,11,31
10,Success,49,28,0,14,35
10,Success,52,26,9,7,45
10,Success,50,26,0,11,39
10,Success,49,31,0,10,39
10,Success,43,23,0,19,24
10,Success,46,26,1,14,32
10,Success,41,29,4,15,26
10,Success,46,29,0,15,31
10,Success,48,23,1,15,33
10,Success,45,23,12,12,33
10,Success,49,23,0,15,34
10,Success,47,29,1,12,35
10,Success,50,23,7,10,40
10,Success,53,23,1,9,44
10,Success,47,29,2,12,35
10,Success,47,28,0,15,32
10,Success,48,19,13,14,34
10,Success,49,25,0,15,34
10,Success,46,26,1,16,30
10,Success,45,25,1,15,30
10,Success,46,25,0,16,30
10,Success,47,28,0,15,32
10,Success,48,30,0,13,35
10,Success,53,23,1,12,41
10,Success,47,28,2,10,37
10,Success,53,25,4,8,45
10,Success,53,21,2,11,42
10,Success,47,23,11,6,41
10,Success,48,22,6,13,35
10,Success,48,33,0,9,39
10,Success,52,23,0,18,34
10,Success,50,20,5,12,38
10,Success,49,24,0,13,36
10,Success,36,40,0,15,21
10,Success,50,24,0,12,38
10,Success,36,38,8,9,27
10,Success,51,25,0,15,36
10,Success,55,15,0,17,38
10,Success,45,28,0,15,30
10,Success,54,30,0,7,47
10,Success,53,21,0,14,39
10,Success,43,25,0,18,25
10,Success,46,29,10,9,37
10,Success,51,25,0,11,40
10,Success,47,32,0,12,35
10,Success,56,17,1,10,46
10,Success,45,38,0,7,38
10,Success,47,21,12,10,37
10,Success,44,31,1,16,28
10,Success,53,21,3,10,43
10,Success,49,28,0,11,38
10,Success,55,30,0,5,50
10,Success,51,25,0,14,37
10,Success,40,32,0,17,23
10,Success,44,33,0,14,30
10,Success,52,24,0,15,37
10,Success,49,28,6,8,41
10,Success,52,17,0,20,32
10,Success,44,26,0,20,24
10,Success,44,25,7,13,31
10,Success,49,34,0,11,38
10,Success,47,30,0,14,33
10,Success,40,32,0,17,23
10,Success,51,24,0,12,39
10,Success,45,34,0,12,33
10,Success,47,22,2,15,32
10,Success,45,22,8,15,30
10,Success,50,29,0,12,38
10,Success,56,21,0,10,46
10,Success,49,29,2,11,38
10,Success,53,27,0,9,44
10,Success,54,24,0,15,39
10,Success,48,26,1,13,35
10,Success,45,26,3,19,26
10,Success,44,28,0,19,25
10,Success,51,24,2,15,36
10,Success,44,23,11,12,32
10,Success,48,35,0,8,40
10,Success,50,27,0,13,37
10,Success,48,26,0,16,32
10,Success,49,26,0,16,33
10,Success,50,21,6,13,37
10,Success,46,26,7,11,35
10,Success,40,37,0,13,27
10,Success,60,17,0,12,48
10,Success,48,29,5,8,40
10,Success,51,29,0,11,40
10,Success,44,27,0,16,28
10,Success,48,28,3,11,37
10,Success,49,30,5,8,41
10,Success,54,23,0,10,44
10,Success,46,35,0,12,34
10,Success,48,29,1,8,40
10,Success,49,24,6,12,37
10,Success,50,23,1,12,38
10,Success,42,28,0,14,28
10,Success,54,20,6,8,46
10,Success,53,26,0,15,38
10,Success,44,26,13,12,32
10,Success,47,24,0,18,29
10,Success,41,27,0,19,22
10,Success,52,28,0,9,43
10,Success,43,36,0,13,30
10,Success,44,25,0,20,24
10,Success,51,22,5,9,42
10,Success,50,24,0,16,34
10,Success,51,31,0,11,40
10,Success,44,26,3,15,29
10,Success,41,33,0,17,24
10,Success,47,25,4,12,35
10,Success,43,29,4,14,29
10,Success,52,20,4,17,35
10,Success,57,21,3,9,48
10,Success,52,28,0,10,42
10,Success,50,29,0,10,40
10,Success,44,36,0,10,34
10,Success,49,32,0,10,39
10,Success,45,24,11,10,35
10,Success,50,22,6,8,42
10,Success,41,30,11,13,28
10,Success,36,36,5,15,21
10,Success,54,23,7,8,46
10,Success,51,23,4,11,40
10,Success,51,29,0,11,40
10,Success,54,18,6,13,41
10,Success,50,20,6,16,34
10,Success,46,20,1,22,24
10,Success,52,21,0,17,35
10,Success,51,25,0,15,36
10,Success,43,22,4,22,21
10,Success,54,18,0,13,41
10,Success,52,28,0,9,43
10,Success,42,39,0,13,29
10,Success,46,22,7,16,30
10,Success,48,28,0,15,33
10,Success,44,31,6,8,36
10,Success,56,20,5,13,43
10,Success,49,26,2,11,38
10,Success,51,20,6,13,38
10,Success,48,25,4,14,34
10,Success,44,27,0,21,23
10,Success,48,32,3,8,40
10,Success,47,26,6,9,38
10,Success,53,24,0,12,41
10,Success,46,33,0,14,32
10,Success,57,23,0,9,48
10,Success,47,26,0,16,31
10,Success,53,19,5,12,41
10,Success,48,28,0,12,36
10,Success,47,26,1,15,32
10,Success,58,27,0,9,49
10,Success,45,25,9,10,35
10,Success,46,23,4,16,30
10,Success,46,30,0,13,33
10,Success,50,27,0,13,37
10,Success,46,35,0,10,36
10,Success,46,32,0,10,36
10,Success,52,28,0,9,43
10,Success,40,37,0,13,27
10,Success,47,24,6,15,32
10,Success,54,28,0,8,46
10,Success,48,28,0,11,37
10,Success,45,29,1,16,29
10,Success,41,30,0,13,28
10,Success,44,34,0,17,27
10,Success,42,36,5,10,32
10,Success,39,30,4,13,26
10,Success,36,42,0,15,21
10,Success,51,29,0,7,44
10,Success,48,31,0,8,40
10,Success,51,21,0,15,36
10,Success,53,25,0,11,42
10,Success,51,26,0,10,41
10,Success,41,27,7,15,26
10,Success,53,24,1,8,45
10,Success,41,30,2,12,29
10,Success,38,40,0,11,27
10,Success,45,28,0,16,29
10,Success,44,26,5,12,32
10,Success,49,28,4,10,39
10,Success,46,22,0,21,25
10,Success,50,21,2,16,34
10,Success,49,15,1,19,30
10,Success,43,36,0,11,32
10,Success,54,31,0,4,50
10,Success,39,38,0,9,30
10,Success,49,28,0,11,38
10,Success,45,33,0,10,35
10,Success,50,22,3,14,36
10,Success,54,23,0,13,41
10,Success,49,30,0,8,41
10,Success,39,43,0,6,33
10,Success,43,32,0,16,27
10,Success,53,23,1,11,42
10,Success,47,28,0,16,31
10,Success,43,30,6,12,31
10,Success,47,31,4,9,38
10,Success,47,34,0,10,37
10,Success,47,24,6,9,38
10,Success,48,27,3,11,37
10,Success,45,30,0,18,27
10,Success,45,19,3,19,26
10,Success,48,32,0,12,36
10,Success,45,34,0,13,32
10,Success,46,28,6,9,37
10,Success,52,22,5,11,41
10,Success,45,26,5,13,32
10,Success,46,30,0,13,33
10,Success,42,30,6,14,28
10,Success,47,28,0,17,30
10,Success,45,29,0,14,31
10,Success,50,28,0,10,40
10,Success,55,27,0,7,48
10,Success,37,31,8,14,23
10,Success,52,27,1,10,42
10,Success,54,24,2,7,47
10,Success,39,43,0,9,30
10,Success,55,25,0,13,42
10,Success,52,20,0,13,39
10,Success,43,26,5,17,26
10,Success,55,30,0,6,49
10,Success,55,24,0,11,44
10,Success,43,29,5,15,28
10,Success,41,25,8,18,23
10,Success,46,33,0,14,32
10,Success,49,22,3,14,35
10,Success,47,28,0,14,33
10,Success,46,23,9,14,32
10,Success,47,27,4,15,32
10,Success,46,30,1,13,33
10,Success,51,27,0,9,42
10,Success,52,23,0,10,42
10,Success,42,37,0,13,29
10,Success,52,28,1,9,43
10,Success,54,27,0,9,45
10,Success,60,16,2,10,50
10,Success,46,33,0,10,36
10,Success,49,30,0,12,37
10,Success,49,25,10,10,39
10,Success,47,24,10,13,34
10,Success,52,28,1,8,44
10,Success,45,30,0,15,30
10,Success,47,26,7,11,36
10,Success,48,24,0,19,29
10,Success,53,22,0,14,39
10,Success,40,32,0,20,20
10,Success,43,32,4,13,30
10,Success,50,25,0,12,38
10,Success,45,34,0,9,36
10,Success,53,19,3,13,40
10,Success,39,37,0,17,22
10,Success,53,21,0,14,39
10,Success,52,22,1,14,38
10,Success,51,25,0,11,40
10,Success,40,37,0,15,25
10,Success,49,27,0,12,37
10,Success,46,33,0,12,34
10,Success,51,32,0,6,45
10,Success,49,26,0,13,36
10,Success,47,39,0,5,42
10,Success,53,22,0,11,42
10,Success,40,35,5,11,29
10,Success,54,21,6,15,39
10,Success,45,28,10,9,36
10,Success,50,24,6,10,40
10,Success,39,32,9,14,25
10,Success,46,28,1,13,33
10,Success,42,25,6,14,28
10,Success,48,29,0,17,31
10,Success,51,24,0,11,40
10,Success,49,26,0,13,36
10,Success,53,23,0,12,41
10,Success,38,27,9,17,21
10,Success,47,19,0,19,28
10,Success,44,31,6,12,32
10,Success,56,18,3,11,45
10,Success,51,22,0,11,40
10,Success,48,23,0,14,34
10,Success,45,27,7,17,28
10,Success,41,31,0,15,26
10,Success,51,33,0,9,42
10,Success,57,19,0,14,43
10,Success,56,23,8,6,50
10,Success,59,19,6,8,51
10,Success,53,18,4,13,40
10,Success,54,21,2,10,44
10,Success,44,30,0,14,30
10,Success,50,18,3,18,32
10,Success,46,28,0,14,32
10,Success,45,34,0,14,31
10,Success,51,29,0,10,41
10,Success,53,20,2,13,40
10,Success,48,22,2,13,35
10,Success,46,30,0,13,33
10,Success,56,23,0,13,43
10,Success,49,23,0,13,36
10,Success,49,20,7,13,36
10,Success,52,27,0,8,44
10,Success,43,28,9,13,30
10,Success,50,20,0,18,32
10,Success,55,20,1,10,45
10,Success,47,29,0,12,35
10,Success,42,35,0,17,25
10,Success,51,26,0,14,37
10,Success,45,26,6,14,31
10,Success,47,21,4,17,30
10,Success,50,29,0,12,38
10,Success,51,22,0,14,37
10,Success,52,26,2,12,40
10,Success,42,35,0,11,31
10,Success,39,34,6,13,26
10,Success,45,36,0,12,33
10,Success,43,29,0,18,25
10,Success,55,21,1,9,46
10,Success,43,27,4,17,26
10,Success,35,33,0,16,19
10,Success,47,29,1,10,37
10,Success,49,25,0,14,35
10,Success,53,28,0,6,47
10,Success,46,31,7,7,39
10,Success,37,32,0,22,15
10,Success,46,35,0,8,38
10,Success,51,21,3,12,39
10,Success,46,33,2,12,34
10,Success,46,19,0,19,27
10,Success,43,36,0,11,32
10,Success,45,34,0,10,35
10,Success,49,27,0,9,40
10,Success,44,31,7,11,33
10,Success,45,31,7,7,38
10,Success,39,38,0,15,24
10,Success,45,19,5,21,24
10,Success,46,30,0,15,31
10,Success,46,33,0,12,34
10,Success,48,24,1,16,32
10,Success,47,25,2,13,34
10,Success,45,30,0,16,29
10,Success,50,25,6,8,42
10,Success,49,24,4,10,39
10,Success,50,20,10,12,38
10,Success,46,22,2,18,28
10,Success,47,24,0,15,32
10,Success,44,28,7,14,30
10,Success,36,42,0,15,21
10,Success,50,21,4,14,36
10,Success,45,23,2,19,26
10,Success,41,28,5,17,24
10,Success,58,15,1,11,47
10,Success,46,27,2,13,33
10,Success,46,38,0,5,41
10,Success,43,30,10,10,33
10,Success,60,21,1,6,54
10,Success,46,30,6,13,33
10,Success,57,20,2,10,47
10,Success,47,25,2,15,32
10,Success,44,35,0,11,33
10,Success,46,23,0,19,27
10,Success,48,24,0,16,32
10,Success,51,28,1,10,41
10,Success,37,38,0,13,24
10,Success,51,20,3,13,38
10,Success,47,26,0,15,32
10,Success,52,15,3,17,35
10,Success,55,22,1,10,45
10,Success,46,26,0,16,30
10,Success,46,22,6,15,31
10,Success,45,26,5,11,34
10,Success,46,31,0,12,34
10,Success,40,35,0,18,22
10,Success,42,28,5,17,25
10,Success,49,26,0,12,37
10,Success,58,21,1,11,47
10,Success,46,28,0,15,31
10,Success,57,25,0,9,48
10,Success,52,18,1,15,37
10,Success,45,32,0,12,33
10,Success,45,25,14,10,35
10,Success,43,26,1,17,26
10,Success,41,25,6,17,24
10,Success,48,22,8,16,32
10,Success,47,27,0,17,30
10,Success,47,32,0,10,37
10,Success,47,22,0,18,29
10,Success,57,16,2,11,46
10,Success,54,13,1,17,37
10,Success,45,30,0,13,32
10,Success,49,32,0,9,40
10,Success,48,25,0,15,33
10,Success,55,21,2,12,43
10,Success,46,30,1,14,32
10,Success,53,30,0,9,44
10,Success,53,29,0,9,44
10,Success,44,28,0,18,26
10,Success,45,27,5,12,33
10,Success,46,34,0,12,34
10,Success,50,25,0,12,38
10,Success,44,30,4,8,36
10,Success,45,25,2,15,30
10,Success,53,22,2,10,43
10,Success,37,24,16,16,21
10,Success,45,25,7,9,36
10,Success,46,28,0,13,33
10,Success,53,24,7,8,45
10,Success,51,23,0,18,33
10,Success,46,28,6,10,36
10,Success,52,29,0,9,43
10,Success,54,23,0,14,40
10,Success,46,28,3,14,32
10,Success,53,24,3,11,42
10,Success,45,26,6,12,33
10,Success,54,16,10,9,45
10,Success,50,26,0,11,39
10,Success,48,26,5,11,37
10,Success,53,15,3,14,39
10,Success,46,33,3,7,39
10,Success,49,32,0,7,42
10,Success,54,28,0,7,47
10,Success,48,31,0,9,39
10,Success,48,26,0,15,33
10,Success,46,33,0,14,32
10,Success,46,29,0,14,32
10,Success,39,33,4,17,22
10,Success,52,25,0,13,39
10,Success,49,24,0,16,33
10,Success,48,25,5,13,35
10,Success,46,31,0,8,38
10,Success,41,29,0,21,20
10,Success,47,23,0,13,34
10,Success,43,34,0,14,29
10,Success,48,30,0,10,38
10,Success,51,22,1,11,40
10,Success,51,25,2,12,39
10,Success,42,32,8,12,30
10,Success,54,22,2,9,45
10,Success,47,22,8,12,35
10,Success,41,27,6,14,27
10,Success,43,33,0,15,28
10,Success,47,32,3,10,37
10,Success,53,26,0,12,41
10,Success,44,37,0,9,35
10,Success,49,24,0,13,36
10,Success,47,23,6,15,32
10,Success,48,28,0,10,38
10,Success,44,34,0,8,36
10,Success,50,27,1,8,42
10,Success,46,25,3,14,32
10,Success,36,34,0,17,19
10,Success,48,36,0,8,40
10,Success,52,25,0,14,38
10,Success,48,26,0,12,36
10,Success,43,36,0,11,32
10,Success,51,24,0,18,33
10,Success,45,29,6,11,34
10,Success,48,20,6,14,34
10,Success,48,22,2,15,33
10,Success,50,29,5,8,42
10,Success,53,28,0,10,43
10,Success,50,36,0,8,42
10,Success,54,19,3,10,44
10,Success,42,38,0,10,32
10,Success,48,33,0,11,37
10,Success,49,30,2,10,39
10,Success,47,25,0,18,29
10,Success,47,33,0,12,35
10,Success,42,32,0,15,27
10,Success,48,24,2,15,33
10,Success,43,30,0,19,24
10,Success,45,32,0,13,32
10,Success,49,31,0,11,38
10,Success,52,21,3,11,41
10,Success,42,34,0,10,32
10,Success,50,27,0,9,41
10,Success,48,27,8,8,40
10,Success,45,26,7,11,34
10,Success,51,26,1,13,38
10,Success,53,23,5,8,45
10,Success,42,33,0,15,27
10,Success,48,29,0,16,32
10,Success,50,32,4,7,43
10,Success,44,28,5,14,30
10,Success,45,36,0,10,35
10,Success,47,31,0,15,32
10,Success,41,23,7,20,21
10,Success,51,18,0,18,33
10,Success,44,33,6,8,36
10,Success,53,24,1,13,40
10,Success,45,29,3,10,35
10,Success,49,29,0,8,41
10,Success,48,23,3,18,30
10,Success,45,31,0,11,34
10,Success,46,28,0,16,30
10,Success,57,23,1,7,50
10,Success,50,24,4,11,39
10,Success,45,25,4,15,30
10,Success,53,28,0,11,42
10,Success,47,26,3,14,33
10,Success,49,27,0,14,35
10,Success,55,27,1,8,47
10,Success,48,31,0,12,36
10,Success,56,16,2,11,45
10,Success,48,21,0,20,28
10,Success,48,25,0,13,35
10,Success,48,31,4,4,44
10,Success,41,22,9,17,24
10,Success,43,31,3,12,31
10,Success,47,25,1,13,34
10,Success,46,24,4,14,32
10,Success,49,24,3,12,37
10,Success,53,26,0,12,41
10,Success,49,25,0,13,36
10,Success,45,25,7,13,32
10,Success,49,23,2,15,34
10,Success,52,18,1,15,37
10,Success,49,18,11,13,36
10,Success,51,30,0,11,40
10,Success,44,29,0,13,31
10,Success,49,30,0,8,41
10,Success,39,36,0,15,24
10,Success,50,28,0,13,37
10,Success,51,28,0,13,38
10,Success,47,31,0,12,35
10,Success,52,25,0,10,42
10,Success,49,26,0,9,40
10,Success,48,31,0,12,36
10,Success,46,35,0,12,34
10,Success,40,30,9,13,27
10,Success,53,25,0,12,41
10,Success,46,27,0,15,31
10,Success,53,24,0,10,43
10,Success,45,33,4,7,38
10,Success,52,24,0,12,40
10,Success,49,31,0,14,35
10,Success,46,22,4,17,29
10,Success,53,24,1,8,45
10,Success,47,23,7,15,32
10,Success,50,23,0,15,35
10,Success,47,31,0,9,38
10,Success,43,33,0,15,28
10,Success,43,30,0,18,25
10,Success,42,36,0,14,28
10,Success,40,40,0,16,24
10,Success,55,21,0,15,40
10,Success,49,22,7,11,38
10,Success,51,25,0,12,39
10,Success,48,25,2,13,35
10,Success,49,24,0,15,34
10,Success,44,23,0,18,26
10,Success,45,18,7,18,27
10,Success,47,29,5,9,38
10,Success,41,43,0,9,32
10,Success,45,29,0,16,29
10,Success,51,22,6,10,41
10,Success,46,29,0,18,28
10,Success,58,24,0,8,50
10,Success,40,31,8,14,26
10,Success,59,23,1,8,51
10,Success,52,22,0,12,40
10,Success,49,24,0,13,36
10,Success,51,26,0,11,40
10,Success,40,28,5,21,19
10,Success,46,25,0,17,29
10,Success,45,29,0,14,31
10,Success,48,32,0,10,38
10,Success,46,23,3,17,29
10,Success,40,36,0,10,30
10,Success,54,20,1,10,44
10,Success,49,29,1,12,37
10,Success,38,32,10,12,26
10,Success,42,41,0,13,29
10,Success,49,21,5,12,37
10,Success,48,27,1,11,37
10,Success,48,24,0,13,35
10,Success,47,23,5,12,35
10,Success,50,21,0,17,33
10,Success,47,25,7,12,35
10,Success,53,25,0,10,43
10,Success,48,25,0,16,32
10,Success,40,29,5,15,25
10,Success,43,31,0,12,31
10,Success,49,31,0,8,41
10,Success,48,25,0,18,30
10,Success,58,22,0,6,52
10,Success,46,30,3,10,36
10,Success,41,30,0,15,26
10,Success,41,31,11,12,29
10,Success,47,33,0,11,36
10,Success,47,29,3,9,38
10,Success,49,27,2,13,36
10,Success,53,30,0,7,46
10,Success,50,28,0,10,40
10,Success,47,26,6,11,36
10,Success,48,25,2,16,32
10,Success,47,24,6,15,32
10,Success,38,31,8,15,23
10,Success,49,24,0,13,36
10,Success,36,40,0,16,20
10,Success,54,23,5,9,45
10,Success,49,35,0,9,40
10,Success,43,32,0,16,27
10,Success,51,22,0,16,35
10,Success,50,25,4,11,39
10,Success,43,24,8,12,31
10,Success,43,33,3,13,30
10,Success,33,37,8,15,18
10,Success,41,44,0,10,31
10,Success,51,25,1,10,41
10,Success,51,16,8,11,40
10,Success,44,26,3,16,28
10,Success,45,26,0,18,27
10,Success,50,26,0,10,40
10,Success,45,31,0,14,31
10,Success,51,25,0,11,40
10,Success,52,20,0,14,38
10,Success,46,33,0,8,38
10,Success,46,26,0,16,30
10,Success,46,24,6,14,32
10,Success,52,31,0,10,42
10,Success,55,22,0,12,43
10,Success,49,24,8,8,41
10,Success,50,22,0,15,35
10,Success,44,25,4,15,29
10,Success,54,18,4,14,40
10,Success,51,23,1,10,41
10,Success,52,20,0,14,38
10,Success,45,28,1,13,32
10,Success,53,24,1,13,40
10,Success,54,14,1,17,37
10,Success,42,34,0,14,28
10,Success,53,26,0,10,43
10,Success,49,24,0,13,36
10,Success,40,29,12,12,28
10,Success,51,24,0,9,42
10,Success,43,29,0,20,23
10,Success,50,31,0,10,40
10,Success,43,33,0,17,26
10,Success,51,26,4,8,43
10,Success,48,22,2,17,31
10,Success,39,32,0,21,18
10,Success,46,34,2,8,38
10,Success,47,24,2,14,33
10,Success,46,27,8,9,37
10,Success,54,20,6,9,45
10,Success,51,28,0,12,39
10,Success,56,21,3,9,47
10,Success,54,19,0,16,38
10,Success,51,28,0,7,44
10,Success,46,32,0,12,34
10,Success,49,29,1,10,39
10,Success,47,26,7,9,38
10,Success,46,33,0,10,36
10,Success,44,32,0,13,31
10,Success,44,25,14,7,37
10,Success,62,21,0,7,55
10,Success,44,26,2,17,27
10,Success,51,27,0,8,43
10,Success,50,31,0,7,43
10,Success,50,21,0,19,31
10,Success,56,19,6,10,46
10,Success,46,21,9,11,35
10,Success,39,26,3,20,19
10,Success,53,27,0,14,39
10,Success,44,27,0,15,29
10,Success,49,27,1,11,38
10,Success,48,24,1,16,32
10,Success,54,16,5,13,41
10,Success,41,35,0,15,26
10,Success,37,44,0,12,25
10,Success,50,26,1,13,37
10,Success,44,29,0,17,27
10,Success,51,22,0,15,36
10,Success,52,24,3,15,37
10,Success,50,33,0,9,41
10,Success,48,25,1,15,33
10,Success,49,37,0,8,41
10,Success,46,26,2,16,30
10,Success,50,31,0,6,44
10,Success,47,20,5,17,30
10,Success,52,27,0,11,41
10,Success,39,33,0,17,22
10,Success,59,22,7,7,52
10,Success,46,26,0,15,31
10,Success,46,30,0,12,34
10,Success,50,37,0,5,45
10,Success,56,20,0,11,45
10,Success,43,28,0,18,25
10,Success,47,35,0,7,40
10,Success,46,29,1,12,34
10,Success,56,18,2,13,43
10,Success,48,28,3,8,40
10,Success,45,26,0,15,30
10,Success,48,28,0,12,36
10,Success,42,32,0,16,26
10,Success,48,34,0,11,37
10,Success,45,23,3,17,28
10,Success,48,28,0,11,37
10,Success,47,27,5,12,35
10,Success,51,24,0,12,39
10,Success,49,27,0,17,32
10,Success,49,29,0,10,39
10,Success,50,32,0,8,42
10,Success,43,37,0,14,29
10,Success,54,18,1,12,42
10,Success,52,23,0,15,37
10,Success,55,22,0,10,45
10,Success,50,23,5,13,37
10,Success,52,24,1,12,40
10,Success,46,35,0,10,36
10,Success,51,26,3,9,42
10,Success,54,22,10,7,47
10,Success,49,22,8,11,38
10,Success,44,30,4,12,32
10,Success,45,27,9,6,39
10,Success,52,24,0,14,38
10,Success,40,36,0,16,24
10,Success,41,33,0,12,29
10,Success,46,19,0,23,23
10,Success,47,23,4,14,33
10,Success,44,31,0,11,33
10,Success,51,23,0,16,35
10,Success,53,24,0,11,42
10,Success,49,27,0,13,36
10,Success,44,39,0,9,35
10,Success,48,24,0,13,35
10,Success,46,37,0,11,35
10,Success,43,21,4,24,19
10,Success,42,29,0,17,25
10,Success,43,31,0,17,26
10,Success,49,22,0,16,33
10,Success,55,26,0,6,49
10,Success,46,32,0,11,35
10,Success,47,26,0,14,33
10,Success,52,24,3,13,39
10,Success,37,34,0,16,21
10,Success,48,29,2,10,38
10,Success,44,33,0,14,30
10,Success,47,30,0,11,36
10,Success,46,28,0,17,29
10,Success,40,32,10,10,30
10,Success,62,19,0,9,53
10,Success,51,24,2,12,39
10,Success,45,30,7,9,36
10,Success,45,34,4,8,37
10,Success,44,31,4,13,31
10,Success,41,30,11,12,29
10,Success,42,27,6,19,23
10,Success,47,27,0,12,35
10,Success,55,20,2,12,43
10,Success,45,24,7,17,28
10,Success,48,27,0,15,33
10,Success,45,32,0,11,34
10,Success,41,40,0,9,32
10,Success,49,30,0,12,37
10,Success,51,25,0,10,41
10,Success,45,33,0,15,30
10,Success,39,29,0,21,18
10,Success,47,21,5,14,33
10,Success,52,28,0,10,42
10,Success,51,27,0,9,42
10,Success,52,28,0,10,42
10,Success,46,24,6,13,33
10,Success,46,34,0,12,34
10,Success,51,28,2,9,42
10,Success,45,32,0,11,34
10,Success,43,25,4,14,29
10,Success,52,22,3,9,43
10,Success,45,24,12,9,36
10,Success,48,20,10,12,36
10,Success,51,26,4,9,42
10,Success,47,22,9,12,35
10,Success,43,34,0,15,28
10,Success,55,23,0,11,44
10,Success,52,21,2,15,37
10,Success,58,18,6,8,50
10,Success,48,28,6,8,40
10,Success,48,24,0,13,35
10,Success,41,31,11,10,31
10,Success,47,21,7,12,35
10,Success,50,25,7,11,39
10,Success,46,22,0,17,29
10,Success,50,28,0,12,38
10,Success,53,28,0,8,45
10,Success,49,26,0,13,36
10,Success,44,27,4,9,35
10,Success,55,26,0,4,51
10,Success,43,34,0,12,31
10,Success,44,14,15,22,22
10,Success,47,25,4,18,29
10,Success,44,30,2,14,30
10,Success,41,31,8,16,25
10,Success,52,28,0,8,44
10,Success,49,24,0,15,34
10,Success,42,31,5,11,31
10,Success,44,31,4,14,30
10,Success,52,24,3,13,39
10,Success,52,31,0,8,44
10,Success,37,33,0,17,20
10,Success,46,24,6,15,31
10,Success,48,25,11,10,38
10,Success,48,28,3,10,38
10,Success,53,28,1,9,44
10,Success,50,25,6,10,40
10,Success,44,37,0,12,32
10,Success,44,29,6,10,34
10,Success,47,36,0,8,39
10,Success,54,24,0,11,43
10,Success,43,31,2,13,30
10,Success,58,13,4,14,44
10,Success,47,30,3,9,38
10,Success,55,29,0,7,48
10,Success,50,27,0,11,39
10,Success,53,17,0,15,38
10,Success,51,30,0,11,40
10,Success,47,31,0,12,35
10,Success,47,26,5,12,35
10,Success,42,31,8,10,32
10,Success,53,22,7,10,43
10,Success,49,27,3,13,36
10,Success,52,31,0,9,43
10,Success,46,30,0,10,36
10,Success,41,35,0,16,25
10,Success,48,20,6,15,33
10,Success,49,21,4,14,35
10,Success,50,29,0,14,36
10,Success,49,28,3,9,40
10,Success,43,32,2,14,29
10,Success,53,28,0,8,45
10,Success,55,25,0,8,47
10,Success,56,26,0,11,45
10,Success,49,30,0,10,39
10,Success,46,26,0,16,30
10,Success,53,30,0,5,48
10,Success,42,32,3,12,30
10,Success,54,23,0,14,40
10,Success,44,40,0,10,34
10,Success,43,23,12,16,27
10,Success,48,27,1,16,32
10,Success,49,28,5,10,39
10,Success,39,28,0,21,18
10,Success,55,15,2,17,38
10,Success,52,24,5,9,43
10,Success,38,33,12,11,27
10,Success,52,21,5,11,41
10,Success,59,22,0,10,49
10,Success,48,29,6,9,39
10,Success,51,22,3,14,37
10,Success,43,23,14,13,30
10,Success,51,20,0,16,35
10,Success,52,25,0,13,39
10,Success,54,23,0,14,40
10,Success,49,24,2,14,35
10,Success,45,32,0,11,34
10,Success,51,24,0,19,32
10,Success,50,32,0,11,39
10,Success,58,20,0,9,49
10,Success,50,24,5,12,38
10,Success,47,27,0,17,30
10,Success,52,28,0,8,44
10,Success,49,30,0,11,38
10,Success,43,36,0,9,34
10,Success,48,24,0,17,31
10,Success,44,29,0,11,33
10,Success,51,23,0,13,38
10,Success,48,33,0,11,37
10,Success,47,22,0,16,31
10,Success,55,22,2,8,47
10,Success,45,30,0,11,34
10,Success,45,27,2,16,29
10,Success,56,19,0,12,44
10,Success,43,33,0,15,28
10,Success,46,31,0,12,34
10,Success,43,29,0,13,30
10,Success,45,36,0,11,34
10,Success,40,31,0,16,24
10,Success,43,25,3,18,25
10,Success,50,28,0,10,40
10,Success,48,23,4,11,37
10,Success,48,26,1,12,36
10,Success,50,30,0,11,39
10,Success,53,26,0,13,40
10,Success,47,24,1,13,34
10,Success,46,28,0,13,33
10,Success,48,29,0,10,38
10,Success,50,24,0,14,36
10,Success,48,32,3,8,40
10,Success,44,36,0,10,34
10,Success,53,30,0,10,43
10,Success,50,36,0,7,43
10,Success,49,25,0,11,38
10,Success,51,25,1,14,37
10,Success,50,25,1,11,39
10,Success,49,23,3,12,37
10,Success,50,23,0,14,36
10,Success,52,21,0,17,35
10,Success,51,28,0,11,40
10,Success,47,30,1,12,35
10,Success,46,29,6,9,37
10,Success,49,26,0,11,38
10,Success,45,29,1,13,32
10,Success,45,28,0,18,27
10,Success,48,27,2,14,34
10,Success,51,30,0,7,44
10,Success,53,20,4,11,42
10,Success,56,22,0,10,46
10,Success,45,36,0,11,34
10,Success,46,29,3,12,34
10,Success,57,19,0,10,47
10,Success,49,23,4,14,35
10,Success,46,33,2,9,37
10,Success,45,35,8,6,39
10,Success,43,30,0,18,25
10,Success,48,28,4,14,34
10,Success,51,18,4,16,35
10,Success,53,21,0,16,37
10,Success,57,20,0,9,48
10,Success,48,25,3,12,36
10,Success,43,25,4,17,26
10,Success,52,18,10,11,41
10,Success,50,22,0,18,32
10,Success,45,34,0,12,33
10,Success,48,22,0,12,36
10,Success,43,26,0,17,26
10,Success,44,34,0,15,29
10,Success,47,19,6,20,27
10,Success,58,20,9,5,53
10,Success,46,31,0,8,38
10,Success,50,19,6,14,36
10,Success,47,27,4,9,38
10,Success,52,31,0,9,43
10,Success,52,17,1,15,37
10,Success,47,31,2,8,39
10,Success,53,28,0,9,44
10,Success,51,19,0,21,30
10,Success,45,27,2,9,36
10,Success,46,26,7,13,33
10,Success,49,24,3,15,34
10,Success,47,22,4,16,31
10,Success,45,30,0,13,32
10,Success,49,28,0,13,36
10,Success,57,19,2,10,47
10,Success,35,48,0,10,25
10,Success,50,26,0,12,38
10,Success,38,34,0,18,20
10,Success,48,23,8,12,36
10,Success,50,23,0,15,35
10,Success,57,20,5,9,48
10,Success,53,21,2,14,39
10,Success,53,22,3,10,43
10,Success,47,29,0,11,36
10,Success,45,29,0,17,28
10,Success,38,42,0,14,24
10,Success,47,23,1,14,33
10,Success,49,30,0,7,42
10,Success,50,24,0,15,35
10,Success,49,19,0,22,27
10,Success,44,29,2,13,31
10,Success,50,20,6,15,35
10,Success,52,29,0,11,41
10,Success,46,31,0,14,32
10,Success,50,24,0,13,37
10,Success,50,26,1,11,39
10,Success,50,16,0,22,28
10,Success,46,26,10,9,37
10,Success,60,23,1,5,55
10,Success,49,28,1,12,37
10,Success,56,21,1,10,46
10,Success,48,23,1,13,35
10,Success,47,24,1,13,34
10,Success,49,25,2,14,35
10,Success,53,30,0,9,44
10,Success,49,29,0,13,36
10,Success,52,22,0,17,35
10,Success,51,23,0,11,40
10,Success,50,23,4,11,39
10,Success,51,23,1,10,41
10,Success,43,35,0,10,33
10,Success,51,22,1,14,37
10,Success,51,28,0,10,41
10,Success,46,18,8,14,32
10,Success,60,19,6,8,52
10,Success,43,38,0,8,35
10,Success,34,44,0,13,21
10,Success,50,22,0,15,35
10,Success,53,25,0,12,41
10,Success,53,25,0,11,42
10,Success,42,19,8,20,22
10,Success,49,25,0,14,35
10,Success,47,19,1,21,26
10,Success,56,23,0,11,45
10,Success,51,18,3,12,39
10,Success,51,23,8,9,42
10,Success,42,29,5,16,26
10,Success,49,25,1,9,40
10,Success,48,28,4,12,36
10,Success,49,22,5,13,36
10,Success,44,25,0,20,24
10,Success,48,28,0,13,35
10,Success,53,24,0,13,40
10,Success,54,22,0,3,51
10,Success,51,24,5,15,36
10,Success,39,36,0,16,23
10,Success,45,31,0,13,32
10,Success,53,32,0,6,47
10,Success,54,15,0,13,41
10,Success,52,20,0,16,36
10,Success,48,19,7,16,32
10,Success,53,14,2,13,40
10,Success,44,31,3,12,32
10,Success,44,31,0,12,32
10,Success,54,22,3,9,45
10,Success,51,24,0,13,38
10,Success,46,27,2,14,32
10,Success,50,26,3,12,38
10,Success,47,30,2,8,39
10,Success,45,29,3,11,34
10,Success,56,25,5,6,50
10,Success,39,42,0,11,28
10,Success,54,19,11,9,45
10,Success,45,31,0,12,33
10,Success,43,32,0,14,29
10,Success,41,38,4,11,30
10,Success,54,20,1,10,44
10,Success,45,26,0,16,29
10,Success,50,31,1,8,42
10,Success,52,29,0,6,46
10,Success,53,22,0,13,40
10,Success,51,26,0,13,38
10,Success,40,34,0,13,27
10,Success,49,30,1,10,39
10,Success,51,25,8,8,43
10,Success,46,24,9,11,35
10,Success,44,25,7,13,31
10,Success,57,22,0,10,47
10,Success,49,32,0,5,44
10,Success,50,26,0,19,31
10,Success,51,30,0,9,42
10,Success,47,24,0,18,29
10,Success,44,33,0,12,32
10,Success,48,26,0,15,33
10,Success,42,29,0,12,30
10,Success,45,27,4,14,31
10,Success,45,37,0,11,34
10,Success,38,41,0,14,24
10,Success,51,26,0,11,40
10,Success,49,25,0,17,32
10,Success,56,24,0,11,45
10,Success,50,21,1,18,32
10,Success,52,23,5,7,45
10,Success,53,25,4,6,47
10,Success,48,27,0,14,34
10,Success,49,27,0,13,36
10,Success,44,18,6,19,25
10,Success,57,23,0,10,47
10,Success,48,26,3,9,39
10,Success,42,37,0,9,33
10,Success,52,20,4,15,37
10,Success,54,24,1,7,47
10,Success,46,28,0,15,31
10,Success,52,30,0,8,44
10,Success,46,33,0,11,35
10,Success,52,24,0,12,40
10,Success,46,24,7,14,32
10,Success,54,23,0,11,43
10,Success,53,28,0,7,46
10,Success,40,37,0,6,34
10,Success,47,34,0,11,36
10,Success,40,33,0,16,24
10,Success,50,26,0,11,39
10,Success,46,27,0,13,33
10,Success,41,33,1,17,24
10,Success,49,26,9,10,39
10,Success,54,28,0,7,47
10,Success,48,20,1,15,33
10,Success,52,28,0,8,44
10,Success,51,24,3,9,42
10,Success,52,27,0,13,39
10,Success,54,20,5,10,44
10,Success,39,38,0,14,25
10,Success,50,21,5,12,38
10,Success,41,33,1,14,27
10,Success,47,35,0,12,35
10,Success,50,29,0,14,36
10,Success,50,22,1,15,35
10,Success,44,40,0,11,33
10,Success,46,24,6,14,32
10,Success,50,25,4,13,37
10,Success,44,28,10,11,33
10,Success,57,20,0,13,44
10,Success,56,19,0,13,43
10,Success,47,24,0,16,31
10,Success,56,25,2,9,47
10,Success,49,24,2,15,34
10,Success,41,26,7,15,26
10,Success,40,35,0,13,27
10,Success,48,29,3,12,36
10,Success,53,27,0,11,42
10,Success,42,24,9,16,26
10,Success,47,26,3,13,34
10,Success,42,34,0,15,27
10,Success,52,24,1,14,38
10,Success,47,28,0,15,32
10,Success,49,25,0,14,35
10,Success,62,17,0,8,54
10,Success,48,29,1,8,40
10,Success,46,25,4,12,34
10,Success,50,25,6,12,38
10,Success,48,36,0,6,42
10,Success,47,30,0,9,38
10,Success,56,26,0,7,49
10,Success,46,22,5,14,32
10,Success,53,28,2,9,44
10,Success,44,19,0,20,24
10,Success,43,35,0,12,31
10,Success,50,22,6,12,38
10,Success,52,33,0,7,45
10,Success,53,20,0,16,37
10,Success,52,25,0,11,41
10,Success,43,28,0,19,24
10,Success,35,42,0,14,21
10,Success,51,24,0,14,37
10,Success,45,24,4,16,29
10,Success,39,28,13,16,23
10,Success,54,21,3,12,42
10,Success,40,34,4,12,28
10,Success,47,27,0,15,32
10,Success,43,35,0,12,31
10,Success,53,24,4,10,43
10,Success,48,24,0,17,31
10,Success,48,27,1,12,36
10,Success,49,27,0,10,39
10,Success,49,23,4,13,36
10,Success,51,26,0,11,40
10,Success,48,24,4,12,36
10,Success,50,24,0,16,34
10,Success,55,21,2,8,47
10,Success,56,20,3,9,47
10,Success,49,30,0,10,39
10,Success,46,35,0,12,34
10,Success,50,29,0,10,40
10,Success,45,41,0,8,37
10,Success,47,23,0,16,31
10,Success,50,20,0,13,37
10,Success,49,26,0,11,38
10,Success,47,21,4,17,30
10,Success,53,24,4,7,46
10,Success,62,19,0,9,53
10,Success,44,32,0,15,29
10,Success,46,29,5,15,31
10,Success,41,25,3,22,19
10,Success,54,25,0,8,46
10,Success,50,30,0,12,38
10,Success,54,24,0,10,44
10,Success,45,33,1,9,36
10,Success,48,26,4,9,39
10,Success,49,30,0,10,39
10,Success,50,25,0,18,32
10,Success,45,31,0,11,34
10,Success,51,26,2,10,41
10,Success,50,26,0,15,35
10,Success,43,34,1,13,30
10,Success,55,18,0,16,39
10,Success,48,24,1,18,30
10,Success,52,27,0,12,40
10,Success,45,25,6,15,30
10,Success,46,30,0,11,35
10,Success,42,27,4,16,26
10,Success,48,31,0,10,38
10,Success,51,28,0,10,41
10,Success,47,27,0,16,31
10,Success,40,23,8,16,24
10,Success,54,23,6,6,48
10,Success,41,29,5,12,29
10,Success,50,18,8,13,37
10,Success,39,45,0,10,29
10,Success,46,27,4,14,32
10,Success,45,28,2,14,31
10,Success,49,25,0,16,33
10,Success,41,34,0,19,22
10,Success,54,24,0,11,43
10,Success,47,28,0,12,35
10,Success,49,28,0,15,34
10,Success,44,30,0,15,29
10,Success,50,30,0,7,43
10,Success,50,29,0,13,37
10,Success,44,36,0,11,33
10,Success,46,27,3,10,36
10,Success,47,25,3,17,30
10,Success,58,17,0,11,47
10,Success,44,36,0,9,35
10,Success,41,31,0,15,26
10,Success,46,31,5,10,36
10,Success,52,28,0,8,44
10,Success,51,26,3,13,38
10,Success,46,28,0,15,31
10,Success,47,22,0,17,30
10,Success,53,28,2,8,45
10,Success,42,32,0,16,26
10,Success,46,25,6,15,31
10,Success,49,26,0,11,38
10,Success,40,26,10,14,26
10,Success,47,30,0,13,34
10,Success,57,19,1,13,44
10,Success,45,31,0,14,31
10,Success,48,22,3,15,33
10,Success,52,28,0,8,44
10,Success,43,35,0,11,32
10,Success,49,20,1,15,34
10,Success,51,27,0,16,35
10,Success,52,26,1,14,38
10,Success,50,25,0,14,36
10,Success,48,32,2,8,40
10,Success,49,30,0,13,36
10,Success,42,33,0,11,31
10,Success,47,25,7,14,33
10,Success,44,23,3,17,27
10,Success,53,20,5,10,43
10,Success,50,30,0,8,42
10,Success,53,15,4,16,37
10,Success,53,25,0,12,41
10,Success,51,29,0,8,43
10,Success,51,25,0,11,40
10,Success,52,27,4,7,45
10,Success,53,22,1,10,43
10,Success,47,30,0,10,37
10,Success,51,30,0,10,41
10,Success,52,24,0,10,42
10,Success,45,31,6,12,33
10,Success,54,20,0,16,38
10,Success,42,30,5,13,29
10,Success,45,32,0,13,32
10,Success,50,26,5,7,43
10,Success,40,34,0,18,22
10,Success,36,36,1,16,20
10,Success,55,24,2,9,46
10,Success,48,31,0,12,36
10,Success,48,30,0,14,34
10,Success,45,26,0,17,28
10,Success,47,30,8,9,38
10,Success,52,20,3,10,42
10,Success,51,24,1,16,35
10,Success,47,35,0,10,37
10,Success,52,25,5,11,41
10,Success,54,23,0,11,43
10,Success,42,31,0,18,24
10,Success,46,24,6,11,35
10,Success,50,24,0,10,40
10,Success,44,36,3,8,36
10,Success,44,26,6,16,28
10,Success,46,30,0,12,34
10,Success,54,24,5,9,45
10,Success,47,23,1,14,33
10,Success,46,39,0,11,35
10,Success,52,24,0,11,41
10,Success,48,24,9,13,35
10,Success,42,30,6,15,27
10,Success,48,29,5,10,38
10,Success,52,25,0,13,39
10,Success,48,26,10,9,39
10,Success,60,19,2,7,53
10,Success,53,21,1,13,40
10,Success,50,29,0,14,36
10,Success,45,30,0,17,28
10,Success,43,34,0,15,28
10,Success,52,24,0,14,38
10,Success,43,30,1,14,29
10,Success,49,27,0,15,34
10,Success,45,27,1,14,31
10,Success,51,26,3,9,42
10,Success,46,32,0,12,34
10,Success,54,26,0,8,46
10,Success,49,27,0,9,40
10,Success,51,27,8,8,43
10,Success,48,27,0,13,35
10,Success,38,30,2,20,18
10,Success,49,28,0,10,39
10,Success,45,22,0,22,23
10,Success,47,32,0,10,37
10,Success,46,28,0,14,32
10,Success,52,20,3,14,38
10,Success,46,24,3,14,32
10,Success,46,35,1,7,39
10,Success,48,28,0,11,37
10,Success,46,25,1,13,33
10,Success,48,30,2,14,34
10,Success,59,17,1,13,46
10,Success,42,25,8,13,29
10,Success,48,21,6,15,33
10,Success,53,26,0,11,42
10,Success,44,24,6,15,29
10,Success,44,25,4,17,27
10,Success,43,23,7,18,25
10,Success,43,25,9,12,31
10,Success,54,26,0,11,43
10,Success,51,25,0,11,40
10,Success,47,25,2,10,37
10,Success,47,26,4,13,34
10,Success,50,23,3,9,41
10,Success,51,30,0,7,44
10,Success,45,32,0,13,32
10,Success,47,23,7,12,35
10,Success,47,27,0,15,32
10,Success,46,31,0,16,30
10,Success,56,19,1,15,41
10,Success,57,18,3,10,47
10,Success,43,32,0,15,28
10,Success,44,30,5,11,33
10,Success,47,23,6,14,33
10,Success,41,39,0,9,32
10,Success,51,20,3,13,38
10,Success,43,32,0,13,30
10,Success,43,29,6,15,28
10,Success,53,23,6,8,45
10,Success,53,19,8,13,40
10,Success,45,27,0,19,26
10,Success,50,23,0,17,33
10,Success,42,26,3,16,26
10,Success,39,36,0,13,26
10,Success,47,32,3,11,36
10,Success,54,16,2,13,41
10,Success,46,31,0,14,32
10,Success,49,31,5,8,41
10,Success,55,21,0,11,44
10,Success,41,37,0,14,27
10,Success,41,28,0,15,26
10,Success,56,23,0,8,48
10,Success,49,31,0,10,39
10,Success,47,20,2,17,30
10,Success,53,18,1,14,39
10,Success,55,15,0,17,38
10,Success,51,25,3,12,39
10,Success,45,27,0,17,28
10,Success,48,23,6,12,36
10,Success,44,27,4,17,27
10,Success,41,27,4,17,24
10,Success,45,30,8,7,38
10,Success,42,33,0,12,30
10,Success,47,25,2,13,34
10,Success,45,27,0,13,32
10,Success,46,30,0,14,32
10,Success,46,36,3,8,38
10,Success,46,30,0,13,33
10,Success,49,21,0,18,31
10,Success,48,36,1,4,44
10,Success,48,28,0,11,37
10,Success,45,29,4,14,31
10,Success,34,33,16,12,22
10,Success,44,37,0,11,33
10,Success,33,39,0,21,12
10,Success,50,23,0,11,39
10,Success,47,35,0,12,35
10,Success,63,13,1,11,52
10,Success,46,33,0,10,36
10,Success,43,33,0,15,28
10,Success,51,26,1,8,43
10,Success,47,22,7,16,31
10,Success,47,34,0,11,36
10,Success,56,19,5,12,44
10,Success,45,24,3,14,31
10,Success,54,23,0,13,41
10,Success,47,30,0,11,36
10,Success,53,17,0,15,38
10,Success,50,24,0,16,34
10,Success,55,27,0,7,48
10,Success,51,16,6,13,38
10,Success,51,22,0,14,37
10,Success,50,29,0,16,34
10,Success,45,26,0,16,29
10,Success,56,18,5,12,44
10,Success,48,25,1,9,39
10,Success,45,31,5,11,34
10,Success,38,38,0,18,20
10,Success,45,30,0,14,31
10,Success,40,40,0,12,28
10,Success,54,21,0,13,41
10,Success,49,23,4,14,35
10,Success,41,36,0,9,32
10,Success,56,22,3,7,49
10,Success,43,28,8,12,31
10,Success,47,29,0,15,32
10,Success,49,25,9,7,42
10,Success,48,31,0,11,37
10,Success,40,33,2,12,28
10,Success,52,28,0,9,43
10,Success,45,25,6,12,33
10,Success,55,27,0,11,44
10,Success,45,22,3,22,23
10,Success,42,27,0,19,23
10,Success,47,29,0,15,32
10,Success,43,29,3,12,31
10,Success,41,29,5,17,24
10,Success,54,25,0,10,44
10,Success,48,36,0,6,42
10,Success,45,34,0,12,33
10,Success,38,41,0,13,25
10,Success,53,32,0,6,47
10,Success,50,25,0,12,38
10,Success,45,29,6,11,34
10,Success,51,21,5,14,37
10,Success,48,26,0,11,37
10,Success,49,24,0,16,33
10,Success,43,35,0,14,29
10,Success,48,25,4,9,39
10,Success,45,30,4,12,33
10,Success,47,25,0,13,34
10,Success,52,16,11,13,39
10,Success,54,24,1,11,43
10,Success,50,19,5,11,39
10,Success,54,18,3,13,41
10,Success,43,27,1,12,31
10,Success,44,30,0,16,28
10,Success,48,23,9,12,36
10,Success,47,26,6,11,36
10,Success,43,26,3,19,24
10,Success,46,30,0,12,34
10,Success,56,21,5,10,46
10,Success,44,18,8,20,24
10,Success,48,32,0,10,38
10,Success,44,24,5,16,28
10,Success,46,29,0,12,34
10,Success,48,30,1,12,36
10,Success,46,26,10,7,39
10,Success,58,24,0,8,50
10,Success,48,27,4,10,38
10,Success,42,25,3,17,25
10,Success,44,30,7,9,35
10,Success,43,28,10,10,33
10,Success,46,32,0,14,32
10,Success,44,30,4,12,32
10,Success,46,33,4,8,38
10,Success,50,21,0,13,37
10,Success,50,24,4,11,39
10,Success,44,30,9,7,37
10,Success,55,19,4,8,47
10,Success,49,25,4,13,36
10,Success,53,20,0,13,40
10,Success,43,24,4,17,26
10,Success,48,27,2,10,38
10,Success,51,24,0,13,38
10,Success,48,30,0,8,40
10,Success,59,23,0,7,52
10,Success,49,29,0,12,37
10,Success,45,24,6,15,30
10,Success,46,32,3,9,37
10,Success,43,35,7,10,33
10,Success,49,26,1,13,36
10,Success,50,28,0,11,39
10,Success,52,27,0,9,43
10,Success,52,20,2,16,36
10,Success,54,20,4,12,42
10,Success,42,25,7,16,26
10,Success,43,33,0,13,30
10,Success,46,24,5,9,37
10,Success,45,24,0,18,27
10,Success,51,18,0,15,36
10,Success,48,26,0,13,35
10,Success,44,29,0,15,29
10,Success,46,29,0,18,28
10,Success,51,19,3,12,39
10,Success,52,26,0,10,42
10,Success,55,24,0,10,45
10,Success,46,25,4,14,32
10,Success,41,26,6,18,23
10,Success,41,26,1,19,22
10,Success,56,22,2,9,47
10,Success,52,23,7,10,42
10,Success,52,27,1,8,44
10,Success,49,20,2,17,32
10,Success,51,27,0,14,37
10,Success,50,21,2,14,36
10,Success,56,29,0,7,49
10,Success,42,26,4,18,24
10,Success,44,28,1,13,31
10,Success,53,30,0,9,44
10,Success,40,37,0,16,24
10,Success,44,30,0,18,26
10,Success,52,30,0,8,44
10,Success,47,23,8,13,34
10,Success,50,22,4,11,39
10,Success,46,26,0,18,28
10,Success,52,26,2,10,42
10,Success,51,22,2,11,40
10,Success,45,31,0,8,37
10,Success,53,29,0,12,41
10,Success,46,26,5,12,34
10,Success,45,32,0,11,34
10,Success,50,32,0,8,42
10,Success,41,33,5,12,29
10,Success,48,23,4,14,34
10,Success,48,35,0,10,38
10,Success,50,30,0,12,38
10,Success,46,30,1,10,36
10,Success,41,39,0,10,31
10,Success,55,23,0,11,44
10,Success,38,36,0,16,22
10,Success,47,28,3,13,34
10,Success,45,23,0,22,23
10,Success,57,25,3,6,51
10,Success,48,30,0,15,33
10,Success,54,18,5,14,40
10,Success,46,28,2,13,33
10,Success,45,27,4,12,33
10,Success,54,26,0,9,45
10,Success,48,30,0,16,32
10,Success,45,35,0,11,34
10,Success,54,24,0,10,44
10,Success,58,19,1,10,48
10,Success,52,30,0,9,43
10,Success,48,26,0,18,30
10,Success,46,23,0,17,29
10,Success,49,26,0,11,38
10,Success,47,26,0,12,35
10,Success,46,29,0,12,34
10,Success,53,26,0,12,41
10,Success,47,30,0,16,31
10,Success,53,24,1,12,41
10,Success,42,29,1,11,31
10,Success,43,23,9,12,31
10,Success,45,30,0,15,30
10,Success,49,26,10,8,41
10,Success,57,22,0,8,49
10,Success,50,17,7,15,35
10,Success,51,24,0,13,38
10,Success,52,27,0,10,42
10,Success,50,23,0,15,35
10,Success,46,25,0,15,31
10,Success,45,35,0,10,35
10,Success,42,28,4,15,27
10,Success,51,22,1,14,37
10,Success,47,21,0,18,29
10,Success,36,36,0,17,19
10,Success,46,35,0,9,37
10,Success,47,23,0,19,28
10,Success,44,27,4,12,32
10,Success,51,27,1,11,40
10,Success,46,28,0,14,32
10,Success,42,33,0,13,29
10,Success,51,25,0,16,35
10,Success,54,31,0,10,44
10,Success,55,17,1,11,44
10,Success,47,30,0,10,37
10,Success,52,26,0,14,38
10,Success,42,32,0,14,28
10,Success,42,41,0,9,33
10,Success,47,17,3,18,29
10,Success,48,30,0,11,37
10,Success,40,33,0,17,23
10,Success,45,26,13,9,36
10,Success,38,37,0,14,24
10,Success,55,31,0,8,47
10,Success,51,27,0,10,41
10,Success,50,28,0,10,40
10,Success,48,28,0,15,33
10,Success,51,29,0,10,41
10,Success,53,26,0,13,40
10,Success,41,39,0,10,31
10,Success,48,25,0,16,32
10,Success,44,31,9,7,37
10,Success,54,24,0,11,43
10,Success,47,24,1,16,31
10,Success,48,29,0,13,35
10,Success,50,30,1,9,41
10,Success,51,24,4,13,38
10,Success,47,29,0,13,34
10,Success,47,25,5,14,33
10,Success,47,30,0,12,35
10,Success,49,24,3,11,38
10,Success,49,19,0,16,33
10,Success,51,24,0,12,39
10,Success,40,30,10,11,29
10,Success,48,25,0,16,32
10,Success,41,34,0,15,26
10,Success,50,22,0,15,35
10,Success,48,24,4,14,34
10,Success,51,20,15,6,45
10,Success,42,26,0,20,22
10,Success,52,26,0,13,39
10,Success,53,23,0,17,36
10,Success,38,35,10,10,28
10,Success,47,28,0,19,28
10,Success,54,20,1,12,42
10,Success,39,44,0,10,29
10,Success,44,22,7,15,29
10,Success,50,26,0,9,41
10,Success,50,23,5,13,37
10,Success,53,21,2,13,40
10,Success,49,21,4,14,35
10,Success,55,20,2,13,42
10,Success,43,23,3,20,23
10,Success,35,48,0,11,24
10,Success,41,40,0,8,33
10,Success,45,18,2,21,24
10,Success,46,31,0,11,35
10,Success,50,25,1,13,37
10,Success,46,30,0,13,33
10,Success,49,29,0,13,36
10,Success,45,27,0,16,29
10,Success,48,32,0,9,39
10,Success,56,20,0,10,46
10,Success,46,32,0,12,34
10,Success,49,27,0,11,38
10,Success,44,23,8,14,30
10,Success,48,31,0,11,37
10,Success,55,18,0,13,42
10,Success,47,34,0,13,34
10,Success,43,35,0,14,29
10,Success,41,29,4,13,28
10,Success,48,28,3,10,38
10,Success,55,21,1,10,45
10,Success,47,35,0,10,37
10,Success,45,33,0,12,33
10,Success,53,25,2,11,42
10,Success,60,22,2,7,53
10,Success,56,22,1,12,44
10,Success,47,33,0,13,34
10,Success,39,29,7,15,24
10,Success,45,26,0,18,27
10,Success,42,42,0,12,30
10,Success,47,30,11,6,41
10,Success,54,22,0,15,39
10,Success,45,25,7,15,30
10,Success,49,27,0,14,35
10,Success,46,31,3,10,36
10,Success,54,18,2,13,41
10,Success,49,29,2,13,36
10,Success,47,22,6,16,31
10,Success,52,22,0,12,40
10,Success,44,30,0,16,28
10,Success,50,32,0,11,39
10,Success,55,22,0,11,44
10,Success,48,27,0,14,34
10,Success,49,31,0,12,37
10,Success,47,32,0,12,35
10,Success,48,25,3,15,33
10,Success,43,32,4,10,33
10,Success,46,32,0,18,28
10,Success,49,26,0,18,31
10,Success,59,19,3,7,52
10,Success,46,31,1,10,36
10,Success,49,22,1,14,35
10,Success,47,27,4,13,34
10,Success,47,36,0,10,37
10,Success,43,31,4,11,32
10,Success,48,23,6,12,36
10,Success,49,28,0,9,40
10,Success,44,32,5,11,33
10,Success,47,35,0,12,35
10,Success,50,24,0,12,38
10,Success,41,30,0,15,26
10,Success,48,28,0,14,34
10,Success,52,17,6,14,38
10,Success,45,36,0,8,37
10,Success,42,27,0,18,24
10,Success,41,33,0,17,24
10,Success,51,21,2,14,37
10,Success,52,27,0,9,43
10,Success,44,23,5,21,23
10,Success,45,32,3,13,32
10,Success,46,30,6,11,35
10,Success,47,24,4,10,37
10,Success,50,25,1,11,39
10,Success,51,26,0,14,37
10,Success,48,27,4,12,36
10,Success,46,34,0,7,39
10,Success,38,39,0,19,19
10,Success,46,30,0,18,28
10,Success,43,29,0,15,28
10,Success,44,28,6,16,28
10,Success,46,25,3,15,31
10,Success,38,29,13,12,26
10,Success,50,22,6,14,36
10,Success,44,34,0,14,30
10,Success,47,29,7,8,39
10,Success,47,38,0,7,40
10,Success,49,22,7,12,37
10,Success,50,25,8,7,43
10,Success,46,24,0,18,28
10,Success,46,31,0,6,40
10,Success,45,36,0,10,35
10,Success,34,33,5,15,19
10,Success,45,34,0,13,32
10,Success,49,27,5,9,40
10,Success,51,23,6,12,39
10,Success,49,22,2,13,36
10,Success,43,30,0,16,27
10,Success,51,31,0,11,40
10,Success,52,17,3,14,38
10,Success,51,28,2,7,44
10,Success,49,31,0,9,40
10,Success,41,27,3,16,25
10,Success,51,25,2,10,41
10,Success,44,23,12,9,35
10,Success,42,26,4,16,26
10,Success,50,29,4,10,40
10,Success,46,27,2,14,32
10,Success,47,22,4,17,30
10,Success,48,27,0,15,33
10,Success,51,19,2,15,36
10,Success,47,22,9,14,33
10,Success,50,26,0,15,35
10,Success,49,29,0,10,39
10,Success,48,23,1,16,32
10,Success,46,30,0,15,31
10,Success,53,20,1,13,40
10,Success,47,34,0,9,38
10,Success,53,20,8,12,41
10,Success,40,39,0,13,27
10,Success,53,24,8,8,45
10,Success,46,28,0,19,27
10,Success,47,27,2,13,34
10,Success,53,27,0,11,42
10,Success,50,25,8,12,38
10,Success,48,30,1,14,34
10,Success,50,22,3,13,37
10,Success,44,29,0,13,31
10,Success,45,28,3,15,30
10,Success,45,31,1,13,32
10,Success,48,28,5,9,39
10,Success,52,29,0,11,41
10,Success,51,27,5,8,43
10,Success,44,41,0,10,34
10,Success,51,27,0,13,38
10,Success,55,23,1,11,44
10,Success,43,38,0,12,31
10,Success,42,36,0,10,32
10,Success,46,33,0,8,38
10,Success,54,28,0,9,45
10,Success,54,27,0,11,43
10,Success,45,24,0,18,27
10,Success,55,21,0,9,46
10,Success,48,26,2,13,35
10,Success,50,26,0,15,35
10,Success,47,36,0,11,36
10,Success,48,25,0,15,33
10,Success,57,20,1,11,46
10,Success,52,25,0,12,40
10,Success,62,19,3,8,54
10,Success,42,39,0,10,32
10,Success,50,26,0,11,39
10,Success,60,23,0,5,55
10,Success,59,21,0,9,50
10,Success,53,25,0,12,41
10,Success,48,26,2,13,35
10,Success,49,32,0,9,40
10,Success,52,24,1,11,41
10,Success,39,28,9,20,19
10,Success,52,24,0,13,39
10,Success,47,29,4,9,38
10,Success,54,21,0,13,41
10,Success,47,21,12,14,33
10,Success,41,20,7,20,21
10,Success,50,19,10,16,34
10,Success,43,23,1,21,22
10,Success,54,15,4,14,40
10,Success,41,28,0,19,22
10,Success,53,26,0,13,40
10,Success,42,30,6,15,27
10,Success,43,35,0,17,26
10,Success,55,24,0,8,47
10,Success,43,28,0,18,25
10,Success,44,26,1,18,26
10,Success,43,34,0,11,32
10,Success,45,35,0,13,32
10,Success,52,26,0,11,41
10,Success,51,24,0,14,37
10,Success,48,31,0,11,37
10,Success,45,31,0,16,29
10,Success,38,32,8,15,23
10,Success,52,21,2,13,39
10,Success,50,26,0,12,38
10,Success,43,30,4,16,27
10,Success,56,14,8,11,45
10,Success,52,17,7,12,40
10,Success,39,33,0,15,24
10,Success,35,38,2,15,20
10,Success,43,34,1,10,33
10,Success,43,26,0,24,19
10,Success,50,24,2,13,37
10,Success,45,27,0,14,31
10,Success,46,28,1,10,36
10,Success,46,31,0,12,34
10,Success,44,32,0,10,34
10,Success,54,23,4,10,44
10,Success,48,24,0,18,30
10,Success,47,23,1,10,37
10,Success,44,31,6,9,35
10,Success,47,33,2,11,36
10,Success,53,21,4,14,39
10,Success,45,21,6,18,27
10,Success,42,28,0,16,26
10,Success,49,27,1,14,35
10,Success,51,26,3,11,40
10,Success,51,23,0,15,36
10,Success,43,24,6,22,21
10,Success,43,28,1,17,26
10,Success,51,23,0,16,35
10,Success,55,22,0,9,46
10,Success,43,28,0,18,25
10,Success,45,33,1,10,35
10,Success,58,19,0,15,43
10,Success,50,19,1,15,35
10,Success,43,35,2,11,32
10,Success,52,25,0,9,43
10,Success,50,29,2,11,39
10,Success,44,28,0,13,31
10,Success,53,19,2,9,44
10,Success,49,26,0,10,39
10,Success,42,38,0,10,32
10,Success,43,37,0,14,29
10,Success,47,30,1,7,40
10,Success,47,27,5,12,35
10,Success,47,27,11,10,37
10,Success,52,24,0,14,38
10,Success,39,35,0,16,23
10,Success,49,32,0,10,39
10,Success,41,38,0,11,30
10,Success,55,21,0,12,43
10,Success,44,28,0,14,30
10,Success,39,34,1,15,24
10,Success,47,26,0,18,29
10,Success,44,28,0,17,27
10,Success,50,22,11,8,42
10,Success,53,22,0,12,41
10,Success,42,36,0,12,30
10,Success,49,19,4,18,31
10,Success,48,22,2,12,36
10,Success,55,25,3,7,48
10,Success,51,23,3,13,38
10,Success,49,23,2,15,34
10,Success,47,32,0,12,35
10,Success,46,27,1,15,31
10,Success,46,24,9,12,34
10,Success,48,27,0,13,35
10,Success,45,32,3,10,35
10,Success,45,27,6,11,34
10,Success,49,22,4,14,35
10,Success,42,31,0,18,24
10,Success,49,25,4,9,40
10,Success,47,27,0,15,32
10,Success,52,21,6,12,40
10,Success,47,22,5,13,34
10,Success,48,27,0,16,32
10,Success,48,21,2,19,29
10,Success,52,25,8,6,46
10,Success,50,27,0,10,40
10,Success,44,30,0,16,28
10,Success,38,27,15,16,22
10,Success,42,29,7,11,31
10,Success,35,28,7,23,12
10,Success,44,27,13,12,32
10,Success,51,24,0,10,41
10,Success,43,32,3,13,30
10,Success,50,24,5,10,40
10,Success,52,19,0,17,35
10,Success,51,23,6,12,39
10,Success,49,29,0,11,38
10,Success,51,31,0,6,45
10,Success,46,32,0,11,35
10,Success,54,21,1,10,44
10,Success,53,18,2,11,42
10,Success,51,25,3,9,42
10,Success,58,18,0,10,48
10,Success,54,26,0,7,47
10,Success,42,25,8,18,24
10,Success,55,19,0,15,40
10,Success,48,28,0,15,33
10,Success,47,32,5,5,42
10,Success,53,27,4,7,46
10,Success,44,27,2,15,29
10,Success,38,36,0,17,21
10,Success,34,43,0,19,15
10,Success,54,24,5,9,45
10,Success,54,19,0,11,43
10,Success,47,26,6,13,34
10,Success,54,26,6,5,49
10,Success,53,25,2,9,44
10,Success,47,32,0,11,36
10,Success,51,29,0,10,41
10,Success,51,25,0,14,37
10,Success,45,23,0,16,29
10,Success,49,29,0,14,35
10,Success,55,20,0,13,42
10,Success,57,20,1,8,49
10,Success,51,23,0,12,39
10,Success,54,23,7,7,47
10,Success,49,21,0,20,29
10,Success,50,24,0,14,36
10,Success,50,26,0,12,38
10,Success,49,29,0,10,39
10,Success,39,29,10,12,27
10,Success,50,27,2,10,40
10,Success,49,31,2,9,40
10,Success,45,24,0,20,25
10,Success,54,26,0,10,44
10,Success,50,24,0,12,38
10,Success,53,18,0,16,37
10,Success,48,31,0,10,38
10,Success,49,30,0,13,36
10,Success,45,23,0,16,29
10,Success,38,34,0,15,23
10,Success,42,25,9,17,25
10,Success,45,37,0,7,38
10,Success,50,22,3,16,34
10,Success,46,33,3,7,39
10,Success,49,23,1,12,37
10,Success,48,25,0,13,35
10,Success,43,25,7,13,30
10,Success,41,41,0,12,29
10,Success,53,23,4,10,43
10,Success,44,30,0,16,28
10,Success,65,15,0,9,56
10,Success,47,35,0,13,34
10,Success,49,28,0,8,41
10,Success,54,25,0,10,44
10,Success,44,27,10,14,30
10,Success,43,30,0,12,31
10,Success,52,20,3,16,36
10,Success,48,30,0,10,38
10,Success,49,23,1,14,35
10,Success,46,28,1,14,32
10,Success,48,31,0,10,38
10,Success,41,30,4,16,25
10,Success,57,26,2,6,51
10,Success,49,24,0,16,33
10,Success,47,19,1,19,28
10,Success,52,28,0,9,43
10,Success,46,29,0,15,31
10,Success,47,34,0,14,33
10,Success,50,30,0,9,41
10,Success,52,22,3,11,41
10,Success,46,33,0,11,35
10,Success,52,16,4,16,36
10,Success,48,25,0,15,33
10,Success,41,27,6,15,26
10,Success,45,25,4,14,31
10,Success,45,29,0,16,29
10,Success,48,27,8,8,40
10,Success,49,25,2,15,34
10,Success,44,36,5,7,37
10,Success,51,23,0,13,38
10,Success,45,33,0,14,31
10,Success,50,27,0,13,37
10,Success,51,26,6,9,42
10,Success,50,28,5,11,39
10,Success,39,27,11,14,25
10,Success,45,25,3,15,30
10,Success,47,37,0,6,41
10,Success,44,29,7,12,32
10,Success,53,25,0,11,42
10,Success,44,22,4,18,26
10,Success,43,35,0,13,30
10,Success,52,24,1,13,39
10,Success,51,27,2,10,41
10,Success,51,24,4,9,42
10,Success,47,28,0,14,33
10,Success,50,24,3,13,37
10,Success,47,17,6,19,28
10,Success,48,32,0,11,37
10,Success,44,30,6,11,33
10,Success,45,33,1,13,32
10,Success,56,20,0,13,43
10,Success,57,19,6,12,45
10,Success,47,26,8,17,30
10,Success,52,17,7,18,34
10,Success,46,22,13,10,36
10,Success,53,20,0,17,36
10,Success,49,28,6,6,43
10,Success,50,23,10,10,40
10,Success,54,29,0,8,46
10,Success,47,27,0,14,33
10,Success,52,22,0,16,36
10,Success,52,20,0,10,42
10,Success,46,27,0,19,27
10,Success,48,33,0,12,36
10,Success,48,21,0,16,32
10,Success,48,35,0,12,36
10,Success,50,24,0,17,33
10,Success,46,29,1,9,37
10,Success,49,21,5,12,37
10,Success,41,29,0,19,22
10,Success,49,25,0,16,33
10,Success,50,17,6,16,34
10,Success,44,29,2,11,33
10,Success,43,34,0,15,28
10,Success,49,28,0,16,33
10,Success,51,27,0,10,41
10,Success,42,36,0,9,33
10,Success,50,27,0,12,38
10,Success,43,28,3,13,30
10,Success,47,33,0,8,39
10,Success,44,24,9,11,33
10,Success,50,25,0,12,38
10,Success,54,14,5,15,39
10,Success,38,23,13,11,27
10,Success,47,25,0,12,35
10,Success,52,24,0,14,38
10,Success,56,19,0,14,42
10,Success,45,25,0,19,26
10,Success,51,24,2,9,42
10,Success,49,29,0,11,38
10,Success,41,28,7,14,27
10,Success,51,25,3,12,39
10,Success,42,29,0,19,23
10,Success,40,34,0,14,26
10,Success,43,35,2,11,32
10,Success,51,25,0,12,39
10,Success,47,24,0,15,32
10,Success,49,26,4,10,39
10,Success,37,38,5,11,26
10,Success,53,26,0,9,44
10,Success,38,30,0,24,14
10,Success,45,24,0,18,27
10,Success,44,21,12,16,28
10,Success,49,34,0,7,42
10,Success,54,19,1,13,41
10,Success,45,35,0,13,32
10,Success,50,23,0,18,32
10,Success,39,32,8,11,28
10,Success,49,27,0,12,37
10,Success,49,20,4,12,37
10,Success,43,27,0,17,26
10,Success,46,27,0,17,29
10,Success,46,26,3,13,33
10,Success,50,25,3,15,35
10,Success,57,20,2,7,50
10,Success,41,25,6,20,21
10,Success,53,27,1,7,46
10,Success,45,25,6,13,32
10,Success,42,32,4,10,32
10,Success,42,37,0,11,31
10,Success,48,33,0,9,39
10,Success,52,24,0,15,37
10,Success,53,19,5,12,41
10,Success,47,39,0,9,38
10,Success,43,26,0,20,23
10,Success,49,29,3,8,41
10,Success,41,26,5,17,24
10,Success,43,29,2,11,32
10,Success,41,25,0,20,21
10,Success,45,34,0,12,33
10,Success,47,27,0,11,36
10,Success,49,26,1,13,36
10,Success,50,24,4,13,37
10,Success,46,28,5,12,34
10,Success,53,20,3,13,40
10,Success,48,20,12,9,39
10,Success,42,30,10,13,29
10,Success,46,31,0,12,34
10,Success,48,27,1,10,38
10,Success,44,28,1,15,29
10,Success,47,34,1,8,39
10,Success,49,25,0,13,36
10,Success,46,31,0,14,32
10,Success,49,28,3,11,38
10,Success,49,20,1,18,31
10,Success,49,26,3,10,39
10,Success,50,24,0,17,33
10,Success,56,21,0,11,45
10,Success,41,30,6,15,26
10,Success,45,30,0,15,30
10,Success,52,24,1,11,41
10,Success,53,26,1,9,44
10,Success,50,26,0,15,35
10,Success,42,35,5,12,30
10,Success,49,31,0,8,41
10,Success,51,29,0,12,39
10,Success,51,25,0,11,40
10,Success,44,36,0,12,32
10,Success,41,37,0,17,24
10,Success,44,30,0,14,30
10,Success,39,38,0,16,23
10,Success,54,23,0,14,40
10,Success,50,27,0,14,36
10,Success,52,23,5,12,40
10,Success,34,30,12,18,16
10,Success,46,28,3,13,33
10,Success,51,22,2,15,36
10,Success,40,33,5,8,32
10,Success,44,29,7,11,33
10,Success,48,28,7,11,37
10,Success,53,27,0,9,44
10,Success,48,26,2,12,36
10,Success,41,26,6,17,24
10,Success,58,25,0,8,50
10,Success,42,30,7,13,29
10,Success,44,23,3,15,29
10,Success,52,23,0,14,38
10,Success,45,23,1,20,25
10,Success,45,31,1,14,31
10,Success,51,20,0,17,34
10,Success,50,26,0,14,36
10,Success,56,21,0,11,45
10,Success,47,34,0,10,37
10,Success,55,22,1,10,45
10,Success,35,30,6,22,13
10,Success,50,19,3,18,32
10,Success,45,36,0,11,34
10,Success,50,23,0,14,36
10,Success,53,20,0,13,40
10,Success,51,28,0,10,41
10,Success,44,26,4,18,26
10,Success,49,28,0,14,35
10,Success,56,13,4,12,44
10,Success,56,21,3,10,46
10,Success,53,21,0,17,36
10,Success,52,26,0,11,41
10,Success,47,29,0,13,34
10,Success,46,33,0,8,38
10,Success,42,33,0,14,28
10,Success,47,23,7,14,33
10,Success,56,16,2,14,42
10,Success,56,24,0,7,49
10,Success,49,21,6,14,35
10,Success,41,29,0,22,19
10,Success,56,16,0,19,37
10,Success,42,35,0,16,26
10,Success,44,30,3,10,34
10,Success,45,23,5,17,28
10,Success,40,32,3,14,26
10,Success,50,29,0,12,38
10,Success,48,17,6,20,28
10,Success,53,20,3,14,39
10,Success,44,33,0,11,33
10,Success,43,28,8,10,33
10,Success,52,28,0,9,43
10,Success,53,22,0,12,41
10,Success,49,27,0,10,39
10,Success,50,22,2,12,38
10,Success,49,17,6,13,36
10,Success,50,34,0,8,42
10,Success,48,26,1,13,35
10,Success,41,37,0,13,28
10,Success,62,14,0,15,47
10,Success,55,21,4,10,45
10,Success,53,19,0,12,41
10,Success,50,21,2,16,34
10,Success,50,24,1,14,36
10,Success,41,27,0,23,18
10,Success,52,30,0,6,46
10,Success,46,32,0,15,31
10,Success,51,24,0,15,36
10,Success,47,29,0,11,36
10,Success,52,24,0,11,41
10,Success,37,40,0,12,25
10,Success,43,25,0,18,25
10,Success,43,36,0,13,30
10,Success,53,17,7,12,41
10,Success,48,20,0,20,28
10,Success,44,25,3,15,29
10,Success,53,23,1,13,40
10,Success,52,26,0,11,41
10,Success,61,17,4,10,51
10,Success,50,22,0,15,35
10,Success,46,28,5,12,34
10,Success,51,30,2,8,43
10,Success,51,23,4,11,40
10,Success,50,35,0,10,40
10,Success,45,28,2,16,29
10,Success,48,28,0,12,36
10,Success,38,24,19,13,25
10,Success,48,30,0,10,38
10,Success,42,29,6,12,30
10,Success,49,30,0,9,40
10,Success,53,25,0,12,41
10,Success,41,27,5,17,24
10,Success,52,20,1,14,38
10,Success,47,25,4,10,37
10,Success,55,21,3,13,42
10,Success,39,37,0,13,26
10,Success,48,25,0,14,34
10,Success,50,19,2,16,34
10,Success,53,23,0,9,44
10,Success,51,19,7,15,36
10,Success,53,23,0,12,41
10,Success,46,21,9,10,36
10,Success,49,28,0,14,35
10,Success,45,32,7,10,35
10,Success,46,28,0,12,34
10,Success,40,29,0,17,23
10,Success,40,31,3,18,22
10,Success,51,29,0,13,38
10,Success,47,25,0,17,30
10,Success,55,19,5,11,44
10,Success,50,27,0,10,40
10,Success,44,28,0,16,28
10,Success,45,25,7,12,33
10,Success,54,19,1,11,43
10,Success,47,25,5,12,35
10,Success,51,33,0,7,44
10,Success,57,18,0,14,43
10,Success,47,26,3,16,31
10,Success,37,36,1,14,23
10,Success,53,24,2,9,44
10,Success,40,33,0,16,24
10,Success,41,25,6,19,22
10,Success,58,27,0,8,50
10,Success,55,21,1,8,47
10,Success,55,24,0,10,45
10,Success,56,20,2,12,44
10,Success,45,30,0,14,31
10,Success,46,25,9,9,37
10,Success,49,30,0,14,35
10,Success,48,27,4,13,35
10,Success,47,34,0,11,36
10,Success,52,29,0,9,43
10,Success,45,34,0,14,31
10,Success,47,29,0,15,32
10,Success,55,27,0,8,47
10,Success,54,20,0,13,41
10,Success,46,34,0,7,39
10,Success,50,26,5,12,38
10,Success,48,31,1,6,42
10,Success,44,33,0,15,29
10,Success,54,21,1,11,43
10,Success,61,20,0,10,51
10,Success,52,23,0,12,40
10,Success,41,28,4,15,26
10,Success,55,22,2,13,42
10,Success,53,27,2,9,44
10,Success,50,23,0,14,36
10,Success,45,27,0,13,32
10,Success,47,22,3,15,32
10,Success,41,32,0,17,24
10,Success,46,23,7,11,35
10,Success,37,44,0,12,25
10,Success,47,21,5,14,33
10,Success,42,34,0,13,29
10,Success,51,27,2,7,44
10,Success,44,33,0,14,30
10,Success,54,24,2,5,49
10,Success,55,25,0,12,43
10,Success,41,28,3,14,27
10,Success,45,36,0,9,36
10,Success,52,20,5,9,43
10,Success,43,26,9,16,27
10,Success,50,23,0,16,34
10,Success,48,28,0,15,33
10,Success,48,26,0,12,36
10,Success,49,20,0,20,29
10,Success,49,17,5,20,29
10,Success,44,30,2,13,31
10,Success,43,32,6,12,31
10,Success,50,24,0,12,38
10,Success,47,27,2,12,35
10,Success,53,22,4,9,44
10,Success,46,18,9,18,28
10,Success,40,34,0,16,24
10,Success,50,22,3,12,38
10,Success,43,29,0,15,28
10,Success,55,18,1,12,43
10,Success,45,28,10,12,33
10,Success,48,34,0,13,35
10,Success,49,24,0,13,36
10,Success,50,19,4,16,34
10,Success,53,24,0,14,39
10,Success,52,20,0,15,37
10,Success,51,21,2,15,36
10,Success,58,16,0,15,43
10,Success,42,27,6,17,25
10,Success,46,27,0,12,34
10,Success,40,31,0,14,26
10,Success,42,38,0,11,31
10,Success,45,28,0,16,29
10,Success,45,22,5,13,32
10,Success,50,28,0,13,37
10,Success,56,17,2,13,43
10,Success,51,21,8,10,41
10,Success,43,28,3,15,28
10,Success,47,32,0,15,32
10,Success,44,29,9,13,31
10,Success,55,29,0,5,50
10,Success,50,29,0,8,42
10,Success,49,21,1,16,33
10,Success,44,21,5,15,29
10,Success,40,33,8,15,25
10,Success,52,29,0,10,42
10,Success,49,24,0,14,35
10,Success,48,23,5,14,34
10,Success,40,28,0,18,22
10,Success,50,26,3,8,42
10,Success,48,27,2,13,35
10,Success,44,28,1,14,30
10,Success,49,33,0,6,43
10,Success,50,24,3,12,38
10,Success,52,29,5,3,49
10,Success,51,29,3,8,43
10,Success,41,26,8,15,26
10,Success,49,28,0,11,38
10,Success,52,23,2,14,38
10,Success,56,20,0,13,43
10,Success,50,32,0,9,41
10,Success,50,25,7,11,39
10,Success,47,31,0,11,36
10,Success,46,27,0,16,30
10,Success,44,25,3,14,30
10,Success,49,27,0,13,36
10,Success,42,34,5,9,33
10,Success,42,30,0,18,24
10,Success,50,35,0,8,42
10,Success,44,34,0,13,31
10,Success,43,27,7,12,31
10,Success,46,30,3,9,37
10,Success,46,23,6,16,30
10,Success,50,18,0,18,32
10,Success,44,26,7,18,26
10,Success,39,37,0,15,24
10,Success,37,44,0,14,23
10,Success,50,26,0,15,35
10,Success,44,27,9,12,32
10,Success,44,34,0,11,33
10,Success,49,25,0,13,36
10,Success,46,32,0,12,34
10,Success,50,29,0,17,33
10,Success,45,25,0,18,27
10,Success,49,28,0,9,40
10,Success,41,34,6,8,33
10,Success,55,30,0,6,49
10,Success,48,25,9,13,35
10,Success,58,21,0,9,49
10,Success,48,24,7,10,38
10,Success,45,23,3,18,27
10,Success,47,24,1,18,29
10,Success,52,24,2,12,40
10,Success,47,36,0,6,41
10,Success,41,33,0,14,27
10,Success,52,24,5,8,44
10,Success,51,26,2,10,41
10,Success,46,28,0,9,37
10,Success,50,23,0,12,38
10,Success,50,25,0,12,38
10,Success,48,29,0,14,34
10,Success,51,27,0,9,42
10,Success,53,31,0,7,46
10,Success,39,27,11,17,22
10,Success,46,35,0,14,32
10,Success,52,18,4,10,42
10,Success,50,20,0,16,34
10,Success,48,29,1,12,36
10,Success,46,33,0,11,35
10,Success,47,23,5,15,32
10,Success,56,24,0,11,45
10,Success,42,31,7,13,29
10,Success,47,32,0,9,38
10,Success,49,26,0,12,37
10,Success,49,24,0,15,34
10,Success,53,24,0,12,41
10,Success,42,29,0,17,25
10,Success,50,24,0,14,36
10,Success,44,25,9,16,28
10,Success,53,28,0,6,47
10,Success,51,25,2,13,38
10,Success,49,26,0,16,33
10,Success,47,36,0,6,41
10,Success,48,28,1,10,38
10,Success,52,17,4,15,37
10,Success,48,24,4,14,34
10,Success,46,25,9,12,34
10,Success,42,34,0,14,28
10,Success,53,22,0,11,42
10,Success,42,28,0,19,23
10,Success,49,34,0,9,40
10,Success,42,30,0,17,25
10,Success,48,25,4,9,39
10,Success,48,27,0,14,34
10,Success,39,31,13,10,29
10,Success,48,25,4,12,36
10,Success,55,25,0,8,47
10,Success,49,20,1,19,30
10,Success,53,19,1,16,37
10,Success,44,37,0,13,31
10,Success,37,46,0,8,29
10,Success,49,20,0,19,30
10,Success,51,22,10,10,41
10,Success,51,25,1,10,41
10,Success,38,32,5,12,26
10,Success,54,27,0,8,46
10,Success,51,23,2,14,37
10,Success,43,31,0,14,29
10,Success,44,35,0,13,31
10,Success,44,31,2,12,32
10,Success,47,21,11,12,35
10,Success,46,24,4,14,32
10,Success,50,30,0,13,37
10,Success,42,33,3,13,29
10,Success,47,25,4,15,32
10,Success,44,36,0,15,29
10,Success,44,32,0,17,27
10,Success,39,30,9,11,28
10,Success,43,29,0,15,28
10,Success,51,30,0,14,37
10,Success,50,25,0,13,37
10,Success,55,20,4,11,44
10,Success,51,20,10,7,44
10,Success,41,40,0,8,33
10,Success,49,27,0,12,37
10,Success,50,31,0,8,42
10,Success,51,27,0,11,40
10,Success,46,24,3,18,28
10,Success,41,27,0,17,24
10,Success,55,23,7,5,50
10,Success,38,27,10,14,24
10,Success,47,22,4,13,34
10,Success,54,30,0,10,44
10,Success,49,29,0,12,37
10,Success,51,21,0,12,39
10,Success,48,30,0,9,39
10,Success,49,20,6,13,36
10,Success,49,25,6,8,41
10,Success,47,23,0,13,34
10,Success,46,23,10,15,31
10,Success,42,29,9,10,32
10,Success,44,31,0,13,31
10,Success,55,22,0,12,43
10,Success,49,27,3,9,40
10,Success,45,24,5,12,33
10,Success,49,29,0,12,37
10,Success,53,30,7,5,48
10,Success,50,25,0,14,36
10,Success,49,25,0,12,37
10,Success,53,24,1,11,42
10,Success,47,28,2,13,34
10,Success,57,17,0,13,44
10,Success,46,37,0,10,36
10,Success,47,25,2,16,31
10,Success,50,30,0,8,42
10,Success,55,20,0,11,44
10,Success,50,30,0,12,38
10,Success,43,31,11,7,36
10,Success,53,29,0,8,45
10,Success,51,24,7,11,40
10,Success,46,27,0,13,33
10,Success,60,22,0,8,52
10,Success,54,19,5,14,40
10,Success,48,32,0,13,35
10,Success,49,28,0,8,41
10,Success,49,27,0,12,37
10,Success,49,30,1,11,38
10,Success,49,20,0,20,29
10,Success,48,21,3,18,30
10,Success,43,25,0,19,24
10,Success,51,22,0,14,37
10,Success,45,28,0,16,29
10,Success,45,25,2,20,25
10,Success,46,26,2,15,31
10,Success,43,30,0,16,27
10,Success,54,23,1,12,42
10,Success,56,16,6,15,41
10,Success,47,28,0,14,33
10,Success,46,32,1,10,36
10,Success,44,24,7,16,28
10,Success,50,31,0,13,37
10,Success,47,27,5,12,35
10,Success,54,28,0,9,45
10,Success,47,30,0,12,35
10,Success,50,23,3,13,37
10,Success,45,32,3,9,36
10,Success,46,26,3,13,33
10,Success,41,41,0,11,30
10,Success,47,34,0,10,37
10,Success,55,21,0,10,45
10,Success,52,20,11,10,42
10,Success,45,32,0,15,30
10,Success,47,26,0,15,32
10,Success,46,34,0,10,36
10,Success,53,27,0,9,44
10,Success,53,37,0,6,47
10,Success,51,36,0,6,45
10,Success,55,26,0,8,47
10,Success,49,26,0,12,37
10,Success,51,18,7,16,35
10,Success,50,25,2,12,38
10,Success,52,25,0,13,39
10,Success,50,28,0,11,39
10,Success,45,25,3,14,31
10,Success,50,19,4,16,34
10,Success,52,24,5,9,43
10,Success,44,25,5,15,29
10,Success,34,46,0,15,19
10,Success,54,26,0,9,45
10,Success,49,28,1,12,37
10,Success,44,30,0,13,31
10,Success,47,27,0,14,33
10,Success,46,32,1,12,34
10,Success,46,35,0,13,33
10,Success,47,26,2,14,33
10,Success,55,23,0,9,46
10,Success,50,23,2,15,35
10,Success,52,26,0,11,41
10,Success,53,27,0,10,43
10,Success,50,34,0,7,43
10,Success,48,29,0,15,33
10,Success,52,22,0,14,38
10,Success,48,28,6,9,39
10,Success,41,35,0,14,27
10,Success,54,27,0,7,47
10,Success,46,26,0,16,30
10,Success,52,30,2,9,43
10,Success,48,26,0,13,35
10,Success,51,29,0,8,43
10,Success,52,28,0,8,44
10,Success,45,31,0,14,31
10,Success,46,30,1,14,32
10,Success,45,26,2,15,30
10,Success,54,24,2,10,44
10,Success,52,26,4,9,43
10,Success,47,33,0,11,36
10,Success,53,21,0,10,43
10,Success,46,27,0,16,30
10,Success,50,22,7,12,38
10,Success,49,25,8,10,39
10,Success,41,36,0,13,28
10,Success,47,21,5,13,34
10,Success,44,35,1,9,35
10,Success,52,26,7,10,42
10,Success,48,24,0,17,31
10,Success,48,29,0,11,37
10,Success,45,31,0,17,28
10,Success,40,32,0,19,21
10,Success,55,14,0,18,37
10,Success,56,16,3,15,41
10,Success,41,39,0,11,30
10,Success,50,26,1,12,38
10,Success,52,27,1,10,42
10,Success,48,26,4,10,38
10,Success,53,19,4,14,39
10,Success,43,30,0,16,27
10,Success,50,18,0,18,32
10,Success,56,21,0,6,50
10,Success,50,30,4,7,43
10,Success,47,27,0,17,30
10,Success,48,27,2,13,35
10,Success,50,29,0,13,37
10,Success,51,21,0,16,35
10,Success,46,34,0,14,32
10,Success,51,23,2,11,40
10,Success,52,23,3,12,40
10,Success,47,23,4,13,34
10,Success,50,22,5,12,38
10,Success,54,30,0,9,45
10,Success,46,32,5,8,38
10,Success,53,21,1,14,39
10,Success,49,31,0,11,38
10,Success,44,30,9,11,33
10,Success,46,29,0,14,32
10,Success,53,23,0,13,40
10,Success,46,33,0,13,33
10,Success,51,25,3,10,41
10,Success,47,31,3,8,39
10,Success,47,24,13,10,37
10,Success,43,37,0,11,32
10,Success,52,24,3,8,44
10,Success,51,22,5,12,39
10,Success,40,31,6,14,26
10,Success,48,38,0,7,41
10,Success,45,28,4,9,36
10,Success,55,23,0,11,44
10,Success,48,29,3,7,41
10,Success,46,34,0,14,32
10,Success,48,23,5,16,32
10,Success,45,27,6,13,32
10,Success,53,14,0,19,34
10,Success,42,27,4,16,26
10,Success,54,27,0,10,44
10,Success,54,25,2,10,44
10,Success,47,22,5,15,32
10,Success,58,22,1,8,50
10,Success,54,21,7,11,43
10,Success,54,17,6,9,45
10,Success,43,33,4,12,31
10,Success,39,28,5,17,22
10,Success,49,23,5,10,39
10,Success,50,33,0,11,39
10,Success,45,32,0,13,32
10,Success,60,20,0,14,46
10,Success,56,23,0,10,46
10,Success,39,29,9,12,27
10,Success,41,29,11,14,27
10,Success,50,21,4,18,32
10,Success,47,30,3,13,34
10,Success,50,24,2,14,36
10,Success,43,31,8,11,32
10,Success,50,21,0,11,39
10,Success,54,27,4,6,48
10,Success,45,31,0,8,37
10,Success,44,29,1,13,31
10,Success,51,25,2,8,43
10,Success,63,15,4,9,54
10,Success,49,25,0,12,37
10,Success,48,27,5,9,39
10,Success,48,30,0,12,36
10,Success,48,24,0,12,36
10,Success,48,29,0,15,33
10,Success,49,25,2,11,38
10,Success,44,44,0,9,35
10,Success,54,23,0,15,39
10,Success,45,28,5,11,34
10,Success,42,34,2,13,29
10,Success,50,28,2,9,41
10,Success,50,23,2,14,36
10,Success,51,27,0,11,40
10,Success,51,30,0,7,44
10,Success,45,26,4,16,29
10,Success,50,22,1,15,35
10,Success,40,36,0,14,26
10,Success,59,16,0,9,50
10,Success,50,29,0,11,39
10,Success,43,30,0,18,25
10,Success,48,31,0,8,40
10,Success,49,27,4,9,40
10,Success,44,24,10,15,29
10,Success,49,30,0,13,36
10,Success,42,35,0,12,30
10,Success,45,25,7,15,30
10,Success,46,26,1,15,31
10,Success,55,24,4,7,48
10,Success,46,30,0,13,33
10,Success,47,29,3,10,37
10,Success,45,30,0,18,27
10,Success,53,26,0,10,43
10,Success,45,33,0,13,32
10,Success,43,28,1,16,27
10,Success,49,32,1,8,41
10,Success,41,30,6,14,27
10,Success,54,22,0,14,40
10,Success,36,34,0,19,17
10,Success,50,30,0,6,44
10,Success,48,26,0,17,31
10,Success,43,31,0,15,28
10,Success,47,33,0,10,37
10,Success,40,30,6,16,24
10,Success,45,24,2,17,28
10,Success,55,23,7,6,49
10,Success,44,29,0,18,26
10,Success,51,25,3,6,45
10,Success,51,32,0,7,44
10,Success,44,28,0,16,28
10,Success,47,25,0,15,32
10,Success,47,28,2,15,32
10,Success,50,24,8,9,41
10,Success,50,29,0,13,37
10,Success,46,36,0,11,35
10,Success,52,22,0,10,42
10,Success,47,26,0,17,30
10,Success,51,23,0,12,39
10,Success,45,31,0,16,29
10,Success,54,25,4,6,48
10,Success,40,42,0,12,28
10,Success,46,26,2,16,30
10,Success,56,20,0,16,40
10,Success,40,32,0,14,26
10,Success,46,33,0,10,36
10,Success,45,22,7,14,31
10,Success,50,26,2,11,39
10,Success,50,24,2,10,40
10,Success,48,27,0,17,31
10,Success,59,20,0,10,49
10,Success,40,28,8,9,31
10,Success,50,27,0,13,37
10,Success,49,26,8,7,42
10,Success,51,23,0,13,38
10,Success,47,31,0,16,31
10,Success,44,23,17,12,32
10,Success,54,24,0,14,40
10,Success,52,21,0,16,36
10,Success,43,30,5,10,33
10,Success,54,21,0,11,43
10,Success,53,16,2,16,37
10,Success,51,32,0,13,38
10,Success,51,31,0,8,43
10,Success,46,22,2,15,31
10,Success,53,24,0,11,42
10,Success,52,25,7,8,44
10,Success,49,26,0,13,36
10,Success,42,31,0,15,27
10,Success,49,25,0,17,32
10,Success,49,28,0,13,36
10,Success,47,26,2,14,33
10,Success,42,33,0,12,30
10,Success,55,17,13,9,46
10,Success,49,31,0,8,41
10,Success,42,32,7,13,29
10,Success,51,20,2,16,35
10,Success,49,27,5,6,43
10,Success,40,31,4,12,28
10,Success,45,26,0,18,27
10,Success,46,25,8,12,34
10,Success,54,16,2,11,43
10,Success,44,27,0,16,28
10,Success,43,38,0,14,29
10,Success,42,33,0,17,25
10,Success,44,31,0,11,33
10,Success,51,23,0,14,37
10,Success,53,24,0,10,43
10,Success,50,28,0,7,43
10,Success,45,22,0,16,29
10,Success,42,32,5,11,31
10,Success,41,33,4,12,29
10,Success,53,22,5,8,45
10,Success,40,33,5,11,29
10,Success,53,22,4,14,39
10,Success,45,31,0,11,34
10,Success,40,33,2,15,25
10,Success,49,22,7,13,36
10,Success,50,27,1,13,37
10,Success,49,26,0,16,33
10,Success,41,26,5,16,25
10,Success,52,32,0,8,44
10,Success,50,26,3,10,40
10,Success,46,31,0,12,34
10,Success,48,28,2,11,37
10,Success,48,25,4,12,36
10,Success,42,34,0,19,23
10,Success,49,25,0,17,32
10,Success,51,27,1,11,40
10,Success,50,29,4,7,43
10,Success,50,29,0,7,43
10,Success,49,32,0,10,39
10,Success,43,26,13,12,31
10,Success,54,20,0,11,43
10,Success,52,29,0,8,44
10,Success,42,20,7,18,24
10,Success,52,24,0,13,39
10,Success,46,27,0,15,31
10,Success,47,29,0,12,35
10,Success,44,30,0,18,26
10,Success,45,22,6,14,31
10,Success,49,25,0,15,34
10,Success,48,26,0,15,33
10,Success,45,30,0,15,30
10,Success,43,30,0,14,29
10,Success,49,24,2,13,36
10,Success,52,20,3,15,37
10,Success,48,24,0,14,34
10,Success,48,22,2,15,33
10,Success,44,27,0,17,27
10,Success,55,22,0,13,42
10,Success,47,32,0,14,33
10,Success,50,25,7,9,41
10,Success,41,37,0,10,31
10,Success,56,22,2,6,50
10,Success,44,38,0,12,32
10,Success,53,22,0,10,43
10,Success,44,30,2,13,31
10,Success,58,16,1,13,45
10,Success,51,24,0,13,38
10,Success,48,28,0,7,41
10,Success,51,27,0,10,41
10,Success,53,24,3,12,41
10,Success,56,18,1,15,41
10,Success,46,30,1,14,32
10,Success,48,25,1,14,34
10,Success,46,36,0,10,36
10,Success,55,21,1,10,45
10,Success,50,20,7,10,40
10,Success,42,28,2,18,24
10,Success,42,37,0,13,29
10,Success,44,34,0,12,32
10,Success,41,34,0,13,28
10,Success,54,26,0,7,47
10,Success,38,43,0,11,27
10,Success,51,18,3,13,38
10,Success,42,32,7,10,32
10,Success,46,29,0,12,34
10,Success,44,34,0,13,31
10,Success,46,29,0,12,34
10,Success,49,27,0,13,36
10,Success,47,30,6,9,38
10,Success,43,28,3,14,29
10,Success,52,30,0,8,44
10,Success,40,35,0,19,21
10,Success,51,19,0,17,34
10,Success,46,27,0,17,29
10,Success,52,26,2,12,40
10,Success,48,23,0,13,35
10,Success,48,26,0,14,34
10,Success,43,36,0,16,27
10,Success,50,23,0,15,35
10,Success,46,27,3,9,37
10,Success,50,31,0,12,38
10,Success,52,25,0,12,40
10,Success,45,31,2,12,33
10,Success,47,31,0,12,35
10,Success,49,26,0,14,35
10,Success,54,22,0,13,41
10,Success,55,25,0,11,44
10,Success,49,19,0,15,34
10,Success,43,32,7,6,37
10,Success,45,30,4,9,36
10,Success,53,26,3,8,45
10,Success,47,27,0,14,33
10,Success,50,25,2,10,40
10,Success,51,25,3,12,39
10,Success,42,31,0,19,23
10,Success,47,28,2,11,36
10,Success,53,28,0,8,45
10,Success,40,25,0,21,19
10,Success,47,31,0,11,36
10,Success,45,28,1,13,32
10,Success,51,24,0,9,42
10,Success,52,19,4,15,37
10,Success,48,26,1,11,37
10,Success,57,22,2,8,49
10,Success,55,20,6,11,44
10,Success,55,29,0,6,49
10,Success,49,29,0,10,39
10,Success,46,32,0,8,38
10,Success,43,31,0,17,26
10,Success,52,25,0,9,43
10,Success,54,26,0,8,46
10,Success,49,27,0,12,37
10,Success,48,26,0,13,35
10,Success,45,25,1,16,29
10,Success,49,24,2,14,35
10,Success,48,29,1,8,40
10,Success,50,26,0,13,37
10,Success,45,33,0,11,34
10,Success,48,24,5,12,36
10,Success,53,24,0,12,41
10,Success,52,26,0,15,37
10,Success,46,30,0,15,31
10,Success,49,25,2,14,35
10,Success,51,26,0,12,39
10,Success,40,31,8,17,23
10,Success,48,32,0,14,34
10,Success,49,25,0,13,36
10,Success,41,39,0,12,29
10,Success,42,29,0,20,22
10,Success,48,23,8,10,38
10,Success,46,29,0,15,31
10,Success,50,26,3,11,39
10,Success,45,32,0,13,32
10,Success,46,26,10,11,35
10,Success,49,29,0,9,40
10,Success,49,23,8,9,40
10,Success,42,32,3,10,32
10,Success,57,20,3,9,48
10,Success,44,35,0,12,32
10,Success,47,22,0,16,31
10,Success,49,31,0,7,42
10,Success,52,24,2,9,43
10,Success,50,26,0,11,39
10,Success,48,24,5,13,35
10,Success,52,26,0,12,40
10,Success,44,39,0,7,37
10,Success,40,37,0,14,26
10,Success,45,34,3,9,36
10,Success,49,28,3,8,41
10,Success,55,22,0,16,39
10,Success,45,33,0,18,27
10,Success,51,27,0,9,42
10,Success,55,20,0,12,43
10,Success,44,34,0,14,30
10,Success,49,31,0,8,41
10,Success,48,24,2,13,35
10,Success,46,25,2,16,30
10,Success,50,29,0,9,41
10,Success,51,24,0,14,37
10,Success,46,31,0,12,34
10,Success,50,28,0,9,41
10,Success,44,32,0,11,33
10,Success,46,31,8,10,36
10,Success,49,23,2,13,36
10,Success,55,22,1,11,44
10,Success,54,27,0,7,47
10,Success,46,29,2,11,35
10,Success,44,38,0,8,36
10,Success,49,23,0,13,36
10,Success,51,22,0,17,34
10,Success,46,33,0,11,35
10,Success,50,28,0,16,34
10,Success,44,21,4,23,21
10,Success,39,26,4,21,18
10,Success,44,30,0,15,29
10,Success,46,26,9,13,33
10,Success,43,26,0,18,25
10,Success,46,34,0,11,35
10,Success,54,27,0,9,45
10,Success,49,22,9,13,36
10,Success,45,30,0,14,31
10,Success,45,28,1,16,29
10,Success,51,28,0,10,41
10,Success,50,25,0,17,33
10,Success,58,20,1,10,48
10,Success,49,27,4,12,37
10,Success,49,22,1,13,36
10,Success,43,35,0,11,32
10,Success,48,28,0,11,37
10,Success,59,15,0,15,44
10,Success,48,30,0,15,33
10,Success,45,31,0,11,34
10,Success,50,26,0,14,36
10,Success,47,18,2,20,27
10,Success,44,33,0,11,33
10,Success,47,33,0,11,36
10,Success,44,34,3,11,33
10,Success,37,35,0,17,20
10,Success,46,23,2,14,32
10,Success,47,37,0,6,41
10,Success,54,19,0,14,40
10,Success,42,30,0,14,28
10,Success,42,28,6,14,28
10,Success,44,34,0,10,34
10,Success,50,26,0,12,38
10,Success,46,28,0,17,29
10,Success,46,30,0,10,36
10,Success,50,23,0,14,36
10,Success,39,35,0,17,22
10,Success,42,39,0,10,32
10,Success,52,25,0,11,41
10,Success,55,25,0,8,47
10,Success,55,22,4,14,41
10,Success,50,32,0,12,38
10,Success,47,25,0,17,30
10,Success,53,21,3,12,41
10,Success,44,24,6,13,31
10,Success,51,20,0,16,35
10,Success,49,25,0,14,35
10,Success,46,27,0,13,33
10,Success,51,22,4,14,37
10,Success,48,33,0,11,37
10,Success,50,28,0,14,36
10,Success,51,30,0,11,40
10,Success,46,29,0,15,31
10,Success,45,24,3,15,30
10,Success,49,36,0,5,44
10,Success,46,28,3,13,33
10,Success,37,40,1,16,21
10,Success,39,28,8,15,24
10,Success,46,26,0,16,30
10,Success,43,32,0,13,30
10,Success,51,32,0,9,42
10,Success,48,23,5,13,35
10,Success,43,33,5,10,33
10,Success,47,30,0,13,34
10,Success,50,28,0,12,38
10,Success,57,17,3,7,50
10,Success,41,31,2,15,26
10,Success,44,33,0,12,32
10,Success,40,32,7,15,25
10,Success,40,30,0,21,19
10,Success,46,29,0,15,31
10,Success,43,34,0,12,31
10,Success,38,31,2,14,24
10,Success,55,24,0,11,44
10,Success,48,21,0,16,32
10,Success,42,35,0,14,28
10,Success,51,27,3,6,45
10,Success,61,23,1,3,58
10,Success,48,29,0,15,33
10,Success,54,29,0,6,48
10,Success,43,28,3,12,31
10,Success,49,23,1,14,35
10,Success,46,34,0,9,37
10,Success,40,30,6,17,23
10,Success,48,28,8,5,43
10,Success,47,28,0,15,32
10,Success,44,36,0,10,34
10,Success,37,40,0,16,21
10,Success,48,30,0,11,37
10,Success,46,25,0,13,33
10,Success,47,29,3,10,37
10,Success,50,31,0,12,38
10,Success,52,26,3,8,44
10,Success,54,28,0,10,44
10,Success,55,30,0,6,49
10,Success,47,29,0,14,33
10,Success,49,24,5,11,38
10,Success,48,28,0,12,36
10,Success,41,28,5,16,25
10,Success,51,25,2,11,40
10,Success,56,22,0,8,48
10,Success,54,25,4,8,46
10,Success,51,25,0,9,42
10,Success,54,22,0,11,43
10,Success,43,29,9,13,30
10,Success,53,26,0,10,43
10,Success,50,19,6,14,36
10,Success,45,29,4,12,33
10,Success,54,22,0,11,43
10,Success,46,26,0,18,28
10,Success,37,33,0,18,19
10,Success,49,23,0,17,32
10,Success,51,28,0,8,43
10,Success,55,25,0,10,45
10,Success,42,23,5,19,23
10,Success,47,26,0,14,33
10,Success,46,25,0,15,31
10,Success,46,27,0,18,28
10,Success,47,30,4,10,37
10,Success,53,20,2,13,40
10,Success,55,26,0,7,48
10,Success,57,22,0,11,46
10,Success,45,27,0,15,30
10,Success,53,22,4,12,41
10,Success,43,33,0,14,29
10,Success,55,23,1,7,48
10,Success,49,20,9,14,35
10,Success,46,21,9,17,29
10,Success,51,27,5,7,44
10,Success,46,24,5,16,30
10,Success,44,23,12,15,29
10,Success,40,38,0,17,23
10,Success,49,37,0,6,43
10,Success,41,29,0,19,22
10,Success,50,34,0,11,39
10,Success,47,27,3,11,36
10,Success,44,27,6,15,29
10,Success,54,22,0,11,43
10,Success,46,32,0,11,35
10,Success,56,21,1,14,42
10,Success,42,33,0,12,30
10,Success,50,25,0,10,40
10,Success,50,30,0,7,43
10,Success,44,29,0,14,30
10,Success,47,28,0,10,37
10,Success,46,26,0,20,26
10,Success,43,22,1,20,23
10,Success,49,30,0,13,36
10,Success,40,25,0,25,15
10,Success,51,21,0,17,34
10,Success,51,26,4,9,42
10,Success,46,22,5,13,33
10,Success,49,21,0,16,33
10,Success,55,22,0,10,45
10,Success,47,27,3,14,33
10,Success,39,39,0,12,27
10,Success,55,29,0,7,48
10,Success,38,42,0,11,27
10,Success,45,30,0,13,32
10,Success,43,29,9,10,33
10,Success,49,29,0,14,35
10,Success,42,26,0,22,20
10,Success,46,29,0,9,37
10,Success,53,26,1,12,41
10,Success,48,26,6,9,39
10,Success,48,19,9,12,36
10,Success,42,31,8,13,29
10,Success,49,23,3,12,37
10,Success,52,25,0,11,41
10,Success,45,27,6,14,31
10,Success,52,18,4,16,36
10,Success,43,33,0,10,33
10,Success,41,27,9,11,30
10,Success,39,27,1,23,16
10,Success,57,19,1,12,45
10,Success,50,30,0,10,40
10,Success,47,17,5,17,30
10,Success,43,26,9,13,30
10,Success,46,30,3,12,34
10,Success,51,27,0,13,38
10,Success,43,26,6,15,28
10,Success,51,25,1,12,39
10,Success,42,36,0,12,30
10,Success,47,26,3,16,31
10,Success,54,26,0,10,44
10,Success,40,33,5,16,24
10,Success,33,32,7,18,15
10,Success,47,28,0,14,33
10,Success,52,23,0,15,37
10,Success,42,32,3,12,30
10,Success,51,26,0,12,39
10,Success,54,17,1,14,40
10,Success,46,30,0,12,34
10,Success,54,29,0,10,44
10,Success,50,30,0,10,40
10,Success,45,24,8,13,32
10,Success,49,18,1,15,34
10,Success,50,22,1,13,37
10,Success,45,39,0,11,34
10,Success,48,24,4,13,35
10,Success,46,37,0,9,37
10,Success,52,19,0,13,39
10,Success,44,27,6,12,32
10,Success,48,33,0,10,38
10,Success,45,37,0,12,33
10,Success,54,31,0,7,47
10,Success,52,29,0,7,45
10,Success,49,28,3,8,41
10,Success,51,23,7,8,43
10,Success,51,28,0,12,39
10,Success,50,24,3,15,35
10,Success,53,24,0,10,43
10,Success,46,27,11,7,39
10,Success,45,26,1,16,29
10,Success,54,30,0,8,46
10,Success,43,35,0,14,29
10,Success,50,21,4,13,37
10,Success,47,33,0,8,39
10,Success,52,23,1,10,42
10,Success,50,27,0,8,42
10,Success,46,34,0,7,39
10,Success,42,33,1,12,30
10,Success,41,31,3,12,29
10,Success,41,38,0,13,28
10,Success,41,28,0,19,22
10,Success,52,21,0,17,35
10,Success,59,18,0,10,49
10,Success,62,21,2,6,56
10,Success,38,38,0,13,25
10,Success,48,22,1,14,34
10,Success,48,27,1,11,37
10,Success,44,24,10,12,32
10,Success,50,29,2,7,43
10,Success,52,24,0,14,38
10,Success,48,18,2,15,33
10,Success,51,30,0,9,42
10,Success,43,31,1,18,25
10,Success,46,33,0,16,30
10,Success,51,32,0,8,43
10,Success,44,29,0,16,28
10,Success,48,20,7,14,34
10,Success,45,32,0,14,31
10,Success,51,29,0,11,40
10,Success,49,23,3,10,39
10,Success,48,27,0,14,34
10,Success,41,33,0,17,24
10,Success,52,21,0,11,41
10,Success,52,27,1,11,41
10,Success,54,13,4,21,33
10,Success,50,34,0,9,41
10,Success,56,22,2,10,46
10,Success,51,27,5,6,45
10,Success,43,35,0,14,29
10,Success,41,30,8,13,28
10,Success,43,24,0,21,22
10,Success,44,29,1,17,27
10,Success,53,25,0,11,42
10,Success,49,25,3,14,35
10,Success,47,25,0,15,32
10,Success,40,29,4,18,22
10,Success,49,25,3,11,38
10,Success,46,27,0,14,32
10,Success,45,34,3,9,36
10,Success,51,25,4,10,41
10,Success,54,22,0,11,43
10,Success,53,24,0,18,35
10,Success,42,38,0,12,30
10,Success,46,27,0,14,32
10,Success,47,28,0,13,34
10,Success,54,23,2,8,46
10,Success,43,30,2,15,28
10,Success,44,28,7,14,30
10,Success,43,28,0,18,25
10,Success,52,30,2,8,44
10,Success,42,33,0,14,28
10,Success,55,17,0,15,40
10,Success,53,28,0,5,48
10,Success,44,25,0,18,26
10,Success,44,28,4,12,32
10,Success,46,28,4,14,32
10,Success,46,27,9,10,36
10,Success,46,34,0,11,35
10,Success,50,26,5,8,42
10,Success,49,20,7,13,36
10,Success,49,18,1,13,36
10,Success,50,25,3,13,37
10,Success,48,34,0,14,34
10,Success,55,21,4,11,44
10,Success,45,26,0,18,27
10,Success,55,26,0,11,44
10,Success,54,20,5,10,44
10,Success,45,25,1,19,26
10,Success,51,27,4,9,42
10,Success,46,22,0,23,23
10,Success,48,30,0,9,39
10,Success,50,33,0,10,40
10,Success,36,44,0,16,20
10,Success,51,23,0,12,39
10,Success,52,24,0,13,39
10,Success,51,27,4,9,42
10,Success,47,31,0,14,33
10,Success,49,28,0,12,37
10,Success,51,28,0,12,39
10,Success,50,26,0,7,43
10,Success,45,28,2,13,32
10,Success,42,33,0,11,31
10,Success,49,24,6,11,38
10,Success,46,25,6,13,33
10,Success,59,16,0,15,44
10,Success,55,24,0,10,45
10,Success,51,28,0,13,38
10,Success,52,19,3,16,36
10,Success,41,32,0,17,24
10,Success,43,38,0,14,29
10,Success,45,32,0,15,30
10,Success,54,17,2,14,40
10,Success,47,23,1,18,29
10,Success,55,24,0,10,45
10,Success,49,22,0,15,34
10,Success,45,34,0,15,30
10,Success,47,27,3,15,32
10,Success,47,30,0,13,34
10,Success,54,21,0,14,40
10,Success,49,34,0,8,41
10,Success,45,30,0,13,32
10,Success,36,34,0,17,19
10,Success,50,21,1,15,35
10,Success,49,31,0,10,39
10,Success,49,27,7,11,38
10,Success,54,22,1,5,49
10,Success,52,25,0,10,42
10,Success,49,29,0,11,38
10,Success,51,24,1,10,41
10,Success,52,21,1,13,39
10,Success,47,26,0,13,34
10,Success,47,26,5,10,37
10,Success,50,31,0,9,41
10,Success,48,23,0,16,32
10,Success,40,37,0,14,26
10,Success,42,36,0,14,28
10,Success,60,19,4,8,52
10,Success,53,26,0,9,44
10,Success,50,26,2,13,37
10,Success,44,28,0,17,27
10,Success,49,30,0,11,38
10,Success,42,24,10,14,28
10,Success,52,21,5,13,39
10,Success,53,20,8,9,44
10,Success,50,25,0,15,35
10,Success,51,24,0,14,37
10,Success,51,23,4,11,40
10,Success,47,30,4,8,39
10,Success,50,24,0,15,35
10,Success,45,36,0,11,34
10,Success,55,23,1,6,49
10,Success,46,29,0,16,30
10,Success,48,28,3,9,39
10,Success,49,26,5,13,36
10,Success,40,27,3,20,20
10,Success,49,22,0,19,30
10,Success,45,30,0,14,31
10,Success,51,30,0,7,44
10,Success,44,27,0,18,26
10,Success,41,27,11,10,31
10,Success,45,26,2,14,31
10,Success,33,41,0,13,20
10,Success,42,32,0,17,25
10,Success,51,23,3,14,37
10,Success,50,35,0,5,45
10,Success,58,18,3,11,47
10,Success,53,25,2,7,46
10,Success,51,26,0,13,38
10,Success,53,25,0,12,41
10,Success,53,24,0,11,42
10,Success,53,19,5,13,40
10,Success,56,20,3,11,45
10,Success,47,23,0,19,28
10,Success,43,30,2,17,26
10,Success,42,31,2,11,31
10,Success,47,32,1,12,35
10,Success,48,26,2,14,34
10,Success,45,32,0,14,31
10,Success,53,30,0,8,45
10,Success,41,32,0,18,23
10,Success,46,28,0,12,34
10,Success,46,35,0,8,38
10,Success,43,27,8,16,27
10,Success,44,28,1,13,31
10,Success,55,23,0,10,45
10,Success,52,24,2,10,42
10,Success,54,20,0,13,41
10,Success,52,26,0,15,37
10,Success,48,21,10,13,35
10,Success,44,33,5,13,31
10,Success,47,29,3,11,36
10,Success,45,25,7,15,30
10,Success,55,29,0,8,47
10,Success,45,29,0,16,29
10,Success,41,30,0,17,24
10,Success,48,29,0,10,38
10,Success,47,27,2,17,30
10,Success,46,22,0,19,27
10,Success,49,24,6,12,37
10,Success,56,21,3,10,46
10,Success,42,34,2,10,32
10,Success,53,25,0,11,42
10,Success,50,25,5,13,37
10,Success,46,34,1,7,39
10,Success,44,29,8,13,31
10,Success,48,30,0,10,38
10,Success,43,40,0,8,35
10,Success,51,22,0,18,33
10,Success,50,22,0,12,38
10,Success,61,17,0,11,50
10,Success,51,23,0,13,38
10,Success,47,26,5,9,38
10,Success,55,25,4,8,47
10,Success,52,22,3,12,40
10,Success,41,38,0,14,27
10,Success,45,18,10,19,26
10,Success,51,25,1,8,43
10,Success,52,24,5,8,44
10,Success,52,24,1,12,40
10,Success,46,27,5,13,33
10,Success,47,24,4,15,32
10,Success,52,32,0,8,44
10,Success,53,21,0,13,40
10,Success,52,22,0,15,37
10,Success,39,35,2,16,23
10,Success,50,23,1,14,36
10,Success,51,23,0,15,36
10,Success,50,23,0,13,37
10,Success,40,37,0,15,25
10,Success,45,24,6,12,33
10,Success,48,28,3,10,38
10,Success,54,28,2,10,44
10,Success,38,33,0,16,22
10,Success,58,24,0,7,51
10,Success,57,21,1,15,42
10,Success,44,31,1,13,31
10,Success,47,27,6,12,35
10,Success,42,28,5,16,26
10,Success,48,28,0,12,36
10,Success,49,28,0,15,34
10,Success,48,28,0,12,36
10,Success,44,25,1,18,26
10,Success,45,27,5,14,31
10,Success,56,20,3,7,49
10,Success,40,30,6,19,21
10,Success,39,37,0,15,24
10,Success,47,25,0,17,30
10,Success,46,23,0,18,28
10,Success,55,25,0,9,46
10,Success,49,28,0,12,37
10,Success,44,33,0,13,31
10,Success,51,25,0,13,38
10,Success,47,29,0,15,32
10,Success,54,31,0,7,47
10,Success,46,25,1,16,30
10,Success,49,31,0,9,40
10,Success,48,33,0,7,41
10,Success,48,21,6,10,38
10,Success,56,23,0,10,46
10,Success,41,28,4,16,25
10,Success,43,34,6,11,32
10,Success,54,19,0,15,39
10,Success,47,25,0,18,29
10,Success,52,26,5,8,44
10,Success,50,23,1,14,36
10,Success,48,23,10,12,36
10,Success,51,24,4,11,40
10,Success,50,25,5,10,40
10,Success,43,27,1,17,26
10,Success,38,44,0,11,27
10,Success,48,28,0,14,34
10,Success,45,20,0,24,21
10,Success,54,19,2,10,44
10,Success,47,37,2,7,40
10,Success,55,22,7,9,46
10,Success,56,21,0,12,44
10,Success,46,34,0,7,39
10,Success,40,42,6,7,33
10,Success,51,23,3,14,37
10,Success,52,24,4,12,40
10,Success,37,41,0,11,26
10,Success,52,16,2,18,34
10,Success,49,33,0,9,40
10,Success,45,36,0,16,29
10,Success,56,23,0,9,47
10,Success,38,32,1,18,20
10,Success,49,29,0,12,37
10,Success,45,24,8,13,32
10,Success,47,20,9,16,31
10,Success,52,29,4,4,48
10,Success,43,34,0,11,32
10,Success,44,29,0,18,26
10,Success,54,20,0,17,37
10,Success,45,29,0,12,33
10,Success,48,30,0,8,40
10,Success,44,31,7,11,33
10,Success,51,23,0,15,36
10,Success,43,38,0,9,34
10,Success,49,17,0,22,27
10,Success,51,29,0,10,41
10,Success,46,28,0,15,31
10,Success,46,28,0,12,34
10,Success,44,24,6,12,32
10,Success,53,24,2,11,42
10,Success,52,26,1,9,43
10,Success,51,32,0,6,45
10,Success,48,32,0,8,40
10,Success,46,27,0,15,31
10,Success,41,37,0,12,29
10,Success,48,28,0,11,37
10,Success,59,17,0,10,49
10,Success,49,30,0,9,40
10,Success,49,23,5,17,32
10,Success,52,21,0,16,36
10,Success,53,26,0,8,45
10,Success,47,30,0,12,35
10,Success,47,32,0,11,36
10,Success,54,17,2,17,37
10,Success,53,24,1,11,42
10,Success,42,35,0,11,31
10,Success,51,29,0,12,39
10,Success,49,27,0,14,35
10,Success,45,26,2,18,27
10,Success,46,26,6,9,37
10,Success,46,28,0,13,33
10,Success,45,23,10,13,32
10,Success,48,30,0,11,37
10,Success,50,26,0,11,39
10,Success,44,33,0,10,34
10,Success,53,25,0,9,44
10,Success,50,27,0,11,39
10,Success,51,23,0,16,35
10,Success,41,22,14,15,26
10,Success,41,39,0,8,33
10,Success,48,32,0,10,38
10,Success,42,30,4,13,29
10,Success,49,19,4,14,35
10,Success,44,33,3,9,35
10,Success,42,28,9,13,29
10,Success,39,29,3,16,23
10,Success,42,25,4,15,27
10,Success,52,27,1,12,40
10,Success,44,32,0,16,28
10,Success,49,33,0,10,39
10,Success,53,25,0,12,41
10,Success,57,19,0,8,49
10,Success,44,26,2,15,29
10,Success,50,23,0,15,35
10,Success,46,23,6,17,29
10,Success,54,17,3,13,41
10,Success,48,31,1,9,39
10,Success,50,25,4,13,37
10,Success,50,23,6,12,38
10,Success,47,24,0,15,32
10,Success,46,32,0,11,35
10,Success,50,26,1,13,37
10,Success,50,32,0,12,38
10,Success,50,30,0,14,36
10,Success,55,19,0,9,46
10,Success,48,28,0,15,33
10,Success,47,22,3,17,30
10,Success,50,25,2,11,39
10,Success,52,18,3,12,40
10,Success,43,38,0,13,30
10,Success,43,17,1,23,20
10,Success,50,31,0,10,40
10,Success,49,23,1,16,33
10,Success,49,19,6,16,33
10,Success,48,28,4,13,35
10,Success,47,26,0,18,29
10,Success,36,38,0,18,18
10,Success,43,28,3,13,30
10,Success,50,21,0,15,35
10,Success,45,23,0,19,26
10,Success,44,28,1,19,25
10,Success,46,32,0,14,32
10,Success,53,30,0,7,46
10,Success,57,18,3,11,46
10,Success,58,22,0,9,49
10,Success,50,29,0,12,38
10,Success,42,29,1,18,24
10,Success,48,30,0,12,36
10,Success,44,29,6,14,30
10,Success,45,24,9,10,35
10,Success,46,27,1,13,33
10,Success,44,37,0,10,34
10,Success,45,28,10,9,36
10,Success,47,25,1,10,37
10,Success,44,39,0,9,35
10,Success,52,21,4,8,44
10,Success,56,25,0,9,47
10,Success,48,20,1,17,31
10,Success,48,28,0,13,35
10,Success,39,39,0,14,25
10,Success,46,31,0,10,36
10,Success,45,37,0,10,35
10,Success,51,32,0,10,41
10,Success,52,21,0,16,36
10,Success,44,29,0,16,28
10,Success,50,23,0,14,36
10,Success,48,26,1,13,35
10,Success,55,22,0,8,47
10,Success,40,37,0,14,26
10,Success,51,26,0,8,43
10,Success,44,25,3,17,27
10,Success,47,28,0,19,28
10,Success,55,23,0,16,39
10,Success,57,18,0,8,49
10,Success,56,17,4,16,40
10,Success,58,21,0,8,50
10,Success,47,33,0,11,36
10,Success,46,23,2,18,28
10,Success,45,27,0,17,28
10,Success,51,24,2,10,41
10,Success,55,24,2,6,49
10,Success,50,24,3,12,38
10,Success,53,24,0,10,43
10,Success,49,23,1,14,35
10,Success,52,19,3,17,35
10,Success,53,17,2,15,38
10,Success,42,36,0,13,29
10,Success,42,23,0,25,17
10,Success,49,20,12,13,36
10,Success,44,26,0,12,32
10,Success,48,20,2,16,32
10,Success,54,22,1,10,44
10,Success,49,20,10,13,36
10,Success,55,22,0,12,43
10,Success,56,27,0,8,48
10,Success,46,29,0,13,33
10,Success,49,27,0,14,35
10,Success,43,26,5,18,25
10,Success,52,27,6,7,45
10,Success,46,30,4,10,36
10,Success,53,30,0,10,43
10,Success,43,26,3,16,27
10,Success,54,17,5,11,43
10,Success,61,20,0,9,52
10,Success,48,28,0,12,36
10,Success,42,32,3,16,26
10,Success,57,25,0,10,47
10,Success,40,35,0,18,22
10,Success,48,29,3,7,41
10,Success,51,24,1,15,36
10,Success,52,25,4,7,45
10,Success,51,23,0,16,35
10,Success,48,24,0,16,32
10,Success,42,34,3,14,28
10,Success,53,28,0,12,41
10,Success,42,31,0,17,25
10,Success,46,25,0,16,30
10,Success,51,22,0,17,34
10,Success,41,34,5,13,28
10,Success,51,24,0,13,38
10,Success,51,28,0,10,41
10,Success,49,31,0,10,39
10,Success,51,26,0,10,41
10,Success,41,30,5,12,29
10,Success,47,27,4,13,34
10,Success,42,28,1,21,21
10,Success,50,29,0,16,34
10,Success,58,20,0,10,48
10,Success,48,21,0,16,32
10,Success,45,31,4,11,34
10,Success,49,24,1,17,32
10,Success,48,23,5,15,33
10,Success,49,36,0,4,45
10,Success,51,24,4,10,41
10,Success,54,21,0,13,41
10,Success,52,19,6,14,38
10,Success,45,21,4,19,26
10,Success,47,25,0,15,32
10,Success,54,25,0,11,43
10,Success,51,23,6,10,41
10,Success,50,32,0,8,42
10,Success,53,22,0,13,40
10,Success,48,26,11,7,41
10,Success,49,25,0,15,34
10,Success,48,24,0,16,32
10,Success,47,22,4,14,33
10,Success,49,31,0,9,40
10,Success,47,20,6,19,28
10,Success,51,26,0,10,41
10,Success,46,33,0,15,31
10,Success,42,25,9,13,29
10,Success,45,31,3,10,35
10,Success,57,22,0,9,48
10,Success,49,35,0,7,42
10,Success,44,36,0,9,35
10,Success,58,19,3,8,50
10,Success,40,37,0,16,24
10,Success,45,32,2,13,32
10,Success,42,34,0,10,32
10,Success,44,31,3,12,32
10,Success,42,31,0,15,27
10,Success,43,20,6,21,22
10,Success,44,24,0,19,25
10,Success,43,22,5,14,29
10,Success,54,18,2,14,40
10,Success,48,28,0,10,38
10,Success,46,36,0,11,35
10,Success,45,33,0,11,34
10,Success,42,37,0,12,30
10,Success,43,31,8,11,32
10,Success,52,26,4,7,45
10,Success,52,24,0,12,40
10,Success,46,38,0,8,38
10,Success,49,31,1,8,41
10,Success,48,28,5,9,39
10,Success,49,31,0,11,38
10,Success,41,31,4,16,25
10,Success,47,26,0,17,30
10,Success,40,32,0,18,22
10,Success,39,30,6,18,21
10,Success,51,23,1,11,40
10,Success,48,33,0,11,37
10,Success,50,24,0,16,34
10,Success,44,31,2,14,30
10,Success,44,33,0,13,31
10,Success,46,26,7,11,35
10,Success,49,28,0,10,39
10,Success,50,28,1,9,41
10,Success,52,28,0,10,42
10,Success,42,27,6,19,23
10,Success,38,36,0,18,20
10,Success,53,21,2,9,44
10,Success,51,23,1,13,38
10,Success,57,28,0,5,52
10,Success,49,35,0,6,43
10,Success,48,28,3,12,36
10,Success,47,31,0,15,32
10,Success,47,23,3,15,32
10,Success,45,26,1,18,27
10,Success,43,35,0,16,27
10,Success,46,19,0,25,21
10,Success,47,26,2,13,34
10,Success,48,21,3,15,33
10,Success,40,31,7,15,25
10,Success,53,23,5,11,42
10,Success,50,28,5,10,40
10,Success,53,20,2,13,40
10,Success,48,23,0,19,29
10,Success,43,33,1,16,27
10,Success,54,18,3,11,43
10,Success,53,28,2,7,46
10,Success,45,27,3,15,30
10,Success,50,23,0,12,38
10,Success,52,19,3,14,38
10,Success,49,23,0,14,35
10,Success,38,31,0,25,13
10,Success,42,34,7,7,35
10,Success,47,29,2,10,37
10,Success,44,32,4,12,32
10,Success,49,32,0,7,42
10,Success,53,26,0,9,44
10,Success,50,23,2,14,36
10,Success,41,33,12,7,34
10,Success,49,27,0,13,36
10,Success,47,20,6,16,31
10,Success,42,27,8,14,28
10,Success,54,26,0,9,45
10,Success,42,23,5,20,22
10,Success,45,32,0,12,33
10,Success,50,24,7,10,40
10,Success,54,22,0,14,40
10,Success,53,27,3,8,45
10,Success,48,38,0,8,40
10,Success,46,26,0,16,30
10,Success,45,36,0,9,36
10,Success,58,14,3,11,47
10,Success,50,30,0,6,44
10,Success,45,30,0,14,31
10,Success,59,21,3,10,49
10,Success,41,31,0,17,24
10,Success,53,25,0,10,43
10,Success,49,30,0,9,40
10,Success,57,26,0,9,48
10,Success,45,28,4,12,33
10,Success,45,31,0,13,32
10,Success,49,26,6,8,41
10,Success,48,32,0,7,41
10,Success,51,28,3,5,46
10,Success,43,26,11,12,31
10,Success,50,26,3,9,41
10,Success,52,22,2,10,42
10,Success,45,36,0,10,35
10,Success,50,27,0,16,34
10,Success,44,30,0,15,29
10,Success,49,24,0,16,33
10,Success,44,31,0,17,27
10,Success,43,35,0,17,26
10,Success,40,35,6,11,29
10,Success,52,23,2,13,39
10,Success,52,26,0,8,44
10,Success,54,15,6,12,42
10,Success,43,28,2,20,23
10,Success,50,24,4,13,37
10,Success,50,24,3,12,38
10,Success,48,25,3,14,34
10,Success,38,33,0,16,22
10,Success,45,31,0,10,35
10,Success,55,26,1,9,46
10,Success,49,22,0,16,33
10,Success,49,24,0,11,38
10,Success,51,23,0,16,35
10,Success,46,22,2,16,30
10,Success,46,27,0,19,27
10,Success,43,30,3,14,29
10,Success,47,32,2,7,40
10,Success,48,26,2,11,37
10,Success,43,29,0,19,24
10,Success,47,23,0,17,30
10,Success,52,32,0,10,42
10,Success,46,33,6,11,35
10,Success,45,35,0,9,36
10,Success,46,31,0,11,35
10,Success,50,29,0,9,41
10,Success,41,31,0,18,23
10,Success,50,26,0,14,36
10,Success,52,26,0,12,40
10,Success,50,31,1,10,40
10,Success,53,19,5,13,40
10,Success,53,26,0,10,43
10,Success,45,30,0,12,33
10,Success,55,15,5,14,41
10,Success,49,22,0,16,33
10,Success,47,30,0,14,33
10,Success,45,28,0,13,32
10,Success,43,36,0,13,30
10,Success,43,30,0,17,26
10,Success,51,20,1,17,34
10,Success,48,24,0,11,37
10,Success,51,24,3,10,41
10,Success,52,24,6,14,38
10,Success,49,25,2,15,34
10,Success,50,26,6,9,41
10,Success,41,29,2,15,26
10,Success,51,26,6,10,41
10,Success,42,35,4,11,31
10,Success,47,25,2,14,33
10,Success,35,47,0,17,18
10,Success,56,19,6,8,48
10,Success,46,37,0,7,39
10,Success,50,21,0,17,33
10,Success,37,25,0,25,12
10,Success,54,22,5,7,47
10,Success,46,29,4,11,35
10,Success,47,25,6,9,38
10,Success,46,23,3,19,27
10,Success,52,23,3,10,42
10,Success,46,28,1,15,31
10,Success,52,22,0,14,38
10,Success,52,19,6,13,39
10,Success,47,29,2,9,38
10,Success,49,32,0,10,39
10,Success,50,32,1,8,42
10,Success,52,24,0,12,40
10,Success,48,26,0,13,35
10,Success,43,37,0,13,30
10,Success,47,21,8,15,32
10,Success,56,22,2,7,49
10,Success,44,37,0,9,35
10,Success,46,28,0,15,31
10,Success,50,30,2,10,40
10,Success,40,36,0,13,27
10,Success,42,26,6,18,24
10,Success,44,30,0,16,28
10,Success,41,38,0,12,29
10,Success,40,33,0,20,20
10,Success,54,20,4,12,42
10,Success,47,30,0,14,33
10,Success,47,27,8,10,37
10,Success,47,30,4,12,35
10,Success,57,15,2,11,46
10,Success,50,26,0,17,33
10,Success,46,29,0,15,31
10,Success,51,30,0,12,39
10,Success,45,25,10,11,34
10,Success,55,24,0,11,44
10,Success,47,29,0,12,35
10,Success,56,15,3,13,43
10,Success,50,23,0,13,37
10,Success,53,23,0,13,40
10,Success,52,22,0,15,37
10,Success,48,22,4,17,31
10,Success,50,25,0,12,38
10,Success,50,16,0,20,30
10,Success,44,25,0,19,25
10,Success,46,26,3,11,35
10,Success,48,28,0,14,34
10,Success,44,30,3,12,32
10,Success,41,38,3,9,32
10,Success,46,37,0,12,34
10,Success,51,21,0,15,36
10,Success,54,28,1,7,47
10,Success,54,27,0,8,46
10,Success,47,20,4,20,27
10,Success,47,30,4,9,38
10,Success,52,25,0,12,40
10,Success,48,28,2,14,34
10,Success,47,29,0,13,34
10,Success,43,25,12,12,31
10,Success,51,29,0,12,39
10,Success,45,19,3,19,26
10,Success,40,37,0,15,25
10,Success,43,34,0,13,30
10,Success,45,24,4,16,29
10,Success,54,22,0,15,39
10,Success,51,17,5,13,38
10,Success,47,27,5,12,35
10,Success,48,29,0,11,37
10,Success,51,20,4,13,38
10,Success,48,24,7,9,39
10,Success,41,32,0,15,26
10,Success,53,24,0,11,42
10,Success,50,24,0,15,35
10,Success,48,28,0,11,37
10,Success,46,36,0,13,33
10,Success,42,34,0,13,29
10,Success,53,19,6,13,40
10,Success,46,29,0,14,32
10,Success,48,28,5,11,37
10,Success,48,25,0,12,36
10,Success,44,31,0,14,30
10,Success,45,27,2,12,33
10,Success,53,20,1,12,41
10,Success,50,23,4,14,36
10,Success,44,29,0,15,29
10,Success,53,26,2,9,44
10,Success,53,28,0,5,48
10,Success,45,20,8,16,29
10,Success,58,25,0,6,52
10,Success,47,32,0,8,39
10,Success,48,28,6,7,41
10,Success,48,25,1,17,31
10,Success,53,27,0,14,39
10,Success,52,27,0,10,42
10,Success,47,34,0,12,35
10,Success,49,29,0,10,39
10,Success,48,32,7,5,43
10,Success,44,35,0,11,33
10,Success,53,25,1,11,42
10,Success,55,18,0,13,42
10,Success,49,26,0,13,36
10,Success,49,32,0,13,36
10,Success,51,21,0,18,33
10,Success,49,30,4,9,40
10,Success,54,30,0,5,49
10,Success,49,19,6,17,32
10,Success,37,35,0,17,20
10,Success,56,21,1,10,46
10,Success,51,26,0,10,41
10,Success,44,23,9,16,28
10,Success,54,27,0,10,44
10,Success,48,24,8,10,38
10,Success,44,29,0,17,27
10,Success,48,27,5,9,39
10,Success,44,31,4,13,31
10,Success,51,24,3,15,36
10,Success,48,27,0,14,34
10,Success,49,26,5,10,39
10,Success,46,27,6,11,35
10,Success,55,16,1,13,42
10,Success,44,26,1,16,28
10,Success,52,22,5,11,41
10,Success,46,28,0,16,30
10,Success,55,25,0,13,42
10,Success,48,32,0,9,39
10,Success,47,26,0,17,30
10,Success,55,20,1,12,43
10,Success,36,34,7,12,24
10,Success,50,21,2,14,36
10,Success,47,36,0,11,36
10,Success,41,38,0,12,29
10,Success,39,32,3,17,22
10,Success,55,23,0,12,43
10,Success,44,21,7,21,23
10,Success,54,25,0,9,45
10,Success,49,24,0,12,37
10,Success,57,18,0,15,42
10,Success,61,16,0,11,50
10,Success,44,36,0,14,30
10,Success,57,25,0,9,48
10,Success,46,25,0,19,27
10,Success,53,19,2,13,40
10,Success,49,26,1,13,36
10,Success,56,26,0,8,48
10,Success,44,26,8,13,31
10,Success,50,17,9,15,35
10,Success,49,26,0,14,35
10,Success,52,31,0,9,43
10,Success,46,34,0,11,35
10,Success,49,20,9,12,37
10,Success,43,23,0,23,20
10,Success,51,17,3,14,37
10,Success,51,25,7,8,43
10,Success,40,31,0,16,24
10,Success,51,22,0,13,38
10,Success,49,26,0,14,35
10,Success,41,36,0,13,28
10,Success,48,24,7,12,36
10,Success,47,25,5,14,33
10,Success,47,21,12,10,37
10,Success,52,23,0,12,40
10,Success,58,20,0,10,48
10,Success,52,23,1,11,41
10,Success,47,32,0,8,39
10,Success,44,30,4,11,33
10,Success,46,30,0,16,30
10,Success,50,23,0,15,35
10,Success,53,22,2,13,40
10,Success,54,19,3,15,39
10,Success,40,29,4,16,24
10,Success,41,26,4,20,21
10,Success,49,25,0,15,34
10,Success,42,33,0,11,31
10,Success,38,31,6,17,21
10,Success,50,30,2,7,43
10,Success,44,34,0,13,31
10,Success,45,32,1,12,33
10,Success,50,31,0,12,38
10,Success,50,19,5,16,34
10,Success,51,18,9,14,37
10,Success,41,31,0,16,25
10,Success,49,20,7,11,38
10,Success,51,22,1,12,39
10,Success,48,25,3,11,37
10,Success,40,29,15,9,31
10,Success,46,27,0,20,26
10,Success,46,26,5,15,31
10,Success,49,27,0,13,36
10,Success,50,23,7,11,39
10,Success,51,26,0,8,43
10,Success,54,19,0,13,41
10,Success,44,23,11,15,29
10,Success,54,26,0,12,42
10,Success,46,28,4,12,34
10,Success,51,19,0,15,36
10,Success,55,29,0,8,47
10,Success,45,28,8,14,31
10,Success,40,30,0,18,22
10,Success,47,28,0,11,36
10,Success,57,20,2,9,48
10,Success,44,30,0,16,28
10,Success,53,28,0,8,45
10,Success,44,34,0,13,31
10,Success,48,28,0,14,34
10,Success,57,24,0,13,44
10,Success,42,40,0,7,35
10,Success,44,25,10,10,34
10,Success,57,21,0,8,49
10,Success,48,26,6,11,37
10,Success,40,34,0,18,22
10,Success,54,25,1,10,44
10,Success,48,25,0,17,31
10,Success,48,27,2,10,38
10,Success,48,32,0,11,37
10,Success,46,21,1,17,29
10,Success,48,34,0,6,42
10,Success,54,23,2,11,43
10,Success,44,30,2,11,33
10,Success,45,35,0,10,35
10,Success,54,25,1,8,46
10,Success,51,23,3,10,41
10,Success,42,30,10,14,28
10,Success,43,32,0,12,31
10,Success,52,25,0,10,42
10,Success,49,22,8,10,39
10,Success,49,29,0,14,35
10,Success,55,22,2,12,43
10,Success,42,31,0,17,25
10,Success,53,25,0,10,43
10,Success,43,27,7,18,25
10,Success,51,27,6,6,45
10,Success,54,20,5,11,43
10,Success,53,26,3,9,44
10,Success,46,29,0,14,32
10,Success,52,22,0,19,33
10,Success,50,26,5,10,40
10,Success,51,23,0,14,37
10,Success,49,34,0,10,39
10,Success,47,28,2,16,31
10,Success,49,18,5,18,31
10,Success,47,26,0,12,35
10,Success,55,23,0,9,46
10,Success,48,28,0,11,37
10,Success,61,18,2,9,52
10,Success,48,26,0,15,33
10,Success,40,27,8,16,24
10,Success,48,27,0,17,31
10,Success,56,20,0,10,46
10,Success,51,21,3,14,37
10,Success,44,29,3,11,33
10,Success,52,21,0,14,38
10,Success,38,23,8,24,14
10,Success,56,25,0,7,49
10,Success,54,23,0,12,42
10,Success,44,29,0,19,25
10,Success,42,23,10,14,28
10,Success,46,27,6,11,35
10,Success,53,16,1,14,39
10,Success,52,31,5,9,43
10,Success,43,34,0,14,29
10,Success,57,17,9,9,48
10,Success,45,32,0,13,32
10,Success,44,22,0,18,26
10,Success,49,32,0,8,41
10,Success,46,30,4,10,36
10,Success,54,26,0,12,42
10,Success,48,37,0,11,37
10,Success,55,24,0,12,43
10,Success,50,28,0,11,39
10,Success,48,25,0,14,34
10,Success,61,15,4,6,55
10,Success,48,24,2,17,31
10,Success,43,28,0,15,28
10,Success,53,22,0,13,40
10,Success,48,32,0,11,37
10,Success,52,26,2,6,46
10,Success,44,39,0,8,36
10,Success,51,20,2,17,34
10,Success,41,28,0,18,23
10,Success,51,21,0,15,36
10,Success,45,28,4,16,29
10,Success,42,23,0,21,21
10,Success,49,25,13,9,40
10,Success,47,29,5,10,37
10,Success,47,31,7,8,39
10,Success,45,30,0,15,30
10,Success,55,31,0,7,48
10,Success,40,28,2,14,26
10,Success,43,31,0,13,30
10,Success,43,42,0,4,39
10,Success,56,19,1,10,46
10,Success,53,24,0,12,41
10,Success,43,26,3,15,28
10,Success,57,19,2,12,45
10,Success,45,36,0,9,36
10,Success,56,25,0,10,46
10,Success,43,29,0,13,30
10,Success,51,27,0,7,44
10,Success,49,26,0,14,35
10,Success,49,22,7,10,39
10,Success,45,31,0,15,30
10,Success,54,29,0,5,49
10,Success,49,27,8,12,37
10,Success,44,37,0,11,33
10,Success,41,36,0,14,27
10,Success,43,32,0,15,28
10,Success,52,28,0,9,43
10,Success,52,27,1,8,44
10,Success,51,22,0,14,37
10,Success,49,30,0,10,39
10,Success,47,26,0,12,35
10,Success,42,24,0,26,16
10,Success,57,25,0,6,51
10,Success,46,21,0,21,25
10,Success,42,34,0,13,29
10,Success,39,36,0,15,24
10,Success,47,20,0,17,30
10,Success,46,32,0,11,35
10,Success,44,33,0,14,30
10,Success,46,30,6,10,36
10,Success,51,28,3,8,43
10,Success,53,23,3,15,38
10,Success,56,25,0,5,51
10,Success,50,21,3,10,40
10,Success,50,28,0,12,38
10,Success,41,35,3,14,27
10,Success,49,25,2,12,37
10,Success,52,33,0,3,49
10,Success,50,28,0,10,40
10,Success,48,31,0,11,37
10,Success,44,25,1,13,31
10,Success,43,42,0,9,34
10,Success,48,28,0,10,38
10,Success,41,25,13,12,29
10,Success,48,25,4,12,36
10,Success,57,16,2,17,40
10,Success,50,22,4,14,36
10,Success,38,33,0,17,21
10,Success,39,26,0,25,14
10,Success,47,26,8,11,36
10,Success,48,21,0,15,33
10,Success,48,25,0,16,32
10,Success,49,27,7,10,39
10,Success,51,23,2,14,37
10,Success,47,27,0,14,33
10,Success,47,31,0,15,32
10,Success,48,24,6,8,40
10,Success,45,28,10,8,37
10,Success,54,22,4,14,40
10,Success,47,25,0,14,33
10,Success,45,29,0,12,33
10,Success,47,21,2,17,30
10,Success,47,26,0,11,36
10,Success,55,23,5,8,47
10,Success,55,19,3,12,43
10,Success,49,28,2,12,37
10,Success,45,27,3,14,31
10,Success,53,19,8,13,40
10,Success,41,31,3,18,23
10,Success,52,23,1,13,39
10,Success,42,38,0,15,27
10,Success,46,35,1,8,38
10,Success,51,24,2,14,37
10,Success,51,28,0,11,40
10,Success,52,29,2,7,45
10,Success,46,32,0,17,29
10,Success,43,33,0,14,29
10,Success,47,25,3,15,32
10,Success,41,34,0,15,26
10,Success,43,31,0,17,26
10,Success,46,32,0,10,36
10,Success,51,25,1,13,38
10,Success,46,27,9,11,35
10,Success,49,29,0,8,41
10,Success,42,32,0,14,28
10,Success,55,24,0,12,43
10,Success,57,15,4,14,43
10,Success,45,26,6,12,33
10,Success,42,26,2,16,26
10,Success,55,24,0,7,48
10,Success,54,24,2,11,43
10,Success,41,34,0,18,23
10,Success,47,26,0,19,28
10,Success,51,20,0,18,33
10,Success,44,35,1,10,34
10,Success,48,31,0,10,38
10,Success,57,14,2,11,46
10,Success,50,27,0,15,35
10,Success,52,22,4,12,40
10,Success,45,38,0,7,38
10,Success,53,26,0,11,42
10,Success,57,18,9,9,48
10,Success,48,34,0,8,40
10,Success,54,25,0,12,42
10,Success,44,25,5,15,29
10,Success,50,22,8,10,40
10,Success,56,25,0,9,47
10,Success,47,28,6,9,38
10,Success,47,32,0,14,33
10,Success,52,22,2,11,41
10,Success,45,28,0,14,31
10,Success,47,25,10,8,39
10,Success,48,29,1,8,40
10,Success,50,28,0,11,39
10,Success,50,28,0,10,40
10,Success,51,24,2,11,40
10,Success,50,26,0,14,36
10,Success,44,23,13,12,32
10,Success,50,33,0,11,39
10,Success,46,29,1,8,38
10,Success,43,28,5,13,30
10,Success,40,29,7,11,29
10,Success,50,17,14,12,38
10,Success,42,30,0,21,21
10,Success,41,38,0,12,29
10,Success,47,26,0,14,33
10,Success,50,19,3,17,33
10,Success,44,39,0,11,33
10,Success,46,27,6,10,36
10,Success,49,28,0,11,38
10,Success,47,22,5,18,29
10,Success,42,27,4,20,22
10,Success,46,25,0,16,30
10,Success,51,22,0,17,34
10,Success,58,22,0,13,45
10,Success,50,24,0,15,35
10,Success,52,27,0,11,41
10,Success,51,29,1,7,44
10,Success,45,31,0,12,33
10,Success,50,28,0,11,39
10,Success,46,28,2,15,31
10,Success,43,37,0,11,32
10,Success,54,13,5,16,38
10,Success,51,30,0,8,43
10,Success,41,30,3,15,26
10,Success,45,35,0,8,37
10,Success,54,31,0,8,46
10,Success,52,21,2,14,38
10,Success,50,30,0,8,42
10,Success,56,25,0,11,45
10,Success,51,18,10,13,38
10,Success,43,28,4,14,29
10,Success,47,28,0,15,32
10,Success,53,24,0,11,42
10,Success,54,19,0,15,39
10,Success,48,27,0,13,35
10,Success,55,22,0,11,44
10,Success,48,32,0,6,42
10,Success,47,24,0,14,33
10,Success,48,25,4,16,32
10,Success,51,21,0,14,37
10,Success,47,27,3,11,36
10,Success,46,32,0,15,31
10,Success,49,31,0,13,36
10,Success,45,31,0,13,32
10,Success,48,29,0,16,32
10,Success,53,22,2,9,44
10,Success,40,41,0,11,29
10,Success,44,27,8,10,34
10,Success,49,24,1,16,33
10,Success,45,24,10,11,34
10,Success,47,32,0,11,36
10,Success,47,20,12,13,34
10,Success,42,34,0,14,28
10,Success,46,35,0,12,34
10,Success,44,32,0,15,29
10,Success,50,28,1,9,41
10,Success,51,22,1,11,40
10,Success,50,18,2,19,31
10,Success,51,18,4,17,34
10,Success,51,23,1,15,36
10,Success,54,20,0,14,40
10,Success,50,21,3,14,36
10,Success,44,30,0,18,26
10,Success,47,27,0,16,31
10,Success,48,26,8,9,39
10,Success,51,21,8,11,40
10,Success,52,20,1,11,41
10,Success,51,31,0,9,42
10,Success,54,23,0,11,43
10,Success,48,18,9,17,31
10,Success,40,34,3,14,26
10,Success,49,29,0,15,34
10,Success,44,34,0,14,30
10,Success,49,21,0,18,31
10,Success,53,23,1,13,40
10,Success,57,20,6,7,50
10,Success,52,19,4,14,38
10,Success,49,27,6,9,40
10,Success,49,29,0,11,38
10,Success,53,19,2,15,38
10,Success,42,31,0,20,22
10,Success,53,20,9,9,44
10,Success,53,20,0,15,38
10,Success,42,36,0,11,31
10,Success,47,25,9,13,34
10,Success,48,24,7,9,39
10,Success,45,19,1,23,22
10,Success,40,23,10,18,22
10,Success,46,31,0,14,32
10,Success,47,23,5,14,33
10,Success,52,32,0,9,43
10,Success,47,27,0,16,31
10,Success,42,33,6,11,31
10,Success,49,26,0,13,36
10,Success,56,26,0,7,49
10,Success,50,32,1,7,43
10,Success,51,30,0,9,42
10,Success,41,39,0,11,30
10,Success,38,33,2,17,21
10,Success,50,25,1,11,39
10,Success,50,23,2,15,35
10,Success,38,45,0,13,25
10,Success,50,30,0,11,39
10,Success,47,26,3,10,37
10,Success,52,28,0,12,40
10,Success,52,25,0,10,42
10,Success,48,28,3,12,36
10,Success,47,33,0,12,35
10,Success,49,32,0,13,36
10,Success,52,20,1,12,40
10,Success,49,27,0,12,37
10,Success,37,29,17,8,29
10,Success,54,17,3,12,42
10,Success,53,24,3,8,45
10,Success,46,28,1,14,32
10,Success,55,23,0,13,42
10,Success,46,27,0,15,31
10,Success,61,15,0,11,50
10,Success,42,28,7,12,30
10,Success,53,19,2,15,38
10,Success,46,22,3,13,33
10,Success,56,23,0,12,44
10,Success,48,30,2,13,35
10,Success,45,27,5,13,32
10,Success,40,35,0,12,28
10,Success,49,23,0,15,34
10,Success,48,24,3,11,37
10,Success,43,31,1,17,26
10,Success,45,34,0,14,31
10,Success,47,25,1,14,33
10,Success,45,33,4,10,35
10,Success,50,22,5,9,41
10,Success,47,29,0,12,35
10,Success,46,28,0,14,32
10,Success,48,24,0,17,31
10,Success,48,32,1,8,40
10,Success,49,26,9,7,42
10,Success,47,33,0,12,35
10,Success,52,19,1,16,36
10,Success,46,25,3,17,29
10,Success,46,25,5,14,32
10,Success,46,28,2,15,31
10,Success,41,29,9,13,28
10,Success,49,28,0,12,37
10,Success,47,30,0,12,35
10,Success,52,30,0,7,45
10,Success,57,21,1,8,49
10,Success,39,34,6,9,30
10,Success,56,25,0,10,46
10,Success,45,29,4,14,31
10,Success,46,29,2,14,32
10,Success,42,33,0,16,26
10,Success,45,30,0,11,34
10,Success,47,27,3,11,36
10,Success,50,22,5,13,37
10,Success,47,26,0,13,34
10,Success,45,21,10,14,31
10,Success,39,28,4,16,23
10,Success,53,29,0,6,47
10,Success,41,32,0,17,24
10,Success,50,32,5,5,45
10,Success,54,24,12,5,49
10,Success,52,19,2,12,40
10,Success,45,31,0,13,32
10,Success,44,38,0,12,32
10,Success,50,18,0,16,34
10,Success,46,32,4,10,36
10,Success,46,34,0,10,36
10,Success,48,29,0,10,38
10,Success,44,25,6,15,29
10,Success,51,19,0,17,34
10,Success,48,29,0,8,40
10,Success,59,20,0,7,52
10,Success,38,31,5,18,20
10,Success,52,23,6,10,42
10,Success,46,39,0,8,38
10,Success,44,34,0,11,33
10,Success,52,29,0,5,47
10,Success,44,28,11,11,33
10,Success,47,26,7,11,36
10,Success,39,29,6,19,20
10,Success,43,34,0,14,29
10,Success,50,23,7,13,37
10,Success,49,30,0,7,42
10,Success,45,30,7,11,34
10,Success,44,18,5,20,24
10,Success,44,32,0,13,31
10,Success,49,24,1,15,34
10,Success,47,32,0,13,34
10,Success,50,32,0,8,42
10,Success,51,22,8,11,40
10,Success,36,46,0,14,22
10,Success,51,20,9,11,40
10,Success,47,29,2,10,37
10,Success,49,23,0,15,34
10,Success,41,31,0,14,27
10,Success,40,41,0,11,29
10,Success,56,22,0,9,47
10,Success,39,30,5,16,23
10,Success,43,34,0,10,33
10,Success,49,23,0,17,32
10,Success,46,28,0,14,32
10,Success,48,31,0,12,36
10,Success,52,26,0,12,40
10,Success,54,25,0,11,43
10,Success,52,25,0,8,44
10,Success,49,20,4,13,36
10,Success,49,24,0,15,34
10,Success,49,22,0,15,34
10,Success,41,27,5,23,18
10,Success,43,27,3,15,28
10,Success,47,35,0,11,36
10,Success,39,36,0,19,20
10,Success,47,23,3,13,34
10,Success,49,27,3,10,39
10,Success,44,30,7,12,32
10,Success,47,29,0,12,35
10,Success,51,22,6,10,41
10,Success,46,30,3,10,36
10,Success,45,26,1,12,33
10,Success,47,28,0,15,32
10,Success,56,26,0,8,48
10,Success,47,22,5,14,33
10,Success,45,34,0,10,35
10,Success,48,25,0,16,32
10,Success,50,24,0,12,38
10,Success,47,28,0,12,35
10,Success,54,21,4,9,45
10,Success,52,24,5,11,41
10,Success,49,30,0,11,38
10,Success,44,25,11,12,32
10,Success,54,19,0,15,39
10,Success,51,26,0,12,39
10,Success,47,25,5,12,35
10,Success,43,36,0,10,33
10,Success,45,27,0,15,30
10,Success,50,29,0,8,42
10,Success,46,21,10,18,28
10,Success,51,28,0,12,39
10,Success,44,36,0,11,33
10,Success,45,31,1,13,32
10,Success,48,33,0,7,41
10,Success,46,26,0,11,35
10,Success,40,33,0,19,21
10,Success,41,35,0,12,29
10,Success,53,25,0,8,45
10,Success,47,24,3,14,33
10,Success,53,29,0,9,44
10,Success,45,29,0,16,29
10,Success,48,29,0,13,35
10,Success,44,24,3,21,23
10,Success,43,26,9,12,31
10,Success,52,32,0,9,43
10,Success,51,30,0,8,43
10,Success,46,23,7,16,30
10,Success,53,23,0,12,41
10,Success,57,21,0,10,47
10,Success,49,30,0,15,34
10,Success,48,25,2,17,31
10,Success,59,24,3,7,52
10,Success,50,28,0,12,38
10,Success,46,27,0,20,26
10,Success,47,24,10,14,33
10,Success,52,26,5,5,47
10,Success,56,21,1,9,47
10,Success,50,30,0,9,41
10,Success,47,32,0,10,37
10,Success,51,24,3,9,42
10,Success,46,28,3,13,33
10,Success,44,32,7,9,35
10,Success,41,27,0,22,19
10,Success,47,28,0,14,33
10,Success,57,17,0,15,42
10,Success,50,23,6,14,36
10,Success,57,26,3,5,52
10,Success,46,34,0,10,36
10,Success,45,32,0,12,33
10,Success,44,25,5,16,28
10,Success,52,31,0,8,44
10,Success,43,37,0,12,31
10,Success,51,27,0,13,38
10,Success,36,35,7,15,21
10,Success,50,33,0,4,46
10,Success,40,25,10,17,23
10,Success,53,19,5,10,43
10,Success,50,24,0,12,38
10,Success,45,35,0,10,35
10,Success,44,31,0,16,28
10,Success,43,31,0,14,29
10,Success,40,34,11,7,33
10,Success,50,28,0,12,38
10,Success,50,33,0,12,38
10,Success,46,23,4,14,32
10,Success,50,34,0,6,44
10,Success,41,42,0,9,32
10,Success,52,23,0,16,36
10,Success,45,26,0,17,28
10,Success,51,25,2,12,39
10,Success,53,21,3,14,39
10,Success,42,29,5,18,24
10,Success,43,28,3,17,26
10,Success,51,29,0,10,41
10,Success,52,22,4,11,41
10,Success,44,33,2,9,35
10,Success,43,31,2,15,28
10,Success,44,28,0,16,28
10,Success,49,24,0,20,29
10,Success,48,28,2,15,33
10,Success,45,34,2,11,34
10,Success,38,34,0,16,22
10,Success,47,27,0,17,30
10,Success,52,25,0,14,38
10,Success,47,25,3,10,37
10,Success,49,35,0,10,39
10,Success,58,19,1,12,46
10,Success,58,20,0,8,50
10,Success,48,28,0,14,34
10,Success,51,24,0,11,40
10,Success,52,27,1,10,42
10,Success,53,22,3,11,42
10,Success,49,25,3,8,41
10,Success,51,22,2,13,38
10,Success,54,21,1,13,41
10,Success,53,26,0,9,44
10,Success,60,17,0,11,49
10,Success,43,24,8,16,27
10,Success,49,31,0,11,38
10,Success,42,33,0,12,30
10,Success,54,27,0,6,48
10,Success,43,25,2,22,21
10,Success,46,24,6,16,30
10,Success,46,31,0,10,36
10,Success,51,23,0,16,35
10,Success,46,28,5,11,35
10,Success,45,33,0,11,34
10,Success,46,22,3,16,30
10,Success,44,32,0,14,30
10,Success,47,27,3,10,37
10,Success,42,30,0,17,25
10,Success,54,23,0,18,36
10,Success,49,25,0,15,34
10,Success,49,26,0,12,37
10,Success,44,33,0,14,30
10,Success,45,32,6,11,34
10,Success,47,28,0,16,31
10,Success,46,27,6,15,31
10,Success,50,25,1,13,37
10,Success,45,35,0,14,31
10,Success,44,28,0,12,32
10,Success,52,17,0,20,32
10,Success,53,30,0,6,47
10,Success,48,26,2,12,36
10,Success,54,19,5,14,40
10,Success,55,25,0,12,43
10,Success,50,25,5,7,43
10,Success,45,36,0,10,35
10,Success,56,19,1,11,45
10,Success,51,27,0,12,39
10,Success,43,27,7,14,29
10,Success,51,23,0,13,38
10,Success,52,15,2,19,33
10,Success,49,26,0,13,36
10,Success,43,33,0,11,32
10,Success,53,16,0,14,39
10,Success,44,25,3,17,27
10,Success,47,29,5,11,36
10,Success,37,44,0,11,26
10,Success,43,28,9,13,30
10,Success,57,19,3,12,45
10,Success,52,26,0,9,43
10,Success,51,25,0,13,38
10,Success,53,20,0,16,37
10,Success,43,33,2,13,30
10,Success,46,31,0,12,34
10,Success,52,26,2,10,42
10,Success,50,29,2,11,39
10,Success,48,31,0,9,39
10,Success,45,35,0,9,36
10,Success,48,25,0,16,32
10,Success,39,35,12,9,30
10,Success,46,30,0,14,32
10,Success,42,26,4,17,25
10,Success,46,27,1,15,31
10,Success,45,24,3,19,26
10,Success,48,20,5,14,34
10,Success,50,29,0,11,39
10,Success,54,22,4,10,44
10,Success,46,29,0,13,33
10,Success,51,20,1,13,38
10,Success,47,25,4,15,32
10,Success,42,39,0,13,29
10,Success,52,16,0,22,30
10,Success,56,24,0,9,47
10,Success,50,29,0,8,42
10,Success,54,20,0,11,43
10,Success,47,24,0,15,32
10,Success,51,30,0,10,41
10,Success,61,18,0,10,51
10,Success,44,32,0,15,29
10,Success,53,21,2,14,39
10,Success,39,33,3,14,25
10,Success,37,41,0,14,23
10,Success,48,26,3,12,36
10,Success,54,15,2,17,37
10,Success,49,27,0,14,35
10,Success,45,25,0,16,29
10,Success,50,31,9,5,45
10,Success,49,25,4,10,39
10,Success,42,27,0,23,19
10,Success,57,24,1,8,49
10,Success,47,27,3,11,36
10,Success,52,17,11,13,39
10,Success,45,32,0,14,31
10,Success,43,24,2,17,26
10,Success,46,30,0,15,31
10,Success,48,19,5,20,28
10,Success,51,25,2,11,40
10,Success,50,23,0,17,33
10,Success,49,24,0,14,35
10,Success,50,23,1,14,36
10,Success,50,24,0,12,38
10,Success,49,21,0,18,31
10,Success,45,26,9,7,38
10,Success,46,28,7,10,36
10,Success,42,28,7,14,28
10,Success,50,26,2,9,41
10,Success,44,24,3,16,28
10,Success,49,22,1,14,35
10,Success,42,22,14,14,28
10,Success,52,26,0,12,40
10,Success,45,40,0,7,38
10,Success,50,25,0,16,34
10,Success,47,28,0,10,37
10,Success,44,31,0,15,29
10,Success,45,32,0,15,30
10,Success,49,26,1,14,35
10,Success,47,36,0,12,35
10,Success,40,39,0,13,27
10,Success,38,34,0,14,24
10,Success,46,32,5,7,39
10,Success,39,31,1,18,21
10,Success,41,34,3,13,28
10,Success,43,21,4,20,23
10,Success,41,33,2,13,28
10,Success,51,22,0,14,37
10,Success,55,19,3,12,43
10,Success,52,22,0,13,39
10,Success,40,32,0,16,24
10,Success,48,24,0,18,30
10,Success,44,31,4,10,34
10,Success,43,36,0,15,28
10,Success,51,19,4,19,32
10,Success,45,32,0,14,31
10,Success,47,28,9,9,38
10,Success,44,35,0,10,34
10,Success,36,41,0,12,24
10,Success,47,20,3,13,34
10,Success,52,23,2,13,39
10,Success,51,28,1,9,42
10,Success,51,26,1,9,42
10,Success,53,21,1,15,38
10,Success,51,24,0,11,40
10,Success,47,23,4,15,32
10,Success,50,21,0,16,34
10,Success,45,31,0,14,31
10,Success,44,25,0,20,24
10,Success,42,31,3,15,27
10,Success,46,20,11,12,34
10,Success,47,24,7,16,31
10,Success,47,28,0,13,34
10,Success,40,29,9,17,23
10,Success,50,27,3,10,40
10,Success,47,31,0,11,36
10,Success,52,26,0,13,39
10,Success,56,22,0,13,43
10,Success,47,20,2,21,26
10,Success,52,23,0,9,43
10,Success,47,35,0,8,39
10,Success,50,22,2,14,36
10,Success,48,23,1,19,29
10,Success,44,33,0,11,33
10,Success,55,21,0,8,47
10,Success,57,22,1,9,48
10,Success,45,34,0,12,33
10,Success,47,31,1,11,36
10,Success,51,25,0,14,37
10,Success,36,31,0,17,19
10,Success,50,32,0,8,42
10,Success,56,21,1,12,44
10,Success,51,20,6,12,39
10,Success,56,10,4,16,40
10,Success,46,28,7,9,37
10,Success,47,30,0,13,34
10,Success,46,35,0,8,38
10,Success,50,19,6,10,40
10,Success,49,31,3,8,41
10,Success,47,27,0,14,33
10,Success,51,23,4,9,42
10,Success,49,21,3,18,31
10,Success,47,30,0,15,32
10,Success,50,20,0,19,31
10,Success,50,22,0,17,33
10,Success,48,26,3,11,37
10,Success,48,31,0,11,37
10,Success,56,16,10,8,48
10,Success,46,26,0,15,31
10,Success,51,22,0,15,36
10,Success,52,26,0,11,41
10,Success,41,40,0,11,30
10,Success,48,35,0,9,39
10,Success,60,21,0,3,57
10,Success,50,24,3,9,41
10,Success,50,29,0,9,41
10,Success,48,25,0,11,37
10,Success,45,34,0,10,35
10,Success,53,22,0,13,40
10,Success,53,19,6,10,43
10,Success,46,27,0,12,34
10,Success,43,35,3,12,31
10,Success,51,22,0,14,37
10,Success,49,28,3,7,42
10,Success,47,32,0,13,34
10,Success,47,33,0,11,36
10,Success,45,27,0,15,30
10,Success,51,34,0,7,44
10,Success,39,31,12,9,30
10,Success,59,19,0,10,49
10,Success,45,26,0,16,29
10,Success,40,36,0,13,27
10,Success,52,22,1,16,36
10,Success,46,27,5,12,34
10,Success,46,35,1,6,40
10,Success,46,29,1,14,32
10,Success,46,34,0,13,33
10,Success,54,22,0,8,46
10,Success,47,27,3,13,34
10,Success,42,33,0,13,29
10,Success,47,30,0,11,36
10,Success,42,22,3,20,22
10,Success,55,19,2,11,44
10,Success,43,33,0,13,30
10,Success,48,24,0,16,32
10,Success,51,26,4,9,42
10,Success,36,38,0,18,18
10,Success,46,30,0,12,34
10,Success,42,37,0,13,29
10,Success,48,26,1,12,36
10,Success,50,28,0,13,37
10,Success,50,29,6,11,39
10,Success,51,31,0,13,38
10,Success,47,23,0,13,34
10,Success,47,29,0,12,35
10,Success,53,23,5,9,44
10,Success,45,25,9,13,32
10,Success,42,26,4,15,27
10,Success,47,24,0,19,28
10,Success,45,31,0,13,32
10,Success,53,16,1,17,36
10,Success,54,24,0,13,41
10,Success,49,35,0,7,42
10,Success,50,20,5,13,37
10,Success,51,27,2,9,42
10,Success,48,32,2,9,39
10,Success,53,28,0,8,45
10,Success,55,16,6,7,48
10,Success,49,22,6,13,36
10,Success,48,30,0,10,38
10,Success,46,35,0,10,36
10,Success,44,33,0,13,31
10,Success,57,22,1,10,47
10,Success,53,17,3,15,38
10,Success,52,30,0,8,44
10,Success,47,29,4,9,38
10,Success,45,33,1,9,36
10,Success,49,28,1,13,36
10,Success,43,31,0,19,24
10,Success,44,30,0,10,34
10,Success,53,19,7,14,39
10,Success,49,31,7,7,42
10,Success,44,28,2,17,27
10,Success,43,35,0,14,29
10,Success,47,33,0,11,36
10,Success,48,33,0,9,39
10,Success,53,25,0,12,41
10,Success,38,33,0,16,22
10,Success,49,33,0,12,37
10,Success,47,20,3,18,29
10,Success,52,28,0,12,40
10,Success,49,18,0,16,33
10,Success,46,24,8,14,32
10,Success,48,27,5,9,39
10,Success,49,27,0,7,42
10,Success,46,22,2,22,24
10,Success,50,27,0,10,40
10,Success,51,22,0,12,39
10,Success,44,26,8,12,32
10,Success,52,18,0,16,36
10,Success,51,28,0,15,36
10,Success,46,32,0,11,35
10,Success,51,28,3,7,44
10,Success,53,25,0,11,42
10,Success,45,35,0,9,36
10,Success,44,30,3,15,29
10,Success,43,20,11,14,29
10,Success,46,31,0,15,31
10,Success,44,31,8,7,37
10,Success,51,32,0,8,43
10,Success,42,28,1,19,23
10,Success,51,21,1,20,31
10,Success,50,27,0,13,37
10,Success,46,23,3,16,30
10,Success,45,30,1,13,32
10,Success,41,36,6,10,31
10,Success,43,28,8,11,32
10,Success,57,23,2,9,48
10,Success,56,17,8,7,49
10,Success,52,21,6,13,39
10,Success,47,29,4,13,34
10,Success,42,36,0,14,28
10,Success,44,44,0,3,41
10,Success,51,25,1,10,41
10,Success,49,27,0,12,37
10,Success,45,32,0,15,30
10,Success,40,32,0,18,22
10,Success,53,23,0,11,42
10,Success,51,25,6,8,43
10,Success,42,34,0,15,27
10,Success,46,27,2,17,29
10,Success,47,19,10,17,30
10,Success,45,22,2,18,27
10,Success,47,26,5,15,32
10,Success,45,36,0,11,34
10,Success,46,34,1,10,36
10,Success,51,22,0,16,35
10,Success,49,28,10,6,43
10,Success,55,30,3,3,52
10,Success,51,23,3,12,39
10,Success,53,24,6,11,42
10,Success,45,34,0,13,32
10,Success,48,25,2,17,31
10,Success,45,29,2,15,30
10,Success,51,30,4,6,45
10,Success,48,23,1,15,33
10,Success,40,33,0,14,26
10,Success,50,25,5,9,41
10,Success,45,21,9,17,28
10,Success,50,19,13,12,38
10,Success,54,22,6,7,47
10,Success,48,32,4,12,36
10,Success,49,34,0,9,40
10,Success,49,28,0,11,38
10,Success,50,25,3,12,38
10,Success,41,28,0,17,24
10,Success,52,27,0,12,40
10,Success,51,29,0,8,43
10,Success,50,21,5,11,39
10,Success,45,32,0,12,33
10,Success,52,19,0,17,35
10,Success,42,26,7,15,27
10,Success,46,24,8,13,33
10,Success,48,28,2,10,38
10,Success,46,27,11,9,37
10,Success,38,39,0,16,22
10,Success,48,27,4,11,37
10,Success,46,29,5,11,35
10,Success,48,22,0,17,31
10,Success,44,24,8,13,31
10,Success,56,21,1,7,49
10,Success,51,21,0,19,32
10,Success,45,31,0,15,30
10,Success,49,31,0,10,39
10,Success,54,25,0,10,44
10,Success,54,19,2,10,44
10,Success,53,29,0,9,44
10,Success,53,28,0,10,43
10,Success,46,23,0,19,27
10,Success,48,29,0,12,36
10,Success,51,28,1,10,41
10,Success,51,30,0,8,43
10,Success,53,21,1,12,41
10,Success,50,20,2,15,35
10,Success,39,30,0,21,18
10,Success,50,24,6,10,40
10,Success,53,17,6,13,40
10,Success,42,35,0,12,30
10,Success,50,18,3,17,33
10,Success,43,27,5,15,28
10,Success,52,25,5,10,42
10,Success,49,20,10,9,40
10,Success,42,33,0,15,27
10,Success,49,32,0,11,38
10,Success,48,27,0,14,34
10,Success,48,29,0,15,33
10,Success,48,22,7,14,34
10,Success,51,23,4,11,40
10,Success,46,33,0,12,34
10,Success,41,38,0,9,32
10,Success,56,24,0,9,47
10,Success,57,18,0,10,47
10,Success,49,28,0,12,37
10,Success,50,25,3,10,40
10,Success,48,28,0,13,35
10,Success,49,19,0,18,31
10,Success,53,24,9,7,46
10,Success,47,33,0,11,36
10,Success,49,24,2,12,37
10,Success,49,26,0,17,32
10,Success,55,21,1,13,42
10,Success,46,27,5,8,38
10,Success,48,24,2,13,35
10,Success,40,28,4,16,24
10,Success,52,28,0,9,43
10,Success,41,41,0,10,31
10,Success,49,24,3,12,37
10,Success,43,23,4,21,22
10,Success,35,39,3,11,24
10,Success,47,39,0,7,40
10,Success,55,19,4,14,41
10,Success,52,21,3,16,36
10,Success,44,29,5,13,31
10,Success,48,30,0,13,35
10,Success,51,32,0,7,44
10,Success,46,35,0,9,37
10,Success,54,23,0,9,45
10,Success,47,35,0,11,36
10,Success,52,28,0,9,43
10,Success,46,30,2,13,33
10,Success,48,30,0,12,36
10,Success,51,25,0,9,42
10,Success,42,32,0,13,29
10,Success,44,32,2,9,35
10,Success,41,32,0,18,23
10,Success,51,29,3,4,47
10,Success,50,26,3,8,42
10,Success,49,34,0,7,42
10,Success,48,25,1,14,34
10,Success,44,25,7,15,29
10,Success,42,37,0,13,29
10,Success,55,26,0,9,46
10,Success,51,25,4,12,39
10,Success,45,25,0,20,25
10,Success,46,24,11,11,35
10,Success,46,27,3,12,34
10,Success,51,25,4,11,40
10,Success,47,24,0,17,30
10,Success,52,27,0,13,39
10,Success,44,28,0,14,30
10,Success,57,21,0,8,49
10,Success,51,27,2,9,42
10,Success,51,28,2,10,41
10,Success,42,19,14,20,22
10,Success,41,33,0,17,24
10,Success,45,25,4,13,32
10,Success,46,24,4,18,28
10,Success,44,29,0,18,26
10,Success,52,26,0,12,40
10,Success,46,34,0,8,38
10,Success,43,30,0,20,23
10,Success,50,29,0,10,40
10,Success,40,41,0,12,28
10,Success,46,36,0,8,38
10,Success,47,22,4,18,29
10,Success,52,21,2,12,40
10,Success,49,25,6,10,39
10,Success,43,23,5,19,24
10,Success,39,33,9,12,27
10,Success,46,29,0,11,35
10,Success,51,27,0,11,40
10,Success,46,28,0,13,33
10,Success,49,24,3,13,36
10,Success,46,26,0,17,29
10,Success,46,25,0,19,27
10,Success,43,28,7,16,27
10,Success,47,30,1,13,34
10,Success,51,22,3,12,39
10,Success,46,32,7,7,39
10,Success,40,29,6,20,20
10,Success,45,25,3,16,29
10,Success,45,31,0,16,29
10,Success,40,39,0,14,26
10,Success,54,24,1,9,45
10,Success,43,27,12,11,32
10,Success,52,21,0,13,39
10,Success,55,26,0,9,46
10,Success,41,35,0,13,28
10,Success,43,31,0,16,27
10,Success,49,26,0,17,32
10,Success,45,24,1,16,29
10,Success,51,26,3,10,41
10,Success,58,19,1,8,50
10,Success,42,24,3,18,24
10,Success,46,28,4,12,34
10,Success,53,23,0,14,39
10,Success,50,24,1,9,41
10,Success,40,26,0,22,18
10,Success,45,28,2,13,32
10,Success,39,37,0,15,24
10,Success,50,33,0,7,43
10,Success,41,26,11,13,28
10,Success,51,29,0,10,41
10,Success,45,33,0,9,36
10,Success,47,31,0,14,33
10,Success,50,27,3,8,42
10,Success,41,28,7,15,26
10,Success,48,29,0,13,35
10,Success,55,22,4,10,45
10,Success,48,34,0,11,37
10,Success,52,25,3,8,44
10,Success,46,30,3,8,38
10,Success,39,36,0,16,23
10,Success,53,17,0,13,40
10,Success,48,26,0,15,33
10,Success,46,35,0,13,33
10,Success,46,26,0,16,30
10,Success,47,26,5,12,35
10,Success,56,16,3,10,46
10,Success,58,18,1,10,48
10,Success,47,37,0,8,39
10,Success,49,31,0,10,39
10,Success,53,23,0,10,43
10,Success,53,23,0,13,40
10,Success,47,21,4,17,30
10,Success,45,31,0,14,31
10,Success,37,36,0,19,18
10,Success,49,23,0,15,34
10,Success,52,26,0,11,41
10,Success,39,35,0,14,25
10,Success,49,23,0,12,37
10,Success,49,26,8,9,40
10,Success,50,21,0,16,34
10,Success,48,23,7,12,36
10,Success,54,27,0,8,46
10,Success,48,25,0,13,35
10,Success,60,14,1,10,50
10,Success,47,26,1,9,38
10,Success,40,38,0,14,26
10,Success,49,34,0,11,38
10,Success,45,37,0,9,36
10,Success,43,32,0,14,29
10,Success,39,33,0,22,17
10,Success,39,35,0,18,21
10,Success,47,31,0,14,33
10,Success,46,34,0,12,34
10,Success,54,14,3,12,42
10,Success,51,18,6,12,39
10,Success,49,24,0,14,35
10,Success,51,27,0,13,38
10,Success,50,26,0,8,42
10,Success,50,31,0,11,39
10,Success,49,25,3,11,38
10,Success,57,19,0,11,46
10,Success,50,23,0,19,31
10,Success,57,19,3,9,48
10,Success,52,27,0,12,40
10,Success,55,24,0,10,45
10,Success,47,31,0,10,37
10,Success,50,30,0,9,41
10,Success,57,20,0,7,50
10,Success,45,33,3,6,39
10,Success,53,25,0,7,46
10,Success,46,24,6,15,31
10,Success,45,29,0,11,34
10,Success,51,29,0,11,40
10,Success,47,32,0,13,34
10,Success,48,23,0,17,31
10,Success,52,27,0,8,44
10,Success,43,35,0,13,30
10,Success,46,26,0,18,28
10,Success,48,23,0,15,33
10,Success,40,27,8,19,21
10,Success,47,20,9,17,30
10,Success,47,24,0,14,33
10,Success,48,33,0,6,42
10,Success,53,19,0,13,40
10,Success,45,34,0,14,31
10,Success,47,21,0,17,30
10,Success,48,26,0,15,33
10,Success,54,22,1,11,43
10,Success,53,28,0,9,44
10,Success,46,30,0,16,30
10,Success,43,27,0,18,25
10,Success,49,24,5,11,38
10,Success,46,30,0,13,33
10,Success,46,29,6,11,35
10,Success,46,25,5,12,34
10,Success,46,28,0,15,31
10,Success,43,31,3,14,29
10,Success,48,29,0,15,33
10,Success,44,25,0,18,26
10,Success,41,30,4,15,26
10,Success,47,32,0,9,38
10,Success,46,28,0,15,31
10,Success,59,22,0,10,49
10,Success,42,39,0,8,34
10,Success,40,32,0,19,21
10,Success,46,31,1,11,35
10,Success,46,25,0,16,30
10,Success,45,27,0,19,26
10,Success,48,27,4,12,36
10,Success,52,23,5,7,45
10,Success,46,29,0,17,29
10,Success,44,32,6,8,36
10,Success,55,25,0,9,46
10,Success,45,27,7,12,33
10,Success,37,36,0,15,22
10,Success,37,36,4,14,23
10,Success,44,28,10,8,36
10,Success,51,27,0,13,38
10,Success,53,26,0,13,40
10,Success,46,23,0,19,27
10,Success,55,21,0,14,41
10,Success,48,26,0,14,34
10,Success,49,32,0,11,38
10,Success,49,27,3,10,39
10,Success,44,34,0,14,30
10,Success,54,23,0,11,43
10,Success,42,33,6,9,33
10,Success,45,25,3,15,30
10,Success,51,21,0,16,35
10,Success,41,32,0,13,28
10,Success,44,31,7,11,33
10,Success,49,30,0,10,39
10,Success,42,34,0,13,29
10,Success,41,42,0,8,33
10,Success,51,24,0,11,40
10,Success,56,24,0,8,48
10,Success,52,28,0,11,41
10,Success,52,16,0,16,36
10,Success,38,35,0,18,20
10,Success,54,28,0,8,46
10,Success,51,23,3,10,41
10,Success,53,19,0,16,37
10,Success,48,24,1,15,33
10,Success,47,20,10,15,32
10,Success,49,28,0,11,38
10,Success,43,33,0,11,32
10,Success,47,27,5,11,36
10,Success,49,25,0,15,34
10,Success,62,21,0,4,58
10,Success,56,19,1,13,43
10,Success,48,26,3,15,33
10,Success,50,25,0,9,41
10,Success,48,30,0,8,40
10,Success,46,28,4,11,35
10,Success,49,25,6,9,40
10,Success,58,19,0,11,47
10,Success,45,30,0,16,29
10,Success,50,28,4,12,38
10,Success,51,26,3,9,42
10,Success,53,27,0,8,45
10,Success,46,26,1,13,33
10,Success,51,17,10,12,39
10,Success,44,32,2,12,32
10,Success,51,33,0,5,46
10,Success,43,30,3,13,30
10,Success,49,30,0,11,38
10,Success,56,22,0,9,47
10,Success,46,23,6,14,32
10,Success,42,31,0,16,26
10,Success,50,24,0,14,36
10,Success,48,27,0,14,34
10,Success,50,26,0,12,38
10,Success,58,19,1,11,47
10,Success,51,24,3,12,39
10,Success,49,24,3,11,38
10,Success,49,22,0,16,33
10,Success,39,36,0,17,22
10,Success,46,25,6,14,32
10,Success,51,26,3,9,42
10,Success,48,30,0,13,35
10,Success,49,29,2,13,36
10,Success,50,31,0,12,38
10,Success,59,26,1,5,54
10,Success,52,28,3,8,44
10,Success,54,25,1,9,45
10,Success,54,21,0,14,40
10,Success,50,32,0,10,40
10,Success,46,29,1,13,33
10,Success,43,21,3,22,21
10,Success,43,38,0,12,31
10,Success,46,26,0,16,30
10,Success,48,32,0,13,35
10,Success,48,26,3,11,37
10,Success,48,20,6,16,32
10,Success,46,26,9,12,34
10,Success,52,19,2,10,42
10,Success,51,31,0,11,40
10,Success,53,22,0,11,42
10,Success,46,24,1,15,31
10,Success,49,29,2,8,41
10,Success,56,22,0,7,49
10,Success,49,30,1,7,42
10,Success,50,23,2,13,37
10,Success,48,31,2,10,38
10,Success,47,30,0,11,36
10,Success,50,23,6,9,41
10,Success,60,18,4,10,50
10,Success,47,24,8,13,34
10,Success,46,23,10,8,38
10,Success,51,34,0,6,45
10,Success,47,28,0,17,30
10,Success,46,29,0,16,30
10,Success,46,28,4,13,33
10,Success,51,17,1,17,34
10,Success,48,25,0,12,36
10,Success,52,19,6,12,40
10,Success,48,35,0,7,41
10,Success,45,29,3,17,28
10,Success,51,21,0,17,34
10,Success,48,22,7,11,37
10,Success,52,19,3,15,37
10,Success,49,22,2,14,35
10,Success,60,16,2,10,50
10,Success,41,28,3,15,26
10,Success,38,28,8,15,23
10,Success,47,28,0,12,35
10,Success,53,19,4,11,42
10,Success,50,26,0,14,36
10,Success,42,29,4,13,29
10,Success,49,28,0,9,40
10,Success,45,25,3,14,31
10,Success,48,26,0,14,34
10,Success,58,21,1,6,52
10,Success,49,32,0,10,39
10,Success,52,27,0,12,40
10,Success,47,31,3,11,36
10,Success,47,24,2,16,31
10,Success,51,25,1,13,38
10,Success,43,27,3,16,27
10,Success,49,28,2,9,40
10,Success,53,23,0,15,38
10,Success,50,21,0,17,33
10,Success,48,22,2,15,33
10,Success,55,30,0,8,47
10,Success,49,25,0,14,35
10,Success,47,31,3,9,38
10,Success,48,23,4,13,35
10,Success,50,19,8,14,36
10,Success,56,24,1,9,47
10,Success,45,27,0,17,28
10,Success,54,23,4,9,45
10,Success,45,30,0,17,28
10,Success,49,24,0,13,36
10,Success,48,26,3,12,36
10,Success,45,28,4,13,32
10,Success,49,27,0,17,32
10,Success,48,24,0,13,35
10,Success,50,18,6,12,38
10,Success,50,20,0,20,30
10,Success,51,31,0,8,43
10,Success,53,20,4,10,43
10,Success,47,20,4,17,30
10,Success,43,34,0,8,35
10,Success,54,28,0,6,48
10,Success,40,31,1,17,23
10,Success,44,23,8,15,29
10,Success,49,29,0,11,38
10,Success,46,28,0,10,36
10,Success,42,28,0,18,24
10,Success,47,32,0,10,37
10,Success,57,23,1,7,50
10,Success,37,20,18,18,19
10,Success,48,31,2,13,35
10,Success,55,22,2,9,46
10,Success,51,23,7,8,43
10,Success,52,19,5,14,38
10,Success,48,33,0,7,41
10,Success,45,25,4,16,29
10,Success,57,17,1,14,43
10,Success,45,27,0,16,29
10,Success,45,29,0,16,29
10,Success,44,23,1,19,25
10,Success,46,25,0,18,28
10,Success,50,30,0,11,39
10,Success,48,27,0,12,36
10,Success,48,32,0,14,34
10,Success,44,32,3,10,34
10,Success,53,22,0,13,40
10,Success,45,28,0,18,27
10,Success,53,21,3,11,42
10,Success,51,26,0,15,36
10,Success,43,29,0,19,24
10,Success,36,32,0,23,13
10,Success,53,24,1,11,42
10,Success,42,29,0,16,26
10,Success,52,29,0,9,43
10,Success,44,28,0,17,27
10,Success,48,26,0,14,34
10,Success,50,31,0,12,38
10,Success,54,30,0,7,47
10,Success,51,21,1,14,37
10,Success,47,31,0,13,34
10,Success,49,23,4,16,33
10,Success,44,26,8,15,29
10,Success,49,31,0,12,37
10,Success,51,21,5,13,38
10,Success,54,27,0,11,43
10,Success,49,23,0,15,34
10,Success,51,23,0,18,33
10,Success,50,17,0,19,31
10,Success,46,20,0,18,28
10,Success,51,22,4,12,39
10,Success,47,33,0,10,37
10,Success,51,26,0,13,38
10,Success,48,34,0,10,38
10,Success,49,23,8,7,42
10,Success,51,28,0,9,42
10,Success,54,22,2,13,41
10,Success,46,33,0,11,35
10,Success,56,26,0,9,47
10,Success,44,30,0,12,32
10,Success,46,25,0,15,31
10,Success,47,25,1,12,35
10,Success,43,28,0,16,27
10,Success,45,34,0,14,31
10,Success,47,32,0,10,37
10,Success,50,23,3,11,39
10,Success,42,31,2,17,25
10,Success,43,30,5,15,28
10,Success,50,29,5,9,41
10,Success,47,28,3,13,34
10,Success,52,27,1,10,42
10,Success,51,19,3,16,35
10,Success,52,21,7,7,45
10,Success,40,38,0,13,27
10,Success,46,25,0,17,29
10,Success,54,23,0,9,45
10,Success,42,30,0,15,27
10,Success,48,27,0,15,33
10,Success,54,21,2,13,41
10,Success,52,27,0,9,43
10,Success,51,20,9,12,39
10,Success,51,27,1,7,44
10,Success,54,23,4,11,43
10,Success,48,25,0,18,30
10,Success,44,30,0,19,25
10,Success,45,28,0,10,35
10,Success,45,29,5,10,35
10,Success,44,30,3,13,31
10,Success,36,36,0,19,17
10,Success,44,30,5,11,33
10,Success,48,30,0,12,36
10,Success,49,24,1,12,37
10,Success,53,20,0,14,39
10,Success,44,30,0,18,26
10,Success,49,23,6,13,36
10,Success,43,29,2,16,27
10,Success,44,26,7,15,29
10,Success,40,27,8,17,23
10,Success,56,21,0,9,47
10,Success,47,22,5,18,29
10,Success,51,22,5,12,39
10,Success,52,25,0,13,39
10,Success,44,27,0,15,29
10,Success,48,27,0,13,35
10,Success,53,26,0,12,41
10,Success,47,33,0,7,40
10,Success,47,31,0,12,35
10,Success,52,22,4,8,44
10,Success,45,31,0,17,28
10,Success,48,27,0,16,32
10,Success,52,27,0,11,41
10,Success,52,21,1,13,39
10,Success,44,34,0,11,33
10,Success,43,35,0,15,28
10,Success,48,24,0,13,35
10,Success,48,28,0,12,36
10,Success,50,24,2,12,38
10,Success,50,20,4,15,35
10,Success,47,27,0,16,31
10,Success,46,26,4,18,28
10,Success,52,25,0,14,38
10,Success,58,21,0,9,49
10,Success,50,31,0,11,39
10,Success,44,37,0,9,35
10,Success,46,24,4,16,30
10,Success,48,31,0,11,37
10,Success,47,38,0,8,39
10,Success,46,30,0,13,33
10,Success,43,27,0,20,23
10,Success,43,24,3,19,24
10,Success,53,30,0,8,45
10,Success,44,29,0,13,31
10,Success,44,38,0,11,33
10,Success,51,21,0,17,34
10,Success,50,31,0,7,43
10,Success,54,19,4,12,42
10,Success,50,28,0,9,41
10,Success,44,36,1,11,33
10,Success,51,27,0,11,40
10,Success,47,35,0,10,37
10,Success,53,22,0,11,42
10,Success,56,17,6,10,46
10,Success,54,27,0,12,42
10,Success,49,25,6,10,39
10,Success,46,25,5,12,34
10,Success,44,28,7,12,32
10,Success,47,35,0,6,41
10,Success,55,24,0,13,42
10,Success,45,32,3,10,35
10,Success,51,22,2,12,39
10,Success,48,26,2,14,34
10,Success,42,32,0,16,26
10,Success,46,36,0,9,37
10,Success,45,35,0,6,39
10,Success,47,32,0,9,38
10,Success,52,23,0,11,41
10,Success,47,25,3,14,33
10,Success,51,32,0,7,44
10,Success,51,33,0,9,42
10,Success,49,29,0,11,38
10,Success,51,23,7,6,45
10,Success,47,23,4,13,34
10,Success,46,34,0,11,35
10,Success,46,29,5,12,34
10,Success,44,30,1,12,32
10,Success,52,19,3,17,35
10,Success,55,31,0,10,45
10,Success,49,23,5,12,37
10,Success,47,32,0,14,33
10,Success,43,39,0,11,32
10,Success,48,30,0,10,38
10,Success,47,24,3,15,32
10,Success,46,34,0,16,30
10,Success,49,23,1,16,33
10,Success,46,26,0,14,32
10,Success,48,21,0,17,31
10,Success,50,30,0,9,41
10,Success,46,26,5,16,30
10,Success,39,32,3,18,21
10,Success,49,29,2,10,39
10,Success,58,22,1,6,52
10,Success,50,26,5,13,37
10,Success,46,25,9,13,33
10,Success,53,23,5,7,46
10,Success,47,23,0,19,28
10,Success,53,28,0,9,44
10,Success,44,28,0,18,26
10,Success,47,27,0,14,33
10,Success,46,30,0,16,30
10,Success,49,22,0,19,30
10,Success,44,31,0,15,29
10,Success,51,22,0,15,36
10,Success,44,28,9,10,34
10,Success,43,33,0,15,28
10,Success,37,43,0,13,24
10,Success,50,19,7,13,37
10,Success,39,37,0,15,24
10,Success,51,22,3,11,40
10,Success,47,22,1,21,26
10,Success,51,25,0,8,43
10,Success,50,22,2,17,33
10,Success,48,20,3,12,36
10,Success,51,27,0,11,40
10,Success,60,23,0,6,54
10,Success,56,25,1,7,49
10,Success,51,35,0,7,44
10,Success,46,26,8,11,35
10,Success,48,31,0,12,36
10,Success,46,27,0,15,31
10,Success,49,34,0,9,40
10,Success,43,32,0,16,27
10,Success,48,22,4,16,32
10,Success,54,28,0,9,45
10,Success,53,28,0,8,45
10,Success,52,21,0,10,42
10,Success,47,35,0,9,38
10,Success,48,27,0,16,32
10,Success,52,19,4,12,40
10,Success,50,25,0,11,39
10,Success,36,33,12,15,21
10,Success,43,33,0,17,26
10,Success,46,26,2,13,33
10,Success,43,27,8,15,28
10,Success,53,24,0,14,39
10,Success,42,30,5,14,28
10,Success,50,29,0,9,41
10,Success,51,23,0,11,40
10,Success,49,29,0,8,41
10,Success,51,23,0,13,38
10,Success,53,24,0,8,45
10,Success,41,34,2,15,26
10,Success,50,26,6,7,43
10,Success,48,25,0,15,33
10,Success,38,25,14,16,22
10,Success,39,29,0,21,18
10,Success,44,21,5,19,25
10,Success,50,28,2,9,41
10,Success,48,25,4,9,39
10,Success,53,25,0,9,44
10,Success,47,29,0,11,36
10,Success,56,23,0,11,45
10,Success,45,24,3,15,30
10,Success,53,25,6,6,47
10,Success,41,33,7,11,30
10,Success,37,31,0,19,18
10,Success,53,24,3,10,43
10,Success,39,34,0,16,23
10,Success,47,30,0,12,35
10,Success,44,30,0,11,33
10,Success,55,20,0,13,42
10,Success,49,24,0,13,36
10,Success,56,23,0,10,46
10,Success,47,28,3,14,33
10,Success,47,24,0,21,26
10,Success,48,24,5,15,33
10,Success,47,27,2,12,35
10,Success,52,24,0,11,41
10,Success,50,20,0,14,36
10,Success,53,23,0,12,41
10,Success,47,29,0,13,34
10,Success,48,22,7,15,33
10,Success,50,27,3,12,38
10,Success,47,25,10,12,35
10,Success,47,24,1,20,27
10,Success,58,20,0,10,48
10,Success,42,36,0,10,32
10,Success,51,17,11,12,39
10,Success,53,22,0,12,41
10,Success,50,21,2,13,37
10,Success,56,20,5,8,48
10,Success,48,27,0,14,34
10,Success,41,34,4,14,27
10,Success,44,28,7,11,33
10,Success,49,26,0,15,34
10,Success,49,27,1,13,36
10,Success,49,28,0,11,38
10,Success,48,30,0,10,38
10,Success,39,26,11,13,26
10,Success,48,35,0,10,38
10,Success,56,23,0,10,46
10,Success,51,25,0,16,35
10,Success,46,23,2,17,29
10,Success,49,26,5,11,38
10,Success,49,32,0,10,39
10,Success,51,20,0,19,32
10,Success,50,29,1,9,41
10,Success,44,36,0,10,34
10,Success,49,28,0,10,39
10,Success,46,30,3,14,32
10,Success,55,24,0,10,45
10,Success,40,33,0,16,24
10,Success,42,31,6,15,27
10,Success,43,29,0,15,28
10,Success,52,34,0,7,45
10,Success,46,22,4,15,31
10,Success,51,21,4,13,38
10,Success,53,23,0,14,39
10,Success,48,36,0,10,38
10,Success,41,30,6,14,27
10,Success,43,34,3,10,33
10,Success,43,32,5,13,30
10,Success,50,20,6,12,38
10,Success,47,28,0,12,35
10,Success,48,33,0,11,37
10,Success,44,31,0,14,30
10,Success,45,33,0,12,33
10,Success,45,30,0,13,32
10,Success,46,36,0,10,36
10,Success,49,24,2,12,37
10,Success,49,27,5,9,40
10,Success,48,24,0,17,31
10,Success,48,19,2,18,30
10,Success,46,31,0,18,28
10,Success,50,28,2,12,38
10,Success,37,40,5,10,27
10,Success,43,23,8,17,26
10,Success,49,23,2,16,33
10,Success,55,22,0,9,46
10,Success,50,19,10,11,39
10,Success,51,28,0,9,42
10,Success,55,26,0,5,50
10,Success,49,26,0,14,35
10,Success,50,23,0,14,36
10,Success,42,35,0,12,30
10,Success,47,21,4,18,29
10,Success,51,25,1,11,40
10,Success,51,25,3,8,43
10,Success,52,32,0,7,45
10,Success,46,29,0,15,31
10,Success,52,23,0,13,39
10,Success,48,37,0,8,40
10,Success,48,23,0,13,35
10,Success,45,38,0,10,35
10,Success,48,26,0,16,32
10,Success,52,23,0,13,39
10,Success,48,29,0,13,35
10,Success,44,33,0,16,28
10,Success,44,29,0,14,30
10,Success,48,22,9,13,35
10,Success,54,21,0,11,43
10,Success,45,30,0,10,35
10,Success,56,29,3,4,52
10,Success,48,32,0,8,40
10,Success,48,22,7,12,36
10,Success,54,16,4,20,34
10,Success,47,27,1,13,34
10,Success,48,32,0,12,36
10,Success,47,29,0,12,35
10,Success,44,27,7,13,31
10,Success,46,26,2,13,33
10,Success,49,29,0,9,40
10,Success,37,38,0,16,21
10,Success,52,31,0,8,44
10,Success,55,22,5,7,48
10,Success,55,18,4,18,37
10,Success,51,20,4,13,38
10,Success,49,28,0,8,41
10,Success,45,36,0,11,34
10,Success,43,30,0,17,26
10,Success,44,31,4,14,30
10,Success,40,37,0,12,28
10,Success,49,26,0,13,36
10,Success,54,22,0,14,40
10,Success,48,19,3,16,32
10,Success,54,19,4,13,41
10,Success,46,35,0,11,35
10,Success,51,29,0,11,40
10,Success,47,28,0,10,37
10,Success,51,26,1,9,42
10,Success,51,27,0,11,40
10,Success,45,27,6,9,36
10,Success,51,25,4,12,39
10,Success,48,27,0,14,34
10,Success,40,40,0,11,29
10,Success,54,21,2,10,44
10,Success,41,25,12,15,26
10,Success,49,27,0,10,39
10,Success,49,21,5,17,32
10,Success,51,22,0,15,36
10,Success,39,35,7,9,30
10,Success,47,20,6,18,29
10,Success,58,21,4,8,50
10,Success,54,23,1,11,43
10,Success,38,37,0,16,22
10,Success,50,21,2,16,34
10,Success,48,29,0,11,37
10,Success,44,27,7,9,35
10,Success,49,23,2,14,35
10,Success,40,38,0,12,28
10,Success,46,32,0,13,33
10,Success,47,28,0,15,32
10,Success,44,32,0,11,33
10,Success,43,26,7,16,27
10,Success,43,28,9,12,31
10,Success,53,22,3,9,44
10,Success,50,25,0,12,38
10,Success,48,26,2,16,32
10,Success,45,28,0,15,30
10,Success,44,29,7,12,32
10,Success,54,22,6,10,44
10,Success,59,20,0,10,49
10,Success,42,29,0,16,26
10,Success,51,22,0,12,39
10,Success,49,30,1,10,39
10,Success,43,23,5,18,25
10,Success,46,25,2,15,31
10,Success,44,25,4,19,25
10,Success,49,32,0,10,39
10,Success,52,23,7,10,42
10,Success,46,26,8,9,37
10,Success,43,23,10,15,28
10,Success,39,30,0,22,17
10,Success,53,22,0,14,39
10,Success,45,33,2,10,35
10,Success,51,31,0,9,42
10,Success,48,35,0,8,40
10,Success,41,39,0,9,32
10,Success,42,28,13,10,32
10,Success,45,29,0,13,32
10,Success,50,21,0,16,34
10,Success,49,30,0,12,37
10,Success,40,34,0,13,27
10,Success,39,31,2,21,18
10,Success,38,41,0,14,24
10,Success,50,27,0,13,37
10,Success,47,28,6,11,36
10,Success,47,32,0,8,39
10,Success,47,23,5,13,34
10,Success,54,21,8,9,45
10,Success,50,29,0,9,41
10,Success,52,24,0,11,41
10,Success,47,26,5,11,36
10,Success,52,27,0,11,41
10,Success,40,30,4,17,23
10,Success,46,30,0,15,31
10,Success,37,39,0,17,20
10,Success,50,27,5,9,41
10,Success,49,28,5,11,38
10,Success,52,20,6,10,42
10,Success,50,24,0,14,36
10,Success,49,25,1,15,34
10,Success,47,28,0,13,34
10,Success,45,30,0,15,30
10,Success,50,25,0,12,38
10,Success,48,24,3,18,30
10,Success,50,19,0,19,31
10,Success,53,18,0,13,40
10,Success,48,26,2,11,37
10,Success,42,28,7,17,25
10,Success,53,26,0,10,43
10,Success,57,24,1,7,50
10,Success,51,28,0,8,43
10,Success,49,25,6,11,38
10,Success,47,33,0,10,37
10,Success,51,30,0,9,42
10,Success,49,24,2,17,32
10,Success,48,27,0,14,34
10,Success,45,38,0,13,32
10,Success,46,29,2,12,34
10,Success,46,24,1,16,30
10,Success,50,27,0,11,39
10,Success,50,31,0,10,40
10,Success,38,32,7,13,25
10,Success,53,26,0,9,44
10,Success,50,23,1,13,37
10,Success,50,29,0,10,40
10,Success,36,36,0,20,16
10,Success,36,42,0,18,18
10,Success,47,27,0,15,32
10,Success,50,24,6,7,43
10,Success,40,36,0,15,25
10,Success,48,32,0,11,37
10,Success,52,19,2,15,37
10,Success,46,24,0,20,26
10,Success,53,21,0,13,40
10,Success,42,35,0,14,28
10,Success,45,27,0,17,28
10,Success,50,24,0,16,34
10,Success,51,26,2,13,38
10,Success,49,28,0,14,35
10,Success,44,31,0,13,31
10,Success,48,26,0,11,37
10,Success,45,31,0,15,30
10,Success,36,44,0,14,22
10,Success,48,36,0,6,42
10,Success,47,33,0,11,36
10,Success,43,25,0,20,23
10,Success,53,22,0,9,44
10,Success,54,16,8,8,46
10,Success,53,26,0,8,45
10,Success,49,28,1,10,39
10,Success,46,30,3,11,35
10,Success,45,33,0,11,34
10,Success,48,40,0,3,45
10,Success,45,27,0,18,27
10,Success,51,30,0,10,41
10,Success,47,26,0,12,35
10,Success,44,31,7,7,37
10,Success,47,31,0,11,36
10,Success,51,32,0,9,42
10,Success,53,28,0,6,47
10,Success,51,26,0,9,42
10,Success,46,23,3,15,31
10,Success,55,20,3,12,43
10,Success,45,26,2,13,32
10,Success,46,38,0,8,38
10,Success,45,30,0,14,31
10,Success,43,29,3,15,28
10,Success,53,22,0,13,40
10,Success,54,20,0,16,38
10,Success,49,27,0,11,38
10,Success,53,21,0,12,41
10,Success,50,26,0,13,37
10,Success,49,26,0,13,36
10,Success,49,30,0,9,40
10,Success,52,23,0,13,39
10,Success,46,25,1,17,29
10,Success,42,27,5,13,29
10,Success,47,21,4,13,34
10,Success,47,26,0,15,32
10,Success,47,20,0,18,29
10,Success,48,31,0,10,38
10,Success,51,25,0,10,41
10,Success,49,29,0,12,37
10,Success,50,22,0,13,37
10,Success,47,25,0,19,28
10,Success,52,20,2,14,38
10,Success,43,28,0,16,27
10,Success,38,31,8,16,22
10,Success,44,29,8,10,34
10,Success,43,38,0,9,34
10,Success,55,25,0,7,48
10,Success,43,26,8,15,28
10,Success,54,19,1,12,42
10,Success,42,40,0,12,30
10,Success,53,20,4,8,45
10,Success,49,32,0,10,39
10,Success,49,26,0,15,34
10,Success,48,28,0,15,33
10,Success,45,33,0,16,29
10,Success,45,27,5,10,35
10,Success,48,32,0,13,35
10,Success,45,37,0,10,35
10,Success,52,27,0,9,43
10,Success,48,29,0,15,33
10,Success,49,23,1,14,35
10,Success,47,20,8,14,33
10,Success,54,25,0,8,46
10,Success,49,27,0,9,40
10,Success,50,32,3,9,41
10,Success,36,41,0,11,25
10,Success,52,20,2,10,42
10,Success,47,29,0,12,35
10,Success,52,22,1,11,41
10,Success,49,22,0,17,32
10,Success,52,23,2,12,40
10,Success,54,23,3,11,43
10,Success,46,25,0,21,25
10,Success,39,40,0,14,25
10,Success,42,37,0,11,31
10,Success,44,28,0,21,23
10,Success,50,28,1,7,43
10,Success,46,28,0,14,32
10,Success,53,23,0,9,44
10,Success,51,25,3,13,38
10,Success,50,27,4,8,42
10,Success,50,28,0,10,40
10,Success,52,18,2,13,39
10,Success,49,22,3,15,34
10,Success,45,27,4,16,29
10,Success,41,26,14,14,27
10,Success,46,17,5,19,27
10,Success,45,36,0,10,35
10,Success,45,25,0,17,28
10,Success,48,30,5,6,42
10,Success,40,29,8,13,27
10,Success,47,28,0,14,33
10,Success,42,33,0,16,26
10,Success,48,24,3,15,33
10,Success,45,33,0,12,33
10,Success,48,28,0,13,35
10,Success,44,34,0,15,29
10,Success,47,33,0,9,38
10,Success,53,25,0,12,41
10,Success,46,33,0,12,34
10,Success,61,15,1,12,49
10,Success,43,32,4,12,31
10,Success,56,24,0,10,46
10,Success,49,31,0,8,41
10,Success,42,36,0,14,28
10,Success,40,42,0,9,31
10,Success,49,15,3,19,30
10,Success,39,37,0,18,21
10,Success,49,27,0,12,37
10,Success,47,20,3,16,31
10,Success,51,16,5,16,35
10,Success,41,30,5,14,27
10,Success,45,32,1,13,32
10,Success,48,25,10,11,37
10,Success,40,32,10,12,28
10,Success,51,25,2,10,41
10,Success,56,25,3,8,48
10,Success,51,28,1,9,42
10,Success,49,30,2,9,40
10,Success,46,33,0,11,35
10,Success,55,24,0,12,43
10,Success,49,20,2,19,30
10,Success,51,24,0,15,36
10,Success,41,27,6,19,22
10,Success,48,23,6,15,33
10,Success,51,26,0,11,40
10,Success,46,27,8,11,35
10,Success,49,26,0,11,38
10,Success,55,19,1,13,42
10,Success,47,26,4,12,35
10,Success,50,16,4,16,34
10,Success,51,22,4,13,38
10,Success,50,33,0,11,39
10,Success,50,23,2,15,35
10,Success,44,19,7,22,22
10,Success,49,19,8,14,35
10,Success,47,24,5,11,36
10,Success,51,27,5,7,44
10,Success,45,34,0,12,33
10,Success,56,18,0,14,42
10,Success,42,39,0,12,30
10,Success,48,24,0,14,34
10,Success,45,27,7,12,33
10,Success,53,27,0,9,44
10,Success,40,37,0,13,27
10,Success,45,29,3,12,33
10,Success,47,29,0,11,36
10,Success,44,34,5,10,34
10,Success,39,42,0,11,28
10,Success,44,28,0,17,27
10,Success,42,37,0,13,29
10,Success,45,29,0,16,29
10,Success,50,28,0,10,40
10,Success,53,30,0,7,46
10,Success,44,32,6,11,33
10,Success,51,17,1,18,33
10,Success,46,27,8,12,34
10,Success,54,29,0,7,47
10,Success,48,27,0,16,32
10,Success,55,21,0,11,44
10,Success,43,25,7,19,24
10,Success,44,32,0,15,29
10,Success,51,35,2,6,45
10,Success,46,29,0,14,32
10,Success,56,22,0,11,45
10,Success,44,35,4,9,35
10,Success,48,25,2,16,32
10,Success,56,17,0,12,44
10,Success,48,26,5,12,36
10,Success,51,24,1,9,42
10,Success,52,19,2,13,39
10,Success,63,22,0,5,58
10,Success,53,23,0,11,42
10,Success,47,23,2,14,33
10,Success,49,18,10,16,33
10,Success,54,26,0,9,45
10,Success,36,37,0,17,19
10,Success,49,30,3,9,40
10,Success,46,31,0,12,34
10,Success,50,16,5,17,33
10,Success,49,27,2,15,34
10,Success,44,30,0,14,30
10,Success,46,32,0,13,33
10,Success,47,31,0,13,34
10,Success,45,33,0,13,32
10,Success,42,30,11,13,29
10,Success,53,19,3,14,39
10,Success,53,25,0,14,39
10,Success,54,19,1,15,39
10,Success,44,36,0,14,30
10,Success,45,31,0,14,31
10,Success,49,25,0,15,34
10,Success,50,27,4,6,44
10,Success,51,24,1,13,38
10,Success,51,24,0,13,38
10,Success,47,27,0,12,35
10,Success,47,26,2,16,31
10,Success,45,26,0,16,29
10,Success,46,24,0,19,27
10,Success,46,24,9,13,33
10,Success,45,23,0,18,27
10,Success,52,23,0,14,38
10,Success,43,33,0,15,28
10,Success,47,31,3,11,36
10,Success,40,29,12,11,29
10,Success,44,26,9,12,32
10,Success,52,21,7,10,42
10,Success,54,24,0,11,43
10,Success,48,27,7,9,39
10,Success,49,25,0,16,33
10,Success,40,34,7,14,26
10,Success,53,21,1,12,41
10,Success,62,18,4,8,54
10,Success,45,27,0,18,27
10,Success,50,24,0,14,36
10,Success,50,25,6,10,40
10,Success,52,25,5,8,44
10,Success,45,28,1,12,33
10,Success,51,23,0,11,40
10,Success,50,26,0,13,37
10,Success,52,30,0,9,43
10,Success,49,28,0,9,40
10,Success,48,23,6,10,38
10,Success,46,29,6,11,35
10,Success,52,23,0,16,36
10,Success,47,24,3,12,35
10,Success,51,28,0,12,39
10,Success,50,14,0,26,24
10,Success,48,27,0,13,35
10,Success,43,35,0,14,29
10,Success,44,27,0,18,26
10,Success,56,22,0,11,45
10,Success,44,28,0,18,26
10,Success,44,27,5,16,28
10,Success,53,25,3,10,43
10,Success,57,22,1,9,48
10,Success,45,33,0,11,34
10,Success,47,26,0,16,31
10,Success,54,17,2,15,39
10,Success,43,25,5,18,25
10,Success,45,18,11,17,28
10,Success,46,33,0,12,34
10,Success,51,27,0,14,37
10,Success,51,28,0,12,39
10,Success,51,29,0,11,40
10,Success,46,32,0,9,37
10,Success,59,16,2,14,45
10,Success,58,20,0,10,48
10,Success,51,27,0,15,36
10,Success,49,26,1,12,37
10,Success,52,25,0,14,38
10,Success,42,39,0,8,34
10,Success,44,23,3,17,27
10,Success,52,26,0,13,39
10,Success,50,18,8,16,34
10,Success,46,28,0,14,32
10,Success,52,29,0,10,42
10,Success,48,28,2,11,37
10,Success,49,29,0,16,33
10,Success,48,24,5,10,38
10,Success,48,27,8,10,38
10,Success,48,30,0,16,32
10,Success,34,38,0,21,13
10,Success,54,24,0,12,42
10,Success,47,21,4,20,27
10,Success,47,30,0,11,36
10,Success,44,36,0,14,30
10,Success,43,33,0,12,31
10,Success,50,22,0,17,33
10,Success,45,27,3,14,31
10,Success,47,24,5,12,35
10,Success,42,24,8,16,26
10,Success,42,25,4,15,27
10,Success,40,26,13,17,23
10,Success,41,31,5,12,29
10,Success,49,24,4,10,39
10,Success,54,23,1,11,43
10,Success,53,22,0,13,40
10,Success,51,30,3,7,44
10,Success,39,29,0,23,16
10,Success,47,36,0,12,35
10,Success,45,27,0,13,32
10,Success,44,34,0,15,29
10,Success,49,25,0,13,36
10,Success,45,23,12,13,32
10,Success,41,35,0,21,20
10,Success,55,27,0,7,48
10,Success,48,33,2,6,42
10,Success,44,30,6,14,30
10,Success,48,24,0,12,36
10,Success,55,23,0,10,45
10,Success,44,21,9,17,27
10,Success,45,33,5,8,37
10,Success,52,21,0,16,36
10,Success,50,26,5,10,40
10,Success,52,27,0,12,40
10,Success,51,26,0,10,41
10,Success,47,25,8,10,37
10,Success,42,28,6,14,28
10,Success,41,28,4,18,23
10,Success,47,27,0,15,32
10,Success,53,20,1,13,40
10,Success,49,23,8,8,41
10,Success,50,19,0,18,32
10,Success,49,24,5,16,33
10,Success,52,23,5,12,40
10,Success,53,28,2,9,44
10,Success,52,19,0,18,34
10,Success,46,27,6,12,34
10,Success,40,34,0,11,29
10,Success,50,27,2,13,37
10,Success,51,28,1,12,39
10,Success,50,22,2,16,34
10,Success,41,36,0,14,27
10,Success,48,28,0,14,34
10,Success,52,33,0,9,43
10,Success,51,16,5,13,38
10,Success,51,20,2,13,38
10,Success,51,21,0,14,37
10,Success,46,28,4,8,38
10,Success,45,23,1,18,27
10,Success,42,30,0,19,23
10,Success,44,22,1,18,26
10,Success,50,28,0,9,41
10,Success,49,27,4,11,38
10,Success,44,34,0,12,32
10,Success,46,27,0,15,31
10,Success,55,20,3,15,40
10,Success,54,32,0,8,46
10,Success,58,17,2,11,47
10,Success,46,28,0,13,33
10,Success,50,29,0,13,37
10,Success,41,33,5,12,29
10,Success,48,30,0,8,40
10,Success,50,33,0,9,41
10,Success,54,23,0,11,43
10,Success,54,23,0,14,40
10,Success,49,30,0,13,36
10,Success,46,25,7,12,34
10,Success,44,30,0,16,28
10,Success,47,27,0,14,33
10,Success,44,28,5,13,31
10,Success,54,26,4,3,51
10,Success,46,27,3,14,32
10,Success,59,18,1,11,48
10,Success,46,33,0,10,36
10,Success,51,22,7,8,43
10,Success,55,23,0,11,44
10,Success,52,26,0,7,45
10,Success,52,25,0,16,36
10,Success,53,30,0,10,43
10,Success,42,40,0,11,31
10,Success,48,32,0,11,37
10,Success,47,28,0,15,32
10,Success,45,26,1,18,27
10,Success,52,24,2,10,42
10,Success,41,36,0,14,27
10,Success,44,26,4,15,29
10,Success,52,23,0,9,43
10,Success,49,23,3,12,37
10,Success,52,25,1,10,42
10,Success,43,36,0,15,28
10,Success,49,33,0,11,38
10,Success,49,24,0,14,35
10,Success,53,27,0,8,45
10,Success,45,29,0,19,26
10,Success,46,28,0,17,29
10,Success,45,28,0,13,32
10,Success,45,32,0,14,31
10,Success,56,19,6,11,45
10,Success,43,22,7,18,25
10,Success,50,22,2,14,36
10,Success,49,28,1,10,39
10,Success,49,27,0,15,34
10,Success,45,22,2,22,23
10,Success,51,23,4,12,39
10,Success,55,22,0,14,41
10,Success,43,25,7,12,31
10,Success,51,26,0,12,39
10,Success,46,27,7,13,33
10,Success,51,31,0,10,41
10,Success,55,20,1,10,45
10,Success,51,29,0,12,39
10,Success,47,24,2,14,33
10,Success,51,29,0,10,41
10,Success,46,34,0,10,36
10,Success,49,33,0,6,43
10,Success,40,33,11,9,31
10,Success,50,23,0,14,36
10,Success,53,20,2,13,40
10,Success,53,24,0,11,42
10,Success,49,19,0,17,32
10,Success,51,24,0,12,39
10,Success,48,26,2,13,35
10,Success,46,26,5,12,34
10,Success,45,31,7,10,35
10,Success,45,34,0,11,34
10,Success,44,35,0,12,32
10,Success,52,34,0,9,43
10,Success,48,31,5,8,40
10,Success,47,24,1,15,32
10,Success,42,32,3,10,32
10,Success,50,27,0,12,38
10,Success,45,32,0,16,29
10,Success,44,26,6,15,29
10,Success,49,33,0,8,41
10,Success,45,25,7,10,35
10,Success,41,32,0,15,26
10,Success,47,26,0,19,28
10,Success,43,29,5,13,30
10,Success,50,24,0,13,37
10,Success,51,21,2,17,34
10,Success,57,21,0,13,44
10,Success,50,23,4,15,35
10,Success,51,24,0,11,40
10,Success,41,27,6,18,23
10,Success,51,26,4,10,41
10,Success,48,26,0,14,34
10,Success,40,32,0,17,23
10,Success,53,23,0,15,38
10,Success,49,28,0,14,35
10,Success,48,22,4,20,28
10,Success,47,32,0,11,36
10,Success,38,32,0,13,25
10,Success,47,33,0,10,37
10,Success,44,30,0,16,28
10,Success,54,21,0,16,38
10,Success,52,23,0,10,42
10,Success,43,33,0,18,25
10,Success,43,31,0,13,30
10,Success,48,31,0,14,34
10,Success,47,28,2,12,35
10,Success,54,21,5,10,44
10,Success,48,32,0,12,36
10,Success,47,23,3,17,30
10,Success,45,27,5,16,29
10,Success,54,20,5,12,42
10,Success,50,22,2,17,33
10,Success,42,30,3,17,25
10,Success,50,24,0,12,38
10,Success,52,26,0,11,41
10,Success,49,26,0,13,36
10,Success,48,30,0,12,36
10,Success,51,29,0,11,40
10,Success,50,18,0,19,31
10,Success,52,27,0,12,40
10,Success,49,32,0,9,40
10,Success,44,28,2,18,26
10,Success,48,27,0,11,37
10,Success,42,31,4,12,30
10,Success,44,36,0,11,33
10,Success,51,21,0,14,37
10,Success,46,32,0,12,34
10,Success,51,30,0,10,41
10,Success,52,21,3,11,41
10,Success,46,29,0,12,34
10,Success,49,27,0,17,32
10,Success,55,17,0,15,40
10,Success,49,22,4,18,31
10,Success,48,29,1,14,34
10,Success,55,22,4,7,48
10,Success,44,34,0,14,30
10,Success,58,22,0,5,53
10,Success,54,17,9,11,43
10,Success,41,30,0,12,29
10,Success,41,33,0,15,26
10,Success,47,33,0,10,37
10,Success,46,24,8,14,32
10,Success,45,25,8,10,35
10,Success,47,31,3,10,37
10,Success,50,24,0,16,34
10,Success,45,38,0,11,34
10,Success,52,22,6,11,41
10,Success,48,31,0,12,36
10,Success,55,23,0,10,45
10,Success,48,28,0,9,39
10,Success,42,26,0,20,22
10,Success,41,27,10,13,28
10,Success,52,23,2,13,39
10,Success,51,30,5,6,45
10,Success,43,32,0,14,29
10,Success,47,33,0,7,40
10,Success,54,20,0,14,40
10,Success,50,33,4,7,43
10,Success,41,33,0,14,27
10,Success,51,25,0,14,37
10,Success,42,40,0,10,32
10,Success,48,35,0,7,41
10,Success,58,20,1,7,51
10,Success,44,29,7,9,35
10,Success,50,21,2,17,33
10,Success,47,25,8,8,39
10,Success,48,25,1,15,33
10,Success,50,30,0,12,38
10,Success,54,22,1,10,44
10,Success,49,29,3,7,42
10,Success,53,23,0,12,41
10,Success,49,24,8,10,39
10,Success,50,22,0,13,37
10,Success,48,22,0,18,30
10,Success,48,30,0,11,37
10,Success,47,22,3,13,34
10,Success,55,27,0,7,48
10,Success,49,23,2,14,35
10,Success,57,20,3,8,49
10,Success,51,25,6,8,43
10,Success,50,18,3,21,29
10,Success,59,13,2,8,51
10,Success,49,18,7,19,30
10,Success,56,27,0,6,50
10,Success,39,36,0,18,21
10,Success,49,22,0,16,33
10,Success,45,24,0,20,25
10,Success,52,20,0,16,36
10,Success,52,20,1,13,39
10,Success,46,29,3,15,31
10,Success,50,25,0,14,36
10,Success,37,32,0,19,18
10,Success,49,26,0,9,40
10,Success,53,25,0,11,42
10,Success,52,20,6,11,41
10,Success,52,24,6,9,43
10,Success,51,16,7,15,36
10,Success,44,24,9,12,32
10,Success,58,20,0,12,46
10,Success,46,25,1,14,32
10,Success,44,24,9,14,30
10,Success,47,24,4,12,35
10,Success,53,25,0,11,42
10,Success,47,27,4,14,33
10,Success,48,28,6,11,37
10,Success,57,20,1,12,45
10,Success,49,25,0,15,34
10,Success,40,47,0,9,31
10,Success,51,26,2,10,41
10,Success,47,33,6,10,37
10,Success,45,34,0,12,33
10,Success,40,28,0,17,23
10,Success,54,23,2,11,43
10,Success,50,22,5,13,37
10,Success,50,20,5,11,39
10,Success,46,26,6,15,31
10,Success,54,18,0,15,39
10,Success,50,24,0,13,37
10,Success,48,24,5,14,34
10,Success,42,26,7,16,26
10,Success,47,28,0,13,34
10,Success,57,22,0,10,47
10,Success,47,23,5,12,35
10,Success,50,27,0,12,38
10,Success,46,32,0,13,33
10,Success,46,30,0,15,31
10,Success,49,33,0,12,37
10,Success,43,34,3,5,38
10,Success,52,26,0,9,43
10,Success,46,33,0,9,37
10,Success,50,19,2,19,31
10,Success,46,31,0,13,33
10,Success,43,21,4,22,21
10,Success,50,23,0,15,35
10,Success,50,26,0,13,37
10,Success,42,36,0,17,25
10,Success,51,25,6,8,43
10,Success,42,31,9,10,32
10,Success,53,26,2,7,46
10,Success,44,27,5,12,32
10,Success,49,25,0,15,34
10,Success,42,21,7,17,25
10,Success,56,19,0,9,47
10,Success,46,33,0,10,36
10,Success,44,26,5,16,28
10,Success,39,33,0,16,23
10,Success,45,30,0,16,29
10,Success,43,35,0,10,33
10,Success,51,24,0,15,36
10,Success,39,30,3,18,21
10,Success,47,28,0,15,32
10,Success,50,28,0,12,38
10,Success,46,21,10,16,30
10,Success,48,34,0,8,40
10,Success,38,35,0,17,21
10,Success,46,34,0,12,34
10,Success,47,23,0,18,29
10,Success,51,28,0,11,40
10,Success,47,21,7,13,34
10,Success,49,26,3,12,37
10,Success,47,32,0,12,35
10,Success,46,28,0,16,30
10,Success,45,34,0,10,35
10,Success,51,31,1,6,45
10,Success,49,28,0,12,37
10,Success,49,29,0,11,38
10,Success,55,21,2,11,44
10,Success,48,22,0,16,32
10,Success,43,27,0,23,20
10,Success,51,23,1,13,38
10,Success,36,43,0,14,22
10,Success,56,21,3,10,46
10,Success,52,25,0,13,39
10,Success,50,21,7,13,37
10,Success,55,26,0,9,46
10,Success,46,27,8,12,34
10,Success,49,24,6,11,38
10,Success,56,20,0,12,44
10,Success,50,29,0,12,38
10,Success,55,30,0,6,49
10,Success,47,23,0,19,28
10,Success,45,27,1,14,31
10,Success,45,32,0,13,32
10,Success,45,28,0,16,29
10,Success,44,33,0,11,33
10,Success,48,26,1,12,36
10,Success,52,25,0,12,40
10,Success,42,29,10,13,29
10,Success,46,26,2,14,32
10,Success,53,24,0,13,40
10,Success,50,22,8,7,43
10,Success,52,28,0,10,42
10,Success,52,24,5,9,43
10,Success,44,23,9,18,26
10,Success,49,27,2,12,37
10,Success,45,27,3,11,34
10,Success,53,29,0,8,45
10,Success,44,23,3,20,24
10,Success,52,29,0,13,39
10,Success,48,24,8,11,37
10,Success,43,30,1,14,29
10,Success,53,17,6,14,39
10,Success,50,24,4,6,44
10,Success,50,28,3,8,42
10,Success,52,19,0,14,38
10,Success,48,29,0,13,35
10,Success,44,28,4,13,31
10,Success,46,27,9,14,32
10,Success,40,34,0,16,24
10,Success,53,32,0,7,46
10,Success,47,21,10,12,35
10,Success,49,24,1,13,36
10,Success,54,24,5,11,43
10,Success,40,39,0,16,24
10,Success,41,39,0,10,31
10,Success,50,24,3,13,37
10,Success,49,24,5,15,34
10,Success,51,30,0,11,40
10,Success,43,36,0,9,34
10,Success,44,25,12,12,32
10,Success,54,25,4,8,46
10,Success,43,34,0,13,30
10,Success,49,30,0,11,38
10,Success,41,29,7,13,28
10,Success,42,33,7,11,31
10,Success,48,30,0,13,35
10,Success,51,29,0,11,40
10,Success,47,28,3,9,38
10,Success,49,32,0,7,42
10,Success,52,29,0,11,41
10,Success,48,28,0,14,34
10,Success,47,24,8,14,33
10,Success,59,19,2,10,49
10,Success,44,24,2,20,24
10,Success,49,34,0,11,38
10,Success,47,28,2,15,32
10,Success,40,39,0,12,28
10,Success,46,19,4,19,27
10,Success,47,31,0,11,36
10,Success,54,20,2,14,40
10,Success,40,30,9,13,27
10,Success,54,21,0,11,43
10,Success,52,24,1,13,39
10,Success,43,34,0,14,29
10,Success,40,39,0,12,28
10,Success,43,28,2,13,30
10,Success,53,26,0,10,43
10,Success,46,30,0,14,32
10,Success,47,33,1,8,39
10,Success,49,25,1,16,33
10,Success,48,25,0,11,37
10,Success,46,25,6,15,31
10,Success,43,39,0,15,28
10,Success,40,32,5,14,26
10,Success,48,16,13,14,34
10,Success,43,25,0,23,20
10,Success,47,25,1,14,33
10,Success,49,24,0,13,36
10,Success,44,29,9,8,36
10,Success,48,22,0,18,30
10,Success,43,27,1,19,24
10,Success,37,27,10,15,22
10,Success,49,24,9,11,38
10,Success,46,21,9,15,31
10,Success,51,26,0,13,38
10,Success,52,23,2,12,40
10,Success,49,29,0,10,39
10,Success,45,33,0,9,36
10,Success,48,24,7,10,38
10,Success,48,26,0,15,33
10,Success,52,24,0,12,40
10,Success,47,38,0,8,39
10,Success,54,16,8,11,43
10,Success,47,24,0,20,27
10,Success,46,36,0,6,40
10,Success,48,25,0,16,32
10,Success,52,25,0,11,41
10,Success,51,26,0,13,38
10,Success,42,31,3,11,31
10,Success,44,23,5,15,29
10,Success,48,23,0,19,29
10,Success,48,29,0,11,37
10,Success,52,21,0,14,38
10,Success,53,28,0,9,44
10,Success,50,27,0,13,37
10,Success,48,24,0,14,34
10,Success,51,28,5,9,42
10,Success,52,23,3,11,41
10,Success,46,30,0,12,34
10,Success,49,29,0,11,38
10,Success,39,30,13,13,26
10,Success,53,23,0,11,42
10,Success,48,34,0,12,36
10,Success,46,29,0,14,32
10,Success,43,30,0,13,30
10,Success,48,31,0,12,36
10,Success,48,20,11,13,35
10,Success,47,33,0,10,37
10,Success,42,37,0,13,29
10,Success,53,29,0,7,46
10,Success,43,28,8,14,29
10,Success,50,26,7,9,41
10,Success,45,30,0,11,34
10,Success,46,29,0,18,28
10,Success,50,19,0,17,33
10,Success,59,14,0,17,42
10,Success,43,32,0,12,31
10,Success,55,15,6,14,41
10,Success,57,24,0,9,48
10,Success,54,23,0,13,41
10,Success,52,19,2,15,37
10,Success,60,19,0,7,53
10,Success,45,29,0,13,32
10,Success,50,24,2,12,38
10,Success,44,31,3,12,32
10,Success,45,32,0,9,36
10,Success,48,32,0,13,35
10,Success,50,23,2,16,34
10,Success,40,39,0,14,26
10,Success,37,31,5,19,18
10,Success,43,29,7,13,30
10,Success,48,29,2,9,39
10,Success,53,29,0,9,44
10,Success,47,28,0,12,35
10,Success,42,25,0,23,19
10,Success,48,32,0,10,38
10,Success,48,30,0,9,39
10,Success,46,33,0,12,34
10,Success,42,21,7,17,25
10,Success,47,29,0,9,38
10,Success,45,32,0,12,33
10,Success,41,33,0,13,28
10,Success,51,22,4,12,39
10,Success,56,21,0,6,50
10,Success,52,24,0,12,40
10,Success,49,31,0,12,37
10,Success,54,24,5,9,45
10,Success,49,29,3,12,37
10,Success,51,29,0,12,39
10,Success,49,28,0,11,38
10,Success,50,25,0,9,41
10,Success,54,28,0,8,46
10,Success,50,17,1,20,30
10,Success,54,23,4,11,43
10,Success,47,29,6,11,36
10,Success,46,28,0,15,31
10,Success,53,27,0,11,42
10,Success,44,26,1,16,28
10,Success,48,34,0,8,40
10,Success,51,18,3,19,32
10,Success,49,22,6,14,35
10,Success,45,28,3,12,33
10,Success,50,26,4,12,38
10,Success,44,27,6,11,33
10,Success,51,30,4,7,44
10,Success,47,24,8,12,35
10,Success,53,26,0,9,44
10,Success,46,25,2,16,30
10,Success,45,31,0,11,34
10,Success,47,31,3,10,37
10,Success,50,33,0,11,39
10,Success,47,27,8,11,36
10,Success,47,25,3,12,35
10,Success,51,27,0,7,44
10,Success,50,28,1,7,43
10,Success,49,28,0,11,38
10,Success,44,33,0,11,33
10,Success,43,28,8,11,32
10,Success,47,35,2,10,37
10,Success,49,20,4,12,37
10,Success,60,20,3,10,50
10,Success,45,26,3,10,35
10,Success,51,25,4,11,40
10,Success,46,28,0,14,32
10,Success,51,24,0,11,40
10,Success,37,32,3,17,20
10,Success,49,30,0,17,32
10,Success,51,27,2,11,40
10,Success,46,25,0,21,25
10,Success,52,28,6,7,45
10,Success,48,29,0,16,32
10,Success,50,26,0,12,38
10,Success,48,21,9,14,34
10,Success,46,26,1,19,27
10,Success,46,32,0,15,31
10,Success,49,23,0,14,35
10,Success,47,31,0,17,30
10,Success,51,28,0,13,38
10,Success,46,28,4,13,33
10,Success,42,38,0,14,28
10,Success,48,29,0,13,35
10,Success,44,30,0,14,30
10,Success,46,27,0,13,33
10,Success,57,19,0,12,45
10,Success,53,24,0,11,42
10,Success,46,34,5,7,39
10,Success,41,32,0,17,24
10,Success,51,24,0,13,38
10,Success,49,20,7,14,35
10,Success,55,17,3,15,40
10,Success,51,25,0,11,40
10,Success,53,25,2,10,43
10,Success,39,29,0,18,21
10,Success,57,22,2,10,47
10,Success,51,22,5,11,40
10,Success,51,26,4,11,40
10,Success,49,29,0,10,39
10,Success,43,31,9,11,32
10,Success,46,22,3,20,26
10,Success,50,28,0,13,37
10,Success,51,22,6,13,38
10,Success,56,16,5,14,42
10,Success,43,27,8,16,27
10,Success,52,25,3,11,41
10,Success,49,26,5,7,42
10,Success,46,26,2,16,30
10,Success,45,20,5,18,27
10,Success,43,36,0,14,29
10,Success,43,31,0,17,26
10,Success,46,36,0,10,36
10,Success,46,25,3,13,33
10,Success,61,19,0,10,51
10,Success,47,32,0,16,31
10,Success,46,27,6,11,35
10,Success,44,31,6,11,33
10,Success,47,29,4,11,36
10,Success,42,35,0,16,26
10,Success,44,26,4,16,28
10,Success,43,29,0,16,27
10,Success,49,27,3,11,38
10,Success,53,28,0,9,44
10,Success,46,37,0,9,37
10,Success,41,31,0,17,24
10,Success,54,18,9,13,41
10,Success,45,38,0,11,34
10,Success,55,11,7,15,40
10,Success,54,21,1,12,42
10,Success,54,22,7,12,42
10,Success,47,24,0,20,27
10,Success,38,34,0,17,21
10,Success,52,23,1,10,42
10,Success,49,26,0,17,32
10,Success,43,32,7,10,33
10,Success,46,30,2,10,36
10,Success,47,31,0,11,36
10,Success,54,22,0,12,42
10,Success,55,24,0,12,43
10,Success,48,28,1,12,36
10,Success,53,23,2,9,44
10,Success,47,27,3,12,35
10,Success,55,21,0,12,43
10,Success,53,27,0,10,43
10,Success,49,22,1,15,34
10,Success,47,24,0,20,27
10,Success,50,30,0,11,39
10,Success,51,23,0,12,39
10,Success,50,28,0,10,40
10,Success,50,27,0,10,40
10,Success,42,31,7,10,32
10,Success,47,23,4,16,31
10,Success,48,30,0,12,36
10,Success,54,16,1,11,43
10,Success,48,25,0,14,34
10,Success,46,27,6,13,33
10,Success,55,16,3,13,42
10,Success,50,30,0,11,39
10,Success,41,44,0,4,37
10,Success,53,24,0,15,38
10,Success,46,30,6,11,35
10,Success,49,28,0,8,41
10,Success,48,23,2,16,32
10,Success,46,29,2,15,31
10,Success,49,26,0,16,33
10,Success,50,29,0,13,37
10,Success,49,23,0,14,35
10,Success,51,18,3,18,33
10,Success,53,23,0,9,44
10,Success,47,29,4,8,39
10,Success,45,27,0,18,27
10,Success,56,21,3,8,48
10,Success,42,29,8,13,29
10,Success,45,26,2,17,28
10,Success,49,17,1,21,28
10,Success,49,23,0,17,32
10,Success,44,24,5,20,24
10,Success,50,23,2,10,40
10,Success,52,27,0,12,40
10,Success,44,24,4,18,26
10,Success,45,27,0,16,29
10,Success,56,22,1,8,48
10,Success,44,34,0,13,31
10,Success,47,21,5,16,31
10,Success,48,26,6,12,36
10,Success,48,29,0,13,35
10,Success,52,23,0,15,37
10,Success,49,27,0,14,35
10,Success,40,34,0,17,23
10,Success,55,25,0,10,45
10,Success,42,33,4,9,33
10,Success,44,29,2,14,30
10,Success,55,18,2,13,42
10,Success,40,34,5,13,27
10,Success,52,20,6,12,40
10,Success,46,29,0,17,29
10,Success,43,27,4,12,31
10,Success,48,36,0,10,38
10,Success,51,23,5,12,39
10,Success,39,40,0,14,25
10,Success,49,22,3,14,35
10,Success,47,28,0,16,31
10,Success,55,24,0,12,43
10,Success,54,22,0,12,42
10,Success,48,26,1,12,36
10,Success,56,27,0,7,49
10,Success,40,27,0,18,22
10,Success,49,24,16,7,42
10,Success,47,24,6,17,30
10,Success,49,23,3,13,36
10,Success,50,25,5,13,37
10,Success,51,28,0,13,38
10,Success,49,29,0,13,36
10,Success,44,38,0,11,33
10,Success,51,27,2,10,41
10,Success,48,23,0,16,32
10,Success,46,29,0,15,31
10,Success,42,31,4,10,32
10,Success,46,23,0,21,25
10,Success,39,27,12,16,23
10,Success,58,20,3,10,48
10,Success,50,30,0,7,43
10,Success,45,22,7,19,26
10,Success,59,18,0,11,48
10,Success,49,29,0,11,38
10,Success,47,37,0,6,41
10,Success,50,25,0,14,36
10,Success,48,24,0,16,32
10,Success,45,28,1,16,29
10,Success,41,30,1,16,25
10,Success,39,39,0,15,24
10,Success,51,23,0,18,33
10,Success,39,34,3,11,28
10,Success,49,27,5,12,37
10,Success,48,32,0,8,40
10,Success,43,21,10,14,29
10,Success,46,28,2,13,33
10,Success,42,31,10,9,33
10,Success,47,26,5,12,35
10,Success,43,27,11,11,32
10,Success,43,28,5,15,28
10,Success,39,39,0,13,26
10,Success,44,30,4,12,32
10,Success,46,25,7,13,33
10,Success,56,22,1,10,46
10,Success,52,27,2,10,42
10,Success,41,33,0,14,27
10,Success,41,33,3,13,28
10,Success,52,25,0,11,41
10,Success,45,22,3,18,27
10,Success,43,21,2,22,21
10,Success,46,28,0,13,33
10,Success,46,25,5,15,31
10,Success,38,33,0,20,18
10,Success,47,25,1,15,32
10,Success,54,24,0,13,41
10,Success,45,22,7,20,25
10,Success,45,28,7,12,33
10,Success,57,14,3,18,39
10,Success,47,22,8,14,33
10,Success,38,47,0,8,30
10,Success,44,34,0,14,30
10,Success,51,22,6,10,41
10,Success,56,22,1,12,44
10,Success,49,34,0,12,37
10,Success,43,24,6,16,27
10,Success,57,22,2,10,47
10,Success,49,21,7,15,34
10,Success,47,29,1,14,33
10,Success,39,42,0,11,28
10,Success,46,25,5,12,34
10,Success,45,33,0,13,32
10,Success,45,23,0,19,26
10,Success,46,23,9,14,32
10,Success,39,34,0,22,17
10,Success,46,33,2,9,37
10,Success,37,28,12,15,22
10,Success,49,23,5,16,33
10,Success,52,28,2,9,43
10,Success,45,28,0,20,25
10,Success,46,27,5,14,32
10,Success,43,24,2,23,20
10,Success,47,24,3,12,35
10,Success,43,37,0,13,30
10,Success,48,30,0,14,34
10,Success,54,27,0,6,48
10,Success,50,25,3,13,37
10,Success,48,21,8,20,28
10,Success,49,23,6,12,37
10,Success,45,31,0,11,34
10,Success,50,23,3,11,39
10,Success,45,31,0,13,32
10,Success,47,33,0,10,37
10,Success,43,29,0,13,30
10,Success,43,27,0,17,26
10,Success,46,27,0,12,34
10,Success,50,26,0,14,36
10,Success,49,34,0,7,42
10,Success,35,41,0,14,21
10,Success,43,28,0,21,22
10,Success,50,28,2,8,42
10,Success,51,23,0,14,37
10,Success,46,33,0,8,38
10,Success,45,33,0,16,29
10,Success,51,28,1,9,42
10,Success,52,25,0,12,40
10,Success,44,24,8,14,30
10,Success,52,16,4,19,33
10,Success,50,28,0,9,41
10,Success,44,33,5,10,34
10,Success,40,23,8,14,26
10,Success,49,29,0,11,38
10,Success,47,24,7,11,36
10,Success,38,24,7,17,21
10,Success,47,25,1,15,32
10,Success,43,29,0,14,29
10,Success,48,26,0,12,36
10,Success,49,27,1,9,40
10,Success,47,31,0,14,33
10,Success,36,42,6,9,27
10,Success,46,29,3,12,34
10,Success,44,32,0,14,30
10,Success,51,20,0,17,34
10,Success,52,28,0,11,41
10,Success,44,30,2,13,31
10,Success,47,29,0,12,35
10,Success,45,32,0,12,33
10,Success,45,30,0,17,28
10,Success,48,30,0,11,37
10,Success,46,19,6,18,28
10,Success,57,17,3,14,43
10,Success,45,35,0,13,32
10,Success,52,30,0,10,42
10,Success,43,27,9,14,29
10,Success,44,35,0,8,36
10,Success,50,22,0,16,34
10,Success,52,24,8,9,43
10,Success,49,31,0,8,41
10,Success,53,23,3,10,43
10,Success,46,30,0,11,35
10,Success,45,22,0,19,26
10,Success,45,25,0,19,26
10,Success,51,27,0,11,40
10,Success,47,28,1,13,34
10,Success,48,26,2,14,34
10,Success,45,23,4,20,25
10,Success,53,24,5,11,42
10,Success,48,34,0,7,41
10,Success,54,17,3,15,39
10,Success,53,21,3,11,42
10,Success,49,27,5,11,38
10,Success,46,21,12,15,31
10,Success,37,45,0,14,23
10,Success,42,32,0,16,26
10,Success,50,27,6,4,46
10,Success,51,22,0,14,37
10,Success,49,24,4,15,34
10,Success,49,18,3,16,33
10,Success,48,25,0,15,33
10,Success,42,23,0,18,24
10,Success,53,27,1,11,42
10,Success,48,21,1,17,31
10,Success,44,30,0,13,31
10,Success,48,23,2,14,34
10,Success,48,24,0,15,33
10,Success,54,20,0,16,38
10,Success,41,31,3,13,28
10,Success,42,23,7,18,24
10,Success,51,25,4,9,42
10,Success,51,31,0,5,46
10,Success,50,20,1,15,35
10,Success,54,25,0,9,45
10,Success,49,22,3,14,35
10,Success,51,21,8,13,38
10,Success,50,22,0,15,35
10,Success,44,32,0,14,30
10,Success,51,19,1,14,37
10,Success,47,27,0,17,30
10,Success,51,29,3,7,44
10,Success,52,24,0,9,43
10,Success,47,27,0,13,34
10,Success,42,21,0,26,16
10,Success,49,31,0,10,39
10,Success,40,30,0,20,20
10,Success,40,33,0,15,25
10,Success,50,21,6,15,35
10,Success,48,35,0,10,38
10,Success,46,35,1,8,38
10,Success,44,29,1,15,29
10,Success,50,30,0,13,37
10,Success,53,22,0,16,37
10,Success,47,21,7,17,30
10,Success,44,30,10,10,34
10,Success,46,33,0,15,31
10,Success,34,38,0,18,16
10,Success,42,29,9,13,29
10,Success,49,24,5,12,37
10,Success,52,26,1,7,45
10,Success,50,25,3,7,43
10,Success,38,34,0,16,22
10,Success,52,28,0,11,41
10,Success,48,27,0,15,33
10,Success,47,29,5,12,35
10,Success,43,36,0,12,31
10,Success,43,34,0,12,31
10,Success,51,25,3,12,39
10,Success,49,27,0,17,32
10,Success,46,40,0,6,40
10,Success,35,38,0,20,15
10,Success,47,30,0,9,38
10,Success,44,38,0,11,33
10,Success,44,32,3,10,34
10,Success,48,34,4,9,39
10,Success,52,23,1,10,42
10,Success,55,26,0,9,46
10,Success,58,20,0,9,49
10,Success,53,32,0,4,49
10,Success,47,26,1,14,33
10,Success,49,21,0,17,32
10,Success,46,28,0,12,34
10,Success,48,20,2,20,28
10,Success,44,31,0,13,31
10,Success,48,21,6,17,31
10,Success,47,31,0,13,34
10,Success,51,28,0,11,40
10,Success,49,23,3,15,34
10,Success,38,43,0,9,29
10,Success,53,26,0,12,41
10,Success,50,26,0,19,31
10,Success,43,38,0,10,33
10,Success,41,37,0,16,25
10,Success,40,27,5,16,24
10,Success,47,19,8,15,32
10,Success,56,24,2,8,48
10,Success,46,25,3,16,30
10,Success,42,34,2,12,30
10,Success,47,31,2,8,39
10,Success,51,21,6,10,41
10,Success,50,28,0,14,36
10,Success,47,25,0,13,34
10,Success,47,29,0,14,33
10,Success,48,29,0,13,35
10,Success,49,24,0,17,32
10,Success,45,28,8,9,36
10,Success,56,29,3,6,50
10,Success,48,20,7,14,34
10,Success,49,29,0,12,37
10,Success,53,23,3,10,43
10,Success,53,24,6,8,45
10,Success,49,33,4,7,42
10,Success,49,24,5,12,37
10,Success,47,28,2,17,30
10,Success,48,32,1,7,41
10,Success,47,33,0,11,36
10,Success,47,29,0,11,36
10,Success,45,24,6,14,31
10,Success,45,29,3,11,34
10,Success,50,23,3,12,38
10,Success,55,15,6,12,43
10,Success,47,33,2,9,38
10,Success,49,21,4,12,37
10,Success,49,29,0,12,37
10,Success,47,21,9,16,31
10,Success,53,25,0,7,46
10,Success,46,20,6,17,29
10,Success,55,27,0,5,50
10,Success,57,20,0,10,47
10,Success,47,27,3,11,36
10,Success,41,23,6,18,23
10,Success,48,32,0,9,39
10,Success,45,32,0,12,33
10,Success,47,32,0,9,38
10,Success,48,26,0,12,36
10,Success,45,32,4,9,36
10,Success,47,30,0,14,33
10,Success,52,28,0,10,42
10,Success,44,28,0,17,27
10,Success,52,28,0,10,42
10,Success,56,21,1,11,45
10,Success,61,14,1,12,49
10,Success,50,28,0,11,39
10,Success,50,28,1,11,39
10,Success,54,23,0,12,42
10,Success,38,24,10,18,20
10,Success,46,26,1,16,30
10,Success,50,30,0,11,39
10,Success,46,23,5,17,29
10,Success,50,30,2,7,43
10,Success,51,17,0,18,33
10,Success,55,23,0,9,46
10,Success,50,19,9,13,37
10,Success,44,39,0,7,37
10,Success,48,24,3,11,37
10,Success,47,29,0,13,34
10,Success,54,18,0,15,39
10,Success,50,25,2,12,38
10,Success,49,23,0,14,35
10,Success,44,34,0,17,27
10,Success,39,33,4,13,26
10,Success,55,21,0,12,43
10,Success,44,23,2,17,27
10,Success,52,27,2,9,43
10,Success,51,28,0,11,40
10,Success,41,32,0,18,23
10,Success,44,28,12,8,36
10,Success,51,30,0,11,40
10,Success,48,30,0,11,37
10,Success,51,25,0,13,38
10,Success,58,26,0,9,49
10,Success,48,25,4,13,35
10,Success,42,33,0,15,27
10,Success,46,33,0,13,33
10,Success,45,26,4,14,31
10,Success,39,26,13,11,28
10,Success,54,21,1,9,45
10,Success,47,29,0,14,33
10,Success,49,33,0,12,37
10,Success,46,28,2,10,36
10,Success,49,21,3,17,32
10,Success,49,30,0,11,38
10,Success,56,25,0,10,46
10,Success,47,22,9,16,31
10,Success,48,27,0,14,34
10,Success,50,27,0,10,40
10,Success,47,30,0,9,38
10,Success,46,26,0,17,29
10,Success,47,24,3,12,35
10,Success,44,29,0,14,30
10,Success,51,30,0,11,40
10,Success,46,29,5,10,36
10,Success,51,22,0,15,36
10,Success,50,30,0,10,40
10,Success,54,28,0,9,45
10,Success,48,25,0,12,36
10,Success,53,27,3,9,44
10,Success,45,25,8,12,33
10,Success,49,23,0,16,33
10,Success,47,21,10,14,33
10,Success,51,30,0,9,42
10,Success,47,31,0,12,35
10,Success,53,17,8,13,40
10,Success,45,28,0,15,30
10,Success,57,14,3,13,44
10,Success,53,27,0,8,45
10,Success,47,32,2,8,39
10,Success,48,20,4,17,31
10,Success,49,27,1,11,38
10,Success,54,27,0,7,47
10,Success,40,25,2,22,18
10,Success,42,29,0,19,23
10,Success,47,29,0,13,34
10,Success,46,27,12,8,38
10,Success,54,25,0,10,44
10,Success,54,21,0,13,41
10,Success,50,23,5,12,38
10,Success,50,27,0,12,38
10,Success,42,31,7,12,30
10,Success,51,27,0,12,39
10,Success,49,28,1,10,39
10,Success,48,25,0,14,34
10,Success,57,22,0,11,46
10,Success,55,18,6,10,45
10,Success,46,26,1,14,32
10,Success,53,29,0,9,44
10,Success,50,30,0,12,38
10,Success,49,26,0,15,34
10,Success,50,25,0,15,35
10,Success,48,27,1,15,33
10,Success,46,30,0,14,32
10,Success,42,25,2,21,21
10,Success,50,28,0,13,37
10,Success,50,29,1,9,41
10,Success,40,39,0,14,26
10,Success,50,23,9,10,40
10,Success,44,31,0,15,29
10,Success,45,28,1,14,31
10,Success,45,29,5,13,32
10,Success,44,27,10,10,34
10,Success,51,23,0,12,39
10,Success,53,21,0,16,37
10,Success,45,27,0,11,34
10,Success,51,21,0,16,35
10,Success,45,29,7,10,35
10,Success,48,31,0,8,40
10,Success,51,27,0,14,37
10,Success,48,21,3,18,30
10,Success,47,29,0,14,33
10,Success,41,27,11,12,29
10,Success,46,29,0,15,31
10,Success,45,28,0,15,30
10,Success,54,22,0,15,39
10,Success,44,25,0,22,22
10,Success,44,28,9,12,32
10,Success,45,26,1,14,31
10,Success,57,17,0,12,45
10,Success,53,19,7,13,40
10,Success,56,24,0,9,47
10,Success,46,28,1,10,36
10,Success,51,23,0,16,35
10,Success,45,30,5,11,34
10,Success,42,34,0,13,29
10,Success,51,27,0,12,39
10,Success,40,36,0,14,26
10,Success,50,27,0,10,40
10,Success,40,33,0,16,24
10,Success,41,33,0,17,24
10,Success,48,26,0,17,31
10,Success,48,31,1,9,39
10,Success,44,26,11,11,33
10,Success,43,29,4,14,29
10,Success,47,24,8,15,32
10,Success,48,29,1,9,39
10,Success,48,25,0,17,31
10,Success,37,40,0,10,27
10,Success,35,33,9,16,19
10,Success,43,31,0,15,28
10,Success,42,26,16,10,32
10,Success,39,39,3,6,33
10,Success,50,26,0,12,38
10,Success,47,29,0,13,34
10,Success,42,36,0,10,32
10,Success,48,26,0,15,33
10,Success,47,27,0,17,30
10,Success,51,26,3,9,42
10,Success,53,19,0,14,39
10,Success,51,24,0,10,41
10,Success,51,32,0,10,41
10,Success,50,29,0,8,42
10,Success,40,28,6,17,23
10,Success,49,23,8,10,39
10,Success,43,25,9,19,24
10,Success,46,28,7,12,34
10,Success,58,18,0,13,45
10,Success,48,31,0,12,36
10,Success,40,27,5,18,22
10,Success,53,29,0,10,43
10,Success,51,28,0,13,38
10,Success,45,34,0,13,32
10,Success,49,33,0,6,43
10,Success,44,29,4,13,31
10,Success,46,23,5,16,30
10,Success,45,35,0,13,32
10,Success,48,24,0,18,30
10,Success,48,30,0,11,37
10,Success,47,30,0,15,32
10,Success,58,17,0,13,45
10,Success,48,35,0,8,40
10,Success,50,30,0,11,39
10,Success,52,23,3,14,38
10,Success,43,31,8,11,32
10,Success,50,21,4,12,38
10,Success,45,29,0,17,28
10,Success,46,31,4,10,36
10,Success,54,23,0,12,42
10,Success,49,29,2,9,40
10,Success,49,24,3,10,39
10,Success,45,39,0,9,36
10,Success,47,26,3,13,34
10,Success,53,27,2,10,43
10,Success,42,31,0,12,30
10,Success,62,15,1,9,53
10,Success,49,27,4,10,39
10,Success,47,24,2,9,38
10,Success,53,21,2,13,40
10,Success,43,36,0,14,29
10,Success,52,27,0,13,39
10,Success,49,32,0,10,39
10,Success,44,28,6,13,31
10,Success,44,37,0,10,34
10,Success,54,26,1,7,47
10,Success,46,31,0,9,37
10,Success,54,23,2,13,41
10,Success,52,23,0,13,39
10,Success,45,30,4,9,36
10,Success,46,24,2,11,35
10,Success,50,26,0,18,32
10,Success,45,30,0,15,30
10,Success,50,24,6,12,38
10,Success,48,20,1,18,30
10,Success,48,29,2,9,39
10,Success,46,29,1,12,34
10,Success,50,22,0,13,37
10,Success,53,20,0,12,41
10,Success,48,31,0,8,40
10,Success,44,27,5,14,30
10,Success,50,24,0,13,37
10,Success,54,21,0,13,41
10,Success,49,35,0,10,39
10,Success,38,34,6,15,23
10,Success,55,21,0,11,44
10,Success,48,32,0,11,37
10,Success,45,26,8,10,35
10,Success,54,28,0,7,47
10,Success,52,21,0,14,38
10,Success,46,23,7,12,34
10,Success,50,22,3,16,34
10,Success,50,35,0,7,43
10,Success,49,28,0,13,36
10,Success,42,37,0,12,30
10,Success,39,29,4,16,23
10,Success,52,25,10,8,44
10,Success,50,22,2,13,37
10,Success,44,30,0,13,31
10,Success,47,24,5,14,33
10,Success,45,28,0,17,28
10,Success,58,27,0,8,50
10,Success,53,21,6,13,40
10,Success,47,28,0,11,36
10,Success,49,33,0,8,41
10,Success,52,28,0,11,41
10,Success,49,28,0,11,38
10,Success,49,29,1,10,39
10,Success,49,26,9,10,39
10,Success,55,21,0,14,41
10,Success,48,24,2,14,34
10,Success,48,28,0,10,38
10,Success,50,23,2,11,39
10,Success,41,36,0,16,25
10,Success,43,31,0,13,30
10,Success,54,21,0,13,41
10,Success,51,19,0,19,32
10,Success,46,28,6,13,33
10,Success,42,31,0,15,27
10,Success,46,26,4,13,33
10,Success,51,24,0,14,37
10,Success,49,35,0,6,43
10,Success,43,32,0,16,27
10,Success,49,29,0,14,35
10,Success,50,23,0,16,34
10,Success,42,31,5,11,31
10,Success,52,27,1,10,42
10,Success,51,20,6,14,37
10,Success,46,28,0,13,33
10,Success,48,34,0,8,40
10,Success,52,27,0,12,40
10,Success,49,23,9,11,38
10,Success,55,22,0,9,46
10,Success,51,21,6,12,39
10,Success,58,23,0,8,50
10,Success,52,29,0,11,41
10,Success,42,27,9,13,29
10,Success,45,34,0,12,33
10,Success,47,32,0,11,36
10,Success,49,22,3,13,36
10,Success,46,25,5,9,37
10,Success,44,27,0,17,27
10,Success,51,26,3,11,40
10,Success,52,23,2,11,41
10,Success,43,29,3,17,26
10,Success,55,22,0,16,39
10,Success,51,20,4,15,36
10,Success,44,38,0,9,35
10,Success,54,28,0,9,45
10,Success,43,28,0,14,29
10,Success,48,24,8,12,36
10,Success,54,23,1,11,43
10,Success,48,32,0,12,36
10,Success,53,32,1,8,45
10,Success,46,28,3,13,33
10,Success,53,22,0,13,40
10,Success,47,25,0,16,31
10,Success,48,26,10,12,36
10,Success,52,21,0,12,40
10,Success,53,20,1,11,42
10,Success,46,30,0,14,32
10,Success,57,22,0,11,46
10,Success,47,26,2,11,36
10,Success,44,30,0,15,29
10,Success,48,27,2,11,37
10,Success,46,28,4,10,36
10,Success,60,17,0,9,51
10,Success,41,30,2,12,29
10,Success,43,29,12,9,34
10,Success,57,15,0,14,43
10,Success,44,31,4,9,35
10,Success,52,25,4,10,42
10,Success,46,27,0,18,28
10,Success,43,42,0,9,34
10,Success,47,32,0,11,36
10,Success,45,31,0,12,33
10,Success,45,30,1,16,29
10,Success,51,26,0,16,35
10,Success,54,25,3,5,49
10,Success,53,24,2,9,44
10,Success,51,22,4,15,36
10,Success,55,27,0,9,46
10,Success,46,25,0,22,24
10,Success,49,30,0,11,38
10,Success,43,33,0,13,30
10,Success,48,34,0,8,40
10,Success,47,32,0,12,35
10,Success,53,22,4,10,43
10,Success,46,26,1,14,32
10,Success,46,33,0,12,34
10,Success,46,29,0,12,34
10,Success,46,29,0,16,30
10,Success,45,22,2,20,25
10,Success,54,23,0,10,44
10,Success,52,24,5,5,47
10,Success,49,28,4,10,39
10,Success,46,28,5,12,34
10,Success,56,22,5,6,50
10,Success,51,23,4,12,39
10,Success,43,32,0,15,28
10,Success,51,24,0,12,39
10,Success,47,26,0,16,31
10,Success,43,28,0,18,25
10,Success,54,24,0,11,43
10,Success,57,21,1,10,47
10,Success,51,22,3,13,38
10,Success,54,17,0,14,40
10,Success,42,33,9,11,31
10,Success,47,25,0,19,28
10,Success,51,34,0,9,42
10,Success,55,27,0,9,46
10,Success,57,23,0,6,51
10,Success,44,37,0,14,30
10,Success,53,24,0,8,45
10,Success,51,27,8,9,42
10,Success,39,43,0,11,28
10,Success,49,33,0,6,43
10,Success,46,29,0,12,34
10,Success,52,21,0,18,34
10,Success,47,25,0,16,31
10,Success,49,23,0,14,35
10,Success,45,36,0,9,36
10,Success,43,28,5,13,30
10,Success,48,26,0,16,32
10,Success,40,33,0,19,21
10,Success,48,33,0,9,39
10,Success,51,25,0,10,41
10,Success,59,10,1,15,44
10,Success,43,33,3,10,33
10,Success,39,37,0,16,23
10,Success,43,31,4,12,31
10,Success,46,28,4,12,34
10,Success,50,24,1,15,35
10,Success,44,25,8,14,30
10,Success,51,24,1,13,38
10,Success,51,29,0,10,41
10,Success,51,32,3,4,47
10,Success,49,27,1,14,35
10,Success,47,23,4,18,29
10,Success,48,31,0,12,36
10,Success,45,35,0,11,34
10,Success,43,31,0,16,27
10,Success,50,23,0,15,35
10,Success,46,27,4,10,36
10,Success,52,18,4,13,39
10,Success,50,22,6,16,34
10,Success,51,22,6,13,38
10,Success,45,26,0,17,28
10,Success,45,19,5,20,25
10,Success,48,32,0,8,40
10,Success,48,23,1,15,33
10,Success,36,38,0,16,20
10,Success,43,28,1,14,29
10,Success,43,31,2,13,30
10,Success,52,29,0,10,42
10,Success,46,30,0,10,36
10,Success,49,23,1,13,36
10,Success,41,40,0,10,31
10,Success,43,35,0,10,33
10,Success,45,37,0,9,36
10,Success,45,30,6,11,34
10,Success,49,22,0,20,29
10,Success,48,26,7,11,37
10,Success,48,33,0,10,38
10,Success,52,19,1,15,37
10,Success,43,27,5,17,26
10,Success,50,22,3,15,35
10,Success,49,25,7,9,40
10,Success,59,18,0,9,50
10,Success,58,12,4,14,44
10,Success,46,35,1,10,36
10,Success,53,19,0,18,35
10,Success,44,29,5,14,30
10,Success,46,28,2,10,36
10,Success,54,21,3,12,42
10,Success,55,22,0,12,43
10,Success,50,31,1,8,42
10,Success,41,41,0,12,29
10,Success,45,35,0,11,34
10,Success,54,25,1,10,44
10,Success,43,28,2,12,31
10,Success,46,29,0,13,33
10,Success,48,30,0,10,38
10,Success,48,24,4,9,39
10,Success,45,32,0,8,37
10,Success,43,31,0,14,29
10,Success,49,27,0,13,36
10,Success,53,29,0,12,41
10,Success,38,32,10,12,26
10,Success,51,28,1,9,42
10,Success,42,25,10,16,26
10,Success,53,23,0,14,39
10,Success,50,24,9,10,40
10,Success,49,23,1,14,35
10,Success,47,26,4,14,33
10,Success,47,27,0,13,34
10,Success,43,36,1,11,32
10,Success,53,22,0,11,42
10,Success,49,22,3,15,34
10,Success,49,23,6,15,34
20,Success,47,34,0,6,41
20,Success,51,24,0,9,42
20,Success,44,28,6,9,35
20,Success,46,26,0,18,28
20,Success,53,24,0,14,39
20,Success,45,28,4,15,30
20,Success,55,19,2,15,40
20,Success,45,25,2,15,30
20,Success,48,24,4,14,34
20,Success,43,27,0,14,29
20,Success,48,21,5,18,30
20,Success,47,29,4,8,39
20,Success,47,28,3,10,37
20,Success,43,34,0,15,28
20,Success,41,44,0,8,33
20,Success,50,27,0,12,38
20,Success,47,28,0,16,31
20,Success,45,28,2,15,30
20,Success,45,35,2,7,38
20,Success,50,30,0,10,40
20,Success,46,30,2,11,35
20,Success,51,17,6,13,38
20,Success,49,22,9,11,38
20,Success,51,23,4,14,37
20,Success,48,31,0,12,36
20,Success,46,25,8,11,35
20,Success,48,25,0,14,34
20,Success,43,31,0,15,28
20,Success,56,28,0,9,47
20,Success,50,25,1,14,36
20,Success,49,28,0,15,34
20,Success,52,24,0,12,40
20,Success,56,15,3,15,41
20,Success,46,25,0,15,31
20,Success,48,29,0,13,35
20,Success,56,23,0,12,44
20,Success,52,34,0,5,47
20,Success,50,22,4,14,36
20,Success,53,28,0,10,43
20,Success,53,23,0,12,41
20,Success,54,27,0,8,46
20,Success,49,22,3,15,34
20,Success,42,36,0,13,29
20,Success,46,30,0,16,30
20,Success,46,26,2,16,30
20,Success,44,24,1,20,24
20,Success,53,24,3,11,42
20,Success,46,33,0,11,35
20,Success,52,23,5,11,41
20,Success,48,26,0,15,33
20,Success,47,26,4,10,37
20,Success,42,31,0,16,26
20,Success,52,26,0,12,40
20,Success,53,25,1,10,43
20,Success,48,26,4,11,37
20,Success,50,25,0,12,38
20,Success,51,27,0,11,40
20,Success,46,26,10,12,34
20,Success,55,22,0,7,48
20,Success,52,24,0,14,38
20,Success,46,37,0,9,37
20,Success,47,26,4,11,36
20,Success,51,28,0,12,39
20,Success,51,26,3,14,37
20,Success,44,25,0,17,27
20,Success,45,26,1,14,31
20,Success,42,31,0,16,26
20,Success,49,28,0,13,36
20,Success,47,23,5,17,30
20,Success,50,26,2,11,39
20,Success,48,33,0,9,39
20,Success,46,20,3,16,30
20,Success,50,21,6,11,39
20,Success,46,31,2,10,36
20,Success,49,27,1,12,37
20,Success,45,22,8,16,29
20,Success,46,34,0,12,34
20,Success,50,29,0,7,43
20,Success,53,24,0,11,42
20,Success,46,28,2,14,32
20,Success,44,25,14,10,34
20,Success,43,26,4,12,31
20,Success,57,23,0,9,48
20,Fail,40,22,7,23,17
20,Success,54,25,0,8,46
20,Success,55,21,2,12,43
20,Success,55,25,0,6,49
20,Success,49,38,0,6,43
20,Success,46,28,1,12,34
20,Success,50,27,3,6,44
20,Success,48,28,2,10,38
20,Success,56,24,0,11,45
20,Success,50,38,0,7,43
20,Success,43,37,0,9,34
20,Success,53,24,0,13,40
20,Success,46,31,0,12,34
20,Success,53,28,1,9,44
20,Success,43,35,0,15,28
20,Success,39,47,0,6,33
20,Success,50,26,7,10,40
20,Success,47,25,0,17,30
20,Success,46,27,0,17,29
20,Success,53,24,0,11,42
20,Success,47,30,0,14,33
20,Success,52,33,0,4,48
20,Success,47,32,0,11,36
20,Success,60,18,0,13,47
20,Success,47,24,0,17,30
20,Success,42,30,3,13,29
20,Success,51,19,0,16,35
20,Success,54,19,2,12,42
20,Success,54,21,5,11,43
20,Success,52,27,3,10,42
20,Success,43,30,0,15,28
20,Success,55,19,0,12,43
20,Success,56,17,1,15,41
20,Success,43,28,2,14,29
20,Success,44,30,0,17,27
20,Success,44,25,0,16,28
20,Success,46,28,0,15,31
20,Success,47,26,5,16,31
20,Success,46,32,0,12,34
20,Success,45,34,0,15,30
20,Success,49,25,6,11,38
20,Success,49,24,0,11,38
20,Success,41,29,0,17,24
20,Success,52,20,0,14,38
20,Success,46,32,0,10,36
20,Success,54,24,0,10,44
20,Success,49,30,0,11,38
20,Success,52,27,0,9,43
20,Success,45,26,3,16,29
20,Success,51,27,0,11,40
20,Success,50,31,0,12,38
20,Success,39,32,10,13,26
20,Success,35,36,14,9,26
20,Success,45,39,0,11,34
20,Success,51,21,3,14,37
20,Success,51,19,0,12,39
20,Success,52,30,0,11,41
20,Success,54,17,2,16,38
20,Success,40,30,3,16,24
20,Success,43,35,0,10,33
20,Success,50,17,10,15,35
20,Success,48,20,0,15,33
20,Success,53,22,8,10,43
20,Success,50,34,0,11,39
20,Success,45,32,0,15,30
20,Success,51,19,1,17,34
20,Success,55,24,0,10,45
20,Success,47,24,4,16,31
20,Success,39,33,0,18,21
20,Success,43,31,0,15,28
20,Success,41,26,8,13,28
20,Success,46,25,6,16,30
20,Success,48,27,3,13,35
20,Success,54,20,0,16,38
20,Success,50,32,0,7,43
20,Success,56,21,0,11,45
20,Success,47,37,0,9,38
20,Success,52,30,0,10,42
20,Success,40,37,0,10,30
20,Success,48,25,0,12,36
20,Success,52,20,2,15,37
20,Success,39,29,0,17,22
20,Success,44,31,0,16,28
20,Success,51,23,0,17,34
20,Success,54,23,0,13,41
20,Success,46,28,0,17,29
20,Success,43,29,0,20,23
20,Success,53,19,4,15,38
20,Success,39,31,11,12,27
20,Success,53,25,0,12,41
20,Success,42,30,4,13,29
20,Success,51,25,2,9,42
20,Success,41,29,10,12,29
20,Success,45,28,4,12,33
20,Success,43,33,0,12,31
20,Success,51,28,0,13,38
20,Success,48,23,2,15,33
20,Success,45,34,0,14,31
20,Success,49,18,12,9,40
20,Success,40,40,0,12,28
20,Success,47,22,0,15,32
20,Success,50,27,0,13,37
20,Success,48,24,0,13,35
20,Success,50,28,2,7,43
20,Success,53,20,1,15,38
20,Success,47,31,0,12,35
20,Success,49,34,0,5,44
20,Success,44,37,0,13,31
20,Success,49,27,2,11,38
20,Success,49,25,1,11,38
20,Success,51,27,0,17,34
20,Success,51,18,3,14,37
20,Success,44,25,8,18,26
20,Success,56,26,0,9,47
20,Success,49,22,0,16,33
20,Success,45,27,0,19,26
20,Success,60,17,0,9,51
20,Success,48,30,0,10,38
20,Success,50,21,7,12,38
20,Success,50,23,3,13,37
20,Success,47,26,0,11,36
20,Success,47,24,1,15,32
20,Success,47,27,2,14,33
20,Success,50,27,0,12,38
20,Success,46,29,3,12,34
20,Success,49,29,0,11,38
20,Success,49,34,0,10,39
20,Success,53,23,0,13,40
20,Success,39,32,0,15,24
20,Success,46,22,7,16,30
20,Success,45,36,0,11,34
20,Success,52,27,0,6,46
20,Success,48,28,0,17,31
20,Success,51,23,1,15,36
20,Success,44,30,1,15,29
20,Success,40,29,7,15,25
20,Success,56,24,0,7,49
20,Success,54,21,7,9,45
20,Success,48,29,0,10,38
20,Success,45,20,8,18,27
20,Success,47,28,1,9,38
20,Success,43,31,4,13,30
20,Success,47,33,0,9,38
20,Success,40,35,2,12,28
20,Success,45,34,1,7,38
20,Success,55,23,2,10,45
20,Success,49,24,2,15,34
20,Success,47,23,3,19,28
20,Success,48,26,5,12,36
20,Success,52,26,0,12,40
20,Success,49,28,2,12,37
20,Success,47,32,0,11,36
20,Success,44,25,13,13,31
20,Success,52,26,0,12,40
20,Success,48,27,0,13,35
20,Success,50,23,2,11,39
20,Success,52,29,0,8,44
20,Success,54,20,0,14,40
20,Success,44,27,0,19,25
20,Success,42,31,6,12,30
20,Success,44,30,2,14,30
20,Success,52,16,3,17,35
20,Success,51,27,0,12,39
20,Success,48,23,0,13,35
20,Success,45,32,0,16,29
20,Success,45,32,0,11,34
20,Success,39,36,0,19,20
20,Success,50,20,2,17,33
20,Success,45,26,0,20,25
20,Success,43,28,8,15,28
20,Success,44,22,14,14,30
20,Success,48,23,0,16,32
20,Success,48,29,0,15,33
20,Success,47,26,0,12,35
20,Success,60,20,5,6,54
20,Success,49,33,0,9,40
20,Success,41,32,4,13,28
20,Success,50,28,2,8,42
20,Success,44,32,5,12,32
20,Success,47,31,0,10,37
20,Success,53,23,0,12,41
20,Success,56,18,0,11,45
20,Success,52,20,7,8,44
20,Success,42,22,12,18,24
20,Success,49,28,2,11,38
20,Success,47,26,0,13,34
20,Success,48,29,0,13,35
20,Success,52,25,0,12,40
20,Success,48,35,0,10,38
20,Success,51,29,0,7,44
20,Success,39,32,0,15,24
20,Success,38,39,0,15,23
20,Success,47,28,3,12,35
20,Success,57,24,0,7,50
20,Success,47,32,0,15,32
20,Success,44,28,1,11,33
20,Success,46,28,0,14,32
20,Success,49,29,0,11,38
20,Success,49,22,6,13,36
20,Success,54,22,3,8,46
20,Success,46,29,0,16,30
20,Success,56,28,0,5,51
20,Success,53,26,0,10,43
20,Success,50,28,0,12,38
20,Success,47,25,5,11,36
20,Success,56,24,0,7,49
20,Success,46,31,1,11,35
20,Success,51,21,1,15,36
20,Success,50,28,0,11,39
20,Success,50,33,0,7,43
20,Success,46,33,0,12,34
20,Success,50,23,1,11,39
20,Success,42,32,4,13,29
20,Success,44,33,0,14,30
20,Success,54,20,2,13,41
20,Success,44,26,9,9,35
20,Success,57,23,0,8,49
20,Success,52,24,2,10,42
20,Success,44,31,2,13,31
20,Success,46,19,8,17,29
20,Success,46,34,0,9,37
20,Success,47,36,2,7,40
20,Success,42,27,1,13,29
20,Success,48,26,8,8,40
20,Success,52,30,0,13,39
20,Success,50,21,1,15,35
20,Success,45,29,0,17,28
20,Success,47,32,0,8,39
20,Success,41,23,10,14,27
20,Fail,39,32,0,22,17
20,Success,47,24,3,18,29
20,Success,51,27,0,5,46
20,Success,42,27,7,12,30
20,Success,45,30,0,9,36
20,Success,50,25,0,14,36
20,Success,47,31,2,12,35
20,Success,50,28,0,10,40
20,Success,54,23,0,13,41
20,Success,36,46,0,11,25
20,Success,48,28,2,12,36
20,Success,40,30,0,18,22
20,Success,49,24,0,15,34
20,Success,46,27,3,12,34
20,Success,41,38,0,11,30
20,Success,51,22,1,12,39
20,Success,53,18,5,11,42
20,Success,49,27,1,5,44
20,Success,45,28,11,6,39
20,Success,48,31,2,12,36
20,Success,43,32,0,16,27
20,Success,53,21,0,16,37
20,Success,47,23,0,14,33
20,Success,45,25,7,16,29
20,Success,48,26,0,16,32
20,Success,52,33,0,8,44
20,Success,59,15,2,11,48
20,Success,47,30,3,10,37
20,Success,49,27,0,14,35
20,Success,47,27,4,14,33
20,Success,49,26,0,13,36
20,Success,51,19,6,11,40
20,Success,49,28,0,13,36
20,Success,52,22,1,11,41
20,Success,49,27,0,15,34
20,Success,40,29,11,11,29
20,Success,53,26,0,11,42
20,Success,45,26,3,13,32
20,Success,51,22,0,15,36
20,Success,45,28,6,11,34
20,Success,52,19,6,13,39
20,Success,52,26,0,9,43
20,Success,49,24,2,11,38
20,Success,51,32,0,8,43
20,Success,54,26,2,9,45
20,Success,44,32,0,12,32
20,Success,40,27,8,12,28
20,Success,46,28,0,13,33
20,Success,46,24,4,14,32
20,Success,44,29,1,14,30
20,Success,50,31,0,9,41
20,Success,53,28,0,10,43
20,Success,45,32,0,11,34
20,Success,45,30,2,14,31
20,Success,52,29,2,8,44
20,Success,43,26,10,14,29
20,Success,44,31,3,11,33
20,Success,48,30,0,12,36
20,Success,48,23,3,16,32
20,Success,49,27,0,11,38
20,Success,47,30,2,10,37
20,Success,53,24,0,10,43
20,Success,53,20,0,15,38
20,Success,53,27,0,10,43
20,Success,48,23,7,10,38
20,Success,47,24,10,12,35
20,Success,57,21,0,12,45
20,Success,50,18,5,17,33
20,Success,41,33,0,15,26
20,Success,53,25,2,7,46
20,Success,40,24,7,19,21
20,Success,48,32,0,8,40
20,Success,42,30,11,8,34
20,Success,46,28,2,11,35
20,Success,50,28,0,8,42
20,Success,45,27,2,16,29
20,Success,49,28,5,9,40
20,Success,50,24,0,16,34
20,Success,42,38,0,12,30
20,Success,44,35,0,14,30
20,Success,47,27,0,17,30
20,Success,43,33,0,17,26
20,Success,48,28,0,15,33
20,Success,43,29,0,13,30
20,Success,58,24,0,10,48
20,Success,51,27,0,11,40
20,Success,43,38,0,14,29
20,Success,54,20,2,12,42
20,Success,52,26,0,8,44
20,Success,40,37,0,11,29
20,Success,44,29,2,15,29
20,Success,47,20,11,14,33
20,Success,52,20,0,15,37
20,Success,43,36,0,12,31
20,Success,48,23,9,7,41
20,Success,41,33,0,15,26
20,Success,50,26,6,10,40
20,Success,45,27,12,8,37
20,Success,44,26,3,21,23
20,Success,50,29,0,10,40
20,Success,51,29,0,9,42
20,Success,51,17,5,18,33
20,Success,57,15,6,12,45
20,Success,45,21,10,13,32
20,Success,48,21,6,10,38
20,Success,47,24,6,14,33
20,Success,46,33,0,13,33
20,Success,54,23,0,10,44
20,Success,42,36,2,9,33
20,Success,44,28,0,13,31
20,Success,48,26,2,16,32
20,Success,51,18,5,15,36
20,Success,48,30,0,10,38
20,Success,44,28,0,15,29
20,Success,50,26,1,16,34
20,Success,46,26,7,9,37
20,Success,54,27,0,9,45
20,Success,48,29,5,11,37
20,Success,43,39,0,13,30
20,Success,47,27,6,12,35
20,Success,47,28,0,13,34
20,Success,44,37,0,12,32
20,Success,54,24,0,10,44
20,Success,49,28,0,9,40
20,Success,51,19,6,13,38
20,Success,49,23,0,19,30
20,Success,47,25,1,16,31
20,Success,51,20,3,14,37
20,Success,59,21,2,7,52
20,Success,49,25,4,9,40
20,Success,53,23,0,11,42
20,Success,44,27,0,17,27
20,Success,47,27,0,16,31
20,Success,46,29,0,13,33
20,Success,53,21,6,10,43
20,Success,54,17,1,12,42
20,Fail,36,27,11,18,18
20,Success,48,29,0,13,35
20,Success,53,23,0,10,43
20,Success,52,16,4,17,35
20,Success,57,18,0,10,47
20,Success,42,36,0,15,27
20,Success,52,27,0,10,42
20,Success,49,33,2,11,38
20,Success,46,26,0,18,28
20,Success,47,18,2,17,30
20,Success,48,19,5,14,34
20,Success,53,22,0,14,39
20,Success,45,29,5,13,32
20,Success,41,31,0,12,29
20,Success,57,18,1,12,45
20,Success,46,27,0,15,31
20,Success,48,27,0,14,34
20,Success,48,28,0,14,34
20,Success,48,28,0,12,36
20,Success,59,18,0,11,48
20,Success,45,30,1,9,36
20,Success,48,29,0,12,36
20,Success,48,29,0,14,34
20,Success,49,25,0,12,37
20,Success,42,33,0,16,26
20,Success,47,30,0,11,36
20,Success,44,30,0,16,28
20,Success,47,27,2,11,36
20,Success,51,21,4,13,38
20,Success,48,24,0,14,34
20,Success,48,19,6,16,32
20,Success,52,24,5,14,38
20,Success,42,39,0,8,34
20,Success,52,26,0,11,41
20,Success,50,33,0,11,39
20,Success,50,28,0,11,39
20,Success,47,29,0,18,29
20,Success,47,25,1,15,32
20,Success,48,26,0,12,36
20,Success,47,30,1,11,36
20,Success,45,37,0,14,31
20,Success,53,27,0,8,45
20,Success,38,37,4,13,25
20,Success,39,44,0,10,29
20,Success,52,22,3,12,40
20,Success,49,26,0,11,38
20,Success,54,22,6,11,43
20,Success,43,31,0,18,25
20,Success,49,35,0,7,42
20,Success,36,36,0,13,23
20,Success,37,28,13,14,23
20,Success,53,20,0,15,38
20,Success,46,31,0,12,34
20,Success,49,35,0,11,38
20,Success,50,27,2,12,38
20,Success,46,29,6,10,36
20,Success,48,22,5,18,30
20,Success,52,23,0,13,39
20,Success,51,28,0,9,42
20,Success,42,35,0,15,27
20,Success,55,21,2,6,49
20,Success,45,33,2,8,37
20,Success,42,30,0,19,23
20,Success,45,25,3,16,29
20,Success,45,38,0,9,36
20,Success,38,26,10,18,20
20,Success,49,33,0,7,42
20,Success,47,24,0,16,31
20,Success,42,32,2,11,31
20,Success,49,30,0,12,37
20,Success,38,48,0,9,29
20,Success,52,26,0,17,35
20,Success,50,27,0,13,37
20,Success,51,26,0,9,42
20,Success,55,21,0,15,40
20,Success,48,25,0,10,38
20,Success,48,29,0,11,37
20,Success,40,32,1,16,24
20,Success,51,25,0,16,35
20,Success,45,27,1,17,28
20,Success,50,29,0,9,41
20,Success,45,25,2,15,30
20,Success,54,26,6,7,47
20,Success,46,25,0,20,26
20,Success,47,30,0,12,35
20,Success,49,29,0,12,37
20,Success,49,27,5,8,41
20,Success,53,26,0,7,46
20,Success,46,28,3,12,34
20,Success,49,25,2,11,38
20,Success,54,32,0,6,48
20,Success,50,29,2,8,42
20,Success,44,24,7,12,32
20,Success,39,29,13,13,26
20,Success,45,32,0,13,32
20,Success,47,32,0,12,35
20,Success,45,28,0,13,32
20,Success,48,21,2,17,31
20,Success,51,19,2,12,39
20,Success,42,28,0,13,29
20,Success,49,28,0,13,36
20,Success,47,33,0,12,35
20,Success,51,24,7,9,42
20,Success,46,31,0,14,32
20,Success,45,27,9,14,31
20,Success,51,22,3,12,39
20,Success,49,32,0,10,39
20,Success,50,25,5,9,41
20,Success,44,37,0,11,33
20,Success,47,25,0,14,33
20,Success,52,21,3,13,39
20,Success,43,33,0,12,31
20,Success,54,28,0,7,47
20,Success,52,28,5,7,45
20,Success,45,25,11,12,33
20,Success,55,27,0,6,49
20,Success,55,17,0,13,42
20,Success,46,27,1,10,36
20,Success,51,25,1,14,37
20,Success,45,29,0,16,29
20,Success,50,21,4,13,37
20,Success,55,21,3,9,46
20,Success,52,21,0,13,39
20,Success,42,30,10,9,33
20,Success,40,42,0,13,27
20,Success,45,23,3,19,26
20,Success,47,29,0,14,33
20,Success,45,25,1,16,29
20,Success,45,28,0,16,29
20,Success,49,21,0,17,32
20,Success,44,26,11,12,32
20,Success,46,28,0,12,34
20,Success,56,15,0,15,41
20,Success,55,20,3,14,41
20,Success,47,29,0,13,34
20,Success,48,32,0,11,37
20,Success,55,18,6,14,41
20,Success,53,22,2,12,41
20,Success,56,17,1,16,40
20,Success,47,30,0,14,33
20,Success,45,31,2,11,34
20,Success,55,27,1,6,49
20,Success,38,36,0,12,26
20,Success,48,34,0,9,39
20,Success,53,28,0,9,44
20,Success,41,30,2,13,28
20,Success,45,25,8,11,34
20,Success,52,24,0,12,40
20,Success,46,30,0,10,36
20,Success,55,16,11,12,43
20,Success,56,17,0,12,44
20,Success,55,13,2,18,37
20,Success,49,27,0,13,36
20,Success,43,30,4,9,34
20,Success,48,23,6,13,35
20,Success,44,33,0,12,32
20,Success,46,23,2,17,29
20,Success,51,29,0,10,41
20,Success,44,23,10,14,30
20,Success,54,14,0,14,40
20,Success,45,26,2,12,33
20,Success,41,36,0,17,24
20,Success,45,38,0,7,38
20,Success,46,29,0,15,31
20,Success,41,37,0,15,26
20,Success,41,28,2,19,22
20,Success,37,44,0,10,27
20,Success,40,26,6,17,23
20,Success,45,26,0,19,26
20,Success,46,25,0,16,30
20,Success,49,25,0,16,33
20,Success,53,23,4,9,44
20,Success,48,29,0,14,34
20,Success,56,17,0,11,45
20,Success,40,28,0,19,21
20,Success,40,32,5,14,26
20,Success,43,32,0,15,28
20,Success,42,26,11,12,30
20,Success,50,26,0,12,38
20,Success,50,25,4,9,41
20,Success,48,27,1,12,36
20,Success,55,27,0,9,46
20,Success,49,22,3,13,36
20,Success,50,27,0,13,37
20,Success,47,32,0,13,34
20,Success,55,24,5,7,48
20,Success,55,21,5,11,44
20,Success,36,30,14,13,23
20,Success,48,25,5,11,37
20,Success,48,22,8,14,34
20,Success,45,35,3,8,37
20,Success,44,28,2,14,30
20,Success,66,16,6,6,60
20,Success,50,28,7,10,40
20,Success,49,31,0,14,35
20,Success,42,33,0,19,23
20,Success,40,39,0,10,30
20,Success,40,36,0,12,28
20,Success,58,25,1,5,53
20,Success,38,32,15,9,29
20,Success,50,27,4,11,39
20,Success,46,26,7,12,34
20,Success,45,27,1,12,33
20,Success,56,21,0,12,44
20,Success,54,20,0,12,42
20,Success,53,24,0,13,40
20,Success,40,35,0,16,24
20,Success,49,17,7,15,34
20,Success,56,22,2,6,50
20,Success,46,25,5,13,33
20,Success,41,30,2,16,25
20,Success,45,24,0,19,26
20,Success,52,17,6,10,42
20,Success,46,19,8,21,25
20,Success,42,38,0,11,31
20,Success,53,21,0,11,42
20,Success,54,27,2,10,44
20,Success,47,22,6,13,34
20,Success,54,22,0,11,43
20,Success,49,30,2,11,38
20,Success,54,25,1,8,46
20,Success,57,24,0,5,52
20,Success,47,22,0,17,30
20,Success,47,30,0,13,34
20,Success,48,23,2,16,32
20,Success,48,30,0,12,36
20,Success,45,29,9,13,32
20,Success,39,34,5,12,27
20,Success,50,26,0,12,38
20,Success,48,32,0,13,35
20,Success,50,31,2,8,42
20,Success,45,26,5,11,34
20,Success,45,30,0,12,33
20,Success,53,18,0,15,38
20,Success,41,36,0,15,26
20,Success,46,27,2,10,36
20,Success,47,27,1,13,34
20,Success,47,30,0,14,33
20,Success,53,29,0,11,42
20,Success,54,23,5,12,42
20,Success,36,30,8,14,22
20,Success,49,26,6,9,40
20,Success,49,22,5,14,35
20,Success,51,23,6,10,41
20,Success,48,28,1,16,32
20,Success,41,32,0,14,27
20,Success,54,24,5,8,46
20,Success,49,23,0,18,31
20,Success,41,33,0,17,24
20,Success,51,24,5,9,42
20,Success,49,34,0,10,39
20,Success,44,24,9,16,28
20,Success,45,29,0,16,29
20,Success,43,30,3,13,30
20,Success,44,28,2,17,27
20,Success,46,32,0,9,37
20,Success,52,26,0,10,42
20,Success,49,28,0,13,36
20,Success,46,32,0,15,31
20,Success,47,26,4,14,33
20,Success,50,29,0,8,42
20,Success,45,27,0,11,34
20,Success,48,24,4,15,33
20,Success,47,23,3,14,33
20,Success,45,25,4,15,30
20,Success,46,25,1,14,32
20,Success,44,25,9,13,31
20,Success,45,26,0,17,28
20,Success,47,30,4,10,37
20,Success,50,30,0,11,39
20,Success,44,31,0,14,30
20,Success,49,30,0,10,39
20,Success,41,33,0,13,28
20,Success,49,25,0,14,35
20,Success,46,34,4,7,39
20,Success,44,35,0,10,34
20,Success,45,35,0,10,35
20,Success,46,34,0,9,37
20,Success,48,30,0,12,36
20,Success,48,25,0,17,31
20,Success,39,41,0,11,28
20,Success,52,26,4,8,44
20,Success,50,31,0,10,40
20,Success,48,32,0,7,41
20,Success,46,27,3,12,34
20,Success,50,29,0,7,43
20,Success,47,25,4,9,38
20,Success,45,30,0,13,32
20,Success,42,25,5,15,27
20,Success,44,30,6,9,35
20,Success,46,32,0,11,35
20,Success,44,41,0,7,37
20,Success,54,16,0,15,39
20,Success,51,28,0,12,39
20,Success,47,26,5,14,33
20,Success,57,22,2,9,48
20,Success,47,36,0,9,38
20,Success,47,15,6,21,26
20,Success,41,33,0,16,25
20,Success,47,29,0,12,35
20,Success,41,22,10,18,23
20,Success,46,28,0,13,33
20,Success,57,18,0,14,43
20,Success,49,29,0,16,33
20,Success,51,24,4,9,42
20,Success,51,23,1,11,40
20,Success,47,31,0,12,35
20,Success,50,21,4,14,36
20,Success,45,27,0,17,28
20,Success,49,26,0,17,32
20,Success,47,23,5,13,34
20,Success,49,26,0,14,35
20,Success,49,23,0,16,33
20,Success,41,31,7,12,29
20,Success,46,23,7,14,32
20,Success,48,30,0,8,40
20,Success,50,20,8,10,40
20,Success,49,25,0,15,34
20,Success,54,20,5,13,41
20,Success,49,26,0,12,37
20,Success,50,16,2,18,32
20,Success,41,26,7,13,28
20,Success,43,29,9,11,32
20,Success,41,26,0,20,21
20,Success,54,20,0,17,37
20,Success,50,29,0,13,37
20,Success,52,22,0,13,39
20,Success,56,20,0,8,48
20,Success,52,20,6,13,39
20,Success,50,21,9,14,36
20,Success,43,23,10,15,28
20,Success,53,21,0,14,39
20,Success,52,27,0,13,39
20,Success,45,29,1,14,31
20,Success,46,31,0,11,35
20,Success,45,30,0,13,32
20,Success,51,32,0,8,43
20,Success,51,31,0,11,40
20,Success,56,23,1,7,49
20,Success,44,31,0,14,30
20,Success,53,28,2,6,47
20,Success,48,26,2,13,35
20,Success,51,24,0,11,40
20,Success,41,32,0,14,27
20,Success,50,22,0,18,32
20,Success,51,27,4,7,44
20,Success,53,30,0,8,45
20,Success,51,22,0,14,37
20,Success,38,31,3,13,25
20,Success,45,21,4,19,26
20,Success,47,34,0,8,39
20,Success,49,20,3,18,31
20,Success,49,23,11,8,41
20,Success,45,33,0,9,36
20,Success,58,18,0,11,47
20,Success,51,31,0,12,39
20,Success,47,28,5,11,36
20,Success,41,30,6,13,28
20,Success,47,29,0,13,34
20,Success,50,23,0,9,41
20,Success,43,21,3,23,20
20,Success,54,18,5,11,43
20,Success,47,18,15,14,33
20,Success,45,32,2,13,32
20,Success,43,22,0,17,26
20,Success,41,43,0,8,33
20,Success,45,28,5,13,32
20,Success,52,27,0,9,43
20,Success,41,35,3,11,30
20,Success,53,25,0,11,42
20,Success,52,25,7,9,43
20,Success,47,21,0,18,29
20,Success,49,26,10,7,42
20,Success,46,25,1,15,31
20,Success,45,26,0,14,31
20,Success,45,36,0,7,38
20,Success,52,28,1,6,46
20,Success,40,30,10,12,28
20,Success,55,16,5,14,41
20,Success,45,29,0,17,28
20,Success,53,22,1,10,43
20,Success,46,33,0,12,34
20,Success,42,30,2,17,25
20,Success,49,23,0,14,35
20,Success,49,29,0,11,38
20,Success,45,27,2,14,31
20,Success,51,24,0,13,38
20,Success,49,22,0,19,30
20,Success,50,24,9,8,42
20,Success,39,37,0,19,20
20,Success,52,23,0,11,41
20,Success,58,22,1,9,49
20,Success,49,23,5,14,35
20,Success,53,22,0,15,38
20,Success,48,32,0,10,38
20,Success,43,35,0,15,28
20,Success,55,21,7,6,49
20,Success,53,27,3,7,46
20,Success,47,23,2,15,32
20,Success,51,20,3,14,37
20,Success,54,26,0,9,45
20,Success,44,21,3,20,24
20,Success,55,18,6,10,45
20,Success,45,28,6,8,37
20,Success,56,22,0,10,46
20,Success,59,20,0,10,49
20,Success,50,24,0,14,36
20,Success,46,29,0,19,27
20,Success,52,30,2,8,44
20,Success,49,25,6,10,39
20,Success,45,18,6,18,27
20,Success,44,29,0,16,28
20,Success,55,18,2,11,44
20,Success,45,26,7,14,31
20,Success,46,36,0,10,36
20,Success,60,23,0,6,54
20,Success,51,28,5,10,41
20,Success,48,31,0,14,34
20,Success,46,25,0,17,29
20,Success,48,26,0,13,35
20,Success,48,27,0,16,32
20,Success,46,25,6,12,34
20,Success,37,42,0,11,26
20,Success,59,11,1,12,47
20,Success,47,29,0,12,35
20,Success,51,19,6,14,37
20,Success,55,22,0,12,43
20,Success,50,28,0,11,39
20,Success,47,27,1,11,36
20,Success,49,25,0,15,34
20,Success,50,21,4,17,33
20,Success,42,42,0,10,32
20,Success,48,27,0,11,37
20,Success,52,28,0,10,42
20,Success,51,26,0,11,40
20,Success,48,29,0,14,34
20,Success,43,30,6,6,37
20,Success,42,28,6,17,25
20,Success,53,24,0,13,40
20,Success,49,22,2,15,34
20,Success,52,25,1,9,43
20,Success,54,26,0,9,45
20,Success,50,32,0,10,40
20,Success,50,21,4,13,37
20,Success,43,31,0,19,24
20,Success,55,24,0,8,47
20,Success,45,29,7,12,33
20,Success,47,37,0,8,39
20,Success,51,32,0,8,43
20,Success,45,27,2,15,30
20,Success,53,26,0,6,47
20,Success,51,26,0,14,37
20,Success,49,26,0,12,37
20,Success,46,33,0,11,35
20,Success,50,20,3,15,35
20,Success,51,28,0,8,43
20,Success,51,28,0,13,38
20,Success,46,36,0,8,38
20,Success,47,29,0,13,34
20,Success,41,34,0,15,26
20,Success,48,23,0,17,31
20,Success,47,19,9,12,35
20,Success,43,31,0,18,25
20,Success,55,24,1,8,47
20,Success,42,32,0,15,27
20,Success,50,23,1,13,37
20,Success,46,41,0,7,39
20,Success,43,27,2,20,23
20,Success,49,25,7,9,40
20,Success,48,24,0,13,35
20,Success,53,23,1,17,36
20,Success,44,31,0,11,33
20,Success,56,24,2,6,50
20,Success,48,24,1,12,36
20,Success,47,30,4,12,35
20,Success,53,22,6,6,47
20,Success,48,18,3,18,30
20,Success,44,22,10,12,32
20,Success,56,21,0,10,46
20,Success,46,27,2,12,34
20,Success,42,28,7,13,29
20,Success,50,24,0,16,34
20,Success,47,26,4,13,34
20,Success,49,22,1,18,31
20,Success,48,29,1,14,34
20,Success,41,36,0,11,30
20,Success,44,33,0,11,33
20,Success,44,28,5,13,31
20,Success,45,40,0,6,39
20,Success,46,26,0,18,28
20,Success,56,28,3,4,52
20,Success,43,34,0,13,30
20,Success,54,25,1,11,43
20,Success,58,20,0,8,50
20,Success,56,26,0,9,47
20,Success,48,28,0,14,34
20,Success,52,24,0,8,44
20,Success,53,25,5,9,44
20,Success,45,37,0,9,36
20,Success,42,33,0,13,29
20,Success,53,24,4,9,44
20,Success,45,26,1,18,27
20,Success,40,29,2,19,21
20,Success,42,32,7,13,29
20,Success,51,21,3,11,40
20,Success,51,22,3,15,36
20,Success,52,28,4,7,45
20,Success,49,24,4,13,36
20,Success,40,34,0,19,21
20,Success,45,33,0,15,30
20,Success,49,23,0,17,32
20,Success,53,31,0,7,46
20,Success,58,21,0,7,51
20,Success,50,23,5,12,38
20,Success,50,28,0,12,38
20,Success,51,24,0,14,37
20,Success,49,31,0,6,43
20,Success,44,25,6,15,29
20,Success,38,37,0,14,24
20,Success,52,25,2,11,41
20,Success,52,23,0,14,38
20,Success,59,17,0,10,49
20,Success,44,37,0,11,33
20,Success,49,24,9,12,37
20,Success,49,24,0,13,36
20,Success,48,20,10,11,37
20,Success,59,22,1,3,56
20,Success,44,29,0,14,30
20,Success,53,25,0,9,44
20,Success,44,24,1,18,26
20,Success,50,26,0,18,32
20,Success,44,24,6,17,27
20,Success,51,29,1,10,41
20,Success,43,25,15,11,32
20,Success,35,45,0,11,24
20,Success,46,38,0,8,38
20,Success,43,34,0,12,31
20,Success,50,30,0,12,38
20,Success,40,37,0,13,27
20,Success,49,23,2,14,35
20,Success,52,19,5,15,37
20,Success,54,29,0,10,44
20,Success,46,31,0,13,33
20,Success,51,22,0,13,38
20,Success,49,23,4,14,35
20,Success,41,28,3,16,25
20,Success,48,25,3,12,36
20,Success,44,27,3,16,28
20,Success,43,37,0,9,34
20,Success,54,26,0,11,43
20,Success,39,38,0,17,22
20,Success,40,35,0,16,24
20,Success,54,25,0,12,42
20,Success,60,20,0,12,48
20,Success,60,14,0,11,49
20,Success,49,27,0,14,35
20,Success,46,22,4,14,32
20,Success,50,22,4,13,37
20,Success,49,21,6,13,36
20,Success,50,25,1,15,35
20,Success,48,29,0,9,39
20,Success,45,31,0,13,32
20,Success,54,23,0,13,41
20,Success,53,24,1,10,43
20,Success,44,24,7,13,31
20,Success,53,29,1,6,47
20,Success,54,24,3,10,44
20,Success,56,21,0,9,47
20,Success,47,29,0,13,34
20,Success,42,36,2,12,30
20,Success,47,29,5,9,38
20,Success,53,24,0,9,44
20,Success,49,22,2,12,37
20,Success,56,24,0,8,48
20,Success,48,24,2,13,35
20,Success,50,27,0,11,39
20,Success,45,18,3,21,24
20,Success,56,25,0,10,46
20,Success,48,26,4,9,39
20,Success,54,23,0,10,44
20,Success,50,24,2,10,40
20,Success,54,25,0,9,45
20,Success,49,29,0,9,40
20,Success,50,28,0,11,39
20,Success,51,26,0,10,41
20,Success,46,29,0,15,31
20,Success,58,18,3,10,48
20,Success,43,27,4,13,30
20,Success,43,29,5,13,30
20,Success,57,18,2,13,44
20,Success,59,25,0,4,55
20,Success,50,30,2,8,42
20,Success,55,24,0,11,44
20,Success,42,31,1,11,31
20,Success,44,24,0,18,26
20,Success,44,28,0,17,27
20,Success,49,28,0,14,35
20,Success,43,28,0,18,25
20,Success,48,26,0,12,36
20,Success,57,24,2,6,51
20,Success,42,33,6,7,35
20,Success,42,30,11,11,31
20,Success,53,24,0,12,41
20,Success,48,32,0,10,38
20,Success,37,36,3,15,22
20,Success,54,24,0,11,43
20,Success,57,23,0,11,46
20,Success,57,18,1,12,45
20,Success,44,25,11,13,31
20,Success,51,26,0,10,41
20,Success,41,26,11,14,27
20,Success,47,30,0,12,35
20,Success,50,33,0,8,42
20,Success,47,23,0,13,34
20,Success,49,25,0,11,38
20,Success,42,29,2,17,25
20,Success,47,29,1,13,34
20,Success,49,28,0,11,38
20,Success,49,27,0,16,33
20,Success,47,32,0,10,37
20,Success,49,25,0,13,36
20,Success,49,25,3,10,39
20,Success,48,25,0,18,30
20,Success,50,24,0,14,36
20,Success,45,39,0,7,38
20,Success,50,26,0,16,34
20,Success,50,24,4,13,37
20,Success,39,34,6,15,24
20,Success,49,27,1,11,38
20,Success,55,22,0,12,43
20,Success,50,23,0,12,38
20,Success,42,24,12,15,27
20,Success,54,28,0,8,46
20,Success,44,24,6,18,26
20,Success,48,25,2,11,37
20,Success,49,26,0,19,30
20,Success,47,26,0,16,31
20,Success,49,25,0,15,34
20,Success,45,27,3,12,33
20,Success,49,28,1,12,37
20,Success,43,32,7,10,33
20,Success,46,32,0,13,33
20,Success,45,33,2,12,33
20,Success,53,22,2,11,42
20,Success,60,18,1,5,55
20,Success,48,22,11,7,41
20,Success,44,32,0,13,31
20,Success,57,18,0,11,46
20,Success,42,32,5,13,29
20,Success,50,26,1,9,41
20,Success,49,25,5,13,36
20,Success,44,33,0,13,31
20,Success,41,24,6,20,21
20,Success,50,27,0,10,40
20,Success,42,31,0,16,26
20,Success,49,29,0,14,35
20,Success,45,32,0,13,32
20,Success,52,27,0,12,40
20,Success,46,28,2,13,33
20,Success,47,28,0,16,31
20,Success,44,28,2,13,31
20,Success,51,28,0,10,41
20,Success,52,26,0,11,41
20,Success,50,24,3,14,36
20,Success,45,28,2,20,25
20,Success,47,34,0,15,32
20,Success,48,25,2,14,34
20,Success,45,29,5,13,32
20,Success,56,23,0,12,44
20,Success,56,26,7,3,53
20,Fail,38,28,1,20,18
20,Success,50,25,0,14,36
20,Success,46,33,0,11,35
20,Success,47,36,0,8,39
20,Success,43,24,0,18,25
20,Success,51,24,5,10,41
20,Success,52,21,2,10,42
20,Success,46,30,0,14,32
20,Success,47,28,2,12,35
20,Success,49,31,5,7,42
20,Success,46,23,8,15,31
20,Success,51,25,0,10,41
20,Success,43,25,7,13,30
20,Success,55,27,0,10,45
20,Success,47,31,0,10,37
20,Success,51,29,0,12,39
20,Success,53,28,0,15,38
20,Success,50,27,0,12,38
20,Success,45,28,0,9,36
20,Success,53,19,5,12,41
20,Success,44,31,9,7,37
20,Success,43,30,1,19,24
20,Success,49,30,0,11,38
20,Success,44,32,0,10,34
20,Success,49,30,0,10,39
20,Success,43,39,3,7,36
20,Success,44,36,0,12,32
20,Success,54,24,0,9,45
20,Success,47,25,0,19,28
20,Success,46,30,0,11,35
20,Success,42,27,5,18,24
20,Success,50,23,0,11,39
20,Success,49,25,0,13,36
20,Success,46,27,5,11,35
20,Success,49,23,0,16,33
20,Success,44,34,0,12,32
20,Success,52,29,0,13,39
20,Success,43,29,6,11,32
20,Success,52,27,0,8,44
20,Success,39,34,0,19,20
20,Success,45,28,4,12,33
20,Success,49,28,2,11,38
20,Success,41,30,0,17,24
20,Success,48,23,0,19,29
20,Success,48,30,1,11,37
20,Success,44,25,0,17,27
20,Success,44,38,0,14,30
20,Success,44,27,4,12,32
20,Success,51,20,2,13,38
20,Success,47,25,1,18,29
20,Success,46,31,0,13,33
20,Success,43,32,0,13,30
20,Success,50,27,1,8,42
20,Success,50,28,0,10,40
20,Success,46,28,0,13,33
20,Success,39,28,2,17,22
20,Success,51,32,0,10,41
20,Success,43,28,0,18,25
20,Success,46,26,6,14,32
20,Success,44,28,8,11,33
20,Success,43,28,3,17,26
20,Success,45,25,0,18,27
20,Success,50,26,0,13,37
20,Success,48,24,0,17,31
20,Success,46,26,0,17,29
20,Success,48,29,0,12,36
20,Success,44,31,0,15,29
20,Success,50,19,5,15,35
20,Success,37,41,0,11,26
20,Success,55,25,0,11,44
20,Success,52,21,0,12,40
20,Success,45,27,6,11,34
20,Success,42,27,6,15,27
20,Success,49,24,0,14,35
20,Success,50,22,4,15,35
20,Success,55,24,0,9,46
20,Success,42,26,9,13,29
20,Success,48,23,1,13,35
20,Success,55,20,5,10,45
20,Success,48,27,0,14,34
20,Success,46,20,10,12,34
20,Success,53,23,1,14,39
20,Success,44,26,10,11,33
20,Success,38,41,0,10,28
20,Success,46,24,4,15,31
20,Success,52,27,0,14,38
20,Success,47,32,0,9,38
20,Success,40,27,15,14,26
20,Success,54,20,1,12,42
20,Success,42,30,6,15,27
20,Success,41,27,8,13,28
20,Success,50,33,0,10,40
20,Success,47,21,3,17,30
20,Success,44,28,0,20,24
20,Success,46,27,0,15,31
20,Success,47,21,0,16,31
20,Success,45,28,5,11,34
20,Success,48,27,0,14,34
20,Success,57,24,0,8,49
20,Success,47,32,2,11,36
20,Success,50,29,0,11,39
20,Success,54,25,0,9,45
20,Success,48,33,0,10,38
20,Success,56,18,6,10,46
20,Success,40,36,0,11,29
20,Success,45,33,0,7,38
20,Success,43,27,0,17,26
20,Success,44,34,0,10,34
20,Success,49,29,5,8,41
20,Fail,39,29,0,21,18
20,Success,44,27,1,14,30
20,Success,45,32,3,11,34
20,Success,50,26,2,9,41
20,Success,45,25,0,19,26
20,Success,53,23,0,10,43
20,Success,49,22,9,11,38
20,Success,54,23,0,12,42
20,Success,49,22,3,13,36
20,Success,39,33,0,17,22
20,Success,50,36,0,7,43
20,Success,47,26,0,18,29
20,Success,50,26,0,14,36
20,Success,46,32,1,14,32
20,Success,40,34,0,14,26
20,Success,49,29,5,10,39
20,Success,36,32,9,15,21
20,Success,59,20,0,11,48
20,Success,46,34,0,11,35
20,Success,49,27,0,13,36
20,Success,45,32,0,14,31
20,Success,54,17,3,14,40
20,Success,51,32,0,4,47
20,Success,52,31,0,5,47
20,Success,46,31,0,16,30
20,Success,51,27,0,11,40
20,Success,47,22,0,14,33
20,Success,52,21,0,17,35
20,Success,52,21,2,12,40
20,Success,51,30,0,7,44
20,Success,45,22,13,10,35
20,Success,49,27,0,10,39
20,Success,52,26,0,13,39
20,Success,56,24,0,10,46
20,Success,50,24,1,12,38
20,Success,47,29,0,14,33
20,Success,47,33,0,11,36
20,Success,44,31,5,12,32
20,Success,47,36,0,11,36
20,Success,53,20,1,12,41
20,Success,46,30,0,10,36
20,Success,44,29,0,14,30
20,Success,55,21,2,10,45
20,Success,50,33,0,9,41
20,Success,41,37,4,9,32
20,Success,48,31,0,9,39
20,Success,43,31,0,14,29
20,Success,47,27,0,11,36
20,Success,47,27,0,15,32
20,Success,48,20,3,21,27
20,Success,45,20,4,16,29
20,Success,50,21,3,13,37
20,Success,48,24,0,19,29
20,Success,44,24,5,17,27
20,Success,47,24,3,15,32
20,Success,43,35,0,13,30
20,Success,50,20,3,12,38
20,Success,43,29,0,15,28
20,Success,50,28,0,10,40
20,Success,47,30,0,15,32
20,Success,55,27,0,5,50
20,Success,53,27,2,5,48
20,Success,48,20,7,14,34
20,Success,47,26,0,17,30
20,Success,51,31,0,7,44
20,Success,52,23,2,11,41
20,Success,43,37,0,13,30
20,Success,49,27,0,13,36
20,Success,46,21,0,18,28
20,Success,52,27,0,6,46
20,Success,52,25,1,11,41
20,Success,53,21,3,9,44
20,Success,40,22,13,19,21
20,Fail,42,18,4,23,19
20,Success,53,31,0,7,46
20,Success,50,28,3,12,38
20,Fail,35,31,9,18,17
20,Success,54,24,0,12,42
20,Success,53,19,1,11,42
20,Success,46,28,0,11,35
20,Success,45,29,0,15,30
20,Success,45,28,0,19,26
20,Success,41,31,0,17,24
20,Success,49,27,0,14,35
20,Success,55,24,0,7,48
20,Success,44,26,5,13,31
20,Success,56,22,0,11,45
20,Success,50,33,0,8,42
20,Success,53,22,0,19,34
20,Success,49,21,8,14,35
20,Success,46,31,3,9,37
20,Success,48,23,3,16,32
20,Success,45,38,0,9,36
20,Success,44,27,2,11,33
20,Success,50,33,0,9,41
20,Success,53,20,2,16,37
20,Success,48,37,0,6,42
20,Success,45,29,0,14,31
20,Success,47,26,1,16,31
20,Success,49,26,0,14,35
20,Success,48,30,0,13,35
20,Success,51,25,0,12,39
20,Success,42,29,2,17,25
20,Success,45,25,7,10,35
20,Success,49,24,0,18,31
20,Success,49,29,1,10,39
20,Success,56,17,6,11,45
20,Success,43,35,2,12,31
20,Success,43,26,0,22,21
20,Success,42,32,0,17,25
20,Success,49,29,0,11,38
20,Success,44,35,0,12,32
20,Success,55,22,0,11,44
20,Success,44,30,0,18,26
20,Success,48,26,0,14,34
20,Success,56,19,0,10,46
20,Success,53,28,0,6,47
20,Success,51,31,0,8,43
20,Success,44,32,6,13,31
20,Success,49,21,0,16,33
20,Success,39,30,4,18,21
20,Success,44,34,0,10,34
20,Success,49,27,0,11,38
20,Success,43,29,3,15,28
20,Success,50,29,0,14,36
20,Success,57,20,7,8,49
20,Success,49,21,1,13,36
20,Success,43,39,0,12,31
20,Success,44,32,0,11,33
20,Success,41,31,4,15,26
20,Success,45,22,0,23,22
20,Success,51,25,6,7,44
20,Success,44,32,1,14,30
20,Success,44,30,2,14,30
20,Success,54,30,0,9,45
20,Success,52,24,4,14,38
20,Success,47,26,8,11,36
20,Success,58,17,3,9,49
20,Success,57,19,7,9,48
20,Success,49,28,0,12,37
20,Success,47,28,0,12,35
20,Success,41,34,0,13,28
20,Success,45,24,2,17,28
20,Success,48,31,5,12,36
20,Success,52,21,1,12,40
20,Success,51,25,2,15,36
20,Success,57,18,2,12,45
20,Success,48,27,1,11,37
20,Success,47,22,11,10,37
20,Success,51,21,9,11,40
20,Success,55,21,3,12,43
20,Success,56,24,1,8,48
20,Success,48,27,0,15,33
20,Success,50,32,0,10,40
20,Success,46,29,0,13,33
20,Success,57,24,0,10,47
20,Success,48,28,0,15,33
20,Success,52,30,0,9,43
20,Success,53,27,0,11,42
20,Success,52,30,0,9,43
20,Success,53,26,2,10,43
20,Success,47,27,0,19,28
20,Success,49,34,0,10,39
20,Success,44,30,2,15,29
20,Success,47,31,0,10,37
20,Success,41,42,0,11,30
20,Success,44,29,0,17,27
20,Success,53,25,0,12,41
20,Success,41,36,0,15,26
20,Success,45,28,7,16,29
20,Success,42,22,2,14,28
20,Success,48,23,0,19,29
20,Success,46,25,5,14,32
20,Success,56,20,2,12,44
20,Success,54,22,3,6,48
20,Success,50,21,2,19,31
20,Success,49,31,0,11,38
20,Success,51,24,0,14,37
20,Success,51,27,0,14,37
20,Success,42,31,0,18,24
20,Success,40,36,0,15,25
20,Success,43,30,0,18,25
20,Success,45,31,2,12,33
20,Success,42,32,0,18,24
20,Success,47,26,2,13,34
20,Success,50,28,0,15,35
20,Success,55,21,1,11,44
20,Success,49,14,8,19,30
20,Success,48,26,0,14,34
20,Success,51,22,0,12,39
20,Success,51,22,1,14,37
20,Success,48,27,0,15,33
20,Success,43,33,0,12,31
20,Success,43,25,1,15,28
20,Success,45,33,3,12,33
20,Success,58,16,0,13,45
20,Success,44,30,0,13,31
20,Success,51,21,0,12,39
20,Success,44,29,4,9,35
20,Success,54,24,0,15,39
20,Success,41,33,7,12,29
20,Success,47,22,11,12,35
20,Success,43,30,3,13,30
20,Success,53,22,7,10,43
20,Success,48,26,3,15,33
20,Success,48,25,1,13,35
20,Success,42,27,4,16,26
20,Success,52,19,3,15,37
20,Success,48,24,4,13,35
20,Success,43,35,0,10,33
20,Success,47,24,0,18,29
20,Success,48,29,2,13,35
20,Success,46,32,0,10,36
20,Success,58,17,1,12,46
20,Success,53,20,7,10,43
20,Success,47,23,3,17,30
20,Success,58,20,7,6,52
20,Success,54,22,2,9,45
20,Success,50,26,2,10,40
20,Fail,37,31,5,19,18
20,Success,48,34,0,10,38
20,Success,51,24,0,13,38
20,Success,50,26,1,10,40
20,Success,49,25,0,11,38
20,Success,48,29,0,17,31
20,Success,51,29,0,9,42
20,Success,50,21,0,13,37
20,Success,41,36,0,12,29
20,Success,49,31,0,12,37
20,Success,50,31,0,10,40
20,Success,46,30,0,12,34
20,Success,50,28,0,13,37
20,Success,44,30,7,13,31
20,Success,49,24,4,13,36
20,Success,46,35,0,9,37
20,Success,47,30,0,12,35
20,Success,51,24,1,15,36
20,Success,49,25,0,13,36
20,Success,41,31,0,16,25
20,Success,51,24,0,17,34
20,Success,40,28,12,14,26
20,Success,44,27,0,13,31
20,Success,49,21,0,16,33
20,Success,49,25,0,18,31
20,Success,52,27,5,5,47
20,Success,48,26,0,13,35
20,Success,50,23,0,11,39
20,Success,50,30,0,8,42
20,Success,52,19,1,17,35
20,Success,44,20,8,18,26
20,Fail,38,33,0,19,19
20,Success,48,25,4,12,36
20,Success,41,29,0,20,21
20,Success,44,24,3,19,25
20,Success,60,14,0,14,46
20,Success,44,28,0,16,28
20,Success,50,24,1,13,37
20,Success,47,28,0,16,31
20,Success,50,23,1,14,36
20,Success,50,26,5,7,43
20,Success,42,27,4,19,23
20,Success,50,26,0,13,37
20,Success,40,30,2,16,24
20,Success,43,30,3,14,29
20,Success,46,28,0,20,26
20,Success,45,32,0,13,32
20,Success,51,25,0,12,39
20,Success,59,18,2,10,49
20,Success,49,23,0,16,33
20,Success,48,27,6,9,39
20,Success,47,33,0,11,36
20,Success,39,32,16,5,34
20,Success,46,35,0,11,35
20,Success,52,20,0,17,35
20,Success,41,31,8,14,27
20,Success,49,28,4,10,39
20,Success,50,31,3,9,41
20,Success,51,29,0,10,41
20,Success,61,22,0,6,55
20,Success,48,28,0,15,33
20,Success,46,27,6,13,33
20,Success,49,24,2,15,34
20,Success,47,23,1,18,29
20,Success,51,25,2,13,38
20,Success,50,22,1,13,37
20,Success,45,35,0,14,31
20,Success,37,38,0,12,25
20,Success,48,27,5,11,37
20,Success,54,22,0,11,43
20,Success,50,25,2,15,35
20,Success,47,25,0,18,29
20,Success,48,25,1,14,34
20,Success,45,28,0,15,30
20,Success,39,32,4,15,24
20,Success,42,35,0,14,28
20,Success,46,34,0,8,38
20,Success,44,37,0,10,34
20,Success,47,25,8,14,33
20,Success,48,23,0,18,30
20,Success,45,30,0,12,33
20,Success,56,23,3,9,47
20,Success,45,23,3,17,28
20,Success,48,20,1,21,27
20,Success,49,22,1,14,35
20,Success,50,19,4,14,36
20,Success,49,23,5,14,35
20,Success,54,22,0,13,41
20,Success,50,27,0,16,34
20,Success,47,23,6,12,35
20,Success,48,30,0,9,39
20,Success,50,26,0,11,39
20,Success,45,31,0,12,33
20,Success,52,23,4,9,43
20,Success,44,26,0,16,28
20,Success,45,30,0,15,30
20,Success,47,26,0,14,33
20,Success,50,20,6,11,39
20,Success,44,36,0,13,31
20,Fail,38,36,0,20,18
20,Success,49,28,0,11,38
20,Success,51,19,5,12,39
20,Success,52,22,0,13,39
20,Success,51,18,6,13,38
20,Success,54,26,0,7,47
20,Success,50,25,2,10,40
20,Success,53,17,11,9,44
20,Success,42,35,0,17,25
20,Success,50,28,1,11,39
20,Success,46,32,0,13,33
20,Success,45,29,1,14,31
20,Success,45,32,0,13,32
20,Success,50,25,2,8,42
20,Success,59,22,0,9,50
20,Success,47,37,0,6,41
20,Success,45,29,6,12,33
20,Success,54,24,6,13,41
20,Success,45,35,0,13,32
20,Success,48,28,0,18,30
20,Success,49,21,8,12,37
20,Success,51,29,0,6,45
20,Success,51,25,0,10,41
20,Success,51,30,0,11,40
20,Success,45,32,6,7,38
20,Success,52,26,0,8,44
20,Success,46,27,2,14,32
20,Success,51,19,0,20,31
20,Success,48,26,3,12,36
20,Success,45,34,0,9,36
20,Success,50,16,4,18,32
20,Success,47,24,3,14,33
20,Success,45,31,5,12,33
20,Success,47,35,0,8,39
20,Success,52,18,6,12,40
20,Success,51,26,0,11,40
20,Success,48,24,4,16,32
20,Success,55,24,0,12,43
20,Success,43,25,5,19,24
20,Success,54,19,0,14,40
20,Success,50,32,0,10,40
20,Success,46,36,0,6,40
20,Success,51,29,0,11,40
20,Success,52,21,0,12,40
20,Success,45,29,2,13,32
20,Success,50,24,3,14,36
20,Success,48,30,0,12,36
20,Success,51,27,2,9,42
20,Success,48,25,0,11,37
20,Success,49,22,10,11,38
20,Success,45,33,0,12,33
20,Success,47,26,2,10,37
20,Success,45,28,4,13,32
20,Success,53,21,3,13,40
20,Success,51,26,0,10,41
20,Success,39,26,9,15,24
20,Success,53,27,0,11,42
20,Success,50,27,1,9,41
20,Success,44,25,4,14,30
20,Success,58,19,4,9,49
20,Success,45,23,2,16,29
20,Success,56,19,3,14,42
20,Success,43,26,6,15,28
20,Success,51,32,0,7,44
20,Success,53,23,1,13,40
20,Success,52,23,4,9,43
20,Success,53,25,0,11,42
20,Success,45,36,6,4,41
20,Success,48,22,1,17,31
20,Success,44,33,0,15,29
20,Fail,36,37,0,18,18
20,Success,49,24,0,15,34
20,Success,48,29,0,9,39
20,Success,43,31,0,19,24
20,Success,46,26,0,13,33
20,Success,49,28,0,11,38
20,Success,46,36,0,12,34
20,Success,41,37,0,12,29
20,Success,42,35,0,14,28
20,Success,43,37,0,12,31
20,Success,54,21,3,10,44
20,Success,50,32,0,7,43
20,Success,51,14,0,22,29
20,Success,53,28,0,6,47
20,Success,54,14,1,14,40
20,Success,47,29,0,11,36
20,Success,45,34,0,13,32
20,Success,48,34,0,10,38
20,Fail,39,27,2,20,19
20,Success,46,21,2,19,27
20,Success,51,24,9,8,43
20,Success,43,27,0,16,27
20,Success,46,29,2,14,32
20,Success,51,26,4,8,43
20,Success,46,28,2,12,34
20,Success,49,31,0,12,37
20,Success,52,26,0,10,42
20,Success,53,24,5,7,46
20,Success,45,27,6,14,31
20,Success,55,23,0,11,44
20,Success,50,30,0,9,41
20,Success,54,29,0,7,47
20,Success,47,30,0,9,38
20,Success,46,33,0,11,35
20,Success,44,38,0,13,31
20,Success,41,37,0,12,29
20,Success,49,25,2,9,40
20,Success,50,27,0,13,37
20,Success,50,28,0,11,39
20,Success,46,31,0,13,33
20,Success,49,26,3,10,39
20,Success,49,29,0,14,35
20,Success,43,29,1,14,29
20,Success,53,22,0,12,41
20,Success,48,22,4,17,31
20,Success,51,20,0,17,34
20,Success,46,21,0,20,26
20,Success,47,26,0,15,32
20,Success,45,32,0,13,32
20,Success,51,25,0,8,43
20,Success,46,24,5,13,33
20,Success,58,20,0,7,51
20,Success,46,33,0,11,35
20,Success,48,29,0,11,37
20,Success,43,23,11,14,29
20,Success,44,27,4,18,26
20,Success,42,37,0,10,32
20,Success,37,41,0,15,22
20,Success,50,23,7,10,40
20,Success,44,32,0,15,29
20,Success,54,25,0,10,44
20,Success,43,32,3,13,30
20,Success,49,29,1,13,36
20,Success,49,23,5,14,35
20,Success,48,25,5,13,35
20,Success,46,32,0,10,36
20,Success,43,34,0,10,33
20,Success,48,22,7,16,32
20,Success,41,26,5,14,27
20,Success,52,21,5,10,42
20,Success,46,35,0,9,37
20,Success,57,21,2,10,47
20,Success,53,25,3,7,46
20,Success,44,33,0,16,28
20,Success,44,30,1,12,32
20,Success,49,24,1,14,35
20,Success,41,30,0,17,24
20,Success,43,21,5,14,29
20,Success,46,23,1,19,27
20,Success,46,35,0,14,32
20,Success,49,27,0,12,37
20,Success,50,29,0,9,41
20,Success,48,29,0,12,36
20,Success,50,22,2,12,38
20,Success,45,20,3,17,28
20,Success,44,36,0,10,34
20,Success,53,23,0,8,45
20,Success,44,33,0,10,34
20,Success,41,27,5,16,25
20,Success,43,28,0,16,27
20,Success,51,26,0,11,40
20,Success,43,25,0,17,26
20,Success,43,37,0,13,30
20,Success,45,32,0,13,32
20,Success,51,23,5,9,42
20,Success,47,32,0,11,36
20,Success,52,27,2,9,43
20,Success,48,19,0,20,28
20,Success,42,30,0,17,25
20,Success,46,25,4,14,32
20,Success,46,28,0,13,33
20,Success,51,25,3,11,40
20,Success,48,29,0,12,36
20,Success,48,26,0,11,37
20,Success,48,24,5,14,34
20,Success,53,19,0,16,37
20,Success,52,24,1,9,43
20,Success,43,35,0,11,32
20,Success,54,22,4,9,45
20,Success,45,31,0,13,32
20,Success,43,22,7,14,29
20,Success,53,19,1,13,40
20,Success,56,32,0,4,52
20,Success,41,28,2,16,25
20,Success,51,29,0,11,40
20,Success,50,22,6,12,38
20,Success,49,23,1,16,33
20,Success,46,30,0,13,33
20,Success,52,27,0,10,42
20,Success,42,32,0,13,29
20,Success,46,30,3,9,37
20,Success,47,29,5,11,36
20,Success,51,29,0,9,42
20,Success,49,23,2,15,34
20,Success,49,22,3,14,35
20,Success,51,24,1,13,38
20,Success,53,24,0,10,43
20,Success,49,30,0,8,41
20,Success,49,32,0,9,40
20,Success,44,25,0,19,25
20,Success,45,27,9,10,35
20,Success,60,22,0,9,51
20,Success,44,24,6,16,28
20,Success,47,19,3,17,30
20,Success,51,28,0,12,39
20,Success,58,16,1,13,45
20,Success,44,23,10,16,28
20,Success,48,34,0,8,40
20,Success,41,36,0,17,24
20,Success,47,33,0,11,36
20,Success,43,29,5,12,31
20,Success,48,27,0,15,33
20,Success,54,24,0,15,39
20,Success,44,24,2,16,28
20,Success,48,26,6,12,36
20,Success,54,29,0,8,46
20,Success,47,32,0,13,34
20,Success,42,33,0,12,30
20,Success,49,19,4,22,27
20,Success,47,30,0,8,39
20,Success,43,32,0,18,25
20,Success,56,20,0,16,40
20,Success,45,32,0,12,33
20,Success,42,31,8,12,30
20,Success,43,30,2,15,28
20,Success,51,16,1,19,32
20,Success,53,21,0,15,38
20,Success,49,30,0,12,37
20,Success,51,32,3,6,45
20,Success,45,32,0,13,32
20,Success,43,31,6,13,30
20,Success,41,30,6,12,29
20,Success,50,27,0,11,39
20,Success,44,38,0,11,33
20,Success,43,29,0,15,28
20,Success,42,32,6,11,31
20,Success,52,26,5,9,43
20,Success,50,33,0,6,44
20,Fail,37,37,0,18,19
20,Success,50,24,4,13,37
20,Success,46,24,2,15,31
20,Success,43,43,0,5,38
20,Success,42,34,5,7,35
20,Success,44,27,8,11,33
20,Success,50,28,0,12,38
20,Success,48,26,0,12,36
20,Success,44,33,0,12,32
20,Success,51,25,3,11,40
20,Success,55,23,5,10,45
20,Success,41,29,8,13,28
20,Success,56,22,4,8,48
20,Success,55,20,0,13,42
20,Success,51,22,0,17,34
20,Success,54,21,7,7,47
20,Success,46,30,0,10,36
20,Success,41,34,0,15,26
20,Success,44,27,7,12,32
20,Success,50,24,3,10,40
20,Success,51,25,0,11,40
20,Success,46,25,2,13,33
20,Fail,37,31,0,21,16
20,Success,56,24,0,10,46
20,Success,46,26,4,12,34
20,Success,48,30,0,12,36
20,Success,58,22,2,7,51
20,Success,45,33,0,11,34
20,Success,47,27,4,13,34
20,Success,48,24,4,11,37
20,Success,48,20,10,14,34
20,Success,46,25,2,16,30
20,Success,48,26,4,15,33
20,Success,47,28,0,14,33
20,Success,53,25,0,11,42
20,Success,50,27,0,13,37
20,Success,49,24,0,15,34
20,Success,45,27,0,13,32
20,Success,45,31,3,11,34
20,Success,42,32,0,18,24
20,Success,47,28,2,14,33
20,Success,46,24,0,20,26
20,Success,46,36,0,8,38
20,Success,51,27,0,14,37
20,Success,52,22,0,14,38
20,Success,46,40,0,3,43
20,Success,37,44,0,13,24
20,Success,45,28,0,16,29
20,Success,52,28,1,7,45
20,Success,47,33,0,9,38
20,Success,49,24,2,13,36
20,Success,49,30,0,10,39
20,Success,48,30,6,8,40
20,Success,52,24,6,11,41
20,Success,50,28,0,11,39
20,Success,50,20,3,8,42
20,Success,49,24,0,16,33
20,Success,51,29,1,10,41
20,Success,52,28,0,8,44
20,Success,49,28,6,9,40
20,Success,49,18,1,17,32
20,Success,48,23,2,15,33
20,Success,44,35,0,10,34
20,Success,46,23,9,14,32
20,Success,54,20,0,12,42
20,Success,55,24,0,11,44
20,Success,49,23,1,13,36
20,Success,46,25,0,16,30
20,Success,44,23,1,23,21
20,Success,49,25,0,15,34
20,Success,52,21,0,13,39
20,Success,54,22,0,14,40
20,Success,52,24,0,15,37
20,Success,44,33,6,7,37
20,Success,45,28,0,15,30
20,Success,51,22,4,13,38
20,Success,51,28,0,11,40
20,Success,42,25,7,18,24
20,Success,54,21,5,5,49
20,Success,46,26,9,14,32
20,Success,46,33,0,8,38
20,Success,48,20,7,14,34
20,Success,56,20,0,16,40
20,Success,50,30,4,6,44
20,Success,48,34,0,9,39
20,Success,54,25,0,11,43
20,Success,52,23,5,7,45
20,Success,50,27,6,11,39
20,Success,49,31,0,8,41
20,Success,53,30,0,9,44
20,Success,51,14,7,16,35
20,Success,41,35,0,11,30
20,Success,53,23,0,10,43
20,Success,46,36,0,11,35
20,Success,43,38,0,9,34
20,Success,47,29,0,13,34
20,Success,45,34,2,10,35
20,Success,48,29,0,15,33
20,Success,55,23,0,11,44
20,Success,50,24,0,13,37
20,Success,43,28,0,12,31
20,Success,44,37,0,10,34
20,Success,48,24,0,16,32
20,Success,41,32,0,18,23
20,Success,47,23,1,16,31
20,Success,45,26,9,9,36
20,Success,45,20,9,14,31
20,Success,54,21,6,8,46
20,Success,45,25,0,16,29
20,Success,43,41,0,8,35
20,Success,44,39,0,11,33
20,Success,52,31,0,6,46
20,Success,53,12,10,11,42
20,Success,43,26,3,15,28
20,Success,50,29,0,13,37
20,Success,41,24,12,14,27
20,Success,48,25,1,16,32
20,Success,56,20,0,13,43
20,Success,47,26,1,12,35
20,Success,48,21,7,16,32
20,Success,47,29,1,11,36
20,Success,45,37,0,10,35
20,Success,44,29,0,20,24
20,Success,48,33,0,13,35
20,Success,46,24,4,14,32
20,Success,52,14,5,15,37
20,Success,51,26,3,5,46
20,Success,46,25,7,11,35
20,Success,46,31,0,13,33
20,Success,52,24,0,14,38
20,Success,49,24,0,13,36
20,Success,50,31,0,9,41
20,Success,51,21,0,15,36
20,Success,50,33,0,6,44
20,Success,51,22,0,17,34
20,Success,57,18,1,14,43
20,Success,50,29,0,9,41
20,Success,45,35,0,10,35
20,Success,44,21,8,18,26
20,Success,45,28,0,16,29
20,Success,56,20,0,11,45
20,Success,49,31,0,10,39
20,Success,45,25,2,15,30
20,Success,47,26,0,18,29
20,Success,49,19,3,19,30
20,Success,39,35,0,15,24
20,Success,45,33,0,13,32
20,Success,53,33,0,6,47
20,Success,46,31,0,8,38
20,Success,45,33,4,9,36
20,Success,43,33,0,16,27
20,Success,43,31,1,17,26
20,Success,44,27,6,14,30
20,Success,56,20,0,13,43
20,Success,46,28,5,13,33
20,Success,49,32,0,12,37
20,Success,51,22,2,10,41
20,Success,53,20,3,12,41
20,Success,47,21,1,16,31
20,Success,51,29,1,7,44
20,Success,40,28,11,13,27
20,Success,42,30,2,13,29
20,Success,47,18,10,16,31
20,Success,52,24,0,13,39
20,Success,37,33,0,16,21
20,Success,47,38,0,8,39
20,Success,52,24,0,14,38
20,Success,45,27,6,11,34
20,Success,57,23,0,6,51
20,Success,48,31,0,12,36
20,Success,48,32,2,8,40
20,Success,53,24,1,12,41
20,Success,44,31,0,13,31
20,Success,45,31,3,9,36
20,Success,45,33,4,8,37
20,Success,52,25,4,8,44
20,Success,45,21,0,20,25
20,Success,49,17,9,13,36
20,Success,48,27,2,11,37
20,Success,42,29,2,16,26
20,Success,43,34,4,14,29
20,Success,49,28,0,12,37
20,Success,39,39,0,15,24
20,Success,41,28,0,17,24
20,Success,46,27,0,14,32
20,Success,53,22,6,10,43
20,Success,55,22,0,11,44
20,Success,55,20,1,11,44
20,Success,50,22,1,14,36
20,Success,52,22,0,14,38
20,Success,45,27,3,16,29
20,Success,39,44,0,10,29
20,Success,50,26,3,10,40
20,Success,47,29,0,13,34
20,Success,54,24,0,11,43
20,Success,44,30,1,10,34
20,Success,56,21,0,11,45
20,Success,43,27,3,13,30
20,Success,46,22,7,13,33
20,Success,53,24,0,10,43
20,Success,45,36,0,10,35
20,Success,49,21,0,21,28
20,Success,51,25,4,12,39
20,Success,44,32,0,14,30
20,Success,56,19,0,12,44
20,Success,49,20,0,15,34
20,Success,53,26,0,13,40
20,Success,52,24,4,11,41
20,Fail,36,33,0,21,15
20,Success,50,30,0,12,38
20,Success,47,27,0,14,33
20,Fail,37,21,14,20,17
20,Success,47,28,0,13,34
20,Success,57,23,0,9,48
20,Success,49,22,0,16,33
20,Success,48,28,3,10,38
20,Success,48,32,0,10,38
20,Success,47,36,0,7,40
20,Success,44,32,0,14,30
20,Success,58,20,0,8,50
20,Success,42,35,0,13,29
20,Success,45,25,0,16,29
20,Success,49,24,6,11,38
20,Success,52,23,0,11,41
20,Success,47,34,0,10,37
20,Success,50,33,0,10,40
20,Success,51,24,3,12,39
20,Success,47,29,7,9,38
20,Success,42,28,11,13,29
20,Success,55,25,0,11,44
20,Success,51,32,0,10,41
20,Success,41,35,0,17,24
20,Success,52,25,1,7,45
20,Success,39,27,5,18,21
20,Success,46,27,0,16,30
20,Success,42,29,4,12,30
20,Success,50,29,0,8,42
20,Success,47,30,0,18,29
20,Success,43,34,0,11,32
20,Success,54,22,0,11,43
20,Success,54,19,6,12,42
20,Success,43,31,0,17,26
20,Success,40,34,0,17,23
20,Success,44,33,0,16,28
20,Success,43,30,0,15,28
20,Success,60,16,4,9,51
20,Success,39,37,0,13,26
20,Success,49,24,0,17,32
20,Success,45,29,3,11,34
20,Success,40,35,0,16,24
20,Success,52,19,0,15,37
20,Success,54,21,1,10,44
20,Success,47,28,1,16,31
20,Success,40,29,0,17,23
20,Success,54,23,2,13,41
20,Success,47,36,0,9,38
20,Success,48,27,2,12,36
20,Success,41,34,1,11,30
20,Success,47,30,3,11,36
20,Success,52,19,5,13,39
20,Success,44,27,4,16,28
20,Success,53,24,4,10,43
20,Success,49,25,2,13,36
20,Success,54,24,2,10,44
20,Success,46,32,0,15,31
20,Success,47,28,6,11,36
20,Success,38,38,0,13,25
20,Success,43,32,2,10,33
20,Success,47,18,0,17,30
20,Success,51,30,0,10,41
20,Success,48,25,8,10,38
20,Success,44,35,0,13,31
20,Success,45,26,1,14,31
20,Success,51,21,9,9,42
20,Success,48,26,3,12,36
20,Success,51,26,1,8,43
20,Success,53,22,0,11,42
20,Success,44,29,4,13,31
20,Success,48,23,8,13,35
20,Success,46,29,0,11,35
20,Success,40,30,0,18,22
20,Success,47,29,1,12,35
20,Success,44,30,0,12,32
20,Success,47,32,0,14,33
20,Success,45,26,10,13,32
20,Success,55,21,0,11,44
20,Success,51,26,0,12,39
20,Success,50,21,2,16,34
20,Success,49,28,0,13,36
20,Success,50,28,1,13,37
20,Success,52,24,3,8,44
20,Success,45,23,9,11,34
20,Success,51,23,4,11,40
20,Success,45,23,5,13,32
20,Success,45,19,12,14,31
20,Success,49,20,4,16,33
20,Success,41,26,4,18,23
20,Success,47,22,5,12,35
20,Success,48,23,0,17,31
20,Success,50,27,0,14,36
20,Success,46,27,0,15,31
20,Success,51,33,0,7,44
20,Success,52,28,0,11,41
20,Success,55,24,1,8,47
20,Success,49,29,0,9,40
20,Success,41,31,0,15,26
20,Success,48,30,0,11,37
20,Success,50,29,0,9,41
20,Success,49,27,6,8,41
20,Success,41,34,3,6,35
20,Success,52,27,6,9,43
20,Success,58,18,0,13,45
20,Success,42,27,0,19,23
20,Success,49,26,2,9,40
20,Success,53,23,1,12,41
20,Success,48,22,0,17,31
20,Success,52,25,4,9,43
20,Success,43,36,0,14,29
20,Success,49,32,0,10,39
20,Success,57,19,0,8,49
20,Success,55,20,3,13,42
20,Success,55,18,5,13,42
20,Success,57,22,5,7,50
20,Success,53,27,2,12,41
20,Success,46,24,5,17,29
20,Success,42,35,0,13,29
20,Success,43,35,0,14,29
20,Success,42,26,9,15,27
20,Success,48,29,0,13,35
20,Success,45,37,0,7,38
20,Success,52,32,0,11,41
20,Success,42,35,0,13,29
20,Success,48,28,0,12,36
20,Success,40,32,0,17,23
20,Success,50,23,2,16,34
20,Success,49,19,1,18,31
20,Success,47,30,4,10,37
20,Success,53,23,6,7,46
20,Success,43,38,0,13,30
20,Success,46,29,1,16,30
20,Success,50,19,4,12,38
20,Success,48,31,0,8,40
20,Success,48,24,9,10,38
20,Success,53,24,0,10,43
20,Success,45,37,0,10,35
20,Success,41,23,9,20,21
20,Success,50,24,0,14,36
20,Success,45,33,1,11,34
20,Success,46,26,7,11,35
20,Success,48,21,3,17,31
20,Success,44,26,3,12,32
20,Success,57,25,0,7,50
20,Success,49,21,2,19,30
20,Success,49,25,11,9,40
20,Success,47,31,0,12,35
20,Success,39,23,12,18,21
20,Success,45,31,0,13,32
20,Success,42,35,0,10,32
20,Success,51,26,0,13,38
20,Success,48,26,3,9,39
20,Success,54,27,0,12,42
20,Success,40,35,0,18,22
20,Success,47,32,0,13,34
20,Success,45,32,0,13,32
20,Success,37,36,0,15,22
20,Success,41,38,0,14,27
20,Success,52,21,4,14,38
20,Success,48,27,0,11,37
20,Success,50,28,0,13,37
20,Success,45,30,0,14,31
20,Success,51,31,0,10,41
20,Success,45,32,0,14,31
20,Success,50,22,4,11,39
20,Success,37,28,5,17,20
20,Success,45,30,0,13,32
20,Success,55,19,5,11,44
20,Success,53,21,0,13,40
20,Success,38,32,11,14,24
20,Success,51,30,0,12,39
20,Success,58,26,0,5,53
20,Success,55,22,0,11,44
20,Success,51,25,1,14,37
20,Success,48,21,3,16,32
20,Success,46,29,2,14,32
20,Success,49,25,0,16,33
20,Success,50,28,1,9,41
20,Success,45,29,7,9,36
20,Success,52,21,1,12,40
20,Success,48,28,0,13,35
20,Success,47,44,0,5,42
20,Success,50,24,0,11,39
20,Success,46,29,0,14,32
20,Success,47,31,0,11,36
20,Success,47,25,6,11,36
20,Success,43,35,0,12,31
20,Success,45,22,0,22,23
20,Success,46,30,0,14,32
20,Success,43,35,0,12,31
20,Success,49,24,3,12,37
20,Success,47,24,1,16,31
20,Success,49,27,0,10,39
20,Success,44,32,5,11,33
20,Success,51,29,0,8,43
20,Success,47,24,0,15,32
20,Success,58,24,3,7,51
20,Success,45,29,7,9,36
20,Success,43,32,6,10,33
20,Success,49,30,0,11,38
20,Success,49,31,0,13,36
20,Success,43,25,0,23,20
20,Success,44,28,3,13,31
20,Success,51,25,4,9,42
20,Success,50,25,2,13,37
20,Success,49,31,1,11,38
20,Fail,39,30,0,20,19
20,Success,50,31,0,8,42
20,Success,46,33,1,9,37
20,Success,59,22,0,10,49
20,Success,43,27,5,14,29
20,Success,42,31,4,13,29
20,Success,43,32,0,17,26
20,Success,45,27,8,12,33
20,Success,45,26,16,8,37
20,Success,48,33,0,6,42
20,Success,49,30,0,12,37
20,Success,45,29,0,15,30
20,Success,50,22,4,15,35
20,Success,37,33,9,14,23
20,Success,41,26,7,20,21
20,Success,51,27,1,12,39
20,Success,49,40,0,5,44
20,Success,49,23,0,15,34
20,Success,51,22,6,10,41
20,Success,45,33,0,15,30
20,Success,42,26,5,15,27
20,Success,48,31,3,8,40
20,Success,48,29,2,12,36
20,Success,45,32,0,12,33
20,Success,47,36,0,6,41
20,Success,46,30,0,9,37
20,Success,61,16,0,8,53
20,Success,52,23,4,10,42
20,Success,52,26,0,13,39
20,Success,44,28,4,15,29
20,Success,48,28,0,12,36
20,Success,52,26,1,12,40
20,Success,48,29,0,12,36
20,Success,51,25,5,11,40
20,Success,49,27,0,15,34
20,Success,42,29,3,15,27
20,Success,44,40,0,9,35
20,Success,53,29,0,10,43
20,Success,47,19,4,18,29
20,Success,49,23,0,12,37
20,Success,48,26,7,9,39
20,Success,44,34,1,8,36
20,Success,48,25,6,15,33
20,Success,46,32,0,11,35
20,Success,46,18,5,18,28
20,Success,44,26,7,13,31
20,Success,46,30,0,15,31
20,Success,47,26,2,14,33
20,Success,51,26,0,11,40
20,Success,46,23,6,15,31
20,Success,52,23,2,13,39
20,Success,56,18,0,15,41
20,Success,43,22,5,18,25
20,Success,44,28,9,15,29
20,Success,51,17,0,12,39
20,Success,51,22,6,14,37
20,Success,57,18,0,10,47
20,Success,49,22,0,16,33
20,Success,49,16,6,17,32
20,Success,46,25,1,18,28
20,Success,49,27,0,11,38
20,Success,52,29,0,6,46
20,Success,52,25,0,15,37
20,Success,56,21,0,12,44
20,Success,46,31,0,13,33
20,Success,46,26,0,16,30
20,Success,49,26,3,11,38
20,Success,49,20,11,13,36
20,Success,48,27,3,10,38
20,Success,41,33,0,14,27
20,Success,56,20,0,14,42
20,Success,52,26,0,10,42
20,Success,50,26,6,7,43
20,Success,53,26,0,11,42
20,Success,56,17,4,12,44
20,Success,45,32,1,13,32
20,Success,40,38,0,13,27
20,Success,51,23,3,13,38
20,Success,56,20,3,10,46
20,Success,52,20,1,17,35
20,Success,56,16,7,12,44
20,Success,50,23,2,11,39
20,Success,45,23,3,17,28
20,Success,51,21,0,15,36
20,Success,46,36,0,10,36
20,Success,40,38,0,12,28
20,Success,44,28,6,12,32
20,Success,54,28,0,9,45
20,Success,50,25,0,19,31
20,Fail,36,44,0,17,19
20,Success,48,26,0,16,32
20,Success,43,34,2,14,29
20,Success,48,33,0,12,36
20,Success,45,32,0,17,28
20,Success,46,32,0,14,32
20,Success,55,28,0,11,44
20,Success,43,31,0,14,29
20,Success,39,38,0,15,24
20,Success,51,28,0,9,42
20,Success,39,30,5,16,23
20,Success,51,34,0,6,45
20,Success,54,32,0,4,50
20,Success,45,37,0,12,33
20,Success,36,31,9,15,21
20,Success,46,26,3,14,32
20,Success,55,24,1,11,44
20,Success,52,25,1,10,42
20,Success,52,21,5,12,40
20,Success,56,16,2,11,45
20,Success,50,22,7,10,40
20,Success,49,21,5,16,33
20,Success,49,25,4,10,39
20,Success,41,25,12,10,31
20,Success,47,23,4,15,32
20,Success,53,19,1,15,38
20,Success,52,26,0,11,41
20,Success,55,25,0,9,46
20,Success,42,31,0,15,27
20,Success,48,25,3,12,36
20,Success,50,22,7,10,40
20,Success,48,30,0,13,35
20,Success,57,25,0,7,50
20,Success,57,24,0,10,47
20,Success,45,30,0,14,31
20,Success,54,29,0,10,44
20,Success,54,22,5,9,45
20,Success,53,33,0,9,44
20,Success,50,24,4,11,39
20,Success,52,27,0,9,43
20,Success,46,24,2,16,30
20,Success,53,25,0,9,44
20,Success,42,32,6,13,29
20,Success,49,30,5,12,37
20,Success,46,36,1,7,39
20,Success,52,26,2,11,41
20,Success,49,29,0,12,37
20,Success,41,27,6,15,26
20,Success,48,24,6,10,38
20,Success,47,24,0,17,30
20,Success,48,30,0,10,38
20,Success,48,29,0,12,36
20,Success,43,30,0,17,26
20,Success,46,28,0,14,32
20,Success,47,35,0,10,37
20,Success,45,25,1,15,30
20,Success,46,24,2,15,31
20,Success,45,33,0,11,34
20,Success,47,25,0,15,32
20,Success,54,23,0,13,41
20,Success,54,20,0,13,41
20,Success,42,34,3,12,30
20,Success,47,33,0,9,38
20,Success,48,19,5,18,30
20,Success,41,37,1,12,29
20,Success,46,30,0,18,28
20,Success,50,25,0,13,37
20,Success,47,26,0,12,35
20,Success,41,25,7,15,26
20,Success,49,31,0,12,37
20,Success,48,21,0,19,29
20,Success,49,25,0,15,34
20,Success,47,27,0,13,34
20,Success,47,34,0,9,38
20,Success,51,25,1,10,41
20,Success,40,38,0,15,25
20,Success,44,27,0,14,30
20,Success,55,28,2,4,51
20,Success,42,34,5,12,30
20,Success,51,19,0,18,33
20,Success,43,27,0,17,26
20,Success,45,27,5,12,33
20,Success,56,23,3,11,45
20,Success,48,26,2,15,33
20,Success,55,24,0,11,44
20,Success,48,25,1,15,33
20,Success,54,22,4,8,46
20,Success,54,21,1,13,41
20,Success,41,38,0,15,26
20,Success,46,34,0,9,37
20,Success,40,30,0,20,20
20,Success,50,22,1,12,38
20,Success,45,26,4,11,34
20,Success,50,25,4,11,39
20,Success,47,28,10,8,39
20,Success,48,26,3,12,36
20,Success,47,25,0,14,33
20,Success,46,31,0,13,33
20,Success,46,32,0,9,37
20,Success,54,22,2,6,48
20,Success,43,25,5,18,25
20,Success,45,28,0,13,32
20,Success,47,30,0,11,36
20,Success,48,29,0,11,37
20,Success,50,26,0,12,38
20,Success,46,25,6,10,36
20,Success,45,28,1,15,30
20,Success,50,22,3,15,35
20,Success,45,35,0,13,32
20,Success,42,25,1,18,24
20,Success,58,17,3,10,48
20,Success,53,21,1,11,42
20,Success,47,31,0,15,32
20,Success,46,26,0,14,32
20,Success,49,23,4,13,36
20,Success,52,30,0,10,42
20,Success,41,35,5,11,30
20,Success,39,36,9,11,28
20,Success,44,29,0,17,27
20,Success,45,28,3,13,32
20,Success,44,23,9,14,30
20,Success,50,36,0,8,42
20,Success,52,21,10,11,41
20,Success,42,28,2,15,27
20,Success,56,22,0,12,44
20,Success,45,29,0,18,27
20,Success,60,29,0,8,52
20,Success,47,32,0,9,38
20,Success,57,24,0,9,48
20,Success,52,29,0,9,43
20,Success,38,38,0,14,24
20,Success,52,22,1,12,40
20,Success,48,25,0,15,33
20,Success,47,28,5,12,35
20,Success,52,27,0,9,43
20,Success,43,32,0,17,26
20,Success,50,27,3,10,40
20,Success,48,27,0,13,35
20,Success,46,29,0,14,32
20,Success,43,23,13,8,35
20,Success,51,24,0,13,38
20,Success,47,27,4,12,35
20,Success,51,25,0,10,41
20,Success,42,36,0,14,28
20,Success,47,29,0,12,35
20,Success,39,34,3,12,27
20,Success,52,22,3,13,39
20,Success,50,26,2,12,38
20,Success,49,24,0,17,32
20,Success,53,26,0,10,43
20,Success,49,35,0,12,37
20,Success,49,26,8,8,41
20,Success,53,22,4,6,47
20,Success,47,28,3,14,33
20,Success,47,19,3,16,31
20,Success,50,28,0,12,38
20,Success,59,20,0,10,49
20,Success,54,18,0,14,40
20,Success,49,26,0,16,33
20,Success,51,24,1,10,41
20,Success,45,29,5,12,33
20,Success,50,23,0,16,34
20,Success,49,24,9,10,39
20,Success,54,23,0,16,38
20,Success,51,26,2,12,39
20,Success,47,25,5,10,37
20,Success,40,34,2,15,25
20,Success,59,21,0,11,48
20,Success,51,28,1,11,40
20,Success,46,26,7,12,34
20,Success,46,34,0,11,35
20,Success,48,29,0,13,35
20,Success,47,28,3,10,37
20,Success,50,27,0,12,38
20,Success,40,28,5,18,22
20,Success,42,37,5,7,35
20,Success,55,30,0,8,47
20,Success,52,27,0,11,41
20,Success,44,29,6,9,35
20,Success,45,35,0,11,34
20,Success,53,22,2,14,39
20,Success,55,23,0,10,45
20,Success,51,26,0,14,37
20,Success,45,26,10,11,34
20,Success,58,19,0,12,46
20,Success,42,30,0,17,25
20,Success,42,32,0,18,24
20,Success,49,26,1,11,38
20,Success,47,28,0,10,37
20,Success,39,31,7,14,25
20,Success,49,30,0,13,36
20,Success,43,35,0,14,29
20,Success,48,25,0,15,33
20,Success,50,19,2,15,35
20,Success,49,24,8,11,38
20,Success,44,30,0,9,35
20,Success,51,30,0,10,41
20,Success,51,31,0,10,41
20,Success,52,23,3,10,42
20,Success,46,36,0,7,39
20,Success,48,19,0,20,28
20,Success,54,27,0,12,42
20,Success,52,23,0,13,39
20,Success,50,24,4,11,39
20,Success,47,23,3,18,29
20,Success,51,24,0,8,43
20,Success,51,17,5,15,36
20,Success,44,26,0,17,27
20,Success,55,22,4,12,43
20,Success,43,25,4,17,26
20,Success,48,28,1,14,34
20,Success,45,29,0,14,31
20,Success,48,25,0,17,31
20,Success,40,30,4,16,24
20,Success,51,31,0,7,44
20,Success,49,27,5,12,37
20,Success,47,21,7,10,37
20,Success,53,27,0,9,44
20,Success,53,20,1,19,34
20,Success,51,29,5,5,46
20,Success,47,32,0,11,36
20,Success,44,30,0,12,32
20,Success,51,27,1,10,41
20,Success,52,22,2,13,39
20,Success,48,26,1,16,32
20,Success,50,25,7,7,43
20,Success,47,25,8,13,34
20,Success,50,30,0,5,45
20,Success,46,36,0,11,35
20,Success,51,23,3,9,42
20,Success,45,29,0,16,29
20,Success,49,22,2,14,35
20,Success,42,25,6,19,23
20,Success,57,20,5,10,47
20,Success,50,27,2,12,38
20,Success,54,22,4,11,43
20,Success,41,32,2,12,29
20,Success,50,27,1,14,36
20,Success,50,31,0,12,38
20,Success,42,33,0,14,28
20,Success,41,36,0,13,28
20,Success,42,30,6,12,30
20,Success,43,28,10,12,31
20,Success,44,29,4,12,32
20,Success,46,33,2,13,33
20,Success,43,33,0,20,23
20,Success,48,34,0,9,39
20,Success,55,26,2,9,46
20,Success,44,30,7,12,32
20,Success,52,28,0,8,44
20,Success,39,30,9,10,29
20,Success,48,35,0,9,39
20,Success,48,18,9,13,35
20,Success,50,24,0,14,36
20,Success,42,34,0,14,28
20,Success,39,31,0,19,20
20,Success,48,26,0,16,32
20,Success,44,26,7,14,30
20,Success,42,26,5,17,25
20,Success,43,30,0,13,30
20,Success,50,26,0,14,36
20,Success,52,24,0,8,44
20,Success,47,26,4,13,34
20,Success,51,22,6,13,38
20,Success,46,35,0,8,38
20,Success,44,31,0,13,31
20,Success,56,24,1,13,43
20,Success,44,33,0,14,30
20,Success,49,28,2,7,42
20,Success,51,27,1,12,39
20,Success,49,20,1,18,31
20,Success,52,26,0,9,43
20,Success,43,30,7,13,30
20,Success,55,24,0,13,42
20,Success,48,23,1,17,31
20,Success,43,26,2,14,29
20,Success,44,22,0,23,21
20,Success,47,24,0,19,28
20,Success,51,22,0,17,34
20,Success,48,19,2,14,34
20,Success,47,28,4,8,39
20,Success,46,29,4,11,35
20,Success,47,26,5,10,37
20,Success,50,29,0,12,38
20,Success,42,34,0,14,28
20,Success,48,34,0,6,42
20,Success,49,28,0,14,35
20,Success,49,23,1,17,32
20,Success,53,26,1,12,41
20,Success,58,20,7,9,49
20,Success,49,25,0,13,36
20,Success,46,34,0,9,37
20,Success,49,23,1,13,36
20,Success,50,25,1,13,37
20,Success,43,31,0,16,27
20,Success,47,37,0,10,37
20,Success,46,33,0,10,36
20,Success,52,25,5,11,41
20,Success,44,29,2,16,28
20,Success,46,32,0,11,35
20,Success,46,31,0,11,35
20,Success,46,35,0,5,41
20,Success,54,20,0,16,38
20,Success,49,26,8,8,41
20,Success,54,28,0,8,46
20,Success,47,26,3,13,34
20,Success,43,36,0,13,30
20,Success,44,32,3,10,34
20,Success,45,34,5,9,36
20,Success,45,27,6,10,35
20,Success,40,35,5,11,29
20,Success,56,20,4,10,46
20,Success,49,26,2,11,38
20,Success,51,26,2,12,39
20,Success,47,32,0,9,38
20,Success,45,27,3,13,32
20,Success,44,32,1,14,30
20,Success,51,26,0,13,38
20,Success,42,31,7,11,31
20,Success,47,35,0,7,40
20,Success,56,23,0,9,47
20,Success,52,22,0,16,36
20,Success,49,27,5,8,41
20,Success,53,31,0,8,45
20,Success,48,27,0,11,37
20,Success,54,26,0,10,44
20,Success,43,29,4,16,27
20,Success,50,31,0,9,41
20,Success,42,26,11,10,32
20,Success,48,27,1,12,36
20,Success,50,28,0,10,40
20,Success,51,26,0,12,39
20,Success,47,22,7,15,32
20,Success,51,25,3,7,44
20,Success,44,25,0,19,25
20,Success,47,29,0,13,34
20,Success,53,27,0,11,42
20,Success,52,28,0,10,42
20,Success,46,26,9,11,35
20,Success,53,18,2,13,40
20,Success,41,33,0,14,27
20,Success,49,26,1,14,35
20,Success,49,26,1,14,35
20,Success,48,28,0,12,36
20,Success,50,26,0,13,37
20,Success,47,22,14,15,32
20,Success,47,26,5,12,35
20,Success,39,34,5,14,25
20,Success,56,28,0,10,46
20,Success,47,26,10,11,36
20,Success,46,22,13,13,33
20,Success,41,26,6,16,25
20,Success,47,23,11,10,37
20,Success,48,22,4,15,33
20,Success,45,30,2,14,31
20,Success,44,29,4,13,31
20,Success,53,18,3,14,39
20,Success,51,27,0,14,37
20,Success,46,28,5,11,35
20,Success,46,28,2,13,33
20,Success,55,19,1,13,42
20,Fail,39,35,0,20,19
20,Success,51,25,0,15,36
20,Success,50,27,6,11,39
20,Success,45,32,0,14,31
20,Success,44,22,3,21,23
20,Success,49,25,1,12,37
20,Success,47,38,0,6,41
20,Success,42,25,2,18,24
20,Success,44,30,0,14,30
20,Success,50,24,0,17,33
20,Success,50,28,0,14,36
20,Success,43,35,0,12,31
20,Success,48,32,5,8,40
20,Success,45,29,0,14,31
20,Success,54,27,0,9,45
20,Success,50,23,0,18,32
20,Success,47,28,0,13,34
20,Success,42,39,0,8,34
20,Success,52,27,0,11,41
20,Success,51,22,2,14,37
20,Success,53,26,0,11,42
20,Success,40,30,2,15,25
20,Success,58,13,1,16,42
20,Success,47,24,13,11,36
20,Success,48,29,0,11,37
20,Success,44,35,0,9,35
20,Success,48,26,0,15,33
20,Success,42,29,5,14,28
20,Success,55,24,3,7,48
20,Success,43,30,0,17,26
20,Success,48,28,0,15,33
20,Success,43,27,8,14,29
20,Success,47,30,0,13,34
20,Success,43,25,8,12,31
20,Success,53,16,3,19,34
20,Success,42,29,1,16,26
20,Success,44,26,6,12,32
20,Success,51,32,0,9,42
20,Success,42,31,0,16,26
20,Success,44,32,0,15,29
20,Success,39,36,6,14,25
20,Success,47,28,0,12,35
20,Success,39,32,0,16,23
20,Success,39,40,0,13,26
20,Success,47,29,0,15,32
20,Success,59,19,2,9,50
20,Success,55,16,1,11,44
20,Success,52,21,5,11,41
20,Success,55,21,4,11,44
20,Success,49,29,0,11,38
20,Success,42,28,5,16,26
20,Success,45,23,4,13,32
20,Success,49,26,0,15,34
20,Success,41,33,7,12,29
20,Success,52,22,3,10,42
20,Success,45,34,0,9,36
20,Success,45,31,7,9,36
20,Success,51,31,0,10,41
20,Success,49,18,6,17,32
20,Success,56,24,2,8,48
20,Success,47,24,6,11,36
20,Success,52,22,1,10,42
20,Success,53,23,2,9,44
20,Success,50,26,0,11,39
20,Success,43,31,3,13,30
20,Success,49,32,0,8,41
20,Success,48,29,0,14,34
20,Success,55,26,0,7,48
20,Success,52,25,0,9,43
20,Success,42,34,0,15,27
20,Success,51,29,0,12,39
20,Success,49,23,2,15,34
20,Success,55,22,0,11,44
20,Success,51,23,0,13,38
20,Success,54,25,0,12,42
20,Success,52,26,0,9,43
20,Success,50,26,6,9,41
20,Success,53,24,0,9,44
20,Success,45,29,6,9,36
20,Success,53,24,3,7,46
20,Success,49,28,4,10,39
20,Success,48,29,0,11,37
20,Success,50,22,4,12,38
20,Success,39,31,3,17,22
20,Success,45,29,0,19,26
20,Success,61,18,0,12,49
20,Success,49,24,3,14,35
20,Success,55,22,1,15,40
20,Success,42,30,0,17,25
20,Success,50,31,0,7,43
20,Success,59,18,2,10,49
20,Success,58,19,0,11,47
20,Success,49,26,0,13,36
20,Success,50,29,0,11,39
20,Success,45,27,9,13,32
20,Success,57,20,0,10,47
20,Success,47,22,0,16,31
20,Success,51,28,2,10,41
20,Success,38,43,0,11,27
20,Success,46,29,0,19,27
20,Success,43,31,1,14,29
20,Success,43,32,0,15,28
20,Success,56,25,4,7,49
20,Success,52,19,1,18,34
20,Success,47,25,0,14,33
20,Success,52,23,6,9,43
20,Fail,37,28,0,24,13
20,Success,47,26,1,14,33
20,Success,47,21,7,18,29
20,Success,44,35,0,15,29
20,Success,49,24,0,14,35
20,Success,45,27,0,15,30
20,Success,40,36,0,17,23
20,Success,47,24,3,16,31
20,Success,50,29,5,7,43
20,Success,53,27,0,12,41
20,Success,48,26,0,14,34
20,Success,47,39,0,10,37
20,Success,52,25,0,10,42
20,Success,48,31,0,13,35
20,Success,57,14,2,15,42
20,Success,51,26,2,8,43
20,Success,48,18,0,23,25
20,Success,56,22,4,12,44
20,Success,39,27,16,15,24
20,Success,48,27,0,9,39
20,Success,49,22,1,13,36
20,Success,46,32,0,9,37
20,Success,60,21,0,10,50
20,Success,56,17,3,12,44
20,Success,56,26,2,8,48
20,Success,50,22,3,16,34
20,Success,47,31,7,7,40
20,Success,48,33,0,13,35
20,Success,43,31,1,14,29
20,Success,49,20,10,15,34
20,Success,46,30,6,10,36
20,Success,47,28,0,12,35
20,Success,46,27,0,16,30
20,Success,46,23,8,15,31
20,Success,50,22,3,13,37
20,Success,50,31,0,11,39
20,Success,53,24,1,10,43
20,Success,45,28,0,15,30
20,Success,43,29,0,20,23
20,Success,53,22,0,13,40
20,Success,40,32,4,15,25
20,Success,39,34,0,18,21
20,Success,45,35,0,12,33
20,Success,57,25,0,9,48
20,Success,60,19,0,12,48
20,Success,43,20,0,21,22
20,Success,46,30,1,9,37
20,Success,41,34,0,16,25
20,Success,48,27,4,12,36
20,Success,44,27,7,13,31
20,Success,52,24,0,12,40
20,Success,51,19,5,14,37
20,Success,49,33,0,8,41
20,Success,56,19,0,14,42
20,Success,52,21,5,11,41
20,Success,47,25,0,15,32
20,Success,43,27,6,13,30
20,Success,47,36,0,11,36
20,Success,55,27,0,8,47
20,Success,49,27,0,11,38
20,Success,47,29,0,13,34
20,Success,46,37,0,13,33
20,Success,48,33,0,9,39
20,Success,47,20,4,17,30
20,Success,51,25,3,11,40
20,Success,46,28,14,9,37
20,Success,56,20,3,8,48
20,Success,50,27,0,11,39
20,Success,44,28,7,12,32
20,Success,39,33,6,13,26
20,Success,51,29,0,8,43
20,Success,51,25,0,13,38
20,Success,48,19,6,16,32
20,Success,48,25,4,13,35
20,Success,64,20,0,7,57
20,Success,53,24,1,14,39
20,Success,52,22,2,12,40
20,Success,45,25,5,13,32
20,Success,57,17,0,15,42
20,Success,42,33,0,15,27
20,Success,44,29,0,15,29
20,Success,47,31,0,12,35
20,Success,53,26,0,8,45
20,Success,52,27,0,11,41
20,Success,49,15,11,16,33
20,Success,51,25,0,13,38
20,Success,48,23,1,14,34
20,Success,43,32,0,17,26
20,Success,43,17,7,18,25
20,Success,54,20,0,14,40
20,Success,44,24,1,17,27
20,Success,60,21,0,6,54
20,Success,50,26,0,12,38
20,Success,44,37,0,10,34
20,Success,51,20,4,13,38
20,Success,48,32,0,12,36
20,Success,44,25,3,19,25
20,Success,47,36,0,9,38
20,Success,53,24,0,9,44
20,Fail,41,19,6,22,19
20,Success,53,27,0,10,43
20,Success,42,32,0,16,26
20,Success,45,26,2,12,33
20,Success,44,25,3,16,28
20,Success,51,32,0,5,46
20,Success,47,22,0,20,27
20,Success,46,31,0,12,34
20,Success,42,27,8,12,30
20,Success,49,24,3,11,38
20,Success,46,37,0,10,36
20,Success,53,28,0,7,46
20,Success,50,21,5,13,37
20,Success,47,19,6,17,30
20,Success,48,25,0,15,33
20,Success,47,31,0,9,38
20,Success,49,24,0,10,39
20,Success,51,18,9,11,40
20,Success,43,26,3,16,27
20,Success,44,26,1,17,27
20,Success,49,24,3,10,39
20,Success,50,27,0,16,34
20,Success,54,22,0,10,44
20,Success,49,25,0,15,34
20,Success,51,27,11,5,46
20,Success,44,32,0,10,34
20,Success,53,22,0,12,41
20,Success,45,23,8,14,31
20,Success,49,17,16,11,38
20,Success,48,32,2,10,38
20,Success,48,35,0,12,36
20,Success,41,37,0,12,29
20,Success,54,19,7,10,44
20,Success,45,37,0,8,37
20,Success,47,36,0,9,38
20,Success,46,35,1,10,36
20,Success,46,27,0,21,25
20,Success,44,35,0,14,30
20,Success,42,32,0,16,26
20,Success,43,28,5,16,27
20,Success,54,31,0,5,49
20,Success,58,26,0,9,49
20,Success,43,29,0,19,24
20,Success,46,32,0,13,33
20,Success,52,23,0,14,38
20,Success,56,24,0,9,47
20,Success,48,26,3,12,36
20,Success,45,29,0,16,29
20,Success,51,31,0,9,42
20,Success,56,22,2,7,49
20,Success,47,25,0,16,31
20,Success,43,25,3,18,25
20,Success,49,21,4,15,34
20,Success,42,34,0,11,31
20,Success,46,30,0,12,34
20,Success,45,35,0,12,33
20,Success,48,28,0,15,33
20,Success,55,24,4,7,48
20,Success,53,20,5,10,43
20,Success,59,25,0,5,54
20,Success,44,37,0,10,34
20,Success,43,32,0,13,30
20,Success,46,32,1,12,34
20,Success,52,31,0,9,43
20,Success,46,27,4,11,35
20,Success,54,22,5,9,45
20,Success,45,34,0,10,35
20,Success,47,25,3,16,31
20,Success,54,27,0,9,45
20,Success,40,32,0,16,24
20,Success,50,17,6,15,35
20,Success,44,38,0,8,36
20,Success,43,25,5,18,25
20,Success,48,16,2,16,32
20,Success,43,24,0,22,21
20,Success,45,36,0,8,37
20,Success,47,21,7,16,31
20,Success,49,20,2,15,34
20,Success,51,24,2,9,42
20,Success,52,28,0,12,40
20,Success,55,18,2,15,40
20,Success,48,30,2,13,35
20,Success,41,38,0,11,30
20,Success,44,38,0,10,34
20,Success,51,31,0,10,41
20,Success,47,31,0,13,34
20,Success,44,32,0,16,28
20,Success,45,21,14,13,32
20,Success,43,31,0,15,28
20,Success,52,27,0,11,41
20,Success,52,26,0,14,38
20,Success,45,24,6,13,32
20,Success,44,34,0,9,35
20,Success,53,21,0,10,43
20,Success,50,24,0,16,34
20,Success,41,31,10,12,29
20,Success,53,25,0,12,41
20,Success,46,24,0,18,28
20,Success,44,30,3,15,29
20,Success,41,30,9,10,31
20,Success,58,25,1,7,51
20,Success,48,31,0,12,36
20,Success,52,23,5,10,42
20,Success,48,20,0,17,31
20,Success,52,22,2,15,37
20,Success,46,37,0,10,36
20,Success,45,32,0,13,32
20,Success,51,20,3,15,36
20,Success,48,26,2,13,35
20,Success,53,26,2,9,44
20,Success,43,28,0,17,26
20,Success,43,27,2,18,25
20,Success,53,25,0,7,46
20,Success,49,31,1,9,40
20,Success,46,25,1,15,31
20,Fail,34,31,11,15,19
20,Success,53,24,2,12,41
20,Success,49,26,0,15,34
20,Success,48,22,0,15,33
20,Success,50,31,0,12,38
20,Success,53,26,0,12,41
20,Success,49,28,0,6,43
20,Success,47,26,7,13,34
20,Success,53,22,5,11,42
20,Success,51,25,0,13,38
20,Success,47,26,7,9,38
20,Success,46,38,0,9,37
20,Success,51,23,6,12,39
20,Success,47,28,3,13,34
20,Success,43,38,0,12,31
20,Success,49,22,0,13,36
20,Success,48,30,0,9,39
20,Success,43,28,0,17,26
20,Success,47,29,0,13,34
20,Success,45,30,0,15,30
20,Success,49,26,0,17,32
20,Success,50,31,0,9,41
20,Success,43,25,7,13,30
20,Success,52,22,3,11,41
20,Success,48,28,5,8,40
20,Success,46,28,2,13,33
20,Success,56,17,3,13,43
20,Success,51,30,3,9,42
20,Success,40,32,8,12,28
20,Success,50,26,2,12,38
20,Success,46,27,0,13,33
20,Success,36,36,8,13,23
20,Success,51,27,2,10,41
20,Success,52,29,0,9,43
20,Success,43,28,0,15,28
20,Success,54,26,0,11,43
20,Success,48,27,0,13,35
20,Success,45,27,7,10,35
20,Success,51,20,0,18,33
20,Success,44,33,1,11,33
20,Success,48,33,0,9,39
20,Success,52,19,0,15,37
20,Success,46,26,0,15,31
20,Success,47,21,0,19,28
20,Success,46,29,0,15,31
20,Success,48,26,1,11,37
20,Success,42,39,0,11,31
20,Success,43,27,0,19,24
20,Success,46,23,12,14,32
20,Success,45,35,0,12,33
20,Success,44,32,0,14,30
20,Success,53,27,2,12,41
20,Success,51,30,0,7,44
20,Success,55,22,0,13,42
20,Success,40,30,0,16,24
20,Success,56,20,3,11,45
20,Success,50,31,0,8,42
20,Success,53,22,0,15,38
20,Success,54,21,0,12,42
20,Success,44,26,10,13,31
20,Success,51,22,5,10,41
20,Success,48,30,0,8,40
20,Success,43,25,9,12,31
20,Success,43,32,5,9,34
20,Success,42,28,6,15,27
20,Success,38,35,5,15,23
20,Success,42,26,5,15,27
20,Success,53,16,0,15,38
20,Success,42,27,2,19,23
20,Success,56,21,1,12,44
20,Success,55,26,0,7,48
20,Success,59,17,1,11,48
20,Success,47,34,0,12,35
20,Success,40,37,0,14,26
20,Success,45,30,3,10,35
20,Success,48,21,2,14,34
20,Success,52,22,0,10,42
20,Success,44,32,1,11,33
20,Success,50,28,0,9,41
20,Success,52,20,4,15,37
20,Success,45,25,6,15,30
20,Success,46,34,0,11,35
20,Success,53,24,0,11,42
20,Success,49,29,0,14,35
20,Success,53,29,0,4,49
20,Success,53,24,3,10,43
20,Fail,32,33,7,22,10
20,Success,56,13,7,12,44
20,Success,43,31,0,17,26
20,Success,51,20,3,7,44
20,Success,53,24,0,11,42
20,Success,42,30,1,15,27
20,Success,55,18,6,10,45
20,Success,55,21,4,12,43
20,Success,47,27,15,7,40
20,Success,54,16,9,14,40
20,Success,57,19,2,14,43
20,Success,45,35,0,13,32
20,Success,46,22,7,15,31
20,Success,50,27,6,6,44
20,Success,42,40,0,13,29
20,Success,47,29,0,12,35
20,Success,48,28,0,11,37
20,Success,43,28,5,14,29
20,Success,46,32,2,10,36
20,Success,48,30,0,10,38
20,Success,41,34,0,16,25
20,Success,45,28,6,13,32
20,Success,47,27,0,13,34
20,Success,53,26,0,14,39
20,Success,49,23,1,16,33
20,Success,54,27,0,10,44
20,Success,49,29,0,11,38
20,Success,47,27,6,13,34
20,Success,49,24,0,17,32
20,Success,48,23,0,17,31
20,Success,46,34,0,11,35
20,Success,45,22,4,17,28
20,Success,52,20,3,19,33
20,Success,46,25,13,9,37
20,Success,39,41,0,12,27
20,Success,49,25,1,15,34
20,Success,46,26,4,13,33
20,Success,57,24,0,10,47
20,Success,50,23,2,15,35
20,Success,50,26,0,11,39
20,Success,46,27,0,16,30
20,Success,50,24,5,14,36
20,Success,54,22,2,11,43
20,Success,53,22,0,15,38
20,Success,49,26,2,9,40
20,Success,48,29,6,9,39
20,Success,49,27,0,13,36
20,Success,45,29,0,17,28
20,Success,46,26,0,14,32
20,Success,49,25,1,12,37
20,Success,39,39,0,12,27
20,Success,45,27,3,13,32
20,Success,45,23,10,13,32
20,Success,43,29,1,13,30
20,Success,47,30,0,16,31
20,Success,52,29,0,10,42
20,Success,50,24,1,12,38
20,Success,49,23,6,10,39
20,Success,44,31,5,9,35
20,Success,48,27,0,14,34
20,Success,54,28,0,10,44
20,Success,48,30,0,10,38
20,Success,51,21,1,13,38
20,Success,48,24,3,12,36
20,Success,50,30,0,8,42
20,Success,58,19,0,11,47
20,Success,43,34,0,13,30
20,Success,46,32,0,11,35
20,Success,48,30,0,12,36
20,Success,48,31,1,10,38
20,Success,52,23,3,10,42
20,Success,34,44,0,9,25
20,Success,46,24,6,14,32
20,Success,47,23,2,19,28
20,Success,47,30,0,12,35
20,Success,45,29,0,13,32
20,Success,42,35,0,11,31
20,Success,55,27,0,9,46
20,Success,51,27,0,13,38
20,Success,47,23,0,19,28
20,Success,53,27,1,7,46
20,Success,43,30,3,14,29
20,Fail,41,26,0,24,17
20,Success,42,30,0,18,24
20,Success,44,23,10,15,29
20,Success,46,19,11,14,32
20,Success,39,37,0,13,26
20,Success,47,25,6,11,36
20,Success,39,42,0,13,26
20,Success,44,35,0,12,32
20,Success,51,23,0,13,38
20,Success,55,24,0,5,50
20,Success,50,35,0,6,44
20,Success,51,24,4,10,41
20,Success,49,20,1,19,30
20,Success,51,29,0,10,41
20,Success,44,30,0,14,30
20,Fail,38,32,0,22,16
20,Success,59,18,0,8,51
20,Success,48,26,0,13,35
20,Success,45,36,0,9,36
20,Success,50,26,3,12,38
20,Success,46,28,0,12,34
20,Success,47,24,6,12,35
20,Success,49,23,9,9,40
20,Success,50,31,0,12,38
20,Success,48,29,2,10,38
20,Success,47,28,0,17,30
20,Success,48,30,2,8,40
20,Success,51,24,5,9,42
20,Success,48,26,8,7,41
20,Success,54,21,4,11,43
20,Success,52,24,5,10,42
20,Success,51,28,0,12,39
20,Success,48,26,2,15,33
20,Success,45,23,6,18,27
20,Success,38,41,0,13,25
20,Success,51,23,0,13,38
20,Success,53,23,1,10,43
20,Success,45,22,4,17,28
20,Success,42,40,0,11,31
20,Success,54,28,2,5,49
20,Fail,37,22,15,18,19
20,Success,48,28,1,15,33
20,Success,53,20,2,13,40
20,Success,51,22,3,12,39
20,Success,42,30,7,12,30
20,Success,44,24,0,17,27
20,Success,53,21,2,12,41
20,Success,46,32,0,15,31
20,Success,51,28,0,11,40
20,Success,54,25,0,10,44
20,Success,50,23,0,11,39
20,Success,45,31,0,10,35
20,Success,43,28,8,8,35
20,Success,49,27,0,13,36
20,Success,48,26,0,14,34
20,Success,52,21,0,12,40
20,Success,46,28,2,12,34
20,Success,48,25,0,13,35
20,Success,44,37,0,14,30
20,Success,51,25,1,8,43
20,Success,45,28,4,13,32
20,Success,52,27,0,12,40
20,Success,47,28,8,10,37
20,Success,50,35,0,8,42
20,Success,52,18,0,16,36
20,Success,44,25,0,19,25
20,Success,51,26,0,14,37
20,Success,49,23,2,16,33
20,Success,49,31,1,7,42
20,Success,47,25,2,10,37
20,Success,43,31,2,14,29
20,Success,47,18,0,24,23
20,Success,47,29,3,10,37
20,Success,46,33,0,13,33
20,Success,50,33,0,7,43
20,Success,54,17,0,18,36
20,Success,42,41,0,11,31
20,Success,44,36,5,5,39
20,Success,45,30,6,8,37
20,Success,46,29,10,11,35
20,Success,47,27,8,7,40
20,Success,54,17,1,13,41
20,Success,38,41,0,13,25
20,Success,55,21,1,12,43
20,Success,51,27,0,12,39
20,Success,44,33,2,8,36
20,Success,52,27,0,11,41
20,Success,42,30,0,18,24
20,Success,53,25,0,5,48
20,Success,46,27,3,13,33
20,Success,51,30,1,8,43
20,Success,46,30,0,12,34
20,Success,49,24,5,13,36
20,Success,53,20,1,11,42
20,Success,44,35,0,15,29
20,Success,53,20,0,15,38
20,Success,45,27,2,15,30
20,Success,48,30,3,8,40
20,Success,49,22,2,11,38
20,Success,47,34,0,14,33
20,Success,56,23,1,10,46
20,Success,50,25,0,14,36
20,Success,44,27,7,14,30
20,Success,61,17,2,10,51
20,Success,57,20,3,11,46
20,Success,43,29,0,18,25
20,Success,43,27,0,18,25
20,Success,45,38,0,11,34
20,Success,51,30,0,10,41
20,Success,50,26,0,13,37
20,Success,48,22,6,13,35
20,Success,51,27,0,10,41
20,Success,48,28,4,9,39
20,Success,46,29,5,11,35
20,Success,48,22,2,13,35
20,Success,51,25,3,4,47
20,Success,50,29,4,9,41
20,Success,56,22,4,7,49
20,Success,46,32,0,12,34
20,Success,52,26,0,9,43
20,Success,50,28,9,7,43
20,Success,43,33,0,16,27
20,Success,48,28,1,11,37
20,Success,50,23,11,11,39
20,Success,55,27,0,8,47
20,Success,48,28,5,12,36
20,Success,48,25,5,13,35
20,Success,46,30,0,11,35
20,Success,51,21,1,13,38
20,Success,51,26,6,8,43
20,Success,48,27,0,14,34
20,Success,54,17,2,16,38
20,Success,47,26,1,12,35
20,Success,40,24,6,17,23
20,Success,55,17,1,15,40
20,Success,48,30,0,16,32
20,Success,44,33,2,11,33
20,Success,49,29,0,13,36
20,Success,46,27,0,13,33
20,Success,43,25,7,15,28
20,Success,47,31,0,11,36
20,Success,44,30,0,17,27
20,Success,48,28,0,13,35
20,Success,50,27,0,13,37
20,Success,40,26,10,17,23
20,Success,49,27,0,13,36
20,Success,49,28,2,12,37
20,Success,45,31,0,14,31
20,Success,40,30,5,13,27
20,Success,43,29,7,10,33
20,Success,45,26,5,13,32
20,Success,49,25,0,15,34
20,Success,51,23,0,11,40
20,Success,49,28,0,14,35
20,Success,51,21,3,15,36
20,Success,42,26,7,18,24
20,Success,46,27,0,18,28
20,Success,50,32,0,6,44
20,Success,48,24,3,13,35
20,Success,47,33,1,10,37
20,Success,55,15,0,15,40
20,Success,49,25,3,8,41
20,Success,48,28,0,13,35
20,Success,52,18,7,10,42
20,Success,47,25,4,14,33
20,Success,48,29,1,15,33
20,Success,52,26,4,6,46
20,Success,39,31,7,13,26
20,Success,42,30,0,16,26
20,Success,57,22,0,12,45
20,Success,50,25,0,10,40
20,Success,53,21,7,9,44
20,Success,46,39,0,8,38
20,Success,48,21,0,20,28
20,Success,46,28,0,13,33
20,Success,40,25,8,16,24
20,Success,50,25,0,11,39
20,Success,51,23,0,14,37
20,Success,41,31,0,15,26
20,Success,48,23,2,14,34
20,Success,44,28,5,13,31
20,Success,48,27,0,13,35
20,Success,42,27,12,13,29
20,Success,45,35,0,14,31
20,Success,54,22,2,7,47
20,Success,48,23,0,13,35
20,Success,48,32,2,9,39
20,Success,46,29,0,17,29
20,Success,52,27,3,6,46
20,Success,48,31,4,7,41
20,Success,53,24,5,7,46
20,Success,47,20,2,14,33
20,Success,43,24,9,15,28
20,Success,41,32,11,9,32
20,Success,44,29,5,11,33
20,Success,50,25,7,6,44
20,Success,40,35,0,18,22
20,Success,47,31,0,10,37
20,Success,49,19,1,18,31
20,Success,50,30,0,12,38
20,Success,41,27,0,17,24
20,Success,50,27,5,4,46
20,Success,53,27,0,8,45
20,Success,50,23,1,14,36
20,Success,44,32,0,15,29
20,Fail,36,31,0,22,14
20,Success,52,24,0,14,38
20,Success,48,30,0,13,35
20,Success,49,25,0,17,32
20,Success,48,35,0,9,39
20,Success,49,31,0,10,39
20,Success,54,17,5,13,41
20,Success,46,30,2,9,37
20,Success,53,24,2,9,44
20,Success,48,36,0,7,41
20,Success,53,19,0,14,39
20,Success,53,22,0,15,38
20,Success,52,22,0,12,40
20,Success,51,23,9,12,39
20,Success,56,17,0,15,41
20,Success,48,27,1,12,36
20,Success,46,33,0,10,36
20,Success,47,28,0,13,34
20,Success,43,36,0,14,29
20,Success,53,27,6,8,45
20,Success,43,29,1,17,26
20,Success,45,26,6,12,33
20,Success,50,26,0,11,39
20,Success,45,33,0,13,32
20,Success,45,26,0,21,24
20,Success,42,35,0,15,27
20,Success,51,26,0,9,42
20,Success,48,28,0,15,33
20,Success,51,24,4,11,40
20,Success,49,24,4,12,37
20,Success,47,22,8,15,32
20,Success,51,21,0,16,35
20,Success,49,22,2,15,34
20,Success,47,21,7,14,33
20,Success,52,24,0,12,40
20,Success,51,27,4,9,42
20,Fail,37,24,9,22,15
20,Success,47,22,0,21,26
20,Success,40,30,6,17,23
20,Success,48,35,0,12,36
20,Success,47,20,4,17,30
20,Success,43,31,0,16,27
20,Success,45,26,9,12,33
20,Success,42,36,0,12,30
20,Success,50,22,1,12,38
20,Success,49,23,3,14,35
20,Success,43,28,2,12,31
20,Success,58,23,0,7,51
20,Success,54,27,4,4,50
20,Success,41,32,0,17,24
20,Success,49,26,4,11,38
20,Success,48,25,7,10,38
20,Success,50,24,0,14,36
20,Success,50,23,0,15,35
20,Success,48,28,0,12,36
20,Fail,36,34,2,18,18
20,Success,42,30,4,13,29
20,Success,44,30,0,16,28
20,Success,49,32,0,10,39
20,Success,54,23,0,13,41
20,Success,44,33,0,18,26
20,Success,48,19,8,18,30
20,Success,45,29,3,13,32
20,Success,61,18,2,9,52
20,Success,40,29,2,19,21
20,Success,44,28,7,12,32
20,Success,54,24,0,10,44
20,Success,64,19,0,7,57
20,Success,51,22,2,13,38
20,Success,53,21,4,13,40
20,Success,37,37,0,14,23
20,Success,46,27,0,15,31
20,Success,49,25,0,16,33
20,Success,48,22,5,16,32
20,Success,40,36,0,9,31
20,Success,45,33,1,9,36
20,Fail,37,34,0,18,19
20,Success,48,28,0,14,34
20,Success,48,24,6,10,38
20,Success,47,27,0,14,33
20,Success,50,25,2,13,37
20,Success,47,33,0,13,34
20,Success,50,21,1,15,35
20,Success,44,30,0,14,30
20,Success,49,24,0,16,33
20,Success,51,26,4,6,45
20,Success,48,28,0,14,34
20,Success,57,21,4,12,45
20,Success,42,28,1,20,22
20,Success,51,29,0,14,37
20,Success,53,27,4,6,47
20,Success,42,27,4,17,25
20,Success,41,38,0,11,30
20,Success,50,26,0,13,37
20,Success,48,29,3,10,38
20,Success,43,35,0,13,30
20,Success,51,23,7,10,41
20,Success,49,19,1,15,34
20,Success,49,24,0,12,37
20,Success,47,24,8,11,36
20,Success,57,19,0,11,46
20,Success,49,23,6,12,37
20,Success,44,22,7,18,26
20,Success,50,34,0,8,42
20,Success,46,33,0,9,37
20,Success,54,20,4,12,42
20,Success,48,31,0,9,39
20,Success,52,23,3,10,42
20,Success,47,23,0,13,34
20,Success,46,26,4,18,28
20,Success,52,27,7,6,46
20,Success,50,26,0,12,38
20,Success,56,19,1,12,44
20,Success,46,24,10,13,33
20,Success,50,29,8,6,44
20,Success,52,21,0,14,38
20,Success,54,24,1,9,45
20,Success,52,23,1,14,38
20,Success,58,21,0,11,47
20,Success,41,28,7,15,26
20,Success,45,25,7,12,33
20,Success,55,24,0,8,47
20,Success,46,32,0,9,37
20,Success,39,32,1,16,23
20,Success,56,24,1,4,52
20,Success,48,23,3,21,27
20,Success,48,27,3,11,37
20,Success,52,24,0,12,40
20,Success,53,22,2,12,41
20,Success,58,22,0,11,47
20,Success,53,31,0,6,47
20,Success,53,28,2,8,45
20,Success,48,30,0,14,34
20,Success,52,30,0,7,45
20,Success,49,31,0,8,41
20,Success,56,22,0,10,46
20,Success,45,29,0,17,28
20,Success,45,29,2,13,32
20,Success,42,26,8,16,26
20,Success,51,26,3,7,44
20,Success,47,27,0,12,35
20,Success,45,34,0,12,33
20,Success,36,29,4,16,20
20,Success,41,37,0,10,31
20,Success,44,28,0,17,27
20,Success,45,23,8,14,31
20,Success,45,35,0,12,33
20,Success,52,26,0,8,44
20,Success,55,24,0,11,44
20,Success,48,25,0,13,35
20,Success,47,25,0,15,32
20,Success,50,24,0,12,38
20,Success,49,26,1,13,36
20,Success,47,24,1,19,28
20,Success,52,22,0,12,40
20,Success,56,19,7,12,44
20,Success,47,27,4,10,37
20,Success,51,27,2,12,39
20,Success,48,35,0,9,39
20,Success,47,26,5,11,36
20,Success,54,22,0,11,43
20,Success,40,32,3,13,27
20,Success,46,30,0,10,36
20,Success,49,21,0,15,34
20,Success,48,31,0,14,34
20,Success,53,22,2,14,39
20,Success,45,25,6,16,29
20,Success,43,31,0,19,24
20,Success,49,24,0,10,39
20,Success,49,28,0,13,36
20,Success,42,34,0,16,26
20,Success,52,19,6,14,38
20,Success,44,28,0,16,28
20,Success,54,23,1,14,40
20,Success,46,29,0,15,31
20,Success,47,23,6,14,33
20,Success,50,18,0,18,32
20,Success,45,25,0,18,27
20,Success,39,25,9,15,24
20,Success,54,28,0,12,42
20,Success,54,29,0,9,45
20,Success,51,25,0,14,37
20,Success,54,26,0,9,45
20,Success,49,25,0,16,33
20,Success,60,17,3,9,51
20,Success,50,27,4,11,39
20,Success,48,27,1,10,38
20,Success,41,31,6,16,25
20,Success,45,29,0,16,29
20,Success,42,37,0,11,31
20,Fail,40,26,0,24,16
20,Success,45,38,0,10,35
20,Success,50,32,0,7,43
20,Success,49,26,0,14,35
20,Success,51,21,4,17,34
20,Success,43,27,5,14,29
20,Success,45,23,9,17,28
20,Fail,39,29,0,24,15
20,Success,45,29,0,16,29
20,Success,53,25,0,10,43
20,Success,42,25,7,17,25
20,Success,50,24,0,12,38
20,Success,45,23,4,14,31
20,Success,45,30,0,16,29
20,Success,55,23,0,8,47
20,Success,49,23,7,8,41
20,Success,41,43,0,8,33
20,Success,53,18,5,14,39
20,Success,46,28,2,13,33
20,Success,46,26,7,10,36
20,Success,47,30,2,9,38
20,Success,44,31,0,16,28
20,Success,44,24,8,15,29
20,Success,56,18,0,10,46
20,Success,47,29,1,14,33
20,Success,51,22,1,13,38
20,Success,53,23,0,13,40
20,Success,46,26,0,16,30
20,Success,48,23,0,15,33
20,Success,45,28,3,16,29
20,Success,51,24,6,14,37
20,Success,42,28,4,13,29
20,Success,49,27,0,11,38
20,Success,47,24,0,15,32
20,Success,52,23,0,10,42
20,Success,51,32,0,10,41
20,Success,55,20,2,13,42
20,Success,48,27,0,16,32
20,Success,46,24,8,12,34
20,Success,49,20,3,19,30
20,Success,50,28,0,11,39
20,Success,47,19,13,13,34
20,Success,55,18,1,8,47
20,Success,53,27,9,6,47
20,Success,48,23,9,8,40
20,Success,51,23,0,11,40
20,Success,43,25,7,14,29
20,Success,45,27,9,8,37
20,Success,52,30,0,8,44
20,Success,46,28,0,14,32
20,Success,38,30,11,10,28
20,Success,49,28,0,13,36
20,Success,46,30,0,13,33
20,Success,51,20,0,17,34
20,Success,48,29,4,12,36
20,Success,46,24,3,14,32
20,Success,45,30,0,13,32
20,Success,46,33,0,14,32
20,Success,46,30,3,13,33
20,Success,45,27,1,16,29
20,Success,48,26,4,13,35
20,Success,57,21,0,10,47
20,Success,47,27,0,15,32
20,Success,47,33,0,10,37
20,Success,42,35,0,10,32
20,Success,44,23,4,16,28
20,Success,56,19,1,14,42
20,Success,48,24,6,10,38
20,Success,51,20,0,17,34
20,Success,51,24,0,11,40
20,Success,58,17,0,11,47
20,Success,60,22,0,7,53
20,Success,50,28,0,12,38
20,Success,57,16,4,11,46
20,Success,46,29,6,13,33
20,Success,54,24,2,11,43
20,Success,54,22,4,9,45
20,Success,51,26,3,11,40
20,Success,46,31,0,13,33
20,Success,51,26,3,12,39
20,Success,49,19,7,17,32
20,Success,50,29,0,12,38
20,Success,59,18,1,9,50
20,Success,54,26,0,8,46
20,Success,49,30,0,8,41
20,Success,48,25,0,15,33
20,Success,36,45,0,13,23
20,Success,43,26,4,16,27
20,Success,47,30,0,13,34
20,Success,44,26,0,15,29
20,Success,49,28,2,9,40
20,Success,48,28,2,9,39
20,Success,40,40,0,12,28
20,Success,52,25,4,9,43
20,Success,52,26,6,7,45
20,Success,52,26,0,9,43
20,Success,55,20,3,11,44
20,Success,56,16,0,12,44
20,Success,47,28,3,12,35
20,Success,56,21,0,7,49
20,Success,48,30,0,15,33
20,Success,46,28,0,15,31
20,Success,51,26,0,10,41
20,Success,40,40,0,8,32
20,Success,49,32,0,8,41
20,Success,48,30,0,12,36
20,Success,53,27,4,6,47
20,Success,52,26,0,11,41
20,Fail,40,30,0,21,19
20,Success,46,29,4,9,37
20,Success,51,28,0,7,44
20,Success,61,25,0,5,56
20,Success,44,27,0,17,27
20,Success,49,24,5,10,39
20,Success,48,26,4,12,36
20,Success,48,27,7,8,40
20,Success,51,17,3,19,32
20,Success,56,18,2,8,48
20,Success,41,29,3,16,25
20,Success,49,23,0,13,36
20,Success,45,25,0,18,27
20,Success,51,26,0,10,41
20,Success,53,24,0,12,41
20,Success,56,17,7,8,48
20,Success,47,27,0,16,31
20,Success,49,27,0,12,37
20,Success,52,29,0,10,42
20,Success,42,32,0,13,29
20,Success,45,32,0,9,36
20,Success,52,26,0,12,40
20,Success,44,24,4,18,26
20,Success,45,27,3,14,31
20,Success,50,28,0,10,40
20,Success,44,28,0,18,26
20,Success,47,22,8,12,35
20,Success,49,27,3,11,38
20,Success,50,31,0,8,42
20,Success,55,24,0,8,47
20,Success,47,34,0,12,35
20,Success,51,27,4,7,44
20,Success,47,26,3,11,36
20,Success,43,36,0,9,34
20,Success,47,35,0,8,39
20,Success,47,24,0,16,31
20,Success,51,18,0,18,33
20,Fail,36,24,7,25,11
20,Success,52,30,0,7,45
20,Success,48,31,0,13,35
20,Success,42,27,7,15,27
20,Success,49,31,0,10,39
20,Success,55,24,0,8,47
20,Success,46,33,0,10,36
20,Success,49,22,0,17,32
20,Success,52,20,1,13,39
20,Success,42,38,0,15,27
20,Success,54,24,1,7,47
20,Success,50,25,0,13,37
20,Success,47,30,0,10,37
20,Success,50,23,0,13,37
20,Success,52,26,0,11,41
20,Success,49,23,2,13,36
20,Success,50,27,0,14,36
20,Success,47,29,0,15,32
20,Success,53,21,6,13,40
20,Success,45,36,0,11,34
20,Success,58,17,0,13,45
20,Success,51,27,5,8,43
20,Success,52,30,0,5,47
20,Success,55,23,2,10,45
20,Success,53,23,0,13,40
20,Success,50,26,0,13,37
20,Success,44,25,6,16,28
20,Success,56,18,0,8,48
20,Success,42,23,3,21,21
20,Success,52,27,0,12,40
20,Success,50,20,2,15,35
20,Success,39,31,7,15,24
20,Success,46,31,0,16,30
20,Success,48,24,3,14,34
20,Success,54,27,0,10,44
20,Success,42,31,0,17,25
20,Success,45,33,0,14,31
20,Success,49,21,4,15,34
20,Success,48,26,0,16,32
20,Success,49,24,4,12,37
20,Success,47,31,0,12,35
20,Success,50,38,0,6,44
20,Success,51,24,0,15,36
20,Success,55,23,0,13,42
20,Success,54,20,2,14,40
20,Success,53,24,2,10,43
20,Success,47,25,2,11,36
20,Success,56,24,0,10,46
20,Success,49,26,0,14,35
20,Success,49,27,1,11,38
20,Success,48,26,3,16,32
20,Success,45,28,0,20,25
20,Success,43,31,0,20,23
20,Success,42,28,6,13,29
20,Success,52,23,0,12,40
20,Success,44,23,8,18,26
20,Success,48,27,0,11,37
20,Success,52,27,0,10,42
20,Success,43,29,0,13,30
20,Success,49,24,0,14,35
20,Success,45,26,5,12,33
20,Success,44,23,14,12,32
20,Success,51,27,0,10,41
20,Success,53,26,2,7,46
20,Success,46,37,0,9,37
20,Success,49,31,0,6,43
20,Success,42,27,6,14,28
20,Success,51,33,0,5,46
20,Success,54,16,3,14,40
20,Success,45,29,0,15,30
20,Success,44,31,0,13,31
20,Success,48,23,0,17,31
20,Success,45,32,0,14,31
20,Success,48,30,1,13,35
20,Success,49,22,8,10,39
20,Success,49,31,5,5,44
20,Success,46,29,0,12,34
20,Success,46,25,3,11,35
20,Success,46,29,3,10,36
20,Success,45,32,0,15,30
20,Success,44,36,0,13,31
20,Success,43,28,9,13,30
20,Success,44,33,1,9,35
20,Success,56,25,0,10,46
20,Success,49,23,6,11,38
20,Success,49,20,7,12,37
20,Success,44,32,0,15,29
20,Success,50,25,1,13,37
20,Success,52,22,0,13,39
20,Success,45,32,0,18,27
20,Success,60,15,2,9,51
20,Success,46,24,8,13,33
20,Success,49,28,3,11,38
20,Success,51,24,0,13,38
20,Success,53,21,6,11,42
20,Success,51,25,0,11,40
20,Success,46,25,2,18,28
20,Success,46,28,7,9,37
20,Success,49,20,5,16,33
20,Success,58,24,3,5,53
20,Success,46,28,0,18,28
20,Success,50,25,1,10,40
20,Success,48,34,0,10,38
20,Success,50,23,0,16,34
20,Success,54,31,0,8,46
20,Success,52,26,0,11,41
20,Success,47,39,0,9,38
20,Success,45,29,0,17,28
20,Success,49,22,4,16,33
20,Success,50,26,3,9,41
20,Success,52,25,0,14,38
20,Success,43,30,0,20,23
20,Success,41,23,9,19,22
20,Success,42,28,9,14,28
20,Success,52,26,0,12,40
20,Success,53,25,7,4,49
20,Success,48,29,0,10,38
20,Success,53,20,4,11,42
20,Success,51,26,0,12,39
20,Success,39,37,0,17,22
20,Success,51,26,1,10,41
20,Success,50,18,6,16,34
20,Success,39,37,0,16,23
20,Success,49,29,0,10,39
20,Success,50,30,1,7,43
20,Success,43,27,3,13,30
20,Fail,36,37,5,17,19
20,Success,40,36,0,17,23
20,Success,44,36,0,11,33
20,Success,40,35,2,14,26
20,Success,53,20,0,15,38
20,Success,46,35,0,12,34
20,Success,52,24,4,12,40
20,Success,52,29,1,11,41
20,Success,49,30,0,9,40
20,Success,44,32,0,14,30
20,Success,53,22,0,12,41
20,Success,49,27,0,12,37
20,Success,46,23,0,17,29
20,Success,47,24,0,16,31
20,Success,44,34,0,12,32
20,Success,37,43,0,13,24
20,Success,53,21,1,14,39
20,Success,44,29,6,12,32
20,Success,46,28,0,15,31
20,Fail,41,27,0,23,18
20,Fail,39,28,0,21,18
20,Success,45,25,1,19,26
20,Success,45,35,5,4,41
20,Success,48,23,3,17,31
20,Success,42,26,0,21,21
20,Success,45,25,3,13,32
20,Success,46,34,0,11,35
20,Success,57,13,0,17,40
20,Success,52,27,0,12,40
20,Success,43,27,1,14,29
20,Success,57,17,11,10,47
20,Success,47,27,6,11,36
20,Success,42,26,9,14,28
20,Success,48,28,0,10,38
20,Success,43,32,0,16,27
20,Success,50,32,0,8,42
20,Success,51,18,1,18,33
20,Success,54,26,4,7,47
20,Success,50,24,6,10,40
20,Success,45,34,0,12,33
20,Success,51,21,0,12,39
20,Success,41,27,5,20,21
20,Success,50,18,1,17,33
20,Success,50,32,0,7,43
20,Success,52,21,1,11,41
20,Success,51,25,0,13,38
20,Success,51,36,0,3,48
20,Success,45,34,0,11,34
20,Success,44,35,0,12,32
20,Success,49,19,5,15,34
20,Success,37,37,6,9,28
20,Success,42,36,0,16,26
20,Success,48,31,3,8,40
20,Success,40,31,1,18,22
20,Success,47,31,2,9,38
20,Success,49,24,3,13,36
20,Success,45,28,1,15,30
20,Success,46,30,10,7,39
20,Success,48,32,0,11,37
20,Success,46,25,1,15,31
20,Success,49,24,1,15,34
20,Success,51,19,3,12,39
20,Success,44,29,0,17,27
20,Success,48,26,2,10,38
20,Success,49,23,0,15,34
20,Success,45,28,4,13,32
20,Success,47,23,0,18,29
20,Success,48,28,2,12,36
20,Success,52,25,0,12,40
20,Success,49,19,3,14,35
20,Success,47,22,0,20,27
20,Success,45,22,6,17,28
20,Success,51,20,1,19,32
20,Success,46,31,0,11,35
20,Success,46,31,0,9,37
20,Success,56,18,1,13,43
20,Success,41,25,3,19,22
20,Success,40,34,0,18,22
20,Success,47,29,0,15,32
20,Success,55,23,0,13,42
20,Success,49,29,2,9,40
20,Success,51,24,3,10,41
20,Success,44,33,0,15,29
20,Success,48,31,1,11,37
20,Success,51,29,1,8,43
20,Success,53,27,0,12,41
20,Success,54,27,0,9,45
20,Success,48,29,2,10,38
20,Success,47,26,5,14,33
20,Success,44,38,0,8,36
20,Success,62,15,0,10,52
20,Success,54,25,0,13,41
20,Success,47,24,4,15,32
20,Success,44,30,0,14,30
20,Success,50,33,0,11,39
20,Success,49,26,0,11,38
20,Success,50,21,0,16,34
20,Success,51,27,6,10,41
20,Success,49,29,1,10,39
20,Success,48,26,3,14,34
20,Success,53,27,0,10,43
20,Success,49,27,0,12,37
20,Success,53,30,0,8,45
20,Success,45,34,2,10,35
20,Success,41,34,3,14,27
20,Success,45,39,0,6,39
20,Success,50,22,0,15,35
20,Success,52,21,0,14,38
20,Success,46,30,1,10,36
20,Success,42,28,7,9,33
20,Success,47,17,8,20,27
20,Success,52,29,3,5,47
20,Success,48,28,0,15,33
20,Success,47,27,6,14,33
20,Success,54,27,0,7,47
20,Success,41,26,0,21,20
20,Success,56,24,2,7,49
20,Success,44,33,3,8,36
20,Success,53,21,0,13,40
20,Success,52,29,0,12,40
20,Success,50,29,0,9,41
20,Success,44,27,1,16,28
20,Success,53,22,0,16,37
20,Success,56,18,0,13,43
20,Success,43,31,0,14,29
20,Success,49,27,0,16,33
20,Success,49,32,0,7,42
20,Success,53,25,0,11,42
20,Success,48,22,2,15,33
20,Success,46,37,0,10,36
20,Success,52,25,0,11,41
20,Success,47,34,0,9,38
20,Success,44,27,5,16,28
20,Success,48,24,5,8,40
20,Success,44,29,0,13,31
20,Success,52,19,11,11,41
20,Success,38,32,4,15,23
20,Success,53,23,2,11,42
20,Success,44,35,0,11,33
20,Success,44,30,4,11,33
20,Success,48,25,0,12,36
20,Success,53,29,1,6,47
20,Success,47,26,0,16,31
20,Success,49,21,0,19,30
20,Success,47,21,9,13,34
20,Success,51,21,2,12,39
20,Success,46,38,0,7,39
20,Success,53,18,5,14,39
20,Success,43,24,2,18,25
20,Success,48,29,0,12,36
20,Success,47,27,1,13,34
20,Success,47,27,5,13,34
20,Success,54,21,4,8,46
20,Success,38,36,0,15,23
20,Success,43,27,3,18,25
20,Success,48,22,3,16,32
20,Success,52,26,0,12,40
20,Success,48,22,1,15,33
20,Success,53,22,0,13,40
20,Success,48,34,0,13,35
20,Success,52,23,3,12,40
20,Success,47,23,7,14,33
20,Success,48,28,5,11,37
20,Success,42,31,2,16,26
20,Success,49,20,2,13,36
20,Success,52,25,1,8,44
20,Success,56,16,0,15,41
20,Success,55,25,0,12,43
20,Success,43,34,0,14,29
20,Success,52,27,1,13,39
20,Success,48,28,0,11,37
20,Success,55,23,2,13,42
20,Success,50,27,0,13,37
20,Success,52,23,0,15,37
20,Success,42,31,5,15,27
20,Success,53,22,0,13,40
20,Success,43,36,0,9,34
20,Success,51,23,6,14,37
20,Success,52,26,0,12,40
20,Success,53,30,0,9,44
20,Success,47,35,0,9,38
20,Success,42,28,6,15,27
20,Success,41,31,0,16,25
20,Success,50,34,0,10,40
20,Success,44,33,0,10,34
20,Success,48,25,0,14,34
20,Success,38,41,0,13,25
20,Success,49,28,0,13,36
20,Success,55,26,0,9,46
20,Success,47,27,0,15,32
20,Success,49,26,2,12,37
20,Success,49,21,0,15,34
20,Success,42,28,7,13,29
20,Success,46,26,0,10,36
20,Success,54,21,1,13,41
20,Success,50,27,0,13,37
20,Success,51,18,0,20,31
20,Success,45,36,0,8,37
20,Success,44,35,0,14,30
20,Success,42,32,6,9,33
20,Success,45,37,0,12,33
20,Success,36,33,9,16,20
20,Success,55,27,0,8,47
20,Success,55,26,0,12,43
20,Success,46,26,0,19,27
20,Success,52,21,0,13,39
20,Success,41,32,8,14,27
20,Success,50,29,0,11,39
20,Success,46,35,0,12,34
20,Success,51,24,0,13,38
20,Success,48,23,7,9,39
20,Success,47,23,0,20,27
20,Success,47,23,5,15,32
20,Success,49,22,5,14,35
20,Success,58,15,2,12,46
20,Success,53,20,2,14,39
20,Success,45,33,0,16,29
20,Success,52,20,7,13,39
20,Success,39,42,0,13,26
20,Success,51,28,4,12,39
20,Success,47,22,7,13,34
20,Success,50,22,5,13,37
20,Success,51,26,4,8,43
20,Success,57,22,0,12,45
20,Success,54,23,2,10,44
20,Success,45,25,0,20,25
20,Success,48,25,0,16,32
20,Success,54,24,3,6,48
20,Success,49,30,1,8,41
20,Success,41,35,1,15,26
20,Success,52,24,0,11,41
20,Success,43,24,2,18,25
20,Success,49,22,3,17,32
20,Success,47,24,0,19,28
20,Success,47,29,0,12,35
20,Success,50,28,0,10,40
20,Success,43,29,5,15,28
20,Success,43,26,1,16,27
20,Success,43,30,0,18,25
20,Success,46,31,0,9,37
20,Success,50,23,2,14,36
20,Success,54,23,0,14,40
20,Success,47,26,0,15,32
20,Success,60,22,0,9,51
20,Success,49,26,3,12,37
20,Success,45,25,5,14,31
20,Success,52,28,0,8,44
20,Success,51,24,2,12,39
20,Success,50,20,12,11,39
20,Success,45,26,4,18,27
20,Success,50,21,1,14,36
20,Success,45,33,0,16,29
20,Success,46,28,4,16,30
20,Success,36,37,14,9,27
20,Success,46,27,7,11,35
20,Success,52,27,1,12,40
20,Success,47,28,0,12,35
20,Success,52,21,2,13,39
20,Success,49,23,3,12,37
20,Success,43,39,0,7,36
20,Success,46,29,0,15,31
20,Success,43,29,11,11,32
20,Success,54,30,0,5,49
20,Success,50,21,0,15,35
20,Success,43,28,0,20,23
20,Success,48,27,2,11,37
20,Success,49,30,0,14,35
20,Success,55,24,0,13,42
20,Success,51,25,0,12,39
20,Success,50,20,10,14,36
20,Success,42,34,0,13,29
20,Success,51,26,1,11,40
20,Success,49,23,0,14,35
20,Success,45,35,0,7,38
20,Success,43,28,4,18,25
20,Success,59,17,1,9,50
20,Success,56,23,0,14,42
20,Success,49,24,2,14,35
20,Success,45,32,0,12,33
20,Success,50,27,0,13,37
20,Success,57,21,0,14,43
20,Success,37,34,8,14,23
20,Success,47,31,0,15,32
20,Success,56,24,0,11,45
20,Success,47,25,0,17,30
20,Success,51,31,0,10,41
20,Success,47,27,1,12,35
20,Success,44,26,10,12,32
20,Success,41,34,0,17,24
20,Success,52,17,0,18,34
20,Success,52,30,0,11,41
20,Success,42,26,4,16,26
20,Success,49,23,6,14,35
20,Success,52,23,8,8,44
20,Success,43,24,12,12,31
20,Success,50,30,0,10,40
20,Success,44,28,4,15,29
20,Success,51,20,3,19,32
20,Success,41,32,0,15,26
20,Success,55,19,3,9,46
20,Success,44,26,8,14,30
20,Success,56,25,0,8,48
20,Success,50,26,0,9,41
20,Success,46,28,0,16,30
20,Success,42,35,0,12,30
20,Success,44,32,0,13,31
20,Success,43,26,0,20,23
20,Success,47,36,0,8,39
20,Success,48,25,4,13,35
20,Success,48,28,0,15,33
20,Success,51,30,0,12,39
20,Success,51,22,10,9,42
20,Success,51,21,7,9,42
20,Success,52,17,7,16,36
20,Success,45,22,6,16,29
20,Success,41,32,0,19,22
20,Success,53,22,0,12,41
20,Success,48,27,0,13,35
20,Success,45,29,0,18,27
20,Success,55,28,0,10,45
20,Success,52,24,6,9,43
20,Success,45,26,0,16,29
20,Success,45,33,0,13,32
20,Success,50,30,2,9,41
20,Success,48,33,0,9,39
20,Success,48,28,0,15,33
20,Success,39,30,4,18,21
20,Success,49,32,0,12,37
20,Success,49,21,0,17,32
20,Success,44,23,9,18,26
20,Success,46,23,6,18,28
20,Success,47,29,0,14,33
20,Success,49,21,8,13,36
20,Success,49,27,0,15,34
20,Success,42,41,0,11,31
20,Success,49,15,6,18,31
20,Success,53,28,0,7,46
20,Success,49,32,0,11,38
20,Success,43,32,5,14,29
20,Success,45,32,0,11,34
20,Success,44,23,0,21,23
20,Success,48,23,0,17,31
20,Success,49,29,0,11,38
20,Success,57,20,1,9,48
20,Success,54,25,2,5,49
20,Success,49,27,0,14,35
20,Success,52,24,3,8,44
20,Success,43,32,0,10,33
20,Success,42,23,5,20,22
20,Success,53,29,0,9,44
20,Success,51,25,1,12,39
20,Success,60,22,0,10,50
20,Success,57,15,4,9,48
20,Success,48,27,0,14,34
20,Success,47,34,1,9,38
20,Success,41,29,0,17,24
20,Success,48,24,3,12,36
20,Success,41,22,7,20,21
20,Success,45,26,5,14,31
20,Success,38,37,0,16,22
20,Success,43,35,0,12,31
20,Success,47,28,3,13,34
20,Success,51,26,0,11,40
20,Success,45,30,0,13,32
20,Success,50,31,0,12,38
20,Success,46,25,4,15,31
20,Success,50,19,7,10,40
20,Success,53,23,0,15,38
20,Success,48,29,2,9,39
20,Success,49,27,0,13,36
20,Success,51,24,2,10,41
20,Success,53,23,1,8,45
20,Success,60,18,1,13,47
20,Success,43,30,4,12,31
20,Success,44,22,5,16,28
20,Success,52,27,2,13,39
20,Success,49,25,3,12,37
20,Success,47,25,10,9,38
20,Success,42,32,0,13,29
20,Success,48,23,11,8,40
20,Success,47,27,0,15,32
20,Success,49,23,4,13,36
20,Success,43,34,0,14,29
20,Success,54,18,5,12,42
20,Success,49,27,6,9,40
20,Success,51,24,3,12,39
20,Success,41,30,8,17,24
20,Success,42,33,5,10,32
20,Success,48,32,0,11,37
20,Success,46,26,1,15,31
20,Success,52,27,0,13,39
20,Success,52,27,0,12,40
20,Success,52,27,0,12,40
20,Success,54,23,0,12,42
20,Success,49,25,5,13,36
20,Success,49,18,5,17,32
20,Success,53,19,1,13,40
20,Success,47,30,0,14,33
20,Success,54,25,0,11,43
20,Success,44,30,1,11,33
20,Success,49,27,2,9,40
20,Success,51,24,0,14,37
20,Success,46,30,2,13,33
20,Success,51,24,0,14,37
20,Success,48,35,0,5,43
20,Success,42,34,4,14,28
20,Success,51,21,1,11,40
20,Success,48,27,4,12,36
20,Success,48,26,6,10,38
20,Fail,38,26,6,19,19
20,Success,53,19,0,17,36
20,Success,47,39,0,8,39
20,Success,50,23,4,12,38
20,Success,42,28,11,14,28
20,Success,46,28,6,10,36
20,Success,48,27,3,10,38
20,Success,42,29,7,12,30
20,Success,55,19,2,17,38
20,Success,45,27,0,18,27
20,Success,56,19,0,14,42
20,Success,47,23,1,16,31
20,Success,46,22,6,16,30
20,Success,42,31,0,20,22
20,Success,53,23,5,11,42
20,Success,52,27,0,9,43
20,Success,59,22,0,8,51
20,Success,42,38,0,14,28
20,Success,56,19,0,14,42
20,Success,46,35,0,12,34
20,Success,49,27,0,12,37
20,Success,53,18,0,18,35
20,Success,38,32,2,17,21
20,Success,57,20,1,8,49
20,Success,56,19,1,13,43
20,Success,45,27,5,15,30
20,Success,45,26,9,17,28
20,Success,59,17,6,8,51
20,Success,51,24,0,15,36
20,Success,51,27,4,7,44
20,Success,46,29,0,12,34
20,Success,43,32,0,15,28
20,Success,46,36,0,8,38
20,Success,51,33,0,8,43
20,Success,54,23,4,11,43
20,Success,43,32,9,7,36
20,Success,54,25,4,7,47
20,Success,50,27,2,11,39
20,Success,43,29,3,15,28
20,Success,48,28,3,13,35
20,Success,48,27,0,15,33
20,Success,54,27,0,9,45
20,Success,48,24,0,15,33
20,Success,44,29,6,9,35
20,Success,46,23,7,14,32
20,Success,54,23,1,10,44
20,Success,46,29,0,16,30
20,Success,48,26,0,17,31
20,Success,47,27,0,17,30
20,Success,46,24,4,15,31
20,Success,53,25,2,12,41
20,Success,52,29,0,10,42
20,Success,44,20,12,14,30
20,Success,55,27,0,5,50
20,Success,51,25,2,12,39
20,Success,47,25,7,16,31
20,Success,39,33,0,18,21
20,Success,47,25,0,13,34
20,Success,54,26,0,11,43
20,Success,47,28,4,8,39
20,Success,49,28,9,8,41
20,Success,40,39,0,11,29
20,Success,43,36,0,11,32
20,Success,48,28,0,11,37
20,Success,45,34,0,12,33
20,Success,41,37,0,8,33
20,Success,44,28,0,17,27
20,Success,41,34,2,12,29
20,Success,47,28,0,10,37
20,Success,47,25,5,13,34
20,Success,54,24,1,10,44
20,Success,47,19,11,15,32
20,Success,48,23,0,15,33
20,Success,44,27,0,16,28
20,Success,41,31,1,15,26
20,Success,54,22,1,9,45
20,Success,53,24,0,13,40
20,Success,55,21,3,10,45
20,Success,51,22,4,14,37
20,Success,46,22,1,15,31
20,Success,40,26,7,17,23
20,Success,52,24,3,11,41
20,Success,49,26,0,12,37
20,Success,48,21,0,16,32
20,Success,47,26,4,11,36
20,Success,49,31,0,10,39
20,Success,51,27,0,13,38
20,Success,50,26,3,9,41
20,Success,43,40,0,11,32
20,Success,49,36,1,6,43
20,Success,45,31,3,12,33
20,Success,46,35,0,8,38
20,Success,49,21,0,16,33
20,Success,52,29,2,8,44
20,Success,49,32,0,12,37
20,Success,48,30,0,10,38
20,Success,45,31,0,13,32
20,Success,53,22,0,13,40
20,Success,42,33,0,11,31
20,Success,56,17,1,17,39
20,Success,42,32,0,18,24
20,Success,45,25,1,19,26
20,Success,52,25,0,8,44
20,Success,42,32,0,16,26
20,Success,47,29,0,13,34
20,Success,45,30,5,12,33
20,Success,47,22,9,13,34
20,Success,49,31,0,13,36
20,Success,55,25,0,12,43
20,Success,55,24,1,6,49
20,Success,42,28,10,12,30
20,Success,49,30,0,14,35
20,Success,52,28,0,7,45
20,Success,42,35,5,10,32
20,Success,53,18,2,15,38
20,Success,53,25,3,9,44
20,Success,47,30,0,13,34
20,Success,51,20,6,11,40
20,Success,52,21,5,10,42
20,Success,44,28,5,14,30
20,Success,47,34,0,10,37
20,Success,48,28,4,9,39
20,Success,51,28,0,11,40
20,Success,49,28,0,9,40
20,Success,48,23,0,17,31
20,Success,43,31,0,17,26
20,Success,41,29,1,10,31
20,Success,49,35,0,9,40
20,Success,50,18,10,15,35
20,Success,50,32,3,6,44
20,Success,45,32,1,13,32
20,Success,46,25,7,11,35
20,Success,51,24,2,11,40
20,Success,57,24,0,7,50
20,Success,46,31,0,16,30
20,Success,43,22,11,17,26
20,Success,55,22,0,9,46
20,Success,51,18,0,17,34
20,Success,42,31,0,16,26
20,Success,40,30,0,18,22
20,Success,49,28,0,16,33
20,Success,51,26,0,11,40
20,Success,55,27,0,7,48
20,Success,53,26,0,9,44
20,Success,40,37,0,8,32
20,Success,52,31,0,8,44
20,Success,48,20,1,16,32
20,Success,47,26,0,17,30
20,Success,48,38,0,8,40
20,Success,42,34,0,10,32
20,Success,50,25,0,13,37
20,Success,47,32,0,10,37
20,Success,50,25,2,14,36
20,Success,46,26,0,11,35
20,Success,43,42,0,10,33
20,Success,43,26,6,16,27
20,Success,46,26,2,16,30
20,Success,51,31,0,8,43
20,Success,43,32,2,11,32
20,Success,48,32,0,11,37
20,Success,43,29,7,12,31
20,Success,45,26,0,16,29
20,Success,49,21,11,9,40
20,Success,53,22,0,15,38
20,Success,40,26,8,18,22
20,Success,43,38,0,13,30
20,Success,51,24,1,12,39
20,Success,47,31,1,12,35
20,Success,47,19,1,20,27
20,Success,50,27,4,10,40
20,Success,46,29,7,12,34
20,Success,47,26,9,11,36
20,Success,44,24,3,16,28
20,Success,47,26,2,12,35
20,Success,44,24,0,14,30
20,Success,46,29,0,15,31
20,Success,53,21,0,12,41
20,Success,51,21,4,16,35
20,Success,52,25,5,9,43
20,Success,46,30,4,10,36
20,Success,52,37,0,7,45
20,Success,46,26,3,15,31
20,Success,44,28,0,17,27
20,Success,48,29,0,9,39
20,Success,46,32,0,11,35
20,Success,47,29,0,16,31
20,Success,39,35,0,16,23
20,Success,52,23,0,14,38
20,Success,54,22,5,9,45
20,Success,47,24,5,13,34
20,Success,47,26,7,13,34
20,Success,57,22,4,10,47
20,Success,42,31,0,19,23
20,Success,53,24,0,9,44
20,Success,46,33,2,9,37
20,Success,50,20,7,11,39
20,Success,55,17,14,7,48
20,Success,45,34,0,11,34
20,Success,51,18,9,11,40
20,Success,52,25,0,12,40
20,Success,56,24,0,14,42
20,Success,61,17,1,9,52
20,Success,48,25,5,10,38
20,Success,47,25,6,13,34
20,Success,49,20,0,19,30
20,Success,55,29,0,6,49
20,Success,45,40,0,7,38
20,Success,49,26,5,9,40
20,Success,53,18,6,11,42
20,Success,53,21,0,12,41
20,Success,52,17,5,16,36
20,Success,50,27,0,11,39
20,Success,51,23,3,10,41
20,Success,54,25,0,14,40
20,Success,47,29,0,12,35
20,Success,50,22,8,10,40
20,Success,57,20,0,9,48
20,Success,51,21,3,16,35
20,Success,51,23,3,12,39
20,Success,55,19,0,10,45
20,Success,56,21,0,10,46
20,Success,57,15,0,16,41
20,Success,39,42,0,12,27
20,Success,45,33,0,12,33
20,Success,42,31,11,11,31
20,Success,46,24,3,15,31
20,Success,46,30,8,10,36
20,Success,45,38,0,10,35
20,Success,47,25,5,12,35
20,Success,53,29,0,11,42
20,Success,51,27,0,12,39
20,Success,48,33,0,10,38
20,Success,45,38,0,12,33
20,Success,44,29,6,12,32
20,Success,59,18,1,9,50
20,Success,52,20,1,15,37
20,Success,57,20,0,14,43
20,Success,43,34,0,14,29
20,Success,52,29,0,10,42
20,Success,48,24,0,17,31
20,Success,51,25,0,13,38
20,Success,53,17,0,19,34
20,Success,47,20,10,14,33
20,Success,44,35,0,7,37
20,Success,48,33,0,12,36
20,Success,49,30,0,13,36
20,Success,48,18,6,18,30
20,Success,47,20,2,18,29
20,Success,57,19,0,12,45
20,Success,47,28,5,12,35
20,Success,49,27,0,13,36
20,Success,53,28,0,8,45
20,Success,51,27,1,10,41
20,Success,44,32,5,12,32
20,Success,56,20,0,11,45
20,Success,47,36,0,13,34
20,Success,52,22,1,13,39
20,Success,54,29,0,10,44
20,Success,51,24,7,11,40
20,Success,45,27,4,12,33
20,Success,50,24,0,10,40
20,Success,57,19,5,5,52
20,Success,55,24,2,11,44
20,Success,43,32,0,17,26
20,Success,54,22,1,13,41
20,Success,51,27,4,10,41
20,Success,53,26,2,9,44
20,Success,47,30,0,14,33
20,Success,53,26,0,10,43
20,Success,57,24,0,6,51
20,Success,47,30,6,10,37
20,Success,48,31,0,11,37
20,Success,47,25,4,12,35
20,Success,50,26,0,14,36
20,Success,46,31,0,14,32
20,Success,51,28,0,6,45
20,Success,41,41,0,14,27
20,Success,45,31,3,12,33
20,Success,51,31,0,8,43
20,Success,45,32,1,9,36
20,Success,54,21,5,8,46
20,Success,41,26,3,14,27
20,Success,45,23,12,15,30
20,Success,44,33,0,15,29
20,Success,41,28,7,15,26
20,Success,40,35,0,15,25
20,Fail,38,26,0,22,16
20,Success,44,30,0,15,29
20,Success,52,22,4,14,38
20,Success,55,25,0,7,48
20,Success,49,32,0,10,39
20,Success,46,35,0,11,35
20,Success,48,23,4,15,33
20,Success,45,35,0,8,37
20,Success,45,32,4,9,36
20,Success,45,38,0,11,34
20,Success,56,29,0,6,50
20,Success,49,29,0,14,35
20,Success,45,40,0,6,39
20,Success,46,26,0,17,29
20,Success,51,31,0,9,42
20,Success,49,24,0,12,37
20,Success,51,23,1,12,39
20,Success,50,24,0,11,39
20,Success,42,28,0,18,24
20,Success,46,36,0,11,35
20,Success,48,26,0,14,34
20,Success,48,36,0,7,41
20,Success,44,27,4,12,32
20,Success,45,30,0,12,33
20,Success,52,23,7,9,43
20,Success,58,19,1,12,46
20,Success,47,31,1,10,37
20,Success,48,29,0,12,36
20,Success,45,32,0,10,35
20,Success,52,23,1,11,41
20,Success,50,35,0,9,41
20,Success,45,33,0,11,34
20,Success,51,25,0,11,40
20,Success,48,20,5,17,31
20,Success,46,28,5,13,33
20,Success,49,24,0,16,33
20,Success,50,19,0,18,32
20,Success,44,26,4,13,31
20,Success,43,36,0,11,32
20,Success,53,21,1,12,41
20,Success,46,35,0,9,37
20,Success,51,26,0,10,41
20,Success,48,25,0,15,33
20,Success,55,23,1,10,45
20,Success,51,19,2,14,37
20,Success,42,37,0,15,27
20,Success,47,20,3,20,27
20,Success,52,21,6,8,44
20,Success,52,20,1,13,39
20,Success,54,22,1,12,42
20,Success,52,22,0,13,39
20,Success,53,21,2,15,38
20,Success,55,28,1,9,46
20,Success,54,25,2,11,43
20,Success,51,28,0,9,42
20,Success,43,25,7,13,30
20,Success,48,27,4,11,37
20,Success,54,19,9,9,45
20,Success,48,24,3,15,33
20,Success,53,23,2,11,42
20,Success,46,40,0,6,40
20,Success,48,32,0,11,37
20,Success,54,22,10,8,46
20,Success,45,26,7,11,34
20,Success,46,35,0,11,35
20,Success,45,37,0,10,35
20,Success,53,26,0,7,46
20,Success,45,31,0,13,32
20,Success,49,28,0,12,37
20,Success,40,27,8,19,21
20,Success,46,33,6,10,36
20,Success,45,27,7,13,32
20,Success,46,28,0,17,29
20,Success,49,30,0,8,41
20,Success,43,27,5,16,27
20,Success,51,30,3,7,44
20,Success,46,25,15,7,39
20,Success,45,30,3,15,30
20,Success,51,24,0,12,39
20,Success,54,17,1,8,46
20,Success,53,26,0,11,42
20,Success,42,28,6,17,25
20,Success,39,27,8,17,22
20,Success,47,29,0,14,33
20,Success,45,32,0,12,33
20,Success,48,29,1,12,36
20,Success,51,26,0,13,38
20,Success,45,36,0,10,35
20,Success,45,33,0,14,31
20,Success,48,25,0,11,37
20,Success,51,23,0,14,37
20,Success,57,17,1,14,43
20,Success,58,14,1,12,46
20,Success,53,23,4,11,42
20,Success,46,23,10,16,30
20,Success,47,39,0,10,37
20,Success,45,27,3,12,33
20,Success,45,36,0,14,31
20,Success,52,22,5,10,42
20,Success,51,24,1,11,40
20,Success,50,31,0,13,37
20,Success,48,24,5,14,34
20,Success,49,33,0,9,40
20,Success,41,31,0,13,28
20,Success,44,26,11,13,31
20,Success,47,32,0,11,36
20,Success,45,24,2,15,30
20,Success,47,31,0,9,38
20,Success,49,22,9,10,39
20,Success,47,29,1,9,38
20,Success,49,31,0,12,37
20,Success,51,26,2,11,40
20,Success,54,23,6,6,48
20,Success,51,26,0,10,41
20,Fail,36,30,10,18,18
20,Success,47,29,2,10,37
20,Success,41,33,0,16,25
20,Success,43,29,9,11,32
20,Success,44,33,1,8,36
20,Success,46,31,0,12,34
20,Success,47,26,2,12,35
20,Success,48,29,0,15,33
20,Success,50,29,0,10,40
20,Success,54,24,0,10,44
20,Success,47,30,0,16,31
20,Success,44,28,0,11,33
20,Success,56,20,5,10,46
20,Success,57,18,3,13,44
20,Success,45,27,1,16,29
20,Success,47,28,2,11,36
20,Success,47,28,0,12,35
20,Success,54,21,3,11,43
20,Success,41,30,0,15,26
20,Success,47,29,0,6,41
20,Success,47,28,0,13,34
20,Success,48,23,1,19,29
20,Success,48,29,1,12,36
20,Success,39,33,0,17,22
20,Success,45,24,0,19,26
20,Success,52,24,6,8,44
20,Success,44,25,4,16,28
20,Success,45,26,0,16,29
20,Success,43,24,7,15,28
20,Success,46,26,4,10,36
20,Success,48,23,7,13,35
20,Success,59,19,3,10,49
20,Success,50,24,4,12,38
20,Success,52,29,0,8,44
20,Success,51,21,6,15,36
20,Success,53,23,0,12,41
20,Success,49,25,1,14,35
20,Success,63,17,0,9,54
20,Success,45,26,6,13,32
20,Success,46,26,0,16,30
20,Success,51,22,0,16,35
20,Success,42,29,4,17,25
20,Success,51,25,7,12,39
20,Success,45,31,1,11,34
20,Success,42,30,7,10,32
20,Success,59,21,0,10,49
20,Success,53,34,0,5,48
20,Success,45,34,0,11,34
20,Success,49,34,0,7,42
20,Success,49,27,3,12,37
20,Success,47,23,8,12,35
20,Success,51,31,1,8,43
20,Success,53,26,0,12,41
20,Success,41,37,0,13,28
20,Success,54,22,1,13,41
20,Success,45,26,10,13,32
20,Success,45,33,0,15,30
20,Success,46,36,0,9,37
20,Success,55,18,4,10,45
20,Success,50,24,0,13,37
20,Success,46,33,1,10,36
20,Success,58,15,0,15,43
20,Success,47,29,0,16,31
20,Success,44,27,6,14,30
20,Success,51,23,4,11,40
20,Success,43,24,14,16,27
20,Success,41,36,0,13,28
20,Success,51,22,0,15,36
20,Success,49,30,2,10,39
20,Success,51,27,0,12,39
20,Success,56,17,1,12,44
20,Success,50,28,0,10,40
20,Success,50,26,0,11,39
20,Success,54,25,0,10,44
20,Success,52,27,0,10,42
20,Success,47,26,0,16,31
20,Success,46,36,0,9,37
20,Success,49,28,0,10,39
20,Success,45,38,0,9,36
20,Success,48,34,0,11,37
20,Success,53,26,0,7,46
20,Success,41,25,4,14,27
20,Success,48,28,8,9,39
20,Success,46,27,5,12,34
20,Success,50,21,6,10,40
20,Success,45,29,0,15,30
20,Success,49,28,0,14,35
20,Success,52,34,0,6,46
20,Success,42,29,5,17,25
20,Success,52,30,0,11,41
20,Success,38,39,0,14,24
20,Success,49,25,2,12,37
20,Success,50,18,0,21,29
20,Success,52,25,0,14,38
20,Success,49,28,0,10,39
20,Success,50,29,1,6,44
20,Success,43,28,0,20,23
20,Success,51,21,5,13,38
20,Success,34,33,14,13,21
20,Success,52,31,0,8,44
20,Success,46,35,0,11,35
20,Success,47,30,0,12,35
20,Success,46,33,0,13,33
20,Success,49,27,4,11,38
20,Success,49,29,1,10,39
20,Success,51,31,0,9,42
20,Success,53,25,3,7,46
20,Success,41,36,0,14,27
20,Success,46,25,4,12,34
20,Success,42,32,0,13,29
20,Success,38,39,0,13,25
20,Success,46,25,0,15,31
20,Success,54,15,1,17,37
20,Success,58,18,2,7,51
20,Success,47,29,5,9,38
20,Success,52,24,0,14,38
20,Success,53,26,7,5,48
20,Success,48,33,0,14,34
20,Success,56,28,0,10,46
20,Success,37,31,8,14,23
20,Success,58,14,0,15,43
20,Success,48,23,2,18,30
20,Success,41,26,0,17,24
20,Success,50,23,2,14,36
20,Success,50,23,0,14,36
20,Success,47,24,1,18,29
20,Success,49,26,2,12,37
20,Success,58,20,2,7,51
20,Success,55,25,0,11,44
20,Success,51,22,10,11,40
20,Success,44,28,0,13,31
20,Success,55,19,0,12,43
20,Success,50,23,4,11,39
20,Success,46,23,1,15,31
20,Success,45,29,3,11,34
20,Success,45,28,6,15,30
20,Success,46,25,5,16,30
20,Success,50,22,0,15,35
20,Success,45,28,7,11,34
20,Success,54,20,6,8,46
20,Success,41,36,0,14,27
20,Success,50,30,0,8,42
20,Fail,38,33,0,20,18
20,Success,49,25,1,17,32
20,Success,50,25,0,12,38
20,Success,45,29,4,12,33
20,Success,52,30,0,10,42
20,Success,43,31,0,13,30
20,Success,54,24,0,17,37
20,Success,57,24,2,7,50
20,Success,53,26,0,15,38
20,Success,53,23,0,15,38
20,Success,50,31,0,10,40
20,Success,50,27,3,11,39
20,Success,52,22,0,13,39
20,Success,48,22,0,20,28
20,Success,48,22,6,14,34
20,Success,49,25,4,11,38
20,Success,43,23,8,11,32
20,Success,53,26,0,11,42
20,Success,45,29,2,13,32
20,Success,50,21,0,17,33
20,Success,45,27,3,16,29
20,Success,44,38,0,10,34
20,Success,44,25,4,16,28
20,Success,62,18,0,8,54
20,Success,52,21,3,13,39
20,Success,49,27,5,10,39
20,Success,52,27,1,10,42
20,Success,46,20,7,15,31
20,Success,54,22,0,9,45
20,Success,45,20,10,14,31
20,Success,45,23,1,19,26
20,Success,40,34,0,14,26
20,Success,50,26,5,5,45
20,Success,41,42,0,10,31
20,Success,52,28,0,8,44
20,Success,51,34,0,4,47
20,Success,55,23,0,8,47
20,Success,49,22,4,13,36
20,Success,43,32,2,14,29
20,Success,56,24,3,10,46
20,Success,43,35,0,12,31
20,Success,49,29,0,10,39
20,Success,51,26,2,8,43
20,Success,41,29,5,12,29
20,Success,42,34,0,13,29
20,Success,50,26,0,13,37
20,Success,52,28,0,11,41
20,Success,50,26,0,11,39
20,Success,45,27,3,15,30
20,Success,49,24,0,11,38
20,Success,52,26,0,11,41
20,Success,53,20,3,11,42
20,Success,56,24,0,7,49
20,Success,42,37,0,15,27
20,Success,52,20,7,10,42
20,Success,44,31,0,14,30
20,Success,47,36,0,6,41
20,Success,54,23,5,10,44
20,Success,48,28,0,13,35
20,Success,44,32,0,14,30
20,Success,44,28,8,11,33
20,Success,49,28,2,13,36
20,Success,44,29,0,15,29
20,Success,45,30,2,11,34
20,Success,42,31,0,18,24
20,Success,36,28,16,13,23
20,Success,45,35,0,15,30
20,Success,56,13,0,16,40
20,Success,45,19,15,17,28
20,Success,53,21,5,15,38
20,Success,46,32,0,12,34
20,Success,51,27,0,11,40
20,Success,49,25,2,11,38
20,Success,51,29,0,12,39
20,Success,54,29,0,9,45
20,Success,45,27,0,13,32
20,Success,45,28,7,12,33
20,Success,48,32,0,8,40
20,Success,53,23,0,13,40
20,Success,44,34,0,16,28
20,Success,51,31,0,6,45
20,Success,53,21,1,15,38
20,Success,43,34,0,12,31
20,Success,54,25,0,10,44
20,Success,52,26,4,9,43
20,Success,49,30,0,9,40
20,Success,44,27,0,18,26
20,Success,60,16,0,9,51
20,Success,51,29,0,11,40
20,Success,51,28,0,14,37
20,Success,55,16,2,11,44
20,Success,46,30,0,11,35
20,Success,40,35,3,13,27
20,Success,54,24,0,12,42
20,Success,48,24,0,18,30
20,Success,51,30,0,13,38
20,Success,46,29,2,11,35
20,Success,48,29,1,11,37
20,Success,45,30,7,8,37
20,Success,46,29,0,10,36
20,Success,49,30,0,11,38
20,Success,47,25,0,15,32
20,Success,44,35,0,11,33
20,Success,46,22,3,15,31
20,Success,46,29,10,11,35
20,Success,49,28,2,10,39
20,Success,48,30,0,15,33
20,Success,50,29,0,13,37
20,Success,49,29,0,14,35
20,Success,48,26,2,16,32
20,Success,47,32,0,16,31
20,Success,49,23,6,11,38
20,Success,46,29,2,13,33
20,Success,53,25,0,10,43
20,Success,57,24,1,10,47
20,Success,46,23,3,16,30
20,Success,60,17,5,10,50
20,Success,39,24,7,19,20
20,Success,55,20,0,9,46
20,Success,51,19,0,15,36
20,Success,49,29,0,11,38
20,Success,50,26,1,13,37
20,Success,45,31,0,17,28
20,Success,51,24,1,11,40
20,Success,47,29,0,13,34
20,Success,51,24,1,14,37
20,Success,50,30,4,10,40
20,Fail,37,31,0,20,17
20,Success,39,30,5,14,25
20,Success,55,21,2,10,45
20,Success,56,25,0,7,49
20,Success,53,23,3,11,42
20,Success,54,24,0,13,41
20,Success,47,25,0,18,29
20,Success,51,19,0,16,35
20,Success,52,24,0,13,39
20,Success,47,22,14,10,37
20,Success,56,21,2,9,47
20,Success,46,30,5,9,37
20,Success,50,29,0,10,40
20,Success,56,22,1,5,51
20,Success,45,24,2,15,30
20,Success,53,23,6,9,44
20,Success,48,31,0,10,38
20,Success,46,31,3,10,36
20,Success,53,29,0,11,42
20,Success,47,27,0,15,32
20,Success,54,26,0,12,42
20,Success,44,35,0,14,30
20,Success,52,26,0,10,42
20,Success,48,26,5,10,38
20,Success,56,23,2,8,48
20,Success,48,30,0,11,37
20,Success,54,28,1,9,45
20,Success,49,21,1,16,33
20,Success,52,24,1,12,40
20,Success,51,27,4,9,42
20,Success,60,18,0,11,49
20,Success,47,26,0,14,33
20,Success,51,30,1,8,43
20,Success,46,26,4,12,34
20,Success,40,36,0,11,29
20,Success,48,25,0,16,32
20,Success,48,28,0,13,35
20,Success,55,24,0,5,50
20,Fail,31,35,7,18,13
20,Success,48,35,0,8,40
20,Success,47,27,5,9,38
20,Success,51,24,4,10,41
20,Success,42,32,0,20,22
20,Success,48,25,4,12,36
20,Success,51,26,0,11,40
20,Success,53,19,2,13,40
20,Success,46,32,2,11,35
20,Success,46,33,5,9,37
20,Success,46,29,0,12,34
20,Success,44,30,3,14,30
20,Success,49,33,0,6,43
20,Success,43,28,0,16,27
20,Success,50,32,0,11,39
20,Success,47,28,2,9,38
20,Success,51,29,0,13,38
20,Success,52,23,0,13,39
20,Success,49,28,0,12,37
20,Success,44,32,4,8,36
20,Success,52,24,0,13,39
20,Success,47,29,0,12,35
20,Success,55,18,0,12,43
20,Success,41,19,12,20,21
20,Success,48,26,0,11,37
20,Success,49,28,0,16,33
20,Success,49,29,0,13,36
20,Success,40,35,5,11,29
20,Success,49,31,0,12,37
20,Success,46,27,6,13,33
20,Success,49,24,0,13,36
20,Success,52,22,1,13,39
20,Success,54,26,0,10,44
20,Success,54,29,0,7,47
20,Success,49,27,0,15,34
20,Success,50,25,4,8,42
20,Success,49,20,3,19,30
20,Success,44,25,1,17,27
20,Success,53,27,0,11,42
20,Success,47,33,0,12,35
20,Success,53,26,0,10,43
20,Success,54,29,0,8,46
20,Success,52,28,0,11,41
20,Success,44,29,1,14,30
20,Success,39,32,0,16,23
20,Success,54,21,5,9,45
20,Success,45,36,0,14,31
20,Success,48,25,0,13,35
20,Success,50,24,0,13,37
20,Success,51,29,0,8,43
20,Success,55,22,0,14,41
20,Success,42,25,4,17,25
20,Success,45,27,7,10,35
20,Success,47,29,5,11,36
20,Success,56,19,4,9,47
20,Success,44,22,4,18,26
20,Success,49,27,0,15,34
20,Success,39,31,4,14,25
20,Success,46,27,1,15,31
20,Success,50,27,6,12,38
20,Success,41,25,5,20,21
20,Success,51,17,1,21,30
20,Success,45,28,6,16,29
20,Success,51,25,4,9,42
20,Success,61,23,1,6,55
20,Success,48,25,3,13,35
20,Success,53,22,3,11,42
20,Success,47,28,0,15,32
20,Success,50,30,4,8,42
20,Success,44,30,4,10,34
20,Success,49,30,2,7,42
20,Success,48,23,0,14,34
20,Success,44,34,0,12,32
20,Success,54,21,1,14,40
20,Success,44,28,2,14,30
20,Success,50,29,0,11,39
20,Success,50,24,0,15,35
20,Success,54,28,0,6,48
20,Success,46,27,1,9,37
20,Success,52,20,5,12,40
20,Success,49,26,4,11,38
20,Success,56,25,0,11,45
20,Success,58,24,0,8,50
20,Success,47,23,0,16,31
20,Success,41,38,0,12,29
20,Success,41,30,8,17,24
20,Success,42,33,0,13,29
20,Success,48,24,14,8,40
20,Success,57,14,3,16,41
20,Success,41,28,6,16,25
20,Success,53,26,0,11,42
20,Success,46,33,0,10,36
20,Success,50,20,6,13,37
20,Success,42,37,0,11,31
20,Success,47,26,0,14,33
20,Success,45,30,0,14,31
20,Success,47,29,3,12,35
20,Success,53,24,0,7,46
20,Success,51,21,8,13,38
20,Success,46,21,14,9,37
20,Success,53,26,0,10,43
20,Success,51,21,1,10,41
20,Success,51,31,0,6,45
20,Success,47,29,0,12,35
20,Success,52,32,0,6,46
20,Fail,38,37,0,19,19
20,Success,48,26,2,13,35
20,Success,50,21,5,12,38
20,Success,49,28,0,15,34
20,Success,52,30,0,11,41
20,Success,49,24,5,13,36
20,Success,47,33,0,9,38
20,Success,41,39,0,13,28
20,Success,57,17,0,8,49
20,Success,52,18,4,14,38
20,Success,54,25,0,10,44
20,Success,48,24,7,9,39
20,Success,46,28,0,17,29
20,Success,43,32,0,13,30
20,Success,44,32,8,8,36
20,Success,49,23,0,16,33
20,Success,47,33,0,7,40
20,Success,47,24,2,15,32
20,Success,49,20,5,12,37
20,Success,48,24,0,19,29
20,Success,51,26,0,12,39
20,Success,49,26,2,12,37
20,Success,44,34,0,18,26
20,Success,51,28,4,6,45
20,Success,52,20,0,17,35
20,Success,44,27,3,13,31
20,Success,48,30,0,12,36
20,Success,45,35,0,8,37
20,Success,52,23,5,7,45
20,Success,51,25,1,12,39
20,Success,43,37,0,8,35
20,Success,45,28,0,13,32
20,Success,50,27,0,12,38
20,Success,59,23,0,10,49
20,Success,53,17,5,14,39
20,Success,48,23,2,17,31
20,Success,45,39,0,8,37
20,Success,43,31,0,15,28
20,Success,50,24,0,13,37
20,Success,46,29,0,14,32
20,Fail,36,38,0,18,18
20,Success,44,35,0,12,32
20,Success,46,30,0,14,32
20,Success,57,24,0,7,50
20,Success,45,32,5,12,33
20,Success,54,24,0,13,41
20,Success,43,28,0,18,25
20,Success,42,28,1,18,24
20,Success,51,24,0,15,36
20,Success,42,38,0,12,30
20,Success,52,21,10,8,44
20,Success,46,38,0,10,36
20,Success,51,18,2,18,33
20,Success,54,25,0,10,44
20,Success,42,30,0,17,25
20,Success,41,33,0,14,27
20,Success,58,25,0,6,52
20,Success,42,26,1,15,27
20,Success,46,27,5,8,38
20,Success,45,34,0,11,34
20,Success,52,20,0,10,42
20,Success,58,24,0,9,49
20,Success,44,29,2,14,30
20,Success,50,22,7,10,40
20,Success,46,28,0,16,30
20,Success,49,18,5,14,35
20,Success,55,25,4,10,45
20,Success,56,21,0,10,46
20,Success,45,28,0,17,28
20,Success,47,27,0,15,32
20,Success,46,40,0,7,39
20,Success,47,29,2,14,33
20,Success,40,28,5,17,23
20,Success,53,26,0,11,42
20,Success,41,33,2,15,26
20,Success,54,24,0,12,42
20,Success,49,25,3,15,34
20,Success,48,28,0,10,38
20,Success,49,25,7,11,38
20,Success,53,19,2,14,39
20,Success,44,40,0,5,39
20,Success,47,20,8,16,31
20,Success,52,20,0,12,40
20,Success,48,35,0,8,40
20,Success,43,30,4,13,30
20,Success,43,23,7,18,25
20,Success,44,33,0,14,30
20,Success,46,23,6,16,30
20,Success,50,18,0,18,32
20,Success,49,25,11,11,38
20,Success,44,29,0,15,29
20,Success,46,26,5,14,32
20,Success,55,18,5,8,47
20,Success,54,30,0,11,43
20,Success,47,25,0,18,29
20,Success,46,27,4,12,34
20,Success,44,33,1,11,33
20,Success,46,30,0,16,30
20,Success,46,30,2,13,33
20,Success,52,23,1,14,38
20,Success,47,33,0,10,37
20,Success,47,29,1,9,38
20,Success,53,20,10,10,43
20,Success,49,23,4,11,38
20,Success,48,26,1,12,36
20,Success,54,29,0,8,46
20,Success,58,25,0,9,49
20,Success,46,31,0,12,34
20,Success,48,16,5,20,28
20,Success,50,28,0,12,38
20,Success,53,28,0,9,44
20,Success,45,30,0,16,29
20,Success,40,34,0,15,25
20,Success,40,31,6,12,28
20,Success,47,30,0,12,35
20,Success,53,27,0,12,41
20,Success,46,30,5,10,36
20,Success,50,30,5,10,40
20,Success,49,31,0,10,39
20,Success,45,31,3,9,36
20,Success,53,21,0,12,41
20,Success,51,21,5,12,39
20,Success,50,24,1,9,41
20,Success,56,21,0,14,42
20,Success,51,23,2,15,36
20,Success,44,30,2,13,31
20,Success,43,26,0,18,25
20,Success,48,26,1,17,31
20,Success,55,21,0,13,42
20,Success,53,23,0,15,38
20,Success,53,27,0,11,42
20,Success,39,35,0,12,27
20,Success,45,27,1,15,30
20,Success,57,24,0,6,51
20,Success,41,28,3,16,25
20,Success,48,31,0,11,37
20,Success,51,22,0,12,39
20,Success,45,32,0,14,31
20,Success,53,21,0,13,40
20,Success,45,28,0,12,33
20,Success,45,32,1,10,35
20,Success,38,32,3,14,24
20,Success,55,21,0,10,45
20,Success,46,30,0,11,35
20,Success,53,27,0,8,45
20,Success,47,29,0,11,36
20,Success,37,40,1,12,25
20,Success,54,23,0,9,45
20,Success,51,27,0,13,38
20,Success,44,26,1,17,27
20,Success,46,21,1,18,28
20,Success,47,24,0,15,32
20,Success,53,24,0,12,41
20,Success,46,22,1,16,30
20,Success,49,23,0,16,33
20,Success,56,22,2,7,49
20,Success,51,23,0,16,35
20,Success,39,30,0,19,20
20,Success,48,25,0,15,33
20,Success,45,30,0,10,35
20,Success,51,23,0,13,38
20,Success,46,31,0,13,33
20,Success,47,32,0,8,39
20,Success,50,25,0,14,36
20,Success,43,25,11,13,30
20,Success,51,20,0,13,38
20,Success,49,25,0,11,38
20,Success,50,20,4,16,34
20,Success,52,20,1,15,37
20,Success,51,24,0,12,39
20,Success,43,26,10,14,29
20,Success,47,28,0,16,31
20,Success,57,18,4,12,45
20,Success,64,21,2,4,60
20,Success,56,20,0,11,45
20,Success,49,31,0,11,38
20,Success,48,29,6,8,40
20,Success,47,34,0,8,39
20,Success,45,26,4,14,31
20,Success,42,36,0,13,29
20,Success,52,23,0,14,38
20,Success,52,25,4,6,46
20,Success,50,23,0,13,37
20,Success,54,23,0,10,44
20,Success,45,40,0,7,38
20,Success,45,28,0,15,30
20,Success,48,18,1,23,25
20,Success,41,30,3,14,27
20,Success,40,39,0,13,27
20,Success,46,26,0,19,27
20,Success,44,30,6,13,31
20,Success,48,31,0,9,39
20,Success,44,31,0,13,31
20,Success,53,19,6,12,41
20,Success,51,22,6,14,37
20,Success,53,32,0,6,47
20,Success,45,33,0,9,36
20,Success,48,22,7,16,32
20,Success,49,34,0,7,42
20,Success,45,35,0,11,34
20,Success,50,18,4,15,35
20,Success,51,32,0,8,43
20,Success,57,22,3,7,50
20,Success,46,28,0,16,30
20,Success,50,27,2,9,41
20,Success,59,18,0,9,50
20,Success,48,34,0,12,36
20,Success,52,28,0,8,44
20,Success,59,22,0,9,50
20,Success,48,30,4,11,37
20,Success,43,30,0,15,28
20,Success,52,28,0,12,40
20,Success,54,25,0,9,45
20,Success,37,29,15,11,26
20,Success,41,27,0,20,21
20,Success,49,30,0,11,38
20,Success,43,27,0,20,23
20,Success,48,27,0,12,36
20,Success,47,24,5,11,36
20,Success,47,17,5,16,31
20,Success,49,26,0,11,38
20,Success,47,25,8,12,35
20,Fail,36,33,0,22,14
20,Success,52,18,4,13,39
20,Success,53,30,0,10,43
20,Success,43,36,0,12,31
20,Success,47,21,6,14,33
20,Success,53,19,0,14,39
20,Success,60,18,6,6,54
20,Success,48,28,1,13,35
20,Success,50,26,1,11,39
20,Success,50,19,2,23,27
20,Success,42,28,9,14,28
20,Success,46,35,0,13,33
20,Success,49,29,1,8,41
20,Success,48,35,0,8,40
20,Success,51,22,7,14,37
20,Success,42,26,7,14,28
20,Success,53,18,1,14,39
20,Success,49,23,1,14,35
20,Success,54,22,1,10,44
20,Success,48,28,3,12,36
20,Success,53,32,0,5,48
20,Success,48,24,4,14,34
20,Success,56,21,1,11,45
20,Success,46,28,4,13,33
20,Success,53,18,1,17,36
20,Success,43,25,7,17,26
20,Success,39,31,0,18,21
20,Success,51,23,4,10,41
20,Success,53,20,0,13,40
20,Success,49,21,0,16,33
20,Success,45,30,0,15,30
20,Success,41,34,0,13,28
20,Success,53,19,7,10,43
20,Success,46,25,5,14,32
20,Success,41,33,6,13,28
20,Success,48,19,9,14,34
20,Success,44,29,8,12,32
20,Success,41,27,1,17,24
20,Success,49,27,6,9,40
20,Success,48,20,2,19,29
20,Success,41,35,0,15,26
20,Success,46,30,0,15,31
20,Success,57,19,0,9,48
20,Success,44,32,0,13,31
20,Success,47,25,5,14,33
20,Success,42,25,9,13,29
20,Success,52,28,0,8,44
20,Success,43,29,7,13,30
20,Success,38,36,0,18,20
20,Success,42,30,1,12,30
20,Success,55,16,0,18,37
20,Success,52,29,0,9,43
20,Success,40,28,2,16,24
20,Success,48,34,0,15,33
20,Success,46,25,4,16,30
20,Success,44,33,0,14,30
20,Success,47,33,0,11,36
20,Success,48,25,0,13,35
20,Success,50,22,0,12,38
20,Success,44,24,5,15,29
20,Success,50,25,2,8,42
20,Success,55,22,0,11,44
20,Success,45,27,4,16,29
20,Success,46,25,7,11,35
20,Success,52,26,1,11,41
20,Success,45,30,0,16,29
20,Success,45,26,7,11,34
20,Success,46,28,0,14,32
20,Success,52,30,0,7,45
20,Success,47,21,10,13,34
20,Success,45,28,6,14,31
20,Success,46,28,4,12,34
20,Success,39,28,10,18,21
20,Success,50,22,3,13,37
20,Success,51,22,2,13,38
20,Success,46,22,6,11,35
20,Success,50,21,1,12,38
20,Success,45,27,6,15,30
20,Success,51,27,6,10,41
20,Success,41,37,0,9,32
20,Success,46,23,2,20,26
20,Success,45,30,0,11,34
20,Success,50,28,0,7,43
20,Success,52,26,1,10,42
20,Success,48,26,0,17,31
20,Success,57,18,2,11,46
20,Success,52,26,1,10,42
20,Success,48,31,0,11,37
20,Success,52,23,3,10,42
20,Success,52,28,0,11,41
20,Success,51,21,0,15,36
20,Success,49,29,0,11,38
20,Success,49,32,0,9,40
20,Success,47,37,0,9,38
20,Success,45,27,0,16,29
20,Success,45,30,0,12,33
20,Success,51,23,1,10,41
20,Success,47,31,0,13,34
20,Success,43,28,8,14,29
20,Success,41,24,9,17,24
20,Success,50,25,3,10,40
20,Success,49,29,1,7,42
20,Success,51,17,2,16,35
20,Success,48,26,0,14,34
20,Success,47,27,9,9,38
20,Success,47,38,0,9,38
20,Success,47,34,0,13,34
20,Success,52,25,1,12,40
20,Success,48,33,0,12,36
20,Fail,40,22,8,21,19
20,Success,58,21,6,9,49
20,Success,44,33,0,13,31
20,Success,43,25,9,16,27
20,Success,43,26,4,17,26
20,Success,57,26,0,9,48
20,Success,51,23,0,12,39
20,Success,44,35,0,12,32
20,Success,46,26,1,15,31
20,Success,47,26,0,14,33
20,Success,52,24,0,13,39
20,Success,47,32,0,12,35
20,Success,47,28,5,9,38
20,Success,52,20,5,16,36
20,Success,51,26,0,12,39
20,Success,49,32,0,9,40
20,Success,48,28,0,14,34
20,Success,51,27,2,10,41
20,Success,45,34,0,10,35
20,Success,53,22,2,10,43
20,Success,48,26,6,9,39
20,Success,49,28,0,12,37
20,Success,50,23,3,15,35
20,Success,44,29,5,16,28
20,Success,56,24,3,6,50
20,Success,46,25,4,14,32
20,Success,48,37,0,7,41
20,Success,60,21,0,5,55
20,Success,47,24,1,13,34
20,Success,49,20,0,20,29
20,Success,55,24,0,9,46
20,Success,52,18,3,15,37
20,Success,43,27,4,10,33
20,Success,47,25,0,13,34
20,Success,46,33,0,11,35
20,Success,47,35,0,10,37
20,Success,44,27,3,17,27
20,Fail,42,19,2,24,18
20,Success,48,30,0,13,35
20,Success,44,27,9,13,31
20,Success,50,27,0,14,36
20,Success,47,21,7,13,34
20,Success,42,26,13,10,32
20,Success,43,25,0,20,23
20,Success,44,35,0,13,31
20,Success,48,27,0,14,34
20,Success,51,25,0,10,41
20,Success,49,18,6,17,32
20,Success,51,25,7,10,41
20,Success,47,19,6,18,29
20,Success,44,29,1,13,31
20,Success,52,28,0,10,42
20,Success,44,24,4,15,29
20,Success,40,38,0,11,29
20,Success,49,25,6,10,39
20,Success,51,27,0,9,42
20,Success,50,30,4,8,42
20,Success,47,26,3,13,34
20,Success,43,29,2,17,26
20,Success,51,25,0,15,36
20,Success,46,29,0,17,29
20,Success,48,27,2,16,32
20,Success,34,35,10,12,22
20,Success,49,30,0,12,37
20,Success,57,23,0,8,49
20,Success,43,24,4,15,28
20,Success,45,38,0,12,33
20,Success,44,39,0,10,34
20,Success,53,22,7,7,46
20,Success,49,30,2,12,37
20,Success,49,27,3,13,36
20,Success,52,25,0,12,40
20,Success,50,24,0,15,35
20,Success,49,22,0,16,33
20,Success,48,29,0,11,37
20,Success,45,36,0,9,36
20,Success,44,31,4,11,33
20,Success,48,26,0,14,34
20,Success,45,28,0,13,32
20,Success,52,23,0,12,40
20,Success,50,19,1,20,30
20,Fail,37,31,0,24,13
20,Success,42,33,0,18,24
20,Success,48,29,1,11,37
20,Success,52,19,0,17,35
20,Success,47,30,0,15,32
20,Success,45,28,2,14,31
20,Success,41,42,0,10,31
20,Success,43,23,3,17,26
20,Success,47,21,6,13,34
20,Success,40,31,2,16,24
20,Success,46,35,0,10,36
20,Success,55,19,0,16,39
20,Success,51,24,0,15,36
20,Success,49,23,0,14,35
20,Success,47,25,5,15,32
20,Success,51,26,2,11,40
20,Success,48,24,2,16,32
20,Success,50,32,0,8,42
20,Success,46,28,3,16,30
20,Success,38,31,10,13,25
20,Success,47,22,1,18,29
20,Success,50,26,2,6,44
20,Success,44,31,0,14,30
20,Success,47,18,8,15,32
20,Success,41,28,7,14,27
20,Success,49,36,0,6,43
20,Success,52,25,5,9,43
20,Success,43,32,0,9,34
20,Success,48,34,0,10,38
20,Success,51,22,6,11,40
20,Success,54,17,6,12,42
20,Success,44,27,4,13,31
20,Success,41,28,0,17,24
20,Success,52,22,4,10,42
20,Success,40,31,0,17,23
20,Success,49,23,0,14,35
20,Success,50,29,0,9,41
20,Success,51,25,0,11,40
20,Success,43,36,0,13,30
20,Success,45,32,0,14,31
20,Success,44,34,0,9,35
20,Success,50,27,1,10,40
20,Success,46,35,0,11,35
20,Success,52,31,0,9,43
20,Success,49,27,0,13,36
20,Success,48,27,5,12,36
20,Success,42,31,0,19,23
20,Success,41,42,0,12,29
20,Success,61,20,0,10,51
20,Success,48,27,0,17,31
20,Success,51,22,1,14,37
20,Success,50,31,0,8,42
20,Success,47,25,3,17,30
20,Success,42,32,0,16,26
20,Success,48,27,8,11,37
20,Success,45,26,4,15,30
20,Success,46,25,3,15,31
20,Success,61,17,0,11,50
20,Success,59,18,3,9,50
20,Success,42,31,0,20,22
20,Success,51,24,3,11,40
20,Success,53,22,2,10,43
20,Success,41,30,3,14,27
20,Success,54,20,6,9,45
20,Success,50,29,4,8,42
20,Success,50,29,0,12,38
20,Success,51,29,0,14,37
20,Success,47,25,1,17,30
20,Success,50,28,0,11,39
20,Success,44,32,0,13,31
20,Success,50,25,1,10,40
20,Success,40,32,6,13,27
20,Success,55,21,2,6,49
20,Success,45,22,4,17,28
20,Success,47,27,2,12,35
20,Success,51,21,5,8,43
20,Success,46,30,0,14,32
20,Success,51,21,7,13,38
20,Success,54,22,0,9,45
20,Success,39,30,3,19,20
20,Success,50,24,0,14,36
20,Success,44,34,6,8,36
20,Success,52,23,5,12,40
20,Success,48,25,0,15,33
20,Fail,35,37,0,22,13
20,Success,51,26,1,13,38
20,Success,53,22,0,10,43
20,Success,43,23,6,13,30
20,Success,54,25,0,10,44
20,Success,46,34,1,10,36
20,Success,43,30,0,17,26
20,Success,54,21,0,13,41
20,Success,49,25,1,9,40
20,Success,47,34,0,6,41
20,Success,46,28,0,13,33
20,Fail,39,23,5,23,16
20,Success,47,25,2,14,33
20,Success,49,25,0,15,34
20,Success,46,26,6,13,33
20,Success,54,25,0,10,44
20,Success,46,34,0,10,36
20,Success,44,24,1,16,28
20,Success,52,31,0,10,42
20,Success,43,34,0,11,32
20,Success,51,26,0,11,40
20,Success,49,24,11,12,37
20,Success,54,23,1,6,48
20,Success,55,29,0,10,45
20,Success,49,26,7,11,38
20,Success,50,27,0,11,39
20,Success,54,19,0,16,38
20,Success,50,22,6,10,40
20,Success,51,27,0,10,41
20,Success,55,24,5,8,47
20,Success,47,24,5,16,31
20,Success,57,25,0,6,51
20,Success,63,18,0,9,54
20,Fail,42,23,0,25,17
20,Success,53,27,1,7,46
20,Success,43,28,0,17,26
20,Success,52,25,1,11,41
20,Success,41,23,2,21,20
20,Success,45,34,0,13,32
20,Success,52,21,8,13,39
20,Success,53,22,4,10,43
20,Success,50,31,0,7,43
20,Success,49,25,1,17,32
20,Success,54,20,0,13,41
20,Success,41,35,0,17,24
20,Success,51,33,0,9,42
20,Success,52,24,0,12,40
20,Success,51,27,0,11,40
20,Success,57,23,1,9,48
20,Success,45,32,0,14,31
20,Success,47,26,9,8,39
20,Success,49,26,0,13,36
20,Success,52,29,0,11,41
20,Success,48,27,0,16,32
20,Success,54,24,0,11,43
20,Success,53,27,0,12,41
20,Success,44,23,2,18,26
20,Success,51,22,0,14,37
20,Success,40,34,0,15,25
20,Success,50,28,0,10,40
20,Success,45,24,0,17,28
20,Success,58,23,1,7,51
20,Success,51,29,0,9,42
20,Success,46,16,11,20,26
20,Success,47,28,1,10,37
20,Success,49,22,1,17,32
20,Success,46,33,5,9,37
20,Success,49,27,3,11,38
20,Success,50,28,0,12,38
20,Success,46,33,0,10,36
20,Success,43,27,0,19,24
20,Success,51,20,0,17,34
20,Success,42,25,13,15,27
20,Success,45,27,6,14,31
20,Success,54,22,0,11,43
20,Success,51,19,2,13,38
20,Success,45,26,0,16,29
20,Success,52,26,1,7,45
20,Success,44,35,0,13,31
20,Success,49,27,0,12,37
20,Success,49,24,0,16,33
20,Success,46,20,10,13,33
20,Success,44,25,9,15,29
20,Success,44,34,0,12,32
20,Success,45,36,0,11,34
20,Success,47,32,3,9,38
20,Fail,40,26,0,22,18
20,Success,46,29,0,13,33
20,Success,52,21,15,9,43
20,Success,46,35,0,11,35
20,Success,39,39,0,15,24
20,Success,44,24,11,13,31
20,Success,46,25,1,15,31
20,Success,45,34,0,12,33
20,Success,42,20,6,19,23
20,Success,48,26,2,11,37
20,Success,62,16,3,10,52
20,Success,43,32,0,14,29
20,Success,50,24,5,12,38
20,Success,49,32,2,8,41
20,Success,51,26,2,12,39
20,Success,42,38,0,9,33
20,Success,41,31,0,16,25
20,Success,35,34,10,13,22
20,Success,48,28,1,13,35
20,Success,55,18,4,10,45
20,Success,47,31,4,9,38
20,Success,53,27,0,9,44
20,Success,48,31,0,11,37
20,Success,52,25,0,7,45
20,Success,52,19,1,15,37
20,Success,39,38,0,17,22
20,Success,45,25,5,14,31
20,Success,56,22,6,9,47
20,Success,51,29,0,10,41
20,Success,46,34,0,15,31
20,Success,50,28,0,12,38
20,Success,49,22,5,12,37
20,Success,47,22,7,14,33
20,Success,48,24,8,9,39
20,Success,42,29,3,19,23
20,Success,41,35,3,13,28
20,Success,45,27,7,13,32
20,Success,54,20,0,13,41
20,Success,47,31,3,12,35
20,Success,46,32,3,12,34
20,Success,44,29,0,12,32
20,Success,38,33,0,16,22
20,Success,45,23,8,14,31
20,Success,48,32,0,11,37
20,Success,42,36,0,14,28
20,Success,52,20,1,14,38
20,Success,43,31,2,11,32
20,Success,46,27,3,14,32
20,Success,45,33,0,10,35
20,Success,45,34,0,12,33
20,Success,50,20,0,20,30
20,Success,54,28,0,9,45
20,Success,58,21,0,12,46
20,Success,49,28,0,14,35
20,Success,52,28,0,11,41
20,Success,43,24,6,16,27
20,Success,51,28,0,12,39
20,Success,48,28,3,13,35
20,Success,60,17,1,10,50
20,Success,47,28,7,10,37
20,Success,48,32,7,7,41
20,Success,46,26,0,18,28
20,Success,47,32,0,12,35
20,Success,46,26,7,11,35
20,Success,42,34,0,8,34
20,Success,53,26,0,11,42
20,Success,43,29,3,11,32
20,Success,46,32,0,12,34
20,Success,46,28,4,9,37
20,Success,41,28,6,13,28
20,Success,47,34,0,8,39
20,Success,51,25,2,11,40
20,Success,50,31,0,11,39
20,Success,38,35,0,18,20
20,Success,48,31,0,11,37
20,Success,53,21,5,9,44
20,Success,44,28,9,13,31
20,Success,44,37,0,8,36
20,Success,51,24,2,12,39
20,Success,48,20,5,14,34
20,Success,50,26,3,13,37
20,Success,53,18,5,15,38
20,Success,58,14,1,16,42
20,Success,44,23,0,20,24
20,Success,49,28,0,9,40
20,Success,51,21,2,12,39
20,Success,52,22,0,15,37
20,Success,48,28,3,9,39
20,Success,48,28,0,15,33
20,Success,51,22,1,17,34
20,Success,50,25,0,12,38
20,Success,57,23,1,8,49
20,Success,54,22,0,13,41
20,Success,51,27,0,8,43
20,Success,40,30,0,19,21
20,Success,47,27,0,13,34
20,Success,52,23,10,10,42
20,Success,43,38,0,13,30
20,Success,40,29,11,13,27
20,Success,50,26,0,15,35
20,Success,55,21,1,10,45
20,Success,57,23,0,10,47
20,Success,50,21,2,14,36
20,Success,52,29,0,11,41
20,Success,53,26,0,9,44
20,Success,47,26,5,14,33
20,Success,49,22,5,12,37
20,Success,43,23,6,13,30
20,Success,43,33,0,14,29
20,Success,47,23,1,15,32
20,Success,50,32,0,11,39
20,Success,49,26,0,14,35
20,Success,46,34,0,11,35
20,Success,50,27,4,11,39
20,Success,47,27,5,12,35
20,Success,43,36,0,11,32
20,Success,46,29,0,13,33
20,Success,46,29,0,10,36
20,Success,48,31,0,11,37
20,Success,48,28,2,11,37
20,Success,52,26,1,10,42
20,Success,52,25,1,13,39
20,Success,44,25,7,10,34
20,Success,47,33,0,9,38
20,Success,51,23,1,12,39
20,Success,42,31,2,14,28
20,Success,49,22,0,17,32
20,Success,43,35,0,13,30
20,Success,47,25,7,12,35
20,Success,43,30,0,15,28
20,Success,48,28,5,11,37
20,Success,47,35,0,9,38
20,Success,42,29,11,11,31
20,Success,40,29,9,16,24
20,Fail,34,39,0,20,14
20,Success,54,25,0,5,49
20,Success,50,22,2,18,32
20,Success,40,28,9,13,27
20,Fail,34,40,0,19,15
20,Success,50,22,1,14,36
20,Success,51,26,5,8,43
20,Success,47,27,4,10,37
20,Success,41,23,8,19,22
20,Success,44,28,0,14,30
20,Success,46,33,0,13,33
20,Fail,40,27,0,24,16
20,Success,42,23,7,18,24
20,Success,58,23,2,7,51
20,Success,56,18,0,13,43
20,Success,53,24,0,11,42
20,Success,44,32,0,12,32
20,Success,45,36,0,10,35
20,Success,52,26,2,10,42
20,Fail,34,47,0,15,19
20,Success,47,30,0,14,33
20,Success,43,33,0,13,30
20,Success,51,25,0,14,37
20,Success,46,28,0,13,33
20,Success,52,27,0,9,43
20,Success,58,22,0,9,49
20,Success,38,28,10,18,20
20,Success,46,26,8,11,35
20,Success,45,35,0,12,33
20,Success,48,30,0,12,36
20,Success,45,30,0,8,37
20,Success,43,26,0,17,26
20,Success,47,27,0,13,34
20,Success,53,21,5,11,42
20,Success,50,24,4,13,37
20,Success,52,21,0,12,40
20,Success,48,30,0,16,32
20,Success,40,28,4,18,22
20,Success,54,13,6,15,39
20,Success,51,16,3,18,33
20,Success,58,20,0,11,47
20,Success,53,30,3,6,47
20,Fail,36,32,0,20,16
20,Success,54,20,0,12,42
20,Success,43,29,6,11,32
20,Fail,38,29,1,22,16
20,Success,45,36,0,11,34
20,Fail,40,28,0,22,18
20,Success,50,30,2,5,45
20,Success,46,30,0,11,35
20,Success,48,28,0,12,36
20,Success,45,22,11,15,30
20,Success,53,20,4,9,44
20,Success,45,25,2,14,31
20,Success,47,24,0,17,30
20,Success,47,27,6,10,37
20,Success,48,26,0,12,36
20,Success,47,21,8,14,33
20,Success,43,31,6,8,35
20,Success,48,26,3,11,37
20,Success,50,26,2,10,40
20,Success,45,39,0,5,40
20,Success,42,36,0,15,27
20,Success,45,21,2,18,27
20,Success,52,24,0,12,40
20,Success,49,26,0,10,39
20,Success,52,23,0,15,37
20,Success,40,35,2,12,28
20,Success,53,19,0,13,40
20,Success,63,20,0,5,58
20,Success,45,37,0,10,35
20,Success,44,34,0,15,29
20,Success,50,23,0,14,36
20,Success,44,29,5,15,29
20,Success,45,25,2,17,28
20,Success,42,35,0,15,27
20,Success,44,32,0,13,31
20,Success,48,24,3,15,33
20,Success,50,24,0,10,40
20,Success,51,23,7,11,40
20,Success,53,32,0,7,46
20,Success,43,24,4,16,27
20,Success,50,24,3,16,34
20,Success,54,21,2,11,43
20,Success,51,26,0,13,38
20,Success,53,27,4,10,43
20,Success,47,25,0,18,29
20,Success,40,31,2,14,26
20,Success,46,24,1,14,32
20,Success,49,20,1,14,35
20,Success,45,29,0,11,34
20,Success,41,31,0,16,25
20,Success,41,28,11,16,25
20,Success,47,27,7,11,36
20,Success,48,23,2,14,34
20,Success,52,26,2,13,39
20,Success,48,29,0,11,37
20,Success,52,20,2,14,38
20,Success,47,30,0,12,35
20,Success,48,21,4,17,31
20,Success,48,35,0,13,35
20,Success,47,26,0,14,33
20,Success,44,30,0,13,31
20,Success,52,25,0,11,41
20,Success,48,24,2,16,32
20,Success,44,28,0,16,28
20,Success,48,25,3,16,32
20,Success,49,24,6,12,37
20,Success,58,21,0,8,50
20,Success,50,25,1,13,37
20,Success,50,28,1,9,41
20,Success,38,31,7,16,22
20,Success,59,19,2,7,52
20,Success,47,20,12,12,35
20,Success,43,33,4,10,33
20,Success,41,32,3,10,31
20,Success,49,29,0,12,37
20,Success,49,24,2,12,37
20,Success,50,24,2,14,36
20,Success,44,29,1,17,27
20,Success,43,37,0,10,33
20,Success,47,29,0,12,35
20,Success,41,35,0,13,28
20,Success,44,30,0,16,28
20,Success,53,25,3,11,42
20,Success,49,22,2,15,34
20,Fail,38,32,3,19,19
20,Success,43,25,3,15,28
20,Success,46,26,0,17,29
20,Success,42,32,9,9,33
20,Success,51,23,2,15,36
20,Success,46,32,0,12,34
20,Success,59,20,0,10,49
20,Success,48,24,0,15,33
20,Success,45,30,1,15,30
20,Success,44,31,3,12,32
20,Success,45,29,3,17,28
20,Success,44,23,4,16,28
20,Success,35,35,8,8,27
20,Success,46,30,5,7,39
20,Success,48,31,2,7,41
20,Success,51,28,1,8,43
20,Success,42,28,4,13,29
20,Success,43,34,3,10,33
20,Success,43,35,0,18,25
20,Success,45,30,1,13,32
20,Success,51,27,6,7,44
20,Success,51,28,0,13,38
20,Success,51,20,2,14,37
20,Success,48,28,0,12,36
20,Success,39,38,0,15,24
20,Success,46,28,5,11,35
20,Success,48,27,10,8,40
20,Success,46,29,0,15,31
20,Success,51,30,0,13,38
20,Success,53,28,0,7,46
20,Success,44,25,3,13,31
20,Success,42,28,0,19,23
20,Success,47,35,0,13,34
20,Success,46,23,3,15,31
20,Success,49,33,0,8,41
20,Success,50,28,0,15,35
20,Success,44,27,0,17,27
20,Success,48,33,0,13,35
20,Success,41,27,5,17,24
20,Success,55,22,4,11,44
20,Success,50,26,0,15,35
20,Success,52,27,0,12,40
20,Success,51,21,0,17,34
20,Success,54,30,0,11,43
20,Success,51,28,0,12,39
20,Success,48,28,0,12,36
20,Success,52,22,3,11,41
20,Success,51,25,2,10,41
20,Success,50,28,0,12,38
20,Success,45,30,0,15,30
20,Success,43,39,0,11,32
20,Success,49,30,0,8,41
20,Success,46,30,0,10,36
20,Success,59,21,1,5,54
20,Success,41,38,0,13,28
20,Success,46,25,4,16,30
20,Success,57,15,7,10,47
20,Success,48,30,0,8,40
20,Success,54,23,4,7,47
20,Success,41,22,5,19,22
20,Success,48,18,2,17,31
20,Success,52,28,1,9,43
20,Success,52,24,0,10,42
20,Success,50,23,0,16,34
20,Success,51,29,0,7,44
20,Success,43,32,11,9,34
20,Success,47,22,8,15,32
20,Success,51,22,0,14,37
20,Success,51,26,0,13,38
20,Success,49,29,0,12,37
20,Success,53,26,0,11,42
20,Success,46,24,0,21,25
20,Success,47,19,1,17,30
20,Success,50,21,0,16,34
20,Success,47,28,0,18,29
20,Success,54,15,3,16,38
20,Success,49,23,0,16,33
20,Success,45,33,0,13,32
20,Success,53,20,3,11,42
20,Success,42,35,0,13,29
20,Success,52,13,1,23,29
20,Success,57,20,2,7,50
20,Success,53,19,4,11,42
20,Success,54,24,0,8,46
20,Success,44,27,6,13,31
20,Success,46,26,0,17,29
20,Success,45,26,0,19,26
20,Success,50,22,0,15,35
20,Success,40,38,0,11,29
20,Success,48,28,4,10,38
20,Success,44,29,3,12,32
20,Success,45,32,1,11,34
20,Success,56,20,10,4,52
20,Success,47,29,0,14,33
20,Success,50,27,8,5,45
20,Success,46,32,0,12,34
20,Success,57,20,0,14,43
20,Success,41,36,0,17,24
20,Success,47,25,3,14,33
20,Success,37,36,0,17,20
20,Success,49,31,0,10,39
20,Success,49,25,7,9,40
20,Success,45,26,1,15,30
20,Success,48,30,0,9,39
20,Success,50,22,4,13,37
20,Success,47,20,6,16,31
20,Success,49,17,4,17,32
20,Success,46,31,3,10,36
20,Success,49,21,2,14,35
20,Success,45,25,12,10,35
20,Success,51,20,3,14,37
20,Success,50,27,0,12,38
20,Success,40,41,0,13,27
20,Success,41,33,0,16,25
20,Success,44,31,2,9,35
20,Success,53,20,1,12,41
20,Success,51,25,0,13,38
20,Success,47,32,5,9,38
20,Success,39,40,0,12,27
20,Success,51,28,2,8,43
20,Success,53,22,0,13,40
20,Success,47,25,4,14,33
20,Success,44,41,0,8,36
20,Success,50,27,0,12,38
20,Success,47,27,7,12,35
20,Success,47,24,3,13,34
20,Success,55,22,0,7,48
20,Success,41,31,2,17,24
20,Success,49,34,0,10,39
20,Success,45,36,0,10,35
20,Success,41,32,0,19,22
20,Success,43,32,0,17,26
20,Success,55,24,0,10,45
20,Success,49,22,12,10,39
20,Success,50,22,0,14,36
20,Success,45,24,3,15,30
20,Success,49,30,6,6,43
20,Success,46,30,5,11,35
20,Success,50,30,0,9,41
20,Success,51,22,2,14,37
20,Success,49,28,0,13,36
20,Success,46,28,7,10,36
20,Success,58,19,0,12,46
20,Success,45,29,0,16,29
20,Success,44,26,0,18,26
20,Success,50,23,1,11,39
20,Success,49,23,8,13,36
20,Success,51,23,0,13,38
20,Success,52,21,0,14,38
20,Success,47,22,11,10,37
20,Success,45,34,0,11,34
20,Success,53,31,0,5,48
20,Success,46,30,5,12,34
20,Success,50,27,0,10,40
20,Success,45,32,0,12,33
20,Success,47,34,0,7,40
20,Success,49,20,2,14,35
20,Success,45,38,0,9,36
20,Success,53,21,0,12,41
20,Success,51,29,0,11,40
20,Success,45,21,0,22,23
20,Success,52,25,0,12,40
20,Success,47,23,5,17,30
20,Success,47,24,9,10,37
20,Success,47,28,1,15,32
20,Success,46,29,0,13,33
20,Success,43,26,5,14,29
20,Success,47,26,4,13,34
20,Success,52,27,1,11,41
20,Success,45,34,0,10,35
20,Success,43,29,2,15,28
20,Success,39,33,9,11,28
20,Success,52,24,1,14,38
20,Success,49,25,5,11,38
20,Success,51,23,3,12,39
20,Success,48,28,0,14,34
20,Success,49,29,0,12,37
20,Success,48,20,8,13,35
20,Success,41,32,0,15,26
20,Success,49,28,0,9,40
20,Success,45,29,1,15,30
20,Success,53,20,2,14,39
20,Success,48,24,10,10,38
20,Success,46,28,0,19,27
20,Success,44,34,0,10,34
20,Success,53,29,0,13,40
20,Success,47,33,0,9,38
20,Success,47,28,0,12,35
20,Success,43,26,3,15,28
20,Success,43,38,0,9,34
20,Success,52,22,3,16,36
20,Success,42,32,0,14,28
20,Success,52,26,2,9,43
20,Success,44,27,0,14,30
20,Success,48,25,0,20,28
20,Success,41,42,0,11,30
20,Success,49,26,0,10,39
20,Success,45,32,0,14,31
20,Success,53,18,1,15,38
20,Success,44,27,3,15,29
20,Success,45,33,0,13,32
20,Success,43,27,2,16,27
20,Success,42,24,8,14,28
20,Success,45,27,0,14,31
20,Success,48,27,1,16,32
20,Success,51,28,0,12,39
20,Success,46,33,0,7,39
20,Success,51,21,3,15,36
20,Success,46,27,7,12,34
20,Success,46,31,0,12,34
20,Success,42,27,0,20,22
20,Success,49,23,6,10,39
20,Success,46,32,4,9,37
20,Success,49,30,0,13,36
20,Success,51,29,1,8,43
20,Success,51,29,0,12,39
20,Success,55,25,0,9,46
20,Success,45,29,0,16,29
20,Success,56,17,5,8,48
20,Success,53,21,0,12,41
20,Success,43,25,2,17,26
20,Success,46,23,9,11,35
20,Success,51,22,8,11,40
20,Success,39,31,3,18,21
20,Success,47,31,3,10,37
20,Success,49,32,0,9,40
20,Success,41,24,9,15,26
20,Success,50,26,0,14,36
20,Success,40,33,2,13,27
20,Success,51,30,0,8,43
20,Success,48,26,0,18,30
20,Success,45,32,0,14,31
20,Success,46,33,4,6,40
20,Success,52,23,0,15,37
20,Success,59,24,0,4,55
20,Success,52,25,0,13,39
20,Success,57,23,0,10,47
20,Success,53,24,0,11,42
20,Success,40,27,12,13,27
20,Success,49,27,0,14,35
20,Success,46,26,2,17,29
20,Success,43,40,0,10,33
20,Success,51,28,0,12,39
20,Success,49,29,0,10,39
20,Success,44,26,6,14,30
20,Success,49,31,0,10,39
20,Success,48,29,0,9,39
20,Success,43,33,0,13,30
20,Fail,37,28,11,18,19
20,Success,47,28,0,17,30
20,Success,47,26,2,14,33
20,Success,50,25,4,11,39
20,Success,42,36,0,12,30
20,Success,43,28,0,18,25
20,Success,55,14,0,18,37
20,Success,44,35,2,11,33
20,Success,55,18,1,11,44
20,Success,50,22,0,16,34
20,Success,56,26,0,7,49
20,Success,48,22,0,15,33
20,Success,49,22,8,14,35
20,Success,49,25,0,12,37
20,Success,46,32,0,16,30
20,Success,47,34,0,14,33
20,Success,47,32,0,10,37
20,Success,58,22,0,5,53
20,Success,45,31,2,12,33
20,Success,45,25,0,17,28
20,Success,46,33,0,12,34
20,Success,45,31,5,5,40
20,Fail,36,40,0,17,19
20,Success,57,19,1,9,48
20,Success,49,24,0,16,33
20,Success,44,34,0,16,28
20,Success,53,26,0,9,44
20,Success,43,31,1,13,30
20,Success,43,32,4,13,30
20,Success,48,27,3,11,37
20,Success,49,19,9,14,35
20,Success,46,32,0,15,31
20,Success,47,26,0,11,36
20,Success,47,21,2,20,27
20,Success,51,23,1,16,35
20,Success,45,37,0,11,34
20,Success,47,30,0,14,33
20,Success,42,30,0,12,30
20,Success,53,18,4,13,40
20,Success,48,18,4,18,30
20,Success,48,22,8,14,34
20,Success,44,31,0,18,26
20,Success,54,21,3,12,42
20,Success,48,25,2,14,34
20,Success,49,31,3,6,43
20,Success,47,17,6,18,29
20,Success,54,24,0,4,50
20,Success,49,36,0,8,41
20,Success,57,20,0,14,43
20,Success,43,42,0,9,34
20,Success,52,19,7,13,39
20,Success,46,30,3,11,35
20,Success,55,29,0,7,48
20,Success,45,30,0,12,33
20,Success,53,21,10,9,44
20,Success,45,31,0,11,34
20,Success,51,27,0,11,40
20,Success,48,23,6,14,34
20,Success,48,22,0,17,31
20,Success,45,29,0,19,26
20,Success,49,36,0,9,40
20,Success,45,26,4,12,33
20,Success,42,28,9,11,31
20,Success,55,18,3,15,40
20,Success,50,23,0,14,36
20,Fail,38,37,0,20,18
20,Success,49,22,6,13,36
20,Success,40,35,7,10,30
20,Success,50,24,0,12,38
20,Success,50,33,0,7,43
20,Success,42,33,0,19,23
20,Success,47,28,0,14,33
20,Success,46,25,0,16,30
20,Success,43,36,0,9,34
20,Success,48,37,0,6,42
20,Success,45,29,6,11,34
20,Success,50,29,0,9,41
20,Success,50,28,0,14,36
20,Success,49,27,3,8,41
20,Success,48,30,0,13,35
20,Success,51,26,0,11,40
20,Success,40,35,0,9,31
20,Success,47,24,1,15,32
20,Success,47,27,0,14,33
20,Success,54,24,3,7,47
20,Success,49,27,0,12,37
20,Success,45,24,8,12,33
20,Success,60,19,0,13,47
20,Success,52,21,2,11,41
20,Success,40,31,0,13,27
20,Success,55,20,3,14,41
20,Success,48,31,0,10,38
20,Success,45,31,0,13,32
20,Fail,33,30,7,20,13
20,Success,49,30,0,6,43
20,Success,45,28,5,15,30
20,Success,44,31,2,13,31
20,Success,50,27,3,9,41
20,Success,44,28,6,14,30
20,Success,49,22,3,14,35
20,Success,48,26,2,14,34
20,Success,45,27,0,17,28
20,Success,40,34,0,15,25
20,Success,60,16,2,11,49
20,Success,45,27,1,18,27
20,Success,48,29,5,9,39
20,Success,42,36,0,16,26
20,Success,51,27,0,12,39
20,Success,44,36,0,14,30
20,Success,46,21,4,16,30
20,Success,46,25,0,14,32
20,Success,42,32,0,13,29
20,Success,50,19,10,12,38
20,Success,50,28,0,9,41
20,Success,49,26,4,14,35
20,Success,57,24,0,10,47
20,Success,51,22,5,11,40
20,Success,52,26,0,11,41
20,Success,50,33,0,9,41
20,Success,44,24,1,15,29
20,Success,41,28,2,19,22
20,Success,54,19,3,15,39
20,Success,40,29,6,17,23
20,Success,49,27,2,10,39
20,Success,50,31,0,9,41
20,Success,46,21,8,11,35
20,Success,52,28,2,10,42
20,Success,46,32,2,12,34
20,Success,51,29,0,12,39
20,Success,52,30,0,8,44
20,Success,38,35,6,13,25
20,Success,52,27,0,11,41
20,Success,40,37,0,15,25
20,Success,48,30,0,13,35
20,Success,51,26,0,13,38
20,Success,57,17,1,15,42
20,Success,43,37,0,14,29
20,Success,54,27,3,8,46
20,Success,46,31,0,14,32
20,Success,47,31,0,12,35
20,Success,52,21,0,15,37
20,Success,57,25,0,6,51
20,Success,46,28,0,13,33
20,Success,53,30,0,10,43
20,Success,48,33,0,6,42
20,Success,50,26,0,7,43
20,Success,44,30,0,17,27
20,Success,52,26,0,10,42
20,Success,55,27,0,11,44
20,Success,48,29,0,8,40
20,Success,52,24,1,10,42
20,Success,50,25,0,15,35
20,Success,45,32,4,11,34
20,Success,46,36,0,10,36
20,Success,55,29,0,7,48
20,Success,55,22,2,10,45
20,Success,43,25,0,20,23
20,Success,48,27,0,15,33
20,Success,50,26,6,12,38
20,Success,44,26,0,19,25
20,Fail,41,25,1,22,19
20,Success,54,24,5,7,47
20,Success,43,29,2,19,24
20,Success,53,20,0,14,39
20,Success,48,34,0,12,36
20,Success,55,16,0,13,42
20,Success,45,32,1,14,31
20,Success,46,26,1,14,32
20,Success,42,30,0,16,26
20,Success,49,30,0,10,39
20,Success,44,23,9,15,29
20,Success,53,27,0,11,42
20,Success,54,27,0,10,44
20,Success,50,24,4,15,35
20,Success,49,18,6,16,33
20,Success,40,27,10,15,25
20,Success,50,31,0,8,42
20,Success,50,24,2,13,37
20,Success,55,25,0,7,48
20,Success,44,31,0,14,30
20,Success,46,30,0,14,32
20,Success,49,29,0,11,38
20,Success,50,20,0,15,35
20,Success,48,31,1,8,40
20,Success,50,24,6,10,40
20,Success,50,30,0,12,38
20,Success,41,31,0,16,25
20,Success,46,34,0,9,37
20,Success,54,22,5,10,44
20,Success,48,26,0,15,33
20,Success,48,27,3,11,37
20,Success,45,27,1,12,33
20,Success,48,27,4,13,35
20,Success,49,32,0,10,39
20,Success,47,31,4,9,38
20,Success,50,28,0,11,39
20,Success,44,34,0,9,35
20,Success,54,22,5,8,46
20,Success,47,25,0,17,30
20,Success,43,33,1,13,30
20,Success,44,30,0,15,29
20,Success,49,30,3,9,40
20,Success,47,28,0,11,36
20,Success,48,26,7,8,40
20,Success,49,27,3,10,39
20,Success,53,23,5,12,41
20,Success,51,27,0,10,41
20,Success,52,26,1,10,42
20,Success,59,24,0,6,53
20,Success,54,22,1,14,40
20,Success,53,24,3,12,41
20,Success,46,31,0,13,33
20,Success,49,25,0,15,34
20,Success,47,23,2,14,33
20,Success,47,27,0,12,35
20,Fail,39,21,8,21,18
20,Success,43,29,4,12,31
20,Success,42,22,9,19,23
20,Success,57,17,3,10,47
20,Success,48,27,2,13,35
20,Success,49,22,4,15,34
20,Success,41,36,0,15,26
20,Success,44,31,0,15,29
20,Success,48,30,5,5,43
20,Success,47,32,0,8,39
20,Success,45,28,0,15,30
20,Success,53,24,0,11,42
20,Success,49,24,0,17,32
20,Success,45,33,0,10,35
20,Success,41,33,0,19,22
20,Success,45,25,4,15,30
20,Success,51,28,2,7,44
20,Success,56,25,4,5,51
20,Success,54,22,2,11,43
20,Success,47,26,1,14,33
20,Success,48,33,1,8,40
20,Success,39,39,0,9,30
20,Success,54,22,3,11,43
20,Success,48,23,9,14,34
20,Success,51,24,0,12,39
20,Success,50,21,0,11,39
20,Success,41,29,6,16,25
20,Success,41,34,0,14,27
20,Success,44,27,0,20,24
20,Success,51,25,1,10,41
20,Success,53,30,0,7,46
20,Success,48,24,3,11,37
20,Success,47,23,0,17,30
20,Success,49,23,0,17,32
20,Success,54,21,0,12,42
20,Success,49,24,6,13,36
20,Success,47,32,0,12,35
20,Success,54,23,1,15,39
20,Success,41,25,9,13,28
20,Success,44,30,2,14,30
20,Success,43,39,0,12,31
20,Success,51,27,0,8,43
20,Success,40,32,4,16,24
20,Success,56,17,1,12,44
20,Success,48,24,2,14,34
20,Success,45,31,0,16,29
20,Success,42,34,0,16,26
20,Success,40,36,8,7,33
20,Success,48,25,0,15,33
20,Success,47,25,0,17,30
20,Success,47,28,0,14,33
20,Success,46,27,11,10,36
20,Success,44,35,0,15,29
20,Success,45,33,0,10,35
20,Success,51,26,1,13,38
20,Success,60,19,0,11,49
20,Success,47,23,1,16,31
20,Success,43,28,8,13,30
20,Success,49,32,1,5,44
20,Success,55,20,3,12,43
20,Success,46,32,2,11,35
20,Success,51,27,0,17,34
20,Success,50,26,0,9,41
20,Success,49,29,0,9,40
20,Success,54,26,0,7,47
20,Success,46,25,0,20,26
20,Success,51,23,0,14,37
20,Success,47,28,2,13,34
20,Success,54,16,2,14,40
20,Success,53,25,5,7,46
20,Success,48,25,0,18,30
20,Success,49,32,0,10,39
20,Success,50,27,1,8,42
20,Success,48,30,0,10,38
20,Success,52,25,5,8,44
20,Success,43,20,4,20,23
20,Success,55,13,6,15,40
20,Success,53,21,0,11,42
20,Success,42,31,10,11,31
20,Success,42,27,9,13,29
20,Success,44,34,0,10,34
20,Success,45,30,0,14,31
20,Success,45,29,0,13,32
20,Success,49,28,0,12,37
20,Success,40,34,6,11,29
20,Success,47,27,0,13,34
20,Success,51,25,0,15,36
20,Success,43,24,9,15,28
20,Success,48,36,0,7,41
20,Success,46,30,0,14,32
20,Success,46,28,1,17,29
20,Success,53,23,0,9,44
20,Success,46,25,1,13,33
20,Success,46,22,4,19,27
20,Success,40,32,0,17,23
20,Success,47,34,0,12,35
20,Success,48,28,6,11,37
20,Success,45,34,0,12,33
20,Success,50,27,4,8,42
20,Success,38,33,9,12,26
20,Success,50,24,0,12,38
20,Success,48,25,4,14,34
20,Success,41,25,2,21,20
20,Success,53,20,6,11,42
20,Success,43,40,0,11,32
20,Success,43,28,0,12,31
20,Success,50,22,3,16,34
20,Success,53,24,1,11,42
20,Success,56,18,0,14,42
20,Success,54,22,2,8,46
20,Success,51,29,0,11,40
20,Success,48,22,12,10,38
20,Success,46,28,0,15,31
20,Success,46,29,0,18,28
20,Success,48,26,4,12,36
20,Success,47,24,10,10,37
20,Success,44,26,6,14,30
20,Success,50,25,3,9,41
20,Success,49,22,6,15,34
20,Success,40,37,0,14,26
20,Success,54,23,0,14,40
20,Success,46,28,4,15,31
20,Success,57,21,0,8,49
20,Success,44,29,3,12,32
20,Success,53,25,3,10,43
20,Success,43,30,0,18,25
20,Success,51,27,0,12,39
20,Success,49,28,1,12,37
20,Success,50,27,1,12,38
20,Success,56,28,0,11,45
20,Success,51,27,4,11,40
20,Success,53,20,1,9,44
20,Success,57,25,0,8,49
20,Success,34,42,0,13,21
20,Success,55,22,0,12,43
20,Success,47,30,0,11,36
20,Success,48,31,0,13,35
20,Success,58,20,1,5,53
20,Success,47,29,0,13,34
20,Success,47,30,0,12,35
20,Success,44,28,2,14,30
20,Success,48,24,3,17,31
20,Success,48,20,5,14,34
20,Success,51,26,0,14,37
20,Success,43,27,1,18,25
20,Success,49,25,0,13,36
20,Success,50,28,0,12,38
20,Success,53,24,1,11,42
20,Success,50,24,0,13,37
20,Success,49,26,0,13,36
20,Success,49,22,4,14,35
20,Success,55,26,0,8,47
20,Success,51,26,2,6,45
20,Success,48,26,9,9,39
20,Success,50,23,1,16,34
20,Success,46,31,0,15,31
20,Success,50,26,5,9,41
20,Success,43,30,12,9,34
20,Success,47,26,0,15,32
20,Success,52,25,4,12,40
20,Success,49,21,7,10,39
20,Success,40,30,9,15,25
20,Success,56,12,2,15,41
20,Success,52,25,4,8,44
20,Success,45,34,0,7,38
20,Success,50,28,1,9,41
20,Success,53,28,0,9,44
20,Success,53,25,0,8,45
20,Success,48,32,0,12,36
20,Success,49,28,0,12,37
20,Success,49,28,2,9,40
20,Success,44,34,0,15,29
20,Success,55,20,0,14,41
20,Success,52,20,0,14,38
20,Success,45,33,0,14,31
20,Success,52,20,5,12,40
20,Success,47,20,4,16,31
20,Success,43,31,2,15,28
20,Success,55,22,0,12,43
20,Success,48,34,0,10,38
20,Success,49,32,0,8,41
20,Success,45,36,0,11,34
20,Success,52,25,1,7,45
20,Success,49,27,0,9,40
20,Success,52,27,0,14,38
20,Success,52,30,0,7,45
20,Success,46,30,0,12,34
20,Success,49,26,0,11,38
20,Success,49,27,0,11,38
20,Success,52,24,0,15,37
20,Success,48,28,0,13,35
20,Success,53,22,1,13,40
20,Success,46,26,0,14,32
20,Success,47,23,3,12,35
20,Success,53,18,0,15,38
20,Success,43,31,0,18,25
20,Success,52,27,0,13,39
20,Success,50,31,0,10,40
20,Success,44,31,0,15,29
20,Success,45,34,0,14,31
20,Success,50,23,0,16,34
20,Success,48,26,0,12,36
20,Success,50,23,0,10,40
20,Success,37,39,0,15,22
20,Success,48,22,9,9,39
20,Success,48,22,0,15,33
20,Success,44,30,0,19,25
20,Success,47,24,4,11,36
20,Success,55,21,4,9,46
20,Success,54,24,3,11,43
20,Success,55,20,0,12,43
20,Success,49,25,0,11,38
20,Success,47,26,4,12,35
20,Success,47,26,1,16,31
20,Success,43,40,0,10,33
20,Success,42,35,0,11,31
20,Success,45,26,0,18,27
20,Success,41,32,1,16,25
20,Success,48,30,0,15,33
20,Success,41,30,0,17,24
20,Success,49,25,4,13,36
20,Success,44,29,0,15,29
20,Success,44,26,9,12,32
20,Success,38,31,4,16,22
20,Success,52,21,8,16,36
20,Success,43,30,0,15,28
20,Success,45,24,1,16,29
20,Success,51,20,0,13,38
20,Success,53,25,0,12,41
20,Success,48,33,0,11,37
20,Success,47,29,4,10,37
20,Success,54,17,5,12,42
20,Success,43,29,0,15,28
20,Success,53,25,0,15,38
20,Success,48,25,0,15,33
20,Success,50,25,2,12,38
20,Success,52,29,0,8,44
20,Success,46,25,2,15,31
20,Success,47,34,0,11,36
20,Success,53,25,2,10,43
20,Success,42,27,2,19,23
20,Success,46,26,2,16,30
20,Success,49,27,0,13,36
20,Success,53,21,4,11,42
20,Success,47,30,0,12,35
20,Success,47,29,1,16,31
20,Success,45,28,6,12,33
20,Success,45,27,7,12,33
20,Success,40,25,10,16,24
20,Success,47,30,0,13,34
20,Success,53,20,0,14,39
20,Success,47,26,4,15,32
20,Success,52,22,2,11,41
20,Success,48,31,0,12,36
20,Success,49,36,0,9,40
20,Success,54,21,6,9,45
20,Success,52,24,0,14,38
20,Success,52,25,3,9,43
20,Success,46,28,2,15,31
20,Success,51,19,4,13,38
20,Success,48,30,0,12,36
20,Success,59,21,1,11,48
20,Success,51,24,2,13,38
20,Success,46,32,0,12,34
20,Success,49,27,0,13,36
20,Success,49,26,1,14,35
20,Success,49,22,5,16,33
20,Success,41,34,0,17,24
20,Success,47,27,0,16,31
20,Success,48,31,2,5,43
20,Success,45,27,0,14,31
20,Success,45,36,0,9,36
20,Success,50,24,5,12,38
20,Success,50,32,0,11,39
20,Success,46,37,0,9,37
20,Success,43,28,0,18,25
20,Success,47,21,0,18,29
20,Success,42,33,6,12,30
20,Success,43,29,5,14,29
20,Success,43,41,0,9,34
20,Success,47,18,5,21,26
20,Success,42,28,3,17,25
20,Success,46,31,5,9,37
20,Success,49,33,0,8,41
20,Success,51,23,6,11,40
20,Success,44,30,0,14,30
20,Success,51,25,0,15,36
20,Success,41,31,0,15,26
20,Success,50,21,0,14,36
20,Success,51,33,3,6,45
20,Success,52,23,0,12,40
20,Success,54,25,1,9,45
20,Success,47,28,4,13,34
20,Success,46,32,0,15,31
20,Success,48,28,0,11,37
20,Success,45,32,5,9,36
20,Success,49,26,2,9,40
20,Fail,31,31,16,15,16
20,Success,50,32,0,9,41
20,Success,48,24,3,15,33
20,Success,53,20,10,11,42
20,Success,52,25,0,9,43
20,Success,52,25,0,14,38
20,Success,48,29,3,8,40
20,Success,51,22,6,11,40
20,Success,46,30,4,12,34
20,Success,53,30,0,11,42
20,Success,52,25,0,12,40
20,Success,44,35,0,14,30
20,Success,45,31,0,11,34
20,Success,54,24,1,9,45
20,Success,45,29,0,16,29
20,Success,53,20,0,15,38
20,Success,45,24,4,16,29
20,Success,40,30,2,18,22
20,Success,54,21,0,12,42
20,Success,46,30,0,12,34
20,Success,49,21,10,9,40
20,Success,55,19,1,12,43
20,Success,48,27,1,13,35
20,Success,48,32,0,11,37
20,Success,58,23,0,9,49
20,Success,41,29,3,19,22
20,Success,51,23,0,15,36
20,Success,47,31,2,12,35
20,Success,56,21,3,7,49
20,Success,52,21,0,19,33
20,Success,55,24,2,8,47
20,Success,52,26,0,8,44
20,Success,43,36,0,12,31
20,Success,51,24,0,12,39
20,Success,50,23,0,10,40
20,Success,46,25,3,14,32
20,Success,57,18,3,15,42
20,Success,54,32,0,6,48
20,Success,43,27,5,14,29
20,Success,48,23,8,13,35
20,Success,46,32,0,11,35
20,Success,47,27,5,14,33
20,Success,49,25,3,13,36
20,Success,54,22,0,11,43
20,Success,50,22,6,12,38
20,Success,57,16,0,14,43
20,Success,52,28,0,10,42
20,Success,52,22,0,14,38
20,Success,56,13,4,17,39
20,Success,46,33,0,13,33
20,Success,39,31,4,14,25
20,Success,44,38,0,11,33
20,Success,51,29,4,8,43
20,Success,48,22,5,15,33
20,Success,42,42,0,13,29
20,Success,43,31,4,14,29
20,Success,50,22,6,14,36
20,Success,41,38,0,12,29
20,Success,47,22,2,15,32
20,Success,55,23,0,11,44
20,Success,59,16,2,7,52
20,Success,53,21,0,11,42
20,Success,45,29,0,14,31
20,Success,59,26,0,6,53
20,Success,47,27,4,12,35
20,Success,50,32,0,9,41
20,Success,39,39,0,18,21
20,Success,45,31,0,15,30
20,Success,43,34,0,13,30
20,Success,45,33,1,14,31
20,Success,53,24,0,13,40
20,Success,48,29,1,10,38
20,Success,53,21,0,11,42
20,Success,50,27,0,12,38
20,Success,51,23,4,14,37
20,Success,46,31,0,13,33
20,Success,47,30,0,9,38
20,Success,46,30,2,15,31
20,Success,46,23,0,20,26
20,Success,57,21,0,12,45
20,Success,48,29,0,12,36
20,Success,43,31,0,11,32
20,Success,52,17,4,17,35
20,Success,53,23,0,17,36
20,Success,41,41,0,12,29
20,Success,43,35,1,9,34
20,Success,50,23,1,13,37
20,Success,47,19,13,10,37
20,Success,54,24,0,10,44
20,Success,45,35,0,11,34
20,Success,47,23,10,11,36
20,Success,40,41,0,11,29
20,Success,43,31,0,14,29
20,Success,44,32,0,12,32
20,Success,52,24,1,13,39
20,Success,50,27,0,14,36
20,Success,51,24,1,13,38
20,Success,45,28,8,10,35
20,Success,43,31,0,16,27
20,Success,46,36,0,8,38
20,Success,51,24,4,11,40
20,Success,52,18,6,16,36
20,Success,52,22,4,13,39
20,Success,49,24,1,14,35
20,Success,47,28,5,12,35
20,Fail,40,25,6,21,19
20,Success,49,26,0,14,35
20,Fail,37,29,5,19,18
20,Success,42,36,0,13,29
20,Success,52,22,4,14,38
20,Success,53,21,5,13,40
20,Success,48,26,7,13,35
20,Success,46,23,4,16,30
20,Fail,33,39,5,16,17
20,Success,50,31,1,9,41
20,Success,50,28,0,10,40
20,Success,43,34,0,11,32
20,Success,46,26,9,11,35
20,Success,49,32,0,9,40
20,Success,42,33,4,9,33
20,Success,49,22,2,13,36
20,Success,49,20,0,18,31
20,Success,41,38,0,11,30
20,Success,57,24,0,9,48
20,Success,40,30,0,20,20
20,Success,46,26,0,12,34
20,Success,44,33,6,9,35
20,Success,45,26,4,16,29
20,Success,44,32,0,11,33
20,Success,44,28,0,17,27
20,Success,45,22,1,23,22
20,Success,45,26,10,10,35
20,Success,54,22,2,10,44
20,Success,48,26,0,13,35
20,Success,50,18,6,16,34
20,Success,46,37,0,7,39
20,Success,49,30,0,6,43
20,Success,52,27,0,14,38
20,Success,45,30,0,13,32
20,Success,49,31,5,6,43
20,Success,48,22,0,18,30
20,Success,51,22,0,15,36
20,Success,49,31,0,9,40
20,Success,48,20,4,16,32
20,Success,48,31,0,7,41
20,Success,46,31,0,9,37
20,Success,50,22,3,12,38
20,Success,51,15,4,16,35
20,Success,55,19,7,13,42
20,Success,47,22,0,18,29
20,Success,49,33,0,8,41
20,Success,45,24,1,19,26
20,Success,50,17,5,13,37
20,Success,48,29,0,13,35
20,Success,49,30,0,13,36
20,Success,51,18,7,15,36
20,Success,45,22,1,17,28
20,Success,48,25,6,12,36
20,Success,42,29,0,17,25
20,Success,43,27,3,15,28
20,Success,47,23,8,12,35
20,Success,49,29,0,13,36
20,Success,42,38,0,11,31
20,Success,52,22,5,10,42
20,Success,51,27,0,13,38
20,Success,46,29,0,15,31
20,Success,42,38,0,13,29
20,Success,45,25,0,20,25
20,Success,39,33,7,15,24
20,Success,41,27,0,20,21
20,Success,45,30,0,11,34
20,Success,43,35,0,12,31
20,Success,53,27,2,6,47
20,Success,46,21,6,18,28
20,Success,44,36,0,8,36
20,Success,50,27,1,12,38
20,Success,51,22,1,14,37
20,Success,52,27,4,6,46
20,Success,44,29,1,15,29
20,Success,49,31,0,13,36
20,Success,50,30,0,10,40
20,Fail,41,31,0,23,18
20,Success,50,24,1,12,38
20,Success,49,21,5,15,34
20,Success,53,24,0,15,38
20,Success,52,25,0,10,42
20,Success,46,22,3,19,27
20,Success,45,27,2,17,28
20,Success,55,23,0,9,46
20,Success,47,26,0,10,37
20,Success,49,26,9,10,39
20,Success,50,25,0,15,35
20,Success,57,17,2,8,49
20,Success,54,14,2,19,35
20,Success,57,25,0,10,47
20,Success,48,24,0,13,35
20,Success,46,24,5,15,31
20,Success,51,24,0,11,40
20,Success,41,35,0,16,25
20,Success,47,27,5,12,35
20,Success,46,29,1,12,34
20,Success,49,30,0,9,40
20,Success,45,29,2,11,34
20,Success,52,27,0,13,39
20,Success,42,32,0,17,25
20,Success,42,27,4,16,26
20,Success,52,20,0,14,38
20,Success,47,27,9,5,42
20,Success,44,29,2,14,30
20,Success,46,25,0,16,30
20,Success,40,36,0,14,26
20,Success,48,31,0,14,34
20,Success,46,25,8,14,32
20,Success,50,29,0,13,37
20,Success,41,29,4,16,25
20,Success,45,23,1,22,23
20,Success,47,25,0,15,32
20,Success,49,22,0,14,35
20,Success,48,27,1,14,34
20,Success,51,17,3,16,35
20,Success,49,27,0,10,39
20,Success,53,26,0,14,39
20,Success,49,24,0,11,38
20,Success,41,29,0,17,24
20,Success,39,33,2,17,22
20,Success,51,32,0,7,44
20,Success,50,30,0,10,40
20,Success,46,24,2,15,31
20,Success,46,36,2,6,40
20,Success,55,23,0,11,44
20,Success,44,28,0,12,32
20,Success,49,29,0,9,40
20,Success,52,24,0,11,41
20,Success,52,24,1,12,40
20,Success,57,22,1,8,49
20,Success,51,29,0,10,41
20,Success,47,32,0,13,34
20,Success,50,25,2,13,37
20,Success,45,28,0,20,25
20,Success,49,26,1,10,39
20,Success,54,22,0,14,40
20,Success,52,26,2,8,44
20,Success,51,31,0,9,42
20,Success,50,24,0,16,34
20,Success,46,31,2,13,33
20,Success,50,27,0,10,40
20,Success,43,31,0,20,23
20,Success,48,29,2,10,38
20,Success,48,29,0,14,34
20,Success,42,35,0,12,30
20,Success,56,17,1,16,40
20,Success,53,29,1,6,47
20,Success,51,23,0,13,38
20,Success,50,28,0,11,39
20,Success,60,21,1,6,54
20,Success,56,23,0,9,47
20,Success,45,23,1,18,27
20,Success,46,24,3,15,31
20,Success,46,29,3,10,36
20,Success,55,23,0,14,41
20,Success,50,26,0,13,37
20,Success,36,43,0,15,21
20,Success,53,22,0,11,42
20,Success,47,30,0,13,34
20,Success,45,30,0,13,32
20,Success,40,34,0,19,21
20,Success,37,31,9,13,24
20,Success,43,33,0,14,29
20,Success,48,27,0,12,36
20,Success,48,27,0,12,36
20,Success,54,19,5,10,44
20,Success,45,26,3,16,29
20,Success,45,27,0,17,28
20,Success,46,28,3,10,36
20,Success,54,22,4,12,42
20,Success,51,32,0,8,43
20,Success,38,41,0,14,24
20,Success,47,26,5,13,34
20,Success,45,33,0,11,34
20,Success,49,27,0,14,35
20,Success,47,31,0,10,37
20,Success,52,24,2,9,43
20,Success,48,35,0,8,40
20,Success,47,33,0,9,38
20,Success,46,33,3,10,36
20,Success,53,22,0,13,40
20,Success,40,37,0,11,29
20,Success,55,29,0,6,49
20,Success,42,29,0,18,24
20,Success,45,37,3,6,39
20,Success,47,32,0,9,38
20,Success,49,23,1,15,34
20,Success,54,24,0,11,43
20,Success,44,32,0,16,28
20,Success,46,24,7,11,35
20,Success,55,17,0,13,42
20,Success,51,30,0,9,42
20,Success,56,22,3,10,46
20,Success,42,33,0,14,28
20,Success,48,29,2,14,34
20,Success,46,30,3,11,35
20,Success,43,38,0,12,31
20,Success,50,26,0,12,38
20,Success,43,37,0,11,32
20,Success,50,27,0,10,40
20,Success,52,27,0,10,42
20,Success,52,23,0,12,40
20,Success,47,29,0,15,32
20,Success,54,26,0,10,44
20,Success,47,33,0,11,36
20,Success,45,24,4,14,31
20,Success,47,31,0,14,33
20,Success,44,36,0,10,34
20,Success,44,28,0,13,31
20,Success,42,29,0,21,21
20,Success,49,24,2,12,37
20,Success,47,27,3,11,36
20,Success,52,23,1,12,40
20,Success,45,27,0,17,28
20,Success,48,21,0,16,32
20,Success,47,25,2,10,37
20,Success,50,29,0,13,37
20,Success,46,27,3,13,33
20,Success,52,21,1,14,38
20,Success,53,27,0,9,44
20,Success,44,26,3,17,27
20,Success,41,29,7,15,26
20,Success,41,26,11,13,28
20,Success,44,27,8,10,34
20,Success,47,28,0,12,35
20,Success,51,28,1,8,43
20,Success,54,14,2,18,36
20,Success,48,23,1,14,34
20,Success,45,22,8,17,28
20,Success,54,22,1,10,44
20,Success,50,15,5,15,35
20,Success,44,29,8,10,34
20,Success,52,27,0,11,41
20,Success,49,25,1,15,34
20,Success,50,25,2,10,40
20,Success,49,20,0,20,29
20,Success,50,22,0,11,39
20,Success,45,34,0,12,33
20,Success,41,36,0,14,27
20,Success,45,28,5,9,36
20,Success,39,40,0,12,27
20,Success,46,30,5,9,37
20,Success,53,24,0,14,39
20,Success,41,25,12,12,29
20,Success,43,25,0,20,23
20,Fail,37,30,3,21,16
20,Success,52,20,0,17,35
20,Success,46,38,0,10,36
20,Success,54,28,0,9,45
20,Success,44,28,0,13,31
20,Success,45,29,0,13,32
20,Success,53,22,2,11,42
20,Success,50,24,0,13,37
20,Success,52,25,0,10,42
20,Success,52,29,0,11,41
20,Success,44,26,8,16,28
20,Success,37,38,4,12,25
20,Success,50,24,0,14,36
20,Success,46,30,0,13,33
20,Success,40,29,8,14,26
20,Success,53,20,0,10,43
20,Success,50,22,3,15,35
20,Success,50,25,3,13,37
20,Success,45,26,9,11,34
20,Success,48,35,0,9,39
20,Success,46,29,0,17,29
20,Success,44,20,8,17,27
20,Success,51,35,0,8,43
20,Success,48,26,0,13,35
20,Success,44,33,0,15,29
20,Success,45,29,4,12,33
20,Success,41,27,6,16,25
20,Success,48,26,1,13,35
20,Success,51,23,4,14,37
20,Success,44,27,12,11,33
20,Success,39,42,0,12,27
20,Success,49,29,0,9,40
20,Success,54,20,3,12,42
20,Success,43,31,0,18,25
20,Success,53,24,0,16,37
20,Success,48,27,0,16,32
20,Success,52,35,0,7,45
20,Success,40,40,0,11,29
20,Success,48,33,0,11,37
20,Success,47,20,5,17,30
20,Success,46,21,0,19,27
20,Success,45,26,0,17,28
20,Success,49,26,2,11,38
20,Success,49,27,2,11,38
20,Success,54,28,0,8,46
20,Success,49,36,0,8,41
20,Success,54,21,2,11,43
20,Success,40,32,5,12,28
20,Success,47,20,0,17,30
20,Success,38,29,9,14,24
20,Success,47,24,7,15,32
20,Success,55,20,2,12,43
20,Success,44,29,5,10,34
20,Success,53,22,0,13,40
20,Success,48,33,0,9,39
20,Success,43,35,0,12,31
20,Success,54,18,3,13,41
20,Success,54,22,0,16,38
20,Success,45,33,0,10,35
20,Success,48,23,0,19,29
20,Success,54,22,2,11,43
20,Success,55,21,3,9,46
20,Success,50,24,1,15,35
20,Success,50,27,1,10,40
20,Success,45,29,0,14,31
20,Success,53,18,4,13,40
20,Success,48,22,3,13,35
20,Success,56,19,0,9,47
20,Success,40,27,6,16,24
20,Success,48,25,3,12,36
20,Success,48,27,0,13,35
20,Success,55,21,0,11,44
20,Success,37,44,0,12,25
20,Success,45,32,0,15,30
20,Success,55,14,5,11,44
20,Success,43,20,5,17,26
20,Success,50,30,0,6,44
20,Success,43,39,0,7,36
20,Success,51,27,2,12,39
20,Success,55,25,0,10,45
20,Success,57,19,3,9,48
20,Success,41,39,0,10,31
20,Success,47,25,0,15,32
20,Success,50,22,8,10,40
20,Success,46,25,1,9,37
20,Success,53,28,0,9,44
20,Success,48,33,0,10,38
20,Success,46,27,0,15,31
20,Success,49,28,0,12,37
20,Success,41,29,4,15,26
20,Success,54,29,0,6,48
20,Success,53,24,5,5,48
20,Success,41,26,7,16,25
20,Success,42,40,0,11,31
20,Success,43,29,7,11,32
20,Success,46,30,1,14,32
20,Success,46,19,10,14,32
20,Success,50,28,0,13,37
20,Success,51,25,6,12,39
20,Success,45,30,0,11,34
20,Success,46,31,0,11,35
20,Success,47,33,0,10,37
20,Success,53,25,0,11,42
20,Success,46,31,0,15,31
20,Success,53,21,0,14,39
20,Success,53,23,0,12,41
20,Success,47,25,5,12,35
20,Success,48,24,5,11,37
20,Success,52,27,0,10,42
20,Success,52,33,0,6,46
20,Success,50,27,0,13,37
20,Fail,35,37,2,17,18
20,Success,44,27,8,11,33
20,Success,51,27,0,15,36
20,Success,45,22,11,14,31
20,Success,43,32,2,13,30
20,Success,46,36,0,9,37
20,Success,49,28,0,11,38
20,Success,47,26,0,14,33
20,Success,49,32,3,8,41
20,Success,48,25,8,9,39
20,Success,46,29,0,12,34
20,Success,52,24,3,14,38
20,Success,49,29,0,8,41
20,Success,43,39,1,7,36
20,Success,41,31,0,16,25
20,Success,52,25,0,10,42
20,Success,49,23,9,12,37
20,Success,48,25,0,12,36
20,Success,42,23,0,20,22
20,Success,51,26,0,9,42
20,Success,46,36,0,9,37
20,Success,50,23,2,12,38
20,Success,58,18,1,11,47
20,Success,46,23,1,19,27
20,Success,54,30,0,8,46
20,Success,47,25,0,14,33
20,Success,48,30,6,11,37
20,Success,54,23,1,10,44
20,Success,46,37,0,7,39
20,Success,45,37,0,11,34
20,Success,51,26,3,11,40
20,Success,56,19,4,11,45
20,Success,51,23,5,11,40
20,Success,53,20,0,15,38
20,Success,45,38,0,9,36
20,Success,47,27,4,13,34
20,Success,44,24,8,14,30
20,Success,45,33,0,16,29
20,Success,43,25,7,15,28
20,Success,52,26,3,6,46
20,Success,39,34,3,18,21
20,Success,51,26,0,15,36
20,Success,51,23,3,12,39
20,Success,43,30,6,13,30
20,Success,47,30,1,12,35
20,Success,46,30,2,12,34
20,Success,40,41,0,10,30
20,Success,44,29,0,13,31
20,Success,46,29,0,12,34
20,Success,55,17,7,6,49
20,Success,55,20,6,10,45
20,Success,46,31,0,12,34
20,Success,51,19,1,16,35
20,Success,43,33,0,12,31
20,Success,45,31,3,14,31
20,Success,52,31,0,10,42
20,Success,45,32,0,13,32
20,Success,42,37,0,11,31
20,Success,54,25,0,11,43
20,Success,50,25,2,12,38
20,Success,47,31,0,8,39
20,Success,43,28,4,13,30
20,Success,53,20,7,10,43
20,Success,45,34,0,9,36
20,Success,43,29,4,14,29
20,Success,43,25,12,11,32
20,Success,45,26,4,17,28
20,Success,47,27,2,14,33
20,Success,43,22,7,16,27
20,Success,48,27,2,10,38
20,Success,52,26,1,8,44
20,Success,44,31,0,20,24
20,Success,44,33,0,10,34
20,Success,40,36,0,14,26
20,Success,44,33,2,10,34
20,Success,63,20,0,5,58
20,Success,49,25,0,17,32
20,Success,45,22,10,13,32
20,Success,44,38,0,10,34
20,Success,48,23,0,16,32
20,Success,51,20,2,13,38
20,Success,48,22,8,11,37
20,Success,46,32,0,12,34
20,Success,46,27,2,13,33
20,Success,50,27,3,10,40
20,Success,43,22,10,16,27
20,Success,48,29,6,9,39
20,Fail,40,21,3,22,18
20,Success,50,26,0,16,34
20,Success,51,25,0,8,43
20,Success,45,28,0,16,29
20,Success,45,30,4,12,33
20,Success,55,22,2,10,45
20,Success,48,30,0,13,35
20,Success,42,31,0,20,22
20,Success,52,29,0,8,44
20,Success,53,17,0,14,39
20,Success,49,25,0,11,38
20,Success,46,31,0,10,36
20,Success,49,28,0,11,38
20,Success,46,26,2,13,33
20,Success,47,33,0,13,34
20,Success,52,18,0,13,39
20,Success,41,29,2,16,25
20,Success,45,27,7,13,32
20,Success,47,35,0,9,38
20,Success,48,26,1,13,35
20,Success,49,27,0,11,38
20,Success,43,25,7,16,27
20,Success,48,28,0,11,37
20,Success,51,23,0,13,38
20,Success,45,26,4,15,30
20,Success,58,20,1,7,51
20,Success,45,30,0,17,28
20,Success,59,20,3,8,51
20,Success,46,30,5,8,38
20,Success,55,19,0,15,40
20,Success,46,32,0,12,34
20,Success,45,26,0,16,29
20,Success,52,24,3,6,46
20,Success,51,25,0,10,41
20,Success,49,26,2,15,34
20,Success,49,24,2,17,32
20,Success,44,26,5,14,30
20,Success,53,24,0,14,39
20,Success,41,33,0,18,23
20,Success,61,25,0,5,56
20,Success,51,30,0,10,41
20,Success,48,31,0,13,35
20,Fail,37,35,0,18,19
20,Success,49,28,3,11,38
20,Success,49,26,0,10,39
20,Success,42,29,4,15,27
20,Success,45,32,0,14,31
20,Success,44,24,7,11,33
20,Success,45,31,1,11,34
20,Success,48,35,0,9,39
20,Success,47,22,4,16,31
20,Success,53,24,2,9,44
20,Success,52,18,0,16,36
20,Success,53,17,9,11,42
20,Success,55,21,5,7,48
20,Success,48,27,4,10,38
20,Success,48,25,2,15,33
20,Success,49,24,6,11,38
20,Success,44,31,0,17,27
20,Success,52,26,1,10,42
20,Success,49,20,5,13,36
20,Success,51,26,2,10,41
20,Success,42,28,1,18,24
20,Success,48,31,0,8,40
20,Success,44,36,0,10,34
20,Success,56,25,0,7,49
20,Success,43,37,0,11,32
20,Success,47,29,1,8,39
20,Success,46,37,0,10,36
20,Success,54,27,0,8,46
20,Success,41,32,0,15,26
20,Success,42,40,0,8,34
20,Success,48,30,0,10,38
20,Success,52,12,4,18,34
20,Success,53,18,8,12,41
20,Success,49,27,5,8,41
20,Success,49,23,0,16,33
20,Success,50,24,0,14,36
20,Success,56,21,2,11,45
20,Success,45,29,4,10,35
20,Success,54,26,2,5,49
20,Success,51,22,7,12,39
20,Success,39,39,0,9,30
20,Success,40,30,6,11,29
20,Success,48,24,0,12,36
20,Success,51,18,1,15,36
20,Success,51,30,0,10,41
20,Success,46,30,3,10,36
20,Success,44,32,4,8,36
20,Success,48,23,4,16,32
20,Success,45,28,2,11,34
20,Success,41,28,0,16,25
20,Success,41,40,0,10,31
20,Success,52,19,3,13,39
20,Success,40,38,0,16,24
20,Success,48,22,8,15,33
20,Success,48,23,7,18,30
20,Success,40,35,8,11,29
20,Success,54,28,0,9,45
20,Success,53,22,0,10,43
20,Success,37,41,0,11,26
20,Success,44,27,0,15,29
20,Success,52,29,0,8,44
20,Success,50,15,3,14,36
20,Success,51,22,0,18,33
20,Success,51,34,0,7,44
20,Success,45,26,5,15,30
20,Success,47,35,0,8,39
20,Success,40,27,7,17,23
20,Success,50,26,0,10,40
20,Success,40,30,11,9,31
20,Success,50,27,0,13,37
20,Success,47,24,1,17,30
20,Success,50,25,7,8,42
20,Success,41,28,7,14,27
20,Success,58,17,3,12,46
20,Success,53,20,5,12,41
20,Success,52,19,8,12,40
20,Success,52,23,6,7,45
20,Success,44,30,7,13,31
20,Success,48,26,6,8,40
20,Success,55,17,2,11,44
20,Success,40,32,0,17,23
20,Success,46,21,4,17,29
20,Success,51,24,0,14,37
20,Success,44,39,0,9,35
20,Success,47,31,0,11,36
20,Success,48,25,3,14,34
20,Success,43,28,5,17,26
20,Success,44,29,5,12,32
20,Success,49,28,0,15,34
20,Success,50,29,0,13,37
20,Success,48,33,0,7,41
20,Success,47,28,3,11,36
20,Success,47,27,0,11,36
20,Success,48,28,0,14,34
20,Success,39,31,6,15,24
20,Success,47,24,2,16,31
20,Success,45,32,0,14,31
20,Success,55,29,0,8,47
20,Success,44,29,6,13,31
20,Success,53,28,0,10,43
20,Success,45,29,0,14,31
20,Success,49,32,0,12,37
20,Success,38,36,0,17,21
20,Success,48,34,0,8,40
20,Success,49,24,0,13,36
20,Success,53,23,1,10,43
20,Success,46,19,11,15,31
20,Success,54,29,0,4,50
20,Success,44,36,0,11,33
20,Success,49,21,5,14,35
20,Success,58,24,0,8,50
20,Success,45,28,2,10,35
20,Success,50,29,0,8,42
20,Success,46,26,3,11,35
20,Success,50,32,0,8,42
20,Success,50,18,7,16,34
20,Success,47,20,0,18,29
20,Success,55,19,0,14,41
20,Success,54,25,0,9,45
20,Success,53,31,0,7,46
20,Success,54,19,5,11,43
20,Success,43,27,8,13,30
20,Success,44,25,7,16,28
20,Success,48,35,0,11,37
20,Success,42,28,0,20,22
20,Success,43,28,0,18,25
20,Success,51,24,0,14,37
20,Success,43,30,4,10,33
20,Success,37,36,6,11,26
20,Success,47,36,0,8,39
20,Success,43,33,0,16,27
20,Success,51,27,0,14,37
20,Success,46,28,5,12,34
20,Success,46,28,7,10,36
20,Success,44,33,0,13,31
20,Success,43,28,5,13,30
20,Success,49,23,0,15,34
20,Success,41,24,7,16,25
20,Success,49,27,0,14,35
20,Success,41,31,5,14,27
20,Success,44,32,0,9,35
20,Success,48,24,0,15,33
20,Success,50,24,10,10,40
20,Success,45,27,3,16,29
20,Success,45,35,0,11,34
20,Success,50,27,2,12,38
20,Success,59,19,1,9,50
20,Success,52,23,5,11,41
20,Success,52,28,0,8,44
20,Success,50,23,4,11,39
20,Success,48,26,2,11,37
20,Success,50,21,5,15,35
20,Success,48,30,0,12,36
20,Success,49,25,0,14,35
20,Success,44,35,0,11,33
20,Success,46,31,0,12,34
20,Success,52,21,5,14,38
20,Success,50,22,0,16,34
20,Success,43,22,2,22,21
20,Success,40,28,0,19,21
20,Success,50,26,0,16,34
20,Success,47,23,3,15,32
20,Success,48,24,0,14,34
20,Success,57,22,1,7,50
20,Success,50,31,0,8,42
20,Success,48,23,9,12,36
20,Success,52,24,2,9,43
20,Success,52,29,0,6,46
20,Success,42,35,0,15,27
20,Success,48,25,15,7,41
20,Fail,41,27,0,22,19
20,Success,49,25,6,9,40
20,Success,46,30,2,9,37
20,Success,45,37,0,9,36
20,Success,51,25,0,12,39
20,Success,55,22,1,9,46
20,Success,46,28,1,11,35
20,Success,49,24,0,11,38
20,Success,58,17,0,12,46
20,Success,41,26,7,15,26
20,Success,48,31,0,10,38
20,Success,39,30,7,13,26
20,Success,45,30,5,8,37
20,Success,56,21,1,9,47
20,Success,40,43,0,8,32
20,Success,54,22,2,10,44
20,Success,44,26,4,17,27
20,Success,41,31,0,15,26
20,Success,52,21,0,12,40
20,Success,50,24,3,8,42
20,Success,48,25,0,17,31
20,Success,35,37,9,14,21
20,Success,42,27,6,18,24
20,Success,45,23,1,16,29
20,Success,51,26,0,13,38
20,Success,51,22,1,14,37
20,Success,52,24,0,10,42
20,Success,51,29,0,7,44
20,Success,45,36,0,7,38
20,Success,44,28,6,16,28
20,Success,52,28,0,10,42
20,Success,52,23,0,12,40
20,Success,51,32,0,10,41
20,Success,50,19,4,15,35
20,Success,48,27,0,17,31
20,Success,49,25,4,14,35
20,Success,51,23,2,14,37
20,Success,41,31,0,16,25
20,Success,51,24,0,13,38
20,Success,45,29,1,12,33
20,Success,49,18,2,17,32
20,Fail,40,30,0,21,19
20,Success,52,22,3,10,42
20,Success,52,32,0,9,43
20,Success,50,24,10,7,43
20,Success,49,26,0,11,38
20,Success,42,26,10,11,31
20,Success,50,18,3,16,34
20,Success,56,23,5,7,49
20,Success,53,30,0,8,45
20,Success,52,30,0,8,44
20,Success,46,28,0,17,29
20,Success,57,21,5,8,49
20,Success,46,23,6,16,30
20,Success,51,30,0,8,43
20,Success,49,23,2,14,35
20,Success,46,19,6,20,26
20,Success,60,18,0,9,51
20,Success,46,22,10,14,32
20,Success,40,34,2,13,27
20,Success,51,24,0,17,34
20,Success,49,28,0,11,38
20,Success,50,30,0,8,42
20,Success,59,17,0,10,49
20,Success,37,36,0,15,22
20,Success,45,29,5,14,31
20,Success,42,26,7,18,24
20,Success,54,25,0,12,42
20,Success,44,29,0,12,32
20,Success,47,26,7,11,36
20,Success,47,27,6,10,37
20,Success,50,30,0,12,38
20,Success,45,26,3,15,30
20,Success,55,20,1,12,43
20,Success,48,24,1,14,34
20,Success,48,33,0,8,40
20,Success,48,22,3,16,32
20,Success,55,30,0,9,46
20,Success,43,30,0,13,30
20,Success,51,22,1,14,37
20,Success,55,24,0,11,44
20,Success,49,24,0,15,34
20,Success,42,32,0,18,24
20,Success,50,31,0,8,42
20,Success,46,34,0,10,36
20,Success,45,31,4,11,34
20,Success,51,27,2,9,42
20,Success,53,29,0,4,49
20,Success,50,22,1,14,36
20,Success,53,22,3,12,41
20,Success,51,25,0,13,38
20,Success,44,37,0,13,31
20,Success,54,17,0,16,38
20,Success,47,28,1,11,36
20,Success,49,25,8,12,37
20,Success,53,18,2,13,40
20,Success,49,23,0,17,32
20,Success,44,32,0,15,29
20,Success,51,23,2,10,41
20,Success,51,27,0,11,40
20,Success,47,17,4,19,28
20,Success,48,27,0,14,34
20,Success,48,23,4,16,32
20,Success,46,30,0,13,33
20,Success,48,29,0,11,37
20,Success,44,29,1,14,30
20,Success,45,21,4,18,27
20,Success,55,17,0,16,39
20,Success,53,25,0,13,40
20,Success,43,34,0,10,33
20,Success,50,24,0,15,35
20,Success,53,25,0,10,43
20,Success,49,30,0,11,38
20,Success,55,19,0,8,47
20,Success,48,31,0,8,40
20,Success,44,30,0,15,29
20,Success,44,37,0,12,32
20,Success,47,33,0,13,34
20,Success,50,27,1,11,39
20,Success,51,24,0,12,39
20,Success,49,25,0,13,36
20,Success,42,39,0,13,29
20,Success,52,20,6,14,38
20,Success,53,22,5,12,41
20,Success,46,31,0,11,35
20,Success,57,23,0,10,47
20,Success,43,31,8,10,33
20,Success,53,23,0,9,44
20,Success,46,27,0,13,33
20,Success,54,27,0,9,45
20,Success,51,22,0,16,35
20,Success,52,29,0,11,41
20,Success,41,37,0,10,31
20,Success,58,23,0,8,50
20,Success,44,39,0,11,33
20,Success,50,24,2,15,35
20,Success,52,20,1,11,41
20,Success,49,21,2,14,35
20,Success,47,27,5,11,36
20,Success,50,30,0,11,39
20,Success,51,21,6,17,34
20,Success,44,25,7,17,27
20,Success,57,21,1,8,49
20,Success,46,24,1,16,30
20,Success,42,36,0,13,29
20,Success,44,27,12,9,35
20,Success,42,32,1,14,28
20,Success,46,30,0,10,36
20,Success,53,24,1,12,41
20,Success,53,23,0,12,41
20,Success,51,22,0,18,33
20,Success,47,37,0,10,37
20,Success,42,40,0,11,31
20,Success,49,23,1,13,36
20,Success,53,25,1,10,43
20,Success,43,23,8,16,27
20,Success,45,26,2,15,30
20,Success,50,34,0,9,41
20,Success,38,38,0,13,25
20,Fail,40,22,2,26,14
20,Success,38,26,8,17,21
20,Success,46,29,0,12,34
20,Success,48,28,0,13,35
20,Success,47,21,12,12,35
20,Success,43,25,3,15,28
20,Success,42,31,0,15,27
20,Success,46,36,0,14,32
20,Success,42,34,0,12,30
20,Success,52,24,1,11,41
20,Success,43,26,5,13,30
20,Success,50,21,2,14,36
20,Success,57,24,0,10,47
20,Success,54,21,0,13,41
20,Success,43,25,6,16,27
20,Success,38,41,0,14,24
20,Success,45,26,4,13,32
20,Success,52,26,0,14,38
20,Success,54,24,7,8,46
20,Success,44,28,1,17,27
20,Success,45,36,0,9,36
20,Success,47,28,0,13,34
20,Success,52,23,3,13,39
20,Success,44,34,0,11,33
20,Success,50,38,0,4,46
20,Success,48,30,1,10,38
20,Success,56,24,1,9,47
20,Success,46,28,0,13,33
20,Success,43,27,7,12,31
20,Success,54,23,0,9,45
20,Success,50,25,0,15,35
20,Success,47,23,8,14,33
20,Success,49,30,0,9,40
20,Success,52,30,0,9,43
20,Success,47,27,2,10,37
20,Success,53,21,0,15,38
20,Success,51,20,3,16,35
20,Success,46,27,0,12,34
20,Success,50,25,0,13,37
20,Success,57,18,2,9,48
20,Success,45,29,8,11,34
20,Success,51,28,0,9,42
20,Success,48,22,4,17,31
20,Success,41,36,0,10,31
20,Success,46,27,8,11,35
20,Success,49,24,0,15,34
20,Success,45,24,0,14,31
20,Success,55,19,0,12,43
20,Success,44,36,0,9,35
20,Success,45,29,0,16,29
20,Success,43,33,2,11,32
20,Success,48,27,0,13,35
20,Success,50,23,0,14,36
20,Success,44,33,0,11,33
20,Success,52,25,0,14,38
20,Success,50,22,0,14,36
20,Success,44,25,4,15,29
20,Success,44,31,0,16,28
20,Success,42,34,0,13,29
20,Success,45,28,0,15,30
20,Success,41,25,13,12,29
20,Success,45,32,0,13,32
20,Success,55,16,1,16,39
20,Success,48,29,0,10,38
20,Success,53,21,0,16,37
20,Success,44,22,7,18,26
20,Success,46,38,0,9,37
20,Success,55,22,1,11,44
20,Success,50,37,0,5,45
20,Success,53,24,0,11,42
20,Success,49,26,0,14,35
20,Success,54,21,4,11,43
20,Success,52,27,0,11,41
20,Success,47,27,1,13,34
20,Success,43,34,0,11,32
20,Success,47,16,5,20,27
20,Success,47,24,0,18,29
20,Success,44,38,0,12,32
20,Success,51,30,0,7,44
20,Success,49,26,5,8,41
20,Success,49,25,0,16,33
20,Success,44,34,0,11,33
20,Success,40,34,0,15,25
20,Success,46,31,0,13,33
20,Success,48,30,0,11,37
20,Success,52,25,1,8,44
20,Success,43,32,4,9,34
20,Success,52,16,3,16,36
20,Success,47,27,3,10,37
20,Success,40,38,0,15,25
20,Success,58,22,0,7,51
20,Success,51,19,1,18,33
20,Success,47,28,1,12,35
20,Success,52,18,3,13,39
20,Success,47,28,2,11,36
20,Success,48,26,0,13,35
20,Success,38,42,0,9,29
20,Success,55,21,5,5,50
20,Success,51,23,0,16,35
20,Success,46,21,6,16,30
20,Success,45,31,0,10,35
20,Success,53,27,0,13,40
20,Success,49,26,7,10,39
20,Success,50,20,1,15,35
20,Success,52,21,9,9,43
20,Success,40,24,9,17,23
20,Success,42,29,3,15,27
20,Success,48,27,4,11,37
20,Success,43,29,2,13,30
20,Success,51,26,0,18,33
20,Success,50,28,0,9,41
20,Success,50,29,0,9,41
20,Success,48,26,0,16,32
20,Success,53,21,4,10,43
20,Success,50,17,4,13,37
20,Success,53,27,1,8,45
20,Success,48,33,1,2,46
20,Success,55,22,0,9,46
20,Success,54,25,0,8,46
20,Success,43,30,5,12,31
20,Success,50,21,9,11,39
20,Success,46,28,0,15,31
20,Success,45,35,0,11,34
20,Success,47,31,0,16,31
20,Success,53,24,0,13,40
20,Success,46,29,0,12,34
20,Success,52,17,6,18,34
20,Success,50,17,0,19,31
20,Success,49,27,0,14,35
20,Success,50,27,0,14,36
20,Success,44,29,2,15,29
20,Success,39,29,8,11,28
20,Success,57,20,2,10,47
20,Success,49,32,0,13,36
20,Success,50,29,1,10,40
20,Success,48,20,10,13,35
20,Success,55,25,0,7,48
20,Success,50,26,0,12,38
20,Success,51,14,0,19,32
20,Success,48,27,4,14,34
20,Success,48,32,0,8,40
20,Success,47,23,6,14,33
20,Success,45,28,8,11,34
20,Success,54,21,0,15,39
20,Success,55,18,5,13,42
20,Success,44,24,10,14,30
20,Success,53,19,0,12,41
20,Success,42,29,0,16,26
20,Success,52,29,0,11,41
20,Success,54,22,6,13,41
20,Success,48,24,1,10,38
20,Success,52,25,0,13,39
20,Success,49,32,0,10,39
20,Success,51,30,0,11,40
20,Success,45,33,0,16,29
20,Success,40,25,7,18,22
20,Success,43,28,0,17,26
20,Success,46,30,0,13,33
20,Success,52,31,0,6,46
20,Success,51,29,0,10,41
20,Success,52,25,2,11,41
20,Success,43,31,0,17,26
20,Success,41,35,0,12,29
20,Success,51,13,0,24,27
20,Success,52,23,0,15,37
20,Success,43,25,10,14,29
20,Success,40,27,6,16,24
20,Success,45,26,4,13,32
20,Success,47,19,9,8,39
20,Success,38,33,6,16,22
20,Success,43,28,0,16,27
20,Success,47,28,1,12,35
20,Success,53,21,1,12,41
20,Success,45,28,9,9,36
20,Success,43,33,0,12,31
20,Success,52,18,9,12,40
20,Success,46,26,5,11,35
20,Success,45,29,0,15,30
20,Success,48,24,0,17,31
20,Success,45,32,0,11,34
20,Success,42,26,6,20,22
20,Success,47,27,10,5,42
20,Success,56,22,0,9,47
20,Success,53,21,1,12,41
20,Success,50,25,5,14,36
20,Success,44,34,0,14,30
20,Success,38,37,2,17,21
20,Success,46,27,5,11,35
20,Success,50,24,1,14,36
20,Success,48,24,8,10,38
20,Success,45,24,6,16,29
20,Success,53,22,8,12,41
20,Success,56,23,1,11,45
20,Success,52,30,0,6,46
20,Success,47,16,5,19,28
20,Success,58,19,3,11,47
20,Success,49,29,0,13,36
20,Success,49,22,0,15,34
20,Success,45,27,4,10,35
20,Success,49,31,0,11,38
20,Success,53,22,5,12,41
20,Success,45,24,0,13,32
20,Success,42,34,0,13,29
20,Success,50,27,0,14,36
20,Success,46,29,0,15,31
20,Success,53,24,0,13,40
20,Success,48,28,0,12,36
20,Success,48,24,0,18,30
20,Success,47,35,0,10,37
20,Success,53,24,0,10,43
20,Success,51,24,1,12,39
20,Success,53,25,2,9,44
20,Success,47,27,0,16,31
20,Success,48,29,0,11,37
20,Success,47,33,0,10,37
20,Success,47,27,7,10,37
20,Success,48,27,0,14,34
20,Success,41,34,3,10,31
20,Success,64,17,1,7,57
20,Success,52,21,0,12,40
20,Success,54,14,0,17,37
20,Success,54,25,0,8,46
20,Success,41,36,0,15,26
20,Success,51,19,3,18,33
20,Success,49,30,0,10,39
20,Success,46,22,3,18,28
20,Success,53,20,1,14,39
20,Success,44,35,0,16,28
20,Success,50,29,0,11,39
20,Success,52,30,0,10,42
20,Success,44,30,2,11,33
20,Success,35,47,0,14,21
20,Success,51,32,0,13,38
20,Success,42,31,8,10,32
20,Success,45,31,7,4,41
20,Success,54,25,0,7,47
20,Success,48,21,3,16,32
20,Success,45,28,3,14,31
20,Success,48,21,5,12,36
20,Success,55,23,3,9,46
20,Success,48,25,3,10,38
20,Success,48,27,0,14,34
20,Success,48,27,3,13,35
20,Success,43,34,1,12,31
20,Success,41,39,0,13,28
20,Success,47,36,0,10,37
20,Success,48,21,9,14,34
20,Success,48,32,0,10,38
20,Success,54,21,2,9,45
20,Success,51,27,4,7,44
20,Success,47,27,5,9,38
20,Success,54,27,0,10,44
20,Success,48,26,3,13,35
20,Success,53,29,0,9,44
20,Success,46,33,0,13,33
20,Success,46,35,0,10,36
20,Success,41,37,0,14,27
20,Success,45,23,12,13,32
20,Success,49,30,0,13,36
20,Success,52,20,0,18,34
20,Success,52,30,3,7,45
20,Success,53,19,2,11,42
20,Success,49,36,0,7,42
20,Success,47,34,0,12,35
20,Success,47,25,0,17,30
20,Success,54,15,9,10,44
20,Success,53,24,3,4,49
20,Success,47,27,11,6,41
20,Success,52,24,2,13,39
20,Success,54,19,0,18,36
20,Success,50,26,0,12,38
20,Success,46,29,8,8,38
20,Success,55,24,0,8,47
20,Success,48,29,0,13,35
20,Success,52,23,2,13,39
20,Success,42,26,5,17,25
20,Success,48,28,3,9,39
20,Success,45,26,2,13,32
20,Success,54,23,1,13,41
20,Success,54,20,3,10,44
20,Success,42,34,0,16,26
20,Success,45,24,6,16,29
20,Success,48,22,9,9,39
20,Success,50,21,7,12,38
20,Success,48,27,0,14,34
20,Success,49,31,0,8,41
20,Success,38,27,15,15,23
20,Success,53,26,5,7,46
20,Success,39,31,0,18,21
20,Success,52,31,0,6,46
20,Success,54,21,0,12,42
20,Success,46,31,0,13,33
20,Success,51,27,0,9,42
20,Success,54,21,0,13,41
20,Success,53,25,8,8,45
20,Success,51,21,5,14,37
20,Success,46,26,5,15,31
20,Success,42,42,0,8,34
20,Success,52,23,10,7,45
20,Success,55,24,0,12,43
20,Success,47,17,4,21,26
20,Success,46,28,0,17,29
20,Success,45,32,0,15,30
20,Success,48,27,1,15,33
20,Success,45,25,0,16,29
20,Success,47,30,1,12,35
20,Success,48,23,4,14,34
20,Success,46,38,0,7,39
20,Success,49,26,8,10,39
20,Success,42,37,0,9,33
20,Success,51,27,0,10,41
20,Success,41,28,8,11,30
20,Success,44,29,12,9,35
20,Success,48,29,1,11,37
20,Success,51,35,0,4,47
20,Success,52,24,8,10,42
20,Success,48,30,0,12,36
20,Success,43,30,0,14,29
20,Success,47,33,0,9,38
20,Success,46,33,0,8,38
20,Success,49,31,0,7,42
20,Success,45,30,0,15,30
20,Success,47,22,8,12,35
20,Success,44,30,0,18,26
20,Success,55,15,11,9,46
20,Success,49,18,3,22,27
20,Success,49,29,0,16,33
20,Success,48,32,0,12,36
20,Success,47,27,0,12,35
20,Success,51,34,0,5,46
20,Success,49,26,4,13,36
20,Success,51,26,4,10,41
20,Success,53,20,9,9,44
20,Success,51,30,2,8,43
20,Success,48,18,5,16,32
20,Success,54,23,0,12,42
20,Success,58,17,1,12,46
20,Success,54,25,1,10,44
20,Success,49,18,5,16,33
20,Success,41,31,0,15,26
20,Success,43,30,0,15,28
20,Success,53,24,5,9,44
20,Success,54,24,1,8,46
20,Success,46,26,2,16,30
20,Success,51,26,0,13,38
20,Success,46,27,0,12,34
20,Success,52,24,3,9,43
20,Success,59,17,1,10,49
20,Success,47,28,0,14,33
20,Success,43,33,0,18,25
20,Success,41,33,0,16,25
20,Success,51,27,1,8,43
20,Success,48,25,3,12,36
20,Success,48,28,0,13,35
20,Success,56,21,0,10,46
20,Success,45,23,3,15,30
20,Success,45,34,0,9,36
20,Success,52,19,9,12,40
20,Success,40,33,0,15,25
20,Success,51,19,7,13,38
20,Success,41,28,0,17,24
20,Success,42,31,2,16,26
20,Success,51,25,5,11,40
20,Success,56,16,8,13,43
20,Success,46,31,0,12,34
20,Success,49,32,0,11,38
20,Success,51,25,0,10,41
20,Success,43,25,9,14,29
20,Success,52,26,0,13,39
20,Success,54,20,3,9,45
20,Success,43,37,0,10,33
20,Success,48,30,0,13,35
20,Success,53,29,0,9,44
20,Success,42,23,4,17,25
20,Success,50,22,0,17,33
20,Success,42,35,0,14,28
20,Success,50,32,0,9,41
20,Success,50,27,0,11,39
20,Success,51,21,4,12,39
20,Success,48,26,0,12,36
20,Success,44,26,6,15,29
20,Success,53,20,1,12,41
20,Success,51,28,0,12,39
20,Success,46,28,0,14,32
20,Success,46,30,0,14,32
20,Success,51,25,1,17,34
20,Success,42,31,0,17,25
20,Success,48,27,0,13,35
20,Success,47,27,5,13,34
20,Success,51,23,1,11,40
20,Success,44,34,0,11,33
20,Success,53,22,4,8,45
20,Success,50,28,0,11,39
20,Success,45,39,0,9,36
20,Success,44,31,0,15,29
20,Success,46,23,8,15,31
20,Success,46,25,6,13,33
20,Success,50,21,1,15,35
20,Success,41,36,0,14,27
20,Success,46,34,0,9,37
20,Success,50,22,2,15,35
20,Success,47,32,0,9,38
20,Success,41,34,0,15,26
20,Success,44,30,0,17,27
20,Success,45,25,7,14,31
20,Success,55,22,0,10,45
20,Success,48,30,0,12,36
20,Success,45,33,0,10,35
20,Success,44,29,0,15,29
20,Success,49,27,6,9,40
20,Success,46,30,1,14,32
20,Success,52,29,0,10,42
20,Success,51,25,3,8,43
20,Success,42,31,0,22,20
20,Success,40,31,9,14,26
20,Success,53,28,0,13,40
20,Success,47,30,0,15,32
20,Success,47,27,0,14,33
20,Success,44,35,0,13,31
20,Success,46,28,0,16,30
20,Success,58,17,3,10,48
20,Success,55,20,0,9,46
20,Success,50,26,0,12,38
20,Success,50,26,0,11,39
20,Success,48,25,4,13,35
20,Success,53,21,0,14,39
20,Success,47,25,7,15,32
20,Success,51,37,0,6,45
20,Success,52,22,5,11,41
20,Success,48,26,4,13,35
20,Success,55,24,0,12,43
20,Success,43,34,0,14,29
20,Success,53,24,0,10,43
20,Success,46,24,11,10,36
20,Success,51,25,4,10,41
20,Success,51,22,1,15,36
20,Success,46,29,4,12,34
20,Success,46,30,0,15,31
20,Success,47,23,3,14,33
20,Success,50,28,0,11,39
20,Success,45,37,0,10,35
20,Success,52,20,5,13,39
20,Success,54,30,0,7,47
20,Success,43,21,12,13,30
20,Success,45,29,0,14,31
20,Success,49,23,4,12,37
20,Fail,38,29,0,25,13
20,Success,58,19,0,10,48
20,Success,46,24,7,13,33
20,Success,46,31,0,13,33
20,Success,50,23,0,17,33
20,Success,47,26,3,13,34
20,Success,46,31,2,9,37
20,Success,56,25,0,8,48
20,Success,49,24,4,12,37
20,Success,49,26,7,9,40
20,Success,53,28,2,10,43
20,Success,44,28,5,18,26
20,Success,45,28,1,14,31
20,Success,51,26,0,11,40
20,Success,49,29,0,13,36
20,Success,49,20,8,14,35
20,Success,47,33,0,12,35
20,Success,49,32,0,8,41
20,Success,46,35,0,8,38
20,Success,47,30,0,15,32
20,Success,53,22,1,11,42
20,Success,48,32,0,9,39
20,Success,45,26,2,16,29
20,Success,49,31,0,9,40
20,Success,43,34,3,7,36
20,Success,49,22,3,9,40
20,Success,43,30,0,14,29
20,Success,50,26,0,14,36
20,Success,50,27,5,7,43
20,Success,46,32,0,10,36
20,Success,48,28,0,14,34
20,Success,44,28,9,11,33
20,Success,52,29,0,7,45
20,Success,54,27,1,7,47
20,Success,53,23,7,9,44
20,Fail,38,31,0,21,17
20,Success,53,23,0,11,42
20,Success,51,27,0,12,39
20,Success,46,32,0,14,32
20,Success,47,29,0,14,33
20,Success,41,28,0,18,23
20,Success,46,19,6,16,30
20,Success,49,18,0,18,31
20,Success,55,21,0,10,45
20,Success,52,24,5,12,40
20,Success,47,29,0,13,34
20,Success,49,32,0,6,43
20,Success,46,35,0,11,35
20,Success,48,37,0,10,38
20,Success,48,27,1,12,36
20,Success,57,17,1,11,46
20,Success,47,26,0,14,33
20,Success,48,23,0,16,32
20,Success,53,24,0,11,42
20,Success,56,16,0,10,46
20,Success,53,25,0,11,42
20,Success,48,30,0,12,36
20,Success,47,21,11,18,29
20,Success,47,30,0,11,36
20,Success,46,24,3,12,34
20,Success,47,31,0,11,36
20,Success,44,31,5,11,33
20,Success,54,22,0,10,44
20,Success,40,32,8,11,29
20,Success,47,28,0,13,34
20,Success,48,31,3,7,41
20,Success,48,34,0,7,41
20,Success,62,23,0,7,55
20,Success,45,31,0,14,31
20,Success,53,25,0,10,43
20,Success,47,22,7,13,34
20,Success,41,26,5,19,22
20,Success,56,21,0,13,43
20,Success,50,28,4,12,38
20,Success,47,39,0,8,39
20,Success,45,30,1,13,32
20,Success,52,27,0,7,45
20,Success,48,23,5,11,37
20,Success,46,26,9,8,38
20,Success,53,20,1,13,40
20,Success,47,26,6,13,34
20,Success,53,27,0,11,42
20,Success,53,24,2,8,45
20,Success,49,21,4,16,33
20,Success,52,28,0,9,43
20,Success,52,29,0,8,44
20,Success,55,26,0,9,46
20,Success,45,27,7,13,32
20,Success,48,29,0,12,36
20,Success,49,24,0,17,32
20,Success,47,22,0,14,33
20,Success,51,33,0,6,45
20,Success,60,14,1,16,44
20,Success,57,21,0,11,46
20,Success,37,35,7,13,24
20,Success,44,33,0,15,29
20,Success,43,22,5,22,21
20,Success,53,26,0,11,42
20,Success,46,17,6,20,26
20,Success,48,30,1,11,37
20,Success,42,25,8,15,27
20,Success,54,22,0,13,41
20,Success,55,20,0,12,43
20,Success,44,32,0,14,30
20,Success,45,26,0,17,28
20,Success,43,32,0,12,31
20,Success,51,27,6,10,41
20,Success,47,31,0,14,33
20,Success,43,29,4,13,30
20,Success,51,21,1,13,38
20,Success,50,18,7,13,37
20,Success,44,33,0,14,30
20,Success,40,26,6,19,21
20,Success,45,28,0,20,25
20,Success,47,26,0,14,33
20,Success,49,23,2,11,38
20,Success,46,27,2,15,31
20,Success,48,31,0,12,36
20,Success,52,28,2,8,44
20,Success,48,35,0,5,43
20,Success,44,43,0,9,35
20,Fail,37,31,6,19,18
20,Fail,39,26,6,20,19
20,Success,53,20,3,14,39
20,Success,49,24,1,11,38
20,Success,46,31,0,13,33
20,Success,48,30,0,11,37
20,Success,47,26,6,14,33
20,Success,49,33,0,10,39
20,Success,47,21,1,18,29
20,Success,47,23,0,12,35
20,Success,57,25,1,7,50
20,Success,47,24,5,12,35
20,Success,44,25,3,22,22
20,Success,45,26,5,13,32
20,Success,48,30,1,10,38
20,Success,52,23,1,10,42
20,Success,50,30,7,7,43
20,Success,45,27,5,14,31
20,Success,51,25,12,8,43
20,Success,52,26,3,9,43
20,Success,47,30,0,11,36
20,Success,55,25,0,12,43
20,Success,53,24,0,11,42
20,Success,54,21,5,7,47
20,Success,50,25,0,12,38
20,Success,51,28,0,8,43
20,Success,46,30,1,10,36
20,Success,43,40,0,11,32
20,Success,46,24,0,20,26
20,Success,47,24,0,14,33
20,Success,47,29,5,13,34
20,Success,49,28,0,10,39
20,Success,47,31,0,12,35
20,Success,46,24,3,14,32
20,Success,44,40,0,11,33
20,Success,43,26,7,16,27
20,Success,37,35,0,17,20
20,Success,46,31,0,15,31
20,Success,43,34,0,14,29
20,Success,47,27,0,12,35
20,Success,46,27,8,12,34
20,Success,56,21,0,12,44
20,Success,51,27,0,9,42
20,Success,57,22,1,8,49
20,Success,46,35,0,12,34
20,Success,58,24,0,10,48
20,Success,46,27,0,18,28
20,Success,44,35,3,9,35
20,Success,47,28,0,16,31
20,Success,42,31,6,15,27
20,Success,37,32,3,17,20
20,Success,49,23,4,13,36
20,Success,49,25,2,9,40
20,Success,49,27,0,13,36
20,Success,53,22,0,14,39
20,Success,47,26,3,12,35
20,Success,46,33,0,11,35
20,Success,42,27,6,16,26
20,Success,42,35,0,15,27
20,Success,56,25,3,7,49
20,Success,48,31,2,10,38
20,Success,50,21,6,12,38
20,Success,46,33,5,5,41
20,Success,47,31,0,15,32
20,Fail,40,24,8,21,19
20,Success,39,31,3,17,22
20,Success,50,24,6,7,43
20,Success,44,33,0,10,34
20,Success,54,21,1,14,40
20,Success,47,28,0,16,31
20,Success,43,30,4,13,30
20,Success,51,31,0,9,42
20,Success,48,38,0,6,42
20,Success,52,23,4,10,42
20,Success,49,26,3,14,35
20,Success,49,21,0,16,33
20,Success,39,38,0,13,26
20,Success,48,25,0,13,35
20,Success,56,21,0,11,45
20,Success,44,36,0,13,31
20,Success,50,23,10,7,43
20,Success,46,29,2,13,33
20,Success,48,25,1,11,37
20,Success,41,29,5,14,27
20,Success,53,25,0,15,38
20,Success,46,28,1,10,36
20,Success,49,24,0,14,35
20,Success,51,22,0,12,39
20,Success,47,26,0,17,30
20,Success,42,41,0,11,31
20,Success,50,28,2,10,40
20,Success,49,21,1,15,34
20,Success,45,29,0,14,31
20,Success,43,27,8,12,31
20,Success,53,18,0,17,36
20,Success,53,25,0,10,43
20,Success,56,18,4,13,43
20,Success,47,27,0,17,30
20,Success,47,28,0,14,33
20,Success,53,30,0,10,43
20,Success,49,24,0,14,35
20,Success,43,35,0,15,28
20,Success,46,29,0,12,34
20,Success,40,31,8,10,30
20,Success,43,28,2,13,30
20,Success,44,36,0,13,31
20,Success,53,28,0,8,45
20,Success,55,21,4,11,44
20,Success,46,29,0,14,32
20,Success,45,25,2,14,31
20,Success,48,26,0,14,34
20,Success,47,19,2,21,26
20,Success,43,31,2,13,30
20,Success,53,22,0,9,44
20,Success,53,21,5,7,46
20,Success,50,32,0,7,43
20,Success,49,25,0,15,34
20,Success,54,22,1,10,44
20,Success,43,20,8,18,25
20,Success,44,35,0,10,34
20,Success,49,32,0,10,39
20,Success,43,31,2,12,31
20,Success,48,28,1,12,36
20,Success,50,31,0,10,40
20,Success,54,26,5,6,48
20,Success,54,18,0,11,43
20,Success,43,35,0,14,29
20,Success,42,22,7,14,28
20,Success,52,24,0,13,39
20,Success,48,27,0,14,34
20,Success,44,30,5,12,32
20,Success,54,21,0,17,37
20,Success,46,28,1,9,37
20,Success,43,32,0,15,28
20,Success,40,27,6,19,21
20,Success,55,30,0,4,51
20,Success,47,26,0,14,33
20,Success,51,28,4,8,43
20,Success,58,21,0,10,48
20,Success,53,21,0,13,40
20,Success,42,31,8,11,31
20,Success,48,24,1,17,31
20,Success,52,22,0,16,36
20,Success,51,26,1,14,37
20,Success,49,24,0,11,38
20,Success,44,31,5,12,32
20,Success,49,31,0,6,43
20,Success,42,36,0,8,34
20,Success,43,28,0,15,28
20,Success,47,28,1,13,34
20,Success,54,23,1,12,42
20,Success,48,28,0,16,32
20,Success,54,21,0,11,43
20,Success,47,34,0,10,37
20,Success,55,20,1,12,43
20,Success,57,20,6,10,47
20,Success,51,27,0,10,41
20,Success,44,25,8,13,31
20,Success,41,39,0,13,28
20,Success,48,29,3,10,38
20,Success,55,24,0,10,45
20,Success,52,25,2,10,42
20,Success,44,29,0,16,28
20,Success,58,17,2,8,50
20,Success,49,33,0,13,36
20,Success,45,26,0,16,29
20,Success,44,23,8,17,27
20,Success,50,30,4,7,43
20,Success,56,20,5,12,44
20,Success,43,29,6,11,32
20,Success,49,23,7,14,35
20,Success,52,24,0,11,41
20,Success,49,28,2,11,38
20,Success,50,22,3,16,34
20,Success,47,34,0,8,39
20,Success,42,34,5,13,29
20,Success,49,26,5,14,35
20,Success,47,29,1,10,37
20,Success,59,20,0,12,47
20,Success,46,26,4,11,35
20,Success,48,19,0,14,34
20,Success,43,32,2,11,32
20,Success,43,27,6,16,27
20,Success,49,28,1,12,37
20,Success,46,20,7,16,30
20,Success,47,25,3,17,30
20,Success,47,28,0,11,36
20,Success,40,35,0,14,26
20,Success,53,28,2,6,47
20,Success,48,32,0,8,40
20,Success,56,15,1,14,42
20,Success,40,25,5,19,21
20,Success,57,22,0,10,47
20,Success,51,25,0,14,37
20,Success,52,18,3,13,39
20,Success,52,20,9,12,40
20,Success,53,20,1,14,39
20,Success,52,32,0,5,47
20,Success,48,26,0,12,36
20,Success,54,20,0,16,38
20,Success,44,23,1,20,24
20,Success,49,23,1,15,34
20,Success,49,30,0,9,40
20,Success,50,20,2,15,35
20,Success,48,29,0,9,39
20,Success,48,29,0,14,34
20,Success,47,20,7,16,31
20,Success,46,33,0,12,34
20,Success,44,31,0,16,28
20,Success,52,17,3,13,39
20,Success,48,29,0,14,34
20,Success,54,25,3,13,41
20,Success,46,35,0,7,39
20,Success,46,18,5,21,25
20,Success,42,31,0,13,29
20,Success,45,29,0,15,30
20,Success,41,25,10,16,25
20,Success,48,27,1,12,36
20,Success,48,31,3,10,38
20,Success,45,27,0,19,26
20,Success,50,29,0,14,36
20,Success,49,22,5,16,33
20,Success,55,22,1,6,49
20,Success,51,19,2,13,38
20,Success,48,30,0,10,38
20,Success,50,24,0,17,33
20,Success,42,35,1,11,31
20,Success,46,32,2,12,34
20,Fail,42,22,0,24,18
20,Success,52,20,4,18,34
20,Success,42,32,0,12,30
20,Success,50,27,3,10,40
20,Success,41,31,0,17,24
20,Success,47,30,0,11,36
20,Success,44,36,0,11,33
20,Success,45,36,0,14,31
20,Success,49,34,0,11,38
20,Success,53,24,0,12,41
20,Success,43,27,6,13,30
20,Success,47,28,5,10,37
20,Success,49,25,1,14,35
20,Success,45,29,5,10,35
20,Success,51,25,0,11,40
20,Success,48,25,4,12,36
20,Success,45,33,0,8,37
20,Success,45,22,4,18,27
20,Success,43,28,0,18,25
20,Success,46,23,7,17,29
20,Success,39,34,2,11,28
20,Success,52,19,6,11,41
20,Success,44,25,10,15,29
20,Success,51,18,1,16,35
20,Success,47,34,0,10,37
20,Success,49,27,4,10,39
20,Success,45,29,2,10,35
20,Success,53,23,0,14,39
20,Success,47,27,0,16,31
20,Fail,36,33,8,17,19
20,Success,43,38,0,10,33
20,Success,51,25,0,14,37
20,Success,45,28,4,14,31
20,Success,43,28,0,18,25
20,Success,44,23,3,18,26
20,Success,49,33,0,10,39
20,Success,55,22,0,11,44
20,Success,50,24,0,13,37
20,Success,52,23,6,11,41
20,Success,48,30,3,11,37
20,Success,58,20,0,9,49
20,Success,54,21,1,12,42
20,Success,46,22,2,19,27
20,Success,41,25,3,18,23
20,Success,48,20,12,11,37
20,Success,45,34,0,9,36
20,Fail,39,28,0,22,17
20,Success,54,25,0,10,44
20,Success,50,26,0,7,43
20,Success,40,24,9,17,23
20,Success,54,23,1,12,42
20,Success,47,30,0,10,37
20,Success,52,24,0,14,38
20,Success,48,26,0,12,36
20,Success,48,36,0,9,39
20,Success,48,22,7,14,34
20,Success,44,33,10,6,38
20,Success,50,31,2,9,41
20,Success,51,20,2,17,34
20,Success,50,28,0,10,40
20,Success,45,21,7,16,29
20,Success,55,19,0,15,40
20,Success,51,25,0,8,43
20,Success,45,28,0,13,32
20,Success,47,37,0,8,39
20,Success,44,24,1,17,27
20,Success,50,27,0,15,35
20,Success,46,27,0,14,32
20,Success,36,38,6,13,23
20,Success,49,24,1,11,38
20,Success,51,29,0,10,41
20,Success,43,26,6,12,31
20,Success,42,36,0,12,30
20,Success,52,32,0,8,44
20,Success,50,28,0,10,40
20,Success,60,18,0,13,47
20,Success,49,32,3,11,38
20,Success,47,35,0,8,39
20,Success,56,18,0,16,40
20,Success,49,21,12,12,37
20,Fail,40,30,3,21,19
20,Success,43,28,0,18,25
20,Success,41,39,0,14,27
20,Success,45,36,0,8,37
20,Success,46,28,0,16,30
20,Success,43,35,0,15,28
20,Success,48,30,4,11,37
20,Success,53,23,0,13,40
20,Success,54,23,3,8,46
20,Success,42,31,0,14,28
20,Success,36,38,7,11,25
20,Success,46,35,1,7,39
20,Success,50,21,4,18,32
20,Success,57,22,0,11,46
20,Success,52,18,4,14,38
20,Success,55,26,0,9,46
20,Success,56,24,0,7,49
20,Success,42,32,7,12,30
20,Success,44,20,7,18,26
20,Success,45,25,0,17,28
20,Success,49,25,2,14,35
20,Success,45,33,0,15,30
20,Fail,33,45,0,14,19
20,Success,42,36,2,7,35
20,Success,43,24,8,14,29
20,Success,47,32,0,9,38
20,Success,45,31,0,14,31
20,Success,49,28,0,12,37
20,Success,44,28,0,13,31
20,Success,43,24,0,19,24
20,Success,58,15,0,17,41
20,Success,56,22,0,11,45
20,Success,40,45,0,8,32
20,Success,52,22,0,12,40
20,Success,48,26,1,11,37
20,Success,50,24,1,13,37
20,Success,46,27,1,12,34
20,Success,51,27,1,12,39
20,Success,49,27,3,14,35
20,Success,46,27,0,13,33
20,Success,46,28,1,14,32
20,Success,44,34,0,13,31
20,Success,44,20,10,15,29
20,Success,51,29,0,13,38
20,Success,44,33,0,10,34
20,Success,47,30,0,16,31
20,Success,43,25,5,15,28
20,Success,44,28,11,10,34
20,Success,45,25,7,15,30
20,Success,47,27,0,14,33
20,Success,45,34,1,10,35
20,Success,54,21,1,13,41
20,Success,49,26,4,11,38
20,Success,53,28,0,10,43
20,Success,44,26,3,15,29
20,Success,47,36,0,8,39
20,Success,50,29,0,7,43
20,Success,47,42,0,6,41
20,Success,44,34,0,13,31
20,Success,50,26,6,6,44
20,Success,47,29,0,11,36
20,Success,48,21,6,16,32
20,Success,49,24,0,16,33
20,Success,44,28,8,8,36
20,Success,44,31,0,17,27
20,Success,48,25,2,11,37
20,Success,50,27,0,9,41
20,Success,46,29,6,9,37
20,Success,47,33,0,10,37
20,Success,51,23,2,11,40
20,Success,54,20,5,12,42
20,Success,49,27,1,12,37
20,Success,49,20,10,14,35
20,Success,45,24,2,17,28
20,Success,48,25,0,19,29
20,Success,42,31,3,14,28
20,Success,53,25,1,12,41
20,Success,53,22,0,13,40
20,Success,54,22,4,15,39
20,Success,51,27,0,11,40
20,Success,46,28,5,11,35
20,Success,43,33,0,11,32
20,Success,43,33,0,10,33
20,Success,47,27,0,12,35
20,Success,53,25,0,6,47
20,Success,50,27,0,8,42
20,Success,43,33,5,11,32
20,Success,42,38,0,12,30
20,Success,48,27,5,10,38
20,Success,50,27,3,9,41
20,Success,51,27,4,8,43
20,Success,45,27,2,14,31
20,Success,51,24,4,9,42
20,Success,54,24,0,8,46
20,Success,50,31,0,10,40
20,Success,46,27,7,12,34
20,Success,48,25,0,14,34
20,Success,55,26,2,8,47
20,Success,45,30,0,17,28
20,Success,48,33,0,10,38
20,Success,50,34,0,9,41
20,Success,51,21,1,16,35
20,Success,45,37,0,9,36
20,Success,51,24,5,12,39
20,Success,50,22,0,13,37
20,Success,56,22,3,9,47
20,Success,49,24,3,14,35
20,Success,50,19,2,14,36
20,Success,49,30,0,11,38
20,Success,41,30,3,12,29
20,Success,46,26,0,17,29
20,Success,42,27,8,14,28
20,Success,45,28,4,13,32
20,Success,45,34,0,14,31
20,Success,46,28,4,12,34
20,Success,42,29,0,16,26
20,Success,61,21,1,6,55
20,Success,44,35,2,9,35
20,Success,53,26,0,12,41
20,Success,49,23,4,12,37
20,Success,43,34,0,14,29
20,Success,45,27,0,17,28
20,Success,53,21,6,11,42
20,Success,46,20,0,16,30
20,Success,47,27,1,15,32
20,Success,46,30,0,14,32
20,Success,47,25,5,14,33
20,Success,46,32,0,15,31
20,Success,48,29,6,7,41
20,Success,54,19,8,10,44
20,Success,49,25,1,10,39
20,Success,47,24,0,19,28
20,Success,47,29,0,17,30
20,Success,47,28,0,13,34
20,Success,52,23,6,4,48
20,Success,44,25,0,18,26
20,Success,45,26,8,15,30
20,Success,50,27,2,8,42
20,Success,59,16,4,9,50
20,Success,51,29,0,13,38
20,Success,49,31,0,11,38
20,Success,49,28,0,10,39
20,Success,42,36,0,15,27
20,Success,43,26,0,17,26
20,Success,44,22,8,15,29
20,Success,45,29,1,13,32
20,Success,42,36,0,13,29
20,Success,57,22,0,11,46
20,Success,48,28,0,13,35
20,Success,53,18,0,15,38
20,Success,43,28,0,20,23
20,Success,47,26,3,13,34
20,Success,45,30,4,10,35
20,Success,48,25,2,12,36
20,Success,51,25,1,10,41
20,Success,42,26,13,9,33
20,Success,50,33,0,9,41
20,Success,50,21,4,17,33
20,Success,51,27,3,10,41
20,Success,51,31,0,8,43
20,Success,50,27,0,11,39
20,Success,49,30,0,9,40
20,Success,51,26,0,12,39
20,Success,56,24,0,6,50
20,Success,54,23,0,13,41
20,Success,58,17,0,11,47
20,Success,51,24,0,13,38
20,Success,58,20,1,6,52
20,Success,55,24,1,10,45
20,Success,48,29,0,15,33
20,Success,46,28,6,12,34
20,Success,42,35,0,16,26
20,Success,57,20,0,12,45
20,Success,47,32,0,10,37
20,Success,52,22,1,8,44
20,Success,48,27,4,12,36
20,Success,49,30,0,10,39
20,Success,39,21,22,11,28
20,Success,44,30,0,17,27
20,Success,40,33,0,15,25
20,Success,56,19,0,12,44
20,Success,49,27,0,14,35
20,Success,55,21,4,12,43
20,Success,48,25,8,8,40
20,Success,47,30,3,9,38
20,Success,53,22,0,11,42
20,Success,48,29,0,11,37
20,Success,48,25,0,17,31
20,Success,48,21,2,17,31
20,Success,46,30,0,13,33
20,Success,54,22,5,8,46
20,Success,45,35,0,7,38
20,Success,37,30,7,16,21
20,Success,40,38,0,13,27
20,Success,46,31,2,11,35
20,Success,42,29,2,14,28
20,Success,44,31,0,12,32
20,Success,50,25,0,15,35
20,Success,49,25,3,7,42
20,Success,49,33,0,8,41
20,Success,52,24,0,13,39
20,Success,44,35,0,11,33
20,Success,50,34,0,6,44
20,Success,43,35,0,15,28
20,Success,44,32,0,12,32
20,Success,49,27,2,15,34
20,Success,46,35,0,12,34
20,Success,46,31,0,15,31
20,Success,47,24,5,12,35
20,Success,48,26,1,13,35
20,Fail,40,32,0,24,16
20,Success,44,36,0,13,31
20,Success,48,25,2,13,35
20,Success,43,41,0,13,30
20,Success,49,28,0,10,39
20,Success,47,31,0,12,35
20,Success,43,36,0,12,31
20,Success,48,25,2,15,33
20,Success,49,28,0,12,37
20,Success,47,27,0,15,32
20,Success,51,28,0,12,39
20,Success,56,25,0,7,49
20,Success,46,31,0,13,33
20,Success,41,29,0,19,22
20,Success,54,23,4,8,46
20,Success,51,25,2,10,41
20,Success,43,30,5,10,33
20,Success,49,28,1,10,39
20,Success,55,21,2,15,40
20,Success,45,31,0,12,33
20,Success,55,20,0,15,40
20,Success,43,31,0,16,27
20,Success,50,25,0,10,40
20,Success,42,27,4,15,27
20,Success,40,31,0,20,20
20,Success,51,24,1,13,38
20,Success,50,31,0,12,38
20,Success,47,29,2,9,38
20,Success,46,34,0,11,35
20,Success,50,17,7,15,35
20,Success,44,33,0,11,33
20,Success,44,26,8,11,33
20,Success,50,27,0,11,39
20,Success,52,27,0,12,40
20,Success,45,28,0,15,30
20,Success,45,27,7,13,32
20,Success,48,25,2,14,34
20,Success,44,27,5,12,32
20,Success,56,27,2,3,53
20,Success,49,36,0,5,44
20,Success,48,33,0,7,41
20,Success,47,28,0,15,32
20,Success,51,27,0,12,39
20,Success,48,24,2,14,34
20,Success,50,23,0,15,35
20,Success,46,30,0,13,33
20,Success,47,24,0,20,27
20,Success,47,30,0,9,38
20,Success,48,27,3,11,37
20,Success,51,36,0,7,44
20,Success,47,30,1,12,35
20,Success,49,23,2,14,35
20,Success,50,33,0,9,41
20,Success,47,22,5,14,33
20,Success,51,21,6,10,41
20,Success,55,23,0,12,43
20,Success,50,28,0,12,38
20,Success,48,23,9,15,33
20,Success,47,28,0,13,34
20,Success,46,23,4,19,27
20,Success,50,27,2,14,36
20,Success,50,22,1,13,37
20,Success,45,30,0,15,30
20,Success,47,28,0,14,33
20,Success,56,16,3,15,41
20,Success,45,34,0,11,34
20,Success,57,17,0,13,44
20,Success,50,18,5,15,35
20,Success,48,28,0,14,34
20,Success,47,38,0,7,40
20,Success,54,15,1,15,39
20,Success,58,23,3,4,54
20,Success,40,30,3,14,26
20,Success,48,30,0,10,38
20,Fail,38,37,0,19,19
20,Success,51,23,0,15,36
20,Fail,42,23,0,23,19
20,Success,50,29,0,12,38
20,Success,48,26,3,12,36
20,Success,49,19,6,20,29
20,Success,47,26,7,12,35
20,Success,49,26,3,10,39
20,Success,44,28,8,12,32
20,Success,57,22,0,9,48
20,Success,45,30,0,14,31
20,Success,53,24,0,12,41
20,Success,50,26,2,10,40
20,Success,50,32,0,8,42
20,Success,46,25,0,15,31
20,Success,54,28,0,7,47
20,Success,50,22,0,15,35
20,Success,52,26,8,8,44
20,Success,57,19,0,11,46
20,Success,51,21,10,9,42
20,Success,45,36,0,12,33
20,Success,49,26,0,12,37
20,Success,47,28,5,12,35
20,Success,50,23,2,14,36
20,Success,51,22,2,15,36
20,Success,45,35,0,11,34
20,Fail,36,29,11,18,18
20,Success,50,25,0,13,37
20,Success,49,30,0,10,39
20,Success,52,23,3,12,40
20,Success,46,35,0,10,36
20,Success,43,38,0,6,37
20,Success,49,29,0,9,40
20,Success,46,31,3,13,33
20,Success,52,21,1,14,38
20,Success,45,30,0,11,34
20,Success,50,21,0,18,32
20,Success,49,18,9,14,35
20,Success,41,27,4,18,23
20,Success,47,26,3,11,36
20,Success,46,29,5,11,35
20,Success,50,27,4,9,41
20,Success,46,33,5,9,37
20,Success,49,23,0,15,34
20,Success,51,25,0,14,37
20,Success,52,29,0,10,42
20,Success,48,16,6,15,33
20,Success,44,30,0,11,33
20,Success,49,31,0,8,41
20,Success,53,31,0,5,48
20,Success,55,23,0,8,47
20,Success,50,27,1,10,40
20,Success,56,20,0,8,48
20,Success,46,30,0,10,36
20,Success,39,40,0,10,29
20,Success,49,24,6,10,39
20,Success,48,24,5,14,34
20,Success,50,32,0,9,41
20,Success,46,26,0,19,27
20,Success,51,27,0,13,38
20,Success,53,27,0,10,43
20,Success,53,22,2,9,44
20,Success,50,19,0,18,32
20,Success,50,28,2,11,39
20,Success,46,25,1,14,32
20,Success,46,27,0,12,34
20,Success,46,31,0,14,32
20,Success,43,41,0,9,34
20,Success,46,26,0,14,32
20,Success,51,21,0,16,35
20,Success,43,30,0,19,24
20,Success,51,23,7,10,41
20,Success,53,23,0,13,40
20,Success,48,21,8,12,36
20,Success,52,22,5,14,38
20,Success,47,27,0,12,35
20,Success,45,29,2,13,32
20,Success,47,31,0,11,36
20,Success,39,28,14,15,24
20,Success,42,27,6,18,24
20,Success,49,28,0,9,40
20,Success,46,29,2,11,35
20,Success,51,19,0,16,35
20,Success,54,27,0,11,43
20,Success,47,24,4,12,35
20,Success,56,28,1,7,49
20,Success,49,27,0,13,36
20,Success,49,25,2,12,37
20,Success,51,27,6,7,44
20,Success,49,29,0,14,35
20,Success,43,27,0,22,21
20,Success,48,28,0,12,36
20,Success,55,23,0,10,45
20,Success,45,30,0,12,33
20,Success,49,32,0,9,40
20,Success,44,36,0,10,34
20,Success,49,29,0,15,34
20,Success,46,29,0,16,30
20,Success,52,21,0,13,39
20,Success,53,26,0,7,46
20,Success,48,17,10,14,34
20,Success,53,24,0,10,43
20,Success,52,28,0,14,38
20,Success,50,27,0,17,33
20,Success,54,19,1,12,42
20,Success,48,29,0,13,35
20,Success,46,23,3,18,28
20,Success,47,28,0,12,35
20,Success,57,21,0,11,46
20,Success,43,33,0,12,31
20,Success,47,22,3,19,28
20,Success,51,22,3,14,37
20,Success,54,25,0,6,48
20,Success,50,31,0,6,44
20,Success,42,24,16,13,29
20,Success,47,38,0,7,40
20,Success,50,21,0,18,32
20,Success,46,22,14,10,36
20,Success,43,31,4,15,28
20,Success,45,26,3,14,31
20,Success,52,21,2,12,40
20,Success,50,33,0,9,41
20,Success,49,28,0,13,36
20,Success,50,26,0,10,40
20,Success,43,30,4,11,32
20,Success,44,23,8,15,29
20,Success,50,20,4,13,37
20,Success,45,23,0,18,27
20,Success,49,21,3,11,38
20,Success,58,18,1,11,47
20,Success,50,25,3,10,40
20,Success,50,26,0,17,33
20,Success,51,19,2,17,34
20,Success,43,29,0,14,29
20,Success,48,21,7,13,35
20,Success,51,22,3,11,40
20,Success,44,29,6,9,35
20,Success,50,23,1,14,36
20,Success,49,23,4,17,32
20,Success,51,26,0,11,40
20,Success,45,31,0,12,33
20,Success,51,24,4,12,39
20,Success,47,33,3,7,40
20,Success,51,19,5,15,36
20,Success,50,25,1,13,37
20,Success,54,22,3,9,45
20,Success,40,31,1,15,25
20,Success,41,34,5,9,32
20,Success,43,31,0,18,25
20,Success,51,19,3,11,40
20,Success,50,25,0,11,39
20,Success,48,32,0,10,38
20,Success,51,25,5,9,42
20,Success,48,24,5,14,34
20,Success,52,30,0,9,43
20,Success,49,20,6,12,37
20,Success,47,24,5,13,34
20,Success,48,33,0,9,39
20,Success,51,19,1,16,35
20,Success,45,21,6,16,29
20,Success,48,26,0,12,36
20,Success,37,35,6,13,24
20,Success,44,24,0,20,24
20,Success,54,27,0,10,44
20,Success,39,31,7,13,26
20,Success,54,22,0,14,40
20,Success,45,29,0,17,28
20,Success,47,25,0,20,27
20,Success,51,32,0,8,43
20,Success,47,22,3,15,32
20,Success,42,38,0,9,33
20,Success,48,29,2,11,37
20,Success,48,26,3,13,35
20,Success,41,38,0,12,29
20,Success,49,24,0,17,32
20,Success,60,17,3,8,52
20,Success,45,26,4,14,31
20,Success,48,22,10,6,42
20,Success,49,29,3,9,40
20,Success,48,31,0,8,40
20,Success,50,23,4,13,37
20,Success,50,24,0,16,34
20,Success,48,25,5,11,37
20,Success,53,32,0,5,48
20,Success,56,25,0,12,44
20,Success,45,29,8,12,33
20,Success,47,22,5,15,32
20,Success,46,31,0,15,31
20,Success,45,27,0,16,29
20,Success,48,22,4,14,34
20,Success,46,35,0,14,32
20,Success,52,29,0,9,43
20,Success,47,25,0,16,31
20,Success,51,20,3,17,34
20,Success,52,25,2,8,44
20,Success,49,23,7,13,36
20,Success,46,23,5,16,30
20,Success,41,34,0,19,22
20,Success,48,35,0,13,35
20,Success,45,23,0,19,26
20,Success,44,28,9,8,36
20,Success,46,23,5,13,33
20,Success,49,23,0,13,36
20,Success,52,25,8,6,46
20,Success,50,26,1,13,37
20,Success,51,27,0,9,42
20,Success,44,29,8,13,31
20,Success,52,23,0,14,38
20,Fail,35,42,0,16,19
20,Success,53,27,0,13,40
20,Success,51,28,0,12,39
20,Success,54,20,0,14,40
20,Success,46,32,4,13,33
20,Success,55,16,9,12,43
20,Success,43,40,0,11,32
20,Success,47,25,3,17,30
20,Success,52,24,0,11,41
20,Success,56,18,3,12,44
20,Success,44,25,0,22,22
20,Success,46,28,0,20,26
20,Success,58,22,0,9,49
20,Success,40,40,0,12,28
20,Success,50,27,4,8,42
20,Success,49,29,0,14,35
20,Success,54,28,0,8,46
20,Success,48,22,2,15,33
20,Success,51,31,0,11,40
20,Success,46,24,0,14,32
20,Success,53,25,0,9,44
20,Success,42,36,0,15,27
20,Success,52,21,3,15,37
20,Success,46,31,8,7,39
20,Success,47,37,0,7,40
20,Success,43,30,0,17,26
20,Success,51,26,0,13,38
20,Success,56,20,0,13,43
20,Success,52,14,11,12,40
20,Success,49,27,2,9,40
20,Success,56,23,3,8,48
20,Success,49,25,3,13,36
20,Success,50,25,1,12,38
20,Success,42,35,0,15,27
20,Success,53,24,6,10,43
20,Success,52,25,3,12,40
20,Success,53,23,0,13,40
20,Success,47,25,0,14,33
20,Success,52,18,0,14,38
20,Success,42,30,7,12,30
20,Success,49,24,0,17,32
20,Success,55,21,0,12,43
20,Success,50,38,0,5,45
20,Success,55,23,2,9,46
20,Success,48,30,0,9,39
20,Success,42,30,9,13,29
20,Success,48,24,2,16,32
20,Success,50,24,6,4,46
20,Success,48,24,2,14,34
20,Success,53,21,0,15,38
20,Success,49,23,2,17,32
20,Success,54,23,2,9,45
20,Success,43,40,0,11,32
20,Success,48,25,2,16,32
20,Success,42,26,11,12,30
20,Success,60,17,0,8,52
20,Success,47,30,1,12,35
20,Success,40,31,0,16,24
20,Success,47,32,0,11,36
20,Success,44,30,0,18,26
20,Success,44,29,7,9,35
20,Success,50,24,9,7,43
20,Success,55,25,1,11,44
20,Success,58,22,0,7,51
20,Success,44,28,3,14,30
20,Success,48,29,0,13,35
20,Success,51,22,7,14,37
20,Success,42,27,6,16,26
20,Success,52,30,1,7,45
20,Success,48,27,5,12,36
20,Success,55,28,0,9,46
20,Success,49,26,3,14,35
20,Success,36,37,10,7,29
20,Success,47,26,0,16,31
20,Success,53,23,1,11,42
20,Success,54,23,3,8,46
20,Success,46,34,4,10,36
20,Success,49,30,2,5,44
20,Success,47,21,0,20,27
20,Success,42,34,1,15,27
20,Success,39,28,8,16,23
20,Success,46,25,0,17,29
20,Success,53,18,0,17,36
20,Success,49,21,6,12,37
20,Success,50,19,6,14,36
20,Success,43,33,0,14,29
20,Success,52,23,0,15,37
20,Success,47,23,5,15,32
20,Success,45,27,2,12,33
20,Success,52,20,3,12,40
20,Success,53,25,4,6,47
20,Success,45,26,0,14,31
20,Success,50,16,4,20,30
20,Success,44,35,0,12,32
20,Success,52,25,0,12,40
20,Success,52,29,0,12,40
20,Success,55,24,0,12,43
20,Success,45,25,8,16,29
20,Success,51,24,0,13,38
20,Success,43,31,5,12,31
20,Success,49,26,3,8,41
20,Success,42,37,0,13,29
20,Success,45,28,0,17,28
20,Success,53,25,0,7,46
20,Success,47,27,0,14,33
20,Success,41,34,0,18,23
20,Success,52,25,0,12,40
20,Success,56,26,0,6,50
20,Success,49,23,0,15,34
20,Success,48,28,0,11,37
20,Success,53,18,8,9,44
20,Success,51,26,2,12,39
20,Success,49,29,0,10,39
20,Success,48,25,3,11,37
20,Success,53,18,3,13,40
20,Success,50,29,0,13,37
20,Success,51,21,5,12,39
20,Success,55,22,0,8,47
20,Success,47,26,0,11,36
20,Success,52,17,6,15,37
20,Success,42,32,0,15,27
20,Success,45,29,4,12,33
20,Success,44,30,0,15,29
20,Success,55,20,0,14,41
20,Fail,34,32,9,18,16
20,Success,49,27,0,15,34
20,Success,47,24,8,12,35
20,Success,52,23,0,11,41
20,Success,52,20,3,16,36
20,Success,42,35,0,12,30
20,Success,48,21,7,12,36
20,Success,51,25,2,15,36
20,Success,45,25,0,18,27
20,Success,50,31,0,8,42
20,Success,44,25,0,22,22
20,Success,51,28,0,9,42
20,Success,44,25,1,19,25
20,Success,51,23,0,13,38
20,Success,55,25,0,11,44
20,Success,43,26,4,15,28
20,Success,44,33,0,14,30
20,Success,43,36,0,15,28
20,Success,49,20,2,14,35
20,Success,61,17,3,9,52
20,Success,52,21,0,18,34
20,Success,50,23,0,14,36
20,Success,46,28,0,16,30
20,Success,45,24,2,18,27
20,Success,54,27,0,11,43
20,Success,42,36,0,12,30
20,Success,52,24,0,15,37
20,Success,51,30,0,10,41
20,Success,48,25,0,13,35
20,Success,42,30,0,19,23
20,Success,52,18,10,11,41
20,Success,50,31,0,8,42
20,Success,53,21,0,12,41
20,Success,47,36,0,8,39
20,Success,46,23,3,18,28
20,Success,49,22,0,15,34
20,Success,54,17,2,13,41
20,Success,42,32,0,16,26
20,Success,55,24,0,7,48
20,Success,53,23,1,11,42
20,Success,51,31,1,8,43
20,Success,53,26,0,10,43
20,Success,46,30,0,14,32
20,Success,50,29,0,11,39
20,Success,53,23,4,10,43
20,Success,41,34,0,13,28
20,Success,55,19,3,14,41
20,Success,53,19,0,16,37
20,Success,49,20,2,16,33
20,Success,46,30,2,12,34
20,Success,42,30,2,13,29
20,Success,51,25,2,10,41
20,Success,47,28,0,11,36
20,Success,45,34,3,10,35
20,Success,46,26,10,10,36
20,Success,44,29,5,13,31
20,Success,46,28,0,14,32
20,Success,55,23,0,13,42
20,Success,45,32,0,12,33
20,Success,49,30,0,11,38
20,Success,50,24,2,13,37
20,Success,49,29,0,13,36
20,Success,50,23,5,12,38
20,Success,51,26,0,12,39
20,Success,52,25,0,10,42
20,Success,49,28,2,10,39
20,Success,51,23,11,8,43
20,Success,43,23,10,18,25
20,Success,49,27,3,12,37
20,Success,42,33,0,16,26
20,Success,56,24,0,9,47
20,Success,46,32,0,12,34
20,Success,43,36,0,11,32
20,Success,43,39,0,7,36
20,Success,53,23,1,14,39
20,Success,46,22,5,14,32
20,Success,46,26,1,9,37
20,Success,51,23,3,16,35
20,Success,46,30,0,15,31
20,Success,52,26,0,11,41
20,Success,52,18,9,9,43
20,Success,50,31,0,7,43
20,Success,53,33,0,6,47
20,Success,55,24,1,9,46
20,Success,50,26,0,13,37
20,Success,47,28,0,14,33
20,Success,51,28,0,12,39
20,Success,44,33,0,13,31
20,Success,42,34,0,16,26
20,Success,46,31,1,10,36
20,Success,49,28,0,13,36
20,Success,56,17,0,12,44
20,Success,48,28,0,14,34
20,Success,41,28,3,13,28
20,Success,54,21,4,13,41
20,Success,55,22,0,13,42
20,Success,52,20,3,12,40
20,Success,46,25,4,15,31
20,Success,49,21,0,17,32
20,Success,57,22,5,6,51
20,Success,44,32,6,13,31
20,Success,56,18,0,12,44
20,Success,45,31,0,16,29
20,Success,57,21,1,9,48
20,Success,56,21,0,15,41
20,Success,52,22,0,12,40
20,Success,49,26,0,12,37
20,Success,48,30,3,9,39
20,Success,52,21,0,16,36
20,Success,50,21,1,14,36
20,Success,50,24,0,12,38
20,Success,46,27,3,12,34
20,Success,51,29,0,6,45
20,Success,45,27,11,10,35
20,Success,43,38,0,8,35
20,Success,42,36,0,14,28
20,Success,44,29,5,13,31
20,Success,50,25,0,17,33
20,Success,55,20,2,11,44
20,Success,53,31,0,8,45
20,Success,42,38,0,16,26
20,Success,52,29,0,8,44
20,Success,44,26,11,14,30
20,Success,45,29,1,16,29
20,Success,48,35,0,7,41
20,Success,51,24,0,12,39
20,Success,48,27,0,13,35
20,Success,54,22,0,11,43
20,Success,55,18,0,15,40
20,Success,45,33,0,14,31
20,Success,49,29,0,11,38
20,Success,46,37,0,7,39
20,Success,41,35,0,14,27
20,Success,38,28,13,12,26
20,Success,52,20,0,13,39
20,Success,46,22,7,14,32
20,Success,48,22,10,16,32
20,Success,51,31,0,8,43
20,Success,52,22,0,15,37
20,Success,56,19,0,11,45
20,Success,51,21,8,11,40
20,Success,48,29,0,12,36
20,Success,50,22,0,14,36
20,Success,46,22,13,6,40
20,Success,50,22,7,12,38
20,Success,53,18,11,9,44
20,Success,46,27,4,14,32
20,Success,44,29,0,14,30
20,Success,41,25,6,16,25
20,Success,49,30,0,12,37
20,Success,51,25,0,13,38
20,Success,47,26,1,14,33
20,Success,47,26,2,13,34
20,Success,49,30,0,12,37
20,Success,51,16,5,17,34
20,Success,51,33,0,11,40
20,Success,52,26,0,11,41
20,Success,52,28,0,13,39
20,Success,44,28,9,12,32
20,Success,39,39,0,15,24
20,Success,50,27,0,12,38
20,Success,47,37,0,7,40
20,Success,47,22,7,12,35
20,Success,47,26,0,16,31
20,Success,54,25,0,12,42
20,Success,48,28,0,19,29
20,Success,45,35,0,9,36
20,Success,51,27,0,12,39
20,Success,47,27,0,16,31
20,Success,41,27,9,12,29
20,Success,44,23,5,16,28
20,Success,49,24,0,17,32
20,Success,45,35,0,11,34
20,Success,51,22,16,6,45
20,Success,52,26,0,13,39
20,Success,52,24,0,13,39
20,Success,51,23,1,12,39
20,Success,53,23,0,12,41
20,Success,43,29,0,15,28
20,Success,38,31,6,15,23
20,Success,44,32,0,11,33
20,Success,39,43,0,11,28
20,Success,43,33,0,17,26
20,Success,48,29,0,11,37
20,Success,40,38,1,12,28
20,Success,51,22,0,14,37
20,Success,54,22,0,14,40
20,Success,49,27,0,11,38
20,Success,45,27,1,18,27
20,Success,48,24,2,15,33
20,Success,52,30,0,11,41
20,Success,56,19,4,9,47
20,Success,47,24,10,12,35
20,Success,49,26,1,14,35
20,Success,43,28,0,20,23
20,Success,53,28,0,9,44
20,Success,54,18,7,11,43
20,Success,47,30,0,11,36
20,Success,53,26,0,10,43
20,Success,51,25,3,9,42
20,Success,49,34,0,8,41
20,Success,47,32,0,13,34
20,Success,47,31,0,9,38
20,Success,47,27,1,12,35
20,Fail,33,28,13,18,15
20,Success,46,32,0,9,37
20,Success,49,29,1,15,34
20,Success,57,16,2,13,44
20,Success,45,32,0,12,33
20,Success,51,28,0,11,40
20,Success,58,23,2,6,52
20,Fail,38,31,0,23,15
20,Success,43,29,1,14,29
20,Success,44,33,0,15,29
20,Success,53,20,5,14,39
20,Success,39,40,0,11,28
20,Success,41,30,0,16,25
20,Success,45,23,2,16,29
20,Success,47,29,0,13,34
20,Success,47,27,2,14,33
20,Success,45,40,0,7,38
20,Success,50,24,0,13,37
20,Success,42,34,0,17,25
20,Success,44,30,0,15,29
20,Success,52,23,0,14,38
20,Success,57,16,5,9,48
20,Success,47,24,2,9,38
20,Success,46,34,0,13,33
20,Success,44,18,10,20,24
20,Success,52,23,0,12,40
20,Success,47,20,4,16,31
20,Success,49,26,4,14,35
20,Success,49,23,2,17,32
20,Success,46,30,2,15,31
20,Success,53,30,0,9,44
20,Success,55,24,0,12,43
20,Success,52,23,1,9,43
20,Success,50,29,3,8,42
20,Success,41,42,0,11,30
20,Success,41,27,7,18,23
20,Success,43,28,0,17,26
20,Success,51,25,3,11,40
20,Success,47,41,0,6,41
20,Success,48,28,5,10,38
20,Success,49,22,0,16,33
20,Success,51,26,0,12,39
20,Success,42,25,8,15,27
20,Success,51,28,0,10,41
20,Success,54,28,0,10,44
20,Success,48,25,0,17,31
20,Success,42,28,0,18,24
20,Success,53,20,2,15,38
20,Success,41,30,0,17,24
20,Success,50,25,2,12,38
20,Success,50,25,4,9,41
20,Success,51,28,0,8,43
20,Success,47,26,3,12,35
20,Success,41,40,0,14,27
20,Success,42,26,7,15,27
20,Success,47,33,0,12,35
20,Success,49,26,0,10,39
20,Success,52,30,3,9,43
20,Success,48,40,0,9,39
20,Success,49,26,1,12,37
20,Success,48,30,3,9,39
20,Success,48,20,0,18,30
20,Success,44,23,5,17,27
20,Success,50,27,0,8,42
20,Success,51,18,0,12,39
20,Success,43,23,5,19,24
20,Fail,38,29,0,21,17
20,Success,48,31,0,12,36
20,Success,54,24,0,10,44
20,Success,49,23,0,13,36
20,Success,49,24,1,14,35
20,Success,48,25,0,14,34
20,Success,51,25,0,12,39
20,Success,48,29,0,14,34
20,Success,49,28,0,14,35
20,Success,49,31,0,11,38
20,Success,52,26,0,9,43
20,Success,42,33,0,18,24
20,Success,49,18,6,17,32
20,Success,52,24,0,13,39
20,Success,51,24,0,14,37
20,Success,45,27,0,16,29
20,Success,48,30,0,10,38
20,Success,43,27,0,18,25
20,Success,46,32,0,9,37
20,Success,54,24,2,10,44
20,Success,51,20,3,11,40
20,Success,56,27,0,6,50
20,Success,53,24,0,12,41
20,Success,42,30,0,20,22
20,Success,58,14,1,13,45
20,Success,51,20,3,15,36
20,Success,50,26,0,10,40
20,Success,54,22,0,12,42
20,Success,51,20,7,13,38
20,Success,57,12,2,16,41
20,Success,48,31,4,9,39
20,Success,45,36,0,13,32
20,Success,57,19,0,11,46
20,Success,45,30,0,14,31
20,Success,46,29,0,14,32
20,Success,50,26,0,11,39
20,Success,51,29,3,8,43
20,Success,43,34,0,14,29
20,Success,50,29,0,13,37
20,Success,52,20,0,18,34
20,Success,48,29,0,14,34
20,Success,48,30,5,12,36
20,Success,48,20,6,11,37
20,Success,48,26,2,15,33
20,Success,50,26,9,4,46
20,Success,44,27,0,17,27
20,Success,50,32,0,11,39
20,Success,54,22,0,12,42
20,Success,47,25,0,16,31
20,Success,45,23,0,20,25
20,Success,46,32,2,10,36
20,Success,43,24,6,20,23
20,Success,46,27,1,13,33
20,Success,48,29,3,13,35
20,Success,47,26,0,20,27
20,Success,48,31,0,9,39
20,Success,48,28,0,15,33
20,Success,53,24,0,8,45
20,Success,48,31,1,10,38
20,Success,53,22,4,11,42
20,Success,44,19,10,18,26
20,Success,42,35,0,11,31
20,Success,42,31,1,15,27
20,Success,51,20,1,18,33
20,Success,46,26,5,14,32
20,Success,51,32,0,9,42
20,Success,52,25,1,7,45
20,Success,44,22,8,18,26
20,Success,43,27,10,9,34
20,Success,51,23,8,10,41
20,Fail,37,36,0,18,19
20,Success,46,38,0,8,38
20,Success,45,27,7,11,34
20,Success,49,29,0,9,40
20,Success,50,28,0,12,38
20,Success,49,27,0,12,37
20,Success,46,28,6,12,34
20,Success,44,30,0,10,34
20,Success,51,22,0,18,33
20,Success,55,19,0,12,43
20,Success,43,25,5,18,25
20,Success,54,27,0,8,46
20,Success,54,23,1,11,43
20,Success,55,23,2,6,49
20,Success,43,23,2,19,24
20,Success,43,23,2,22,21
20,Success,52,24,2,11,41
20,Success,41,32,9,12,29
20,Success,44,22,6,15,29
20,Success,54,24,0,8,46
20,Success,51,24,0,12,39
20,Success,47,29,3,11,36
20,Success,53,28,0,11,42
20,Success,49,23,10,11,38
20,Success,46,31,0,12,34
20,Success,50,21,0,12,38
20,Success,48,29,0,12,36
20,Success,56,30,0,7,49
20,Success,54,22,0,10,44
20,Success,44,22,9,15,29
20,Success,48,20,9,12,36
20,Success,43,39,0,9,34
20,Success,54,28,0,7,47
20,Success,50,23,3,15,35
20,Success,48,27,0,13,35
20,Success,47,27,0,16,31
20,Success,53,19,5,10,43
20,Success,53,21,10,12,41
20,Success,52,24,0,13,39
20,Success,52,36,0,4,48
20,Success,50,24,4,9,41
20,Success,37,41,0,13,24
20,Success,45,35,0,10,35
20,Success,41,31,0,15,26
20,Success,47,29,0,11,36
20,Success,54,20,1,12,42
20,Success,54,20,0,6,48
20,Fail,39,26,0,21,18
20,Success,51,23,0,14,37
20,Success,48,27,0,11,37
20,Success,45,36,3,6,39
20,Success,43,37,0,12,31
20,Success,41,28,4,15,26
20,Success,58,19,0,13,45
20,Success,50,32,0,7,43
20,Success,48,26,0,14,34
20,Success,51,22,8,13,38
20,Success,47,20,0,18,29
20,Success,52,23,3,13,39
20,Success,49,25,5,11,38
20,Success,54,26,0,10,44
20,Success,49,28,0,11,38
20,Success,54,18,8,10,44
20,Success,46,32,0,11,35
20,Success,46,22,2,17,29
20,Success,50,24,0,14,36
20,Success,45,24,0,19,26
20,Success,54,22,1,12,42
20,Success,48,35,0,10,38
20,Success,47,25,4,13,34
20,Success,45,25,8,11,34
20,Success,47,24,1,16,31
20,Success,43,31,4,10,33
20,Success,56,22,0,12,44
20,Success,51,22,3,15,36
20,Success,52,23,2,11,41
20,Success,44,26,0,17,27
20,Success,48,23,0,18,30
20,Success,45,28,6,10,35
20,Success,45,28,1,18,27
20,Success,59,20,0,9,50
20,Success,38,33,3,15,23
20,Fail,38,29,0,22,16
20,Success,46,34,0,11,35
20,Success,43,31,4,15,28
20,Success,49,26,4,8,41
20,Success,47,23,5,9,38
20,Success,51,26,0,8,43
20,Success,48,22,0,19,29
20,Success,40,26,8,20,20
20,Success,62,17,0,10,52
20,Success,48,26,6,12,36
20,Success,47,23,2,17,30
20,Success,43,39,0,14,29
20,Success,44,37,0,11,33
20,Success,53,24,2,9,44
20,Success,51,33,0,7,44
20,Success,49,29,2,8,41
20,Success,47,28,3,13,34
20,Success,51,32,0,6,45
20,Success,51,25,8,11,40
20,Success,53,24,0,13,40
20,Success,45,27,0,15,30
20,Success,51,23,5,12,39
20,Success,49,29,0,13,36
20,Success,49,24,7,10,39
20,Success,52,22,5,11,41
20,Success,46,26,0,19,27
20,Success,48,26,0,18,30
20,Success,47,30,0,12,35
20,Success,52,36,0,5,47
20,Success,38,38,0,17,21
20,Success,43,31,2,15,28
20,Success,53,23,0,15,38
20,Success,40,34,3,14,26
20,Success,52,24,0,7,45
20,Success,42,32,0,13,29
20,Success,50,25,0,15,35
20,Success,53,21,1,11,42
20,Success,39,39,0,13,26
20,Success,49,24,7,10,39
20,Success,48,28,0,11,37
20,Success,43,32,2,9,34
20,Success,41,21,10,20,21
20,Success,53,20,0,13,40
20,Success,52,24,0,13,39
20,Success,49,27,0,8,41
20,Success,58,20,0,10,48
20,Success,45,29,0,17,28
20,Success,41,33,9,9,32
20,Success,49,25,0,14,35
20,Success,53,24,3,11,42
20,Success,46,20,11,12,34
20,Success,52,30,1,9,43
20,Success,48,23,9,14,34
20,Success,62,22,0,7,55
20,Success,49,24,0,15,34
20,Success,49,29,0,15,34
20,Success,48,21,0,15,33
20,Success,46,26,6,13,33
20,Success,55,24,3,11,44
20,Success,48,34,0,11,37
20,Success,43,30,4,12,31
20,Success,36,46,0,11,25
20,Success,47,28,0,14,33
20,Success,46,35,0,14,32
20,Success,53,22,3,14,39
20,Success,44,31,0,18,26
20,Success,55,21,3,14,41
20,Success,48,28,6,8,40
20,Success,50,28,4,8,42
20,Success,51,27,0,11,40
20,Success,51,33,0,7,44
20,Success,45,28,0,17,28
20,Success,55,22,0,12,43
20,Success,49,26,0,14,35
20,Success,39,35,0,13,26
20,Success,58,28,0,8,50
20,Success,52,19,0,14,38
20,Success,46,21,7,17,29
20,Success,44,33,0,13,31
20,Success,50,23,1,16,34
20,Success,52,23,5,9,43
20,Success,38,41,0,9,29
20,Success,44,36,0,14,30
20,Success,53,31,0,9,44
20,Success,43,35,0,10,33
20,Success,40,25,9,17,23
20,Success,42,28,8,13,29
20,Success,55,13,0,17,38
20,Success,59,20,0,10,49
20,Success,49,29,0,13,36
20,Success,44,21,13,11,33
20,Success,50,27,0,12,38
20,Success,41,37,2,9,32
20,Success,53,22,7,8,45
20,Success,50,25,3,14,36
20,Success,51,30,0,11,40
20,Success,48,26,0,12,36
20,Success,53,24,1,11,42
20,Success,45,35,0,11,34
20,Success,50,23,1,13,37
20,Success,45,27,8,15,30
20,Success,45,36,0,9,36
20,Success,52,17,6,13,39
20,Success,50,21,5,14,36
20,Success,52,20,1,12,40
20,Success,50,32,0,11,39
20,Success,52,22,5,13,39
20,Success,37,30,12,12,25
20,Success,45,24,12,13,32
20,Success,44,24,0,18,26
20,Success,53,27,0,10,43
20,Success,52,22,0,12,40
20,Success,43,27,4,17,26
20,Success,45,26,4,12,33
20,Success,51,31,0,8,43
20,Success,48,31,0,13,35
20,Success,49,24,1,16,33
20,Success,45,27,9,13,32
20,Success,49,21,0,18,31
20,Success,46,36,1,11,35
20,Success,49,22,3,12,37
20,Fail,36,37,0,19,17
20,Success,51,27,1,6,45
20,Success,51,22,1,14,37
20,Success,47,23,4,16,31
20,Success,45,29,6,11,34
20,Success,47,29,0,10,37
20,Success,52,26,4,11,41
20,Success,43,26,7,12,31
20,Success,49,28,2,7,42
20,Success,47,31,5,9,38
20,Success,50,27,0,13,37
20,Success,50,21,7,11,39
20,Success,44,31,0,11,33
20,Success,48,26,0,13,35
20,Success,50,30,0,8,42
20,Success,45,25,0,17,28
20,Success,53,24,0,15,38
20,Success,50,27,0,12,38
20,Success,46,26,0,17,29
20,Success,47,32,0,13,34
20,Success,47,28,0,15,32
20,Success,50,25,0,12,38
20,Success,43,29,8,12,31
20,Success,47,24,5,13,34
20,Success,47,32,0,12,35
20,Success,51,29,0,9,42
20,Success,45,28,3,14,31
20,Success,47,31,0,12,35
20,Success,44,40,0,6,38
20,Success,55,22,0,12,43
20,Success,38,38,0,14,24
20,Success,53,18,2,15,38
20,Success,52,27,5,11,41
20,Success,50,25,1,13,37
20,Success,42,33,6,11,31
20,Success,47,31,0,10,37
20,Success,45,22,7,15,30
20,Success,45,28,6,15,30
20,Success,48,26,0,15,33
20,Success,49,31,0,13,36
20,Success,39,34,0,14,25
20,Success,55,18,1,14,41
20,Success,51,27,0,12,39
20,Success,47,21,0,19,28
20,Success,43,24,4,16,27
20,Success,46,41,0,9,37
20,Success,46,30,3,8,38
20,Success,42,29,2,15,27
20,Success,53,19,0,11,42
20,Success,50,24,2,13,37
20,Success,46,28,0,18,28
20,Success,54,26,0,12,42
20,Success,45,29,4,14,31
20,Success,55,21,2,13,42
20,Success,57,15,0,14,43
20,Success,42,29,0,15,27
20,Success,44,22,10,17,27
20,Success,44,29,1,16,28
20,Success,40,26,10,19,21
20,Success,48,23,4,12,36
20,Success,54,20,0,11,43
20,Success,52,29,0,7,45
20,Success,51,23,4,8,43
20,Success,48,25,2,16,32
20,Success,50,32,0,11,39
20,Success,46,30,0,15,31
20,Success,51,24,0,13,38
20,Success,46,30,0,10,36
20,Success,50,25,6,9,41
20,Success,50,24,0,12,38
20,Success,50,30,0,9,41
20,Success,52,25,4,7,45
20,Success,49,34,0,10,39
20,Success,45,27,0,18,27
20,Success,52,24,0,13,39
20,Success,45,35,0,12,33
20,Success,51,31,0,8,43
20,Success,47,20,0,21,26
20,Success,53,19,0,15,38
20,Success,51,23,1,16,35
20,Success,45,27,0,15,30
20,Success,46,23,8,12,34
20,Success,53,14,9,12,41
20,Success,59,20,1,11,48
20,Success,49,23,0,11,38
20,Success,45,30,0,14,31
20,Success,49,28,0,13,36
20,Success,50,27,0,14,36
20,Success,44,26,3,15,29
20,Success,41,41,0,12,29
20,Success,45,21,10,13,32
20,Success,43,27,6,11,32
20,Success,46,31,4,7,39
20,Success,51,23,1,13,38
20,Success,56,33,0,2,54
20,Success,42,36,0,13,29
20,Success,48,24,0,14,34
20,Success,46,31,3,13,33
20,Success,45,31,0,11,34
20,Success,40,39,0,15,25
20,Success,55,17,1,13,42
20,Success,45,33,6,9,36
20,Success,47,31,0,7,40
20,Success,46,22,7,15,31
20,Success,51,26,0,11,40
20,Success,42,40,0,11,31
20,Success,49,19,0,21,28
20,Success,51,30,0,5,46
20,Success,48,24,5,14,34
20,Success,53,34,0,7,46
20,Success,49,21,1,18,31
20,Success,45,32,4,10,35
20,Success,43,34,1,10,33
20,Success,49,24,0,14,35
20,Success,51,33,0,8,43
20,Success,47,33,0,12,35
20,Success,52,21,2,13,39
20,Success,47,24,6,11,36
20,Success,47,24,2,13,34
20,Success,49,26,3,14,35
20,Success,39,35,5,11,28
20,Success,52,19,0,16,36
20,Success,49,33,0,6,43
20,Success,51,23,0,12,39
20,Success,54,24,0,12,42
20,Success,50,26,0,11,39
20,Success,44,25,7,12,32
20,Success,47,24,3,18,29
20,Success,44,28,2,17,27
20,Success,49,25,5,12,37
20,Success,46,33,0,10,36
20,Success,53,20,2,14,39
20,Success,51,24,2,8,43
20,Success,52,24,2,11,41
20,Success,48,25,7,12,36
20,Success,49,26,0,12,37
20,Success,45,24,3,16,29
20,Success,51,17,13,15,36
20,Success,52,24,2,10,42
20,Success,52,21,0,11,41
20,Success,48,33,0,8,40
20,Success,50,24,5,12,38
20,Success,48,27,0,14,34
20,Success,51,21,0,16,35
20,Success,40,42,0,10,30
20,Success,46,31,0,12,34
20,Success,47,26,0,15,32
20,Success,47,23,4,9,38
20,Success,55,21,0,11,44
20,Success,56,21,1,14,42
20,Success,50,26,0,15,35
20,Success,49,26,0,12,37
20,Success,56,17,5,10,46
20,Success,53,24,6,7,46
20,Success,51,26,3,8,43
20,Success,52,29,0,9,43
20,Success,50,26,0,13,37
20,Success,50,26,0,10,40
20,Success,49,26,3,14,35
20,Success,52,27,0,9,43
20,Success,47,31,1,14,33
20,Success,53,23,0,9,44
20,Success,47,24,7,14,33
20,Success,48,22,1,18,30
20,Success,47,27,8,12,35
20,Success,40,45,0,7,33
20,Success,56,19,1,16,40
20,Success,46,22,0,21,25
20,Success,44,37,0,13,31
20,Success,43,28,6,14,29
20,Success,50,17,7,16,34
20,Success,55,22,0,8,47
20,Success,59,17,1,7,52
20,Success,53,21,1,12,41
20,Success,51,26,0,11,40
20,Success,53,20,6,9,44
20,Success,49,29,0,13,36
20,Success,51,23,1,11,40
20,Success,50,27,1,12,38
20,Success,44,30,3,15,29
20,Success,41,31,1,15,26
20,Success,45,25,0,16,29
20,Success,44,33,0,13,31
20,Success,53,27,1,9,44
20,Success,60,17,1,14,46
20,Success,42,23,0,20,22
20,Success,45,27,8,10,35
20,Success,54,27,0,9,45
20,Success,44,27,5,16,28
20,Success,45,28,0,16,29
20,Success,42,30,7,13,29
20,Success,41,28,5,18,23
20,Success,53,24,0,12,41
20,Success,43,31,4,12,31
20,Success,48,30,0,10,38
20,Success,54,22,0,14,40
20,Success,53,16,5,17,36
20,Success,47,24,5,12,35
20,Success,44,31,0,13,31
20,Success,53,25,0,16,37
20,Success,44,29,0,20,24
20,Success,48,23,5,13,35
20,Success,50,19,1,16,34
20,Success,38,31,5,15,23
20,Success,46,25,8,13,33
20,Success,46,29,8,11,35
20,Success,38,30,5,16,22
20,Success,50,29,0,10,40
20,Success,54,18,0,16,38
20,Success,46,27,4,15,31
20,Success,55,27,0,11,44
20,Success,54,24,0,12,42
20,Success,50,26,0,12,38
20,Success,51,22,5,12,39
20,Success,43,35,0,13,30
20,Success,51,15,3,10,41
20,Success,45,32,3,10,35
20,Success,48,26,2,8,40
20,Success,46,35,0,14,32
20,Success,53,27,0,9,44
20,Success,47,24,0,16,31
20,Success,45,29,5,9,36
20,Success,52,30,0,10,42
20,Success,49,27,0,14,35
20,Success,36,41,0,14,22
20,Success,51,27,0,13,38
20,Success,48,30,0,8,40
20,Success,50,24,5,10,40
20,Success,47,28,1,9,38
20,Success,42,34,3,16,26
20,Success,47,35,0,11,36
20,Success,49,32,0,6,43
20,Success,53,22,2,11,42
20,Success,47,25,0,12,35
20,Success,49,27,0,11,38
20,Success,42,37,0,6,36
20,Success,50,22,4,14,36
20,Success,53,19,6,9,44
20,Success,49,27,5,10,39
20,Success,40,34,11,10,30
20,Success,51,24,3,13,38
20,Success,52,26,0,11,41
20,Success,42,27,4,18,24
20,Fail,40,28,0,24,16
20,Success,53,30,0,7,46
20,Success,46,31,4,10,36
20,Success,46,25,4,13,33
20,Success,53,29,0,6,47
20,Success,51,29,0,11,40
20,Success,54,25,2,11,43
20,Success,42,41,0,10,32
20,Success,50,29,0,11,39
20,Success,46,30,0,13,33
20,Success,55,20,1,10,45
20,Success,47,25,6,11,36
20,Success,53,29,0,9,44
20,Success,49,34,0,8,41
20,Success,47,31,3,9,38
20,Success,49,23,0,14,35
20,Success,41,31,5,12,29
20,Success,44,27,6,13,31
20,Success,52,27,1,11,41
20,Success,43,23,4,21,22
20,Success,55,20,0,13,42
20,Success,55,23,0,13,42
20,Success,52,23,0,15,37
20,Success,52,24,0,16,36
20,Success,45,29,2,9,36
20,Success,45,28,0,17,28
20,Success,51,28,0,9,42
20,Success,47,27,6,9,38
20,Success,40,36,0,12,28
20,Success,45,30,0,19,26
20,Success,52,26,0,11,41
20,Success,49,25,0,14,35
20,Success,49,32,0,11,38
20,Success,57,20,2,11,46
20,Success,43,29,5,11,32
20,Success,53,24,0,12,41
20,Success,51,24,0,14,37
20,Success,40,32,0,19,21
20,Success,60,23,0,5,55
20,Success,48,27,5,9,39
20,Success,48,33,2,7,41
20,Success,50,23,1,15,35
20,Success,42,36,0,15,27
20,Success,57,22,5,10,47
20,Success,50,25,1,12,38
20,Success,43,28,0,17,26
20,Success,44,28,2,17,27
20,Success,47,31,4,10,37
20,Success,48,31,0,9,39
20,Success,50,24,4,13,37
20,Success,54,16,2,18,36
20,Success,40,28,10,14,26
20,Success,60,16,0,10,50
20,Success,53,18,7,11,42
20,Success,49,28,0,11,38
20,Success,46,29,1,12,34
20,Success,45,26,0,18,27
20,Success,53,25,0,13,40
20,Success,48,25,7,11,37
20,Success,54,27,0,8,46
20,Success,45,26,10,11,34
20,Success,50,26,2,14,36
20,Success,42,28,0,19,23
20,Success,42,36,0,11,31
20,Success,46,34,0,14,32
20,Success,52,26,0,11,41
20,Success,46,27,0,17,29
20,Success,45,33,0,14,31
20,Success,45,26,2,14,31
20,Success,50,23,0,14,36
20,Success,49,29,8,7,42
20,Success,51,22,5,11,40
20,Success,43,32,0,20,23
20,Fail,35,29,9,21,14
20,Success,48,27,1,10,38
20,Success,49,30,0,15,34
20,Success,57,25,0,6,51
20,Success,55,15,3,9,46
20,Success,52,22,0,15,37
20,Success,51,22,0,15,36
20,Success,46,29,0,15,31
20,Success,49,27,1,13,36
20,Success,48,32,0,11,37
20,Success,51,27,0,11,40
20,Success,55,20,1,11,44
20,Success,42,37,4,9,33
20,Success,48,29,0,12,36
20,Success,39,30,9,13,26
20,Success,50,25,0,13,37
20,Success,50,23,1,14,36
20,Success,42,30,4,15,27
20,Success,51,29,0,7,44
20,Success,50,22,5,17,33
20,Success,51,33,0,10,41
20,Success,49,28,0,14,35
20,Success,44,41,0,5,39
20,Success,51,24,4,9,42
20,Success,44,33,0,11,33
20,Success,58,15,1,14,44
20,Success,43,28,5,12,31
20,Success,44,27,3,14,30
20,Success,54,22,0,13,41
20,Success,55,25,3,10,45
20,Success,51,26,0,12,39
20,Success,44,36,0,12,32
20,Success,47,22,2,18,29
20,Success,45,32,7,6,39
20,Success,51,29,0,11,40
20,Success,51,26,0,10,41
20,Success,49,28,0,15,34
20,Success,40,37,4,10,30
20,Success,51,28,0,7,44
20,Success,50,25,0,13,37
20,Success,49,21,10,13,36
20,Success,50,35,0,8,42
20,Success,42,31,5,13,29
20,Success,55,23,0,10,45
20,Success,51,28,4,8,43
20,Success,49,25,0,15,34
20,Success,46,25,8,11,35
20,Success,52,22,4,11,41
20,Success,40,30,8,14,26
20,Success,51,28,3,9,42
20,Success,45,29,0,18,27
20,Success,44,34,0,13,31
20,Success,52,25,2,14,38
20,Success,49,30,0,10,39
20,Success,45,20,8,17,28
20,Success,51,22,4,12,39
20,Success,44,25,6,15,29
20,Success,41,31,3,14,27
20,Success,54,21,0,11,43
20,Success,49,28,0,10,39
20,Success,55,26,0,8,47
20,Success,46,33,0,12,34
20,Success,48,28,0,17,31
20,Success,48,26,3,9,39
20,Success,44,44,0,4,40
20,Success,49,26,2,15,34
20,Success,45,32,4,11,34
20,Success,53,18,6,12,41
20,Success,43,30,6,15,28
20,Success,49,23,1,16,33
20,Success,45,28,6,11,34
20,Success,51,31,0,8,43
20,Success,51,24,0,16,35
20,Success,53,26,1,6,47
20,Success,54,28,2,7,47
20,Success,45,22,7,13,32
20,Success,49,24,3,12,37
20,Success,46,27,7,14,32
20,Success,41,34,0,14,27
20,Success,51,21,6,14,37
20,Success,43,38,0,11,32
20,Success,51,21,0,15,36
20,Success,46,26,0,18,28
20,Success,41,35,0,14,27
20,Success,55,25,0,10,45
20,Success,46,31,0,10,36
20,Success,59,20,4,10,49
20,Success,45,37,0,11,34
20,Success,50,26,1,10,40
20,Success,48,25,1,13,35
20,Success,42,36,0,12,30
20,Success,47,30,0,10,37
20,Fail,43,22,6,24,19
20,Success,47,33,0,12,35
20,Success,51,24,0,9,42
20,Success,46,23,0,18,28
20,Success,50,25,2,14,36
20,Success,48,34,0,9,39
20,Success,40,26,4,17,23
20,Success,46,31,0,10,36
20,Success,50,22,4,11,39
20,Success,55,16,3,12,43
20,Success,45,29,4,11,34
20,Success,50,28,0,9,41
20,Success,52,21,6,11,41
20,Success,46,28,8,12,34
20,Success,54,24,0,14,40
30,Success,47,25,3,14,33
30,Success,49,27,1,8,41
30,Success,52,19,5,12,40
30,Success,50,25,2,10,40
30,Success,47,27,3,12,35
30,Success,50,25,0,18,32
30,Success,46,19,2,14,32
30,Success,48,27,0,13,35
30,Success,44,34,2,10,34
30,Success,54,23,0,13,41
30,Success,42,41,0,8,34
30,Success,45,37,0,10,35
30,Success,43,31,4,9,34
30,Success,45,25,1,15,30
30,Success,46,29,0,10,36
30,Success,49,26,7,11,38
30,Success,54,29,0,8,46
30,Success,50,23,4,11,39
30,Fail,42,24,5,16,26
30,Success,43,31,5,10,33
30,Fail,42,37,0,14,28
30,Success,56,21,2,11,45
30,Success,54,21,2,13,41
30,Success,46,24,8,12,34
30,Fail,41,27,3,19,22
30,Fail,41,26,6,19,22
30,Success,47,30,0,12,35
30,Fail,40,24,9,16,24
30,Success,51,30,0,8,43
30,Success,50,30,0,10,40
30,Success,48,29,0,13,35
30,Success,44,38,0,13,31
30,Success,50,27,6,9,41
30,Success,49,23,0,16,33
30,Success,43,35,0,11,32
30,Fail,47,25,0,18,29
30,Success,46,33,1,9,37
30,Success,53,21,2,12,41
30,Success,48,27,0,12,36
30,Success,43,35,0,11,32
30,Success,51,28,0,10,41
30,Success,47,27,2,11,36
30,Success,48,36,0,7,41
30,Success,48,27,9,9,39
30,Success,52,21,5,11,41
30,Success,43,30,2,12,31
30,Success,47,26,5,12,35
30,Success,49,26,7,8,41
30,Success,53,22,0,12,41
30,Success,54,18,3,14,40
30,Success,49,23,1,14,35
30,Success,42,29,8,10,32
30,Success,55,21,0,12,43
30,Success,42,32,4,12,30
30,Fail,39,23,10,19,20
30,Success,55,23,0,10,45
30,Success,58,23,6,5,53
30,Success,53,18,0,15,38
30,Success,51,24,1,11,40
30,Success,53,25,0,12,41
30,Success,50,29,1,9,41
30,Success,49,29,2,8,41
30,Success,54,19,5,14,40
30,Success,47,30,0,11,36
30,Success,44,28,6,13,31
30,Success,51,18,1,16,35
30,Success,49,19,5,14,35
30,Success,53,14,4,18,35
30,Success,55,23,0,13,42
30,Fail,38,37,0,15,23
30,Fail,43,29,3,16,27
30,Success,53,25,0,10,43
30,Success,46,32,4,9,37
30,Success,56,26,0,6,50
30,Success,47,29,0,16,31
30,Success,49,23,9,8,41
30,Fail,40,39,0,13,27
30,Fail,43,28,6,14,29
30,Success,56,21,3,9,47
30,Success,53,27,2,8,45
30,Success,47,28,2,15,32
30,Success,56,24,0,10,46
30,Fail,44,26,1,16,28
30,Success,48,28,0,10,38
30,Fail,42,24,5,22,20
30,Success,49,26,0,14,35
30,Success,50,27,0,10,40
30,Success,48,29,0,11,37
30,Success,52,25,0,13,39
30,Success,44,31,7,10,34
30,Success,45,28,4,12,33
30,Fail,47,25,0,18,29
30,Success,50,23,8,12,38
30,Fail,45,23,2,16,29
30,Success,45,30,3,9,36
30,Success,50,27,0,9,41
30,Success,45,32,3,11,34
30,Success,50,19,4,15,35
30,Success,50,32,0,9,41
30,Success,56,22,2,11,45
30,Success,48,30,0,11,37
30,Fail,41,30,9,14,27
30,Success,42,27,10,11,31
30,Fail,38,30,2,16,22
30,Success,50,27,0,10,40
30,Success,56,26,0,10,46
30,Success,51,18,6,15,36
30,Fail,39,37,3,10,29
30,Success,54,19,1,10,44
30,Success,49,23,0,15,34
30,Success,51,23,1,11,40
30,Success,48,25,4,12,36
30,Success,50,34,0,8,42
30,Success,47,23,6,15,32
30,Success,58,17,5,12,46
30,Fail,46,23,1,18,28
30,Success,54,19,0,13,41
30,Success,44,37,0,12,32
30,Success,56,23,0,12,44
30,Success,46,33,0,13,33
30,Success,50,22,7,9,41
30,Success,43,35,0,10,33
30,Success,48,26,6,13,35
30,Success,44,34,0,14,30
30,Success,51,27,2,11,40
30,Fail,41,32,1,16,25
30,Success,46,23,7,15,31
30,Success,43,32,0,10,33
30,Success,43,39,0,11,32
30,Success,52,30,0,7,45
30,Success,49,24,7,13,36
30,Fail,43,27,3,16,27
30,Success,49,23,9,9,40
30,Success,47,26,0,15,32
30,Success,54,20,1,14,40
30,Fail,41,29,0,20,21
30,Fail,39,29,0,22,17
30,Success,47,31,0,9,38
30,Success,50,26,0,15,35
30,Success,49,20,3,15,34
30,Success,51,30,0,10,41
30,Success,45,33,0,15,30
30,Success,48,28,4,11,37
30,Fail,41,38,0,14,27
30,Success,49,29,1,12,37
30,Success,51,31,0,10,41
30,Fail,43,20,4,21,22
30,Success,54,24,0,9,45
30,Success,49,28,0,13,36
30,Success,51,18,6,15,36
30,Success,54,20,4,9,45
30,Fail,46,28,0,17,29
30,Success,48,25,5,11,37
30,Success,49,35,0,7,42
30,Success,47,28,0,16,31
30,Success,46,25,2,11,35
30,Success,50,25,1,14,36
30,Success,47,23,6,15,32
30,Success,53,22,0,14,39
30,Success,42,34,0,10,32
30,Success,49,24,2,15,34
30,Success,54,25,0,7,47
30,Success,45,26,11,13,32
30,Success,53,21,3,14,39
30,Success,54,23,2,11,43
30,Success,46,25,2,14,32
30,Fail,43,22,5,17,26
30,Success,57,21,0,13,44
30,Success,47,23,0,17,30
30,Success,47,21,6,14,33
30,Success,47,30,1,12,35
30,Success,52,24,1,13,39
30,Success,43,36,1,11,32
30,Success,51,27,1,9,42
30,Success,52,28,0,11,41
30,Fail,44,27,5,15,29
30,Success,51,21,2,13,38
30,Success,54,17,1,12,42
30,Fail,45,31,0,16,29
30,Fail,40,29,11,13,27
30,Success,49,29,0,12,37
30,Success,48,24,0,15,33
30,Success,46,32,0,11,35
30,Success,45,32,0,15,30
30,Success,56,14,2,19,37
30,Success,49,24,0,13,36
30,Fail,41,35,0,16,25
30,Success,50,29,0,12,38
30,Success,44,33,1,9,35
30,Success,51,31,0,12,39
30,Success,49,34,5,8,41
30,Success,44,31,0,12,32
30,Success,45,35,0,14,31
30,Success,54,29,0,8,46
30,Success,49,31,0,10,39
30,Success,44,32,1,13,31
30,Success,48,26,0,14,34
30,Success,56,26,2,4,52
30,Success,47,27,5,12,35
30,Success,42,34,0,12,30
30,Fail,40,38,0,11,29
30,Success,45,30,5,9,36
30,Fail,43,31,0,15,28
30,Success,43,29,8,13,30
30,Success,52,19,1,17,35
30,Success,47,25,5,10,37
30,Fail,42,30,0,16,26
30,Success,44,27,4,13,31
30,Fail,45,25,2,17,28
30,Success,48,26,2,12,36
30,Success,48,25,0,15,33
30,Success,51,23,0,13,38
30,Success,46,30,0,11,35
30,Success,42,32,7,9,33
30,Success,50,24,3,15,35
30,Success,50,29,0,13,37
30,Success,52,30,0,9,43
30,Success,47,34,0,12,35
30,Fail,45,27,1,16,29
30,Success,52,27,0,11,41
30,Success,48,28,3,11,37
30,Success,42,27,12,11,31
30,Success,45,31,0,12,33
30,Success,45,39,0,5,40
30,Success,44,33,0,13,31
30,Success,52,25,2,10,42
30,Success,50,23,0,14,36
30,Success,54,18,1,13,41
30,Success,48,30,0,10,38
30,Success,54,14,12,15,39
30,Success,49,25,0,13,36
30,Fail,43,32,0,14,29
30,Success,52,23,1,14,38
30,Success,48,29,0,9,39
30,Success,52,18,1,15,37
30,Success,46,36,0,9,37
30,Fail,43,28,0,18,25
30,Success,49,28,0,11,38
30,Success,50,25,8,9,41
30,Fail,41,29,6,14,27
30,Success,54,18,2,14,40
30,Success,50,26,0,13,37
30,Success,51,24,3,13,38
30,Success,44,34,0,11,33
30,Success,56,22,0,12,44
30,Success,55,22,0,9,46
30,Success,50,21,5,12,38
30,Fail,43,27,0,18,25
30,Success,56,24,0,9,47
30,Fail,41,35,0,14,27
30,Success,50,31,0,11,39
30,Success,51,25,0,11,40
30,Success,48,24,1,17,31
30,Fail,46,19,4,21,25
30,Success,45,31,0,14,31
30,Fail,44,24,7,15,29
30,Success,46,30,0,13,33
30,Fail,39,38,0,14,25
30,Success,47,28,4,11,36
30,Success,50,20,5,13,37
30,Fail,41,23,2,22,19
30,Success,55,21,0,8,47
30,Success,46,23,8,12,34
30,Success,46,25,0,16,30
30,Success,48,21,6,13,35
30,Success,56,20,0,13,43
30,Success,48,24,4,15,33
30,Success,57,20,0,11,46
30,Fail,47,20,0,20,27
30,Success,41,37,2,10,31
30,Fail,38,34,4,13,25
30,Success,43,29,4,12,31
30,Success,52,26,2,9,43
30,Fail,41,34,0,18,23
30,Success,46,28,10,11,35
30,Success,42,38,0,11,31
30,Success,50,27,2,11,39
30,Success,49,39,0,1,48
30,Fail,46,23,0,18,28
30,Success,53,22,0,13,40
30,Success,46,27,6,14,32
30,Success,51,23,0,16,35
30,Success,56,22,0,8,48
30,Success,54,27,0,6,48
30,Success,52,17,0,19,33
30,Success,47,32,1,8,39
30,Success,51,27,0,14,37
30,Success,53,32,0,6,47
30,Success,56,19,1,11,45
30,Success,42,34,5,9,33
30,Success,45,26,6,14,31
30,Success,49,26,0,8,41
30,Success,49,30,0,12,37
30,Success,54,22,0,8,46
30,Success,52,30,4,6,46
30,Success,48,26,0,15,33
30,Success,55,17,3,17,38
30,Success,53,23,0,12,41
30,Success,49,21,5,12,37
30,Success,60,23,0,6,54
30,Success,52,27,0,10,42
30,Success,55,28,0,3,52
30,Fail,41,25,4,17,24
30,Success,46,33,8,7,39
30,Fail,42,37,0,16,26
30,Success,50,27,2,9,41
30,Success,51,24,0,14,37
30,Success,49,31,0,8,41
30,Success,48,28,0,10,38
30,Fail,46,22,0,20,26
30,Success,53,20,1,11,42
30,Success,47,26,6,13,34
30,Success,48,32,0,10,38
30,Success,51,28,0,15,36
30,Success,48,29,0,16,32
30,Success,47,29,0,17,30
30,Success,50,23,1,12,38
30,Fail,41,37,0,12,29
30,Success,55,24,0,6,49
30,Success,47,33,0,9,38
30,Fail,38,38,6,11,27
30,Success,46,29,0,12,34
30,Success,48,22,0,17,31
30,Success,46,33,2,6,40
30,Success,49,27,0,13,36
30,Success,46,34,0,12,34
30,Success,55,24,4,11,44
30,Success,50,30,0,11,39
30,Success,42,34,1,12,30
30,Success,47,29,7,10,37
30,Success,53,28,1,8,45
30,Fail,43,26,9,14,29
30,Success,48,27,0,10,38
30,Success,49,30,0,11,38
30,Success,48,29,5,9,39
30,Success,52,24,6,7,45
30,Success,46,28,0,14,32
30,Success,47,31,0,11,36
30,Success,45,34,4,8,37
30,Success,50,29,0,10,40
30,Success,49,26,1,13,36
30,Success,52,25,3,8,44
30,Success,45,27,5,8,37
30,Success,49,24,3,14,35
30,Success,43,39,0,12,31
30,Success,57,19,6,8,49
30,Success,44,32,0,14,30
30,Success,48,21,11,9,39
30,Success,53,20,4,9,44
30,Success,45,37,0,12,33
30,Success,53,24,0,14,39
30,Fail,42,31,0,14,28
30,Success,50,30,0,6,44
30,Fail,41,38,0,16,25
30,Success,47,30,0,12,35
30,Success,48,27,0,9,39
30,Success,53,26,6,8,45
30,Success,51,18,0,17,34
30,Success,50,28,1,12,38
30,Success,43,37,0,9,34
30,Success,53,25,0,8,45
30,Success,48,30,0,13,35
30,Success,47,33,0,9,38
30,Success,48,36,0,7,41
30,Success,49,29,0,11,38
30,Fail,44,27,6,17,27
30,Success,56,20,4,14,42
30,Success,49,32,0,8,41
30,Success,47,25,3,16,31
30,Success,49,23,0,15,34
30,Success,54,23,4,9,45
30,Success,44,27,4,14,30
30,Fail,44,22,1,24,20
30,Success,47,22,8,12,35
30,Success,48,28,3,12,36
30,Fail,49,16,6,20,29
30,Success,50,30,0,8,42
30,Success,50,24,0,13,37
30,Success,46,29,5,10,36
30,Success,54,22,1,13,41
30,Success,49,29,0,12,37
30,Fail,38,38,0,18,20
30,Success,47,21,1,17,30
30,Success,46,33,1,12,34
30,Success,49,29,0,15,34
30,Success,52,24,0,14,38
30,Success,48,26,3,9,39
30,Fail,42,28,0,14,28
30,Success,55,20,0,14,41
30,Success,47,32,1,11,36
30,Success,49,21,3,14,35
30,Success,50,23,0,15,35
30,Success,45,25,9,15,30
30,Success,55,23,0,12,43
30,Success,47,30,0,12,35
30,Success,51,26,2,12,39
30,Success,45,24,10,11,34
30,Fail,39,36,3,13,26
30,Success,50,22,4,12,38
30,Success,58,17,0,11,47
30,Success,56,22,0,13,43
30,Fail,41,32,1,13,28
30,Success,46,32,0,14,32
30,Success,51,28,0,9,42
30,Success,48,31,0,14,34
30,Success,47,22,0,17,30
30,Success,46,25,0,13,33
30,Success,51,24,0,12,39
30,Success,44,33,0,12,32
30,Success,47,29,0,12,35
30,Fail,42,26,13,14,28
30,Fail,42,31,0,17,25
30,Success,48,37,0,7,41
30,Fail,44,30,0,19,25
30,Success,42,38,0,10,32
30,Success,49,21,0,16,33
30,Success,55,31,0,5,50
30,Success,45,28,0,15,30
30,Fail,39,32,0,16,23
30,Success,52,27,0,12,40
30,Success,54,20,3,14,40
30,Success,46,33,0,9,37
30,Success,51,24,1,18,33
30,Success,49,23,0,14,35
30,Success,52,25,0,14,38
30,Fail,41,37,0,15,26
30,Success,52,26,0,11,41
30,Success,48,25,6,12,36
30,Success,43,35,0,13,30
30,Success,44,33,6,10,34
30,Success,48,22,7,13,35
30,Success,56,20,1,14,42
30,Success,49,27,1,11,38
30,Success,53,23,0,11,42
30,Success,51,31,0,11,40
30,Success,49,27,0,14,35
30,Success,53,22,0,12,41
30,Success,52,20,0,15,37
30,Success,52,21,0,15,37
30,Success,51,22,8,13,38
30,Success,48,24,8,12,36
30,Success,52,31,0,9,43
30,Success,47,26,0,13,34
30,Success,46,26,5,14,32
30,Success,49,25,0,14,35
30,Success,48,35,0,8,40
30,Success,50,27,0,13,37
30,Success,55,27,0,8,47
30,Success,46,29,0,14,32
30,Success,53,20,1,16,37
30,Success,50,27,2,8,42
30,Success,58,15,4,15,43
30,Success,50,21,0,16,34
30,Success,47,25,5,13,34
30,Success,52,22,0,15,37
30,Success,50,27,2,11,39
30,Success,54,18,3,14,40
30,Success,48,28,0,10,38
30,Success,47,25,2,13,34
30,Success,59,20,0,13,46
30,Success,48,24,0,15,33
30,Fail,45,31,0,17,28
30,Success,50,24,4,12,38
30,Success,52,28,0,8,44
30,Fail,36,37,5,11,25
30,Success,50,24,0,14,36
30,Success,41,30,8,11,30
30,Success,57,18,6,8,49
30,Success,44,26,0,14,30
30,Success,43,27,6,13,30
30,Success,45,26,0,13,32
30,Success,43,31,6,11,32
30,Success,49,27,0,10,39
30,Success,52,22,5,11,41
30,Success,54,21,1,12,42
30,Fail,38,34,10,12,26
30,Fail,43,28,2,18,25
30,Fail,43,25,5,18,25
30,Success,53,27,2,7,46
30,Success,53,21,2,13,40
30,Success,49,25,6,12,37
30,Success,51,22,0,15,36
30,Fail,42,28,4,16,26
30,Success,47,25,1,15,32
30,Success,52,28,0,11,41
30,Success,49,28,0,10,39
30,Success,55,21,1,9,46
30,Success,54,23,0,11,43
30,Success,43,26,7,11,32
30,Success,57,22,0,9,48
30,Fail,44,34,0,16,28
30,Success,53,26,0,10,43
30,Success,51,22,1,13,38
30,Success,54,22,0,12,42
30,Success,47,24,8,12,35
30,Success,51,21,2,16,35
30,Success,52,23,0,14,38
30,Success,47,30,0,13,34
30,Success,54,29,0,7,47
30,Success,46,33,0,8,38
30,Success,56,20,7,7,49
30,Success,50,25,4,10,40
30,Success,52,25,0,12,40
30,Success,53,23,8,6,47
30,Success,54,22,2,11,43
30,Success,52,23,3,10,42
30,Success,51,28,0,10,41
30,Success,46,27,0,16,30
30,Fail,43,31,0,14,29
30,Fail,44,33,0,15,29
30,Success,49,30,0,10,39
30,Success,47,34,0,12,35
30,Fail,45,29,0,16,29
30,Success,48,30,0,10,38
30,Success,49,26,0,13,36
30,Success,53,23,0,15,38
30,Success,51,26,0,12,39
30,Success,53,23,1,11,42
30,Success,57,20,2,9,48
30,Success,46,33,6,8,38
30,Success,55,23,3,7,48
30,Success,52,27,0,11,41
30,Success,51,29,0,9,42
30,Success,50,29,0,9,41
30,Success,57,25,0,6,51
30,Success,46,32,0,11,35
30,Success,51,26,5,11,40
30,Success,47,33,0,9,38
30,Success,50,25,1,12,38
30,Success,47,23,5,14,33
30,Success,49,25,0,15,34
30,Success,49,26,3,11,38
30,Fail,44,31,0,16,28
30,Success,50,30,0,10,40
30,Success,47,30,6,10,37
30,Success,52,25,0,11,41
30,Success,57,25,0,6,51
30,Success,47,36,0,12,35
30,Success,45,26,0,14,31
30,Success,44,25,10,14,30
30,Success,55,17,0,16,39
30,Success,47,33,0,10,37
30,Success,47,28,0,17,30
30,Success,45,35,0,8,37
30,Success,45,28,2,15,30
30,Success,52,27,0,13,39
30,Success,48,26,0,16,32
30,Fail,46,24,2,17,29
30,Fail,43,23,0,18,25
30,Success,46,31,0,10,36
30,Success,54,20,0,15,39
30,Success,47,26,4,13,34
30,Success,48,28,2,12,36
30,Success,46,30,0,11,35
30,Success,49,27,0,13,36
30,Success,47,31,2,11,36
30,Success,48,31,0,9,39
30,Fail,44,23,6,19,25
30,Fail,38,28,5,22,16
30,Success,47,22,7,12,35
30,Success,48,30,0,11,37
30,Success,53,27,0,8,45
30,Fail,38,27,6,17,21
30,Fail,45,23,9,17,28
30,Success,44,29,8,10,34
30,Fail,46,21,6,17,29
30,Success,52,23,1,12,40
30,Success,43,40,0,9,34
30,Fail,40,30,0,20,20
30,Success,50,24,10,9,41
30,Success,47,21,11,13,34
30,Success,45,31,8,7,38
30,Success,47,33,0,11,36
30,Success,53,25,2,9,44
30,Success,45,36,0,8,37
30,Success,52,27,0,9,43
30,Success,45,22,11,13,32
30,Success,46,34,0,9,37
30,Success,51,27,5,10,41
30,Success,51,22,3,13,38
30,Success,54,23,0,10,44
30,Success,48,24,2,15,33
30,Success,41,27,11,11,30
30,Success,49,28,0,14,35
30,Success,49,23,0,18,31
30,Fail,42,33,0,16,26
30,Success,50,34,0,7,43
30,Success,47,19,5,17,30
30,Success,50,26,1,14,36
30,Success,55,19,1,13,42
30,Success,47,25,1,14,33
30,Success,46,34,8,2,44
30,Success,46,28,5,16,30
30,Success,51,32,0,8,43
30,Success,47,20,5,15,32
30,Success,45,34,0,10,35
30,Success,48,26,0,13,35
30,Success,44,28,0,14,30
30,Success,48,30,0,11,37
30,Success,53,29,2,10,43
30,Success,50,25,0,12,38
30,Success,60,21,4,6,54
30,Success,47,30,2,12,35
30,Success,49,22,1,15,34
30,Success,47,25,8,11,36
30,Success,57,17,0,15,42
30,Success,48,30,2,9,39
30,Fail,42,31,0,17,25
30,Fail,44,23,5,18,26
30,Fail,41,26,6,18,23
30,Fail,40,33,2,14,26
30,Success,47,32,0,15,32
30,Success,49,27,0,14,35
30,Success,49,26,1,14,35
30,Success,49,21,1,17,32
30,Success,45,36,0,11,34
30,Success,50,26,3,10,40
30,Success,47,17,8,17,30
30,Fail,41,30,9,14,27
30,Success,53,26,2,12,41
30,Fail,48,22,0,19,29
30,Success,49,28,1,12,37
30,Success,46,26,1,15,31
30,Success,54,21,6,12,42
30,Success,45,31,6,10,35
30,Success,51,31,0,7,44
30,Fail,42,35,0,15,27
30,Success,46,24,6,16,30
30,Fail,39,38,0,19,20
30,Success,52,25,0,12,40
30,Success,48,28,4,12,36
30,Success,42,32,0,12,30
30,Success,51,30,0,13,38
30,Success,53,19,3,11,42
30,Fail,41,26,11,13,28
30,Success,44,31,0,13,31
30,Success,47,33,0,9,38
30,Success,46,26,6,13,33
30,Success,47,24,2,15,32
30,Success,52,22,4,11,41
30,Success,50,20,6,13,37
30,Fail,40,34,0,17,23
30,Success,51,26,0,12,39
30,Success,50,29,4,9,41
30,Success,52,26,0,11,41
30,Fail,41,32,4,14,27
30,Success,51,24,0,13,38
30,Success,51,28,1,6,45
30,Success,49,26,4,10,39
30,Success,47,37,0,4,43
30,Success,44,33,0,13,31
30,Success,45,31,0,12,33
30,Success,46,26,5,13,33
30,Fail,44,27,0,24,20
30,Success,51,29,0,10,41
30,Fail,44,25,3,18,26
30,Success,47,29,0,11,36
30,Success,54,24,5,6,48
30,Success,53,21,4,11,42
30,Fail,41,29,2,17,24
30,Fail,41,29,0,18,23
30,Success,47,35,0,9,38
30,Success,47,28,3,13,34
30,Success,45,33,3,12,33
30,Fail,39,30,0,19,20
30,Success,48,28,0,15,33
30,Success,59,13,0,15,44
30,Success,51,31,2,6,45
30,Success,51,28,0,10,41
30,Success,55,28,0,7,48
30,Success,48,31,3,9,39
30,Success,57,19,3,9,48
30,Success,49,26,3,14,35
30,Fail,37,34,1,15,22
30,Success,50,26,0,12,38
30,Success,44,28,2,13,31
30,Fail,43,24,0,19,24
30,Success,45,34,0,10,35
30,Success,52,29,0,11,41
30,Success,50,26,9,7,43
30,Success,52,26,0,14,38
30,Fail,38,27,10,14,24
30,Success,44,36,0,12,32
30,Success,59,19,0,9,50
30,Success,49,28,0,13,36
30,Fail,41,39,0,13,28
30,Success,58,16,4,10,48
30,Success,55,23,6,9,46
30,Success,44,33,0,13,31
30,Fail,43,32,0,16,27
30,Success,54,27,0,9,45
30,Success,53,19,5,12,41
30,Success,46,20,11,13,33
30,Fail,35,47,0,11,24
30,Success,48,26,3,11,37
30,Success,47,37,0,9,38
30,Success,45,33,1,10,35
30,Success,49,26,1,13,36
30,Success,51,24,0,9,42
30,Fail,42,31,0,16,26
30,Fail,39,40,0,13,26
30,Success,48,35,0,10,38
30,Success,45,32,0,13,32
30,Fail,43,28,0,21,22
30,Success,49,32,0,10,39
30,Success,48,27,2,12,36
30,Success,50,27,0,11,39
30,Success,56,25,0,8,48
30,Success,53,24,0,11,42
30,Fail,42,30,0,15,27
30,Success,53,22,2,10,43
30,Fail,40,27,5,18,22
30,Success,52,24,0,14,38
30,Success,44,29,0,14,30
30,Success,48,25,1,12,36
30,Success,49,27,5,8,41
30,Success,53,22,3,9,44
30,Fail,36,37,0,17,19
30,Fail,48,21,1,20,28
30,Success,53,28,0,8,45
30,Success,47,28,4,10,37
30,Fail,37,28,8,18,19
30,Success,51,26,0,10,41
30,Success,56,15,5,15,41
30,Success,55,23,5,12,43
30,Fail,43,36,0,14,29
30,Success,54,20,0,14,40
30,Success,46,32,0,14,32
30,Fail,45,22,3,21,24
30,Success,50,26,0,14,36
30,Success,45,41,0,5,40
30,Success,52,20,1,13,39
30,Success,55,25,0,11,44
30,Success,51,29,0,9,42
30,Success,52,23,7,5,47
30,Success,48,27,0,13,35
30,Success,42,37,0,10,32
30,Success,54,21,3,7,47
30,Success,47,39,0,5,42
30,Fail,42,25,7,20,22
30,Success,55,30,0,10,45
30,Success,52,24,2,15,37
30,Success,48,22,3,14,34
30,Success,47,26,0,17,30
30,Success,51,24,2,14,37
30,Success,49,19,8,14,35
30,Success,50,25,0,17,33
30,Success,51,29,0,8,43
30,Success,55,18,1,13,42
30,Success,47,29,0,12,35
30,Success,56,22,0,9,47
30,Success,58,23,0,11,47
30,Success,46,34,0,11,35
30,Fail,39,27,0,22,17
30,Fail,42,28,10,15,27
30,Success,47,24,0,16,31
30,Success,49,26,3,15,34
30,Fail,43,24,2,20,23
30,Success,44,34,0,10,34
30,Fail,42,34,0,17,25
30,Success,49,18,10,15,34
30,Success,55,23,0,8,47
30,Success,45,27,1,14,31
30,Fail,40,34,0,15,25
30,Success,50,23,2,16,34
30,Fail,46,23,0,19,27
30,Success,42,39,0,12,30
30,Success,50,25,3,11,39
30,Success,56,22,1,8,48
30,Success,51,26,0,13,38
30,Fail,43,27,0,19,24
30,Success,50,23,2,15,35
30,Success,55,19,0,9,46
30,Success,44,34,0,11,33
30,Success,52,26,0,11,41
30,Success,43,35,6,12,31
30,Fail,43,29,8,15,28
30,Success,45,29,0,12,33
30,Success,47,28,0,11,36
30,Success,52,15,6,13,39
30,Success,53,24,0,10,43
30,Success,47,30,0,12,35
30,Success,59,17,0,10,49
30,Success,46,30,0,14,32
30,Success,51,31,0,6,45
30,Success,46,22,6,10,36
30,Success,45,26,4,12,33
30,Success,49,24,1,12,37
30,Success,46,23,0,16,30
30,Success,49,33,0,10,39
30,Fail,45,29,0,18,27
30,Success,49,22,6,11,38
30,Success,46,20,7,14,32
30,Success,49,27,1,12,37
30,Success,54,19,0,15,39
30,Success,48,29,3,11,37
30,Success,47,26,8,10,37
30,Success,42,40,0,10,32
30,Success,50,21,0,19,31
30,Success,55,20,0,12,43
30,Success,54,20,1,13,41
30,Success,58,15,1,9,49
30,Fail,43,24,5,18,25
30,Success,48,27,1,11,37
30,Success,53,20,2,13,40
30,Success,48,33,0,10,38
30,Success,45,32,3,9,36
30,Success,47,39,0,6,41
30,Fail,45,19,6,18,27
30,Fail,44,23,7,15,29
30,Success,50,23,0,11,39
30,Success,49,31,0,11,38
30,Success,55,22,3,10,45
30,Success,47,24,6,14,33
30,Success,49,23,1,17,32
30,Success,48,28,3,10,38
30,Success,48,32,1,12,36
30,Success,47,31,2,10,37
30,Success,47,24,6,11,36
30,Success,58,21,0,9,49
30,Fail,46,22,0,17,29
30,Success,49,23,2,16,33
30,Success,55,25,4,7,48
30,Success,54,24,0,11,43
30,Success,51,30,4,7,44
30,Success,47,27,0,17,30
30,Success,48,24,7,14,34
30,Success,45,36,1,9,36
30,Success,47,22,1,16,31
30,Success,49,35,0,9,40
30,Success,54,26,3,9,45
30,Success,52,24,0,10,42
30,Fail,42,27,10,13,29
30,Success,53,24,0,9,44
30,Success,46,32,0,12,34
30,Success,44,33,0,11,33
30,Fail,42,38,0,13,29
30,Success,47,25,0,15,32
30,Success,50,28,0,13,37
30,Success,49,27,1,11,38
30,Success,51,25,0,14,37
30,Success,46,31,2,9,37
30,Success,49,24,4,15,34
30,Success,51,22,0,12,39
30,Fail,44,32,0,17,27
30,Success,47,25,0,16,31
30,Success,48,29,0,15,33
30,Success,49,22,4,13,36
30,Success,45,30,0,12,33
30,Fail,42,27,10,16,26
30,Success,47,24,4,13,34
30,Fail,43,25,3,18,25
30,Success,47,26,0,16,31
30,Success,47,25,0,14,33
30,Fail,44,27,0,19,25
30,Success,50,32,0,12,38
30,Success,50,23,1,9,41
30,Fail,42,22,9,16,26
30,Success,51,25,0,12,39
30,Success,53,20,1,17,36
30,Success,55,24,0,11,44
30,Success,55,23,2,8,47
30,Success,53,29,3,6,47
30,Success,53,23,0,13,40
30,Success,51,20,3,13,38
30,Success,50,22,0,17,33
30,Success,50,26,0,12,38
30,Fail,43,32,0,15,28
30,Fail,44,29,0,16,28
30,Fail,43,32,0,15,28
30,Success,50,30,1,8,42
30,Success,54,21,3,13,41
30,Success,44,26,8,13,31
30,Success,50,19,0,16,34
30,Fail,46,24,2,18,28
30,Fail,43,23,7,17,26
30,Success,50,18,4,14,36
30,Success,51,27,0,15,36
30,Success,53,19,3,14,39
30,Success,45,33,0,12,33
30,Success,46,33,1,8,38
30,Success,50,28,0,9,41
30,Success,41,32,6,10,31
30,Fail,41,39,0,15,26
30,Success,48,23,7,12,36
30,Success,49,27,6,10,39
30,Success,53,18,4,13,40
30,Fail,42,26,2,14,28
30,Success,49,24,0,11,38
30,Success,49,25,0,17,32
30,Success,58,16,0,11,47
30,Success,44,30,0,13,31
30,Success,46,28,0,15,31
30,Success,47,23,7,12,35
30,Success,47,22,0,17,30
30,Success,53,29,0,8,45
30,Success,46,22,2,15,31
30,Success,46,27,5,13,33
30,Success,43,38,0,9,34
30,Success,50,31,0,9,41
30,Success,57,19,1,13,44
30,Success,49,26,0,12,37
30,Success,44,35,0,10,34
30,Success,50,25,0,11,39
30,Success,46,33,0,10,36
30,Success,51,22,5,10,41
30,Success,52,21,1,10,42
30,Fail,42,30,0,19,23
30,Success,48,22,4,13,35
30,Success,42,36,0,11,31
30,Success,49,25,5,11,38
30,Fail,42,34,0,17,25
30,Success,45,34,0,9,36
30,Fail,42,31,0,16,26
30,Success,53,26,0,10,43
30,Success,50,24,4,11,39
30,Success,51,24,0,13,38
30,Success,45,30,0,14,31
30,Success,49,29,0,10,39
30,Success,47,26,0,13,34
30,Success,47,27,0,15,32
30,Success,49,26,0,11,38
30,Success,48,29,0,12,36
30,Success,52,22,0,15,37
30,Success,48,37,0,7,41
30,Fail,40,24,7,17,23
30,Fail,42,29,4,15,27
30,Success,44,31,0,13,31
30,Success,49,31,0,10,39
30,Success,48,36,4,6,42
30,Fail,42,36,0,14,28
30,Success,48,33,0,11,37
30,Success,58,20,0,11,47
30,Success,50,25,0,14,36
30,Success,55,24,1,8,47
30,Success,45,27,1,14,31
30,Success,51,24,3,13,38
30,Success,53,26,1,9,44
30,Fail,43,26,1,15,28
30,Fail,39,30,14,12,27
30,Success,46,29,0,16,30
30,Success,44,27,5,14,30
30,Success,49,27,1,11,38
30,Success,50,25,4,11,39
30,Success,47,22,0,16,31
30,Success,48,23,4,11,37
30,Success,45,27,6,13,32
30,Fail,40,28,5,17,23
30,Success,44,29,4,13,31
30,Fail,43,23,7,17,26
30,Success,53,14,2,20,33
30,Fail,52,17,1,23,29
30,Success,52,26,0,9,43
30,Success,51,31,4,8,43
30,Success,44,35,0,9,35
30,Success,49,25,2,5,44
30,Success,48,28,4,11,37
30,Success,47,38,0,7,40
30,Success,48,26,3,17,31
30,Success,42,30,4,12,30
30,Fail,38,32,5,10,28
30,Fail,45,27,0,19,26
30,Success,49,24,1,14,35
30,Success,48,27,0,14,34
30,Success,51,21,3,13,38
30,Fail,37,32,4,18,19
30,Success,54,24,0,15,39
30,Success,53,21,4,9,44
30,Success,51,26,3,10,41
30,Fail,47,23,0,20,27
30,Success,54,24,0,12,42
30,Success,56,17,1,13,43
30,Success,50,30,0,7,43
30,Success,50,32,0,11,39
30,Success,57,24,0,9,48
30,Success,57,17,10,7,50
30,Success,55,26,0,11,44
30,Success,50,29,0,13,37
30,Success,53,20,0,12,41
30,Success,43,35,6,9,34
30,Success,47,22,4,16,31
30,Success,52,23,3,15,37
30,Success,51,26,0,11,40
30,Success,50,24,4,8,42
30,Success,48,24,0,17,31
30,Success,40,45,0,6,34
30,Success,47,31,0,11,36
30,Success,48,26,0,13,35
30,Success,54,24,0,8,46
30,Success,48,26,8,10,38
30,Success,50,26,0,14,36
30,Success,47,37,0,10,37
30,Success,52,23,0,11,41
30,Success,46,27,1,14,32
30,Success,46,29,2,8,38
30,Fail,40,36,0,13,27
30,Success,50,29,0,10,40
30,Success,50,27,5,9,41
30,Success,52,26,0,10,42
30,Fail,39,26,11,14,25
30,Success,54,25,0,12,42
30,Success,52,28,0,11,41
30,Success,54,18,4,12,42
30,Success,51,25,0,10,41
30,Fail,43,31,1,14,29
30,Success,47,30,0,10,37
30,Fail,40,31,7,14,26
30,Success,46,32,1,12,34
30,Success,52,22,3,17,35
30,Success,49,32,0,5,44
30,Success,53,22,2,11,42
30,Success,50,23,8,13,37
30,Success,55,19,3,14,41
30,Success,50,21,2,15,35
30,Success,53,23,3,9,44
30,Success,43,36,0,11,32
30,Fail,36,50,0,10,26
30,Success,54,23,0,10,44
30,Success,50,21,1,19,31
30,Success,51,24,0,11,40
30,Success,51,22,4,11,40
30,Success,49,20,6,14,35
30,Success,48,23,5,15,33
30,Success,54,19,6,9,45
30,Success,45,36,0,12,33
30,Fail,40,32,3,14,26
30,Fail,41,30,0,16,25
30,Success,50,30,0,11,39
30,Success,50,25,0,14,36
30,Success,45,30,0,11,34
30,Success,53,23,0,10,43
30,Success,44,29,0,14,30
30,Success,57,18,7,7,50
30,Fail,42,36,0,13,29
30,Success,50,17,5,14,36
30,Fail,41,30,4,16,25
30,Success,45,35,0,12,33
30,Success,45,26,5,11,34
30,Fail,39,34,0,14,25
30,Success,44,31,4,12,32
30,Success,47,29,4,12,35
30,Success,48,33,0,9,39
30,Fail,39,32,0,19,20
30,Success,48,24,0,11,37
30,Success,43,39,0,9,34
30,Success,42,34,3,9,33
30,Success,50,20,6,10,40
30,Success,55,19,4,8,47
30,Fail,43,18,4,22,21
30,Success,44,34,0,13,31
30,Success,49,24,4,12,37
30,Success,48,25,3,14,34
30,Success,50,27,0,14,36
30,Success,54,25,0,10,44
30,Success,48,24,3,13,35
30,Success,52,19,1,18,34
30,Success,54,21,0,13,41
30,Fail,42,25,13,15,27
30,Success,58,28,0,8,50
30,Fail,40,42,0,12,28
30,Success,52,25,0,15,37
30,Success,45,28,5,15,30
30,Success,53,23,4,10,43
30,Success,55,19,3,10,45
30,Success,48,23,5,14,34
30,Success,46,34,0,13,33
30,Success,53,20,1,16,37
30,Success,47,27,3,13,34
30,Fail,42,30,0,16,26
30,Success,47,26,1,14,33
30,Fail,45,28,1,16,29
30,Success,48,25,0,15,33
30,Success,47,36,0,9,38
30,Success,51,30,0,7,44
30,Success,48,30,0,8,40
30,Success,50,28,1,11,39
30,Success,44,33,0,14,30
30,Success,49,31,1,11,38
30,Success,48,26,5,13,35
30,Success,47,32,0,9,38
30,Success,53,18,4,17,36
30,Success,53,21,2,13,40
30,Success,46,33,0,13,33
30,Success,48,30,0,13,35
30,Success,50,26,0,14,36
30,Success,58,19,2,6,52
30,Success,50,35,0,6,44
30,Success,45,23,11,9,36
30,Fail,42,31,0,20,22
30,Success,47,35,0,6,41
30,Success,52,23,0,11,41
30,Success,44,39,0,10,34
30,Success,54,24,0,14,40
30,Success,52,28,0,13,39
30,Success,50,24,0,11,39
30,Success,51,19,4,17,34
30,Fail,42,29,1,16,26
30,Success,45,23,7,14,31
30,Fail,46,21,2,21,25
30,Success,59,16,5,9,50
30,Fail,45,24,0,17,28
30,Fail,43,27,7,14,29
30,Success,55,24,4,8,47
30,Success,48,24,0,16,32
30,Fail,40,36,0,16,24
30,Success,48,39,0,6,42
30,Success,48,24,1,15,33
30,Success,44,40,0,10,34
30,Success,48,31,0,12,36
30,Success,52,25,4,8,44
30,Success,52,22,3,12,40
30,Success,47,29,3,9,38
30,Success,47,24,6,12,35
30,Success,46,37,0,10,36
30,Success,45,29,0,15,30
30,Success,47,29,0,12,35
30,Success,56,23,0,9,47
30,Success,53,24,0,11,42
30,Fail,39,36,0,18,21
30,Success,49,23,8,11,38
30,Fail,41,27,0,18,23
30,Success,50,28,5,12,38
30,Fail,38,32,0,19,19
30,Success,44,32,0,12,32
30,Success,49,27,1,10,39
30,Success,46,25,0,14,32
30,Fail,44,31,0,17,27
30,Success,44,33,0,13,31
30,Success,47,35,0,9,38
30,Fail,46,29,0,17,29
30,Success,49,31,0,11,38
30,Fail,41,39,0,14,27
30,Fail,45,27,3,16,29
30,Success,47,29,4,10,37
30,Success,52,20,7,10,42
30,Success,54,26,5,7,47
30,Fail,44,27,0,16,28
30,Success,57,19,2,9,48
30,Success,56,22,2,6,50
30,Success,47,24,0,17,30
30,Success,49,28,7,7,42
30,Success,57,27,0,8,49
30,Success,48,26,4,9,39
30,Success,45,24,13,15,30
30,Success,49,27,0,13,36
30,Fail,42,31,0,18,24
30,Success,42,33,6,10,32
30,Success,51,27,0,12,39
30,Success,49,30,1,9,40
30,Fail,41,26,13,15,26
30,Success,42,36,0,9,33
30,Success,53,19,0,15,38
30,Success,46,32,0,9,37
30,Fail,42,26,2,17,25
30,Success,46,26,0,14,32
30,Fail,40,29,8,12,28
30,Success,48,27,0,15,33
30,Success,47,32,0,9,38
30,Success,51,19,1,14,37
30,Success,45,27,8,11,34
30,Success,43,37,0,11,32
30,Fail,38,34,4,19,19
30,Success,54,16,5,14,40
30,Fail,45,25,4,16,29
30,Success,49,25,0,14,35
30,Success,49,31,0,9,40
30,Success,46,24,4,13,33
30,Success,42,30,10,12,30
30,Success,44,30,4,8,36
30,Success,50,24,2,13,37
30,Success,57,18,0,12,45
30,Success,54,22,2,14,40
30,Success,54,21,0,10,44
30,Success,48,24,2,12,36
30,Fail,44,27,0,16,28
30,Fail,43,28,7,14,29
30,Success,51,26,3,13,38
30,Success,61,23,1,4,57
30,Success,47,23,3,16,31
30,Success,50,27,2,13,37
30,Success,47,31,0,12,35
30,Success,49,23,5,13,36
30,Success,51,22,3,15,36
30,Success,47,26,0,16,31
30,Success,49,21,0,17,32
30,Fail,47,15,5,19,28
30,Success,50,32,0,7,43
30,Success,47,22,1,14,33
30,Success,52,26,0,10,42
30,Success,46,27,2,13,33
30,Success,52,25,2,10,42
30,Success,48,26,0,17,31
30,Fail,37,31,8,16,21
30,Fail,41,30,0,17,24
30,Success,57,18,0,12,45
30,Fail,40,39,0,13,27
30,Success,48,30,0,12,36
30,Success,47,29,0,14,33
30,Success,46,27,0,16,30
30,Success,45,32,0,15,30
30,Success,48,27,4,13,35
30,Fail,36,32,4,20,16
30,Success,52,21,5,7,45
30,Success,51,31,0,8,43
30,Success,44,32,5,12,32
30,Success,47,32,0,11,36
30,Success,51,29,3,7,44
30,Success,59,20,0,10,49
30,Success,50,24,0,16,34
30,Success,50,21,7,13,37
30,Fail,43,30,0,15,28
30,Fail,42,33,0,14,28
30,Success,46,31,0,13,33
30,Fail,38,38,0,18,20
30,Success,47,33,0,11,36
30,Success,46,28,1,14,32
30,Success,56,22,1,10,46
30,Fail,45,26,0,19,26
30,Fail,43,21,9,15,28
30,Success,49,27,0,9,40
30,Success,49,22,9,12,37
30,Success,49,21,0,19,30
30,Success,52,28,0,8,44
30,Success,53,21,0,12,41
30,Success,46,34,0,10,36
30,Success,49,31,3,8,41
30,Success,52,23,0,13,39
30,Success,48,29,0,13,35
30,Success,51,27,2,12,39
30,Success,50,28,1,13,37
30,Success,49,26,0,19,30
30,Success,45,34,0,10,35
30,Success,50,29,0,9,41
30,Success,47,32,0,11,36
30,Fail,43,32,0,15,28
30,Success,50,26,0,11,39
30,Success,48,25,0,16,32
30,Success,45,22,8,15,30
30,Success,45,28,4,15,30
30,Success,49,27,0,13,36
30,Success,48,28,0,11,37
30,Fail,42,28,1,14,28
30,Success,46,26,10,8,38
30,Fail,42,27,7,13,29
30,Fail,43,37,0,15,28
30,Success,53,27,1,9,44
30,Fail,43,26,4,16,27
30,Success,44,39,0,10,34
30,Success,46,30,0,12,34
30,Success,48,28,0,10,38
30,Success,46,33,0,9,37
30,Success,45,32,0,15,30
30,Success,50,28,0,10,40
30,Success,52,27,0,11,41
30,Success,58,27,0,8,50
30,Success,54,25,1,9,45
30,Success,48,27,5,11,37
30,Success,45,35,0,13,32
30,Fail,44,32,0,15,29
30,Success,51,30,1,9,42
30,Success,53,23,0,12,41
30,Success,50,26,2,11,39
30,Success,50,31,0,9,41
30,Fail,41,35,0,17,24
30,Success,55,22,1,8,47
30,Success,52,25,4,8,44
30,Success,40,35,1,8,32
30,Success,48,23,2,12,36
30,Fail,42,34,0,16,26
30,Success,49,23,0,12,37
30,Fail,35,32,9,19,16
30,Success,48,30,3,9,39
30,Success,46,27,2,9,37
30,Success,51,25,1,17,34
30,Success,49,22,8,15,34
30,Success,52,27,1,11,41
30,Success,51,25,0,9,42
30,Success,45,27,0,15,30
30,Success,53,27,2,9,44
30,Success,51,30,0,7,44
30,Success,50,23,3,13,37
30,Success,50,22,0,15,35
30,Fail,43,28,6,14,29
30,Success,46,27,5,9,37
30,Success,51,30,0,12,39
30,Success,46,28,4,13,33
30,Fail,42,32,1,15,27
30,Success,46,36,0,10,36
30,Fail,41,26,3,15,26
30,Success,50,27,0,10,40
30,Success,53,21,0,13,40
30,Success,51,21,0,16,35
30,Success,44,35,0,11,33
30,Fail,44,23,5,16,28
30,Success,48,29,0,13,35
30,Success,55,18,1,13,42
30,Success,56,20,4,9,47
30,Success,53,17,0,14,39
30,Success,53,24,6,10,43
30,Success,48,30,0,12,36
30,Success,48,28,5,10,38
30,Success,50,23,6,13,37
30,Success,48,33,0,12,36
30,Success,52,22,5,10,42
30,Success,45,27,0,14,31
30,Success,51,21,0,14,37
30,Fail,39,39,0,11,28
30,Success,52,23,0,15,37
30,Success,52,22,0,12,40
30,Fail,47,29,0,18,29
30,Success,51,26,5,11,40
30,Success,50,27,0,11,39
30,Fail,44,27,0,17,27
30,Success,47,25,0,15,32
30,Success,49,26,1,10,39
30,Success,50,23,1,13,37
30,Success,45,30,0,13,32
30,Success,50,29,0,12,38
30,Fail,38,31,2,14,24
30,Success,47,24,2,13,34
30,Success,51,23,0,16,35
30,Fail,39,37,0,15,24
30,Fail,42,25,5,18,24
30,Success,50,24,0,11,39
30,Fail,46,27,0,18,28
30,Success,40,32,8,10,30
30,Success,45,23,7,11,34
30,Success,47,31,0,9,38
30,Success,49,28,1,11,38
30,Success,49,31,0,11,38
30,Success,52,26,3,9,43
30,Success,50,23,7,5,45
30,Fail,44,29,0,15,29
30,Success,52,28,0,9,43
30,Success,50,26,0,13,37
30,Success,57,20,4,9,48
30,Success,48,26,2,13,35
30,Fail,41,33,4,15,26
30,Fail,44,23,3,19,25
30,Success,52,26,0,10,42
30,Success,52,25,3,9,43
30,Fail,41,28,11,13,28
30,Success,53,26,1,7,46
30,Success,46,27,3,14,32
30,Success,45,26,2,15,30
30,Success,49,22,0,14,35
30,Success,43,41,0,8,35
30,Success,51,22,4,11,40
30,Fail,40,31,0,17,23
30,Success,50,25,1,13,37
30,Fail,41,34,0,16,25
30,Success,51,26,0,11,40
30,Success,48,25,5,14,34
30,Success,48,28,5,10,38
30,Success,56,23,0,11,45
30,Success,47,26,6,13,34
30,Fail,43,33,0,15,28
30,Fail,45,26,0,17,28
30,Success,44,25,10,12,32
30,Success,52,27,3,10,42
30,Success,54,19,0,12,42
30,Success,52,25,3,9,43
30,Success,43,32,2,9,34
30,Success,51,27,0,10,41
30,Success,48,26,2,12,36
30,Success,47,27,3,12,35
30,Success,48,28,0,13,35
30,Fail,43,31,0,15,28
30,Success,51,31,2,5,46
30,Success,49,20,0,16,33
30,Success,47,28,0,16,31
30,Success,52,23,2,14,38
30,Success,53,31,0,9,44
30,Success,54,22,0,11,43
30,Success,55,18,2,13,42
30,Success,44,29,3,13,31
30,Success,53,26,0,11,42
30,Success,47,23,8,16,31
30,Success,50,29,3,8,42
30,Success,48,19,7,12,36
30,Success,46,17,10,16,30
30,Success,52,27,0,11,41
30,Success,57,20,0,10,47
30,Success,56,18,3,12,44
30,Fail,40,30,2,16,24
30,Success,48,19,4,15,33
30,Success,45,24,0,14,31
30,Success,41,43,0,8,33
30,Success,50,21,0,15,35
30,Fail,49,19,0,25,24
30,Fail,44,25,1,15,29
30,Success,50,29,0,9,41
30,Fail,44,25,0,20,24
30,Fail,37,28,12,18,19
30,Success,49,25,0,10,39
30,Fail,42,25,1,21,21
30,Success,48,29,0,13,35
30,Success,43,30,6,12,31
30,Success,47,32,0,13,34
30,Success,62,23,5,3,59
30,Success,52,22,2,12,40
30,Success,51,24,5,10,41
30,Success,47,27,2,12,35
30,Success,56,22,1,10,46
30,Success,50,27,0,13,37
30,Success,49,25,0,14,35
30,Success,56,24,0,8,48
30,Success,57,24,0,9,48
30,Success,50,28,0,12,38
30,Success,49,23,5,15,34
30,Success,44,28,4,13,31
30,Success,52,24,0,12,40
30,Fail,42,36,0,16,26
30,Success,54,26,1,8,46
30,Success,49,27,0,11,38
30,Success,51,24,0,15,36
30,Success,50,23,3,10,40
30,Success,43,34,2,13,30
30,Success,44,28,10,11,33
30,Success,50,25,0,17,33
30,Success,52,24,4,10,42
30,Success,44,22,10,12,32
30,Success,49,29,0,12,37
30,Success,54,20,0,15,39
30,Success,48,27,0,13,35
30,Success,50,29,0,11,39
30,Fail,43,26,0,18,25
30,Success,51,21,5,12,39
30,Success,44,22,11,12,32
30,Success,51,25,0,10,41
30,Success,46,31,0,11,35
30,Fail,47,21,0,20,27
30,Success,45,25,11,11,34
30,Success,49,21,2,15,34
30,Success,43,33,0,13,30
30,Fail,41,23,9,16,25
30,Success,49,20,9,15,34
30,Success,45,27,2,14,31
30,Success,45,34,0,10,35
30,Success,47,32,0,12,35
30,Success,49,26,2,12,37
30,Success,56,25,1,7,49
30,Fail,40,38,0,11,29
30,Success,49,24,0,14,35
30,Success,49,31,4,9,40
30,Success,49,18,1,17,32
30,Success,45,34,0,12,33
30,Fail,42,30,0,14,28
30,Success,51,19,6,13,38
30,Success,45,26,0,14,31
30,Success,42,36,0,10,32
30,Success,54,22,0,15,39
30,Success,43,38,0,9,34
30,Success,49,24,3,14,35
30,Fail,46,25,0,17,29
30,Success,48,22,7,15,33
30,Fail,42,33,0,15,27
30,Success,57,24,6,4,53
30,Success,53,24,5,10,43
30,Success,57,20,0,9,48
30,Fail,44,28,0,17,27
30,Success,58,27,0,8,50
30,Success,46,30,0,16,30
30,Fail,43,30,0,15,28
30,Success,53,24,3,9,44
30,Success,46,31,4,9,37
30,Success,43,29,4,11,32
30,Success,50,24,4,11,39
30,Success,48,27,0,15,33
30,Success,46,31,0,11,35
30,Success,48,29,0,11,37
30,Success,48,28,0,14,34
30,Success,48,27,2,12,36
30,Success,47,21,7,11,36
30,Success,50,25,0,13,37
30,Success,56,24,0,12,44
30,Success,55,25,5,8,47
30,Success,58,22,1,8,50
30,Success,47,25,10,9,38
30,Success,49,23,11,11,38
30,Success,54,20,0,13,41
30,Success,51,26,1,12,39
30,Success,46,27,0,12,34
30,Success,44,26,13,11,33
30,Success,47,25,3,12,35
30,Success,49,26,4,11,38
30,Success,49,31,0,8,41
30,Success,52,27,1,9,43
30,Fail,43,34,0,17,26
30,Success,51,30,0,12,39
30,Success,51,29,0,9,42
30,Success,54,25,2,8,46
30,Fail,43,30,4,14,29
30,Success,46,29,0,14,32
30,Success,52,26,0,10,42
30,Success,53,26,0,11,42
30,Success,46,22,3,16,30
30,Success,45,29,7,9,36
30,Success,49,28,0,14,35
30,Success,45,28,0,15,30
30,Success,44,31,2,14,30
30,Success,47,26,0,17,30
30,Success,48,29,0,12,36
30,Success,56,24,0,10,46
30,Success,51,27,5,10,41
30,Success,47,30,0,12,35
30,Success,51,24,2,14,37
30,Success,47,23,0,15,32
30,Success,45,33,0,13,32
30,Success,50,31,0,13,37
30,Success,48,24,3,16,32
30,Fail,43,29,0,15,28
30,Success,46,29,0,12,34
30,Success,56,25,0,9,47
30,Success,52,29,0,10,42
30,Fail,45,25,4,18,27
30,Success,53,20,1,11,42
30,Fail,47,21,5,18,29
30,Fail,43,26,3,17,26
30,Success,47,21,4,17,30
30,Success,47,30,2,10,37
30,Success,51,30,0,12,39
30,Success,47,25,3,14,33
30,Success,45,30,0,11,34
30,Success,54,27,0,8,46
30,Success,53,22,0,14,39
30,Fail,39,42,0,14,25
30,Success,56,19,2,9,47
30,Success,50,36,0,7,43
30,Success,49,27,0,12,37
30,Fail,43,33,0,16,27
30,Fail,44,26,0,17,27
30,Fail,42,29,5,14,28
30,Success,49,27,0,11,38
30,Success,45,27,2,14,31
30,Success,50,16,0,20,30
30,Success,50,29,0,12,38
30,Success,52,29,5,7,45
30,Success,44,31,0,13,31
30,Success,51,20,5,14,37
30,Success,50,26,0,13,37
30,Success,51,26,0,15,36
30,Success,46,33,0,12,34
30,Success,43,35,7,8,35
30,Success,51,25,2,11,40
30,Fail,41,39,0,12,29
30,Success,51,24,2,14,37
30,Success,54,21,0,15,39
30,Success,49,25,0,11,38
30,Success,51,27,0,14,37
30,Success,52,24,0,16,36
30,Success,60,21,0,8,52
30,Fail,46,23,0,17,29
30,Success,53,18,0,16,37
30,Success,49,22,2,12,37
30,Success,52,19,0,12,40
30,Success,49,26,4,10,39
30,Success,51,24,6,10,41
30,Success,51,24,6,9,42
30,Success,52,18,2,14,38
30,Success,52,26,4,10,42
30,Success,46,28,0,16,30
30,Success,48,22,1,15,33
30,Success,48,25,2,16,32
30,Success,50,22,5,14,36
30,Success,57,23,2,10,47
30,Success,51,30,2,6,45
30,Success,50,29,0,12,38
30,Success,47,22,10,13,34
30,Success,47,29,0,13,34
30,Success,50,34,0,8,42
30,Fail,42,29,0,17,25
30,Success,45,36,0,10,35
30,Success,49,25,5,13,36
30,Success,54,20,0,14,40
30,Fail,42,32,0,17,25
30,Success,45,36,0,10,35
30,Success,50,22,0,16,34
30,Success,45,26,7,13,32
30,Success,50,23,4,13,37
30,Success,51,22,3,13,38
30,Success,54,22,2,11,43
30,Success,49,26,0,13,36
30,Success,53,25,1,9,44
30,Success,54,21,0,13,41
30,Success,47,23,3,17,30
30,Success,44,33,2,12,32
30,Success,47,24,8,12,35
30,Fail,45,24,8,18,27
30,Success,58,18,1,10,48
30,Fail,42,32,0,17,25
30,Success,48,22,5,13,35
30,Success,47,23,7,14,33
30,Success,45,25,13,12,33
30,Success,53,22,0,11,42
30,Fail,41,33,0,17,24
30,Success,51,31,0,5,46
30,Success,49,31,0,10,39
30,Fail,42,23,10,17,25
30,Fail,43,29,0,15,28
30,Success,49,24,4,11,38
30,Success,47,26,2,16,31
30,Success,59,27,0,10,49
30,Success,50,26,0,10,40
30,Success,52,24,0,14,38
30,Success,53,22,4,11,42
30,Success,51,27,0,13,38
30,Success,45,28,0,15,30
30,Success,46,31,0,13,33
30,Success,55,29,0,6,49
30,Success,48,28,6,12,36
30,Success,49,27,0,12,37
30,Success,45,26,6,15,30
30,Success,53,25,1,12,41
30,Success,44,24,14,11,33
30,Success,44,41,0,9,35
30,Success,48,27,3,13,35
30,Success,53,24,0,13,40
30,Success,54,25,0,10,44
30,Success,50,27,0,14,36
30,Success,51,26,4,7,44
30,Success,47,31,0,14,33
30,Success,48,24,2,14,34
30,Success,52,25,1,12,40
30,Success,52,23,5,11,41
30,Success,47,28,6,10,37
30,Success,50,20,4,14,36
30,Success,47,36,0,12,35
30,Fail,41,28,3,20,21
30,Success,48,29,0,12,36
30,Fail,41,31,0,15,26
30,Success,53,19,3,13,40
30,Fail,31,30,13,18,13
30,Success,47,30,0,11,36
30,Success,50,24,0,13,37
30,Success,55,21,0,14,41
30,Success,50,28,0,13,37
30,Success,53,25,0,10,43
30,Success,49,34,0,9,40
30,Success,45,27,6,13,32
30,Success,50,21,5,13,37
30,Fail,44,25,0,19,25
30,Success,50,21,3,15,35
30,Success,44,24,6,12,32
30,Success,54,26,0,14,40
30,Success,49,23,1,14,35
30,Fail,39,31,12,15,24
30,Success,49,29,0,11,38
30,Fail,44,26,1,21,23
30,Success,55,19,4,11,44
30,Success,51,22,0,15,36
30,Success,52,24,0,14,38
30,Success,48,26,0,15,33
30,Success,47,25,2,17,30
30,Fail,45,24,4,19,26
30,Success,43,29,3,13,30
30,Success,50,30,0,10,40
30,Success,51,21,0,16,35
30,Fail,40,35,0,11,29
30,Fail,39,34,2,15,24
30,Success,58,20,0,9,49
30,Success,49,26,4,10,39
30,Fail,46,24,3,18,28
30,Fail,47,18,1,20,27
30,Success,45,32,0,11,34
30,Success,52,28,0,10,42
30,Success,45,32,0,11,34
30,Success,49,23,2,14,35
30,Success,51,23,0,10,41
30,Fail,44,25,1,20,24
30,Success,49,22,0,13,36
30,Fail,44,31,0,16,28
30,Success,44,36,0,14,30
30,Success,46,29,1,11,35
30,Success,45,34,0,10,35
30,Success,42,37,0,9,33
30,Fail,38,33,3,14,24
30,Success,45,26,1,10,35
30,Success,43,32,1,13,30
30,Fail,41,39,0,12,29
30,Success,48,25,7,10,38
30,Success,42,26,9,12,30
30,Fail,44,24,0,21,23
30,Success,47,30,0,10,37
30,Success,56,14,4,15,41
30,Success,48,32,0,11,37
30,Success,50,24,0,11,39
30,Success,44,31,0,14,30
30,Success,51,23,0,14,37
30,Success,55,20,4,10,45
30,Fail,42,36,0,16,26
30,Fail,37,38,0,18,19
30,Success,47,33,0,11,36
30,Success,51,29,0,12,39
30,Success,48,24,0,15,33
30,Success,52,24,4,10,42
30,Success,57,23,4,6,51
30,Success,51,20,5,12,39
30,Fail,46,29,0,19,27
30,Success,47,31,0,11,36
30,Success,54,28,0,9,45
30,Success,53,20,1,14,39
30,Fail,41,33,4,13,28
30,Success,52,24,0,15,37
30,Success,46,27,6,11,35
30,Success,46,33,0,13,33
30,Success,51,29,0,10,41
30,Success,55,18,1,12,43
30,Success,50,27,0,12,38
30,Success,55,21,0,13,42
30,Success,44,31,0,14,30
30,Fail,44,25,5,16,28
30,Success,55,24,0,10,45
30,Success,52,26,0,12,40
30,Success,49,26,0,13,36
30,Success,49,31,0,12,37
30,Success,44,27,5,14,30
30,Success,49,22,0,19,30
30,Success,49,28,0,10,39
30,Success,56,25,0,8,48
30,Success,53,25,0,14,39
30,Success,49,26,5,9,40
30,Success,48,26,3,14,34
30,Fail,45,28,0,16,29
30,Success,55,23,2,11,44
30,Success,57,23,0,7,50
30,Success,60,16,5,11,49
30,Success,51,26,1,11,40
30,Success,49,29,0,10,39
30,Fail,47,23,0,18,29
30,Success,49,34,0,8,41
30,Success,58,20,0,9,49
30,Success,59,22,0,10,49
30,Success,50,34,0,4,46
30,Success,48,35,0,5,43
30,Success,47,29,7,9,38
30,Success,49,27,0,10,39
30,Success,47,25,0,17,30
30,Success,44,31,5,11,33
30,Success,50,30,0,10,40
30,Success,57,19,7,6,51
30,Success,49,24,0,13,36
30,Success,53,23,4,12,41
30,Success,52,18,8,14,38
30,Success,46,37,0,13,33
30,Success,56,29,0,7,49
30,Success,46,26,4,14,32
30,Success,48,32,0,9,39
30,Success,47,29,1,10,37
30,Fail,42,35,0,14,28
30,Success,50,22,0,17,33
30,Success,47,25,2,14,33
30,Success,49,33,0,9,40
30,Success,46,26,5,14,32
30,Success,50,24,0,15,35
30,Success,45,35,0,10,35
30,Success,50,26,5,15,35
30,Fail,40,31,0,20,20
30,Success,46,33,0,11,35
30,Success,50,24,0,14,36
30,Success,51,26,0,14,37
30,Success,48,30,0,11,37
30,Success,53,18,8,15,38
30,Success,46,26,3,14,32
30,Success,47,23,4,17,30
30,Success,47,32,0,15,32
30,Success,47,27,4,12,35
30,Success,47,29,3,10,37
30,Fail,40,34,0,14,26
30,Success,52,22,2,11,41
30,Success,50,27,0,15,35
30,Success,50,23,2,14,36
30,Success,47,27,5,9,38
30,Success,43,32,6,10,33
30,Success,58,24,0,8,50
30,Success,50,26,0,11,39
30,Success,51,32,0,12,39
30,Fail,36,41,0,14,22
30,Success,46,30,0,13,33
30,Success,54,24,2,10,44
30,Success,47,35,0,8,39
30,Success,49,27,3,11,38
30,Success,49,26,6,10,39
30,Success,48,26,6,7,41
30,Success,51,27,0,7,44
30,Success,45,32,3,9,36
30,Success,47,23,3,12,35
30,Success,47,32,0,14,33
30,Success,45,32,1,14,31
30,Success,46,35,0,10,36
30,Success,47,29,0,16,31
30,Success,48,28,1,12,36
30,Success,46,29,1,10,36
30,Success,53,23,3,12,41
30,Success,48,31,0,10,38
30,Success,50,23,0,15,35
30,Success,52,23,0,14,38
30,Success,49,28,0,9,40
30,Success,50,24,0,15,35
30,Success,50,28,0,7,43
30,Success,49,25,1,16,33
30,Success,44,34,0,12,32
30,Success,57,17,3,13,44
30,Success,43,30,2,12,31
30,Success,47,26,5,10,37
30,Success,56,24,0,10,46
30,Fail,42,22,7,17,25
30,Success,49,28,0,12,37
30,Fail,43,30,0,15,28
30,Success,48,33,0,9,39
30,Success,44,28,6,10,34
30,Success,48,24,6,13,35
30,Success,45,32,0,13,32
30,Success,51,31,0,9,42
30,Success,53,24,1,10,43
30,Fail,38,27,8,14,24
30,Success,50,21,9,11,39
30,Fail,43,28,5,18,25
30,Success,48,28,0,16,32
30,Success,48,37,0,12,36
30,Success,56,19,1,8,48
30,Success,44,28,7,13,31
30,Success,49,27,0,11,38
30,Success,49,31,0,9,40
30,Success,47,27,0,17,30
30,Success,49,27,0,16,33
30,Success,49,28,0,11,38
30,Success,48,26,1,11,37
30,Success,51,26,0,10,41
30,Success,50,28,3,7,43
30,Success,55,26,0,11,44
30,Success,55,26,0,7,48
30,Success,54,24,0,9,45
30,Fail,38,21,14,18,20
30,Success,52,28,0,8,44
30,Success,45,34,0,11,34
30,Success,51,20,4,16,35
30,Success,49,27,0,13,36
30,Success,42,41,0,7,35
30,Fail,45,23,4,19,26
30,Success,47,25,4,16,31
30,Fail,45,28,3,16,29
30,Success,50,27,2,10,40
30,Success,49,28,0,12,37
30,Success,43,33,0,13,30
30,Success,48,21,6,16,32
30,Fail,45,27,2,16,29
30,Success,53,25,0,8,45
30,Success,53,25,0,14,39
30,Success,41,28,9,11,30
30,Success,44,38,0,14,30
30,Success,51,31,0,7,44
30,Success,54,22,0,8,46
30,Success,54,26,0,6,48
30,Success,43,34,5,7,36
30,Success,56,20,5,9,47
30,Success,52,21,0,15,37
30,Success,52,21,1,11,41
30,Success,49,34,0,6,43
30,Success,51,33,0,7,44
30,Success,50,31,0,9,41
30,Success,47,38,0,10,37
30,Success,44,33,3,9,35
30,Success,48,27,7,8,40
30,Success,54,20,0,13,41
30,Success,58,22,2,7,51
30,Success,48,32,0,12,36
30,Success,47,25,0,16,31
30,Fail,45,28,2,16,29
30,Success,48,31,0,12,36
30,Success,49,28,2,5,44
30,Fail,41,28,11,12,29
30,Fail,46,20,7,17,29
30,Fail,41,32,0,18,23
30,Success,44,29,8,13,31
30,Success,46,25,4,16,30
30,Success,51,24,1,8,43
30,Success,43,37,0,13,30
30,Fail,42,37,0,13,29
30,Success,41,37,0,8,33
30,Fail,44,26,0,17,27
30,Success,41,31,10,9,32
30,Success,47,21,1,15,32
30,Fail,43,26,5,18,25
30,Success,49,27,2,10,39
30,Success,52,24,3,14,38
30,Fail,36,32,8,18,18
30,Success,46,30,5,10,36
30,Success,51,22,0,12,39
30,Fail,42,31,0,19,23
30,Success,49,26,0,12,37
30,Success,53,23,0,11,42
30,Success,45,30,0,11,34
30,Success,49,24,1,12,37
30,Success,43,32,0,13,30
30,Success,48,29,0,12,36
30,Fail,44,28,0,16,28
30,Success,49,20,11,11,38
30,Success,49,33,0,10,39
30,Success,53,28,0,5,48
30,Success,46,21,10,12,34
30,Success,48,28,0,13,35
30,Success,53,22,0,12,41
30,Fail,45,22,7,16,29
30,Success,46,25,1,15,31
30,Success,42,26,6,12,30
30,Fail,43,28,0,16,27
30,Success,48,26,6,10,38
30,Success,45,21,6,15,30
30,Success,46,30,0,10,36
30,Fail,43,35,0,14,29
30,Success,51,20,5,11,40
30,Success,47,26,5,12,35
30,Success,47,28,8,9,38
30,Success,54,22,0,10,44
30,Success,48,24,3,17,31
30,Fail,42,29,0,16,26
30,Success,54,29,0,9,45
30,Fail,36,39,0,17,19
30,Success,45,31,4,8,37
30,Success,49,29,5,11,38
30,Success,45,29,6,9,36
30,Fail,45,29,0,17,28
30,Success,46,28,2,12,34
30,Success,45,30,3,11,34
30,Success,47,26,0,17,30
30,Success,50,27,0,13,37
30,Success,52,30,0,9,43
30,Success,51,27,3,9,42
30,Success,42,29,6,11,31
30,Fail,45,26,0,19,26
30,Fail,43,34,0,15,28
30,Success,48,27,0,10,38
30,Success,48,25,5,13,35
30,Success,48,27,1,12,36
30,Success,44,39,0,10,34
30,Success,48,27,0,11,37
30,Success,52,24,0,9,43
30,Success,51,20,1,15,36
30,Success,52,28,0,9,43
30,Success,51,33,0,8,43
30,Success,49,23,6,13,36
30,Fail,40,38,0,16,24
30,Success,45,32,0,15,30
30,Success,46,33,0,12,34
30,Success,54,30,0,9,45
30,Success,49,24,4,14,35
30,Success,51,26,0,13,38
30,Fail,39,34,0,14,25
30,Success,46,28,1,8,38
30,Success,52,28,0,9,43
30,Success,54,24,3,7,47
30,Success,44,35,0,12,32
30,Success,49,22,4,12,37
30,Success,48,27,12,7,41
30,Success,45,26,3,14,31
30,Success,53,20,0,14,39
30,Fail,40,30,3,15,25
30,Fail,39,31,3,19,20
30,Fail,42,34,0,15,27
30,Fail,45,24,2,19,26
30,Success,58,25,0,6,52
30,Success,42,38,5,10,32
30,Success,47,26,5,12,35
30,Success,49,23,8,10,39
30,Fail,44,33,0,17,27
30,Success,50,26,4,9,41
30,Fail,40,31,9,13,27
30,Success,48,18,10,16,32
30,Fail,45,25,0,16,29
30,Success,47,31,1,11,36
30,Success,49,31,0,10,39
30,Success,49,28,1,14,35
30,Fail,38,31,4,17,21
30,Success,51,20,9,11,40
30,Success,50,25,6,13,37
30,Success,54,20,4,16,38
30,Success,52,23,2,12,40
30,Success,52,28,0,11,41
30,Success,46,22,5,15,31
30,Success,47,34,0,10,37
30,Success,54,26,4,8,46
30,Fail,46,26,1,18,28
30,Success,50,28,0,12,38
30,Success,48,33,0,11,37
30,Success,54,25,0,7,47
30,Fail,44,24,4,16,28
30,Success,51,23,6,6,45
30,Success,46,26,2,15,31
30,Success,50,30,4,8,42
30,Success,49,31,0,9,40
30,Success,50,24,6,14,36
30,Success,50,19,13,11,39
30,Success,50,25,0,9,41
30,Fail,36,27,2,23,13
30,Success,52,26,0,12,40
30,Success,49,26,0,11,38
30,Success,54,30,0,10,44
30,Success,48,32,0,12,36
30,Fail,43,23,8,17,26
30,Success,47,25,5,9,38
30,Fail,43,27,4,14,29
30,Success,54,19,8,9,45
30,Success,63,15,0,12,51
30,Fail,45,21,6,18,27
30,Fail,42,28,5,13,29
30,Success,49,32,0,11,38
30,Success,44,33,0,11,33
30,Success,45,31,0,11,34
30,Success,51,30,0,7,44
30,Success,53,26,0,11,42
30,Success,43,34,0,13,30
30,Success,45,36,0,9,36
30,Success,52,28,3,8,44
30,Success,55,19,3,12,43
30,Fail,46,24,0,17,29
30,Success,44,28,0,14,30
30,Fail,42,25,8,14,28
30,Success,54,24,0,12,42
30,Success,49,24,0,18,31
30,Success,44,33,2,7,37
30,Success,55,29,0,7,48
30,Success,47,32,0,13,34
30,Success,44,32,0,9,35
30,Success,52,22,4,13,39
30,Success,54,27,0,12,42
30,Fail,43,27,0,20,23
30,Success,42,40,0,11,31
30,Fail,39,26,10,15,24
30,Success,54,21,0,10,44
30,Success,55,18,7,11,44
30,Success,47,33,1,7,40
30,Success,50,31,0,13,37
30,Success,48,29,3,9,39
30,Success,50,19,2,16,34
30,Fail,40,36,0,13,27
30,Success,50,27,6,8,42
30,Success,44,38,0,10,34
30,Success,45,31,4,14,31
30,Success,54,23,0,14,40
30,Fail,42,20,10,20,22
30,Success,47,27,0,10,37
30,Success,43,36,0,11,32
30,Fail,43,31,0,16,27
30,Success,45,27,0,13,32
30,Success,55,23,1,10,45
30,Success,53,19,7,10,43
30,Success,51,23,0,12,39
30,Fail,37,36,0,14,23
30,Success,46,28,6,13,33
30,Success,49,33,0,10,39
30,Success,57,18,1,13,44
30,Success,44,27,6,11,33
30,Success,50,19,1,17,33
30,Success,53,23,6,6,47
30,Success,55,24,6,8,47
30,Success,53,29,0,8,45
30,Success,44,30,5,10,34
30,Success,43,34,0,12,31
30,Success,50,26,0,12,38
30,Success,50,23,0,15,35
30,Success,45,39,0,10,35
30,Success,47,31,0,12,35
30,Fail,44,27,3,15,29
30,Success,46,25,3,14,32
30,Success,52,23,5,11,41
30,Success,45,30,0,13,32
30,Fail,43,25,3,15,28
30,Success,49,25,0,14,35
30,Fail,44,34,0,15,29
30,Success,50,28,0,13,37
30,Success,52,29,0,8,44
30,Success,54,25,0,9,45
30,Success,48,22,0,14,34
30,Success,48,27,0,12,36
30,Success,45,28,5,13,32
30,Success,51,27,0,18,33
30,Success,45,37,0,9,36
30,Fail,47,26,0,19,28
30,Success,50,34,0,5,45
30,Success,58,19,4,10,48
30,Success,46,33,5,9,37
30,Fail,44,22,8,15,29
30,Success,48,22,7,13,35
30,Success,51,24,4,9,42
30,Fail,43,28,0,17,26
30,Success,46,28,3,12,34
30,Success,47,36,0,7,40
30,Success,45,31,0,14,31
30,Success,53,21,0,13,40
30,Success,48,24,5,9,39
30,Success,42,41,0,7,35
30,Success,45,22,13,13,32
30,Success,57,23,0,11,46
30,Success,48,34,0,12,36
30,Fail,40,34,0,14,26
30,Success,45,25,6,15,30
30,Success,53,19,5,12,41
30,Success,44,41,0,13,31
30,Success,51,30,0,8,43
30,Success,59,16,1,10,49
30,Success,58,19,0,9,49
30,Fail,42,33,0,14,28
30,Fail,39,34,0,13,26
30,Success,54,22,0,13,41
30,Success,53,26,5,8,45
30,Success,45,34,0,10,35
30,Success,47,33,1,8,39
30,Fail,45,24,3,18,27
30,Success,47,24,12,7,40
30,Success,43,29,6,11,32
30,Success,49,21,5,13,36
30,Success,50,22,10,12,38
30,Success,45,30,0,14,31
30,Success,49,24,0,16,33
30,Success,55,21,0,12,43
30,Success,51,21,0,16,35
30,Fail,42,32,0,13,29
30,Success,54,25,1,8,46
30,Success,49,31,0,10,39
30,Success,46,32,0,14,32
30,Fail,36,39,0,15,21
30,Success,44,32,4,12,32
30,Success,45,31,0,13,32
30,Success,45,22,9,15,30
30,Success,47,32,0,13,34
30,Fail,43,26,0,17,26
30,Success,48,29,0,11,37
30,Success,50,22,4,13,37
30,Success,54,24,0,15,39
30,Success,46,31,2,9,37
30,Success,52,27,0,7,45
30,Success,50,25,5,10,40
30,Success,61,16,0,12,49
30,Success,56,26,0,8,48
30,Success,55,17,1,15,40
30,Success,52,29,0,8,44
30,Success,52,28,0,11,41
30,Success,48,28,4,12,36
30,Success,45,30,0,15,30
30,Success,47,22,12,8,39
30,Success,51,24,0,18,33
30,Success,49,22,2,16,33
30,Fail,42,33,0,14,28
30,Success,48,27,0,16,32
30,Success,48,29,0,10,38
30,Success,50,24,0,15,35
30,Success,48,30,0,14,34
30,Success,46,25,0,16,30
30,Success,44,19,12,14,30
30,Success,45,37,0,5,40
30,Success,49,27,8,9,40
30,Success,47,27,7,9,38
30,Fail,41,30,0,22,19
30,Success,49,27,6,8,41
30,Success,51,26,3,7,44
30,Success,53,33,0,5,48
30,Success,50,26,0,10,40
30,Success,46,24,11,11,35
30,Fail,38,32,10,10,28
30,Success,52,24,4,10,42
30,Success,53,20,1,12,41
30,Success,48,29,0,11,37
30,Success,47,28,1,15,32
30,Success,51,28,0,9,42
30,Success,42,28,4,12,30
30,Success,47,29,1,11,36
30,Success,51,25,1,11,40
30,Success,47,26,0,16,31
30,Success,52,24,6,10,42
30,Success,48,27,0,14,34
30,Success,58,24,2,8,50
30,Success,58,15,2,12,46
30,Success,55,25,0,13,42
30,Success,49,26,0,12,37
30,Success,47,22,7,14,33
30,Success,55,22,7,8,47
30,Success,47,25,4,13,34
30,Success,55,22,6,8,47
30,Success,52,18,1,14,38
30,Success,52,23,5,9,43
30,Success,55,25,0,10,45
30,Success,43,36,0,12,31
30,Success,48,39,0,4,44
30,Fail,43,30,7,14,29
30,Success,49,28,0,13,36
30,Success,46,30,4,11,35
30,Fail,42,37,0,15,27
30,Success,45,32,3,8,37
30,Success,58,13,2,13,45
30,Success,52,28,0,11,41
30,Fail,48,19,2,20,28
30,Success,59,17,3,10,49
30,Success,52,29,0,8,44
30,Success,49,32,0,8,41
30,Success,45,30,0,11,34
30,Fail,43,28,0,17,26
30,Fail,42,31,4,13,29
30,Success,52,25,0,13,39
30,Success,52,25,0,14,38
30,Success,42,36,0,9,33
30,Success,52,24,0,11,41
30,Success,43,29,3,13,30
30,Success,50,27,0,13,37
30,Success,57,19,0,11,46
30,Fail,43,29,4,16,27
30,Fail,49,20,0,21,28
30,Success,48,24,0,17,31
30,Success,49,30,1,9,40
30,Fail,38,18,14,24,14
30,Fail,41,31,4,17,24
30,Success,51,25,0,11,40
30,Success,45,34,0,8,37
30,Success,54,25,3,8,46
30,Success,53,23,7,5,48
30,Success,53,25,0,11,42
30,Success,46,32,0,15,31
30,Success,48,27,3,11,37
30,Fail,45,29,1,17,28
30,Success,51,27,0,12,39
30,Fail,43,30,0,19,24
30,Success,48,31,0,7,41
30,Success,48,32,0,11,37
30,Success,55,16,2,15,40
30,Success,55,18,0,19,36
30,Success,54,19,4,14,40
30,Success,50,22,0,18,32
30,Success,54,20,0,14,40
30,Success,45,23,6,15,30
30,Success,50,28,2,11,39
30,Success,50,26,0,12,38
30,Success,47,30,0,15,32
30,Success,50,20,1,12,38
30,Success,50,29,0,13,37
30,Success,53,16,0,21,32
30,Success,51,24,2,12,39
30,Success,51,27,0,9,42
30,Fail,39,30,0,19,20
30,Success,49,34,0,8,41
30,Success,63,20,0,4,59
30,Success,44,35,0,12,32
30,Success,49,19,2,17,32
30,Success,54,25,0,12,42
30,Fail,44,32,1,15,29
30,Success,55,25,0,11,44
30,Success,53,19,1,14,39
30,Success,48,23,3,13,35
30,Fail,48,21,0,19,29
30,Success,49,26,8,13,36
30,Success,57,23,0,8,49
30,Fail,47,19,3,18,29
30,Success,51,28,0,9,42
30,Success,47,28,0,13,34
30,Success,47,32,0,12,35
30,Success,48,23,0,17,31
30,Success,51,26,0,12,39
30,Fail,39,30,7,10,29
30,Success,52,24,0,10,42
30,Fail,40,29,12,13,27
30,Success,54,22,10,7,47
30,Success,51,22,2,9,42
30,Success,52,21,0,14,38
30,Fail,38,25,10,15,23
30,Success,52,17,4,15,37
30,Fail,38,32,7,14,24
30,Success,47,28,0,15,32
30,Success,53,22,1,10,43
30,Fail,41,28,0,19,22
30,Success,49,26,1,11,38
30,Fail,44,32,0,15,29
30,Success,50,25,2,12,38
30,Success,47,27,0,16,31
30,Success,46,28,5,8,38
30,Success,51,26,0,16,35
30,Success,49,24,6,12,37
30,Success,46,31,5,10,36
30,Fail,43,28,3,16,27
30,Success,44,31,0,12,32
30,Fail,40,33,0,15,25
30,Success,52,22,0,15,37
30,Fail,39,37,5,11,28
30,Success,48,30,0,15,33
30,Success,45,29,1,12,33
30,Success,48,23,1,18,30
30,Success,46,23,0,16,30
30,Success,45,38,0,10,35
30,Success,50,32,0,8,42
30,Fail,40,31,7,11,29
30,Success,46,31,6,6,40
30,Success,53,29,0,9,44
30,Success,53,21,0,12,41
30,Success,56,20,2,8,48
30,Success,46,29,2,14,32
30,Fail,39,35,0,20,19
30,Success,45,30,0,11,34
30,Success,43,24,14,10,33
30,Success,51,22,1,13,38
30,Success,42,35,7,8,34
30,Success,51,29,0,8,43
30,Success,49,26,5,11,38
30,Success,48,29,0,13,35
30,Success,51,25,0,13,38
30,Success,51,29,0,8,43
30,Success,45,26,2,15,30
30,Success,47,26,2,15,32
30,Success,48,33,0,7,41
30,Success,55,24,0,7,48
30,Success,54,30,0,13,41
30,Success,50,26,0,14,36
30,Success,58,23,0,12,46
30,Success,50,21,0,17,33
30,Success,49,29,0,10,39
30,Success,52,18,7,14,38
30,Fail,44,37,0,16,28
30,Fail,43,23,8,15,28
30,Fail,45,29,0,18,27
30,Success,48,23,4,18,30
30,Fail,44,29,0,15,29
30,Fail,42,25,7,16,26
30,Success,47,31,0,12,35
30,Success,54,22,0,13,41
30,Success,53,31,0,10,43
30,Success,50,26,0,15,35
30,Fail,45,24,4,17,28
30,Success,52,21,9,12,40
30,Success,49,30,1,12,37
30,Success,54,24,0,10,44
30,Success,52,26,0,11,41
30,Success,47,22,4,16,31
30,Success,52,24,5,9,43
30,Success,51,18,4,14,37
30,Success,45,36,0,11,34
30,Fail,38,26,17,14,24
30,Success,53,31,0,10,43
30,Success,48,27,2,10,38
30,Success,54,22,0,12,42
30,Success,51,24,0,13,38
30,Fail,46,23,1,23,23
30,Success,54,28,1,6,48
30,Fail,45,28,1,17,28
30,Success,52,23,4,15,37
30,Success,55,18,4,11,44
30,Fail,44,25,4,20,24
30,Success,45,37,0,9,36
30,Success,50,30,2,8,42
30,Success,47,26,1,13,34
30,Success,53,21,5,10,43
30,Success,50,35,0,6,44
30,Success,44,32,8,6,38
30,Success,47,27,0,17,30
30,Success,52,22,8,8,44
30,Success,47,23,3,17,30
30,Success,48,23,0,12,36
30,Success,47,28,3,13,34
30,Success,46,35,0,13,33
30,Fail,38,34,0,17,21
30,Fail,45,28,0,16,29
30,Fail,42,28,1,14,28
30,Fail,39,34,0,13,26
30,Fail,41,30,9,13,28
30,Fail,43,36,0,14,29
30,Success,49,27,1,11,38
30,Success,54,26,4,8,46
30,Success,58,22,0,9,49
30,Success,47,30,2,15,32
30,Success,47,28,0,16,31
30,Success,54,19,0,13,41
30,Success,51,25,6,10,41
30,Success,43,36,0,10,33
30,Success,52,29,2,8,44
30,Success,46,34,0,13,33
30,Success,48,25,3,13,35
30,Success,47,36,0,9,38
30,Success,57,22,0,9,48
30,Success,45,24,9,13,32
30,Success,42,30,4,12,30
30,Success,51,24,0,10,41
30,Success,50,31,0,10,40
30,Success,50,16,3,19,31
30,Success,45,36,0,9,36
30,Success,51,32,0,11,40
30,Success,44,32,4,9,35
30,Fail,43,27,6,15,28
30,Fail,42,22,11,15,27
30,Success,49,25,0,13,36
30,Success,54,21,2,15,39
30,Fail,44,24,2,20,24
30,Success,49,29,0,12,37
30,Success,50,35,0,7,43
30,Success,52,21,0,16,36
30,Fail,38,41,0,11,27
30,Success,43,32,4,12,31
30,Fail,44,29,0,16,28
30,Success,47,30,0,13,34
30,Success,52,23,0,13,39
30,Fail,40,28,4,22,18
30,Fail,44,27,6,15,29
30,Fail,42,31,1,14,28
30,Success,42,32,7,12,30
30,Success,51,24,0,13,38
30,Success,46,35,1,7,39
30,Success,50,28,1,11,39
30,Success,51,25,0,13,38
30,Fail,42,35,0,13,29
30,Success,56,21,0,12,44
30,Fail,45,24,5,16,29
30,Success,49,26,2,16,33
30,Success,45,34,0,12,33
30,Success,48,33,0,11,37
30,Fail,43,24,12,14,29
30,Fail,41,26,7,16,25
30,Success,48,21,13,13,35
30,Success,53,18,3,13,40
30,Success,51,30,0,10,41
30,Fail,45,23,5,17,28
30,Success,49,34,0,9,40
30,Success,46,30,2,14,32
30,Success,45,31,4,9,36
30,Success,49,26,0,15,34
30,Fail,44,30,0,15,29
30,Success,49,23,0,17,32
30,Fail,44,28,4,18,26
30,Success,52,23,2,13,39
30,Success,53,26,1,11,42
30,Success,48,34,0,8,40
30,Success,45,29,0,12,33
30,Success,50,24,2,14,36
30,Success,55,21,1,11,44
30,Success,56,25,1,8,48
30,Success,52,31,0,10,42
30,Success,47,26,1,12,35
30,Success,44,30,0,14,30
30,Success,53,21,6,8,45
30,Success,46,30,0,11,35
30,Success,50,25,2,14,36
30,Success,47,21,3,17,30
30,Success,49,27,0,10,39
30,Success,48,29,6,10,38
30,Success,49,27,0,12,37
30,Success,52,19,2,15,37
30,Success,54,22,3,8,46
30,Success,52,22,8,10,42
30,Success,49,24,2,13,36
30,Success,53,29,0,8,45
30,Success,44,30,4,13,31
30,Success,51,29,0,11,40
30,Success,45,27,0,15,30
30,Success,57,17,5,7,50
30,Success,48,29,1,12,36
30,Success,50,25,0,14,36
30,Fail,40,39,0,12,28
30,Success,49,27,2,13,36
30,Fail,44,26,0,19,25
30,Fail,39,44,0,10,29
30,Success,55,21,0,10,45
30,Success,51,24,0,17,34
30,Success,48,28,0,12,36
30,Success,52,26,0,7,45
30,Success,46,32,0,7,39
30,Success,52,14,1,22,30
30,Success,48,23,2,11,37
30,Success,44,35,0,9,35
30,Success,44,29,0,12,32
30,Fail,47,25,0,18,29
30,Success,51,22,6,11,40
30,Fail,46,23,0,17,29
30,Fail,47,26,0,18,29
30,Success,62,21,0,8,54
30,Fail,43,24,8,14,29
30,Success,51,32,0,9,42
30,Success,44,29,4,13,31
30,Success,53,36,0,5,48
30,Success,47,26,0,15,32
30,Success,49,27,0,16,33
30,Success,51,22,0,16,35
30,Fail,39,35,0,14,25
30,Success,50,22,5,12,38
30,Fail,43,36,0,14,29
30,Success,47,22,5,16,31
30,Fail,42,25,12,14,28
30,Success,50,36,0,9,41
30,Success,46,33,0,11,35
30,Success,48,26,3,13,35
30,Success,45,36,3,8,37
30,Fail,43,25,8,14,29
30,Fail,37,34,0,16,21
30,Success,54,21,0,11,43
30,Success,55,21,0,14,41
30,Success,61,17,0,13,48
30,Success,46,32,0,14,32
30,Success,52,21,3,12,40
30,Success,47,20,8,13,34
30,Success,51,21,0,18,33
30,Success,56,23,0,9,47
30,Success,48,24,1,13,35
30,Success,53,22,2,13,40
30,Success,50,25,6,12,38
30,Success,50,28,4,8,42
30,Success,55,14,0,16,39
30,Success,42,35,0,11,31
30,Success,48,24,4,11,37
30,Success,48,23,4,14,34
30,Success,50,25,0,16,34
30,Success,56,14,8,13,43
30,Success,44,31,0,13,31
30,Success,51,26,0,12,39
30,Success,50,29,0,10,40
30,Success,49,28,2,11,38
30,Fail,40,33,7,12,28
30,Success,53,30,0,4,49
30,Fail,39,36,0,22,17
30,Success,48,28,0,13,35
30,Success,48,28,0,13,35
30,Fail,46,21,0,19,27
30,Success,50,31,0,6,44
30,Success,54,22,1,11,43
30,Success,50,22,6,12,38
30,Success,47,27,0,14,33
30,Success,54,23,4,9,45
30,Success,47,24,3,11,36
30,Success,51,23,5,14,37
30,Success,54,23,0,14,40
30,Success,49,25,11,7,42
30,Success,55,21,2,8,47
30,Fail,49,16,4,22,27
30,Success,45,27,8,11,34
30,Success,46,24,3,13,33
30,Success,53,22,3,10,43
30,Success,46,29,0,15,31
30,Success,45,30,0,11,34
30,Success,52,24,0,11,41
30,Success,57,19,0,12,45
30,Success,54,23,2,6,48
30,Success,55,25,1,9,46
30,Success,49,28,0,12,37
30,Success,42,32,6,10,32
30,Success,57,17,4,15,42
30,Success,49,25,0,8,41
30,Success,49,22,8,11,38
30,Success,50,28,0,12,38
30,Success,52,24,0,9,43
30,Success,47,25,1,16,31
30,Success,52,29,0,9,43
30,Success,50,28,5,12,38
30,Success,43,35,0,11,32
30,Success,42,31,8,11,31
30,Success,57,22,2,9,48
30,Success,45,29,5,11,34
30,Success,44,27,2,13,31
30,Success,59,16,0,9,50
30,Fail,39,26,8,17,22
30,Success,47,31,0,11,36
30,Fail,45,29,0,19,26
30,Success,44,29,6,9,35
30,Success,52,18,8,12,40
30,Success,51,25,0,14,37
30,Success,47,30,0,12,35
30,Success,54,28,0,5,49
30,Success,54,21,2,11,43
30,Success,51,31,0,9,42
30,Success,45,35,0,13,32
30,Fail,41,29,0,17,24
30,Success,50,21,1,12,38
30,Success,48,24,9,13,35
30,Success,51,29,0,12,39
30,Success,48,33,0,9,39
30,Success,49,36,0,8,41
30,Fail,43,33,0,14,29
30,Success,56,17,3,11,45
30,Success,47,29,0,15,32
30,Success,48,30,4,10,38
30,Fail,47,24,0,18,29
30,Success,51,23,0,16,35
30,Success,50,25,2,12,38
30,Fail,42,24,12,16,26
30,Success,46,29,5,10,36
30,Success,46,27,4,11,35
30,Success,55,24,0,10,45
30,Success,51,19,0,17,34
30,Success,58,22,0,6,52
30,Success,47,25,0,16,31
30,Fail,38,40,0,10,28
30,Success,46,21,8,16,30
30,Success,45,37,0,12,33
30,Success,47,26,2,10,37
30,Success,53,21,4,13,40
30,Success,50,25,0,17,33
30,Fail,42,35,0,13,29
30,Success,55,21,4,10,45
30,Success,45,30,0,15,30
30,Success,49,23,8,12,37
30,Fail,40,28,0,24,16
30,Fail,44,34,0,16,28
30,Success,52,26,0,9,43
30,Success,47,29,0,13,34
30,Success,51,20,0,17,34
30,Success,56,23,0,8,48
30,Success,49,29,0,11,38
30,Success,47,31,2,9,38
30,Success,54,27,0,9,45
30,Success,52,24,2,12,40
30,Fail,44,30,0,16,28
30,Success,46,26,3,13,33
30,Fail,44,23,4,20,24
30,Success,57,19,0,11,46
30,Success,47,32,0,12,35
30,Fail,40,38,0,14,26
30,Success,50,22,3,10,40
30,Success,47,28,0,15,32
30,Success,50,19,2,18,32
30,Success,45,27,0,15,30
30,Success,49,29,2,9,40
30,Success,53,28,0,7,46
30,Success,57,21,0,7,50
30,Success,57,21,0,8,49
30,Success,54,20,0,12,42
30,Success,47,31,0,11,36
30,Success,51,30,6,5,46
30,Success,43,34,0,13,30
30,Success,49,30,0,7,42
30,Success,46,21,9,14,32
30,Success,51,32,1,9,42
30,Fail,45,26,0,18,27
30,Success,50,30,0,11,39
30,Success,48,28,0,12,36
30,Success,49,28,0,11,38
30,Fail,42,33,0,14,28
30,Success,51,29,0,8,43
30,Success,48,25,0,17,31
30,Success,47,30,0,8,39
30,Success,51,30,0,10,41
30,Success,53,25,7,7,46
30,Success,48,26,3,8,40
30,Success,53,22,0,15,38
30,Success,57,18,0,11,46
30,Success,55,22,0,11,44
30,Success,51,26,0,9,42
30,Success,56,23,0,10,46
30,Fail,44,28,0,21,23
30,Fail,43,27,2,18,25
30,Success,47,18,5,14,33
30,Success,48,28,0,13,35
30,Fail,42,19,8,20,22
30,Success,51,32,0,7,44
30,Success,46,33,0,10,36
30,Success,48,19,5,17,31
30,Success,54,20,0,16,38
30,Success,53,22,2,14,39
30,Success,48,30,0,9,39
30,Success,49,21,3,11,38
30,Success,45,22,9,14,31
30,Success,50,24,0,13,37
30,Success,51,22,5,14,37
30,Success,48,22,1,18,30
30,Success,47,30,0,14,33
30,Success,45,31,2,12,33
30,Success,47,33,0,8,39
30,Success,53,24,0,12,41
30,Success,50,21,0,20,30
30,Success,50,23,7,9,41
30,Success,48,32,0,12,36
30,Success,49,26,0,13,36
30,Success,52,28,1,11,41
30,Success,52,30,0,7,45
30,Success,49,24,4,12,37
30,Fail,44,26,5,17,27
30,Success,45,30,0,12,33
30,Success,47,35,0,8,39
30,Success,42,35,0,12,30
30,Success,48,24,0,16,32
30,Success,48,32,0,10,38
30,Success,51,26,0,10,41
30,Success,45,32,0,11,34
30,Success,45,36,0,8,37
30,Fail,38,34,3,18,20
30,Success,55,30,0,10,45
30,Fail,44,34,0,15,29
30,Success,47,23,12,9,38
30,Success,58,20,1,11,47
30,Success,55,16,2,13,42
30,Fail,40,39,0,15,25
30,Success,44,33,1,10,34
30,Success,45,28,0,13,32
30,Success,47,26,0,15,32
30,Success,53,19,4,14,39
30,Success,50,28,3,9,41
30,Success,48,27,0,15,33
30,Success,47,25,0,16,31
30,Success,47,27,0,13,34
30,Success,59,23,0,7,52
30,Success,56,18,6,7,49
30,Success,43,37,0,10,33
30,Success,56,24,0,10,46
30,Success,47,22,4,16,31
30,Success,48,25,4,11,37
30,Success,48,29,0,12,36
30,Success,43,36,0,9,34
30,Success,48,28,1,13,35
30,Success,47,27,5,13,34
30,Fail,42,35,0,15,27
30,Success,54,25,0,14,40
30,Success,51,26,0,12,39
30,Success,49,26,0,12,37
30,Success,43,38,0,9,34
30,Success,47,26,2,14,33
30,Fail,44,26,1,15,29
30,Fail,38,32,11,11,27
30,Fail,42,32,2,14,28
30,Success,49,23,6,11,38
30,Success,49,28,2,10,39
30,Success,51,20,10,7,44
30,Success,48,31,0,12,36
30,Success,45,34,0,15,30
30,Success,53,21,1,12,41
30,Success,51,27,0,13,38
30,Success,53,29,0,10,43
30,Fail,47,25,0,18,29
30,Success,52,20,2,10,42
30,Success,43,27,12,9,34
30,Fail,43,30,5,16,27
30,Success,54,27,0,10,44
30,Success,53,25,0,13,40
30,Success,50,29,0,9,41
30,Success,50,27,1,11,39
30,Success,48,23,4,14,34
30,Success,45,30,0,10,35
30,Success,47,23,6,10,37
30,Success,44,28,3,10,34
30,Success,44,28,3,12,32
30,Success,50,22,0,15,35
30,Fail,46,27,0,18,28
30,Success,58,19,3,10,48
30,Success,51,28,0,11,40
30,Fail,42,30,1,14,28
30,Success,50,28,0,13,37
30,Fail,45,24,0,16,29
30,Success,44,28,6,11,33
30,Fail,42,28,0,21,21
30,Fail,42,32,3,16,26
30,Success,52,19,4,12,40
30,Success,52,25,0,12,40
30,Success,48,28,0,14,34
30,Success,51,23,4,15,36
30,Fail,40,44,0,11,29
30,Success,52,25,0,11,41
30,Success,52,22,5,13,39
30,Success,48,29,0,11,37
30,Success,53,17,0,17,36
30,Success,49,24,1,14,35
30,Success,50,25,4,11,39
30,Success,50,30,0,14,36
30,Success,45,33,0,9,36
30,Success,51,22,4,14,37
30,Fail,45,23,3,16,29
30,Success,51,32,0,9,42
30,Success,47,30,0,11,36
30,Success,48,29,0,15,33
30,Success,43,35,0,13,30
30,Success,46,29,4,13,33
30,Success,52,27,0,10,42
30,Success,53,23,0,15,38
30,Success,41,41,1,8,33
30,Success,49,27,2,13,36
30,Success,47,36,0,9,38
30,Fail,39,34,8,14,25
30,Success,49,27,2,13,36
30,Success,56,18,0,10,46
30,Success,41,32,5,11,30
30,Success,52,22,5,10,42
30,Success,48,20,5,16,32
30,Fail,44,33,0,17,27
30,Success,46,22,6,15,31
30,Success,48,23,0,17,31
30,Success,50,24,0,14,36
30,Success,45,33,0,12,33
30,Success,43,35,5,8,35
30,Success,53,29,0,9,44
30,Success,54,22,0,11,43
30,Success,48,25,0,13,35
30,Success,48,26,1,16,32
30,Fail,42,30,2,14,28
30,Success,51,24,0,11,40
30,Success,48,30,0,9,39
30,Success,47,30,0,14,33
30,Success,50,26,0,14,36
30,Fail,40,32,8,11,29
30,Success,50,32,2,8,42
30,Fail,42,30,0,20,22
30,Success,49,23,4,12,37
30,Fail,42,31,3,15,27
30,Success,47,35,0,9,38
30,Success,51,24,0,12,39
30,Success,47,22,9,15,32
30,Success,44,27,8,11,33
30,Success,46,25,3,14,32
30,Success,55,28,0,9,46
30,Fail,42,26,8,15,27
30,Success,50,25,0,14,36
30,Success,49,22,4,11,38
30,Success,50,26,1,12,38
30,Success,49,24,5,11,38
30,Fail,45,31,0,17,28
30,Success,46,27,0,14,32
30,Success,45,27,0,15,30
30,Success,53,25,0,12,41
30,Success,45,29,4,12,33
30,Success,46,25,0,14,32
30,Success,49,29,0,13,36
30,Success,51,18,2,14,37
30,Success,52,28,0,14,38
30,Success,51,18,1,16,35
30,Success,49,22,0,17,32
30,Success,48,26,9,9,39
30,Fail,36,31,4,18,18
30,Success,55,24,0,13,42
30,Fail,41,29,6,18,23
30,Success,40,43,0,10,30
30,Success,50,22,3,14,36
30,Fail,41,34,0,17,24
30,Success,48,22,7,11,37
30,Success,50,25,0,14,36
30,Success,48,32,4,11,37
30,Success,46,29,0,12,34
30,Success,50,22,0,17,33
30,Success,46,25,0,12,34
30,Success,51,28,0,11,40
30,Fail,38,32,0,19,19
30,Success,54,32,0,7,47
30,Success,44,32,0,13,31
30,Success,55,22,1,6,49
30,Success,44,35,0,11,33
30,Success,52,25,0,9,43
30,Success,46,30,0,15,31
30,Fail,43,31,0,14,29
30,Success,45,33,0,13,32
30,Success,58,17,1,15,43
30,Success,50,31,0,12,38
30,Success,49,31,0,12,37
30,Fail,43,36,0,17,26
30,Success,51,29,0,11,40
30,Success,49,28,2,7,42
30,Success,47,27,5,12,35
30,Success,47,30,0,12,35
30,Success,51,24,3,13,38
30,Success,56,17,0,14,42
30,Success,46,30,0,15,31
30,Success,47,23,3,14,33
30,Success,53,21,0,11,42
30,Success,47,34,0,10,37
30,Success,51,27,0,10,41
30,Success,53,28,0,10,43
30,Success,57,21,1,8,49
30,Success,47,29,6,10,37
30,Success,44,34,0,9,35
30,Fail,37,41,0,11,26
30,Success,45,30,0,15,30
30,Fail,46,29,0,17,29
30,Success,50,28,1,11,39
30,Fail,43,29,0,16,27
30,Success,46,31,0,14,32
30,Fail,38,26,7,18,20
30,Success,48,22,2,16,32
30,Success,47,26,1,12,35
30,Success,54,27,0,8,46
30,Fail,43,29,0,15,28
30,Fail,47,20,2,18,29
30,Fail,43,29,7,15,28
30,Fail,41,32,8,12,29
30,Success,54,27,0,7,47
30,Success,54,10,1,23,31
30,Success,52,26,6,8,44
30,Success,51,22,3,13,38
30,Success,49,26,0,12,37
30,Success,55,26,3,6,49
30,Success,50,26,0,10,40
30,Success,43,30,6,11,32
30,Fail,43,33,0,17,26
30,Success,55,23,4,9,46
30,Success,46,30,4,10,36
30,Fail,45,27,0,18,27
30,Fail,41,35,1,15,26
30,Success,49,28,0,9,40
30,Success,53,19,10,13,40
30,Success,50,26,2,13,37
30,Success,52,27,5,7,45
30,Success,53,32,0,9,44
30,Success,49,27,2,13,36
30,Fail,45,27,2,16,29
30,Success,48,29,0,10,38
30,Success,50,26,1,10,40
30,Success,49,25,2,9,40
30,Fail,43,28,6,15,28
30,Success,55,20,2,11,44
30,Success,46,23,3,15,31
30,Success,48,23,1,14,34
30,Success,49,26,6,12,37
30,Success,48,27,3,11,37
30,Success,52,28,2,8,44
30,Success,52,30,1,8,44
30,Success,45,33,0,15,30
30,Success,51,20,0,13,38
30,Success,50,25,0,15,35
30,Success,51,25,0,9,42
30,Success,52,29,0,7,45
30,Success,47,35,0,10,37
30,Success,47,31,0,13,34
30,Success,51,30,1,9,42
30,Success,54,22,0,10,44
30,Fail,39,27,12,16,23
30,Success,48,17,12,17,31
30,Success,53,14,1,14,39
30,Success,43,38,0,9,34
30,Success,45,34,0,9,36
30,Success,48,20,3,18,30
30,Success,55,17,2,13,42
30,Success,50,27,0,12,38
30,Fail,41,33,0,15,26
30,Success,41,41,0,8,33
30,Success,47,28,0,15,32
30,Fail,41,43,0,12,29
30,Success,52,24,0,10,42
30,Success,47,26,2,15,32
30,Success,47,28,0,14,33
30,Success,48,29,5,11,37
30,Success,50,24,0,12,38
30,Success,45,33,2,10,35
30,Success,52,19,2,11,41
30,Fail,43,23,13,14,29
30,Success,50,27,0,11,39
30,Success,47,26,0,15,32
30,Success,58,21,2,6,52
30,Success,46,26,10,9,37
30,Success,51,27,0,10,41
30,Success,48,29,1,11,37
30,Fail,42,31,0,19,23
30,Success,48,34,0,12,36
30,Success,50,25,0,13,37
30,Success,56,23,4,11,45
30,Success,47,27,0,12,35
30,Success,57,18,2,10,47
30,Fail,47,18,5,18,29
30,Success,43,40,0,7,36
30,Success,42,38,0,10,32
30,Success,48,24,1,18,30
30,Success,44,30,5,11,33
30,Success,44,32,0,11,33
30,Success,46,29,2,15,31
30,Fail,39,29,6,15,24
30,Success,48,29,0,9,39
30,Fail,47,24,0,18,29
30,Success,50,22,4,11,39
30,Success,44,32,3,12,32
30,Success,49,30,0,11,38
30,Fail,47,21,1,18,29
30,Success,50,23,4,13,37
30,Success,45,29,0,12,33
30,Success,43,32,2,12,31
30,Success,49,29,0,13,36
30,Success,51,23,2,14,37
30,Success,45,31,0,14,31
30,Success,50,27,0,11,39
30,Success,52,21,0,16,36
30,Success,48,25,4,11,37
30,Success,48,22,3,16,32
30,Success,47,28,5,11,36
30,Success,49,27,0,13,36
30,Success,47,26,2,14,33
30,Fail,43,25,0,18,25
30,Success,48,30,0,11,37
30,Success,54,25,0,9,45
30,Success,49,27,5,10,39
30,Success,51,23,3,11,40
30,Success,52,29,0,4,48
30,Success,46,31,6,10,36
30,Success,48,25,12,7,41
30,Success,51,22,4,9,42
30,Success,42,38,0,11,31
30,Success,50,25,3,12,38
30,Fail,37,32,5,14,23
30,Fail,41,25,7,19,22
30,Success,45,23,9,13,32
30,Success,55,22,2,9,46
30,Success,53,22,0,11,42
30,Fail,45,31,0,17,28
30,Success,54,25,1,9,45
30,Success,54,30,0,10,44
30,Success,50,32,0,9,41
30,Fail,37,43,0,12,25
30,Success,46,28,4,15,31
30,Success,51,21,4,13,38
30,Fail,40,31,0,21,19
30,Success,47,30,0,15,32
30,Fail,47,18,8,18,29
30,Success,51,25,0,9,42
30,Success,42,37,0,12,30
30,Fail,38,33,0,19,19
30,Success,47,23,1,16,31
30,Success,47,25,7,6,41
30,Success,53,27,0,7,46
30,Success,44,28,11,12,32
30,Fail,46,22,1,17,29
30,Success,48,28,0,9,39
30,Success,46,24,8,14,32
30,Success,48,29,0,12,36
30,Success,44,28,6,12,32
30,Fail,42,31,0,17,25
30,Success,49,28,0,11,38
30,Fail,44,24,3,18,26
30,Fail,41,34,0,15,26
30,Fail,45,28,1,17,28
30,Success,49,23,0,19,30
30,Success,48,25,6,12,36
30,Success,56,21,0,9,47
30,Success,48,29,0,14,34
30,Success,50,20,4,14,36
30,Success,50,25,0,14,36
30,Success,46,31,2,11,35
30,Fail,41,32,0,18,23
30,Success,46,32,0,15,31
30,Success,55,22,5,11,44
30,Success,52,19,5,13,39
30,Success,56,20,2,12,44
30,Success,49,27,0,10,39
30,Success,46,28,0,14,32
30,Success,42,28,3,12,30
30,Success,50,15,6,16,34
30,Success,50,23,6,12,38
30,Success,52,24,1,12,40
30,Success,53,22,0,14,39
30,Success,47,28,0,12,35
30,Fail,38,36,5,11,27
30,Success,48,31,0,11,37
30,Fail,43,27,5,14,29
30,Success,45,28,6,10,35
30,Success,48,24,0,18,30
30,Success,58,28,0,9,49
30,Success,48,31,0,9,39
30,Success,56,21,0,11,45
30,Success,51,25,6,11,40
30,Success,57,18,1,12,45
30,Success,48,28,0,12,36
30,Success,48,30,1,9,39
30,Fail,43,24,1,22,21
30,Success,57,21,2,11,46
30,Fail,41,33,0,17,24
30,Fail,46,16,6,20,26
30,Success,51,29,0,11,40
30,Success,46,26,3,12,34
30,Success,56,22,2,9,47
30,Success,49,35,0,11,38
30,Success,46,22,4,15,31
30,Success,50,23,7,11,39
30,Success,47,31,0,12,35
30,Success,54,29,0,7,47
30,Fail,40,22,9,20,20
30,Success,51,23,6,10,41
30,Success,56,26,0,5,51
30,Success,52,22,2,8,44
30,Success,49,34,0,8,41
30,Success,49,33,0,10,39
30,Success,45,32,0,9,36
30,Success,49,28,0,14,35
30,Success,48,39,0,8,40
30,Success,56,22,0,9,47
30,Success,55,22,6,10,45
30,Fail,44,33,0,15,29
30,Success,52,22,5,12,40
30,Success,48,31,1,12,36
30,Fail,46,25,1,20,26
30,Success,46,29,0,13,33
30,Fail,39,34,6,12,27
30,Success,55,17,0,13,42
30,Fail,43,29,0,15,28
30,Fail,42,32,4,15,27
30,Success,49,32,0,9,40
30,Success,42,38,0,10,32
30,Success,47,29,2,12,35
30,Success,50,33,0,10,40
30,Success,46,30,0,15,31
30,Success,47,32,3,9,38
30,Success,47,27,4,9,38
30,Success,50,28,0,10,40
30,Success,50,16,6,19,31
30,Success,56,25,1,9,47
30,Success,49,28,1,12,37
30,Success,51,25,0,12,39
30,Success,46,34,0,13,33
30,Success,54,18,8,8,46
30,Success,50,27,0,8,42
30,Success,49,25,3,11,38
30,Success,49,19,4,16,33
30,Success,53,24,0,12,41
30,Success,55,27,0,8,47
30,Success,46,30,0,9,37
30,Success,45,30,0,14,31
30,Success,50,29,0,12,38
30,Fail,42,34,0,16,26
30,Success,52,27,0,11,41
30,Fail,42,34,0,16,26
30,Success,48,23,2,17,31
30,Success,45,31,3,12,33
30,Fail,41,33,0,15,26
30,Success,47,25,7,8,39
30,Success,44,34,0,13,31
30,Success,50,25,0,11,39
30,Success,48,26,0,17,31
30,Success,56,20,0,13,43
30,Success,49,18,5,18,31
30,Fail,45,21,2,21,24
30,Success,50,21,4,16,34
30,Success,46,27,0,16,30
30,Success,50,26,4,9,41
30,Success,50,29,0,12,38
30,Success,48,33,0,8,40
30,Success,45,29,0,15,30
30,Success,54,16,3,15,39
30,Success,44,33,0,13,31
30,Success,52,30,0,7,45
30,Success,48,28,0,15,33
30,Fail,46,29,0,17,29
30,Success,51,21,4,12,39
30,Success,54,24,2,11,43
30,Success,50,27,0,10,40
30,Success,52,20,5,12,40
30,Success,45,33,0,10,35
30,Success,52,21,5,9,43
30,Success,58,21,0,11,47
30,Success,53,28,0,6,47
30,Success,53,22,0,12,41
30,Success,44,29,4,13,31
30,Success,50,26,0,11,39
30,Success,45,25,1,14,31
30,Success,49,29,0,14,35
30,Success,43,37,0,13,30
30,Success,57,23,0,5,52
30,Success,54,25,7,6,48
30,Success,49,28,0,10,39
30,Success,49,20,6,14,35
30,Success,52,26,1,9,43
30,Fail,43,30,3,15,28
30,Success,50,30,0,7,43
30,Success,50,28,0,8,42
30,Fail,41,25,1,21,20
30,Success,49,20,4,15,34
30,Success,45,35,0,7,38
30,Success,49,24,7,11,38
30,Success,50,27,0,12,38
30,Success,46,32,0,13,33
30,Success,49,30,0,14,35
30,Fail,47,27,0,20,27
30,Success,43,34,1,10,33
30,Success,45,20,9,15,30
30,Success,50,23,4,11,39
30,Success,53,20,1,13,40
30,Success,58,20,3,8,50
30,Fail,48,21,0,21,27
30,Success,48,26,1,13,35
30,Success,55,20,2,12,43
30,Success,50,14,10,15,35
30,Success,47,24,4,15,32
30,Success,50,26,0,10,40
30,Success,50,34,0,8,42
30,Success,51,25,0,13,38
30,Success,53,24,3,13,40
30,Fail,42,27,8,17,25
30,Success,48,21,2,15,33
30,Success,55,18,3,11,44
30,Success,45,30,3,11,34
30,Success,55,20,0,15,40
30,Fail,40,33,1,17,23
30,Success,49,24,0,12,37
30,Success,52,32,0,6,46
30,Success,51,21,10,11,40
30,Success,53,22,0,11,42
30,Success,53,27,0,7,46
30,Success,52,23,0,13,39
30,Success,55,23,6,7,48
30,Success,51,21,0,16,35
30,Fail,43,32,0,16,27
30,Success,53,21,0,13,40
30,Fail,44,25,2,20,24
30,Fail,44,31,0,15,29
30,Success,54,23,0,11,43
30,Fail,44,25,5,16,28
30,Success,47,26,5,14,33
30,Success,51,25,0,12,39
30,Success,44,30,1,13,31
30,Success,47,29,0,14,33
30,Success,49,17,8,13,36
30,Success,54,30,0,6,48
30,Success,44,26,7,12,32
30,Success,45,26,10,12,33
30,Success,53,23,0,15,38
30,Success,47,26,6,11,36
30,Success,51,26,0,9,42
30,Success,46,32,0,12,34
30,Success,47,26,8,12,35
30,Success,50,29,0,14,36
30,Fail,45,29,0,16,29
30,Success,47,33,0,7,40
30,Success,48,29,1,10,38
30,Success,50,23,0,12,38
30,Success,44,24,8,14,30
30,Success,49,27,2,14,35
30,Success,60,14,3,10,50
30,Success,52,29,0,6,46
30,Success,52,22,3,14,38
30,Success,44,31,0,14,30
30,Success,50,31,0,11,39
30,Success,44,26,9,14,30
30,Success,48,29,0,15,33
30,Fail,44,29,5,15,29
30,Success,48,28,0,16,32
30,Success,44,27,10,11,33
30,Success,48,25,3,14,34
30,Success,52,23,2,12,40
30,Fail,41,39,0,13,28
30,Success,43,35,0,13,30
30,Success,44,36,0,13,31
30,Success,47,35,0,12,35
30,Success,42,34,2,12,30
30,Success,43,34,0,9,34
30,Success,43,35,0,9,34
30,Success,45,28,0,15,30
30,Fail,41,30,0,19,22
30,Fail,45,27,0,17,28
30,Fail,40,30,0,19,21
30,Success,60,26,0,7,53
30,Success,50,30,1,9,41
30,Success,52,30,0,6,46
30,Success,51,26,2,5,46
30,Success,46,29,7,11,35
30,Success,50,25,4,10,40
30,Success,54,27,0,7,47
30,Success,50,26,0,12,38
30,Success,43,41,0,7,36
30,Fail,46,25,0,17,29
30,Success,50,34,0,10,40
30,Success,52,22,3,13,39
30,Success,45,31,0,14,31
30,Success,54,24,0,9,45
30,Success,54,21,2,13,41
30,Success,51,20,8,10,41
30,Success,51,28,0,7,44
30,Success,50,29,0,11,39
30,Success,52,29,0,7,45
30,Success,52,23,4,10,42
30,Success,54,24,1,10,44
30,Fail,46,25,0,18,28
30,Success,48,20,5,16,32
30,Success,48,34,0,12,36
30,Success,53,24,0,13,40
30,Success,45,25,8,13,32
30,Success,52,19,4,16,36
30,Success,42,33,2,10,32
30,Success,45,31,0,12,33
30,Success,53,22,0,11,42
30,Success,46,39,0,11,35
30,Success,45,27,9,11,34
30,Success,50,27,8,6,44
30,Success,46,35,0,13,33
30,Success,51,28,0,10,41
30,Success,52,23,0,13,39
30,Success,48,29,2,9,39
30,Success,55,19,0,9,46
30,Success,54,23,0,8,46
30,Success,53,20,2,16,37
30,Success,51,19,0,16,35
30,Success,48,21,3,17,31
30,Success,45,34,0,12,33
30,Success,49,21,8,12,37
30,Success,49,25,2,14,35
30,Success,43,36,7,11,32
30,Success,50,26,0,16,34
30,Success,56,19,2,9,47
30,Fail,44,28,0,17,27
30,Success,59,24,0,7,52
30,Success,49,21,5,14,35
30,Success,47,30,0,16,31
30,Fail,43,30,2,15,28
30,Success,49,27,1,12,37
30,Success,43,31,15,7,36
30,Success,46,28,5,8,38
30,Success,48,39,0,3,45
30,Success,50,25,4,10,40
30,Success,43,21,13,11,32
30,Success,50,27,2,12,38
30,Success,44,29,6,9,35
30,Success,50,34,0,9,41
30,Fail,38,37,0,17,21
30,Success,47,26,7,11,36
30,Fail,41,25,4,18,23
30,Success,45,30,3,14,31
30,Success,50,27,3,8,42
30,Success,48,33,0,8,40
30,Success,48,23,8,10,38
30,Success,46,28,2,14,32
30,Success,42,32,6,12,30
30,Success,50,20,6,13,37
30,Success,54,22,0,12,42
30,Success,43,30,8,9,34
30,Success,53,23,1,10,43
30,Success,52,28,0,6,46
30,Success,50,25,4,12,38
30,Success,49,27,0,13,36
30,Success,53,24,2,10,43
30,Success,53,21,0,9,44
30,Success,45,33,0,14,31
30,Success,48,24,0,14,34
30,Success,49,27,4,9,40
30,Success,47,35,0,13,34
30,Success,50,26,0,15,35
30,Success,49,24,7,11,38
30,Fail,43,28,0,16,27
30,Success,46,27,6,14,32
30,Success,48,29,1,15,33
30,Fail,38,42,0,12,26
30,Success,52,26,0,12,40
30,Success,49,27,0,10,39
30,Fail,38,36,0,16,22
30,Success,52,25,0,13,39
30,Fail,41,33,0,15,26
30,Success,52,22,6,11,41
30,Fail,42,34,1,13,29
30,Success,46,26,0,14,32
30,Success,44,31,4,9,35
30,Success,50,27,3,12,38
30,Success,50,21,1,14,36
30,Fail,42,26,5,14,28
30,Success,45,37,0,9,36
30,Success,51,25,2,10,41
30,Fail,42,30,0,16,26
30,Fail,43,29,0,16,27
30,Success,54,21,3,11,43
30,Success,51,23,9,11,40
30,Success,50,29,0,13,37
30,Success,54,26,0,9,45
30,Success,43,30,6,13,30
30,Success,46,32,0,12,34
30,Success,51,21,7,11,40
30,Success,53,26,0,9,44
30,Success,46,32,3,10,36
30,Success,57,16,0,15,42
30,Success,53,22,0,17,36
30,Success,48,24,7,12,36
30,Success,50,22,0,10,40
30,Fail,40,27,2,15,25
30,Success,52,17,3,18,34
30,Fail,42,29,0,20,22
30,Success,46,28,9,10,36
30,Fail,47,23,4,18,29
30,Success,41,36,0,11,30
30,Success,54,16,4,10,44
30,Success,48,28,0,10,38
30,Success,55,22,0,11,44
30,Success,49,27,0,12,37
30,Success,51,26,0,12,39
30,Success,48,26,0,16,32
30,Success,50,19,6,14,36
30,Success,47,28,3,15,32
30,Success,45,41,0,10,35
30,Success,47,27,2,15,32
30,Success,40,36,1,10,30
30,Success,47,24,1,16,31
30,Success,55,22,0,14,41
30,Success,51,26,2,8,43
30,Success,43,38,0,11,32
30,Success,47,24,1,16,31
30,Fail,38,39,0,11,27
30,Success,44,31,1,14,30
30,Success,50,27,4,9,41
30,Success,46,30,1,13,33
30,Success,44,27,3,13,31
30,Success,51,22,1,11,40
30,Fail,49,19,1,20,29
30,Success,51,23,0,16,35
30,Success,48,25,0,13,35
30,Fail,47,26,0,18,29
30,Success,48,28,0,17,31
30,Success,48,30,0,12,36
30,Success,50,24,4,11,39
30,Success,44,30,3,11,33
30,Success,47,29,4,9,38
30,Success,50,21,9,10,40
30,Success,46,24,3,12,34
30,Success,46,29,0,16,30
30,Success,47,35,0,8,39
30,Fail,38,38,0,16,22
30,Success,52,25,0,9,43
30,Success,50,29,0,9,41
30,Success,42,39,0,12,30
30,Success,53,23,2,14,39
30,Success,54,26,0,9,45
30,Success,49,24,13,6,43
30,Success,49,34,1,3,46
30,Success,44,35,0,10,34
30,Success,52,27,0,10,42
30,Success,55,24,0,9,46
30,Success,49,30,2,10,39
30,Success,51,28,5,8,43
30,Fail,46,21,0,20,26
30,Success,52,15,5,16,36
30,Success,45,29,7,10,35
30,Success,51,26,0,14,37
30,Success,50,26,0,12,38
30,Success,53,28,0,13,40
30,Success,50,29,7,8,42
30,Success,56,19,1,9,47
30,Success,46,26,1,15,31
30,Fail,48,24,0,19,29
30,Fail,39,30,0,19,20
30,Success,51,26,0,12,39
30,Success,42,39,0,8,34
30,Success,49,20,2,18,31
30,Success,47,30,0,10,37
30,Success,48,30,5,12,36
30,Success,50,23,2,13,37
30,Success,46,27,1,16,30
30,Fail,44,28,0,16,28
30,Success,51,26,4,10,41
30,Success,52,24,0,15,37
30,Success,47,26,0,11,36
30,Success,49,21,5,16,33
30,Success,49,28,0,10,39
30,Success,49,28,5,10,39
30,Success,51,27,4,11,40
30,Success,46,29,0,11,35
30,Success,61,16,3,9,52
30,Success,52,31,2,6,46
30,Success,46,25,7,16,30
30,Success,53,25,1,9,44
30,Fail,45,23,5,16,29
30,Success,53,25,0,10,43
30,Fail,39,41,0,13,26
30,Success,46,26,1,14,32
30,Fail,46,23,5,17,29
30,Fail,43,32,1,15,28
30,Success,50,26,0,11,39
30,Success,50,27,0,13,37
30,Success,42,40,0,8,34
30,Success,54,28,0,12,42
30,Success,46,29,0,16,30
30,Success,51,29,0,11,40
30,Success,49,26,0,12,37
30,Success,55,22,0,14,41
30,Success,51,26,0,9,42
30,Success,50,31,0,11,39
30,Success,51,28,2,8,43
30,Success,45,31,0,14,31
30,Success,45,33,0,15,30
30,Fail,44,24,5,18,26
30,Success,47,30,1,6,41
30,Fail,43,31,0,17,26
30,Success,55,26,0,7,48
30,Success,44,34,0,11,33
30,Success,49,32,0,7,42
30,Success,49,28,0,12,37
30,Success,54,19,7,12,42
30,Success,56,26,0,6,50
30,Success,52,21,0,12,40
30,Success,46,32,0,12,34
30,Success,50,28,0,11,39
30,Success,53,26,3,8,45
30,Success,49,31,0,11,38
30,Success,50,23,6,13,37
30,Success,52,28,0,9,43
30,Success,48,31,0,13,35
30,Success,57,16,10,7,50
30,Success,47,25,3,12,35
30,Fail,44,30,0,16,28
30,Success,52,23,0,14,38
30,Success,51,25,0,12,39
30,Success,45,39,0,8,37
30,Success,53,16,0,18,35
30,Success,49,28,0,16,33
30,Success,50,24,3,11,39
30,Success,45,32,6,4,41
30,Fail,44,31,0,15,29
30,Success,50,27,0,13,37
30,Success,41,37,4,10,31
30,Success,47,30,0,15,32
30,Success,53,20,1,13,40
30,Success,50,25,0,12,38
30,Success,44,24,7,9,35
30,Fail,43,36,0,14,29
30,Success,51,28,2,11,40
30,Fail,48,22,0,20,28
30,Fail,39,42,0,10,29
30,Success,55,20,3,12,43
30,Success,41,42,0,11,30
30,Success,49,32,1,10,39
30,Success,47,24,2,14,33
30,Success,48,27,2,10,38
30,Success,44,29,4,12,32
30,Success,42,34,0,12,30
30,Success,46,32,0,12,34
30,Success,52,22,0,14,38
30,Fail,46,21,6,17,29
30,Success,50,29,3,11,39
30,Success,47,28,0,10,37
30,Success,52,21,2,12,40
30,Success,47,27,2,15,32
30,Success,58,21,2,10,48
30,Success,52,23,5,9,43
30,Success,52,24,5,13,39
30,Success,50,22,0,17,33
30,Success,50,28,1,13,37
30,Fail,46,23,2,19,27
30,Success,51,23,0,14,37
30,Success,45,30,4,10,35
30,Success,48,31,3,8,40
30,Fail,46,22,6,17,29
30,Success,49,22,5,14,35
30,Fail,41,28,9,13,28
30,Success,50,14,3,16,34
30,Success,53,21,2,11,42
30,Success,52,28,0,10,42
30,Success,53,24,1,11,42
30,Success,46,36,0,8,38
30,Fail,46,26,0,17,29
30,Success,55,20,4,12,43
30,Success,51,22,0,17,34
30,Success,47,26,9,13,34
30,Success,48,22,4,17,31
30,Success,53,19,4,13,40
30,Success,49,33,2,7,42
30,Success,44,29,6,13,31
30,Fail,39,24,5,22,17
30,Fail,43,35,0,15,28
30,Success,53,20,5,11,42
30,Success,45,26,4,15,30
30,Success,51,19,0,17,34
30,Fail,42,27,0,20,22
30,Success,44,26,6,13,31
30,Fail,37,28,10,18,19
30,Fail,43,32,0,15,28
30,Success,48,22,0,14,34
30,Success,48,24,1,15,33
30,Success,47,27,0,13,34
30,Success,49,29,0,12,37
30,Success,51,26,1,12,39
30,Fail,46,21,2,18,28
30,Success,49,21,0,14,35
30,Success,55,21,0,10,45
30,Success,50,22,4,10,40
30,Success,52,26,0,8,44
30,Fail,41,38,0,12,29
30,Success,48,26,1,13,35
30,Success,42,36,0,11,31
30,Success,44,35,0,11,33
30,Fail,42,34,0,14,28
30,Fail,45,25,0,17,28
30,Success,49,31,0,12,37
30,Success,42,35,0,11,31
30,Success,50,21,6,9,41
30,Fail,45,26,0,16,29
30,Success,48,27,2,12,36
30,Fail,42,26,5,16,26
30,Success,46,28,2,12,34
30,Success,47,31,1,11,36
30,Success,43,34,0,13,30
30,Success,45,24,6,14,31
30,Success,49,31,0,11,38
30,Success,45,32,0,15,30
30,Success,53,25,2,7,46
30,Success,46,28,0,16,30
30,Success,47,35,0,7,40
30,Success,57,21,2,11,46
30,Success,51,27,6,9,42
30,Success,49,28,2,12,37
30,Success,45,31,0,13,32
30,Success,54,29,1,3,51
30,Success,54,26,1,9,45
30,Success,51,26,0,12,39
30,Fail,43,32,0,16,27
30,Success,45,33,0,14,31
30,Success,51,24,0,11,40
30,Success,48,26,0,12,36
30,Success,43,29,5,11,32
30,Success,47,26,4,14,33
30,Fail,44,25,0,20,24
30,Success,50,20,1,18,32
30,Success,48,19,4,18,30
30,Success,44,25,5,14,30
30,Success,65,18,0,9,56
30,Success,48,29,0,11,37
30,Success,53,25,1,9,44
30,Success,46,26,8,14,32
30,Success,50,27,0,13,37
30,Success,45,34,0,13,32
30,Success,53,29,0,10,43
30,Success,57,18,0,12,45
30,Success,52,34,0,6,46
30,Success,47,28,8,10,37
30,Success,48,32,0,10,38
30,Success,46,29,8,12,34
30,Success,47,29,0,16,31
30,Success,47,31,0,14,33
30,Success,49,32,0,11,38
30,Success,56,16,0,15,41
30,Success,47,26,3,17,30
30,Success,47,25,9,6,41
30,Fail,44,25,0,22,22
30,Success,52,17,4,17,35
30,Success,53,27,0,11,42
30,Success,48,23,0,15,33
30,Success,48,20,3,14,34
30,Success,43,33,0,13,30
30,Success,52,21,6,10,42
30,Success,48,26,2,13,35
30,Fail,46,26,0,20,26
30,Success,53,28,0,9,44
30,Success,50,27,0,13,37
30,Success,53,29,0,6,47
30,Success,50,26,3,12,38
30,Success,50,24,2,13,37
30,Fail,40,31,4,15,25
30,Success,46,29,2,10,36
30,Fail,43,20,7,22,21
30,Fail,40,34,0,14,26
30,Success,45,21,11,14,31
30,Success,45,30,3,11,34
30,Success,50,28,0,8,42
30,Success,51,24,2,16,35
30,Success,48,30,5,8,40
30,Success,48,25,0,15,33
30,Fail,48,24,1,19,29
30,Success,51,19,0,16,35
30,Success,48,25,2,15,33
30,Success,53,23,0,12,41
30,Success,50,24,1,8,42
30,Fail,44,24,1,17,27
30,Success,45,33,2,11,34
30,Success,51,22,0,16,35
30,Success,49,21,0,17,32
30,Success,50,28,0,10,40
30,Success,50,24,1,13,37
30,Success,49,25,0,14,35
30,Success,54,20,4,11,43
30,Fail,38,30,10,17,21
30,Success,51,24,0,12,39
30,Success,52,32,0,9,43
30,Fail,43,26,9,14,29
30,Success,48,24,3,16,32
30,Success,51,27,0,10,41
30,Success,43,33,5,10,33
30,Success,51,20,2,13,38
30,Success,52,29,2,7,45
30,Success,51,24,0,12,39
30,Success,51,17,2,18,33
30,Success,48,25,7,12,36
30,Success,47,32,0,10,37
30,Success,50,24,1,16,34
30,Success,56,23,0,11,45
30,Success,48,30,0,14,34
30,Success,56,21,0,13,43
30,Success,45,31,0,14,31
30,Success,45,27,6,11,34
30,Success,49,19,5,17,32
30,Success,49,32,3,6,43
30,Success,44,35,4,8,36
30,Success,45,26,2,15,30
30,Success,48,35,0,7,41
30,Success,48,31,0,9,39
30,Success,58,21,0,13,45
30,Success,43,34,0,13,30
30,Success,48,30,0,13,35
30,Success,53,26,0,7,46
30,Success,52,22,3,12,40
30,Success,49,28,3,9,40
30,Fail,43,31,6,14,29
30,Success,54,25,0,10,44
30,Success,51,28,5,6,45
30,Success,50,22,2,15,35
30,Success,47,26,4,14,33
30,Success,46,31,0,10,36
30,Success,51,24,0,17,34
30,Success,51,23,2,13,38
30,Fail,37,32,1,17,20
30,Success,48,28,1,13,35
30,Success,48,25,1,14,34
30,Success,45,33,0,13,32
30,Success,55,20,0,9,46
30,Success,53,22,0,14,39
30,Success,53,21,2,12,41
30,Success,43,32,0,12,31
30,Fail,42,29,2,15,27
30,Success,46,27,4,15,31
30,Success,53,20,0,11,42
30,Success,54,22,0,14,40
30,Success,55,20,0,13,42
30,Success,48,33,0,7,41
30,Success,48,20,5,13,35
30,Success,42,37,0,10,32
30,Success,50,23,8,8,42
30,Success,45,23,10,13,32
30,Success,47,30,0,10,37
30,Success,50,26,2,11,39
30,Success,49,19,0,17,32
30,Success,47,26,5,12,35
30,Success,46,27,0,15,31
30,Success,50,27,0,13,37
30,Success,47,28,0,16,31
30,Success,51,26,0,10,41
30,Success,50,23,2,12,38
30,Success,51,25,0,12,39
30,Success,52,28,2,5,47
30,Fail,44,29,4,15,29
30,Fail,42,25,7,15,27
30,Success,46,30,0,12,34
30,Success,50,31,0,14,36
30,Success,52,25,0,9,43
30,Success,48,22,4,15,33
30,Success,52,19,5,12,40
30,Fail,41,34,0,14,27
30,Success,48,25,0,16,32
30,Success,59,23,0,6,53
30,Fail,45,27,1,17,28
30,Success,56,18,0,13,43
30,Success,49,24,2,12,37
30,Success,52,22,0,13,39
30,Success,48,25,5,14,34
30,Success,49,30,0,8,41
30,Success,50,26,0,17,33
30,Fail,42,30,3,14,28
30,Success,50,29,0,12,38
30,Success,49,33,4,5,44
30,Success,51,26,0,9,42
30,Success,53,25,0,13,40
30,Success,46,29,0,15,31
30,Success,50,34,0,9,41
30,Success,50,29,0,9,41
30,Success,46,38,0,13,33
30,Success,55,16,3,16,39
30,Success,58,21,2,8,50
30,Success,50,25,7,12,38
30,Success,46,32,0,13,33
30,Success,46,31,0,11,35
30,Success,47,29,0,13,34
30,Fail,44,28,2,17,27
30,Success,49,23,0,15,34
30,Fail,35,30,9,17,18
30,Success,49,31,0,9,40
30,Success,48,33,0,13,35
30,Success,50,31,0,8,42
30,Fail,40,29,5,16,24
30,Success,46,30,0,12,34
30,Fail,39,28,11,11,28
30,Fail,40,37,0,15,25
30,Success,50,30,2,7,43
30,Success,43,29,11,9,34
30,Success,46,27,3,13,33
30,Success,48,24,3,16,32
30,Success,54,21,2,7,47
30,Success,55,24,0,10,45
30,Fail,46,29,0,18,28
30,Success,50,29,0,10,40
30,Success,47,33,0,10,37
30,Success,45,32,0,15,30
30,Success,53,25,0,9,44
30,Fail,47,21,6,19,28
30,Success,58,21,6,7,51
30,Success,46,31,0,13,33
30,Fail,45,29,0,17,28
30,Success,52,17,10,16,36
30,Success,55,23,3,10,45
30,Success,46,39,0,7,39
30,Fail,44,29,0,16,28
30,Success,52,29,0,10,42
30,Success,52,31,0,8,44
30,Success,53,16,6,17,36
30,Success,49,30,0,14,35
30,Success,46,29,0,12,34
30,Success,43,31,5,10,33
30,Success,45,21,5,15,30
30,Success,48,22,11,11,37
30,Success,46,31,0,8,38
30,Fail,42,28,0,20,22
30,Fail,37,35,0,16,21
30,Success,46,31,2,11,35
30,Success,48,30,1,10,38
30,Fail,48,27,0,19,29
30,Fail,40,22,21,12,28
30,Success,50,25,3,11,39
30,Success,51,27,0,12,39
30,Success,51,26,10,9,42
30,Success,49,36,0,7,42
30,Success,51,28,4,7,44
30,Success,49,22,0,17,32
30,Success,50,22,3,12,38
30,Success,48,26,9,9,39
30,Success,46,26,7,13,33
30,Success,45,30,1,10,35
30,Success,49,27,0,10,39
30,Success,63,12,1,11,52
30,Success,53,29,0,12,41
30,Success,49,19,6,12,37
30,Success,49,27,0,11,38
30,Success,46,24,0,16,30
30,Success,52,23,0,16,36
30,Success,49,22,10,14,35
30,Success,53,23,0,10,43
30,Success,48,19,7,13,35
30,Success,51,25,0,10,41
30,Fail,43,26,0,17,26
30,Success,55,20,2,10,45
30,Success,47,32,1,8,39
30,Success,50,25,0,16,34
30,Success,59,21,3,5,54
30,Success,48,29,0,15,33
30,Success,48,26,0,14,34
30,Success,57,17,0,17,40
30,Success,41,38,0,11,30
30,Success,52,20,1,17,35
30,Success,52,30,0,11,41
30,Success,52,27,0,10,42
30,Fail,41,28,7,14,27
30,Success,48,33,0,8,40
30,Success,51,29,0,10,41
30,Success,54,23,0,11,43
30,Fail,33,34,9,15,18
30,Success,51,27,2,12,39
30,Success,54,16,7,13,41
30,Fail,46,29,0,17,29
30,Success,53,18,0,18,35
30,Fail,46,23,7,19,27
30,Fail,43,18,4,21,22
30,Success,45,34,0,11,34
30,Success,55,31,0,5,50
30,Success,44,30,1,14,30
30,Success,49,23,0,17,32
30,Success,52,28,3,7,45
30,Fail,40,43,0,13,27
30,Success,48,24,8,14,34
30,Success,44,32,2,14,30
30,Success,49,31,0,8,41
30,Success,54,18,3,16,38
30,Success,49,32,4,8,41
30,Success,54,26,4,9,45
30,Success,55,22,3,6,49
30,Success,45,32,4,11,34
30,Fail,38,37,0,16,22
30,Fail,39,28,5,19,20
30,Success,54,22,0,12,42
30,Fail,45,27,2,17,28
30,Success,47,32,0,9,38
30,Success,46,28,0,16,30
30,Fail,45,15,7,17,28
30,Success,44,24,5,14,30
30,Success,47,25,2,16,31
30,Success,46,32,0,11,35
30,Success,50,30,0,9,41
30,Success,49,20,1,16,33
30,Success,48,29,0,13,35
30,Fail,39,30,7,13,26
30,Success,44,29,1,13,31
30,Fail,44,29,0,18,26
30,Success,44,26,9,14,30
30,Success,49,20,4,14,35
30,Fail,45,32,0,16,29
30,Success,51,29,0,10,41
30,Success,50,29,3,12,38
30,Success,41,41,0,10,31
30,Fail,40,31,0,17,23
30,Success,51,28,0,11,40
30,Success,46,31,7,10,36
30,Success,49,32,0,11,38
30,Success,45,30,0,15,30
30,Success,51,18,0,18,33
30,Success,44,29,3,12,32
30,Success,53,21,3,13,40
30,Success,50,22,2,18,32
30,Success,51,26,0,10,41
30,Success,51,28,1,9,42
30,Success,49,27,0,15,34
30,Success,45,27,9,14,31
30,Success,51,23,7,12,39
30,Fail,41,32,0,19,22
30,Success,46,31,0,11,35
30,Success,45,30,0,12,33
30,Success,44,28,4,14,30
30,Fail,44,29,4,15,29
30,Success,49,25,1,12,37
30,Success,50,25,1,16,34
30,Success,52,27,2,8,44
30,Fail,45,23,5,17,28
30,Success,47,30,1,14,33
30,Success,50,33,0,7,43
30,Success,51,27,0,11,40
30,Success,59,19,2,6,53
30,Success,41,28,9,11,30
30,Success,49,20,5,14,35
30,Success,51,20,7,14,37
30,Success,44,31,0,14,30
30,Success,44,30,1,14,30
30,Success,50,26,0,8,42
30,Success,49,27,0,14,35
30,Success,50,26,3,11,39
30,Success,58,18,3,9,49
30,Success,47,32,0,10,37
30,Success,53,20,2,10,43
30,Success,50,25,1,10,40
30,Success,56,19,2,10,46
30,Fail,44,31,0,19,25
30,Fail,43,26,1,15,28
30,Success,51,27,0,9,42
30,Success,50,26,7,8,42
30,Success,48,24,0,15,33
30,Success,51,24,0,12,39
30,Success,48,23,8,14,34
30,Success,48,36,0,10,38
30,Success,50,21,4,15,35
30,Success,49,30,0,9,40
30,Success,48,25,6,13,35
30,Success,52,24,0,11,41
30,Success,47,34,0,11,36
30,Success,45,32,6,10,35
30,Fail,44,27,2,15,29
30,Success,45,28,1,12,33
30,Success,54,21,0,12,42
30,Success,44,26,5,14,30
30,Fail,42,32,0,18,24
30,Success,47,34,0,12,35
30,Fail,42,36,0,14,28
30,Success,50,25,0,15,35
30,Success,44,32,0,12,32
30,Fail,42,22,11,15,27
30,Success,49,27,1,8,41
30,Success,45,32,0,12,33
30,Success,49,17,3,17,32
30,Success,53,31,0,5,48
30,Fail,38,33,0,16,22
30,Fail,42,22,11,16,26
30,Success,50,23,0,17,33
30,Success,50,29,0,9,41
30,Fail,40,39,0,14,26
30,Fail,46,24,2,17,29
30,Fail,44,22,2,21,23
30,Success,42,41,0,10,32
30,Success,49,27,0,13,36
30,Success,51,24,0,12,39
30,Success,48,30,0,15,33
30,Success,46,28,1,12,34
30,Success,44,24,9,13,31
30,Success,51,23,0,14,37
30,Success,55,22,1,8,47
30,Fail,44,31,0,15,29
30,Success,53,14,0,17,36
30,Success,52,25,2,9,43
30,Success,46,33,0,11,35
30,Success,49,28,0,16,33
30,Success,49,28,0,14,35
30,Success,45,31,0,13,32
30,Success,51,27,0,8,43
30,Success,51,27,1,12,39
30,Success,48,30,0,9,39
30,Success,53,25,0,10,43
30,Success,50,29,0,10,40
30,Success,48,31,0,10,38
30,Success,44,32,0,13,31
30,Success,49,28,1,10,39
30,Success,47,28,0,13,34
30,Success,43,33,1,12,31
30,Fail,45,28,0,18,27
30,Success,52,23,0,13,39
30,Success,58,24,0,4,54
30,Fail,36,33,7,14,22
30,Fail,36,34,8,14,22
30,Success,54,25,4,12,42
30,Success,49,27,4,10,39
30,Success,53,24,3,10,43
30,Success,45,34,0,11,34
30,Success,51,21,3,12,39
30,Success,46,31,8,10,36
30,Success,50,24,1,12,38
30,Success,56,19,0,13,43
30,Success,50,28,0,13,37
30,Success,45,29,0,11,34
30,Success,44,30,6,14,30
30,Success,49,19,2,12,37
30,Success,51,26,0,9,42
30,Success,50,21,2,14,36
30,Success,47,27,0,12,35
30,Fail,46,28,3,17,29
30,Fail,46,28,0,17,29
30,Fail,44,25,8,16,28
30,Success,44,35,0,9,35
30,Success,44,35,0,13,31
30,Success,50,20,0,16,34
30,Success,43,31,12,8,35
30,Success,50,27,7,9,41
30,Success,48,34,0,8,40
30,Success,51,25,4,7,44
30,Fail,43,29,0,16,27
30,Success,51,27,0,14,37
30,Fail,44,23,6,16,28
30,Success,60,26,0,7,53
30,Success,52,26,0,8,44
30,Success,47,38,0,10,37
30,Success,48,27,0,11,37
30,Success,46,34,0,10,36
30,Success,47,33,0,10,37
30,Success,49,22,6,12,37
30,Success,46,29,0,12,34
30,Fail,41,32,9,12,29
30,Success,46,30,0,15,31
30,Success,46,25,7,15,31
30,Success,50,23,11,12,38
30,Success,49,21,3,12,37
30,Success,57,29,0,6,51
30,Fail,44,25,3,17,27
30,Success,48,17,4,17,31
30,Success,51,21,4,14,37
30,Success,45,39,0,10,35
30,Success,53,21,0,9,44
30,Success,50,27,11,6,44
30,Success,44,29,0,12,32
30,Success,48,21,4,11,37
30,Success,44,33,0,13,31
30,Success,50,24,0,13,37
30,Fail,43,25,0,20,23
30,Success,54,19,3,9,45
30,Success,51,27,0,9,42
30,Success,55,19,0,12,43
30,Success,57,19,4,10,47
30,Success,54,21,0,13,41
30,Success,47,32,5,6,41
30,Success,54,22,0,11,43
30,Success,45,25,9,11,34
30,Fail,40,38,0,17,23
30,Success,50,29,4,9,41
30,Success,54,22,2,11,43
30,Success,43,37,0,10,33
30,Success,47,27,4,13,34
30,Success,56,21,5,10,46
30,Success,54,18,2,13,41
30,Success,57,26,0,9,48
30,Success,49,27,0,14,35
30,Success,53,30,0,7,46
30,Success,48,26,1,15,33
30,Success,47,26,1,12,35
30,Success,48,24,7,9,39
30,Success,50,29,0,10,40
30,Fail,35,38,8,13,22
30,Success,51,25,7,11,40
30,Fail,43,29,2,16,27
30,Success,51,27,8,9,42
30,Success,48,33,0,11,37
30,Success,47,31,0,12,35
30,Fail,47,22,3,19,28
30,Success,46,29,6,13,33
30,Success,45,30,0,14,31
30,Success,49,28,0,11,38
30,Success,47,26,0,10,37
30,Success,49,24,11,11,38
30,Success,49,27,2,10,39
30,Success,51,26,3,6,45
30,Fail,38,27,11,17,21
30,Success,52,23,0,17,35
30,Success,48,27,0,14,34
30,Success,46,25,7,10,36
30,Fail,40,39,0,12,28
30,Fail,41,35,0,15,26
30,Success,53,19,3,14,39
30,Success,42,32,3,12,30
30,Success,51,20,0,16,35
30,Success,51,29,0,11,40
30,Success,41,31,5,11,30
30,Success,46,35,0,9,37
30,Fail,40,24,8,15,25
30,Success,50,34,0,9,41
30,Success,47,25,3,13,34
30,Success,50,21,6,17,33
30,Success,46,25,8,14,32
30,Success,44,38,0,9,35
30,Success,55,16,5,11,44
30,Success,45,31,1,10,35
30,Fail,35,29,12,20,15
30,Success,49,26,0,12,37
30,Fail,42,27,2,14,28
30,Success,50,28,0,10,40
30,Success,54,27,0,8,46
30,Fail,44,27,0,20,24
30,Success,45,31,0,14,31
30,Fail,42,22,9,16,26
30,Fail,44,24,11,16,28
30,Success,51,29,0,14,37
30,Success,57,18,1,9,48
30,Success,51,31,0,6,45
30,Success,47,21,8,16,31
30,Success,53,29,0,8,45
30,Success,45,33,0,14,31
30,Success,56,18,1,17,39
30,Success,51,18,0,17,34
30,Success,51,30,0,7,44
30,Success,52,26,3,14,38
30,Success,55,25,0,9,46
30,Fail,38,43,0,16,22
30,Success,56,24,0,9,47
30,Success,48,29,0,8,40
30,Success,52,26,0,15,37
30,Success,50,23,4,12,38
30,Success,45,27,4,13,32
30,Success,46,32,0,15,31
30,Fail,45,27,0,17,28
30,Fail,46,18,4,20,26
30,Success,55,22,4,12,43
30,Fail,42,33,0,16,26
30,Fail,45,18,0,23,22
30,Success,49,22,6,14,35
30,Success,46,32,0,11,35
30,Success,47,23,0,14,33
30,Success,53,25,0,8,45
30,Fail,42,30,3,17,25
30,Success,48,25,0,14,34
30,Success,51,19,6,14,37
30,Fail,43,28,8,15,28
30,Fail,41,32,0,16,25
30,Success,47,26,3,13,34
30,Success,49,25,0,15,34
30,Success,41,34,11,8,33
30,Success,43,36,8,6,37
30,Fail,44,29,0,15,29
30,Success,47,28,0,13,34
30,Success,53,22,5,10,43
30,Success,48,22,8,11,37
30,Fail,44,27,0,16,28
30,Success,52,22,2,12,40
30,Fail,39,37,0,15,24
30,Success,48,30,2,12,36
30,Success,44,35,0,10,34
30,Success,44,25,12,12,32
30,Success,52,21,0,11,41
30,Fail,45,22,5,20,25
30,Success,53,30,0,9,44
30,Fail,45,33,0,16,29
30,Success,48,28,4,12,36
30,Success,55,24,1,12,43
30,Success,52,32,0,7,45
30,Success,49,31,0,13,36
30,Success,54,30,0,7,47
30,Fail,44,26,0,24,20
30,Success,51,20,1,15,36
30,Success,48,35,0,8,40
30,Success,43,29,7,13,30
30,Success,45,30,2,7,38
30,Fail,43,28,2,18,25
30,Success,41,38,0,11,30
30,Success,49,30,0,12,37
30,Fail,40,35,0,21,19
30,Fail,43,22,9,18,25
30,Success,43,27,4,13,30
30,Fail,41,29,5,15,26
30,Success,45,25,5,15,30
30,Success,48,34,0,12,36
30,Success,48,35,0,6,42
30,Success,49,21,4,11,38
30,Fail,45,27,0,17,28
30,Success,53,27,0,10,43
30,Success,55,24,0,14,41
30,Success,47,25,6,10,37
30,Success,53,23,2,13,40
30,Success,52,26,2,9,43
30,Success,52,23,3,11,41
30,Success,47,30,0,15,32
30,Success,49,36,0,8,41
30,Success,49,30,0,10,39
30,Success,59,24,0,6,53
30,Fail,41,36,0,14,27
30,Success,47,27,3,15,32
30,Success,53,20,5,11,42
30,Success,47,30,0,14,33
30,Success,49,27,0,13,36
30,Success,46,26,5,12,34
30,Success,57,21,0,8,49
30,Fail,44,24,5,16,28
30,Fail,45,29,0,16,29
30,Success,44,30,2,14,30
30,Success,47,29,0,16,31
30,Success,49,28,0,12,37
30,Fail,45,33,0,16,29
30,Success,47,32,0,12,35
30,Success,51,28,0,11,40
30,Success,48,30,0,11,37
30,Success,53,21,2,10,43
30,Fail,44,27,4,16,28
30,Success,47,31,0,14,33
30,Success,52,22,6,12,40
30,Fail,41,29,0,18,23
30,Success,44,37,0,9,35
30,Success,46,30,0,13,33
30,Success,46,24,0,14,32
30,Fail,46,23,0,17,29
30,Success,45,27,1,12,33
30,Success,50,23,2,12,38
30,Fail,50,16,1,21,29
30,Success,51,30,0,9,42
30,Success,46,27,1,16,30
30,Success,46,33,0,10,36
30,Success,46,27,2,14,32
30,Success,46,25,0,13,33
30,Fail,45,24,0,22,23
30,Success,51,23,0,10,41
30,Success,52,29,0,11,41
30,Success,43,24,13,12,31
30,Fail,42,27,4,15,27
30,Success,51,24,0,12,39
30,Success,56,21,0,11,45
30,Success,52,27,0,12,40
30,Success,54,21,0,14,40
30,Success,51,29,0,11,40
30,Success,50,20,4,19,31
30,Fail,41,30,5,13,28
30,Success,57,23,0,12,45
30,Success,48,38,0,8,40
30,Success,48,26,1,12,36
30,Success,47,25,5,14,33
30,Fail,48,16,7,22,26
30,Success,43,34,0,10,33
30,Success,48,22,11,10,38
30,Success,51,30,0,11,40
30,Success,52,30,0,6,46
30,Success,50,26,0,11,39
30,Success,48,27,7,10,38
30,Success,52,12,8,17,35
30,Success,52,21,4,13,39
30,Fail,42,29,0,20,22
30,Success,43,36,0,13,30
30,Success,45,35,0,12,33
30,Success,48,23,7,13,35
30,Success,49,27,0,13,36
30,Success,48,24,0,14,34
30,Success,46,27,0,15,31
30,Success,50,24,1,14,36
30,Success,45,27,3,15,30
30,Success,56,25,2,7,49
30,Success,50,23,0,14,36
30,Success,47,34,0,8,39
30,Success,50,22,0,13,37
30,Success,56,21,0,12,44
30,Success,49,31,0,12,37
30,Fail,42,27,0,18,24
30,Success,46,26,0,12,34
30,Success,46,29,0,15,31
30,Fail,41,37,0,13,28
30,Success,56,23,0,13,43
30,Success,42,44,0,6,36
30,Success,52,29,0,8,44
30,Success,53,27,0,9,44
30,Success,45,33,0,14,31
30,Fail,34,36,7,17,17
30,Fail,43,29,8,14,29
30,Success,48,27,4,14,34
30,Success,49,34,0,7,42
30,Success,61,26,0,4,57
30,Success,49,21,0,15,34
30,Success,51,24,0,17,34
30,Success,45,27,5,14,31
30,Success,50,25,0,12,38
30,Success,44,34,0,13,31
30,Success,47,26,0,11,36
30,Success,49,20,3,13,36
30,Success,46,27,0,14,32
30,Success,53,29,4,5,48
30,Success,53,22,2,11,42
30,Success,47,33,0,12,35
30,Success,52,20,1,14,38
30,Success,59,18,0,16,43
30,Success,50,28,2,9,41
30,Success,45,40,0,7,38
30,Success,49,27,4,6,43
30,Success,59,19,0,11,48
30,Success,51,28,0,12,39
30,Success,44,35,0,14,30
30,Success,52,14,2,20,32
30,Success,53,28,1,7,46
30,Success,55,32,0,6,49
30,Success,50,24,0,15,35
30,Success,48,25,2,15,33
30,Success,50,29,0,13,37
30,Success,44,27,5,12,32
30,Success,50,27,0,13,37
30,Success,49,32,0,10,39
30,Success,52,25,0,10,42
30,Success,46,30,2,12,34
30,Success,48,27,2,14,34
30,Success,54,23,0,11,43
30,Success,46,29,0,15,31
30,Fail,43,25,7,14,29
30,Success,46,33,0,11,35
30,Success,51,27,1,6,45
30,Success,49,27,5,7,42
30,Success,47,27,3,13,34
30,Success,55,20,6,7,48
30,Success,45,30,0,15,30
30,Success,49,28,0,13,36
30,Success,51,23,6,12,39
30,Success,52,12,7,17,35
30,Fail,42,28,8,17,25
30,Fail,41,33,0,12,29
30,Success,47,21,6,13,34
30,Success,63,18,0,9,54
30,Success,56,13,8,12,44
30,Success,43,29,10,11,32
30,Success,46,37,0,10,36
30,Success,53,18,11,12,41
30,Success,49,28,5,8,41
30,Success,55,22,0,10,45
30,Success,49,24,0,12,37
30,Success,47,28,2,12,35
30,Success,45,29,1,15,30
30,Success,49,17,5,15,34
30,Success,46,29,4,11,35
30,Success,45,25,0,15,30
30,Fail,48,19,4,19,29
30,Success,46,28,6,12,34
30,Success,49,33,0,8,41
30,Success,49,24,6,9,40
30,Success,56,25,0,11,45
30,Success,43,37,0,9,34
30,Success,45,31,4,10,35
30,Success,45,28,7,14,31
30,Success,54,26,0,11,43
30,Success,49,26,4,11,38
30,Success,47,20,7,14,33
30,Fail,40,40,0,13,27
30,Success,51,27,1,10,41
30,Fail,38,38,0,20,18
30,Success,51,26,5,10,41
30,Fail,40,35,0,15,25
30,Success,50,29,0,12,38
30,Success,49,25,0,15,34
30,Success,50,24,0,15,35
30,Success,50,27,1,10,40
30,Success,49,31,2,10,39
30,Success,52,33,0,10,42
30,Success,57,23,0,3,54
30,Fail,42,33,3,14,28
30,Fail,46,19,5,21,25
30,Success,51,22,3,12,39
30,Success,51,23,0,14,37
30,Fail,44,26,0,20,24
30,Fail,44,21,0,20,24
30,Fail,40,28,0,19,21
30,Fail,46,22,1,20,26
30,Success,43,34,0,12,31
30,Success,46,28,2,13,33
30,Success,50,33,0,9,41
30,Success,47,25,1,16,31
30,Success,45,35,0,7,38
30,Success,49,23,3,15,34
30,Success,47,24,0,17,30
30,Fail,50,20,0,22,28
30,Fail,45,28,0,19,26
30,Success,48,28,3,12,36
30,Success,51,25,0,11,40
30,Success,55,19,0,15,40
30,Success,44,29,0,14,30
30,Success,45,25,6,10,35
30,Success,43,30,5,11,32
30,Success,54,27,0,11,43
30,Success,57,18,0,10,47
30,Success,50,18,4,16,34
30,Fail,44,30,0,20,24
30,Success,49,25,9,8,41
30,Success,46,24,10,10,36
30,Fail,39,41,0,13,26
30,Success,51,28,0,10,41
30,Success,49,21,2,18,31
30,Success,49,28,0,13,36
30,Success,50,21,0,20,30
30,Success,56,19,0,14,42
30,Success,47,33,0,12,35
30,Success,53,25,6,9,44
30,Success,52,18,1,19,33
30,Fail,42,27,6,16,26
30,Success,52,24,5,10,42
30,Success,49,24,3,12,37
30,Success,42,38,0,10,32
30,Success,48,28,0,14,34
30,Success,45,23,1,12,33
30,Success,60,18,0,13,47
30,Success,51,28,0,11,40
30,Success,47,22,0,17,30
30,Success,54,25,0,12,42
30,Success,48,28,4,13,35
30,Success,47,25,5,13,34
30,Success,49,28,0,12,37
30,Success,45,31,0,12,33
30,Success,48,21,0,15,33
30,Success,50,18,1,16,34
30,Success,47,27,5,12,35
30,Success,50,30,0,9,41
30,Success,51,22,0,13,38
30,Success,51,26,0,11,40
30,Fail,40,39,0,15,25
30,Success,48,29,3,11,37
30,Fail,40,31,3,16,24
30,Success,48,31,0,10,38
30,Success,54,23,0,7,47
30,Fail,38,45,0,12,26
30,Fail,47,20,1,19,28
30,Fail,42,31,0,17,25
30,Success,57,20,5,7,50
30,Success,52,24,0,11,41
30,Success,53,22,2,13,40
30,Success,57,20,1,8,49
30,Success,56,23,6,7,49
30,Success,43,27,2,13,30
30,Success,47,24,0,16,31
30,Fail,42,34,0,14,28
30,Success,49,27,6,14,35
30,Fail,42,35,4,13,29
30,Success,52,31,0,8,44
30,Success,49,26,0,12,37
30,Success,49,18,8,17,32
30,Success,47,29,8,5,42
30,Fail,36,29,10,15,21
30,Success,42,39,0,12,30
30,Success,46,26,0,14,32
30,Success,50,29,0,10,40
30,Success,55,23,0,9,46
30,Success,49,23,0,17,32
30,Success,50,25,5,8,42
30,Success,54,20,0,14,40
30,Success,51,25,0,13,38
30,Success,54,26,0,13,41
30,Fail,40,24,6,20,20
30,Success,49,27,2,10,39
30,Success,56,27,0,7,49
30,Fail,44,25,7,15,29
30,Success,48,24,1,14,34
30,Success,57,19,2,13,44
30,Success,47,28,0,13,34
30,Success,52,26,7,8,44
30,Success,47,26,5,14,33
30,Success,53,25,2,9,44
30,Success,54,23,0,12,42
30,Success,48,25,5,10,38
30,Success,42,34,0,11,31
30,Success,45,38,0,8,37
30,Success,53,20,0,12,41
30,Fail,46,24,2,19,27
30,Success,50,27,0,7,43
30,Fail,46,32,0,18,28
30,Fail,47,20,2,21,26
30,Success,52,23,2,9,43
30,Success,61,17,0,8,53
30,Success,54,26,4,7,47
30,Fail,43,31,0,19,24
30,Success,48,19,0,16,32
30,Success,56,18,1,13,43
30,Success,47,28,5,12,35
30,Success,52,25,3,11,41
30,Success,57,17,1,12,45
30,Success,46,29,0,14,32
30,Success,52,31,1,7,45
30,Success,54,21,3,9,45
30,Fail,43,23,0,23,20
30,Success,45,35,0,12,33
30,Fail,45,29,0,17,28
30,Fail,40,27,9,17,23
30,Success,51,21,2,13,38
30,Success,55,18,0,12,43
30,Success,46,22,1,16,30
30,Success,47,23,7,13,34
30,Success,46,27,0,16,30
30,Success,51,27,3,10,41
30,Success,49,26,0,9,40
30,Fail,40,34,0,14,26
30,Success,51,33,0,5,46
30,Success,45,32,0,13,32
30,Success,49,26,0,13,36
30,Fail,40,29,0,21,19
30,Success,47,28,6,11,36
30,Success,49,27,0,11,38
30,Success,45,28,0,13,32
30,Success,53,27,0,7,46
30,Success,46,25,4,14,32
30,Success,55,20,7,10,45
30,Fail,43,29,0,17,26
30,Success,48,29,7,10,38
30,Success,46,32,0,12,34
30,Success,49,32,0,10,39
30,Success,50,17,3,14,36
30,Fail,42,32,0,15,27
30,Fail,41,39,0,12,29
30,Success,56,22,1,11,45
30,Success,48,27,0,13,35
30,Fail,39,23,12,19,20
30,Fail,35,36,5,17,18
30,Success,49,21,1,13,36
30,Success,60,20,0,8,52
30,Success,44,40,0,10,34
30,Success,52,23,2,9,43
30,Success,55,20,1,14,41
30,Success,54,27,0,8,46
30,Success,48,26,0,13,35
30,Fail,42,31,7,13,29
30,Fail,43,25,7,14,29
30,Success,47,28,1,11,36
30,Fail,43,27,4,16,27
30,Success,49,25,0,14,35
30,Success,47,33,3,8,39
30,Success,47,26,0,15,32
30,Success,47,22,3,16,31
30,Success,52,22,0,18,34
30,Success,48,24,3,10,38
30,Success,47,29,0,10,37
30,Success,49,25,0,17,32
30,Success,44,38,0,11,33
30,Success,51,27,0,13,38
30,Fail,46,22,6,17,29
30,Success,49,33,0,5,44
30,Fail,47,20,4,18,29
30,Success,54,26,0,9,45
30,Success,49,24,4,14,35
30,Success,58,19,2,11,47
30,Success,53,21,4,13,40
30,Success,51,22,4,15,36
30,Success,48,22,0,17,31
30,Fail,42,28,0,18,24
30,Success,51,35,0,7,44
30,Success,49,22,0,15,34
30,Success,48,21,3,11,37
30,Success,52,25,0,13,39
30,Success,48,31,0,14,34
30,Success,43,42,0,9,34
30,Success,49,27,0,14,35
30,Fail,41,35,0,17,24
30,Success,50,25,4,12,38
30,Success,52,20,2,12,40
30,Fail,45,28,1,17,28
30,Success,52,28,0,8,44
30,Success,41,36,0,11,30
30,Success,54,23,2,10,44
30,Success,52,21,9,9,43
30,Success,47,25,2,9,38
30,Success,51,23,0,17,34
30,Success,48,24,7,11,37
30,Success,52,28,0,9,43
30,Success,53,23,0,12,41
30,Fail,32,43,0,17,15
30,Success,45,36,0,9,36
30,Success,47,36,0,10,37
30,Success,51,22,3,9,42
30,Success,52,25,0,13,39
30,Success,51,30,0,10,41
30,Success,50,23,2,14,36
30,Success,57,16,0,17,40
30,Success,53,29,0,7,46
30,Success,53,16,7,13,40
30,Success,57,20,4,7,50
30,Success,59,17,0,16,43
30,Success,56,17,1,14,42
30,Success,45,20,9,15,30
30,Success,48,24,0,16,32
30,Fail,43,30,1,14,29
30,Success,55,25,4,6,49
30,Success,47,20,4,13,34
30,Success,45,34,0,14,31
30,Fail,41,27,9,12,29
30,Success,48,26,0,12,36
30,Fail,44,29,6,15,29
30,Success,51,26,0,13,38
30,Success,53,24,5,9,44
30,Fail,43,23,9,15,28
30,Success,53,26,0,11,42
30,Success,50,26,0,12,38
30,Success,47,20,11,14,33
30,Success,47,27,5,15,32
30,Success,49,25,0,13,36
30,Success,45,30,0,14,31
30,Success,50,20,1,15,35
30,Success,47,31,0,13,34
30,Fail,44,33,0,15,29
30,Success,58,18,2,7,51
30,Success,47,26,0,15,32
30,Success,52,20,5,11,41
30,Fail,46,22,5,18,28
30,Fail,36,38,0,17,19
30,Fail,44,25,8,16,28
30,Success,53,21,0,14,39
30,Success,49,26,0,13,36
30,Success,50,25,0,12,38
30,Success,54,21,0,11,43
30,Success,48,27,0,9,39
30,Success,46,32,0,10,36
30,Fail,43,32,0,15,28
30,Success,47,28,0,17,30
30,Success,45,26,0,15,30
30,Success,48,27,3,13,35
30,Success,52,16,1,18,34
30,Success,49,28,10,7,42
30,Success,60,25,0,5,55
30,Success,56,23,0,9,47
30,Success,51,26,0,13,38
30,Success,50,27,2,11,39
30,Success,56,16,1,14,42
30,Fail,43,26,4,15,28
30,Success,43,29,11,9,34
30,Success,45,34,3,8,37
30,Success,50,22,7,9,41
30,Success,55,26,0,6,49
30,Success,53,24,3,11,42
30,Success,50,30,0,15,35
30,Success,49,28,0,12,37
30,Success,49,36,0,9,40
30,Fail,44,32,0,15,29
30,Success,55,29,0,7,48
30,Success,48,26,2,14,34
30,Success,53,22,0,17,36
30,Fail,41,35,0,14,27
30,Success,46,28,5,11,35
30,Success,48,32,0,11,37
30,Success,53,28,4,5,48
30,Fail,41,28,1,22,19
30,Success,42,42,0,7,35
30,Success,54,22,0,15,39
30,Success,43,29,0,13,30
30,Fail,44,32,0,17,27
30,Success,60,16,5,10,50
30,Success,45,25,6,14,31
30,Success,43,35,0,12,31
30,Fail,46,26,2,18,28
30,Success,47,24,1,10,37
30,Success,49,26,2,11,38
30,Success,46,31,0,15,31
30,Success,51,27,0,13,38
30,Success,50,21,4,9,41
30,Success,51,27,0,11,40
30,Success,50,23,2,13,37
30,Success,46,26,7,10,36
30,Success,55,26,4,10,45
30,Success,49,21,0,15,34
30,Success,45,28,4,13,32
30,Fail,44,23,3,17,27
30,Fail,46,31,0,17,29
30,Success,48,26,0,12,36
30,Success,47,22,7,13,34
30,Fail,41,28,8,16,25
30,Success,50,30,1,10,40
30,Success,47,27,0,16,31
30,Success,45,29,1,12,33
30,Success,47,31,0,14,33
30,Success,54,22,0,10,44
30,Success,47,27,4,11,36
30,Success,52,25,0,9,43
30,Success,48,23,6,14,34
30,Success,47,27,7,10,37
30,Success,54,16,6,13,41
30,Success,51,23,3,13,38
30,Success,44,36,0,11,33
30,Fail,37,30,9,12,25
30,Success,53,22,0,14,39
30,Fail,44,32,0,16,28
30,Success,48,30,0,12,36
30,Success,48,28,2,11,37
30,Success,44,29,0,14,30
30,Fail,44,33,0,16,28
30,Fail,44,25,7,16,28
30,Success,44,31,4,12,32
30,Success,49,35,1,7,42
30,Success,50,23,4,14,36
30,Success,52,23,0,11,41
30,Fail,41,32,3,16,25
30,Success,46,28,0,13,33
30,Success,49,25,1,14,35
30,Success,56,19,0,12,44
30,Success,51,20,0,20,31
30,Success,48,30,0,13,35
30,Success,50,25,0,11,39
30,Success,47,26,0,17,30
30,Success,50,19,4,19,31
30,Success,54,14,10,11,43
30,Success,46,26,6,12,34
30,Success,52,19,8,10,42
30,Success,46,31,0,15,31
30,Fail,44,24,5,18,26
30,Success,54,30,0,8,46
30,Success,47,25,5,16,31
30,Fail,41,27,6,16,25
30,Success,45,32,0,11,34
30,Success,48,25,6,13,35
30,Success,47,30,0,11,36
30,Success,52,28,0,10,42
30,Success,46,27,0,16,30
30,Success,51,29,0,8,43
30,Success,47,31,0,12,35
30,Success,45,22,10,15,30
30,Success,47,27,1,15,32
30,Success,48,25,0,16,32
30,Success,49,22,0,17,32
30,Success,47,27,0,14,33
30,Success,54,21,0,10,44
30,Success,48,25,8,11,37
30,Success,45,31,5,8,37
30,Fail,44,33,0,16,28
30,Success,49,30,7,7,42
30,Success,56,21,1,10,46
30,Success,42,32,3,11,31
30,Success,48,31,1,9,39
30,Success,50,30,3,5,45
30,Fail,43,25,3,16,27
30,Success,50,25,0,14,36
30,Success,52,31,0,8,44
30,Success,44,31,7,10,34
30,Success,54,22,3,11,43
30,Success,61,17,4,8,53
30,Success,51,28,0,11,40
30,Success,52,20,3,9,43
30,Success,50,29,0,11,39
30,Fail,45,28,0,16,29
30,Success,48,29,3,6,42
30,Success,44,37,0,9,35
30,Fail,45,27,0,18,27
30,Fail,42,38,0,15,27
30,Success,58,15,4,12,46
30,Fail,38,30,0,23,15
30,Success,55,18,0,11,44
30,Fail,44,28,4,15,29
30,Success,53,32,0,6,47
30,Fail,43,21,9,16,27
30,Success,53,18,1,15,38
30,Success,47,32,0,10,37
30,Fail,44,22,8,19,25
30,Success,46,30,0,13,33
30,Success,48,31,0,12,36
30,Success,51,22,3,12,39
30,Fail,43,25,9,16,27
30,Success,48,30,0,12,36
30,Fail,44,29,0,17,27
30,Success,52,21,5,8,44
30,Success,51,29,0,11,40
30,Success,45,31,0,13,32
30,Success,51,22,3,14,37
30,Success,46,32,0,15,31
30,Fail,41,20,13,17,24
30,Success,51,26,0,14,37
30,Success,58,23,0,8,50
30,Success,52,29,0,10,42
30,Success,57,21,4,10,47
30,Success,47,27,6,11,36
30,Success,46,31,0,12,34
30,Success,51,26,0,11,40
30,Fail,43,22,7,17,26
30,Success,49,27,2,10,39
30,Success,46,29,5,9,37
30,Success,50,31,0,12,38
30,Success,48,31,0,15,33
30,Fail,44,25,0,18,26
30,Success,56,25,0,7,49
30,Success,47,26,1,15,32
30,Success,52,22,8,8,44
30,Success,47,26,0,17,30
30,Success,49,26,0,12,37
30,Success,49,27,0,12,37
30,Success,49,29,0,11,38
30,Success,50,30,0,11,39
30,Fail,44,24,0,19,25
30,Success,47,30,0,12,35
30,Success,51,25,2,12,39
30,Success,45,30,1,13,32
30,Success,45,25,8,13,32
30,Success,47,23,3,15,32
30,Success,48,32,3,8,40
30,Success,47,29,0,16,31
30,Success,51,22,0,14,37
30,Success,43,26,15,10,33
30,Fail,43,28,0,17,26
30,Success,55,22,0,13,42
30,Success,41,34,5,11,30
30,Success,52,29,0,9,43
30,Success,53,18,2,16,37
30,Success,53,23,1,12,41
30,Fail,40,38,0,12,28
30,Success,53,24,0,14,39
30,Success,52,32,0,6,46
30,Success,52,18,3,18,34
30,Success,46,39,0,10,36
30,Success,45,32,0,10,35
30,Success,48,25,0,12,36
30,Success,44,33,6,12,32
30,Success,53,26,1,10,43
30,Success,49,29,0,10,39
30,Success,48,25,1,15,33
30,Success,50,29,0,11,39
30,Success,48,27,4,10,38
30,Fail,40,35,3,14,26
30,Success,48,28,0,13,35
30,Success,47,23,7,12,35
30,Success,48,20,7,18,30
30,Success,51,26,1,12,39
30,Success,54,22,4,10,44
30,Success,52,22,4,10,42
30,Fail,45,22,2,18,27
30,Fail,38,29,6,16,22
30,Success,52,24,0,10,42
30,Success,47,30,0,13,34
30,Fail,45,29,1,16,29
30,Success,50,28,0,9,41
30,Fail,41,43,0,12,29
30,Success,48,29,0,17,31
30,Success,51,28,0,11,40
30,Success,51,21,5,14,37
30,Success,52,27,0,13,39
30,Success,47,28,0,13,34
30,Success,49,24,0,18,31
30,Success,51,21,4,15,36
30,Success,50,27,0,12,38
30,Success,47,32,4,12,35
30,Success,51,23,2,15,36
30,Success,44,23,10,14,30
30,Success,47,24,5,14,33
30,Success,47,33,0,10,37
30,Success,44,29,3,14,30
30,Fail,39,27,10,11,28
30,Success,53,23,0,10,43
30,Success,47,29,0,15,32
30,Success,48,29,0,11,37
30,Success,51,36,0,7,44
30,Fail,45,24,7,21,24
30,Success,45,31,0,14,31
30,Fail,41,28,6,14,27
30,Success,46,28,0,15,31
30,Success,54,19,5,12,42
30,Success,49,31,3,6,43
30,Fail,35,37,6,16,19
30,Success,52,21,0,18,34
30,Success,44,35,0,9,35
30,Success,48,28,0,10,38
30,Success,53,28,0,10,43
30,Success,48,28,0,16,32
30,Success,47,31,0,11,36
30,Fail,35,37,4,14,21
30,Success,45,26,8,10,35
30,Success,46,26,9,8,38
30,Success,52,19,2,16,36
30,Success,50,22,0,17,33
30,Success,51,22,1,11,40
30,Success,49,27,4,12,37
30,Success,46,28,8,7,39
30,Success,53,28,0,7,46
30,Success,50,25,0,11,39
30,Success,50,18,0,17,33
30,Success,55,23,0,11,44
30,Success,49,28,0,13,36
30,Success,50,25,1,10,40
30,Success,45,27,0,14,31
30,Success,56,20,0,12,44
30,Success,54,24,0,7,47
30,Success,52,21,5,13,39
30,Fail,48,20,1,20,28
30,Success,46,24,4,15,31
30,Success,50,31,0,11,39
30,Fail,39,35,0,16,23
30,Success,52,23,1,14,38
30,Success,48,32,0,8,40
30,Success,51,24,6,10,41
30,Success,47,26,0,17,30
30,Success,51,19,1,21,30
30,Success,49,23,1,14,35
30,Fail,37,27,8,21,16
30,Fail,42,21,6,21,21
30,Fail,40,27,3,21,19
30,Fail,39,41,0,10,29
30,Success,46,24,4,15,31
30,Fail,43,30,0,15,28
30,Success,50,30,0,14,36
30,Success,46,31,1,12,34
30,Success,55,16,5,12,43
30,Success,51,21,3,11,40
30,Success,46,25,3,15,31
30,Success,54,20,1,14,40
30,Fail,41,35,0,17,24
30,Success,42,34,0,12,30
30,Success,49,26,0,13,36
30,Success,50,26,5,8,42
30,Fail,42,40,0,14,28
30,Success,57,21,0,6,51
30,Fail,46,28,0,19,27
30,Success,49,23,6,12,37
30,Success,48,25,10,11,37
30,Success,46,31,0,13,33
30,Success,44,29,3,12,32
30,Success,52,18,5,12,40
30,Success,56,26,3,9,47
30,Success,52,24,1,9,43
30,Success,49,26,0,16,33
30,Success,49,29,0,13,36
30,Success,48,36,0,8,40
30,Success,48,26,2,15,33
30,Success,57,30,0,7,50
30,Success,51,27,0,13,38
30,Success,51,26,5,8,43
30,Success,52,19,0,15,37
30,Success,60,17,3,6,54
30,Success,51,23,0,12,39
30,Success,45,38,0,8,37
30,Success,47,32,0,8,39
30,Success,51,23,7,11,40
30,Success,53,20,6,9,44
30,Success,53,22,2,11,42
30,Success,45,30,1,12,33
30,Success,51,25,0,11,40
30,Success,51,22,4,14,37
30,Success,49,31,0,11,38
30,Fail,44,31,0,15,29
30,Success,47,26,0,14,33
30,Fail,46,24,0,17,29
30,Success,51,28,0,11,40
30,Success,48,25,2,11,37
30,Fail,41,34,3,13,28
30,Success,47,30,0,13,34
30,Success,49,26,0,11,38
30,Success,50,25,1,13,37
30,Fail,44,27,1,18,26
30,Success,51,24,7,5,46
30,Success,47,26,3,14,33
30,Fail,44,28,0,15,29
30,Success,42,40,0,10,32
30,Success,52,22,4,11,41
30,Success,47,29,1,13,34
30,Success,48,27,1,13,35
30,Fail,47,19,1,20,27
30,Success,51,21,7,10,41
30,Success,52,23,0,11,41
30,Success,50,16,0,19,31
30,Fail,42,28,7,16,26
30,Success,51,21,0,12,39
30,Success,42,33,3,11,31
30,Fail,42,28,3,14,28
30,Success,49,28,0,9,40
30,Success,46,29,0,16,30
30,Success,44,29,4,13,31
30,Success,47,25,3,12,35
30,Fail,45,23,9,16,29
30,Success,49,20,3,16,33
30,Success,53,26,0,12,41
30,Success,45,35,0,10,35
30,Success,48,30,0,11,37
30,Success,48,22,2,13,35
30,Success,49,30,3,8,41
30,Success,57,30,0,3,54
30,Fail,42,30,2,17,25
30,Fail,41,30,5,13,28
30,Success,55,19,2,12,43
30,Success,46,25,5,11,35
30,Success,45,32,0,12,33
30,Success,53,22,0,12,41
30,Success,49,26,2,12,37
30,Fail,43,26,0,22,21
30,Success,53,23,0,11,42
30,Success,51,26,4,11,40
30,Success,51,30,0,9,42
30,Success,48,33,0,10,38
30,Success,46,30,0,12,34
30,Success,55,19,5,8,47
30,Fail,35,35,5,16,19
30,Success,49,23,0,13,36
30,Fail,47,25,0,19,28
30,Success,46,27,5,10,36
30,Success,50,25,4,11,39
30,Success,47,33,0,8,39
30,Success,44,27,8,14,30
30,Success,47,26,2,15,32
30,Success,46,28,5,12,34
30,Success,46,28,5,10,36
30,Fail,44,28,1,15,29
30,Success,48,25,4,10,38
30,Success,52,23,0,18,34
30,Success,44,30,4,13,31
30,Success,46,31,0,14,32
30,Success,43,37,0,9,34
30,Success,52,29,0,10,42
30,Success,61,19,0,8,53
30,Success,49,29,2,11,38
30,Fail,39,41,0,14,25
30,Success,47,28,8,8,39
30,Success,45,29,0,14,31
30,Success,49,19,7,16,33
30,Success,46,28,4,14,32
30,Success,51,33,0,10,41
30,Success,56,17,6,14,42
30,Success,46,29,4,11,35
30,Success,46,29,3,13,33
30,Success,45,37,0,11,34
30,Fail,36,32,13,13,23
30,Success,59,23,0,9,50
30,Fail,43,30,2,17,26
30,Success,56,23,0,11,45
30,Success,48,22,3,16,32
30,Fail,41,27,6,15,26
30,Success,53,27,0,11,42
30,Success,54,20,0,12,42
30,Success,52,25,3,10,42
30,Success,50,25,10,10,40
30,Success,46,37,0,12,34
30,Success,48,31,0,12,36
30,Success,53,26,2,10,43
30,Success,53,25,0,8,45
30,Success,51,22,10,10,41
30,Success,48,29,0,13,35
30,Fail,43,24,0,18,25
30,Success,49,24,4,12,37
30,Success,49,29,0,12,37
30,Success,53,23,2,12,41
30,Success,42,32,6,12,30
30,Success,49,28,0,10,39
30,Success,51,28,0,10,41
30,Success,57,27,0,7,50
30,Success,48,24,5,14,34
30,Fail,42,38,0,13,29
30,Success,48,28,0,13,35
30,Fail,38,28,8,16,22
30,Success,51,28,0,9,42
30,Success,49,21,5,13,36
30,Success,44,33,0,13,31
30,Success,47,28,0,10,37
30,Success,46,32,0,11,35
30,Fail,41,35,0,15,26
30,Fail,44,33,0,15,29
30,Success,51,25,6,10,41
30,Success,39,40,0,8,31
30,Success,54,23,0,11,43
30,Success,50,29,2,10,40
30,Fail,42,25,0,19,23
30,Fail,42,32,0,17,25
30,Success,46,29,2,14,32
30,Fail,45,26,4,18,27
30,Success,56,24,0,7,49
30,Fail,39,28,4,18,21
30,Fail,45,29,4,16,29
30,Success,50,24,0,13,37
30,Success,46,31,0,12,34
30,Success,44,33,7,8,36
30,Success,53,22,0,15,38
30,Success,48,27,2,14,34
30,Success,47,27,2,8,39
30,Success,55,20,0,14,41
30,Fail,46,24,3,17,29
30,Success,44,31,0,13,31
30,Success,51,23,0,18,33
30,Success,49,29,0,14,35
30,Success,49,26,8,8,41
30,Success,52,28,2,9,43
30,Success,50,26,0,10,40
30,Success,51,26,0,13,38
30,Success,50,26,0,13,37
30,Success,42,26,7,12,30
30,Fail,41,31,0,15,26
30,Success,51,20,1,16,35
30,Success,47,37,0,7,40
30,Success,44,32,1,12,32
30,Success,47,27,0,14,33
30,Success,57,17,5,13,44
30,Success,49,25,2,9,40
30,Fail,44,30,0,16,28
30,Success,56,20,1,8,48
30,Success,49,25,0,12,37
30,Success,50,28,0,10,40
30,Success,50,17,0,20,30
30,Success,52,23,0,13,39
30,Success,50,25,3,11,39
30,Success,48,25,0,15,33
30,Fail,41,36,0,16,25
30,Success,46,27,2,13,33
30,Success,50,31,0,8,42
30,Success,44,29,6,13,31
30,Success,43,33,0,13,30
30,Fail,41,36,0,13,28
30,Success,50,22,0,15,35
30,Fail,39,39,0,10,29
30,Success,42,39,5,7,35
30,Fail,46,26,2,17,29
30,Success,48,25,0,15,33
30,Success,50,22,2,14,36
30,Success,54,20,4,10,44
30,Success,47,29,0,13,34
30,Fail,40,39,0,13,27
30,Fail,46,20,0,20,26
30,Fail,42,23,10,16,26
30,Success,49,21,0,17,32
30,Fail,43,30,0,15,28
30,Success,54,22,1,14,40
30,Success,45,24,7,13,32
30,Success,46,26,1,15,31
30,Fail,39,29,11,13,26
30,Success,54,19,0,15,39
30,Success,50,32,0,10,40
30,Success,45,34,0,14,31
30,Success,48,30,7,8,40
30,Success,46,28,4,11,35
30,Success,48,24,2,11,37
30,Success,47,32,0,13,34
30,Fail,41,36,0,15,26
30,Success,46,21,2,16,30
30,Success,45,27,2,15,30
30,Success,54,20,2,13,41
30,Fail,42,27,0,21,21
30,Success,43,31,4,12,31
30,Fail,40,27,5,17,23
30,Success,45,25,8,14,31
30,Success,43,24,12,11,32
30,Success,54,24,0,9,45
30,Success,45,23,7,14,31
30,Fail,42,27,5,18,24
30,Success,42,38,0,11,31
30,Fail,40,31,0,17,23
30,Success,46,34,0,12,34
30,Success,54,21,0,12,42
30,Fail,44,14,9,24,20
30,Fail,43,30,0,17,26
30,Fail,40,39,0,13,27
30,Success,48,24,11,10,38
30,Success,55,20,2,9,46
30,Success,55,29,0,9,46
30,Success,48,24,1,15,33
30,Success,56,21,0,13,43
30,Fail,39,36,0,16,23
30,Fail,43,24,13,15,28
30,Fail,40,35,0,11,29
30,Success,50,25,6,10,40
30,Success,53,16,0,21,32
30,Fail,38,37,0,19,19
30,Success,44,32,0,11,33
30,Success,50,21,3,14,36
30,Success,51,29,0,11,40
30,Fail,41,37,0,17,24
30,Success,48,23,10,11,37
30,Success,48,28,1,10,38
30,Success,45,33,0,13,32
30,Success,51,31,7,3,48
30,Success,45,28,7,15,30
30,Fail,46,22,0,20,26
30,Success,45,29,3,13,32
30,Fail,45,21,7,18,27
30,Success,45,22,10,13,32
30,Fail,46,22,1,21,25
30,Success,53,17,1,14,39
30,Success,47,22,4,15,32
30,Fail,42,28,7,13,29
30,Fail,41,30,4,16,25
30,Success,51,24,0,14,37
30,Success,44,32,0,12,32
30,Success,46,29,3,10,36
30,Success,56,25,0,14,42
30,Success,47,28,3,12,35
30,Success,45,29,3,13,32
30,Fail,38,36,0,15,23
30,Success,42,34,0,12,30
30,Success,44,40,0,9,35
30,Success,49,26,6,13,36
30,Success,47,35,1,8,39
30,Success,49,26,1,13,36
30,Success,52,20,7,12,40
30,Success,57,17,0,15,42
30,Success,53,18,2,11,42
30,Success,54,27,3,8,46
30,Success,51,21,10,10,41
30,Success,52,21,0,16,36
30,Success,52,26,0,11,41
30,Success,61,16,1,12,49
30,Success,56,31,0,7,49
30,Fail,46,26,5,17,29
30,Success,48,34,0,12,36
30,Success,52,21,6,9,43
30,Success,50,28,4,9,41
30,Success,44,32,0,13,31
30,Success,45,28,3,14,31
30,Success,46,30,0,15,31
30,Success,47,21,2,16,31
30,Success,55,14,7,16,39
30,Success,44,35,0,12,32
30,Fail,36,41,0,16,20
30,Success,55,24,0,11,44
30,Success,53,24,0,11,42
30,Success,53,20,0,15,38
30,Success,47,26,6,11,36
30,Success,48,28,0,10,38
30,Success,45,32,0,11,34
30,Success,48,29,0,10,38
30,Success,60,19,0,10,50
30,Fail,37,38,0,16,21
30,Success,52,24,0,11,41
30,Success,44,34,0,13,31
30,Success,46,32,0,12,34
30,Success,54,22,0,9,45
30,Success,46,32,0,11,35
30,Success,51,22,0,13,38
30,Success,48,30,0,12,36
30,Success,50,18,3,16,34
30,Success,47,24,7,14,33
30,Success,45,34,0,12,33
30,Success,57,19,2,9,48
30,Success,47,26,6,9,38
30,Success,49,22,7,8,41
30,Success,44,35,0,13,31
30,Success,51,29,0,12,39
30,Success,54,22,0,16,38
30,Success,48,29,0,11,37
30,Fail,37,43,0,11,26
30,Success,58,19,2,10,48
30,Success,49,24,2,13,36
30,Success,57,17,1,13,44
30,Success,48,25,5,11,37
30,Success,47,27,1,15,32
30,Success,47,22,0,15,32
30,Success,48,29,0,14,34
30,Success,47,34,0,11,36
30,Success,44,33,0,12,32
30,Success,51,21,0,15,36
30,Success,49,18,6,17,32
30,Success,52,26,0,9,43
30,Success,56,21,0,14,42
30,Success,51,25,0,15,36
30,Success,48,23,0,18,30
30,Success,54,27,0,7,47
30,Success,44,34,3,14,30
30,Fail,47,20,0,20,27
30,Success,51,25,1,12,39
30,Success,50,23,0,17,33
30,Success,46,33,0,15,31
30,Fail,43,25,7,19,24
30,Fail,36,29,8,18,18
30,Fail,46,28,0,17,29
30,Fail,45,30,0,17,28
30,Success,42,33,0,11,31
30,Success,49,26,0,13,36
30,Fail,44,26,0,17,27
30,Success,49,28,0,12,37
30,Success,54,23,4,11,43
30,Success,45,32,0,12,33
30,Success,48,35,0,9,39
30,Success,51,33,0,7,44
30,Success,54,30,0,8,46
30,Success,49,26,0,17,32
30,Success,55,20,1,12,43
30,Fail,45,27,2,17,28
30,Success,48,27,0,15,33
30,Fail,42,31,0,15,27
30,Success,50,20,6,13,37
30,Success,44,37,0,12,32
30,Success,51,33,0,11,40
30,Fail,46,24,1,17,29
30,Success,53,23,0,13,40
30,Success,48,36,0,10,38
30,Success,49,33,0,9,40
30,Success,54,20,3,15,39
30,Fail,47,23,4,20,27
30,Success,46,23,3,15,31
30,Fail,46,24,1,17,29
30,Success,48,29,0,9,39
30,Fail,43,32,0,15,28
30,Success,42,37,0,10,32
30,Fail,41,33,6,12,29
30,Fail,36,20,14,21,15
30,Fail,40,35,0,14,26
30,Success,47,30,0,8,39
30,Success,55,18,2,12,43
30,Success,52,29,0,9,43
30,Success,51,21,1,16,35
30,Success,49,26,0,12,37
30,Fail,40,39,0,12,28
30,Success,46,23,4,11,35
30,Success,46,35,0,12,34
30,Fail,41,23,12,16,25
30,Success,55,25,0,8,47
30,Success,47,27,2,13,34
30,Success,48,29,5,9,39
30,Success,49,25,5,11,38
30,Success,49,28,0,11,38
30,Fail,40,33,0,16,24
30,Success,52,25,0,12,40
30,Success,47,25,4,12,35
30,Success,45,30,0,13,32
30,Success,43,29,5,11,32
30,Success,50,28,0,8,42
30,Success,44,30,0,10,34
30,Success,42,34,9,8,34
30,Fail,46,26,0,17,29
30,Success,47,30,0,11,36
30,Success,45,36,0,12,33
30,Fail,39,37,0,13,26
30,Success,52,32,0,7,45
30,Success,43,32,6,13,30
30,Success,58,17,0,11,47
30,Success,48,32,0,13,35
30,Success,48,18,1,18,30
30,Success,47,27,9,10,37
30,Fail,45,25,2,18,27
30,Success,48,26,7,11,37
30,Success,46,30,0,9,37
30,Success,45,25,0,15,30
30,Success,50,26,2,11,39
30,Success,55,24,2,10,45
30,Fail,44,25,4,17,27
30,Success,51,25,0,14,37
30,Success,50,24,1,14,36
30,Fail,45,28,0,16,29
30,Fail,45,26,1,17,28
30,Success,47,29,0,14,33
30,Fail,45,30,0,16,29
30,Success,44,34,0,9,35
30,Success,53,23,0,12,41
30,Success,56,21,2,12,44
30,Success,50,22,2,13,37
30,Success,50,23,1,13,37
30,Success,45,31,0,15,30
30,Success,54,24,0,11,43
30,Success,46,31,0,11,35
30,Success,53,31,0,7,46
30,Success,50,34,0,7,43
30,Success,44,32,0,14,30
30,Success,48,29,0,13,35
30,Success,43,31,8,10,33
30,Success,49,23,3,13,36
30,Success,44,32,0,10,34
30,Success,55,19,3,14,41
30,Success,56,19,4,10,46
30,Fail,39,37,7,12,27
30,Fail,44,28,3,15,29
30,Success,55,14,9,13,42
30,Success,51,22,2,12,39
30,Fail,42,24,14,15,27
30,Success,52,21,4,10,42
30,Success,48,25,2,12,36
30,Success,48,26,3,16,32
30,Success,54,24,0,14,40
30,Success,53,22,3,12,41
30,Success,46,29,0,12,34
30,Fail,42,32,4,13,29
30,Success,55,28,0,7,48
30,Success,43,30,4,12,31
30,Success,53,23,1,14,39
30,Success,46,34,0,8,38
30,Success,58,23,4,6,52
30,Fail,42,25,7,17,25
30,Success,52,19,2,13,39
30,Success,53,26,0,9,44
30,Success,52,28,0,13,39
30,Success,52,22,0,11,41
30,Fail,38,34,6,15,23
30,Success,53,25,0,10,43
30,Success,44,35,0,8,36
30,Success,49,27,0,9,40
30,Success,41,38,0,9,32
30,Fail,40,25,3,19,21
30,Success,48,22,5,16,32
30,Success,45,34,0,13,32
30,Success,52,18,8,10,42
30,Fail,40,35,0,15,25
30,Success,43,41,0,10,33
30,Success,45,33,0,15,30
30,Success,45,36,0,14,31
30,Fail,42,34,0,14,28
30,Success,45,30,0,13,32
30,Success,44,32,2,13,31
30,Fail,43,28,9,15,28
30,Fail,45,24,0,21,24
30,Fail,41,33,0,15,26
30,Success,46,31,2,11,35
30,Fail,42,35,0,13,29
30,Success,47,28,6,11,36
30,Success,51,21,0,14,37
30,Success,45,28,1,11,34
30,Success,57,19,1,11,46
30,Success,48,32,0,8,40
30,Success,53,27,1,8,45
30,Success,50,24,6,9,41
30,Success,43,26,7,13,30
30,Fail,42,29,0,15,27
30,Success,47,24,0,17,30
30,Success,53,24,6,9,44
30,Fail,40,23,5,23,17
30,Success,50,22,2,14,36
30,Success,45,28,5,15,30
30,Success,48,25,2,14,34
30,Success,53,24,0,15,38
30,Success,49,22,8,16,33
30,Success,47,31,0,11,36
30,Fail,44,27,0,20,24
30,Success,53,26,0,14,39
30,Success,47,33,0,11,36
30,Success,52,27,0,11,41
30,Success,48,28,3,14,34
30,Success,48,25,1,11,37
30,Success,49,31,0,12,37
30,Success,49,27,0,14,35
30,Fail,44,24,0,19,25
30,Success,45,27,2,15,30
30,Success,52,19,1,13,39
30,Success,49,26,0,15,34
30,Success,60,21,0,9,51
30,Success,49,26,3,12,37
30,Success,54,13,11,11,43
30,Success,44,25,9,11,33
30,Success,51,27,0,14,37
30,Fail,43,25,6,14,29
30,Success,50,31,0,8,42
30,Success,50,24,0,14,36
30,Success,49,27,2,9,40
30,Success,45,21,9,11,34
30,Success,46,27,8,12,34
30,Success,51,23,3,12,39
30,Success,53,22,7,7,46
30,Success,48,29,0,14,34
30,Success,53,22,1,13,40
30,Success,49,22,0,15,34
30,Success,52,25,2,7,45
30,Fail,41,34,0,12,29
30,Success,49,23,0,14,35
30,Success,50,31,0,6,44
30,Success,46,35,0,12,34
30,Success,55,20,0,13,42
30,Success,48,22,2,13,35
30,Success,43,39,0,7,36
30,Success,50,20,1,19,31
30,Success,44,30,0,14,30
30,Success,54,24,0,9,45
30,Success,55,23,3,8,47
30,Fail,39,34,0,14,25
30,Success,49,27,0,10,39
30,Fail,42,31,0,18,24
30,Success,51,29,0,10,41
30,Success,44,24,10,13,31
30,Success,47,27,0,11,36
30,Success,47,29,0,14,33
30,Fail,42,33,0,14,28
30,Success,56,26,2,8,48
30,Fail,41,28,3,21,20
30,Success,53,23,2,9,44
30,Success,46,23,4,16,30
30,Fail,46,27,0,18,28
30,Success,51,27,1,9,42
30,Fail,44,30,0,17,27
30,Success,50,26,0,12,38
30,Fail,38,36,7,11,27
30,Fail,43,25,4,17,26
30,Success,44,28,2,13,31
30,Success,49,28,0,14,35
30,Success,44,29,5,13,31
30,Success,44,27,3,13,31
30,Success,46,28,0,13,33
30,Success,47,25,9,10,37
30,Success,48,35,0,9,39
30,Success,45,33,0,10,35
30,Fail,43,30,0,16,27
30,Success,51,31,0,10,41
30,Success,46,25,11,8,38
30,Success,49,29,0,13,36
30,Success,58,20,0,11,47
30,Fail,41,26,0,22,19
30,Fail,46,23,4,19,27
30,Success,46,23,6,12,34
30,Fail,38,41,0,11,27
30,Success,53,25,1,6,47
30,Success,52,22,1,12,40
30,Success,50,23,2,14,36
30,Success,56,20,1,11,45
30,Success,46,29,0,14,32
30,Success,52,22,0,12,40
30,Success,49,29,0,12,37
30,Success,47,24,0,17,30
30,Success,46,33,0,10,36
30,Success,46,26,6,16,30
30,Success,47,25,3,13,34
30,Success,52,19,9,10,42
30,Success,48,25,11,7,41
30,Success,50,27,1,10,40
30,Success,48,29,1,11,37
30,Success,44,34,0,11,33
30,Success,53,27,0,14,39
30,Success,49,31,0,13,36
30,Success,47,27,0,12,35
30,Success,51,27,0,10,41
30,Success,51,21,6,13,38
30,Fail,39,35,2,15,24
30,Success,49,32,0,9,40
30,Success,54,25,0,10,44
30,Success,50,21,3,12,38
30,Fail,44,31,0,16,28
30,Success,49,27,0,12,37
30,Success,55,26,0,8,47
30,Success,48,25,5,15,33
30,Fail,47,23,0,21,26
30,Success,42,35,0,12,30
30,Fail,41,26,8,20,21
30,Success,45,30,6,11,34
30,Success,46,27,5,16,30
30,Success,46,29,0,13,33
30,Fail,34,38,0,13,21
30,Success,56,22,0,8,48
30,Success,49,30,0,13,36
30,Success,50,24,6,14,36
30,Success,53,21,1,14,39
30,Fail,42,34,0,14,28
30,Fail,41,24,9,14,27
30,Success,46,23,8,16,30
30,Success,52,22,0,14,38
30,Fail,40,31,0,17,23
30,Success,48,22,8,14,34
30,Success,43,29,6,11,32
30,Success,44,33,6,11,33
30,Success,46,28,5,12,34
30,Success,51,21,4,13,38
30,Success,48,27,6,10,38
30,Success,56,24,0,11,45
30,Fail,46,27,0,19,27
30,Fail,41,30,2,15,26
30,Fail,42,27,7,17,25
30,Fail,40,30,1,18,22
30,Success,53,26,0,12,41
30,Success,49,24,2,14,35
30,Success,47,22,2,16,31
30,Success,50,25,0,13,37
30,Success,50,20,4,16,34
30,Fail,40,34,0,16,24
30,Success,47,28,0,13,34
30,Success,57,23,2,6,51
30,Success,44,25,11,10,34
30,Success,48,30,1,11,37
30,Fail,43,32,0,15,28
30,Success,48,32,0,12,36
30,Success,45,24,9,14,31
30,Fail,41,29,11,14,27
30,Success,53,19,6,11,42
30,Fail,44,30,0,17,27
30,Success,51,30,0,13,38
30,Success,57,25,0,9,48
30,Success,46,30,1,13,33
30,Success,55,25,6,7,48
30,Success,46,31,0,13,33
30,Success,50,23,0,15,35
30,Fail,41,28,0,16,25
30,Success,57,20,0,10,47
30,Success,55,20,1,12,43
30,Success,54,23,0,11,43
30,Success,46,34,0,10,36
30,Success,51,33,0,5,46
30,Success,53,27,2,6,47
30,Success,52,23,0,13,39
30,Success,44,36,0,11,33
30,Success,54,17,5,8,46
30,Fail,41,29,6,15,26
30,Success,44,30,7,9,35
30,Fail,44,32,0,15,29
30,Success,52,20,4,15,37
30,Success,46,28,3,14,32
30,Success,49,24,2,13,36
30,Success,47,27,9,7,40
30,Success,48,29,0,11,37
30,Success,44,30,1,14,30
30,Success,47,28,5,12,35
30,Success,44,35,0,12,32
30,Success,48,29,0,12,36
30,Success,48,25,6,13,35
30,Success,46,26,1,12,34
30,Success,49,29,1,7,42
30,Success,49,32,3,7,42
30,Success,57,24,0,10,47
30,Success,51,28,0,13,38
30,Success,42,25,5,11,31
30,Success,57,14,2,14,43
30,Success,54,23,1,10,44
30,Success,47,22,3,15,32
30,Success,49,27,6,10,39
30,Success,44,26,4,11,33
30,Success,52,29,0,9,43
30,Success,44,37,0,8,36
30,Success,50,21,10,9,41
30,Fail,37,30,7,19,18
30,Success,48,26,0,14,34
30,Fail,44,20,8,17,27
30,Success,50,15,14,14,36
30,Success,49,28,0,11,38
30,Success,52,21,0,16,36
30,Success,56,20,0,9,47
30,Success,47,33,0,10,37
30,Success,48,27,1,10,38
30,Success,47,23,4,17,30
30,Success,45,33,0,13,32
30,Success,45,31,0,14,31
30,Fail,43,24,5,18,25
30,Success,45,37,0,13,32
30,Success,48,22,0,16,32
30,Fail,43,33,0,15,28
30,Success,50,28,0,11,39
30,Success,55,21,6,8,47
30,Success,47,30,0,11,36
30,Success,48,25,0,18,30
30,Success,48,28,0,15,33
30,Success,51,29,2,9,42
30,Success,46,30,0,15,31
30,Success,49,28,0,12,37
30,Success,45,38,0,10,35
30,Fail,42,22,9,17,25
30,Fail,43,36,0,14,29
30,Success,51,28,0,13,38
30,Success,45,29,10,13,32
30,Success,57,26,1,8,49
30,Success,50,21,1,13,37
30,Success,42,33,0,12,30
30,Success,45,23,14,14,31
30,Success,54,23,0,12,42
30,Fail,38,32,0,21,17
30,Success,54,27,0,7,47
30,Success,58,16,0,13,45
30,Fail,42,32,0,16,26
30,Success,46,28,0,13,33
30,Success,47,26,5,9,38
30,Success,55,27,0,8,47
30,Success,51,28,1,8,43
30,Success,53,23,1,9,44
30,Success,56,26,0,8,48
30,Success,54,26,0,13,41
30,Success,55,23,0,10,45
30,Fail,45,31,0,16,29
30,Success,48,23,6,11,37
30,Success,57,24,0,9,48
30,Fail,41,31,0,16,25
30,Success,43,33,5,9,34
30,Success,55,26,0,9,46
30,Success,49,30,0,12,37
30,Fail,42,40,0,13,29
30,Success,42,26,14,10,32
30,Success,55,20,0,12,43
30,Fail,39,34,5,16,23
30,Success,48,37,0,8,40
30,Success,51,25,0,14,37
30,Success,52,19,1,16,36
30,Success,53,32,0,5,48
30,Success,48,25,1,12,36
30,Success,49,20,0,14,35
30,Success,49,21,2,18,31
30,Fail,39,38,0,13,26
30,Success,56,16,9,7,49
30,Success,43,32,2,13,30
30,Fail,39,33,0,20,19
30,Success,47,27,0,15,32
30,Fail,35,35,5,15,20
30,Success,53,23,0,11,42
30,Success,50,25,0,13,37
30,Success,48,23,3,14,34
30,Success,49,26,0,15,34
30,Success,54,22,0,12,42
30,Success,47,19,2,17,30
30,Success,45,30,1,12,33
30,Success,54,18,0,12,42
30,Success,47,25,9,14,33
30,Success,45,29,2,13,32
30,Fail,41,39,0,13,28
30,Success,50,22,4,13,37
30,Success,55,29,0,9,46
30,Success,53,31,0,8,45
30,Success,44,26,7,13,31
30,Success,49,30,0,13,36
30,Success,42,27,9,12,30
30,Fail,41,30,0,13,28
30,Success,56,23,0,9,47
30,Success,44,34,0,14,30
30,Success,47,21,9,12,35
30,Fail,42,35,1,13,29
30,Success,60,19,1,7,53
30,Success,45,30,0,15,30
30,Success,52,22,0,11,41
30,Success,55,22,0,13,42
30,Fail,44,26,3,18,26
30,Success,44,36,0,11,33
30,Success,48,25,0,13,35
30,Success,49,27,0,13,36
30,Success,51,27,0,10,41
30,Success,52,21,3,15,37
30,Success,47,29,0,15,32
30,Success,44,34,0,13,31
30,Success,43,33,9,10,33
30,Success,49,29,0,11,38
30,Success,54,21,1,10,44
30,Success,55,22,0,7,48
30,Success,45,28,4,14,31
30,Success,49,24,2,14,35
30,Success,54,21,0,13,41
30,Success,52,22,0,15,37
30,Success,47,28,0,14,33
30,Success,52,21,1,14,38
30,Success,47,26,0,17,30
30,Success,49,32,0,9,40
30,Success,51,20,2,13,38
30,Fail,40,39,0,15,25
30,Success,58,16,5,9,49
30,Success,48,21,13,9,39
30,Success,50,27,3,12,38
30,Success,53,22,6,11,42
30,Fail,45,30,0,16,29
30,Success,48,29,3,12,36
30,Success,48,33,3,8,40
30,Success,46,34,0,7,39
30,Success,46,30,0,12,34
30,Success,52,25,2,12,40
30,Success,51,21,0,13,38
30,Success,54,21,1,14,40
30,Success,48,26,0,15,33
30,Success,49,31,0,11,38
30,Success,48,22,2,14,34
30,Fail,40,40,0,15,25
30,Success,49,25,0,12,37
30,Fail,44,24,5,15,29
30,Success,46,31,3,13,33
30,Success,57,22,0,11,46
30,Success,52,28,0,13,39
30,Success,50,27,1,12,38
30,Success,47,30,3,8,39
30,Success,46,35,0,8,38
30,Success,49,29,0,14,35
30,Success,43,36,0,13,30
30,Fail,42,29,0,19,23
30,Success,53,21,2,15,38
30,Success,49,25,0,13,36
30,Success,50,24,0,13,37
30,Success,50,32,0,11,39
30,Success,49,25,8,12,37
30,Fail,43,22,6,14,29
30,Success,44,36,0,12,32
30,Success,46,31,9,8,38
30,Success,49,28,0,13,36
30,Success,52,18,0,18,34
30,Fail,46,25,0,21,25
30,Success,46,29,1,11,35
30,Success,43,34,0,13,30
30,Success,45,31,0,11,34
30,Success,51,21,3,12,39
30,Success,48,28,0,17,31
30,Success,51,24,6,10,41
30,Success,47,33,0,10,37
30,Success,47,35,0,9,38
30,Fail,40,34,0,15,25
30,Success,47,32,0,10,37
30,Success,46,30,0,12,34
30,Success,44,30,3,12,32
30,Fail,46,26,0,17,29
30,Success,46,32,0,12,34
30,Success,53,21,1,16,37
30,Success,53,19,0,16,37
30,Success,45,32,0,11,34
30,Success,54,24,0,13,41
30,Fail,43,29,0,18,25
30,Success,55,22,2,10,45
30,Success,47,22,4,13,34
30,Success,46,25,0,15,31
30,Success,49,24,0,12,37
30,Success,50,30,0,5,45
30,Fail,42,34,0,15,27
30,Fail,34,45,0,16,18
30,Success,52,26,0,13,39
30,Fail,36,45,0,13,23
30,Success,53,25,4,6,47
30,Success,53,20,6,12,41
30,Success,47,29,4,10,37
30,Fail,42,26,7,14,28
30,Success,43,37,0,13,30
30,Success,47,31,0,11,36
30,Fail,44,24,0,18,26
30,Success,49,22,1,17,32
30,Success,49,23,0,19,30
30,Success,49,30,0,12,37
30,Success,46,38,0,9,37
30,Success,43,34,0,12,31
30,Success,45,28,3,13,32
30,Success,56,20,0,8,48
30,Success,56,14,0,16,40
30,Success,47,27,0,16,31
30,Success,47,28,0,15,32
30,Fail,38,35,1,18,20
30,Fail,42,35,0,17,25
30,Success,45,27,4,10,35
30,Success,50,23,0,20,30
30,Success,49,32,0,12,37
30,Success,50,22,1,15,35
30,Success,52,22,3,10,42
30,Success,48,23,0,15,33
30,Success,47,27,2,15,32
30,Fail,37,37,0,14,23
30,Success,53,22,2,12,41
30,Success,47,24,7,16,31
30,Success,55,23,0,10,45
30,Fail,44,33,0,15,29
30,Fail,45,24,4,18,27
30,Success,51,29,0,10,41
30,Success,56,18,0,14,42
30,Success,48,24,3,15,33
30,Success,53,26,0,12,41
30,Success,46,29,0,13,33
30,Success,51,24,0,13,38
30,Success,45,27,6,12,33
30,Success,46,24,3,15,31
30,Success,53,21,1,14,39
30,Fail,44,32,0,15,29
30,Success,50,26,0,12,38
30,Fail,44,28,3,17,27
30,Success,54,21,2,12,42
30,Fail,37,35,0,19,18
30,Success,62,22,0,8,54
30,Success,52,23,0,13,39
30,Success,48,23,2,16,32
30,Fail,46,17,6,18,28
30,Success,50,32,0,10,40
30,Success,53,15,8,13,40
30,Success,46,24,2,15,31
30,Success,48,24,3,16,32
30,Success,51,27,0,12,39
30,Success,52,31,0,9,43
30,Fail,42,27,6,15,27
30,Success,52,26,1,10,42
30,Fail,43,27,1,18,25
30,Success,55,21,2,8,47
30,Success,49,21,7,13,36
30,Fail,42,33,0,14,28
30,Fail,39,34,0,14,25
30,Fail,41,38,0,12,29
30,Success,49,18,5,16,33
30,Fail,43,26,1,18,25
30,Success,52,21,4,14,38
30,Fail,45,28,0,18,27
30,Success,51,25,4,11,40
30,Success,45,36,0,13,32
30,Success,55,13,5,13,42
30,Success,47,31,1,9,38
30,Success,47,26,8,12,35
30,Fail,47,27,0,19,28
30,Success,47,26,1,13,34
30,Fail,42,31,0,16,26
30,Success,50,29,1,8,42
30,Success,48,23,0,17,31
30,Success,48,23,4,18,30
30,Success,46,28,2,14,32
30,Success,46,30,0,13,33
30,Success,52,22,4,15,37
30,Fail,45,24,0,20,25
30,Success,47,26,3,16,31
30,Fail,44,30,0,16,28
30,Success,50,26,11,9,41
30,Fail,43,22,2,23,20
30,Success,43,35,0,11,32
30,Success,48,26,0,14,34
30,Success,48,30,0,14,34
30,Success,48,28,0,14,34
30,Success,49,24,0,12,37
30,Success,52,25,0,9,43
30,Success,48,27,2,12,36
30,Success,44,21,16,13,31
30,Success,56,24,0,7,49
30,Success,54,25,3,9,45
30,Success,49,29,0,7,42
30,Success,57,18,5,8,49
30,Success,50,28,4,8,42
30,Success,53,27,0,10,43
30,Success,46,23,5,14,32
30,Success,50,27,4,8,42
30,Success,51,21,0,11,40
30,Fail,47,24,0,19,28
30,Fail,44,26,5,15,29
30,Success,44,32,2,13,31
30,Success,49,19,2,17,32
30,Success,46,32,0,11,35
30,Success,47,33,0,11,36
30,Success,52,23,3,10,42
30,Success,50,22,1,12,38
30,Success,51,33,0,6,45
30,Success,55,21,0,13,42
30,Success,46,30,0,16,30
30,Fail,43,30,0,16,27
30,Success,57,21,2,9,48
30,Success,52,28,0,11,41
30,Success,50,20,0,14,36
30,Fail,43,29,5,15,28
30,Success,54,17,6,13,41
30,Fail,41,39,0,12,29
30,Success,50,28,0,12,38
30,Success,45,29,2,11,34
30,Success,43,38,0,11,32
30,Success,57,22,0,9,48
30,Success,48,26,4,8,40
30,Fail,42,35,0,13,29
30,Success,44,39,0,9,35
30,Success,47,18,7,16,31
30,Success,44,34,0,11,33
30,Fail,45,24,0,17,28
30,Success,45,34,0,14,31
30,Success,45,27,10,8,37
30,Success,51,31,0,8,43
30,Success,43,39,0,12,31
30,Success,52,23,2,15,37
30,Success,51,22,0,12,39
30,Success,50,24,0,16,34
30,Fail,44,19,8,18,26
30,Success,45,25,3,13,32
30,Success,45,22,5,14,31
30,Fail,41,37,0,15,26
30,Success,45,32,8,10,35
30,Success,52,29,0,12,40
30,Success,52,30,0,9,43
30,Fail,44,28,0,18,26
30,Success,43,26,12,10,33
30,Success,43,29,5,12,31
30,Fail,43,28,5,16,27
30,Fail,43,27,2,17,26
30,Success,56,22,0,12,44
30,Fail,45,19,2,21,24
30,Fail,36,44,0,15,21
30,Success,57,26,0,9,48
30,Success,52,23,5,11,41
30,Success,47,32,0,12,35
30,Fail,43,24,5,17,26
30,Success,48,20,4,16,32
30,Fail,42,32,0,14,28
30,Fail,45,32,0,17,28
30,Success,45,33,0,13,32
30,Success,47,26,11,10,37
30,Success,45,23,3,15,30
30,Success,48,24,7,12,36
30,Success,48,26,2,17,31
30,Success,47,29,8,12,35
30,Success,48,22,0,17,31
30,Success,50,21,4,14,36
30,Success,48,24,6,11,37
30,Success,51,31,0,8,43
30,Success,50,24,0,14,36
30,Fail,40,30,8,14,26
30,Success,43,28,4,13,30
30,Fail,44,20,1,24,20
30,Success,51,31,0,6,45
30,Success,44,31,3,12,32
30,Fail,38,26,3,20,18
30,Success,54,24,0,11,43
30,Fail,43,26,9,15,28
30,Fail,38,25,16,15,23
30,Success,48,33,0,11,37
30,Fail,42,24,10,15,27
30,Success,45,23,8,13,32
30,Success,54,26,0,7,47
30,Success,48,23,0,16,32
30,Success,50,23,0,13,37
30,Success,47,35,0,9,38
30,Fail,45,26,0,17,28
30,Success,53,22,0,9,44
30,Success,53,25,0,11,42
30,Success,46,30,0,10,36
30,Success,50,24,0,10,40
30,Success,52,23,5,14,38
30,Success,50,29,2,6,44
30,Success,49,25,0,13,36
30,Fail,42,31,0,16,26
30,Success,48,26,3,14,34
30,Success,47,24,0,14,33
30,Fail,44,23,2,22,22
30,Fail,48,20,2,19,29
30,Success,58,20,0,8,50
30,Success,57,16,5,12,45
30,Success,49,26,0,14,35
30,Success,48,26,0,16,32
30,Success,46,30,0,12,34
30,Success,46,31,0,15,31
30,Success,50,26,0,11,39
30,Success,51,29,0,9,42
30,Success,49,20,6,14,35
30,Fail,42,39,0,13,29
30,Success,53,20,0,12,41
30,Success,50,26,0,12,38
30,Success,47,30,6,9,38
30,Success,47,32,0,12,35
30,Fail,39,28,10,14,25
30,Success,42,31,5,12,30
30,Success,44,36,0,11,33
30,Success,49,29,0,11,38
30,Success,48,24,6,15,33
30,Success,48,30,0,14,34
30,Success,47,23,9,9,38
30,Success,48,26,6,11,37
30,Success,47,24,0,17,30
30,Fail,41,31,1,14,27
30,Success,47,32,0,11,36
30,Fail,43,32,0,14,29
30,Success,50,24,2,10,40
30,Success,55,24,0,10,45
30,Fail,42,26,12,13,29
30,Success,50,19,2,15,35
30,Success,50,29,0,14,36
30,Success,50,24,2,13,37
30,Success,53,27,0,7,46
30,Success,49,30,0,11,38
30,Success,44,34,0,11,33
30,Success,48,30,0,11,37
30,Fail,42,23,17,13,29
30,Success,49,29,2,10,39
30,Success,58,19,0,10,48
30,Success,43,27,10,12,31
30,Success,53,29,0,10,43
30,Success,48,34,0,11,37
30,Success,45,28,5,14,31
30,Fail,46,24,0,19,27
30,Success,49,22,3,13,36
30,Success,46,24,5,13,33
30,Success,58,14,1,15,43
30,Success,50,30,0,11,39
30,Success,47,30,0,12,35
30,Success,55,20,3,13,42
30,Success,52,22,0,12,40
30,Success,57,20,0,11,46
30,Success,44,34,0,14,30
30,Success,52,28,0,10,42
30,Fail,43,33,1,16,27
30,Success,50,28,0,13,37
30,Success,54,22,4,12,42
30,Success,53,19,2,12,41
30,Success,48,25,0,16,32
30,Fail,41,35,0,16,25
30,Success,49,20,3,16,33
30,Success,53,23,10,6,47
30,Success,50,33,0,10,40
30,Success,53,23,0,10,43
30,Success,49,24,0,17,32
30,Success,46,30,0,13,33
30,Success,51,27,0,12,39
30,Success,45,28,7,11,34
30,Success,52,29,0,7,45
30,Success,56,20,0,14,42
30,Success,47,29,0,13,34
30,Success,43,32,8,10,33
30,Success,52,16,8,14,38
30,Success,50,29,0,12,38
30,Success,49,21,6,16,33
30,Success,48,32,0,10,38
30,Success,50,22,0,13,37
30,Success,52,24,3,12,40
30,Success,50,31,0,9,41
30,Success,42,40,0,10,32
30,Fail,44,30,0,19,25
30,Success,54,23,0,15,39
30,Success,49,29,0,10,39
30,Success,53,22,3,13,40
30,Success,49,19,6,12,37
30,Success,52,24,4,10,42
30,Success,50,21,4,13,37
30,Success,49,27,0,13,36
30,Success,50,32,1,4,46
30,Success,44,32,7,8,36
30,Success,47,29,1,8,39
30,Success,44,28,4,9,35
30,Fail,44,27,0,19,25
30,Success,47,29,0,11,36
30,Success,53,18,6,13,40
30,Fail,42,30,3,13,29
30,Success,50,32,0,13,37
30,Success,45,36,0,11,34
30,Success,54,26,0,13,41
30,Success,51,23,3,9,42
30,Success,47,27,1,12,35
30,Success,47,23,3,17,30
30,Fail,45,28,1,16,29
30,Success,52,21,0,16,36
30,Fail,46,27,0,19,27
30,Success,47,27,0,16,31
30,Fail,45,31,0,16,29
30,Success,52,27,2,9,43
30,Success,47,29,0,16,31
30,Success,49,21,3,14,35
30,Success,49,33,0,9,40
30,Success,47,25,1,16,31
30,Fail,39,27,6,20,19
30,Success,47,36,0,10,37
30,Success,46,25,6,11,35
30,Success,44,28,3,14,30
30,Success,60,20,1,9,51
30,Success,48,27,7,10,38
30,Success,46,28,0,14,32
30,Success,54,24,1,9,45
30,Success,51,23,3,14,37
30,Fail,46,30,0,18,28
30,Fail,42,25,1,18,24
30,Success,46,27,2,15,31
30,Success,44,30,5,9,35
30,Success,47,30,0,12,35
30,Success,45,26,1,15,30
30,Success,49,23,2,16,33
30,Success,51,22,5,13,38
30,Success,49,33,0,8,41
30,Success,44,22,13,12,32
30,Success,40,32,14,8,32
30,Success,48,30,0,10,38
30,Success,51,24,0,11,40
30,Success,52,21,6,11,41
30,Success,56,26,2,6,50
30,Success,48,25,0,14,34
30,Success,45,24,9,14,31
30,Fail,48,18,3,22,26
30,Success,46,27,0,10,36
30,Success,54,22,0,11,43
30,Success,45,37,0,10,35
30,Success,46,29,0,14,32
30,Fail,43,30,0,16,27
30,Success,49,27,0,12,37
30,Success,51,25,2,9,42
30,Success,44,32,1,11,33
30,Success,47,23,5,12,35
30,Fail,44,30,2,15,29
30,Success,52,29,3,7,45
30,Success,44,34,0,10,34
30,Success,50,33,0,8,42
30,Success,48,25,1,15,33
30,Success,45,32,0,10,35
30,Success,49,22,1,18,31
30,Success,52,16,1,16,36
30,Success,51,21,7,12,39
30,Success,50,23,4,10,40
30,Success,50,27,1,15,35
30,Success,51,24,1,14,37
30,Success,52,31,0,9,43
30,Success,46,27,0,13,33
30,Success,53,24,0,10,43
30,Success,45,35,0,10,35
30,Fail,43,28,1,18,25
30,Success,44,37,0,12,32
30,Success,44,37,0,10,34
30,Success,48,33,0,8,40
30,Success,54,19,3,15,39
30,Success,58,20,0,9,49
30,Success,46,34,0,13,33
30,Success,46,35,0,12,34
30,Fail,36,44,0,15,21
30,Success,46,29,6,11,35
30,Success,49,26,5,9,40
30,Success,52,27,0,9,43
30,Success,56,19,3,12,44
30,Success,46,35,0,9,37
30,Success,51,30,2,8,43
30,Fail,40,33,1,15,25
30,Success,48,27,5,13,35
30,Success,50,34,0,10,40
30,Success,45,31,1,11,34
30,Success,48,30,2,10,38
30,Success,53,24,0,14,39
30,Fail,47,21,2,20,27
30,Success,47,27,0,12,35
30,Success,45,36,0,12,33
30,Success,43,36,0,11,32
30,Success,44,30,0,13,31
30,Fail,47,26,0,18,29
30,Success,54,22,1,12,42
30,Success,49,28,0,8,41
30,Success,50,30,0,7,43
30,Success,52,22,0,15,37
30,Success,54,29,0,7,47
30,Success,47,21,7,10,37
30,Fail,38,32,0,15,23
30,Fail,40,35,0,16,24
30,Success,48,29,1,12,36
30,Success,46,25,3,10,36
30,Fail,44,32,0,15,29
30,Success,46,30,3,10,36
30,Fail,37,39,0,15,22
30,Success,49,24,0,18,31
30,Success,43,34,0,13,30
30,Fail,35,38,0,17,18
30,Fail,40,34,3,12,28
30,Success,55,25,0,11,44
30,Success,47,30,0,7,40
30,Success,54,31,0,8,46
30,Success,49,20,0,17,32
30,Success,45,27,4,14,31
30,Success,51,22,2,13,38
30,Success,43,35,0,13,30
30,Fail,42,30,0,17,25
30,Success,52,24,3,10,42
30,Success,54,22,0,13,41
30,Success,51,25,0,16,35
30,Success,49,31,0,14,35
30,Success,52,28,0,7,45
30,Success,51,29,0,9,42
30,Success,44,29,6,14,30
30,Fail,41,30,9,12,29
30,Success,46,32,0,11,35
30,Success,50,22,7,12,38
30,Success,53,24,4,8,45
30,Fail,36,28,13,16,20
30,Success,44,29,0,14,30
30,Success,56,21,0,9,47
30,Success,56,20,4,8,48
30,Fail,39,35,9,11,28
30,Success,47,25,3,14,33
30,Fail,42,24,7,15,27
30,Fail,38,31,0,20,18
30,Fail,45,22,7,16,29
30,Fail,40,36,6,14,26
30,Success,51,27,1,11,40
30,Success,47,26,5,13,34
30,Success,51,24,6,10,41
30,Success,53,22,0,12,41
30,Success,55,23,0,10,45
30,Success,55,21,2,11,44
30,Fail,46,15,8,19,27
30,Success,43,36,0,13,30
30,Success,54,26,0,9,45
30,Success,46,36,0,10,36
30,Fail,45,23,0,19,26
30,Success,53,20,3,10,43
30,Success,47,25,1,16,31
30,Success,50,31,0,11,39
30,Success,55,27,4,7,48
30,Success,48,30,0,12,36
30,Success,46,37,0,7,39
30,Success,47,26,1,15,32
30,Success,62,20,0,9,53
30,Success,50,20,0,15,35
30,Success,50,21,0,15,35
30,Success,45,26,7,14,31
30,Success,49,25,1,10,39
30,Success,50,29,0,9,41
30,Fail,42,30,5,13,29
30,Fail,41,29,8,14,27
30,Fail,42,29,1,15,27
30,Fail,44,25,1,18,26
30,Success,46,33,0,14,32
30,Success,45,31,0,15,30
30,Success,54,18,0,14,40
30,Fail,44,27,0,15,29
30,Fail,41,31,0,18,23
30,Success,49,23,3,8,41
30,Success,44,35,0,14,30
30,Success,55,19,0,12,43
30,Success,48,30,0,10,38
30,Success,47,28,0,14,33
30,Success,44,30,0,11,33
30,Success,51,26,0,10,41
30,Success,52,24,0,11,41
30,Success,59,21,0,11,48
30,Fail,45,28,0,20,25
30,Success,49,25,1,12,37
30,Success,39,32,15,9,30
30,Success,49,27,0,12,37
30,Fail,35,45,0,12,23
30,Success,47,33,0,13,34
30,Success,47,26,9,6,41
30,Success,45,28,0,13,32
30,Success,46,30,5,9,37
30,Success,55,25,0,11,44
30,Success,51,33,0,9,42
30,Success,48,27,0,13,35
30,Success,42,41,0,7,35
30,Success,44,32,0,13,31
30,Success,48,24,2,15,33
30,Success,44,29,0,14,30
30,Success,48,23,9,10,38
30,Success,53,24,0,10,43
30,Success,47,25,8,11,36
30,Success,53,21,2,11,42
30,Fail,43,34,0,17,26
30,Success,53,21,6,10,43
30,Success,48,27,0,13,35
30,Success,46,29,0,16,30
30,Success,43,30,10,9,34
30,Success,53,24,2,8,45
30,Success,47,20,7,17,30
30,Success,60,17,3,8,52
30,Success,49,27,0,12,37
30,Success,52,24,0,13,39
30,Success,47,25,7,11,36
30,Success,48,19,0,16,32
30,Fail,45,27,0,16,29
30,Success,57,25,0,9,48
30,Success,48,30,0,14,34
30,Success,52,14,4,18,34
30,Fail,38,38,6,11,27
30,Fail,33,46,0,18,15
30,Success,50,21,0,20,30
30,Fail,41,28,0,17,24
30,Success,53,20,0,14,39
30,Success,58,18,0,9,49
30,Success,55,24,2,6,49
30,Success,57,19,3,7,50
30,Success,52,27,2,10,42
30,Success,50,26,0,13,37
30,Success,49,29,0,8,41
30,Success,50,31,0,10,40
30,Success,56,22,5,9,47
30,Success,47,25,7,13,34
30,Fail,43,23,5,16,27
30,Success,53,25,1,12,41
30,Success,54,26,6,5,49
30,Success,45,34,7,8,37
30,Success,49,27,0,13,36
30,Success,49,28,0,11,38
30,Success,52,26,0,10,42
30,Success,59,15,0,18,41
30,Success,47,26,1,13,34
30,Fail,42,31,0,14,28
30,Success,45,31,0,11,34
30,Success,51,26,3,8,43
30,Success,50,23,0,18,32
30,Success,48,27,0,17,31
30,Success,49,22,2,17,32
30,Success,55,26,0,7,48
30,Fail,43,23,0,23,20
30,Success,45,36,0,12,33
30,Success,43,34,2,12,31
30,Success,52,29,0,11,41
30,Success,47,26,3,15,32
30,Success,48,29,0,13,35
30,Success,50,20,7,13,37
30,Success,44,28,0,14,30
30,Fail,38,36,0,17,21
30,Success,53,27,1,8,45
30,Fail,44,25,4,17,27
30,Fail,44,30,0,17,27
30,Success,46,33,0,10,36
30,Success,50,28,0,12,38
30,Success,49,31,0,10,39
30,Success,46,32,4,11,35
30,Success,47,27,3,13,34
30,Success,47,28,0,14,33
30,Success,43,31,6,11,32
30,Success,47,23,0,12,35
30,Success,44,26,4,14,30
30,Success,47,31,3,8,39
30,Success,47,24,4,12,35
30,Success,55,16,3,15,40
30,Success,48,30,0,12,36
30,Success,50,27,0,11,39
30,Success,49,25,9,10,39
30,Fail,43,31,0,16,27
30,Success,54,18,0,12,42
30,Success,46,25,0,12,34
30,Success,48,26,2,11,37
30,Success,45,31,0,13,32
30,Success,50,27,0,12,38
30,Success,45,28,0,13,32
30,Success,46,25,0,16,30
30,Success,46,28,0,13,33
30,Success,53,23,0,7,46
30,Success,49,28,5,10,39
30,Success,46,30,0,12,34
30,Success,46,27,10,9,37
30,Fail,42,33,0,14,28
30,Fail,43,26,2,17,26
30,Success,51,24,0,13,38
30,Success,59,18,1,7,52
30,Success,48,27,0,13,35
30,Success,51,22,4,14,37
30,Success,45,31,0,13,32
30,Success,50,30,0,10,40
30,Success,50,26,0,11,39
30,Success,46,34,0,8,38
30,Success,52,24,0,14,38
30,Success,42,38,0,12,30
30,Success,45,40,0,11,34
30,Success,47,35,0,11,36
30,Success,51,29,0,10,41
30,Success,59,19,1,8,51
30,Success,44,35,0,11,33
30,Success,49,27,4,12,37
30,Success,46,31,2,10,36
30,Success,46,26,2,14,32
30,Success,49,29,0,11,38
30,Success,44,32,3,12,32
30,Success,49,34,0,10,39
30,Success,51,27,0,9,42
30,Success,47,23,7,12,35
30,Success,50,33,0,11,39
30,Success,52,24,1,9,43
30,Success,55,20,0,10,45
30,Fail,44,21,6,15,29
30,Success,47,32,0,11,36
30,Fail,45,30,0,17,28
30,Success,47,27,3,13,34
30,Success,51,33,0,9,42
30,Fail,40,29,9,15,25
30,Success,46,28,9,13,33
30,Fail,48,23,1,19,29
30,Success,49,29,4,10,39
30,Fail,42,33,0,16,26
30,Success,50,26,3,10,40
30,Success,50,21,4,17,33
30,Success,48,24,0,13,35
30,Success,47,26,0,17,30
30,Success,52,27,5,11,41
30,Success,45,34,3,8,37
30,Fail,42,29,6,14,28
30,Success,46,36,0,12,34
30,Success,54,17,3,14,40
30,Success,53,23,2,12,41
30,Success,49,28,2,9,40
30,Fail,43,30,0,16,27
30,Success,44,29,9,9,35
30,Success,46,34,0,8,38
30,Fail,41,33,0,21,20
30,Success,47,24,10,8,39
30,Success,46,31,7,5,41
30,Success,42,31,4,11,31
30,Success,54,21,7,10,44
30,Fail,47,24,0,19,28
30,Success,48,31,8,6,42
30,Success,49,26,0,9,40
30,Success,49,24,8,12,37
30,Success,52,23,1,16,36
30,Success,52,18,2,14,38
30,Success,50,24,3,11,39
30,Success,57,27,5,4,53
30,Fail,41,35,0,16,25
30,Fail,44,23,7,15,29
30,Fail,40,28,5,12,28
30,Success,55,22,0,10,45
30,Success,47,26,0,17,30
30,Fail,42,27,0,19,23
30,Success,55,20,3,10,45
30,Success,52,22,2,15,37
30,Success,56,23,0,7,49
30,Success,50,25,0,11,39
30,Fail,42,30,0,16,26
30,Success,51,21,0,12,39
30,Success,52,24,0,15,37
30,Success,53,19,3,12,41
30,Success,49,34,0,8,41
30,Fail,44,30,2,15,29
30,Fail,45,23,0,17,28
30,Success,50,27,4,9,41
30,Success,50,25,3,12,38
30,Success,49,26,0,11,38
30,Success,49,26,7,10,39
30,Fail,39,29,6,16,23
30,Success,59,21,3,7,52
30,Success,49,30,0,13,36
30,Success,49,22,1,18,31
30,Success,51,22,0,10,41
30,Success,47,31,3,8,39
30,Success,50,28,3,9,41
30,Success,46,28,3,14,32
30,Success,46,22,9,14,32
30,Success,48,26,2,14,34
30,Success,59,18,3,6,53
30,Success,46,28,2,13,33
30,Success,53,24,0,9,44
30,Success,55,25,0,9,46
30,Success,53,21,5,8,45
30,Success,52,24,1,10,42
30,Success,48,22,6,15,33
30,Success,44,32,0,12,32
30,Success,48,32,5,8,40
30,Success,49,31,0,13,36
30,Success,53,30,5,7,46
30,Success,44,34,1,9,35
30,Success,48,25,0,15,33
30,Success,53,26,0,11,42
30,Success,44,35,0,12,32
30,Success,50,28,0,7,43
30,Success,51,25,0,13,38
30,Success,49,27,0,10,39
30,Success,46,35,0,10,36
30,Success,48,31,0,9,39
30,Success,50,33,0,7,43
30,Success,48,23,2,15,33
30,Success,51,25,1,11,40
30,Success,54,20,0,17,37
30,Success,50,31,0,8,42
30,Success,53,19,7,12,41
30,Fail,40,35,0,12,28
30,Success,49,24,5,10,39
30,Success,46,30,0,14,32
30,Fail,40,34,2,11,29
30,Success,52,20,6,12,40
30,Fail,45,26,0,17,28
30,Success,51,18,3,15,36
30,Success,48,29,3,11,37
30,Success,46,25,7,13,33
30,Success,50,27,5,5,45
30,Success,51,24,3,14,37
30,Fail,36,38,0,17,19
30,Success,51,26,1,8,43
30,Success,56,29,0,6,50
30,Success,53,25,0,9,44
30,Success,48,22,5,15,33
30,Success,51,27,0,15,36
30,Success,51,24,0,14,37
30,Success,54,25,0,13,41
30,Success,51,25,0,11,40
30,Success,47,29,0,12,35
30,Success,52,24,0,11,41
30,Success,51,21,0,14,37
30,Success,48,30,0,8,40
30,Success,50,30,0,9,41
30,Success,46,36,0,10,36
30,Success,45,25,6,14,31
30,Success,48,26,0,15,33
30,Fail,46,25,0,19,27
30,Success,57,24,0,8,49
30,Success,56,22,0,12,44
30,Success,52,25,0,15,37
30,Success,53,24,0,10,43
30,Success,50,23,5,11,39
30,Fail,42,29,6,16,26
30,Success,47,26,4,15,32
30,Success,51,21,11,8,43
30,Success,42,30,7,10,32
30,Success,46,25,2,12,34
30,Success,53,25,0,11,42
30,Success,44,24,0,14,30
30,Fail,41,23,6,18,23
30,Success,49,24,1,16,33
30,Success,50,21,4,16,34
30,Success,46,25,8,12,34
30,Success,46,26,1,16,30
30,Fail,45,29,1,19,26
30,Success,49,23,1,12,37
30,Success,45,33,0,13,32
30,Success,51,25,3,13,38
30,Success,56,23,0,7,49
30,Success,49,27,0,13,36
30,Success,50,33,0,11,39
30,Success,48,26,3,10,38
30,Success,43,32,7,11,32
30,Success,45,30,5,10,35
30,Success,48,22,2,15,33
30,Success,54,25,0,10,44
30,Success,55,19,5,9,46
30,Fail,44,30,0,16,28
30,Success,52,23,0,12,40
30,Success,50,28,0,10,40
30,Success,49,23,0,18,31
30,Success,54,20,2,11,43
30,Success,54,24,0,9,45
30,Success,50,25,0,13,37
30,Success,53,23,0,10,43
30,Fail,44,25,3,16,28
30,Success,45,27,4,12,33
30,Success,49,31,0,10,39
30,Success,55,24,0,11,44
30,Success,46,34,0,13,33
30,Success,47,29,0,11,36
30,Success,44,29,0,13,31
30,Success,54,25,0,10,44
30,Success,50,27,0,12,38
30,Success,49,22,5,14,35
30,Success,47,27,0,15,32
30,Success,54,27,0,10,44
30,Success,46,29,1,15,31
30,Success,45,32,7,8,37
30,Fail,38,32,3,16,22
30,Fail,44,29,0,16,28
30,Success,49,21,7,13,36
30,Fail,39,28,2,19,20
30,Success,47,24,0,17,30
30,Success,49,19,8,12,37
30,Success,48,28,0,12,36
30,Success,52,22,3,13,39
30,Success,51,28,1,10,41
30,Fail,41,33,0,15,26
30,Fail,43,29,0,16,27
30,Success,55,23,0,15,40
30,Fail,37,33,0,20,17
30,Fail,37,38,0,17,20
30,Success,50,22,4,13,37
30,Success,49,21,9,15,34
30,Success,46,30,0,10,36
30,Fail,41,37,0,14,27
30,Success,47,29,0,16,31
30,Success,55,19,2,12,43
30,Success,49,23,3,11,38
30,Success,54,22,0,13,41
30,Success,50,26,3,8,42
30,Success,51,22,0,11,40
30,Success,54,25,0,11,43
30,Fail,39,28,7,17,22
30,Success,52,17,0,17,35
30,Fail,42,24,11,14,28
30,Success,56,24,3,6,50
30,Success,46,28,0,16,30
30,Success,47,33,0,12,35
30,Success,56,19,0,9,47
30,Success,48,28,0,17,31
30,Success,48,34,0,9,39
30,Success,58,19,0,10,48
30,Success,50,18,13,13,37
30,Success,45,29,0,15,30
30,Fail,42,31,0,20,22
30,Fail,44,31,0,15,29
30,Success,55,22,3,9,46
30,Success,56,20,3,13,43
30,Success,52,25,2,11,41
30,Fail,41,41,0,12,29
30,Success,51,26,3,11,40
30,Success,52,19,3,15,37
30,Success,46,24,5,13,33
30,Success,50,34,0,11,39
30,Fail,43,24,10,16,27
30,Fail,44,34,0,17,27
30,Success,49,25,5,10,39
30,Success,52,20,9,12,40
30,Fail,47,17,8,19,28
30,Success,43,30,1,13,30
30,Success,52,27,0,9,43
30,Success,48,34,1,6,42
30,Success,44,30,6,11,33
30,Success,46,34,0,13,33
30,Fail,40,38,0,16,24
30,Fail,40,28,8,15,25
30,Fail,42,31,6,13,29
30,Success,48,25,0,17,31
30,Success,48,33,3,10,38
30,Success,55,19,0,13,42
30,Success,43,34,1,9,34
30,Success,47,35,0,12,35
30,Fail,41,25,5,15,26
30,Success,46,32,0,13,33
30,Success,47,26,0,15,32
30,Success,48,30,6,8,40
30,Success,49,23,3,12,37
30,Fail,45,22,7,17,28
30,Success,48,25,2,18,30
30,Fail,41,30,0,17,24
30,Success,55,17,1,17,38
30,Success,52,25,0,15,37
30,Success,51,22,3,14,37
30,Fail,48,23,0,19,29
30,Fail,46,21,5,17,29
30,Success,47,37,0,9,38
30,Success,54,25,0,7,47
30,Fail,43,35,0,15,28
30,Success,48,23,6,14,34
30,Success,44,40,0,8,36
30,Fail,45,24,2,19,26
30,Success,43,36,0,10,33
30,Fail,42,35,0,15,27
30,Success,47,30,0,15,32
30,Success,49,25,1,14,35
30,Fail,45,28,0,16,29
30,Success,48,25,0,14,34
30,Fail,37,35,0,17,20
30,Success,48,23,3,12,36
30,Success,53,19,0,18,35
30,Success,52,22,0,15,37
30,Success,51,21,7,14,37
30,Fail,42,37,0,13,29
30,Success,51,29,0,12,39
30,Success,53,27,0,10,43
30,Success,52,22,4,9,43
30,Success,53,24,0,13,40
30,Success,50,29,0,13,37
30,Success,46,28,2,12,34
30,Success,50,23,5,11,39
30,Success,50,22,0,12,38
30,Fail,44,30,0,15,29
30,Success,46,25,2,12,34
30,Success,49,24,4,13,36
30,Success,52,25,0,9,43
30,Success,52,23,0,16,36
30,Success,42,37,0,10,32
30,Success,48,25,0,14,34
30,Success,51,30,1,6,45
30,Fail,42,32,0,13,29
30,Success,52,25,0,8,44
30,Success,45,32,0,10,35
30,Success,42,31,8,8,34
30,Success,45,36,0,13,32
30,Fail,43,31,1,15,28
30,Success,48,24,3,12,36
30,Fail,43,20,4,19,24
30,Success,46,31,0,11,35
30,Success,52,24,10,10,42
30,Success,49,20,5,15,34
30,Success,46,36,0,9,37
30,Success,47,29,0,12,35
30,Success,50,21,0,14,36
30,Success,48,25,2,11,37
30,Success,44,30,3,11,33
30,Success,50,24,0,15,35
30,Success,49,20,1,19,30
30,Success,51,22,4,10,41
30,Success,48,25,4,14,34
30,Success,52,27,3,11,41
30,Fail,41,37,0,14,27
30,Success,47,26,8,11,36
30,Success,55,25,6,3,52
30,Success,44,30,0,14,30
30,Success,45,27,3,15,30
30,Success,47,25,0,14,33
30,Success,47,23,3,13,34
30,Fail,41,29,13,12,29
30,Success,47,36,0,7,40
30,Success,51,27,0,11,40
30,Success,51,25,0,13,38
30,Success,50,19,7,12,38
30,Fail,44,28,0,18,26
30,Fail,37,25,13,18,19
30,Fail,41,37,0,15,26
30,Success,49,24,0,16,33
30,Success,54,23,0,12,42
30,Success,47,34,0,8,39
30,Success,50,21,2,15,35
30,Success,47,34,0,10,37
30,Success,44,34,0,13,31
30,Success,41,36,0,11,30
30,Success,60,23,0,4,56
30,Fail,45,24,2,19,26
30,Fail,39,24,8,16,23
30,Success,53,21,4,10,43
30,Success,49,34,0,9,40
30,Success,49,34,0,8,41
30,Success,54,25,0,7,47
30,Success,52,25,4,11,41
30,Success,53,17,5,13,40
30,Success,46,28,6,11,35
30,Success,46,35,0,10,36
30,Success,55,23,2,5,50
30,Success,56,22,0,9,47
30,Success,51,17,5,18,33
30,Success,40,47,0,6,34
30,Success,48,22,0,15,33
30,Success,55,18,1,14,41
30,Success,46,24,2,13,33
30,Success,46,35,0,7,39
30,Success,53,19,4,15,38
30,Success,47,26,0,11,36
30,Fail,39,33,0,17,22
30,Fail,42,26,7,18,24
30,Success,51,25,0,14,37
30,Success,50,29,0,12,38
30,Success,50,27,0,12,38
30,Success,48,29,0,14,34
30,Success,54,27,0,8,46
30,Success,52,27,0,12,40
30,Success,54,22,0,13,41
30,Success,46,34,0,10,36
30,Success,52,22,2,13,39
30,Fail,40,33,0,15,25
30,Fail,38,35,7,14,24
30,Fail,44,24,10,18,26
30,Success,53,24,1,12,41
30,Success,49,26,2,11,38
30,Fail,44,19,8,18,26
30,Success,55,23,0,11,44
30,Success,48,22,4,18,30
30,Success,47,23,0,16,31
30,Fail,42,27,6,15,27
30,Fail,46,27,0,19,27
30,Fail,42,33,0,13,29
30,Success,49,29,0,9,40
30,Fail,44,24,6,15,29
30,Success,45,30,5,11,34
30,Success,53,25,6,6,47
30,Success,48,24,0,15,33
30,Success,50,17,6,17,33
30,Success,47,31,1,11,36
30,Success,55,17,9,9,46
30,Success,46,33,0,10,36
30,Success,45,33,0,13,32
30,Success,50,24,0,12,38
30,Success,59,26,0,1,58
30,Success,49,23,2,13,36
30,Fail,43,35,0,15,28
30,Success,52,29,0,10,42
30,Fail,43,27,0,16,27
30,Success,50,27,6,7,43
30,Success,51,23,7,13,38
30,Success,46,38,0,9,37
30,Success,45,35,0,14,31
30,Success,46,31,1,10,36
30,Success,49,22,11,11,38
30,Success,42,34,2,12,30
30,Success,52,26,0,11,41
30,Success,48,30,0,11,37
30,Success,53,26,0,10,43
30,Success,54,26,0,11,43
30,Success,57,23,0,7,50
30,Success,53,22,2,11,42
30,Success,47,31,0,13,34
30,Success,50,27,0,15,35
30,Success,41,31,7,10,31
30,Fail,41,29,0,17,24
30,Fail,40,32,0,16,24
30,Fail,40,24,0,24,16
30,Success,44,35,0,12,32
30,Success,45,31,2,13,32
30,Fail,42,29,11,14,28
30,Success,43,40,0,11,32
30,Success,52,24,3,10,42
30,Fail,43,22,7,18,25
30,Fail,47,21,2,18,29
30,Success,45,28,5,12,33
30,Success,49,27,0,17,32
30,Success,43,32,3,7,36
30,Success,52,26,1,11,41
30,Fail,44,18,10,18,26
30,Fail,44,25,1,18,26
30,Success,46,29,0,14,32
30,Success,55,26,2,7,48
30,Success,40,36,3,10,30
30,Fail,39,40,0,11,28
30,Success,52,18,0,13,39
30,Success,50,25,0,14,36
30,Success,46,25,2,16,30
30,Success,45,27,10,10,35
30,Success,50,31,0,12,38
30,Success,58,20,0,11,47
30,Success,50,24,0,14,36
30,Success,47,24,7,13,34
30,Success,44,31,3,11,33
30,Success,45,36,0,7,38
30,Success,51,29,1,10,41
30,Success,45,34,0,11,34
30,Success,49,27,3,11,38
30,Success,49,26,0,11,38
30,Success,50,25,1,14,36
30,Success,46,27,6,9,37
30,Success,47,27,0,14,33
30,Success,53,26,2,13,40
30,Success,50,34,0,12,38
30,Success,44,31,0,14,30
30,Success,50,29,0,10,40
30,Success,58,17,1,12,46
30,Success,56,14,0,17,39
30,Success,49,25,3,13,36
30,Success,57,24,0,10,47
30,Fail,42,34,0,16,26
30,Success,55,24,0,7,48
30,Fail,45,26,1,17,28
30,Success,53,21,4,10,43
30,Success,41,39,0,11,30
30,Success,46,26,2,14,32
30,Success,43,33,10,11,32
30,Success,55,20,0,13,42
30,Success,50,23,1,13,37
30,Success,47,23,9,11,36
30,Success,47,35,1,8,39
30,Success,46,30,0,10,36
30,Fail,47,24,0,19,28
30,Fail,38,43,0,15,23
30,Success,50,25,0,12,38
30,Success,48,32,3,10,38
30,Success,49,29,0,11,38
30,Success,53,24,0,11,42
30,Fail,40,39,0,13,27
30,Success,52,26,4,8,44
30,Success,46,24,3,14,32
30,Success,44,34,0,12,32
30,Fail,42,31,0,15,27
30,Success,52,25,0,9,43
30,Fail,42,28,6,14,28
30,Success,52,25,1,10,42
30,Success,46,32,0,14,32
30,Success,51,28,0,10,41
30,Success,42,38,0,11,31
30,Fail,41,25,8,14,27
30,Success,51,24,5,12,39
30,Success,41,39,0,11,30
30,Success,45,37,0,10,35
30,Success,49,26,1,16,33
30,Success,45,31,0,11,34
30,Success,57,13,9,15,42
30,Success,47,32,0,12,35
30,Success,45,24,6,15,30
30,Fail,42,33,2,16,26
30,Success,51,21,7,12,39
30,Fail,42,35,0,15,27
30,Success,48,31,0,10,38
30,Success,57,26,0,6,51
30,Success,49,24,0,17,32
30,Success,52,20,0,14,38
30,Fail,42,29,8,15,27
30,Success,53,26,0,11,42
30,Fail,41,31,0,15,26
30,Success,44,27,4,14,30
30,Success,42,34,0,12,30
30,Success,49,19,7,14,35
30,Success,49,33,0,6,43
30,Success,46,33,0,10,36
30,Success,50,24,0,10,40
30,Success,49,25,3,14,35
30,Success,49,34,0,9,40
30,Fail,38,35,0,11,27
30,Success,46,27,6,11,35
30,Fail,42,26,10,13,29
30,Fail,42,25,1,22,20
30,Fail,44,31,0,15,29
30,Success,57,21,0,8,49
30,Success,52,21,2,15,37
30,Fail,41,29,7,17,24
30,Success,51,20,0,18,33
30,Success,46,27,11,6,40
30,Success,46,22,6,12,34
30,Fail,44,19,9,15,29
30,Success,46,24,5,11,35
30,Success,47,23,4,13,34
30,Success,44,34,2,10,34
30,Success,45,32,0,14,31
30,Fail,39,35,0,18,21
30,Fail,40,36,0,12,28
30,Success,45,36,0,10,35
30,Success,47,25,8,8,39
30,Fail,47,15,8,22,25
30,Success,51,27,4,8,43
30,Success,50,27,1,11,39
30,Success,51,23,0,13,38
30,Success,56,26,0,7,49
30,Fail,38,35,0,16,22
30,Success,46,29,5,9,37
30,Success,43,35,0,11,32
30,Fail,40,28,2,17,23
30,Success,47,29,0,13,34
30,Success,47,26,2,12,35
30,Success,53,26,0,10,43
30,Success,50,27,1,9,41
30,Fail,40,29,10,13,27
30,Fail,46,24,3,17,29
30,Fail,45,24,0,16,29
30,Success,46,32,0,14,32
30,Success,50,22,8,9,41
30,Success,48,23,0,13,35
30,Success,51,25,6,7,44
30,Success,48,27,8,13,35
30,Success,46,28,0,15,31
30,Success,52,20,10,7,45
30,Fail,46,23,3,19,27
30,Success,49,21,0,18,31
30,Success,44,31,0,14,30
30,Success,47,27,0,13,34
30,Success,46,31,0,11,35
30,Success,44,21,8,14,30
30,Success,45,29,6,12,33
30,Success,48,26,0,12,36
30,Success,51,24,0,18,33
30,Success,49,25,5,9,40
30,Success,54,26,3,9,45
30,Success,51,26,2,13,38
30,Success,52,23,0,12,40
30,Success,58,26,0,8,50
30,Success,55,27,0,9,46
30,Success,49,26,0,14,35
30,Success,51,25,0,16,35
30,Success,43,31,8,9,34
30,Success,51,26,0,12,39
30,Success,54,24,0,10,44
30,Success,57,17,2,13,44
30,Success,45,25,11,11,34
30,Success,44,31,1,13,31
30,Fail,45,24,4,16,29
30,Success,46,26,9,8,38
30,Success,51,28,1,12,39
30,Success,51,24,5,8,43
30,Fail,42,27,8,17,25
30,Success,50,22,1,11,39
30,Success,51,28,2,12,39
30,Success,47,30,0,13,34
30,Success,57,22,3,9,48
30,Fail,42,30,0,16,26
30,Success,51,26,0,12,39
30,Fail,43,26,2,20,23
30,Success,56,21,0,12,44
30,Success,48,33,0,10,38
30,Success,51,24,0,15,36
30,Success,51,24,0,11,40
30,Success,56,17,4,13,43
30,Success,46,27,5,9,37
30,Success,47,25,1,17,30
30,Success,44,26,3,12,32
30,Success,46,28,9,8,38
30,Success,53,16,5,16,37
30,Success,54,23,0,10,44
30,Success,53,26,0,9,44
30,Success,50,27,8,7,43
30,Fail,40,33,0,14,26
30,Success,51,29,0,10,41
30,Success,48,25,0,15,33
30,Fail,39,34,3,15,24
30,Success,47,23,2,14,33
30,Success,55,22,6,9,46
30,Fail,45,25,1,19,26
30,Fail,44,33,0,16,28
30,Success,49,29,3,9,40
30,Success,50,18,7,13,37
30,Success,51,23,8,7,44
30,Success,47,26,0,16,31
30,Success,45,23,8,13,32
30,Success,46,32,0,11,35
30,Success,55,23,0,11,44
30,Fail,43,28,3,16,27
30,Fail,39,35,0,16,23
30,Success,48,28,0,14,34
30,Success,48,27,0,13,35
30,Success,52,24,2,10,42
30,Fail,44,24,6,16,28
30,Success,49,22,0,16,33
30,Success,50,21,0,13,37
30,Success,46,24,4,15,31
30,Success,51,25,0,12,39
30,Success,45,29,0,14,31
30,Success,51,30,0,12,39
30,Success,47,28,3,8,39
30,Fail,37,37,0,17,20
30,Fail,36,30,13,15,21
30,Success,46,31,0,12,34
30,Success,56,29,0,5,51
30,Success,51,25,0,11,40
30,Fail,44,29,0,16,28
30,Fail,35,35,9,14,21
30,Success,51,20,9,10,41
30,Success,51,23,2,14,37
30,Success,48,31,0,13,35
30,Success,48,34,0,9,39
30,Success,51,25,0,15,36
30,Fail,43,33,2,14,29
30,Success,53,22,0,10,43
30,Success,57,22,0,6,51
30,Fail,39,39,0,12,27
30,Success,52,19,4,17,35
30,Success,51,30,0,10,41
30,Success,44,26,10,11,33
30,Success,56,21,9,8,48
30,Success,42,34,0,11,31
30,Success,48,27,1,12,36
30,Success,48,22,0,18,30
30,Fail,44,33,0,15,29
30,Fail,42,24,3,14,28
30,Success,48,32,0,13,35
30,Success,50,21,0,18,32
30,Fail,47,23,0,18,29
30,Success,56,22,0,9,47
30,Success,43,25,5,13,30
30,Success,52,22,0,14,38
30,Fail,43,22,7,14,29
30,Fail,43,27,2,17,26
30,Fail,46,26,2,17,29
30,Success,47,30,8,8,39
30,Fail,41,27,4,19,22
30,Success,46,35,0,10,36
30,Success,44,27,7,12,32
30,Fail,45,31,0,16,29
30,Success,56,24,0,8,48
30,Success,58,13,2,11,47
30,Fail,42,24,15,15,27
30,Success,56,19,0,13,43
30,Success,48,27,0,13,35
30,Success,48,29,0,12,36
30,Fail,44,28,0,18,26
30,Success,49,23,2,14,35
30,Success,52,24,0,12,40
30,Fail,39,28,8,16,23
30,Fail,42,31,0,19,23
30,Success,43,29,2,12,31
30,Success,47,29,6,11,36
30,Fail,41,32,2,13,28
30,Fail,45,30,0,17,28
30,Success,50,28,0,12,38
30,Success,49,26,3,11,38
30,Fail,43,31,0,15,28
30,Fail,43,33,0,14,29
30,Success,48,35,0,9,39
30,Success,50,29,0,13,37
30,Success,46,33,0,14,32
30,Success,45,34,0,13,32
30,Success,54,17,7,10,44
30,Success,45,36,0,9,36
30,Success,47,23,3,17,30
30,Success,50,26,0,12,38
30,Success,46,28,0,15,31
30,Success,52,23,0,11,41
30,Success,52,23,0,12,40
30,Success,52,25,2,9,43
30,Success,45,27,0,15,30
30,Success,46,29,6,11,35
30,Success,56,24,0,8,48
30,Success,44,30,11,9,35
30,Success,51,29,0,8,43
30,Fail,45,24,0,18,27
30,Success,52,22,3,12,40
30,Success,43,38,0,13,30
30,Success,47,18,7,16,31
30,Success,53,24,0,9,44
30,Success,51,21,0,14,37
30,Fail,43,32,0,18,25
30,Success,52,26,0,12,40
30,Success,47,28,0,14,33
30,Success,47,24,6,13,34
30,Success,51,27,1,9,42
30,Success,54,27,1,7,47
30,Success,50,27,0,14,36
30,Success,48,23,4,16,32
30,Success,47,35,0,11,36
30,Success,46,32,0,11,35
30,Success,53,20,0,17,36
30,Fail,41,37,0,12,29
30,Success,55,22,1,11,44
30,Success,45,29,0,14,31
30,Success,49,30,0,10,39
30,Success,48,33,0,10,38
30,Success,45,40,0,7,38
30,Fail,43,28,0,18,25
30,Success,48,25,3,14,34
30,Success,44,25,10,12,32
30,Success,45,35,0,12,33
30,Success,55,24,0,11,44
30,Success,48,25,2,16,32
30,Fail,43,29,3,15,28
30,Success,48,28,0,13,35
30,Success,47,29,0,14,33
30,Fail,42,31,1,16,26
30,Success,45,31,0,13,32
30,Success,48,26,0,15,33
30,Success,49,27,0,12,37
30,Success,49,25,0,12,37
30,Fail,44,30,0,19,25
30,Success,49,32,0,8,41
30,Success,45,33,0,10,35
30,Success,47,31,0,11,36
30,Success,53,30,0,10,43
30,Success,52,19,5,12,40
30,Success,56,24,0,10,46
30,Fail,38,36,0,18,20
30,Success,47,28,3,13,34
30,Fail,38,26,10,20,18
30,Success,47,24,6,13,34
30,Success,50,24,9,9,41
30,Success,56,21,0,8,48
30,Success,46,37,0,8,38
30,Success,49,26,0,14,35
30,Success,49,18,2,18,31
30,Fail,39,41,0,14,25
30,Success,51,24,0,17,34
30,Success,51,23,2,12,39
30,Success,48,32,0,9,39
30,Success,47,25,8,11,36
30,Success,51,27,0,12,39
30,Success,50,22,1,11,39
30,Success,48,30,0,12,36
30,Fail,42,23,8,22,20
30,Success,44,34,0,14,30
30,Success,51,27,6,10,41
30,Fail,42,30,5,15,27
30,Success,47,26,1,13,34
30,Success,49,32,0,12,37
30,Fail,37,39,0,13,24
30,Success,47,32,0,12,35
30,Success,55,29,0,9,46
30,Success,46,25,8,16,30
30,Success,45,34,0,11,34
30,Success,46,28,0,14,32
30,Success,55,19,0,14,41
30,Success,48,28,7,8,40
30,Fail,42,27,8,14,28
30,Success,48,25,4,12,36
30,Success,46,32,0,12,34
30,Fail,35,36,5,13,22
30,Fail,42,27,9,15,27
30,Success,42,35,6,9,33
30,Success,45,29,4,13,32
30,Success,49,29,10,7,42
30,Success,51,26,0,11,40
30,Success,47,28,0,17,30
30,Success,50,27,4,7,43
30,Success,54,22,9,9,45
30,Fail,44,24,4,17,27
30,Success,46,25,0,14,32
30,Success,52,20,1,12,40
30,Fail,38,43,0,11,27
30,Success,49,29,0,13,36
30,Success,48,26,1,9,39
30,Success,52,26,0,11,41
30,Success,52,25,0,11,41
30,Success,51,23,0,17,34
30,Success,49,30,0,14,35
30,Fail,38,39,0,14,24
30,Success,45,33,0,12,33
30,Success,48,31,2,8,40
30,Success,45,29,3,13,32
30,Success,58,21,0,9,49
30,Success,52,19,0,12,40
30,Fail,40,25,7,19,21
30,Fail,43,32,0,14,29
30,Success,45,27,6,9,36
30,Success,51,18,6,16,35
30,Fail,44,28,2,18,26
30,Success,52,21,0,13,39
30,Success,53,25,2,11,42
30,Success,47,28,2,14,33
30,Success,50,24,0,16,34
30,Fail,43,33,1,17,26
30,Success,49,20,3,19,30
30,Fail,43,30,0,16,27
30,Fail,39,34,7,15,24
30,Fail,43,28,8,15,28
30,Success,43,34,0,12,31
30,Success,46,34,0,6,40
30,Success,53,27,1,8,45
30,Success,51,24,0,13,38
30,Success,45,28,0,14,31
30,Success,50,27,0,15,35
30,Success,45,30,0,15,30
30,Success,50,25,5,10,40
30,Success,44,26,11,10,34
30,Success,53,25,0,13,40
30,Success,52,24,3,7,45
30,Success,49,30,0,13,36
30,Success,55,20,0,14,41
30,Success,50,32,0,10,40
30,Fail,40,33,4,12,28
30,Success,44,32,7,9,35
30,Success,44,37,0,10,34
30,Success,51,18,3,12,39
30,Success,55,21,2,12,43
30,Success,50,19,1,16,34
30,Fail,42,29,8,16,26
30,Success,47,25,2,16,31
30,Success,57,16,0,11,46
30,Success,48,26,0,14,34
30,Success,45,33,1,13,32
30,Success,53,24,0,15,38
30,Fail,43,26,7,17,26
30,Success,47,23,5,13,34
30,Success,50,25,4,11,39
30,Success,50,26,0,15,35
30,Success,50,24,1,13,37
30,Success,50,26,1,12,38
30,Success,45,37,0,11,34
30,Success,48,30,0,10,38
30,Success,48,27,0,13,35
30,Success,45,33,0,11,34
30,Success,51,25,0,10,41
30,Fail,48,25,0,20,28
30,Fail,46,22,0,18,28
30,Success,52,16,5,13,39
30,Fail,40,22,9,19,21
30,Success,47,27,0,15,32
30,Success,49,24,0,16,33
30,Success,48,28,0,9,39
30,Success,44,39,0,7,37
30,Success,51,26,0,15,36
30,Success,46,28,5,12,34
30,Success,46,32,0,13,33
30,Success,49,34,0,11,38
30,Fail,37,39,3,13,24
30,Success,44,33,0,11,33
30,Success,47,28,4,11,36
30,Success,52,16,0,20,32
30,Fail,41,27,7,14,27
30,Fail,48,21,0,20,28
30,Success,48,30,1,10,38
30,Success,48,20,5,16,32
30,Success,50,30,0,9,41
30,Success,51,24,0,14,37
30,Success,48,32,0,8,40
30,Success,56,25,0,10,46
30,Success,48,27,0,18,30
30,Fail,41,29,1,18,23
30,Success,55,22,5,9,46
30,Fail,40,30,2,15,25
30,Success,53,34,0,7,46
30,Success,49,28,0,13,36
30,Success,48,21,9,15,33
30,Success,53,30,0,6,47
30,Success,47,24,1,14,33
30,Success,44,31,4,11,33
30,Success,53,24,4,11,42
30,Fail,41,35,0,14,27
30,Success,49,26,0,14,35
30,Success,51,28,0,10,41
30,Success,51,27,0,9,42
30,Success,47,28,5,14,33
30,Fail,40,30,7,14,26
30,Success,54,23,0,9,45
30,Fail,44,26,4,17,27
30,Success,47,34,0,14,33
30,Success,46,30,0,13,33
30,Fail,39,36,0,14,25
30,Success,39,33,9,8,31
30,Success,51,27,1,8,43
30,Success,47,29,0,15,32
30,Fail,43,31,0,15,28
30,Fail,34,40,0,19,15
30,Success,48,35,0,9,39
30,Success,48,34,0,11,37
30,Success,45,30,1,13,32
30,Success,44,31,0,14,30
30,Fail,41,28,0,17,24
30,Success,48,32,0,11,37
30,Success,45,32,0,10,35
30,Fail,41,27,10,15,26
30,Success,49,27,8,8,41
30,Fail,47,24,0,18,29
30,Success,41,36,1,10,31
30,Success,60,12,4,12,48
30,Fail,41,30,4,14,27
30,Success,46,27,0,15,31
30,Success,45,30,0,14,31
30,Success,54,18,0,13,41
30,Success,46,33,0,10,36
30,Success,50,24,0,12,38
30,Success,49,26,6,15,34
30,Success,46,27,9,9,37
30,Success,45,29,5,11,34
30,Success,47,26,0,15,32
30,Success,52,23,0,15,37
30,Success,45,30,0,11,34
30,Success,52,28,2,6,46
30,Success,42,37,0,9,33
30,Success,50,29,0,15,35
30,Success,50,29,0,11,39
30,Success,53,25,0,11,42
30,Success,49,22,0,16,33
30,Success,52,28,3,7,45
30,Success,51,22,0,15,36
30,Success,49,27,0,10,39
30,Success,53,26,0,13,40
30,Success,48,23,0,14,34
30,Success,49,32,0,7,42
30,Success,51,22,4,9,42
30,Success,46,34,0,12,34
30,Success,49,31,0,10,39
30,Fail,40,26,9,14,26
30,Success,47,22,0,16,31
30,Success,42,40,0,10,32
30,Success,48,31,0,13,35
30,Success,47,26,0,15,32
30,Success,48,31,0,12,36
30,Success,50,23,1,14,36
30,Success,48,31,0,11,37
30,Success,46,34,0,7,39
30,Success,53,26,1,7,46
30,Success,45,31,6,9,36
30,Success,52,19,0,15,37
30,Success,45,31,0,13,32
30,Success,50,30,6,9,41
30,Fail,40,35,4,12,28
30,Success,50,27,0,14,36
30,Success,49,32,0,8,41
30,Success,43,38,0,13,30
30,Success,47,31,3,13,34
30,Fail,39,41,0,13,26
30,Success,55,20,5,8,47
30,Fail,40,32,3,11,29
30,Success,51,25,0,15,36
30,Success,46,30,4,8,38
30,Success,49,25,2,10,39
30,Success,49,29,2,10,39
30,Success,52,30,0,7,45
30,Fail,40,33,5,12,28
30,Success,51,23,0,12,39
30,Success,43,38,0,8,35
30,Success,44,37,0,12,32
30,Success,53,20,2,11,42
30,Success,48,26,0,14,34
30,Fail,45,25,1,20,25
30,Success,44,30,0,14,30
30,Success,45,32,0,14,31
30,Success,49,32,0,10,39
30,Success,47,23,6,13,34
30,Fail,43,26,0,23,20
30,Fail,38,32,0,24,14
30,Success,47,26,6,11,36
30,Success,48,23,0,16,32
30,Fail,44,25,0,18,26
30,Success,51,28,4,11,40
30,Success,47,28,0,12,35
30,Fail,43,31,3,14,29
30,Success,49,25,0,12,37
30,Success,44,31,0,12,32
30,Fail,43,26,8,14,29
30,Success,53,28,0,9,44
30,Success,52,20,0,16,36
30,Success,53,20,0,14,39
30,Success,47,31,0,13,34
30,Success,43,38,0,11,32
30,Success,45,25,3,14,31
30,Fail,42,29,6,16,26
30,Success,50,21,8,13,37
30,Success,54,26,1,10,44
30,Success,47,25,2,12,35
30,Success,51,25,0,15,36
30,Success,48,23,4,15,33
30,Success,46,23,9,15,31
30,Success,47,29,2,9,38
30,Success,49,23,0,18,31
30,Success,48,29,1,11,37
30,Success,48,29,0,13,35
30,Fail,40,30,8,15,25
30,Fail,43,30,0,16,27
30,Fail,42,32,1,14,28
30,Success,45,31,0,15,30
30,Success,50,22,3,16,34
30,Success,50,23,0,12,38
30,Success,50,27,0,12,38
30,Fail,47,19,0,23,24
30,Success,49,32,0,12,37
30,Success,48,28,0,13,35
30,Success,44,29,6,14,30
30,Success,51,24,0,10,41
30,Success,47,32,0,8,39
30,Success,49,25,1,14,35
30,Fail,44,29,0,17,27
30,Success,47,29,0,13,34
30,Fail,41,35,0,15,26
30,Success,47,25,4,11,36
30,Success,49,28,0,10,39
30,Success,51,28,3,9,42
30,Success,55,18,8,9,46
30,Success,47,38,0,5,42
30,Fail,35,33,1,18,17
30,Success,47,31,0,14,33
30,Success,45,31,0,14,31
30,Success,55,20,4,10,45
30,Success,50,24,0,15,35
30,Success,52,29,1,8,44
30,Success,51,31,0,12,39
30,Success,47,32,0,11,36
30,Fail,41,36,0,17,24
30,Success,54,20,0,12,42
30,Success,54,23,0,13,41
30,Fail,46,19,3,22,24
30,Success,49,25,7,8,41
30,Success,50,29,0,12,38
30,Success,46,39,0,6,40
30,Success,47,28,0,15,32
30,Success,51,27,2,10,41
30,Success,50,23,3,14,36
30,Success,50,19,1,19,31
30,Success,48,23,3,13,35
30,Success,45,27,1,15,30
30,Fail,40,36,0,15,25
30,Success,47,26,3,12,35
30,Fail,47,23,0,18,29
30,Success,52,24,0,11,41
30,Success,47,32,0,13,34
30,Success,46,33,1,11,35
30,Success,48,30,0,13,35
30,Fail,41,25,5,18,23
30,Success,46,35,0,10,36
30,Success,52,23,4,9,43
30,Success,46,32,0,13,33
30,Success,48,29,0,8,40
30,Success,47,28,0,15,32
30,Success,45,33,0,13,32
30,Success,46,22,5,16,30
30,Fail,45,21,0,21,24
30,Success,56,19,7,10,46
30,Fail,44,28,0,19,25
30,Fail,46,23,5,17,29
30,Fail,43,32,0,14,29
30,Success,50,28,0,10,40
30,Success,51,16,8,12,39
30,Success,55,25,1,9,46
30,Fail,40,32,9,11,29
30,Success,56,17,0,17,39
30,Fail,38,33,4,14,24
30,Success,45,27,8,14,31
30,Fail,38,33,4,16,22
30,Success,53,24,0,11,42
30,Fail,42,33,0,14,28
30,Fail,43,33,0,14,29
30,Success,56,22,0,8,48
30,Success,47,25,4,11,36
30,Fail,44,25,7,16,28
30,Success,49,23,13,8,41
30,Success,51,30,1,8,43
30,Success,52,26,2,10,42
30,Success,47,34,0,8,39
30,Success,50,29,4,10,40
30,Fail,35,34,9,14,21
30,Fail,46,22,6,17,29
30,Success,51,30,0,11,40
30,Success,51,28,0,8,43
30,Fail,37,40,0,15,22
30,Success,53,25,0,8,45
30,Success,51,19,4,14,37
30,Fail,46,23,0,22,24
30,Success,51,27,3,8,43
30,Success,47,26,8,10,37
30,Success,50,23,2,11,39
30,Fail,43,29,4,15,28
30,Success,52,19,3,15,37
30,Success,55,22,4,10,45
30,Success,53,21,0,17,36
30,Success,49,28,0,16,33
30,Fail,38,41,0,11,27
30,Success,45,29,5,10,35
30,Fail,39,34,3,16,23
30,Success,47,30,0,10,37
30,Success,51,21,0,12,39
30,Success,45,28,0,13,32
30,Success,50,22,1,14,36
30,Success,51,22,0,20,31
30,Success,51,27,6,8,43
30,Success,45,33,0,9,36
30,Success,54,23,2,12,42
30,Success,54,23,1,11,43
30,Success,52,27,0,12,40
30,Success,45,24,3,10,35
30,Success,50,27,5,10,40
30,Success,47,30,5,11,36
30,Success,54,21,1,12,42
30,Success,54,19,4,14,40
30,Fail,45,26,0,17,28
30,Success,50,15,4,17,33
30,Success,56,17,4,11,45
30,Success,49,32,1,7,42
30,Success,46,23,2,16,30
30,Success,55,25,0,13,42
30,Success,48,26,0,16,32
30,Success,57,21,2,12,45
30,Success,49,20,2,15,34
30,Success,46,24,0,16,30
30,Success,46,27,7,11,35
30,Fail,41,37,0,14,27
30,Success,54,27,0,8,46
30,Success,44,29,0,14,30
30,Success,49,29,0,9,40
30,Success,54,25,0,10,44
30,Success,55,22,0,11,44
30,Fail,38,34,6,16,22
30,Success,47,20,10,12,35
30,Success,50,24,2,12,38
30,Fail,44,28,0,19,25
30,Success,51,20,4,15,36
30,Success,52,30,0,9,43
30,Success,46,30,0,12,34
30,Success,48,27,5,7,41
30,Success,53,24,1,12,41
30,Success,51,23,4,8,43
30,Success,52,23,0,13,39
30,Success,48,27,3,11,37
30,Success,54,24,0,9,45
30,Success,51,17,5,17,34
30,Success,50,20,3,13,37
30,Success,56,18,1,12,44
30,Success,40,39,0,10,30
30,Success,48,27,0,13,35
30,Success,50,33,0,8,42
30,Success,50,29,0,9,41
30,Success,47,26,0,14,33
30,Success,45,33,0,12,33
30,Success,52,19,7,12,40
30,Success,52,25,0,10,42
30,Success,47,27,0,13,34
30,Success,51,21,3,14,37
30,Success,47,26,2,15,32
30,Fail,42,30,0,16,26
30,Success,54,22,0,12,42
30,Fail,43,30,0,15,28
30,Fail,46,24,0,19,27
30,Fail,41,34,5,13,28
30,Success,49,23,4,13,36
30,Success,54,21,1,13,41
30,Success,50,30,6,8,42
30,Success,52,27,0,9,43
30,Success,53,27,2,9,44
30,Success,48,28,0,12,36
30,Success,44,29,2,14,30
30,Success,52,15,5,14,38
30,Success,55,18,11,10,45
30,Success,48,32,0,11,37
30,Success,49,21,0,14,35
30,Success,49,35,0,12,37
30,Success,50,24,0,13,37
30,Success,48,25,8,12,36
30,Success,43,30,0,12,31
30,Success,49,19,4,12,37
30,Success,46,27,1,12,34
30,Success,54,28,0,9,45
30,Success,47,25,0,15,32
30,Success,47,27,2,14,33
30,Success,44,32,2,11,33
30,Success,47,26,3,10,37
30,Success,49,21,0,18,31
30,Success,48,29,0,13,35
30,Success,49,25,0,13,36
30,Fail,40,39,0,12,28
30,Success,46,30,0,11,35
30,Fail,47,27,0,18,29
30,Success,46,29,0,16,30
30,Fail,42,36,0,16,26
30,Success,48,30,0,15,33
30,Success,48,20,2,14,34
30,Success,48,29,0,9,39
30,Success,44,30,7,8,36
30,Fail,46,26,0,17,29
30,Fail,47,24,0,19,28
30,Success,50,19,3,14,36
30,Success,47,30,0,13,34
30,Success,49,25,4,10,39
30,Success,56,19,0,13,43
30,Success,55,23,2,8,47
30,Success,46,28,0,13,33
30,Success,48,23,2,15,33
30,Success,47,27,0,13,34
30,Success,46,34,0,11,35
30,Success,51,28,0,9,42
30,Success,46,25,8,12,34
30,Success,55,29,0,4,51
30,Success,56,18,0,13,43
30,Success,48,20,4,17,31
30,Success,52,17,7,12,40
30,Success,57,23,5,7,50
30,Success,46,25,0,15,31
30,Success,52,21,0,13,39
30,Success,48,30,0,10,38
30,Fail,43,22,7,17,26
30,Success,49,23,0,13,36
30,Success,51,27,0,9,42
30,Success,47,30,5,11,36
30,Success,53,19,6,10,43
30,Success,48,30,0,16,32
30,Success,54,33,0,6,48
30,Success,43,31,0,12,31
30,Success,46,26,5,14,32
30,Success,48,34,0,8,40
30,Success,54,21,0,11,43
30,Success,41,38,0,10,31
30,Success,46,31,2,12,34
30,Success,43,33,3,10,33
30,Success,58,17,1,12,46
30,Success,53,22,2,11,42
30,Success,58,22,0,11,47
30,Success,58,21,1,9,49
30,Success,43,33,0,13,30
30,Success,53,25,0,7,46
30,Success,48,28,0,12,36
30,Fail,37,32,13,13,24
30,Success,48,28,0,11,37
30,Success,52,31,1,6,46
30,Success,56,20,3,13,43
30,Success,48,24,4,12,36
30,Fail,45,26,0,20,25
30,Success,44,32,0,13,31
30,Success,56,17,0,12,44
30,Success,53,23,0,11,42
30,Success,53,17,7,11,42
30,Success,50,31,0,7,43
30,Success,54,26,0,9,45
30,Fail,41,30,1,12,29
30,Success,48,30,0,11,37
30,Success,55,26,0,8,47
30,Success,54,23,4,10,44
30,Success,47,27,2,12,35
30,Success,51,27,0,12,39
30,Fail,41,30,1,18,23
30,Success,47,32,0,13,34
30,Success,55,20,0,11,44
30,Fail,42,29,3,14,28
30,Success,49,26,1,15,34
30,Success,48,30,4,11,37
30,Success,52,22,0,15,37
30,Fail,41,32,0,19,22
30,Success,53,26,0,8,45
30,Success,44,30,0,13,31
30,Success,48,25,0,13,35
30,Success,49,28,0,15,34
30,Success,46,35,0,5,41
30,Success,53,28,0,9,44
30,Success,52,21,5,11,41
30,Success,49,24,1,13,36
30,Success,53,27,0,11,42
30,Fail,43,30,8,14,29
30,Success,43,36,0,11,32
30,Success,48,23,6,11,37
30,Success,49,26,0,14,35
30,Success,51,25,0,12,39
30,Fail,39,31,5,12,27
30,Success,46,25,7,13,33
30,Success,51,17,7,12,39
30,Success,49,27,0,12,37
30,Success,47,25,3,11,36
30,Success,46,28,0,14,32
30,Success,49,30,1,8,41
30,Fail,46,23,2,17,29
30,Success,44,33,0,11,33
30,Fail,42,36,0,13,29
30,Success,45,36,0,11,34
30,Success,48,32,0,12,36
30,Success,50,17,3,15,35
30,Success,50,24,2,13,37
30,Success,48,27,3,11,37
30,Success,59,19,2,10,49
30,Success,50,27,0,11,39
30,Success,46,24,0,14,32
30,Fail,45,25,0,18,27
30,Success,51,29,3,7,44
30,Success,44,34,0,14,30
30,Fail,42,29,4,14,28
30,Fail,43,30,0,14,29
30,Success,48,28,0,14,34
30,Success,52,29,0,9,43
30,Fail,46,26,1,18,28
30,Success,51,22,4,10,41
30,Success,47,37,0,7,40
30,Success,50,25,1,13,37
30,Fail,47,18,4,20,27
30,Success,50,25,0,14,36
30,Success,52,25,0,10,42
30,Success,48,29,0,12,36
30,Success,42,41,0,8,34
30,Success,47,31,0,14,33
30,Fail,47,20,0,19,28
30,Success,49,26,1,14,35
30,Success,46,34,0,13,33
30,Success,53,27,0,11,42
30,Success,46,29,0,16,30
30,Success,50,31,0,9,41
30,Success,43,30,0,13,30
30,Success,49,25,3,14,35
30,Fail,46,29,0,18,28
30,Success,50,26,1,12,38
30,Fail,42,29,6,16,26
30,Success,45,23,5,15,30
30,Success,50,29,0,15,35
30,Success,43,39,0,10,33
30,Success,46,21,7,15,31
30,Fail,39,42,0,12,27
30,Success,48,30,0,11,37
30,Success,44,33,0,11,33
30,Success,55,15,5,15,40
30,Success,59,18,0,10,49
30,Success,53,19,0,18,35
30,Success,54,23,0,12,42
30,Success,50,29,0,8,42
30,Success,50,21,4,13,37
30,Success,47,27,2,12,35
30,Success,48,22,0,13,35
30,Success,50,24,2,13,37
30,Success,48,20,3,12,36
30,Success,53,22,1,12,41
30,Success,50,30,0,11,39
30,Success,55,20,0,10,45
30,Success,46,34,0,12,34
30,Success,45,28,5,14,31
30,Fail,42,36,0,13,29
30,Success,52,30,0,9,43
30,Success,48,21,5,13,35
30,Success,52,26,1,9,43
30,Success,49,23,0,14,35
30,Success,53,32,0,8,45
30,Success,61,13,0,14,47
30,Success,51,26,0,15,36
30,Success,48,26,0,14,34
30,Success,50,17,4,15,35
30,Success,53,23,0,13,40
30,Success,52,27,1,7,45
30,Success,47,33,0,10,37
30,Success,50,28,0,8,42
30,Success,49,25,0,16,33
30,Success,45,30,3,11,34
30,Success,42,35,0,12,30
30,Success,53,25,0,9,44
30,Success,50,21,2,12,38
30,Success,55,19,0,12,43
30,Success,51,30,4,8,43
30,Success,47,28,1,12,35
30,Success,45,30,4,10,35
30,Success,45,34,0,13,32
30,Success,51,22,6,13,38
30,Success,50,22,5,11,39
30,Success,49,24,4,13,36
30,Success,55,22,7,8,47
30,Success,53,24,0,9,44
30,Success,52,22,0,15,37
30,Success,51,18,1,20,31
30,Fail,42,33,3,13,29
30,Fail,41,32,5,13,28
30,Success,56,26,0,6,50
30,Success,56,18,1,11,45
30,Success,48,27,0,10,38
30,Success,47,27,7,12,35
30,Success,56,23,4,9,47
30,Fail,44,29,6,15,29
30,Fail,43,23,4,18,25
30,Success,48,26,0,14,34
30,Success,44,33,0,12,32
30,Fail,41,36,0,13,28
30,Success,54,19,0,16,38
30,Success,47,27,3,9,38
30,Success,55,22,0,12,43
30,Fail,38,34,8,9,29
30,Success,48,25,5,11,37
30,Success,53,27,0,10,43
30,Success,45,27,6,13,32
30,Success,43,33,0,13,30
30,Success,42,38,0,9,33
30,Success,49,31,1,6,43
30,Success,46,29,1,12,34
30,Success,51,21,9,12,39
30,Success,54,25,0,9,45
30,Success,56,25,3,5,51
30,Success,47,28,3,8,39
30,Success,46,29,0,13,33
30,Success,52,27,1,9,43
30,Success,45,27,0,11,34
30,Success,52,20,0,16,36
30,Success,49,21,12,12,37
30,Success,44,32,1,10,34
30,Success,47,32,0,13,34
30,Success,42,40,0,11,31
30,Fail,45,26,6,16,29
30,Success,46,26,5,14,32
30,Success,53,27,0,7,46
30,Fail,39,27,11,14,25
30,Success,57,19,0,11,46
30,Success,51,28,2,10,41
30,Fail,37,34,0,16,21
30,Success,53,17,9,11,42
30,Success,44,41,0,7,37
30,Success,44,33,0,13,31
30,Fail,35,30,0,21,14
30,Success,53,19,0,15,38
30,Success,53,17,0,14,39
30,Fail,34,32,14,13,21
30,Success,55,25,0,9,46
30,Success,52,22,0,13,39
30,Success,54,26,0,11,43
30,Success,55,15,1,13,42
30,Success,49,27,1,10,39
30,Success,47,23,0,17,30
30,Success,44,33,0,13,31
30,Success,53,22,5,5,48
30,Success,47,27,2,10,37
30,Fail,41,38,0,12,29
30,Success,47,28,4,12,35
30,Fail,41,33,0,15,26
30,Fail,45,23,5,16,29
30,Fail,45,18,6,20,25
30,Fail,43,26,2,15,28
30,Success,46,25,3,16,30
30,Fail,43,23,8,17,26
30,Success,49,22,0,13,36
30,Success,49,31,0,11,38
30,Success,56,20,2,13,43
30,Success,51,25,1,6,45
30,Success,53,25,0,11,42
30,Success,45,22,8,13,32
30,Success,50,19,0,15,35
30,Fail,38,36,0,13,25
30,Success,48,31,0,11,37
30,Success,47,27,3,15,32
30,Success,49,31,5,6,43
30,Success,46,27,0,13,33
30,Success,47,27,0,16,31
30,Success,47,27,0,14,33
30,Success,57,14,6,13,44
30,Success,45,29,6,9,36
30,Fail,40,31,1,17,23
30,Success,54,24,4,7,47
30,Success,53,27,3,7,46
30,Success,53,25,3,6,47
30,Success,47,32,0,12,35
30,Success,47,28,9,6,41
30,Fail,40,27,0,20,20
30,Fail,41,32,0,14,27
30,Success,53,17,1,18,35
30,Success,46,30,0,10,36
30,Success,56,19,8,11,45
30,Success,50,23,8,9,41
30,Success,54,28,0,9,45
30,Success,49,27,0,13,36
30,Success,52,31,0,10,42
30,Success,45,37,0,12,33
30,Fail,40,38,0,15,25
30,Success,45,26,4,13,32
30,Success,49,19,4,15,34
30,Success,55,23,0,9,46
30,Success,42,35,4,10,32
30,Success,54,23,0,12,42
30,Success,43,33,0,11,32
30,Success,46,34,0,9,37
30,Success,45,29,1,14,31
30,Success,46,25,5,15,31
30,Success,48,34,0,8,40
30,Success,55,20,4,10,45
30,Success,57,20,2,10,47
30,Success,52,32,0,8,44
30,Success,52,21,3,11,41
30,Success,50,23,0,15,35
30,Success,51,28,0,11,40
30,Success,52,23,0,15,37
30,Success,49,24,0,17,32
30,Success,47,34,0,8,39
30,Fail,42,30,0,17,25
30,Success,50,29,0,14,36
30,Success,51,22,4,14,37
30,Success,46,31,4,10,36
30,Fail,44,34,0,16,28
30,Success,45,29,0,12,33
30,Success,45,32,0,14,31
30,Success,51,30,0,11,40
30,Success,48,29,0,16,32
30,Fail,44,25,5,16,28
30,Success,48,24,6,13,35
30,Success,48,21,6,13,35
30,Success,53,23,0,10,43
30,Success,49,30,0,13,36
30,Success,48,33,0,14,34
30,Fail,42,33,0,19,23
30,Fail,42,28,0,21,21
30,Success,49,23,4,14,35
30,Fail,42,28,0,20,22
30,Fail,41,28,0,17,24
30,Success,49,18,2,13,36
30,Fail,41,29,9,13,28
30,Success,47,28,4,11,36
30,Success,50,32,0,7,43
30,Success,54,19,5,11,43
30,Success,49,32,0,12,37
30,Success,46,29,0,13,33
30,Fail,38,38,0,14,24
30,Success,50,25,0,11,39
30,Fail,43,31,5,15,28
30,Fail,39,32,10,14,25
30,Success,50,31,0,10,40
30,Success,48,27,4,12,36
30,Success,47,34,0,11,36
30,Success,49,27,5,8,41
30,Success,47,20,6,14,33
30,Success,58,22,0,9,49
30,Success,54,16,1,16,38
30,Success,50,21,5,16,34
30,Success,48,26,0,16,32
30,Fail,41,31,6,12,29
30,Fail,42,30,1,15,27
30,Success,46,31,0,8,38
30,Success,45,26,3,11,34
30,Success,54,20,0,12,42
30,Success,51,29,0,10,41
30,Success,54,13,3,14,40
30,Success,45,32,0,14,31
30,Fail,44,29,0,20,24
30,Success,45,35,0,12,33
30,Success,48,31,0,8,40
30,Success,49,20,3,19,30
30,Success,56,25,0,8,48
30,Success,46,24,7,14,32
30,Success,44,25,9,14,30
30,Success,49,28,0,10,39
30,Success,52,20,5,14,38
30,Fail,41,34,0,13,28
30,Success,46,28,0,14,32
30,Fail,42,30,3,14,28
30,Success,49,27,0,15,34
30,Fail,45,29,0,18,27
30,Fail,39,29,3,15,24
30,Success,53,20,8,11,42
30,Success,54,24,0,12,42
30,Success,55,14,3,18,37
30,Success,43,35,4,8,35
30,Success,46,29,1,13,33
30,Success,45,34,0,11,34
30,Success,51,27,1,9,42
30,Success,51,20,2,10,41
30,Success,51,20,0,14,37
30,Success,51,27,0,8,43
30,Fail,40,26,5,22,18
30,Success,46,28,5,14,32
30,Success,50,29,0,9,41
30,Success,46,27,5,12,34
30,Fail,43,28,5,16,27
30,Success,45,33,0,14,31
30,Fail,44,31,0,18,26
30,Success,53,35,0,4,49
30,Success,47,28,6,10,37
30,Success,43,28,5,12,31
30,Success,49,22,0,14,35
30,Success,55,17,2,15,40
30,Success,51,27,0,9,42
30,Success,48,26,4,10,38
30,Success,45,34,0,12,33
30,Success,48,20,1,16,32
30,Success,48,21,10,14,34
30,Success,45,37,0,9,36
30,Success,46,30,0,12,34
30,Success,53,25,2,12,41
30,Success,49,26,0,17,32
30,Success,52,20,3,13,39
30,Success,43,32,1,10,33
30,Success,52,27,0,10,42
30,Success,48,27,0,16,32
30,Fail,45,24,4,16,29
30,Success,47,28,0,14,33
30,Success,48,34,0,10,38
30,Fail,39,32,8,10,29
30,Success,47,27,1,12,35
30,Success,44,29,1,12,32
30,Success,45,30,0,14,31
30,Success,43,40,0,10,33
30,Success,51,27,3,8,43
30,Success,51,21,0,12,39
30,Success,54,25,0,10,44
30,Fail,42,33,0,15,27
30,Success,48,20,5,16,32
30,Success,53,19,2,11,42
30,Success,51,24,2,16,35
30,Fail,42,40,0,13,29
30,Fail,37,26,9,21,16
30,Success,47,23,3,14,33
30,Success,48,31,0,10,38
30,Success,51,24,0,13,38
30,Success,48,19,8,17,31
30,Success,45,29,0,14,31
30,Success,50,28,0,15,35
30,Success,49,31,7,9,40
30,Fail,47,26,0,18,29
30,Success,46,37,0,9,37
30,Success,45,35,0,12,33
30,Success,48,26,2,12,36
30,Success,52,20,0,15,37
30,Success,56,19,2,11,45
30,Success,48,23,7,14,34
30,Fail,36,36,0,17,19
30,Success,54,19,0,15,39
30,Success,47,25,6,11,36
30,Fail,42,35,0,17,25
30,Success,54,17,4,15,39
30,Success,46,23,6,15,31
30,Success,47,21,11,13,34
30,Success,45,32,4,9,36
30,Success,50,31,0,11,39
30,Success,49,39,0,7,42
30,Success,46,24,9,10,36
30,Success,50,26,0,11,39
30,Success,46,27,4,12,34
30,Success,47,28,0,11,36
30,Fail,46,28,0,17,29
30,Success,47,27,0,17,30
30,Success,44,26,10,14,30
30,Fail,46,24,0,20,26
30,Success,54,18,0,14,40
30,Success,49,28,8,7,42
30,Success,46,38,0,9,37
30,Fail,47,24,0,19,28
30,Success,50,25,0,16,34
30,Success,50,23,0,14,36
30,Fail,46,22,0,17,29
30,Success,50,22,3,13,37
30,Fail,44,31,0,17,27
30,Success,46,29,3,11,35
30,Success,56,16,4,9,47
30,Success,47,22,9,14,33
30,Success,47,28,4,12,35
30,Success,53,22,4,15,38
30,Success,48,30,0,12,36
30,Success,46,30,2,15,31
30,Success,57,20,4,7,50
30,Success,49,26,5,9,40
30,Success,55,18,0,16,39
30,Success,60,23,2,7,53
30,Success,50,30,0,13,37
30,Success,51,26,3,7,44
30,Success,50,26,1,8,42
30,Success,49,19,9,14,35
30,Success,44,36,0,10,34
30,Fail,42,33,0,15,27
30,Success,41,36,2,8,33
30,Success,52,18,0,14,38
30,Success,46,26,1,13,33
30,Success,45,25,4,14,31
30,Success,51,28,6,9,42
30,Success,43,25,7,10,33
30,Success,43,34,0,12,31
30,Success,50,28,0,16,34
30,Success,49,29,0,10,39
30,Fail,44,27,0,19,25
30,Success,54,25,1,9,45
30,Success,48,24,5,14,34
30,Success,55,19,5,12,43
30,Success,45,36,0,12,33
30,Success,52,15,7,13,39
30,Success,43,35,0,13,30
30,Success,53,22,0,11,42
30,Fail,41,34,0,16,25
30,Success,50,21,1,15,35
30,Success,53,24,4,8,45
30,Success,47,28,5,9,38
30,Success,49,26,0,16,33
30,Success,52,20,4,13,39
30,Success,51,35,0,6,45
30,Success,53,27,0,10,43
30,Fail,42,34,0,13,29
30,Success,46,26,1,16,30
30,Fail,43,22,7,16,27
30,Fail,45,27,0,18,27
30,Success,45,36,2,8,37
30,Success,59,21,0,12,47
30,Success,49,27,0,15,34
30,Success,46,29,0,16,30
30,Success,45,32,7,9,36
30,Success,50,18,5,14,36
30,Success,51,36,0,3,48
30,Fail,43,23,8,21,22
30,Success,54,28,1,5,49
30,Success,51,23,2,11,40
30,Success,54,26,0,10,44
30,Success,50,32,0,5,45
30,Fail,40,35,8,11,29
30,Success,46,27,0,12,34
30,Fail,38,43,0,11,27
30,Success,51,25,0,16,35
30,Success,56,24,0,10,46
30,Success,47,22,4,16,31
30,Success,50,19,0,20,30
30,Success,47,19,7,16,31
30,Success,56,20,2,10,46
30,Success,47,26,1,17,30
30,Fail,42,38,0,13,29
30,Success,53,22,3,12,41
30,Success,57,20,0,9,48
30,Success,52,24,0,14,38
30,Success,46,32,0,11,35
30,Success,46,25,0,14,32
30,Success,52,24,2,10,42
30,Success,51,27,0,13,38
30,Success,45,26,4,15,30
30,Success,55,24,0,9,46
30,Success,54,16,1,17,37
30,Success,54,20,1,13,41
30,Success,48,29,0,12,36
30,Success,48,26,2,16,32
30,Success,56,23,2,7,49
30,Success,48,25,2,15,33
30,Success,50,20,2,14,36
30,Fail,38,36,7,9,29
30,Success,49,30,0,10,39
30,Success,47,30,0,14,33
30,Success,41,38,0,10,31
30,Success,56,19,3,11,45
30,Success,49,32,0,6,43
30,Success,52,29,0,6,46
30,Fail,42,28,0,18,24
30,Success,47,27,1,12,35
30,Success,52,27,0,12,40
30,Success,50,24,0,14,36
30,Success,55,19,4,11,44
30,Success,49,25,0,15,34
30,Success,53,18,3,17,36
30,Success,49,19,3,19,30
30,Success,49,24,5,14,35
30,Fail,44,23,1,23,21
30,Fail,41,27,4,18,23
30,Success,51,23,1,11,40
30,Success,50,31,1,9,41
30,Success,49,34,0,6,43
30,Success,48,21,2,16,32
30,Success,50,26,2,10,40
30,Success,43,41,0,10,33
30,Success,46,30,0,10,36
30,Success,46,19,4,16,30
30,Success,50,25,0,15,35
30,Success,47,31,0,12,35
30,Success,54,17,2,12,42
30,Success,52,26,0,13,39
30,Success,50,21,2,15,35
30,Success,44,34,0,10,34
30,Success,46,32,0,15,31
30,Success,49,30,0,12,37
30,Success,50,23,6,11,39
30,Success,48,26,6,11,37
30,Success,46,30,0,12,34
30,Success,48,30,2,9,39
30,Success,49,27,1,14,35
30,Success,49,33,0,10,39
30,Success,50,30,0,12,38
30,Success,43,28,8,12,31
30,Fail,42,27,2,16,26
30,Success,53,22,0,15,38
30,Success,53,24,4,13,40
30,Success,47,26,2,9,38
30,Fail,45,21,5,19,26
30,Success,57,19,2,13,44
30,Success,46,25,10,8,38
30,Fail,48,20,6,19,29
30,Fail,40,33,3,11,29
30,Success,48,27,0,12,36
30,Success,46,35,1,11,35
30,Success,47,34,0,7,40
30,Fail,41,27,7,14,27
30,Fail,48,21,4,19,29
30,Success,45,23,8,14,31
30,Fail,47,22,6,18,29
30,Success,46,28,0,16,30
30,Success,54,29,0,11,43
30,Fail,40,41,0,11,29
30,Success,51,22,2,18,33
30,Success,54,18,5,13,41
30,Success,51,23,0,15,36
30,Success,50,26,6,10,40
30,Success,50,20,2,15,35
30,Fail,40,29,11,12,28
30,Success,49,28,0,16,33
30,Success,55,19,5,7,48
30,Fail,44,27,4,17,27
30,Success,48,31,0,11,37
30,Success,49,32,0,11,38
30,Success,48,24,0,15,33
30,Success,55,21,0,12,43
30,Success,43,30,1,13,30
30,Success,47,22,4,14,33
30,Success,61,19,1,9,52
30,Success,49,33,0,8,41
30,Success,43,37,0,12,31
30,Success,45,30,0,14,31
30,Success,57,17,3,10,47
30,Success,54,19,3,10,44
30,Success,51,22,3,15,36
30,Fail,45,27,3,16,29
30,Success,52,26,1,10,42
30,Success,50,32,3,7,43
30,Success,42,32,6,10,32
30,Success,52,30,2,6,46
30,Success,53,24,0,10,43
30,Success,50,23,2,13,37
30,Success,57,20,6,11,46
30,Success,43,40,0,8,35
30,Success,54,25,0,6,48
30,Success,52,21,0,11,41
30,Success,55,19,0,12,43
30,Success,48,23,2,15,33
30,Fail,42,29,0,17,25
30,Success,52,24,0,10,42
30,Success,50,23,0,17,33
30,Success,47,29,2,17,30
30,Success,53,28,0,9,44
30,Success,46,25,2,13,33
30,Success,46,34,1,9,37
30,Success,45,29,0,14,31
30,Success,50,27,0,11,39
30,Success,50,25,5,7,43
30,Success,54,18,4,15,39
30,Success,56,22,0,8,48
30,Success,48,31,0,8,40
30,Fail,40,38,0,12,28
30,Success,50,28,0,12,38
30,Success,48,31,0,10,38
30,Success,56,23,0,11,45
30,Success,57,25,0,9,48
30,Success,57,20,0,10,47
30,Success,48,25,0,16,32
30,Success,50,21,7,12,38
30,Success,44,28,4,12,32
30,Fail,43,22,5,15,28
30,Success,51,26,0,9,42
30,Success,53,29,0,9,44
30,Success,44,29,3,13,31
30,Success,55,19,0,14,41
30,Success,48,25,4,10,38
30,Success,53,22,6,12,41
30,Success,54,26,0,9,45
30,Success,51,20,0,17,34
30,Success,44,35,0,11,33
30,Success,55,22,0,13,42
30,Success,49,29,4,7,42
30,Success,45,30,3,14,31
30,Success,50,31,0,11,39
30,Success,48,33,0,8,40
30,Success,53,30,0,10,43
30,Fail,41,30,4,14,27
30,Success,46,38,0,9,37
30,Success,46,27,9,12,34
30,Success,53,27,5,6,47
30,Success,47,31,1,8,39
30,Success,47,29,4,8,39
30,Success,48,25,0,14,34
30,Success,54,29,0,9,45
30,Success,51,25,0,12,39
30,Success,46,28,3,10,36
30,Success,54,27,1,11,43
30,Success,48,30,0,14,34
30,Success,59,17,6,11,48
30,Success,54,29,0,3,51
30,Fail,42,30,5,16,26
30,Success,45,39,0,8,37
30,Fail,43,30,0,14,29
30,Success,49,31,0,13,36
30,Fail,44,34,0,15,29
30,Success,52,27,0,8,44
30,Success,54,21,0,9,45
30,Success,46,30,0,9,37
30,Fail,44,30,1,16,28
30,Fail,38,28,10,13,25
30,Fail,39,36,0,21,18
30,Success,53,28,0,8,45
30,Success,47,29,0,11,36
30,Success,50,19,8,11,39
30,Success,48,34,5,5,43
30,Success,52,22,3,15,37
30,Fail,43,23,2,16,27
30,Success,49,30,0,10,39
30,Fail,41,31,0,16,25
30,Success,48,28,4,10,38
30,Success,49,25,0,15,34
30,Success,52,26,0,11,41
30,Success,50,28,0,13,37
30,Success,57,22,0,11,46
30,Success,51,23,1,11,40
30,Fail,45,26,0,16,29
30,Success,49,32,0,9,40
30,Success,51,29,0,7,44
30,Success,44,32,0,13,31
30,Success,49,31,0,10,39
30,Success,49,26,2,11,38
30,Success,46,22,3,15,31
30,Success,46,28,0,15,31
30,Success,47,31,4,11,36
30,Success,45,25,10,13,32
30,Success,50,25,1,11,39
30,Success,50,28,0,12,38
30,Success,58,22,4,10,48
30,Success,49,30,0,13,36
30,Success,46,28,9,11,35
30,Success,52,28,1,9,43
30,Success,44,28,0,14,30
30,Success,46,32,0,13,33
30,Fail,44,28,0,15,29
30,Fail,44,33,0,17,27
30,Success,45,27,7,9,36
30,Success,58,19,0,14,44
30,Success,44,38,0,11,33
30,Success,49,28,0,16,33
30,Fail,44,33,0,15,29
30,Fail,40,28,5,16,24
30,Success,48,33,0,11,37
30,Success,54,22,2,11,43
30,Success,55,24,0,7,48
30,Fail,48,20,2,19,29
30,Success,44,27,3,14,30
30,Fail,45,25,1,16,29
30,Success,52,23,0,15,37
30,Success,46,24,7,12,34
30,Success,49,28,0,12,37
30,Success,47,29,0,13,34
30,Success,41,41,0,11,30
30,Success,44,30,0,14,30
30,Success,52,21,0,14,38
30,Success,47,32,0,12,35
30,Success,46,26,10,10,36
30,Success,49,24,0,12,37
30,Success,54,27,2,8,46
30,Success,52,24,0,13,39
30,Success,49,33,0,10,39
30,Fail,41,27,7,19,22
30,Success,49,29,0,12,37
30,Success,49,27,6,7,42
30,Success,49,23,2,14,35
30,Success,52,27,0,12,40
30,Success,49,33,0,10,39
30,Success,46,30,0,10,36
30,Success,46,26,14,9,37
30,Success,55,21,0,10,45
30,Success,45,30,0,13,32
30,Success,50,28,0,10,40
30,Success,56,24,2,9,47
30,Success,46,34,0,12,34
30,Success,48,30,0,15,33
30,Success,47,23,3,12,35
30,Fail,38,34,3,15,23
30,Success,46,28,5,8,38
30,Success,51,29,0,5,46
30,Success,52,30,0,5,47
30,Success,58,17,2,11,47
30,Success,43,38,0,8,35
30,Success,51,24,0,15,36
30,Success,49,24,0,15,34
30,Success,57,23,0,9,48
30,Success,46,27,0,14,32
30,Success,49,22,6,13,36
30,Fail,44,28,0,16,28
30,Success,48,29,0,10,38
30,Success,51,29,0,10,41
30,Success,48,38,0,9,39
30,Success,47,21,1,16,31
30,Success,46,26,3,12,34
30,Success,51,27,0,12,39
30,Success,49,29,4,9,40
30,Success,56,20,0,12,44
30,Success,52,25,6,7,45
30,Success,50,32,0,10,40
30,Success,46,25,6,14,32
30,Success,48,31,0,10,38
30,Success,49,28,0,13,36
30,Success,53,21,2,12,41
30,Success,57,21,0,9,48
30,Success,44,37,0,11,33
30,Success,53,22,0,16,37
30,Success,53,24,0,13,40
30,Success,50,32,0,10,40
30,Success,48,27,0,14,34
30,Success,51,30,0,10,41
30,Success,54,20,10,7,47
30,Fail,44,23,6,16,28
30,Success,45,31,1,10,35
30,Success,48,25,0,16,32
30,Success,55,16,6,15,40
30,Success,45,26,5,14,31
30,Success,45,21,3,14,31
30,Success,44,32,0,13,31
30,Fail,42,26,1,19,23
30,Success,52,17,2,16,36
30,Success,49,24,0,14,35
30,Success,49,27,4,9,40
30,Success,49,23,2,15,34
30,Success,50,23,3,13,37
30,Success,52,15,4,16,36
30,Success,47,25,4,15,32
30,Success,45,31,0,12,33
30,Success,47,26,3,16,31
30,Fail,43,23,4,16,27
30,Fail,44,31,0,18,26
30,Success,53,25,2,9,44
30,Success,46,28,10,8,38
30,Success,46,28,0,12,34
30,Fail,44,25,4,16,28
30,Success,56,25,0,8,48
30,Success,45,37,0,9,36
30,Success,54,21,1,12,42
30,Fail,39,35,0,17,22
30,Success,49,28,0,16,33
30,Success,50,23,1,12,38
30,Success,49,28,0,11,38
30,Fail,35,39,0,17,18
30,Success,48,29,3,10,38
30,Success,52,24,5,11,41
30,Success,57,25,0,11,46
30,Success,43,24,10,13,30
30,Success,45,34,0,10,35
30,Success,51,28,0,9,42
30,Fail,46,25,1,18,28
30,Success,48,32,0,11,37
30,Fail,42,34,1,13,29
30,Success,51,21,3,14,37
30,Success,52,19,0,17,35
30,Success,49,21,0,18,31
30,Fail,46,23,4,17,29
30,Success,47,39,0,4,43
30,Success,47,24,3,13,34
30,Fail,45,27,4,16,29
30,Success,50,22,3,14,36
30,Fail,38,36,0,16,22
30,Success,48,25,6,7,41
30,Success,49,25,4,12,37
30,Success,45,26,2,13,32
30,Success,56,23,3,6,50
30,Success,54,19,1,16,38
30,Success,47,25,0,16,31
30,Success,53,27,0,13,40
30,Success,46,25,8,13,33
30,Fail,43,30,3,14,29
30,Fail,35,36,0,17,18
30,Success,51,22,0,13,38
30,Success,45,28,5,9,36
30,Fail,43,36,0,14,29
30,Fail,41,28,0,19,22
30,Success,53,22,0,12,41
30,Fail,43,24,8,15,28
30,Success,55,31,0,4,51
30,Success,52,21,4,13,39
30,Fail,44,28,0,17,27
30,Success,57,15,6,13,44
30,Fail,39,31,7,12,27
30,Fail,42,33,0,13,29
30,Fail,39,36,0,17,22
30,Success,46,24,0,16,30
30,Success,50,26,4,11,39
30,Success,57,20,4,5,52
30,Success,54,27,3,8,46
30,Fail,41,31,1,18,23
30,Success,54,22,0,15,39
30,Fail,46,23,4,18,28
30,Success,52,24,1,12,40
30,Success,45,29,0,14,31
30,Fail,40,33,0,18,22
30,Fail,46,24,0,18,28
30,Success,45,35,0,12,33
30,Success,54,25,0,10,44
30,Success,48,27,0,13,35
30,Success,51,25,4,10,41
30,Success,48,32,3,5,43
30,Success,52,28,0,7,45
30,Success,55,20,4,13,42
30,Success,46,26,9,11,35
30,Success,46,23,3,16,30
30,Success,50,33,0,8,42
30,Success,44,35,0,10,34
30,Fail,42,31,3,14,28
30,Success,50,32,0,9,41
30,Success,44,33,0,12,32
30,Success,49,37,0,5,44
30,Fail,39,37,0,12,27
30,Success,50,19,3,14,36
30,Success,47,32,0,9,38
30,Success,53,18,1,15,38
30,Success,46,28,0,12,34
30,Success,48,23,7,16,32
30,Success,46,29,9,8,38
30,Success,53,25,0,13,40
30,Success,54,24,0,12,42
30,Success,45,22,8,14,31
30,Success,48,25,2,13,35
30,Success,46,26,12,9,37
30,Success,47,29,1,16,31
30,Fail,45,27,0,16,29
30,Success,51,24,2,14,37
30,Success,57,22,0,10,47
30,Success,48,18,11,14,34
30,Success,49,25,3,12,37
30,Success,55,18,1,11,44
30,Success,49,26,1,16,33
30,Success,56,17,1,14,42
30,Fail,43,32,0,14,29
30,Fail,43,29,6,15,28
30,Success,48,29,0,11,37
30,Success,48,29,0,17,31
30,Success,51,23,1,14,37
30,Success,46,28,0,15,31
30,Success,51,26,5,8,43
30,Success,45,25,6,12,33
30,Success,47,32,3,10,37
30,Success,50,21,0,15,35
30,Success,49,31,0,12,37
30,Success,46,28,0,13,33
30,Success,51,27,0,11,40
30,Success,49,25,0,15,34
30,Fail,42,29,0,20,22
30,Success,50,21,6,11,39
30,Success,45,29,5,11,34
30,Success,50,27,3,13,37
30,Success,54,25,4,6,48
30,Success,45,27,0,14,31
30,Success,44,38,0,10,34
30,Fail,43,29,2,14,29
30,Success,48,28,2,10,38
30,Success,52,22,6,12,40
30,Fail,44,25,1,18,26
30,Fail,41,25,10,15,26
30,Success,52,25,0,9,43
30,Success,47,28,0,15,32
30,Success,51,28,0,10,41
30,Success,51,23,6,9,42
30,Success,49,28,0,12,37
30,Success,50,32,2,7,43
30,Fail,39,29,7,17,22
30,Fail,40,30,5,13,27
30,Success,46,27,4,12,34
30,Success,48,22,0,18,30
30,Success,48,27,2,13,35
30,Success,51,23,0,14,37
30,Success,48,23,0,16,32
30,Success,44,38,0,11,33
30,Success,47,35,0,8,39
30,Success,41,42,0,10,31
30,Fail,39,31,8,13,26
30,Success,49,23,2,17,32
30,Success,51,24,3,9,42
30,Success,47,21,0,17,30
30,Success,54,20,4,12,42
30,Success,46,26,3,10,36
30,Success,49,27,0,17,32
30,Success,42,40,0,11,31
30,Success,54,21,2,11,43
30,Success,44,31,0,13,31
30,Success,46,26,4,12,34
30,Success,50,31,0,8,42
30,Success,47,28,0,13,34
30,Success,39,43,0,7,32
30,Success,59,24,0,8,51
30,Fail,45,22,9,16,29
30,Success,46,29,5,6,40
30,Success,51,25,1,12,39
30,Success,50,28,0,12,38
30,Success,48,27,0,16,32
30,Success,52,22,4,11,41
30,Success,58,16,1,11,47
30,Success,44,30,0,13,31
30,Success,48,25,1,15,33
30,Success,54,25,1,10,44
30,Success,47,25,5,16,31
30,Success,45,31,0,13,32
30,Fail,49,18,2,21,28
30,Success,52,25,2,11,41
30,Success,52,23,5,10,42
30,Success,46,23,2,16,30
30,Fail,43,30,0,15,28
30,Success,51,32,0,8,43
30,Fail,42,34,0,15,27
30,Success,45,31,2,12,33
30,Success,50,25,2,9,41
30,Success,48,23,5,11,37
30,Success,49,24,5,13,36
30,Success,52,26,5,9,43
30,Success,49,27,0,11,38
30,Success,46,22,9,14,32
30,Fail,41,28,8,13,28
30,Success,46,27,5,12,34
30,Success,46,34,0,15,31
30,Success,47,31,2,10,37
30,Success,56,26,0,6,50
30,Success,45,28,8,7,38
30,Success,49,27,1,15,34
30,Success,50,24,7,7,43
30,Fail,45,22,6,16,29
30,Success,43,29,0,13,30
30,Success,45,38,0,10,35
30,Success,49,26,1,14,35
30,Success,55,22,0,9,46
30,Success,50,24,6,12,38
30,Success,48,29,6,7,41
30,Success,46,25,4,13,33
30,Success,44,27,9,13,31
30,Success,44,39,0,9,35
30,Success,48,28,0,12,36
30,Success,46,28,3,11,35
30,Success,50,25,0,12,38
30,Success,48,23,8,11,37
30,Success,49,32,0,9,40
30,Fail,40,28,7,15,25
30,Success,57,24,0,11,46
30,Success,47,26,8,10,37
30,Success,52,27,2,8,44
30,Success,47,26,2,10,37
30,Fail,43,28,3,18,25
30,Fail,42,39,0,14,28
30,Success,46,35,0,13,33
30,Fail,40,25,8,20,20
30,Success,53,20,1,15,38
30,Success,46,22,8,16,30
30,Fail,40,33,4,15,25
30,Success,52,25,0,12,40
30,Success,50,27,0,11,39
30,Success,49,19,4,12,37
30,Success,53,27,1,7,46
30,Success,48,33,0,11,37
30,Success,50,24,5,12,38
30,Fail,37,32,0,21,16
30,Success,53,20,2,13,40
30,Success,47,30,0,15,32
30,Success,48,27,3,14,34
30,Fail,43,30,0,15,28
30,Success,54,27,0,11,43
30,Success,55,19,8,8,47
30,Success,48,24,4,14,34
30,Success,54,25,5,5,49
30,Success,47,26,7,10,37
30,Success,50,26,0,14,36
30,Success,46,26,9,9,37
30,Success,49,23,3,15,34
30,Fail,45,21,5,19,26
30,Success,54,18,6,10,44
30,Success,53,23,0,8,45
30,Success,47,27,3,11,36
30,Success,51,28,2,5,46
30,Success,54,22,1,15,39
30,Success,52,18,3,15,37
30,Fail,43,31,0,15,28
30,Success,55,21,0,13,42
30,Success,54,22,1,10,44
30,Success,53,24,1,15,38
30,Success,46,33,0,15,31
30,Success,50,29,0,11,39
30,Success,47,33,0,12,35
30,Success,50,29,0,8,42
30,Success,47,24,11,10,37
30,Success,52,22,4,11,41
30,Success,47,32,2,9,38
30,Success,53,25,1,11,42
30,Success,45,30,0,14,31
30,Success,49,31,3,3,46
30,Success,47,30,0,15,32
30,Success,50,24,2,9,41
30,Success,46,28,1,12,34
30,Fail,41,26,8,12,29
30,Success,50,22,0,14,36
30,Success,50,22,0,14,36
30,Success,48,29,0,10,38
30,Success,54,21,0,12,42
30,Success,50,27,1,10,40
30,Success,49,28,4,9,40
30,Success,44,32,5,11,33
30,Success,47,28,0,13,34
30,Success,48,29,4,11,37
30,Success,46,25,6,12,34
30,Fail,41,25,13,12,29
30,Success,50,26,0,11,39
30,Fail,41,39,0,14,27
30,Success,52,24,0,12,40
30,Success,44,28,6,13,31
30,Success,50,20,5,10,40
30,Fail,41,30,4,16,25
30,Success,51,28,5,5,46
30,Success,54,27,0,7,47
30,Success,45,30,0,15,30
30,Success,52,23,1,15,37
30,Fail,41,28,5,17,24
30,Success,51,18,5,16,35
30,Success,51,23,0,17,34
30,Fail,47,19,3,20,27
30,Success,51,26,0,10,41
30,Success,48,22,5,13,35
30,Success,45,32,0,11,34
30,Success,53,24,3,6,47
30,Success,45,37,0,12,33
30,Success,48,30,2,10,38
30,Fail,42,25,3,17,25
30,Success,45,32,0,12,33
30,Success,47,30,0,10,37
30,Success,53,23,4,10,43
30,Success,48,31,0,9,39
30,Success,50,27,0,13,37
30,Success,46,31,0,11,35
30,Success,57,18,2,11,46
30,Fail,44,28,0,18,26
30,Success,50,20,11,14,36
30,Success,46,30,0,9,37
30,Success,49,24,0,15,34
30,Success,47,30,0,14,33
30,Success,51,24,1,12,39
30,Success,60,20,0,13,47
30,Success,44,26,0,14,30
30,Success,47,28,0,12,35
30,Success,48,32,3,12,36
30,Success,47,33,1,9,38
30,Success,47,27,5,14,33
30,Fail,41,36,0,14,27
30,Success,52,22,3,12,40
30,Success,54,17,0,16,38
30,Success,44,32,4,14,30
30,Success,47,29,0,16,31
30,Success,51,23,0,17,34
30,Success,43,35,0,12,31
30,Success,44,36,0,11,33
30,Success,50,23,0,15,35
30,Success,54,22,3,12,42
30,Success,45,34,0,13,32
30,Success,45,29,0,12,33
30,Success,52,30,4,6,46
30,Success,43,29,5,11,32
30,Success,50,30,0,16,34
30,Success,50,24,0,12,38
30,Success,52,25,1,10,42
30,Success,48,24,1,14,34
30,Success,48,24,5,13,35
30,Fail,42,21,0,26,16
30,Success,45,43,0,8,37
30,Success,44,39,0,9,35
30,Success,49,32,0,11,38
30,Success,46,31,0,15,31
30,Success,52,22,0,16,36
30,Success,50,20,0,18,32
30,Success,50,23,2,16,34
30,Fail,40,40,0,14,26
30,Success,46,25,0,14,32
30,Success,53,20,6,14,39
30,Fail,42,41,0,13,29
30,Success,51,26,9,7,44
30,Success,50,20,10,10,40
30,Success,47,30,0,15,32
30,Success,44,27,5,12,32
30,Success,57,18,0,13,44
30,Success,48,21,8,14,34
30,Success,45,24,9,13,32
30,Success,52,25,2,11,41
30,Success,45,39,0,10,35
30,Success,46,34,0,11,35
30,Fail,43,34,0,14,29
30,Fail,45,30,0,17,28
30,Success,47,27,5,10,37
30,Success,48,28,0,13,35
30,Success,53,27,0,12,41
30,Success,52,26,1,9,43
30,Fail,39,34,0,17,22
30,Success,44,29,0,13,31
30,Fail,42,25,1,23,19
30,Success,49,25,0,15,34
30,Fail,37,38,0,18,19
30,Success,47,29,1,11,36
30,Fail,46,25,1,19,27
30,Success,52,22,0,11,41
30,Fail,41,30,0,18,23
30,Success,51,27,1,11,40
30,Success,46,26,4,15,31
30,Success,48,28,0,13,35
30,Success,45,30,0,13,32
30,Success,58,19,0,6,52
30,Success,45,30,5,10,35
30,Success,53,25,0,11,42
30,Success,48,25,6,12,36
30,Success,45,29,3,13,32
30,Success,49,26,3,10,39
30,Success,58,20,3,8,50
30,Fail,41,37,0,14,27
30,Success,44,26,0,14,30
30,Success,43,34,4,10,33
30,Success,50,21,9,13,37
30,Success,48,23,0,15,33
30,Success,52,29,0,10,42
30,Success,47,28,2,7,40
30,Fail,38,34,5,14,24
30,Success,44,28,4,10,34
30,Fail,41,35,0,15,26
30,Fail,44,22,0,22,22
30,Success,50,22,1,14,36
30,Success,48,21,6,17,31
30,Success,52,25,0,8,44
30,Success,50,21,0,16,34
30,Success,50,23,4,10,40
30,Success,44,30,0,13,31
30,Success,50,20,2,14,36
30,Success,45,34,0,13,32
30,Fail,39,30,0,21,18
30,Success,47,26,0,13,34
30,Fail,41,27,9,15,26
30,Success,52,17,8,14,38
30,Fail,38,30,7,15,23
30,Success,45,33,0,10,35
30,Success,51,23,1,13,38
30,Success,44,29,0,11,33
30,Success,49,28,0,13,36
30,Success,49,25,3,11,38
30,Success,48,33,0,7,41
30,Success,54,23,0,14,40
30,Fail,47,24,0,19,28
30,Success,46,28,0,11,35
30,Success,53,27,0,13,40
30,Fail,38,31,3,18,20
30,Success,58,21,0,7,51
30,Success,49,31,0,15,34
30,Fail,46,24,0,17,29
30,Success,42,38,0,9,33
30,Success,46,35,0,11,35
30,Success,47,31,0,13,34
30,Success,48,33,0,10,38
30,Fail,43,27,5,16,27
30,Success,52,21,0,14,38
30,Success,56,21,1,11,45
30,Success,44,27,0,14,30
30,Success,56,16,0,17,39
30,Fail,40,32,4,18,22
30,Success,48,34,0,9,39
30,Fail,40,32,7,12,28
30,Success,53,24,0,12,41
30,Success,50,31,0,10,40
30,Success,51,25,1,14,37
30,Success,53,28,0,12,41
30,Success,62,11,2,12,50
30,Success,49,23,4,13,36
30,Success,51,19,5,14,37
30,Fail,46,24,6,17,29
30,Success,44,27,6,13,31
30,Success,48,31,0,9,39
30,Success,53,21,2,15,38
30,Success,48,28,0,12,36
30,Success,44,24,8,12,32
30,Success,47,32,0,10,37
30,Success,50,23,0,14,36
30,Success,57,23,2,9,48
30,Success,50,16,9,19,31
30,Success,49,25,0,16,33
30,Fail,33,44,0,16,17
30,Success,53,24,2,11,42
30,Success,55,21,0,11,44
30,Success,52,19,4,12,40
30,Success,48,28,0,15,33
30,Success,52,35,0,9,43
30,Success,47,31,0,14,33
30,Success,48,29,0,13,35
30,Fail,45,28,0,17,28
30,Success,49,27,2,11,38
30,Success,52,25,0,12,40
30,Success,42,34,0,10,32
30,Success,52,25,1,9,43
30,Success,57,13,6,16,41
30,Success,51,27,4,9,42
30,Fail,34,33,7,17,17
30,Success,51,28,0,11,40
30,Success,50,30,0,12,38
30,Success,51,22,0,16,35
30,Success,46,30,6,13,33
30,Success,43,34,0,12,31
30,Success,49,22,0,11,38
30,Success,53,24,3,8,45
30,Success,42,29,7,12,30
30,Success,42,27,8,10,32
30,Success,52,28,0,12,40
30,Success,50,25,7,10,40
30,Fail,39,32,0,19,20
30,Success,45,36,0,11,34
30,Success,51,30,0,10,41
30,Success,54,21,9,6,48
30,Success,55,19,2,12,43
30,Success,45,32,0,12,33
30,Success,53,25,0,9,44
30,Success,45,35,0,14,31
30,Success,46,28,2,13,33
30,Success,52,20,5,15,37
30,Success,51,27,0,11,40
30,Success,50,20,0,16,34
30,Success,45,30,5,7,38
30,Success,47,28,0,17,30
30,Success,52,24,1,10,42
30,Success,51,20,10,9,42
30,Success,45,42,0,10,35
30,Success,47,26,7,11,36
30,Success,45,29,7,10,35
30,Success,47,30,0,12,35
30,Success,51,22,6,11,40
30,Success,50,29,0,12,38
30,Success,53,21,0,14,39
30,Fail,42,30,5,13,29
30,Success,46,30,0,16,30
30,Success,56,22,0,8,48
30,Success,45,25,5,13,32
30,Success,49,28,2,11,38
30,Success,46,26,4,13,33
30,Success,50,27,0,13,37
30,Success,49,24,8,8,41
30,Success,51,23,0,15,36
30,Fail,42,27,4,19,23
30,Success,46,29,0,12,34
30,Success,49,33,0,9,40
30,Success,53,18,8,12,41
30,Success,44,30,4,12,32
30,Success,50,38,0,5,45
30,Success,48,32,0,9,39
30,Success,46,29,0,12,34
30,Success,59,24,0,7,52
30,Success,51,27,0,12,39
30,Success,43,32,0,12,31
30,Success,52,20,3,14,38
30,Success,50,20,7,13,37
30,Success,49,28,0,13,36
30,Success,51,22,3,10,41
30,Success,52,24,2,11,41
30,Success,47,29,1,13,34
30,Success,44,37,0,12,32
30,Success,51,25,0,9,42
30,Success,58,28,0,3,55
30,Success,47,25,4,11,36
30,Fail,38,30,12,13,25
30,Success,49,31,0,11,38
30,Success,46,31,0,10,36
30,Success,47,26,2,12,35
30,Fail,39,27,8,16,23
30,Success,47,28,4,13,34
30,Fail,41,25,10,16,25
30,Success,54,22,0,11,43
30,Fail,47,24,0,18,29
30,Fail,41,33,0,17,24
30,Success,45,32,2,10,35
30,Success,52,25,0,13,39
30,Success,49,25,6,12,37
30,Success,58,20,2,11,47
30,Success,51,22,5,10,41
30,Success,52,19,8,11,41
30,Success,45,27,10,10,35
30,Success,55,21,1,13,42
30,Success,46,27,2,13,33
30,Success,48,30,0,12,36
30,Success,46,25,2,15,31
30,Success,50,32,0,7,43
30,Fail,44,22,7,17,27
30,Success,54,21,2,11,43
30,Success,52,25,1,13,39
30,Success,46,28,0,15,31
30,Success,48,22,4,15,33
30,Success,50,25,0,12,38
30,Fail,43,32,0,14,29
30,Success,47,23,1,16,31
30,Fail,46,23,0,18,28
30,Success,51,26,0,10,41
30,Success,54,20,0,13,41
30,Success,48,30,2,11,37
30,Success,56,20,0,10,46
30,Fail,47,21,0,19,28
30,Fail,45,29,0,16,29
30,Success,45,31,0,15,30
30,Success,49,29,2,10,39
30,Success,48,23,3,17,31
30,Success,45,25,0,14,31
30,Success,50,28,0,12,38
30,Success,46,29,1,13,33
30,Fail,43,40,0,14,29
30,Success,47,28,0,12,35
30,Success,48,30,0,14,34
30,Success,50,21,1,14,36
30,Success,52,24,0,11,41
30,Success,45,36,0,12,33
30,Success,55,26,0,8,47
30,Success,48,27,0,15,33
30,Success,54,21,2,12,42
30,Fail,42,20,10,20,22
30,Success,55,24,0,13,42
30,Success,47,29,0,11,36
30,Success,54,21,0,14,40
30,Success,52,24,0,13,39
30,Success,51,26,0,12,39
30,Success,49,30,0,15,34
30,Success,54,26,0,9,45
30,Success,51,17,0,16,35
30,Success,54,20,0,15,39
30,Success,47,27,0,14,33
30,Success,50,27,0,13,37
30,Success,50,20,1,17,33
30,Success,60,21,0,7,53
30,Success,49,22,9,11,38
30,Success,52,29,0,10,42
30,Success,40,36,4,10,30
30,Success,55,24,4,7,48
30,Success,47,24,4,15,32
30,Success,47,32,0,14,33
30,Success,49,25,9,7,42
30,Fail,40,30,2,19,21
30,Success,48,28,0,14,34
30,Success,45,28,7,11,34
30,Success,49,24,2,16,33
30,Success,47,35,0,8,39
30,Success,48,27,2,13,35
30,Success,49,21,9,13,36
30,Success,53,28,2,6,47
30,Fail,44,22,8,18,26
30,Success,54,27,0,5,49
30,Success,55,20,0,15,40
30,Success,55,23,0,11,44
30,Success,53,20,1,16,37
30,Fail,38,37,0,18,20
30,Fail,43,25,2,18,25
30,Success,48,30,0,15,33
30,Fail,41,34,0,13,28
30,Success,50,27,0,11,39
30,Fail,44,29,0,15,29
30,Success,47,37,0,8,39
30,Success,55,18,2,12,43
30,Success,51,23,0,18,33
30,Success,51,25,0,16,35
30,Fail,44,32,0,16,28
30,Success,47,26,4,13,34
30,Success,44,32,0,13,31
30,Success,45,33,0,12,33
30,Fail,38,38,0,15,23
30,Fail,40,28,3,15,25
30,Success,51,26,0,10,41
30,Success,45,35,0,11,34
30,Success,48,29,0,14,34
30,Success,48,28,0,11,37
30,Success,53,22,1,12,41
30,Success,51,20,1,14,37
30,Success,43,36,0,12,31
30,Fail,36,29,4,22,14
30,Success,47,39,0,6,41
30,Success,50,30,1,7,43
30,Fail,43,25,8,15,28
30,Success,47,35,0,9,38
30,Success,51,29,0,10,41
30,Success,55,15,2,14,41
30,Success,46,27,0,14,32
30,Success,48,26,0,14,34
30,Success,44,33,0,10,34
30,Success,46,32,0,13,33
30,Success,49,24,0,11,38
30,Success,53,25,0,8,45
30,Success,52,24,1,12,40
30,Success,52,24,0,8,44
30,Success,52,24,0,14,38
30,Success,47,20,3,16,31
30,Success,47,28,8,8,39
30,Success,46,26,4,14,32
30,Success,48,23,2,13,35
30,Success,51,27,1,11,40
30,Success,57,16,0,12,45
30,Fail,45,24,0,22,23
30,Fail,43,33,0,16,27
30,Success,53,30,0,6,47
30,Success,52,17,3,17,35
30,Success,49,23,1,16,33
30,Success,52,22,4,14,38
30,Success,47,23,5,12,35
30,Success,48,30,0,12,36
30,Success,49,25,0,12,37
30,Success,48,19,9,14,34
30,Success,49,25,0,14,35
30,Success,49,22,2,14,35
30,Success,44,29,2,13,31
30,Success,54,24,5,9,45
30,Success,54,24,0,11,43
30,Success,48,20,4,16,32
30,Fail,40,28,6,16,24
30,Fail,44,25,1,20,24
30,Success,51,29,0,13,38
30,Success,46,27,6,11,35
30,Success,54,24,1,12,42
30,Success,48,32,0,9,39
30,Success,44,29,0,13,31
30,Success,51,26,0,11,40
30,Success,52,21,3,13,39
30,Fail,43,29,8,15,28
30,Success,47,27,5,13,34
30,Success,48,29,0,12,36
30,Success,44,30,6,14,30
30,Fail,44,25,0,17,27
30,Success,55,24,0,8,47
30,Success,51,27,0,10,41
30,Success,48,33,0,11,37
30,Fail,40,36,0,16,24
30,Success,47,30,0,12,35
30,Success,54,33,0,3,51
30,Success,50,23,4,12,38
30,Success,52,20,0,15,37
30,Success,52,21,3,10,42
30,Success,51,27,4,9,42
30,Success,54,19,4,9,45
30,Success,54,27,1,9,45
30,Fail,43,28,4,14,29
30,Success,50,18,4,12,38
30,Success,44,29,0,13,31
30,Success,47,25,0,17,30
30,Success,47,23,0,13,34
30,Success,44,25,8,13,31
30,Success,46,32,0,14,32
30,Success,43,33,5,10,33
30,Fail,45,26,1,16,29
30,Success,55,25,0,8,47
30,Fail,43,23,7,17,26
30,Success,50,24,1,12,38
30,Success,50,28,1,11,39
30,Success,52,24,0,9,43
30,Success,40,44,0,10,30
30,Success,50,18,4,12,38
30,Success,52,20,0,18,34
30,Success,50,27,0,12,38
30,Success,44,34,0,12,32
30,Success,49,23,1,15,34
30,Success,48,27,0,12,36
30,Success,47,29,0,13,34
30,Success,52,23,0,12,40
30,Success,43,33,5,11,32
30,Success,60,15,0,10,50
30,Success,55,22,2,9,46
30,Success,43,32,7,11,32
30,Success,49,32,0,9,40
30,Success,46,34,0,12,34
30,Success,50,22,7,10,40
30,Success,52,25,4,9,43
30,Success,48,23,5,13,35
30,Success,49,30,0,10,39
30,Success,49,29,0,11,38
30,Success,48,20,4,13,35
30,Success,50,24,6,11,39
30,Success,49,22,0,18,31
30,Success,45,31,2,10,35
30,Fail,44,26,0,18,26
30,Success,52,24,0,10,42
30,Fail,44,29,1,15,29
30,Success,52,27,5,6,46
30,Success,52,17,0,14,38
30,Success,55,28,0,8,47
30,Success,44,26,9,12,32
30,Success,42,34,0,12,30
30,Success,53,22,4,11,42
30,Fail,42,30,0,15,27
30,Fail,43,32,0,14,29
30,Success,46,34,0,11,35
30,Success,48,28,2,11,37
30,Fail,40,22,7,18,22
30,Fail,42,24,6,17,25
30,Success,47,31,0,14,33
30,Success,57,18,0,13,44
30,Success,51,25,3,13,38
30,Success,47,31,0,12,35
30,Success,50,24,0,13,37
30,Success,48,25,6,12,36
30,Success,53,26,0,11,42
30,Success,42,25,9,11,31
30,Success,43,31,9,6,37
30,Success,47,22,4,15,32
30,Success,48,19,9,15,33
30,Success,47,27,5,9,38
30,Success,45,30,3,9,36
30,Success,51,21,1,13,38
30,Success,53,26,0,8,45
30,Success,53,25,3,9,44
30,Success,45,31,0,13,32
30,Success,47,26,4,14,33
30,Success,50,27,1,12,38
30,Success,37,44,0,7,30
30,Success,49,27,0,14,35
30,Success,57,23,5,6,51
30,Success,55,25,0,8,47
30,Success,47,25,5,14,33
30,Success,51,21,0,16,35
30,Success,48,29,0,10,38
30,Fail,44,26,2,17,27
30,Success,48,21,2,18,30
30,Fail,44,27,1,19,25
30,Success,52,27,0,7,45
30,Success,45,31,0,14,31
30,Success,52,30,0,10,42
30,Success,46,23,3,14,32
30,Success,50,29,2,8,42
30,Success,45,32,0,12,33
30,Fail,43,34,0,15,28
30,Success,45,25,7,14,31
30,Success,56,17,0,18,38
30,Success,49,28,0,13,36
30,Success,50,30,0,11,39
30,Success,45,30,2,9,36
30,Fail,44,33,0,15,29
30,Success,50,24,4,13,37
30,Fail,45,29,0,18,27
30,Success,45,31,0,11,34
30,Fail,40,34,0,15,25
30,Success,51,24,1,15,36
30,Success,50,31,0,10,40
30,Fail,42,19,14,18,24
30,Success,45,25,2,12,33
30,Fail,39,32,8,14,25
30,Success,60,19,6,7,53
30,Success,51,25,0,15,36
30,Success,48,28,3,8,40
30,Fail,40,26,8,14,26
30,Success,51,26,0,11,40
30,Success,48,25,8,9,39
30,Success,50,25,0,13,37
30,Success,54,22,0,12,42
30,Success,45,24,0,15,30
30,Fail,42,30,7,13,29
30,Success,46,23,4,11,35
30,Fail,46,21,2,18,28
30,Success,55,16,0,16,39
30,Success,55,22,1,8,47
30,Success,52,24,0,15,37
30,Fail,42,35,0,14,28
30,Fail,42,27,0,15,27
30,Fail,43,25,8,15,28
30,Success,48,28,0,15,33
30,Success,56,28,0,7,49
30,Success,51,25,0,12,39
30,Success,49,26,0,14,35
30,Success,43,32,1,10,33
30,Success,47,32,0,13,34
30,Fail,46,26,0,19,27
30,Success,49,21,5,12,37
30,Success,52,19,4,14,38
30,Success,46,32,2,10,36
30,Success,45,31,0,13,32
30,Success,42,29,11,11,31
30,Success,47,34,0,10,37
30,Success,45,32,0,14,31
30,Success,52,27,0,9,43
30,Success,51,19,0,16,35
30,Success,50,26,0,12,38
30,Success,49,28,0,13,36
30,Success,45,24,2,14,31
30,Success,48,25,0,13,35
30,Success,50,26,0,17,33
30,Fail,40,35,0,16,24
30,Fail,44,31,1,15,29
30,Success,48,30,4,8,40
30,Success,53,34,0,5,48
30,Success,52,29,0,6,46
30,Success,46,31,2,11,35
30,Success,43,31,4,11,32
30,Success,49,32,0,8,41
30,Success,53,24,3,10,43
30,Success,48,23,6,11,37
30,Success,49,24,0,18,31
30,Fail,41,40,0,12,29
30,Success,51,28,2,7,44
30,Fail,43,30,0,16,27
30,Success,50,20,8,12,38
30,Success,53,20,3,12,41
30,Success,50,22,0,15,35
30,Success,48,17,6,17,31
30,Success,52,23,1,11,41
30,Success,46,33,0,10,36
30,Success,52,21,0,16,36
30,Success,44,34,0,13,31
30,Success,56,25,0,6,50
30,Success,49,31,0,12,37
30,Fail,44,29,3,16,28
30,Success,51,22,0,14,37
30,Fail,41,36,0,14,27
30,Success,47,23,6,15,32
30,Success,40,37,12,6,34
30,Success,45,40,0,7,38
30,Fail,43,31,0,19,24
30,Fail,37,37,7,13,24
30,Success,49,23,0,15,34
30,Success,45,29,1,13,32
30,Success,47,28,0,13,34
30,Success,51,18,12,10,41
30,Success,45,27,11,10,35
30,Fail,42,29,1,15,27
30,Fail,43,24,7,15,28
30,Success,51,25,10,6,45
30,Success,49,28,6,10,39
30,Success,47,29,3,10,37
30,Success,58,20,3,12,46
30,Success,47,26,5,12,35
30,Success,46,35,0,10,36
30,Success,55,21,0,12,43
30,Success,52,24,0,15,37
30,Fail,43,30,4,14,29
30,Fail,38,27,10,16,22
30,Success,58,18,2,13,45
30,Success,49,19,6,15,34
30,Fail,35,27,10,20,15
30,Success,48,20,5,16,32
30,Success,48,31,0,11,37
30,Success,49,27,0,11,38
30,Success,47,33,0,14,33
30,Success,49,24,0,16,33
30,Fail,44,26,10,16,28
30,Success,46,36,0,10,36
30,Success,51,28,5,9,42
30,Success,49,25,8,9,40
30,Success,49,26,3,13,36
30,Success,45,39,0,10,35
30,Fail,47,22,3,19,28
30,Success,56,24,0,8,48
30,Success,49,23,7,13,36
30,Success,50,24,7,12,38
30,Fail,47,18,6,20,27
30,Success,52,23,2,11,41
30,Success,48,31,0,12,36
30,Success,54,22,2,10,44
30,Success,52,26,0,9,43
30,Success,47,30,7,9,38
30,Success,49,28,0,8,41
30,Success,51,32,0,6,45
30,Fail,41,27,0,17,24
30,Success,43,27,6,13,30
30,Success,44,24,6,13,31
30,Success,50,34,0,7,43
30,Success,57,17,2,9,48
30,Success,55,17,1,15,40
30,Success,47,34,0,13,34
30,Success,49,26,0,15,34
30,Success,52,23,0,13,39
30,Fail,42,31,0,18,24
30,Fail,38,30,5,16,22
30,Success,45,22,11,12,33
30,Success,50,22,5,13,37
30,Success,50,30,0,14,36
30,Fail,42,27,6,16,26
30,Success,58,20,0,9,49
30,Success,51,20,5,15,36
30,Success,53,21,1,11,42
30,Success,46,25,0,15,31
30,Success,47,26,0,12,35
30,Success,56,23,5,11,45
30,Success,55,20,6,10,45
30,Fail,41,34,0,14,27
30,Success,53,24,0,10,43
30,Success,45,26,4,13,32
30,Success,47,30,0,11,36
30,Fail,45,22,3,16,29
30,Success,50,25,0,13,37
30,Success,51,28,0,10,41
30,Fail,48,20,3,21,27
30,Fail,42,33,1,15,27
30,Success,48,20,5,17,31
30,Success,57,21,0,10,47
30,Success,48,25,0,14,34
30,Fail,42,29,4,13,29
30,Success,48,29,1,11,37
30,Fail,43,32,0,16,27
30,Success,59,21,0,9,50
30,Success,52,28,0,12,40
30,Fail,44,27,4,15,29
30,Success,43,36,0,13,30
30,Success,52,22,0,13,39
30,Success,50,24,2,16,34
30,Success,55,24,0,9,46
30,Success,47,33,0,12,35
30,Success,47,29,0,16,31
30,Success,51,28,0,11,40
30,Fail,42,26,5,15,27
30,Success,43,31,0,13,30
30,Success,47,26,4,12,35
30,Success,47,26,2,14,33
30,Success,54,20,7,8,46
30,Fail,44,29,2,16,28
30,Success,47,28,0,13,34
30,Success,51,27,0,10,41
30,Success,52,27,0,11,41
30,Success,46,29,0,12,34
30,Fail,46,23,1,17,29
30,Fail,39,28,5,19,20
30,Success,48,26,3,7,41
30,Fail,43,31,0,15,28
30,Fail,39,34,0,17,22
30,Success,56,26,2,5,51
30,Success,45,29,1,11,34
30,Success,46,32,0,12,34
30,Success,42,37,0,11,31
30,Success,44,27,3,11,33
30,Success,44,34,0,12,32
30,Success,48,27,0,14,34
30,Success,50,27,0,13,37
30,Success,50,26,0,7,43
30,Success,47,28,0,14,33
30,Success,47,27,1,15,32
30,Success,56,20,1,13,43
30,Success,47,22,2,15,32
30,Success,51,23,2,9,42
30,Success,52,30,0,10,42
30,Success,48,24,7,11,37
30,Success,48,23,7,13,35
30,Success,50,28,0,12,38
30,Success,51,17,10,16,35
30,Success,46,28,1,14,32
30,Success,51,15,3,20,31
30,Success,47,25,10,10,37
30,Success,49,30,0,11,38
30,Success,47,18,5,12,35
30,Success,43,31,0,11,32
30,Success,45,29,2,12,33
30,Success,49,20,4,17,32
30,Success,48,31,0,13,35
30,Success,55,15,0,14,41
30,Fail,41,32,8,13,28
30,Success,48,28,0,9,39
30,Success,46,23,4,13,33
30,Success,60,23,0,6,54
30,Success,46,28,0,15,31
30,Success,46,35,0,9,37
30,Success,44,30,0,14,30
30,Success,48,21,8,17,31
30,Success,52,26,0,14,38
30,Success,48,32,3,8,40
30,Success,53,28,0,10,43
30,Fail,46,26,0,18,28
30,Fail,43,32,0,15,28
30,Success,54,24,0,10,44
30,Success,50,31,0,11,39
30,Fail,44,30,0,18,26
30,Success,54,20,5,8,46
30,Success,57,19,0,13,44
30,Success,47,33,0,13,34
30,Success,48,34,0,7,41
30,Success,47,29,7,10,37
30,Success,57,20,0,10,47
30,Success,47,24,4,12,35
30,Fail,42,31,0,15,27
30,Success,50,27,0,11,39
30,Fail,41,37,0,13,28
30,Success,48,28,3,9,39
30,Fail,44,25,0,17,27
30,Success,46,25,0,16,30
30,Success,46,30,0,11,35
30,Success,44,31,0,12,32
30,Success,54,20,2,13,41
30,Success,51,28,0,14,37
30,Success,49,31,0,11,38
30,Success,45,21,10,10,35
30,Success,49,28,0,12,37
30,Success,47,28,3,10,37
30,Success,54,18,0,12,42
30,Success,52,23,6,8,44
30,Success,51,17,3,16,35
30,Success,48,26,10,9,39
30,Fail,46,28,0,18,28
30,Success,45,33,2,10,35
30,Success,46,27,0,14,32
30,Success,49,23,0,18,31
30,Fail,39,33,0,18,21
30,Success,51,27,2,12,39
30,Success,47,23,9,13,34
30,Success,51,21,0,14,37
30,Success,53,27,1,10,43
30,Success,50,27,0,14,36
30,Success,51,33,0,9,42
30,Success,45,29,0,15,30
30,Success,48,28,3,12,36
30,Success,46,33,0,16,30
30,Success,52,25,0,14,38
30,Success,51,23,0,10,41
30,Success,51,26,0,10,41
30,Success,48,30,0,13,35
30,Success,57,18,0,12,45
30,Success,48,30,0,12,36
30,Success,53,24,1,8,45
30,Success,57,20,3,8,49
30,Success,50,23,2,12,38
30,Success,42,35,0,10,32
30,Success,47,22,8,12,35
30,Success,51,31,0,13,38
30,Success,44,26,3,14,30
30,Success,51,27,0,9,42
30,Success,50,23,0,14,36
30,Success,45,32,0,14,31
30,Success,51,23,2,12,39
30,Fail,42,32,0,16,26
30,Fail,44,31,0,16,28
30,Success,53,24,0,10,43
30,Success,48,26,4,11,37
30,Success,50,23,0,12,38
30,Success,46,28,0,16,30
30,Success,49,26,3,9,40
30,Success,45,32,0,11,34
30,Success,48,35,0,9,39
30,Success,47,25,5,15,32
30,Success,48,29,8,5,43
30,Success,50,23,0,15,35
30,Success,47,26,2,14,33
30,Success,52,26,0,10,42
30,Success,55,21,2,10,45
30,Success,46,25,2,16,30
30,Success,48,26,2,15,33
30,Success,46,23,4,13,33
30,Success,48,31,0,14,34
30,Fail,44,33,0,15,29
30,Success,52,19,4,14,38
30,Success,44,34,0,10,34
30,Success,51,16,5,11,40
30,Success,56,24,2,8,48
30,Success,51,22,0,15,36
30,Fail,45,25,0,17,28
30,Success,51,21,11,11,40
30,Success,51,22,2,12,39
30,Success,49,23,0,18,31
30,Success,43,29,3,13,30
30,Fail,43,25,4,16,27
30,Fail,43,23,11,14,29
30,Success,46,31,0,14,32
30,Success,49,33,0,12,37
30,Fail,48,22,1,20,28
30,Success,53,29,0,10,43
30,Success,51,23,3,12,39
30,Success,50,27,0,15,35
30,Fail,38,36,0,15,23
30,Fail,41,39,0,12,29
30,Success,53,25,0,12,41
30,Success,44,29,4,11,33
30,Success,49,26,4,10,39
30,Success,48,30,0,12,36
30,Success,45,33,2,9,36
30,Success,45,34,0,10,35
30,Success,54,23,0,7,47
30,Success,50,27,0,13,37
30,Success,54,22,4,11,43
30,Success,54,22,0,11,43
30,Success,51,21,1,19,32
30,Success,48,32,0,12,36
30,Fail,35,33,0,21,14
30,Success,48,29,4,11,37
30,Success,46,21,10,13,33
30,Fail,43,31,0,14,29
30,Success,49,27,0,14,35
30,Success,50,20,8,13,37
30,Fail,46,31,0,17,29
30,Success,51,21,0,17,34
30,Fail,42,33,0,16,26
30,Success,43,30,2,12,31
30,Success,47,21,7,16,31
30,Success,51,34,0,8,43
30,Success,47,30,0,17,30
30,Success,54,20,6,9,45
30,Success,49,24,0,16,33
30,Success,49,25,4,7,42
30,Success,55,27,0,9,46
30,Success,47,24,6,13,34
30,Success,50,23,0,14,36
30,Success,55,23,0,9,46
30,Success,56,22,4,7,49
30,Success,46,30,4,12,34
30,Success,52,24,1,13,39
30,Success,52,24,0,11,41
30,Success,48,34,0,11,37
30,Success,53,26,0,11,42
30,Success,49,27,0,15,34
30,Fail,42,33,0,18,24
30,Success,53,23,5,8,45
30,Success,59,21,2,7,52
30,Success,47,31,0,13,34
30,Success,49,25,0,15,34
30,Fail,38,33,9,12,26
30,Fail,43,30,4,15,28
30,Success,55,24,0,11,44
30,Success,53,24,1,9,44
30,Success,53,23,0,12,41
30,Success,45,25,7,15,30
30,Success,47,30,0,14,33
30,Success,48,31,0,9,39
30,Success,51,23,0,13,38
30,Success,48,29,0,10,38
30,Success,56,21,0,10,46
30,Success,47,22,5,16,31
30,Fail,38,37,0,13,25
30,Success,44,31,5,10,34
30,Success,51,24,0,11,40
30,Success,52,27,0,12,40
30,Success,50,30,0,9,41
30,Success,48,35,0,9,39
30,Fail,41,25,16,12,29
30,Fail,43,26,3,14,29
30,Success,52,24,0,12,40
30,Success,47,26,2,13,34
30,Success,50,22,5,13,37
30,Success,47,28,0,15,32
30,Success,54,27,0,6,48
30,Success,56,20,0,14,42
30,Success,49,25,3,12,37
30,Success,47,39,0,8,39
30,Fail,41,26,13,12,29
30,Success,48,31,0,13,35
30,Fail,40,35,0,17,23
30,Success,48,25,0,16,32
30,Success,51,28,0,11,40
30,Success,51,23,0,13,38
30,Fail,38,38,0,13,25
30,Success,45,29,0,15,30
30,Fail,45,30,0,20,25
30,Success,41,33,3,11,30
30,Success,45,38,0,8,37
30,Success,42,29,8,10,32
30,Success,51,26,0,13,38
30,Success,47,30,0,12,35
30,Success,51,28,0,13,38
30,Fail,42,32,0,14,28
30,Fail,43,27,8,14,29
30,Fail,41,33,0,12,29
30,Fail,45,27,0,20,25
30,Success,50,26,2,10,40
30,Fail,41,34,0,18,23
30,Success,55,23,4,7,48
30,Success,48,30,0,13,35
30,Fail,37,29,2,21,16
30,Fail,50,14,4,21,29
30,Success,49,24,0,14,35
30,Success,49,27,1,10,39
30,Success,50,27,7,6,44
30,Success,50,31,0,9,41
30,Success,48,28,0,13,35
30,Success,43,34,0,9,34
30,Success,51,30,4,6,45
30,Success,56,19,5,9,47
30,Success,46,30,0,14,32
30,Fail,45,27,0,16,29
30,Success,46,29,7,11,35
30,Success,58,26,0,7,51
30,Success,47,26,4,11,36
30,Success,52,23,4,13,39
30,Success,42,33,5,11,31
30,Success,42,37,3,7,35
30,Success,50,22,2,14,36
30,Success,52,28,1,10,42
30,Success,45,29,0,13,32
30,Success,42,34,1,12,30
30,Success,52,28,0,13,39
30,Success,50,33,0,9,41
30,Success,48,23,0,18,30
30,Success,52,26,0,15,37
30,Success,53,18,1,17,36
30,Success,47,25,7,13,34
30,Fail,46,26,0,19,27
30,Success,49,35,0,7,42
30,Success,49,28,3,11,38
30,Fail,39,34,3,17,22
30,Success,48,31,0,10,38
30,Success,49,19,2,19,30
30,Fail,45,27,0,17,28
30,Success,49,32,1,8,41
30,Success,49,29,0,13,36
30,Success,57,13,5,12,45
30,Success,47,31,0,10,37
30,Fail,36,40,0,14,22
30,Success,47,26,3,10,37
30,Fail,43,25,3,18,25
30,Success,47,20,8,11,36
30,Success,51,27,0,12,39
30,Success,48,26,2,15,33
30,Success,51,26,2,9,42
30,Fail,43,30,0,14,29
30,Success,61,20,0,9,52
30,Success,55,26,0,9,46
30,Fail,41,27,10,15,26
30,Success,51,24,4,10,41
30,Success,48,27,0,16,32
30,Success,44,37,0,12,32
30,Success,45,25,10,14,31
30,Success,45,34,0,15,30
30,Success,48,31,0,11,37
30,Success,50,23,0,13,37
30,Fail,41,40,0,12,29
30,Success,46,29,0,13,33
30,Success,46,24,8,16,30
30,Success,52,17,1,15,37
30,Success,52,25,5,9,43
30,Success,49,24,0,13,36
30,Success,55,22,0,11,44
30,Success,42,30,4,8,34
30,Success,54,28,0,7,47
30,Fail,39,30,11,16,23
30,Fail,39,41,0,14,25
30,Success,58,23,1,8,50
30,Fail,46,17,0,21,25
30,Success,50,25,2,15,35
30,Success,49,22,9,12,37
30,Success,50,27,7,10,40
30,Success,58,26,0,8,50
30,Success,54,23,0,15,39
30,Success,48,29,0,11,37
30,Success,50,29,0,11,39
30,Success,53,25,1,9,44
30,Success,48,26,0,14,34
30,Success,44,23,11,9,35
30,Success,51,29,0,9,42
30,Success,45,34,0,10,35
30,Success,48,30,0,12,36
30,Success,46,23,2,15,31
30,Success,46,29,0,9,37
30,Success,54,24,0,13,41
30,Success,43,31,3,10,33
30,Success,57,21,0,12,45
30,Fail,40,37,0,12,28
30,Success,51,27,0,11,40
30,Success,59,18,0,8,51
30,Success,49,32,0,9,40
30,Success,60,25,0,7,53
30,Success,52,28,0,10,42
30,Success,46,31,0,12,34
30,Success,46,36,0,10,36
30,Fail,37,40,0,19,18
30,Success,52,30,1,8,44
30,Success,50,25,0,13,37
30,Success,50,24,1,14,36
30,Success,55,18,3,13,42
30,Success,47,23,0,17,30
30,Success,44,32,0,14,30
30,Success,48,25,0,13,35
30,Success,49,24,7,10,39
30,Success,46,34,0,12,34
30,Success,51,36,0,5,46
30,Success,45,31,0,13,32
30,Fail,42,29,8,13,29
30,Success,52,22,1,13,39
30,Fail,41,26,11,15,26
30,Fail,40,39,0,15,25
30,Success,47,30,3,12,35
30,Success,45,30,0,14,31
30,Fail,42,29,0,16,26
30,Fail,39,30,3,17,22
30,Success,49,31,0,13,36
30,Fail,42,30,0,16,26
30,Fail,42,28,0,20,22
30,Success,47,24,3,14,33
30,Success,49,27,0,13,36
30,Success,55,20,6,6,49
30,Success,51,30,0,11,40
30,Success,51,28,0,8,43
30,Fail,35,40,0,16,19
30,Fail,37,29,14,14,23
30,Success,48,23,9,10,38
30,Success,52,27,3,10,42
30,Success,48,26,0,15,33
30,Success,47,34,0,13,34
30,Success,52,20,1,14,38
30,Success,48,25,0,14,34
30,Success,51,29,0,10,41
30,Fail,41,30,9,12,29
30,Fail,44,26,4,17,27
30,Success,48,21,5,18,30
30,Success,45,30,8,9,36
30,Success,40,38,0,10,30
30,Success,45,35,0,11,34
30,Success,49,22,8,16,33
30,Success,41,36,3,11,30
30,Success,50,29,0,12,38
30,Success,49,25,1,8,41
30,Success,54,28,0,9,45
30,Success,47,26,1,15,32
30,Success,46,27,7,9,37
30,Success,49,30,0,13,36
30,Success,48,22,6,18,30
30,Success,52,22,5,7,45
30,Success,48,33,0,9,39
30,Success,48,22,4,11,37
30,Success,49,19,1,17,32
30,Success,47,25,6,17,30
30,Success,52,25,0,11,41
30,Success,51,25,0,12,39
30,Success,50,28,0,11,39
30,Success,43,34,0,13,30
30,Success,48,30,3,8,40
30,Success,48,22,4,14,34
30,Success,51,24,3,11,40
30,Success,44,33,0,14,30
30,Success,53,21,2,13,40
30,Success,52,21,8,9,43
30,Success,44,34,0,14,30
30,Success,48,24,2,15,33
30,Fail,45,24,1,18,27
30,Success,50,24,4,10,40
30,Success,50,31,0,12,38
30,Success,41,36,0,11,30
30,Success,46,27,0,13,33
30,Success,50,25,9,6,44
30,Success,50,16,15,12,38
30,Success,51,28,2,7,44
30,Success,48,32,0,12,36
30,Success,49,31,1,10,39
30,Fail,45,29,0,18,27
30,Success,47,23,8,13,34
30,Success,47,28,0,12,35
30,Fail,44,25,3,15,29
30,Success,50,23,1,14,36
30,Success,52,29,0,7,45
30,Success,46,28,0,13,33
30,Success,45,28,2,11,34
30,Success,60,16,3,11,49
30,Success,48,28,1,11,37
30,Success,51,26,3,11,40
30,Fail,44,31,0,16,28
30,Fail,41,30,0,17,24
30,Fail,42,31,0,19,23
30,Success,53,18,0,16,37
30,Success,52,31,1,3,49
30,Success,54,28,0,8,46
30,Success,49,19,9,14,35
30,Fail,44,35,0,15,29
30,Success,47,27,1,15,32
30,Fail,41,26,0,20,21
30,Success,53,26,0,11,42
30,Success,51,30,0,10,41
30,Success,47,28,8,10,37
30,Success,53,22,5,10,43
30,Success,44,33,0,13,31
30,Success,52,18,2,15,37
30,Fail,38,37,1,11,27
30,Success,52,27,0,11,41
30,Success,51,29,0,10,41
30,Success,46,28,0,14,32
30,Success,53,20,8,8,45
30,Success,50,24,0,14,36
30,Success,54,28,5,7,47
30,Success,46,24,5,14,32
30,Success,50,28,0,11,39
30,Success,56,22,3,10,46
30,Success,47,36,0,14,33
30,Success,49,33,1,9,40
30,Success,51,27,0,10,41
30,Success,45,23,10,14,31
30,Success,48,25,2,10,38
30,Success,47,26,6,11,36
30,Success,47,33,0,10,37
30,Success,49,29,0,13,36
30,Success,50,25,6,11,39
30,Success,46,36,0,9,37
30,Success,50,31,0,9,41
30,Success,47,30,0,17,30
30,Success,54,20,4,12,42
30,Success,50,15,2,18,32
30,Success,45,24,6,12,33
30,Success,44,26,5,12,32
30,Fail,44,25,0,23,21
30,Success,48,24,4,13,35
30,Success,59,21,0,7,52
30,Success,49,30,3,10,39
30,Success,54,22,0,10,44
30,Success,50,22,4,11,39
30,Success,52,21,4,13,39
30,Fail,44,25,9,15,29
30,Fail,41,31,3,14,27
30,Success,48,29,0,13,35
30,Success,53,24,2,14,39
30,Success,54,30,0,7,47
30,Success,53,20,5,15,38
30,Success,45,27,4,11,34
30,Success,53,20,5,13,40
30,Success,51,28,0,13,38
30,Success,56,17,0,14,42
30,Success,48,30,0,13,35
30,Success,43,28,7,13,30
30,Success,51,21,0,12,39
30,Success,59,24,0,6,53
30,Success,49,30,0,8,41
30,Fail,38,32,6,16,22
30,Success,57,24,0,9,48
30,Success,50,25,3,12,38
30,Success,51,25,1,10,41
30,Success,48,32,0,15,33
30,Success,51,24,4,13,38
30,Success,48,26,5,11,37
30,Fail,42,33,0,14,28
30,Success,47,22,7,14,33
30,Fail,39,27,4,19,20
30,Success,51,19,12,12,39
30,Success,48,27,3,13,35
30,Success,47,34,0,12,35
30,Success,48,26,3,12,36
30,Success,53,20,0,13,40
30,Success,51,26,4,10,41
30,Success,47,27,5,12,35
30,Success,56,21,0,11,45
30,Success,45,27,0,15,30
30,Fail,40,34,1,15,25
30,Success,54,27,0,9,45
30,Fail,47,28,0,18,29
30,Success,51,29,0,11,40
30,Success,45,23,9,14,31
30,Success,42,38,0,11,31
30,Success,51,23,1,15,36
30,Success,52,17,3,12,40
30,Success,59,17,1,12,47
30,Success,54,25,0,11,43
30,Success,54,19,0,13,41
30,Success,47,32,0,13,34
30,Success,44,27,4,14,30
30,Success,51,25,3,10,41
30,Success,50,21,8,10,40
30,Success,51,15,6,17,34
30,Success,48,31,0,10,38
30,Success,47,26,0,14,33
30,Success,45,33,0,13,32
30,Success,54,20,0,16,38
30,Success,49,25,1,11,38
30,Success,52,19,0,15,37
30,Success,47,28,2,12,35
30,Success,49,23,3,12,37
30,Success,47,26,4,15,32
30,Success,46,34,0,12,34
30,Fail,39,28,5,13,26
30,Success,46,24,0,16,30
30,Success,52,24,0,13,39
30,Success,42,40,0,7,35
30,Success,50,22,1,14,36
30,Success,58,21,0,11,47
30,Success,43,39,0,10,33
30,Success,53,18,8,11,42
30,Success,50,23,0,15,35
30,Success,54,33,0,5,49
30,Fail,40,27,4,18,22
30,Success,53,24,1,10,43
30,Success,49,21,6,13,36
30,Success,53,26,0,12,41
30,Fail,41,34,0,15,26
30,Success,44,34,0,13,31
30,Fail,38,24,14,16,22
30,Success,51,31,0,11,40
30,Fail,42,29,0,15,27
30,Success,47,25,0,13,34
30,Success,46,30,0,14,32
30,Success,46,33,1,14,32
30,Success,51,22,1,14,37
30,Success,50,29,1,11,39
30,Success,53,25,3,7,46
30,Success,53,24,0,12,41
30,Success,48,27,3,12,36
30,Fail,38,32,0,19,19
30,Success,42,35,1,10,32
30,Success,53,21,0,10,43
30,Success,52,27,0,10,42
30,Success,48,22,0,16,32
30,Success,44,31,5,11,33
30,Success,53,21,0,12,41
30,Success,47,27,0,14,33
30,Success,47,32,5,9,38
30,Success,44,28,7,13,31
30,Fail,44,24,3,21,23
30,Success,52,34,0,4,48
30,Success,55,20,4,11,44
30,Success,46,32,0,10,36
30,Success,49,26,0,16,33
30,Success,46,26,5,11,35
30,Success,51,24,11,7,44
30,Success,45,31,1,11,34
30,Fail,43,27,0,14,29
30,Success,47,27,0,16,31
30,Success,44,33,0,13,31
30,Success,52,26,0,9,43
30,Success,49,30,0,10,39
30,Success,45,24,3,15,30
30,Success,48,27,4,12,36
30,Fail,41,38,0,17,24
30,Fail,37,35,4,15,22
30,Success,54,21,0,8,46
30,Success,50,19,3,17,33
30,Success,57,21,3,7,50
30,Success,50,32,0,5,45
30,Success,44,26,6,14,30
30,Fail,42,31,3,14,28
30,Success,45,33,0,13,32
30,Success,44,29,4,13,31
30,Success,50,24,2,10,40
30,Success,55,23,0,13,42
30,Success,46,29,0,15,31
30,Success,46,29,0,12,34
30,Success,45,33,0,8,37
30,Success,55,17,2,15,40
30,Success,53,30,1,9,44
30,Success,55,23,0,12,43
30,Success,49,23,4,15,34
30,Success,55,20,0,10,45
30,Success,48,31,0,9,39
30,Success,51,26,4,11,40
30,Success,57,24,5,7,50
30,Success,44,29,9,12,32
30,Success,46,24,1,15,31
30,Success,49,29,0,11,38
30,Success,50,24,0,14,36
30,Success,43,36,0,11,32
30,Success,47,33,0,11,36
30,Success,50,25,6,10,40
30,Fail,44,33,0,18,26
40,Fail,46,32,0,10,36
40,Fail,42,31,0,16,26
40,Fail,48,29,0,14,34
40,Fail,46,32,0,9,37
40,Fail,48,26,7,12,36
40,Fail,41,32,9,12,29
40,Success,58,15,0,13,45
40,Success,50,22,9,9,41
40,Success,58,28,0,6,52
40,Fail,43,35,0,14,29
40,Fail,45,39,0,11,34
40,Fail,43,25,11,16,27
40,Fail,41,34,4,13,28
40,Fail,45,30,0,16,29
40,Fail,51,23,3,15,36
40,Fail,45,27,0,15,30
40,Success,57,19,0,13,44
40,Fail,45,30,0,15,30
40,Success,54,25,0,10,44
40,Fail,42,29,0,18,24
40,Success,51,20,10,7,44
40,Success,55,23,2,7,48
40,Fail,47,28,0,11,36
40,Fail,48,34,0,12,36
40,Success,49,34,0,8,41
40,Success,51,31,1,7,44
40,Fail,45,32,0,10,35
40,Fail,51,20,5,15,36
40,Success,49,30,0,9,40
40,Fail,47,29,0,12,35
40,Fail,43,30,5,12,31
40,Fail,46,24,1,14,32
40,Fail,51,23,0,14,37
40,Success,53,20,0,12,41
40,Fail,54,16,0,16,38
40,Success,50,27,0,7,43
40,Fail,48,26,3,14,34
40,Success,53,24,0,10,43
40,Fail,37,37,0,16,21
40,Success,56,23,0,10,46
40,Success,56,25,0,9,47
40,Success,53,23,0,13,40
40,Fail,45,33,2,11,34
40,Fail,49,23,1,15,34
40,Fail,47,24,4,15,32
40,Success,52,23,4,11,41
40,Fail,45,32,0,17,28
40,Success,51,23,6,9,42
40,Success,51,27,0,11,40
40,Fail,49,24,2,15,34
40,Fail,43,25,5,15,28
40,Fail,51,23,0,12,39
40,Success,52,28,0,8,44
40,Success,54,21,1,13,41
40,Fail,46,27,0,17,29
40,Fail,49,23,0,17,32
40,Fail,50,21,7,14,36
40,Fail,46,25,5,18,28
40,Fail,45,33,0,15,30
40,Success,51,30,0,8,43
40,Fail,47,28,0,12,35
40,Fail,45,30,0,16,29
40,Fail,46,27,4,12,34
40,Fail,51,19,5,16,35
40,Fail,46,36,0,10,36
40,Fail,47,28,5,14,33
40,Fail,44,31,0,14,30
40,Fail,47,25,3,13,34
40,Success,55,21,0,12,43
40,Fail,43,39,0,13,30
40,Success,56,24,0,11,45
40,Fail,50,29,0,16,34
40,Fail,51,23,0,18,33
40,Success,53,23,6,10,43
40,Fail,49,26,0,11,38
40,Fail,36,36,0,18,18
40,Fail,51,26,0,12,39
40,Fail,43,35,0,16,27
40,Fail,48,29,0,14,34
40,Fail,47,29,0,13,34
40,Fail,52,17,2,16,36
40,Fail,45,23,0,17,28
40,Fail,48,27,4,9,39
40,Fail,48,30,4,14,34
40,Fail,49,25,3,15,34
40,Fail,44,22,9,17,27
40,Success,54,20,3,11,43
40,Fail,49,29,1,10,39
40,Fail,49,25,3,13,36
40,Success,51,28,3,8,43
40,Fail,44,29,0,14,30
40,Success,51,23,0,9,42
40,Fail,47,27,0,15,32
40,Success,52,26,0,10,42
40,Fail,47,21,4,15,32
40,Fail,43,37,0,9,34
40,Fail,41,38,0,14,27
40,Success,53,18,2,11,42
40,Fail,40,36,0,12,28
40,Success,50,30,0,7,43
40,Fail,51,24,0,12,39
40,Fail,41,35,0,14,27
40,Fail,41,35,0,19,22
40,Success,49,34,0,9,40
40,Fail,46,33,0,9,37
40,Fail,45,27,0,15,30
40,Fail,48,27,0,14,34
40,Fail,43,28,4,13,30
40,Fail,43,30,1,16,27
40,Fail,43,33,0,17,26
40,Fail,52,28,0,13,39
40,Fail,44,35,0,12,32
40,Fail,51,31,0,12,39
40,Fail,43,39,0,10,33
40,Fail,50,26,2,11,39
40,Success,53,26,0,10,43
40,Fail,42,26,6,15,27
40,Fail,42,30,3,14,28
40,Fail,49,20,3,12,37
40,Fail,50,27,0,11,39
40,Fail,44,27,4,14,30
40,Fail,48,29,6,9,39
40,Success,53,27,0,8,45
40,Fail,49,25,0,10,39
40,Fail,36,40,0,16,20
40,Fail,47,19,0,23,24
40,Success,54,29,0,7,47
40,Fail,52,24,2,13,39
40,Success,53,26,0,9,44
40,Fail,46,28,0,14,32
40,Fail,49,34,0,10,39
40,Fail,41,34,4,13,28
40,Fail,45,29,0,19,26
40,Fail,45,26,1,16,29
40,Success,60,15,0,9,51
40,Fail,43,28,1,14,29
40,Success,52,23,0,11,41
40,Success,50,26,0,10,40
40,Fail,47,32,0,15,32
40,Fail,37,31,5,15,22
40,Success,51,25,0,11,40
40,Success,54,25,0,12,42
40,Fail,47,27,3,14,33
40,Fail,47,29,0,14,33
40,Fail,49,23,6,11,38
40,Fail,49,20,5,14,35
40,Fail,47,30,0,16,31
40,Fail,37,41,0,14,23
40,Fail,37,43,0,10,27
40,Fail,50,27,0,11,39
40,Success,57,18,3,13,44
40,Fail,47,30,0,14,33
40,Fail,49,28,2,12,37
40,Fail,34,37,0,17,17
40,Fail,46,31,0,12,34
40,Fail,47,28,0,16,31
40,Fail,41,28,4,19,22
40,Success,51,21,5,11,40
40,Fail,50,29,0,15,35
40,Fail,45,38,0,11,34
40,Fail,50,27,0,13,37
40,Fail,43,44,0,8,35
40,Fail,40,41,0,11,29
40,Fail,40,29,5,16,24
40,Fail,44,29,7,13,31
40,Fail,41,29,2,14,27
40,Fail,50,25,0,11,39
40,Fail,43,33,0,15,28
40,Fail,48,24,7,13,35
40,Fail,48,27,0,12,36
40,Success,52,33,0,6,46
40,Fail,44,34,0,15,29
40,Fail,45,26,8,11,34
40,Fail,48,34,0,9,39
40,Fail,45,28,0,14,31
40,Success,52,34,0,7,45
40,Success,54,19,0,10,44
40,Fail,42,24,3,17,25
40,Fail,43,32,0,14,29
40,Fail,50,22,3,14,36
40,Fail,45,29,2,13,32
40,Fail,41,37,0,12,29
40,Fail,42,30,3,15,27
40,Fail,46,25,0,14,32
40,Success,53,25,1,9,44
40,Success,50,26,1,10,40
40,Success,53,24,1,11,42
40,Fail,43,32,0,14,29
40,Success,50,32,1,7,43
40,Fail,43,28,0,13,30
40,Fail,39,30,6,14,25
40,Fail,47,27,9,10,37
40,Fail,48,31,1,10,38
40,Success,49,22,11,7,42
40,Fail,51,25,1,12,39
40,Success,62,21,0,9,53
40,Fail,44,39,0,9,35
40,Fail,51,20,4,15,36
40,Success,51,23,10,8,43
40,Fail,46,31,2,11,35
40,Fail,48,21,11,12,36
40,Fail,45,23,7,17,28
40,Fail,48,32,0,11,37
40,Fail,55,17,0,17,38
40,Success,53,25,0,10,43
40,Success,54,27,0,8,46
40,Success,52,23,0,12,40
40,Success,49,26,6,7,42
40,Success,55,22,0,14,41
40,Fail,46,22,2,12,34
40,Fail,50,22,5,13,37
40,Fail,54,12,7,21,33
40,Fail,44,25,0,17,27
40,Fail,50,21,14,13,37
40,Success,57,20,0,9,48
40,Fail,50,21,7,11,39
40,Fail,44,39,0,11,33
40,Fail,45,24,7,11,34
40,Success,52,27,0,11,41
40,Success,50,33,0,9,41
40,Success,56,18,5,8,48
40,Fail,51,19,0,15,36
40,Fail,42,32,0,14,28
40,Success,53,25,0,9,44
40,Fail,47,23,4,12,35
40,Fail,45,26,0,15,30
40,Success,52,29,0,9,43
40,Fail,46,26,0,16,30
40,Fail,51,20,0,21,30
40,Success,58,19,0,9,49
40,Success,50,32,0,9,41
40,Success,49,34,0,7,42
40,Success,55,23,4,11,44
40,Fail,42,28,0,17,25
40,Fail,37,33,5,14,23
40,Fail,44,35,0,12,32
40,Fail,43,30,10,10,33
40,Success,57,21,0,11,46
40,Fail,51,21,0,16,35
40,Fail,51,23,0,16,35
40,Fail,41,25,5,19,22
40,Fail,48,21,5,13,35
40,Fail,47,26,4,11,36
40,Fail,48,25,2,14,34
40,Fail,45,39,0,9,36
40,Fail,50,28,0,13,37
40,Success,51,29,0,9,42
40,Fail,45,22,11,11,34
40,Success,55,25,0,7,48
40,Fail,51,24,0,13,38
40,Fail,46,36,0,8,38
40,Fail,51,23,0,13,38
40,Fail,48,25,2,12,36
40,Fail,49,25,4,11,38
40,Fail,49,27,2,11,38
40,Fail,45,28,0,20,25
40,Fail,47,26,4,11,36
40,Success,53,27,0,9,44
40,Fail,45,35,0,10,35
40,Fail,44,38,0,9,35
40,Fail,44,31,0,12,32
40,Success,58,22,3,7,51
40,Success,54,26,1,9,45
40,Success,56,22,2,7,49
40,Fail,45,38,0,9,36
40,Fail,44,29,3,15,29
40,Fail,46,24,4,16,30
40,Success,50,27,0,10,40
40,Fail,40,44,0,11,29
40,Fail,52,22,0,13,39
40,Fail,39,29,8,16,23
40,Success,54,27,0,14,40
40,Success,52,24,0,11,41
40,Success,55,24,0,13,42
40,Fail,47,31,0,11,36
40,Fail,50,26,1,14,36
40,Fail,48,29,0,12,36
40,Success,56,30,0,9,47
40,Success,53,30,0,10,43
40,Fail,48,21,1,16,32
40,Fail,39,37,0,17,22
40,Fail,49,25,3,14,35
40,Fail,46,36,0,8,38
40,Fail,42,28,2,14,28
40,Fail,48,29,0,10,38
40,Fail,44,29,0,13,31
40,Fail,48,25,0,14,34
40,Fail,51,23,6,12,39
40,Fail,46,31,0,13,33
40,Fail,43,29,0,17,26
40,Fail,46,31,0,16,30
40,Fail,47,22,1,16,31
40,Success,50,28,3,10,40
40,Fail,46,29,0,14,32
40,Fail,46,25,4,16,30
40,Fail,40,31,4,12,28
40,Success,49,31,0,9,40
40,Fail,52,25,0,14,38
40,Fail,45,23,8,19,26
40,Fail,47,25,5,12,35
40,Success,53,20,2,9,44
40,Fail,50,18,3,17,33
40,Success,52,22,2,12,40
40,Fail,40,25,10,16,24
40,Fail,48,26,1,14,34
40,Fail,44,24,8,15,29
40,Fail,48,29,0,11,37
40,Success,53,20,1,12,41
40,Success,52,22,2,12,40
40,Fail,46,21,9,14,32
40,Fail,43,37,0,13,30
40,Success,55,28,0,7,48
40,Fail,49,23,0,15,34
40,Fail,46,33,0,12,34
40,Success,54,22,1,8,46
40,Fail,47,21,8,14,33
40,Success,55,20,2,13,42
40,Fail,47,28,0,14,33
40,Fail,43,38,0,12,31
40,Fail,49,24,0,13,36
40,Fail,42,26,8,17,25
40,Success,58,21,0,9,49
40,Fail,44,35,0,13,31
40,Fail,47,22,0,15,32
40,Fail,46,25,1,14,32
40,Fail,45,27,7,11,34
40,Success,51,24,2,11,40
40,Fail,46,29,5,10,36
40,Fail,48,38,0,9,39
40,Fail,44,35,0,7,37
40,Fail,49,23,0,13,36
40,Fail,41,32,0,17,24
40,Fail,40,37,0,15,25
40,Fail,48,25,5,14,34
40,Fail,45,23,4,18,27
40,Success,50,30,0,9,41
40,Success,51,28,4,10,41
40,Success,49,27,4,9,40
40,Success,58,11,1,13,45
40,Fail,44,34,6,10,34
40,Success,51,23,0,11,40
40,Fail,51,24,5,13,38
40,Success,50,33,4,4,46
40,Fail,46,35,0,10,36
40,Fail,43,21,3,18,25
40,Success,55,23,1,6,49
40,Fail,47,25,8,9,38
40,Fail,45,32,1,11,34
40,Success,58,17,0,13,45
40,Success,56,18,0,13,43
40,Fail,47,28,0,14,33
40,Success,55,19,0,14,41
40,Success,52,26,5,9,43
40,Fail,41,29,5,17,24
40,Fail,44,31,4,11,33
40,Fail,48,32,0,9,39
40,Fail,45,35,0,11,34
40,Success,54,20,0,14,40
40,Fail,40,31,0,19,21
40,Fail,36,45,0,10,26
40,Fail,42,32,0,18,24
40,Fail,43,26,5,17,26
40,Fail,42,30,0,17,25
40,Fail,47,25,9,13,34
40,Fail,51,24,0,15,36
40,Fail,44,40,0,9,35
40,Fail,45,29,2,12,33
40,Success,55,24,0,11,44
40,Fail,44,33,0,14,30
40,Success,56,21,0,12,44
40,Fail,48,21,4,14,34
40,Success,52,21,4,11,41
40,Fail,45,33,0,13,32
40,Fail,44,30,7,11,33
40,Success,56,23,0,10,46
40,Fail,42,24,7,17,25
40,Fail,46,25,0,13,33
40,Fail,47,29,3,10,37
40,Fail,43,22,8,16,27
40,Success,55,24,4,7,48
40,Fail,46,34,0,14,32
40,Fail,40,32,9,10,30
40,Fail,46,23,0,18,28
40,Success,54,21,1,12,42
40,Fail,47,25,0,16,31
40,Fail,46,28,6,9,37
40,Success,50,26,5,10,40
40,Fail,46,21,5,14,32
40,Fail,48,19,12,11,37
40,Fail,51,23,0,16,35
40,Success,52,28,0,7,45
40,Success,52,25,3,12,40
40,Fail,48,33,0,9,39
40,Fail,51,19,0,16,35
40,Fail,36,37,5,14,22
40,Fail,45,36,0,12,33
40,Fail,45,30,1,15,30
40,Success,55,23,2,10,45
40,Fail,46,30,3,13,33
40,Fail,45,28,5,12,33
40,Success,55,18,2,12,43
40,Success,51,25,4,8,43
40,Fail,47,28,0,12,35
40,Fail,51,13,3,20,31
40,Fail,47,27,0,16,31
40,Fail,46,29,0,19,27
40,Fail,48,21,1,16,32
40,Fail,42,22,6,21,21
40,Success,54,24,0,13,41
40,Success,54,28,0,6,48
40,Success,50,30,2,9,41
40,Fail,48,37,0,9,39
40,Fail,46,29,4,9,37
40,Success,57,15,5,9,48
40,Success,58,21,0,7,51
40,Fail,42,37,0,14,28
40,Fail,53,18,2,17,36
40,Fail,40,23,12,19,21
40,Success,58,23,1,8,50
40,Fail,49,20,6,12,37
40,Fail,49,24,2,16,33
40,Fail,51,24,0,14,37
40,Success,52,26,0,12,40
40,Fail,51,28,0,12,39
40,Fail,54,21,0,16,38
40,Fail,46,25,0,17,29
40,Fail,45,21,7,14,31
40,Fail,46,33,2,9,37
40,Success,49,30,0,9,40
40,Fail,39,28,11,14,25
40,Success,53,31,0,8,45
40,Success,52,32,0,8,44
40,Fail,49,26,3,11,38
40,Fail,47,25,2,16,31
40,Success,53,23,0,13,40
40,Fail,50,26,0,13,37
40,Fail,49,27,3,10,39
40,Fail,49,25,0,16,33
40,Fail,48,29,0,14,34
40,Fail,52,18,0,19,33
40,Success,52,30,0,6,46
40,Success,54,21,4,10,44
40,Fail,49,32,0,12,37
40,Success,51,21,6,9,42
40,Success,54,25,0,9,45
40,Fail,50,24,2,14,36
40,Fail,44,33,0,12,32
40,Fail,48,26,0,14,34
40,Success,56,25,0,9,47
40,Fail,43,38,0,12,31
40,Fail,48,30,0,15,33
40,Fail,43,22,11,13,30
40,Success,56,28,0,9,47
40,Fail,49,31,0,10,39
40,Fail,52,17,3,16,36
40,Fail,45,23,0,16,29
40,Success,60,22,0,7,53
40,Fail,49,29,0,14,35
40,Success,50,21,8,10,40
40,Fail,39,40,2,11,28
40,Success,55,21,4,8,47
40,Fail,47,22,1,13,34
40,Success,57,15,2,15,42
40,Fail,53,19,2,14,39
40,Success,48,33,1,7,41
40,Success,50,26,2,10,40
40,Fail,42,35,0,13,29
40,Fail,49,24,3,15,34
40,Success,53,22,2,10,43
40,Fail,52,19,2,16,36
40,Fail,43,32,7,9,34
40,Success,57,23,0,6,51
40,Fail,41,25,5,19,22
40,Fail,51,27,0,12,39
40,Success,59,21,0,8,51
40,Success,54,23,0,10,44
40,Fail,44,34,0,12,32
40,Fail,48,31,0,11,37
40,Fail,51,22,0,18,33
40,Fail,48,27,0,13,35
40,Success,54,21,0,11,43
40,Fail,42,36,0,13,29
40,Fail,51,22,0,15,36
40,Fail,44,32,0,13,31
40,Success,58,21,0,15,43
40,Success,53,24,0,13,40
40,Fail,48,21,5,15,33
40,Fail,51,25,0,13,38
40,Success,50,30,2,8,42
40,Fail,49,24,6,13,36
40,Fail,45,39,0,11,34
40,Success,54,23,0,11,43
40,Fail,42,39,0,13,29
40,Fail,43,29,5,14,29
40,Success,52,30,0,9,43
40,Fail,46,25,3,15,31
40,Fail,46,29,0,13,33
40,Fail,54,22,0,17,37
40,Fail,44,31,5,13,31
40,Fail,41,28,9,13,28
40,Fail,41,20,8,23,18
40,Fail,47,26,0,15,32
40,Fail,44,26,0,19,25
40,Success,54,24,0,11,43
40,Fail,37,41,0,10,27
40,Success,55,22,0,12,43
40,Fail,41,33,0,19,22
40,Fail,52,17,5,16,36
40,Success,49,28,0,9,40
40,Fail,48,27,1,11,37
40,Success,54,29,0,8,46
40,Fail,39,48,0,6,33
40,Success,50,25,0,10,40
40,Fail,51,29,0,13,38
40,Fail,44,36,0,9,35
40,Fail,47,28,0,16,31
40,Success,50,24,12,7,43
40,Fail,48,22,2,14,34
40,Success,50,31,0,10,40
40,Fail,49,30,2,10,39
40,Fail,51,26,0,12,39
40,Fail,45,28,0,17,28
40,Success,54,32,0,3,51
40,Success,57,25,0,9,48
40,Fail,50,20,5,15,35
40,Fail,46,33,0,13,33
40,Fail,46,32,0,14,32
40,Fail,48,28,0,9,39
40,Fail,43,35,0,13,30
40,Fail,50,32,0,12,38
40,Fail,47,29,0,11,36
40,Fail,51,25,2,12,39
40,Fail,48,26,7,13,35
40,Fail,43,32,5,9,34
40,Fail,49,27,0,10,39
40,Fail,47,18,5,18,29
40,Success,56,18,0,13,43
40,Fail,46,27,8,13,33
40,Fail,45,33,0,13,32
40,Fail,44,27,0,19,25
40,Success,54,25,5,7,47
40,Success,58,23,3,8,50
40,Success,52,29,0,7,45
40,Success,52,26,3,12,40
40,Fail,44,30,0,17,27
40,Success,50,39,0,6,44
40,Fail,49,28,0,14,35
40,Success,52,26,0,10,42
40,Fail,48,30,0,10,38
40,Fail,54,21,0,15,39
40,Fail,48,25,0,16,32
40,Fail,45,33,0,11,34
40,Success,59,21,0,13,46
40,Fail,50,30,0,11,39
40,Fail,47,26,0,14,33
40,Fail,51,20,1,14,37
40,Fail,39,36,0,19,20
40,Success,50,25,5,7,43
40,Success,53,25,0,9,44
40,Success,50,24,4,10,40
40,Fail,52,28,3,13,39
40,Fail,46,32,0,10,36
40,Fail,52,22,0,13,39
40,Success,62,19,0,6,56
40,Fail,35,33,10,13,22
40,Success,54,30,0,7,47
40,Fail,50,28,0,12,38
40,Success,48,29,0,6,42
40,Fail,46,28,3,11,35
40,Success,54,18,4,11,43
40,Fail,47,23,3,19,28
40,Success,55,25,0,9,46
40,Success,49,29,3,9,40
40,Success,56,21,2,9,47
40,Fail,46,38,0,10,36
40,Fail,42,29,1,15,27
40,Fail,32,26,7,24,8
40,Fail,48,26,0,13,35
40,Fail,43,30,0,17,26
40,Success,53,29,0,12,41
40,Fail,50,25,1,11,39
40,Fail,46,37,0,12,34
40,Fail,47,28,5,13,34
40,Fail,35,39,6,11,24
40,Fail,35,41,0,17,18
40,Success,50,27,0,10,40
40,Fail,48,18,7,14,34
40,Fail,43,28,5,13,30
40,Fail,44,35,0,15,29
40,Fail,47,25,8,10,37
40,Fail,48,36,0,11,37
40,Fail,40,31,2,16,24
40,Success,54,26,0,10,44
40,Fail,47,22,9,13,34
40,Fail,45,24,4,17,28
40,Success,51,25,4,10,41
40,Success,53,31,0,7,46
40,Success,51,33,0,7,44
40,Fail,48,20,6,13,35
40,Fail,45,28,0,19,26
40,Fail,42,34,0,12,30
40,Success,47,38,0,7,40
40,Fail,47,29,6,10,37
40,Fail,46,32,0,13,33
40,Fail,51,17,0,18,33
40,Success,56,17,0,13,43
40,Success,52,25,10,8,44
40,Fail,45,25,3,18,27
40,Success,53,17,5,13,40
40,Success,51,30,0,11,40
40,Success,51,21,14,8,43
40,Fail,51,24,0,14,37
40,Fail,35,34,4,18,17
40,Fail,50,14,4,18,32
40,Fail,49,26,0,14,35
40,Success,52,22,2,10,42
40,Fail,49,28,0,11,38
40,Fail,44,31,7,12,32
40,Fail,46,34,0,9,37
40,Fail,43,30,9,14,29
40,Fail,47,24,1,18,29
40,Success,50,24,0,10,40
40,Fail,39,30,3,17,22
40,Success,52,28,0,11,41
40,Fail,48,22,3,16,32
40,Fail,50,22,4,13,37
40,Fail,43,27,9,14,29
40,Fail,45,22,13,11,34
40,Fail,45,33,0,14,31
40,Fail,45,32,0,14,31
40,Success,51,25,3,10,41
40,Fail,42,37,0,11,31
40,Fail,45,25,1,13,32
40,Fail,45,35,0,13,32
40,Success,51,20,6,11,40
40,Success,61,17,0,7,54
40,Fail,43,27,4,15,28
40,Fail,49,27,1,10,39
40,Fail,50,20,3,14,36
40,Success,53,18,3,11,42
40,Fail,39,34,0,15,24
40,Fail,44,28,0,15,29
40,Fail,52,26,2,14,38
40,Fail,47,26,3,13,34
40,Fail,45,34,0,14,31
40,Success,51,28,0,10,41
40,Success,51,28,0,8,43
40,Fail,51,27,0,15,36
40,Fail,50,22,5,13,37
40,Fail,40,32,3,13,27
40,Fail,44,33,0,14,30
40,Fail,47,26,4,13,34
40,Fail,51,22,0,16,35
40,Fail,45,21,5,18,27
40,Success,53,28,0,10,43
40,Success,56,28,0,7,49
40,Fail,42,31,6,11,31
40,Success,50,28,3,10,40
40,Success,53,26,0,10,43
40,Fail,49,22,1,13,36
40,Success,54,19,0,12,42
40,Fail,48,28,2,10,38
40,Success,54,27,0,11,43
40,Fail,44,26,0,12,32
40,Fail,42,32,0,17,25
40,Success,54,25,4,7,47
40,Fail,32,35,6,18,14
40,Fail,44,33,0,13,31
40,Success,56,17,0,14,42
40,Fail,47,24,0,17,30
40,Fail,46,25,2,14,32
40,Success,55,23,0,14,41
40,Success,52,23,3,9,43
40,Success,58,19,0,13,45
40,Success,53,22,2,10,43
40,Success,51,23,2,7,44
40,Fail,51,26,0,12,39
40,Fail,49,23,5,11,38
40,Fail,47,35,0,9,38
40,Fail,51,27,1,12,39
40,Fail,41,27,0,22,19
40,Fail,53,18,4,15,38
40,Fail,50,26,0,13,37
40,Fail,44,25,8,11,33
40,Success,50,30,0,8,42
40,Fail,48,30,0,12,36
40,Fail,51,16,3,19,32
40,Fail,53,22,0,15,38
40,Fail,46,28,1,14,32
40,Fail,46,25,1,16,30
40,Fail,52,22,0,15,37
40,Fail,48,25,2,12,36
40,Success,53,24,0,10,43
40,Fail,45,29,0,17,28
40,Fail,50,28,0,13,37
40,Fail,51,27,0,12,39
40,Fail,45,39,0,7,38
40,Success,57,24,0,9,48
40,Fail,43,26,0,19,24
40,Fail,46,37,0,7,39
40,Fail,43,41,0,8,35
40,Fail,50,26,2,12,38
40,Fail,41,31,5,16,25
40,Fail,47,25,6,13,34
40,Success,55,23,1,9,46
40,Fail,48,34,0,9,39
40,Fail,46,30,0,12,34
40,Success,52,26,2,12,40
40,Success,55,29,0,8,47
40,Fail,46,26,0,14,32
40,Fail,45,29,0,11,34
40,Fail,51,19,2,17,34
40,Success,55,22,0,11,44
40,Fail,42,33,5,12,30
40,Success,50,25,5,7,43
40,Fail,49,27,0,10,39
40,Fail,43,31,0,17,26
40,Fail,48,21,4,18,30
40,Success,51,29,2,9,42
40,Fail,45,25,9,16,29
40,Fail,52,20,4,14,38
40,Success,50,29,0,10,40
40,Fail,40,32,0,15,25
40,Fail,49,24,5,13,36
40,Fail,50,23,6,12,38
40,Fail,43,35,5,8,35
40,Success,51,27,0,11,40
40,Fail,51,26,0,13,38
40,Fail,49,20,8,15,34
40,Fail,45,35,0,12,33
40,Success,51,31,0,7,44
40,Success,54,25,0,8,46
40,Fail,45,25,4,17,28
40,Fail,52,22,0,13,39
40,Fail,50,23,0,15,35
40,Success,52,23,3,12,40
40,Fail,46,26,5,12,34
40,Fail,43,32,0,13,30
40,Success,56,22,0,12,44
40,Success,49,33,0,9,40
40,Fail,51,24,0,13,38
40,Success,54,23,0,13,41
40,Fail,49,27,0,12,37
40,Fail,47,24,5,15,32
40,Fail,48,30,0,11,37
40,Fail,48,27,3,13,35
40,Fail,44,26,3,12,32
40,Success,50,31,0,10,40
40,Success,59,20,0,9,50
40,Fail,38,33,0,16,22
40,Fail,40,33,3,13,27
40,Success,50,29,3,7,43
40,Fail,38,29,12,13,25
40,Success,56,16,1,10,46
40,Fail,43,31,5,10,33
40,Fail,51,29,0,12,39
40,Fail,45,26,2,15,30
40,Fail,52,22,0,14,38
40,Fail,49,24,3,12,37
40,Fail,43,36,0,14,29
40,Success,55,24,1,10,45
40,Fail,47,24,5,16,31
40,Fail,42,27,11,12,30
40,Fail,41,29,7,15,26
40,Fail,52,24,0,14,38
40,Fail,51,24,0,13,38
40,Fail,44,24,8,14,30
40,Fail,46,28,0,14,32
40,Success,49,30,1,8,41
40,Fail,46,23,0,15,31
40,Fail,43,33,0,14,29
40,Fail,46,26,4,13,33
40,Success,55,19,0,11,44
40,Fail,45,34,0,13,32
40,Success,47,26,11,7,40
40,Fail,48,19,7,14,34
40,Fail,45,26,4,15,30
40,Fail,46,30,0,14,32
40,Success,60,18,0,13,47
40,Fail,48,31,0,16,32
40,Fail,46,24,0,17,29
40,Fail,52,16,6,20,32
40,Fail,48,19,6,16,32
40,Fail,43,27,11,14,29
40,Fail,45,30,0,15,30
40,Fail,44,28,8,11,33
40,Fail,44,33,4,9,35
40,Fail,51,24,0,12,39
40,Fail,44,29,2,11,33
40,Fail,46,28,0,14,32
40,Fail,46,18,6,18,28
40,Fail,44,30,2,14,30
40,Fail,43,34,2,12,31
40,Fail,48,31,0,12,36
40,Fail,45,30,0,13,32
40,Fail,52,21,2,13,39
40,Fail,50,25,2,14,36
40,Fail,47,32,0,12,35
40,Success,53,25,0,11,42
40,Success,55,21,2,9,46
40,Fail,43,40,0,10,33
40,Success,54,20,0,12,42
40,Fail,48,26,2,12,36
40,Success,55,23,1,11,44
40,Success,46,33,0,6,40
40,Fail,47,23,0,14,33
40,Fail,50,20,4,13,37
40,Fail,47,22,0,18,29
40,Fail,48,21,7,15,33
40,Fail,45,23,9,14,31
40,Fail,48,31,4,11,37
40,Fail,48,32,0,12,36
40,Fail,47,28,1,14,33
40,Success,57,17,0,14,43
40,Fail,48,31,0,13,35
40,Fail,46,29,6,9,37
40,Fail,48,31,0,10,38
40,Fail,42,32,3,10,32
40,Fail,48,31,0,11,37
40,Fail,45,22,5,19,26
40,Fail,42,31,4,15,27
40,Fail,47,27,3,14,33
40,Fail,50,19,6,11,39
40,Success,54,19,5,10,44
40,Success,52,19,4,11,41
40,Success,54,25,0,9,45
40,Fail,44,31,0,16,28
40,Fail,49,24,0,15,34
40,Fail,47,32,4,9,38
40,Fail,48,28,0,13,35
40,Fail,54,20,0,16,38
40,Fail,46,21,4,19,27
40,Fail,51,28,0,12,39
40,Success,51,32,0,11,40
40,Fail,49,32,0,10,39
40,Fail,45,22,13,14,31
40,Fail,48,28,0,13,35
40,Fail,46,30,2,10,36
40,Fail,50,25,0,16,34
40,Fail,50,31,0,11,39
40,Success,56,24,0,9,47
40,Success,55,20,3,9,46
40,Fail,49,21,7,16,33
40,Fail,35,32,11,13,22
40,Fail,48,33,0,9,39
40,Fail,45,25,0,17,28
40,Success,56,22,4,9,47
40,Fail,41,29,0,17,24
40,Success,59,26,0,2,57
40,Success,61,23,0,5,56
40,Fail,53,16,0,18,35
40,Fail,51,24,0,13,38
40,Success,56,24,0,6,50
40,Fail,45,31,1,14,31
40,Fail,46,33,0,13,33
40,Fail,51,23,2,16,35
40,Fail,45,24,0,18,27
40,Fail,48,24,4,15,33
40,Fail,49,28,0,14,35
40,Fail,47,23,2,12,35
40,Fail,49,25,4,11,38
40,Fail,37,36,3,13,24
40,Success,51,28,0,9,42
40,Fail,48,22,1,16,32
40,Fail,47,30,2,9,38
40,Fail,48,25,0,15,33
40,Fail,53,25,0,14,39
40,Fail,47,30,0,12,35
40,Fail,45,28,2,15,30
40,Fail,49,30,0,15,34
40,Success,54,20,0,14,40
40,Success,51,26,3,9,42
40,Fail,49,24,0,18,31
40,Fail,53,22,0,14,39
40,Fail,49,25,3,10,39
40,Success,52,27,0,9,43
40,Fail,40,36,0,12,28
40,Fail,46,33,0,9,37
40,Fail,41,35,3,11,30
40,Fail,49,31,0,10,39
40,Success,56,18,3,11,45
40,Fail,41,21,11,19,22
40,Fail,44,36,0,13,31
40,Fail,51,23,0,17,34
40,Fail,53,21,2,14,39
40,Fail,48,24,0,13,35
40,Fail,48,27,0,12,36
40,Fail,46,31,0,14,32
40,Fail,43,26,6,13,30
40,Fail,48,24,4,16,32
40,Fail,40,36,0,13,27
40,Fail,42,31,0,17,25
40,Success,50,26,2,10,40
40,Fail,41,28,9,15,26
40,Fail,42,26,7,17,25
40,Fail,39,29,6,15,24
40,Success,54,30,0,9,45
40,Fail,43,30,3,12,31
40,Fail,40,33,6,13,27
40,Fail,45,28,1,17,28
40,Success,53,25,0,8,45
40,Fail,47,24,3,17,30
40,Fail,47,27,0,13,34
40,Fail,45,31,2,12,33
40,Success,53,22,1,11,42
40,Fail,45,28,8,9,36
40,Success,57,19,2,10,47
40,Fail,51,29,0,13,38
40,Success,54,24,0,14,40
40,Success,53,26,1,12,41
40,Fail,49,29,0,12,37
40,Fail,48,22,11,13,35
40,Fail,46,33,0,13,33
40,Fail,45,35,0,12,33
40,Fail,50,24,1,13,37
40,Fail,41,25,15,10,31
40,Fail,51,27,0,12,39
40,Success,56,19,0,13,43
40,Fail,45,34,0,11,34
40,Fail,50,22,0,17,33
40,Success,50,31,0,8,42
40,Success,56,18,4,12,44
40,Fail,42,25,3,17,25
40,Fail,46,30,0,12,34
40,Fail,46,32,2,11,35
40,Fail,48,30,2,9,39
40,Fail,53,20,4,15,38
40,Fail,48,27,0,12,36
40,Success,52,26,3,7,45
40,Fail,47,26,1,14,33
40,Fail,43,29,0,17,26
40,Fail,44,26,0,17,27
40,Fail,42,31,3,14,28
40,Fail,43,33,0,16,27
40,Fail,50,24,4,11,39
40,Fail,47,23,6,11,36
40,Fail,44,32,0,14,30
40,Fail,51,23,0,16,35
40,Fail,48,24,0,15,33
40,Fail,49,25,0,14,35
40,Fail,45,35,0,8,37
40,Fail,38,31,0,18,20
40,Fail,54,17,0,16,38
40,Fail,44,34,0,11,33
40,Fail,47,30,0,11,36
40,Success,53,27,0,8,45
40,Success,51,27,0,8,43
40,Fail,42,30,0,19,23
40,Fail,48,27,0,14,34
40,Fail,46,28,1,14,32
40,Fail,48,27,0,12,36
40,Fail,47,31,3,12,35
40,Fail,47,31,0,10,37
40,Fail,44,29,2,14,30
40,Success,56,18,0,13,43
40,Fail,41,24,8,17,24
40,Fail,44,24,3,18,26
40,Success,52,27,0,10,42
40,Fail,53,22,0,14,39
40,Fail,43,26,9,11,32
40,Success,54,20,0,10,44
40,Success,50,28,3,8,42
40,Success,50,26,1,7,43
40,Success,52,29,0,9,43
40,Fail,37,36,0,17,20
40,Fail,48,32,0,11,37
40,Success,46,30,6,6,40
40,Fail,48,30,0,11,37
40,Fail,48,25,0,19,29
40,Fail,42,34,0,8,34
40,Fail,48,24,0,17,31
40,Fail,51,19,0,14,37
40,Fail,48,27,0,13,35
40,Fail,47,28,0,13,34
40,Fail,48,27,0,11,37
40,Fail,44,36,0,11,33
40,Success,54,24,0,9,45
40,Success,52,24,0,11,41
40,Success,56,18,0,14,42
40,Fail,50,23,0,13,37
40,Fail,47,27,2,11,36
40,Fail,41,29,6,15,26
40,Success,49,27,0,8,41
40,Fail,45,35,2,10,35
40,Success,53,27,1,10,43
40,Success,55,17,0,14,41
40,Success,54,24,0,11,43
40,Success,58,21,1,6,52
40,Success,52,27,0,10,42
40,Success,56,24,0,6,50
40,Fail,45,30,0,18,27
40,Fail,48,22,7,11,37
40,Fail,49,27,1,11,38
40,Fail,49,26,0,13,36
40,Success,52,25,4,7,45
40,Success,55,22,6,8,47
40,Fail,48,26,4,12,36
40,Fail,45,34,0,11,34
40,Fail,44,27,4,14,30
40,Fail,40,38,0,16,24
40,Fail,41,24,3,20,21
40,Fail,45,30,0,14,31
40,Fail,49,28,4,10,39
40,Fail,47,31,0,13,34
40,Fail,46,28,0,17,29
40,Success,57,17,0,13,44
40,Fail,50,22,0,16,34
40,Fail,46,27,0,20,26
40,Fail,46,34,0,10,36
40,Fail,45,25,10,10,35
40,Fail,44,20,8,23,21
40,Fail,47,28,2,11,36
40,Fail,47,29,0,13,34
40,Fail,49,27,0,16,33
40,Success,51,26,5,10,41
40,Fail,37,34,0,23,14
40,Fail,45,25,0,20,25
40,Fail,45,36,0,9,36
40,Success,54,19,0,12,42
40,Fail,46,26,9,10,36
40,Fail,45,24,1,13,32
40,Fail,53,17,0,17,36
40,Success,49,26,1,9,40
40,Fail,39,24,10,15,24
40,Success,53,25,0,11,42
40,Fail,43,32,0,16,27
40,Fail,49,23,6,14,35
40,Success,55,20,1,11,44
40,Fail,42,28,11,10,32
40,Fail,38,31,9,12,26
40,Success,51,25,0,7,44
40,Fail,43,37,0,11,32
40,Fail,47,34,0,12,35
40,Fail,49,27,0,12,37
40,Success,53,24,0,11,42
40,Fail,49,20,3,17,32
40,Fail,46,23,2,21,25
40,Fail,43,24,6,16,27
40,Fail,51,22,0,14,37
40,Fail,40,24,8,19,21
40,Success,50,30,3,9,41
40,Success,58,23,0,8,50
40,Fail,44,33,0,16,28
40,Fail,45,25,3,13,32
40,Success,55,14,8,10,45
40,Fail,47,32,0,13,34
40,Fail,46,21,3,20,26
40,Fail,52,21,1,16,36
40,Fail,46,29,3,13,33
40,Fail,43,26,0,21,22
40,Fail,48,31,2,10,38
40,Fail,41,37,0,14,27
40,Fail,44,32,4,11,33
40,Fail,50,28,0,13,37
40,Success,55,27,0,12,43
40,Fail,47,34,0,9,38
40,Success,53,18,4,13,40
40,Fail,49,25,5,12,37
40,Fail,49,28,3,10,39
40,Fail,50,29,0,11,39
40,Success,53,22,0,12,41
40,Success,51,29,0,7,44
40,Fail,49,24,7,10,39
40,Fail,49,26,3,13,36
40,Fail,43,34,0,11,32
40,Fail,44,25,7,15,29
40,Fail,48,25,8,11,37
40,Fail,53,21,1,14,39
40,Success,57,23,0,10,47
40,Success,54,24,1,7,47
40,Fail,42,25,0,18,24
40,Success,51,25,0,10,41
40,Fail,43,23,10,17,26
40,Success,59,14,8,12,47
40,Fail,47,28,2,14,33
40,Fail,46,21,2,19,27
40,Fail,50,26,0,12,38
40,Fail,43,29,2,17,26
40,Success,52,25,0,10,42
40,Fail,47,28,0,12,35
40,Fail,41,31,7,10,31
40,Success,47,31,0,7,40
40,Fail,45,25,0,13,32
40,Fail,44,33,6,7,37
40,Fail,49,16,6,20,29
40,Success,48,35,0,6,42
40,Fail,45,25,1,15,30
40,Fail,48,24,4,17,31
40,Fail,43,35,0,13,30
40,Fail,40,31,4,18,22
40,Fail,48,32,0,9,39
40,Fail,46,36,0,12,34
40,Fail,49,23,0,12,37
40,Success,53,26,0,9,44
40,Fail,45,40,0,9,36
40,Fail,48,20,3,16,32
40,Success,57,17,7,11,46
40,Fail,39,44,0,10,29
40,Fail,49,31,0,11,38
40,Success,54,23,0,8,46
40,Success,54,20,7,9,45
40,Success,50,27,9,8,42
40,Success,53,25,9,5,48
40,Fail,43,28,6,10,33
40,Fail,47,24,0,16,31
40,Fail,49,28,2,11,38
40,Fail,48,24,5,13,35
40,Fail,37,27,6,17,20
40,Fail,49,27,0,11,38
40,Fail,50,20,3,14,36
40,Fail,45,38,0,10,35
40,Success,51,22,0,10,41
40,Fail,49,24,6,12,37
40,Fail,42,25,5,20,22
40,Success,49,30,0,7,42
40,Fail,46,15,8,22,24
40,Fail,48,21,6,15,33
40,Fail,49,21,4,15,34
40,Fail,51,24,0,14,37
40,Fail,48,25,5,13,35
40,Success,54,28,1,9,45
40,Fail,49,26,0,12,37
40,Fail,44,27,3,13,31
40,Fail,43,33,0,14,29
40,Success,54,24,0,10,44
40,Fail,45,34,5,8,37
40,Success,53,29,0,6,47
40,Fail,44,29,7,13,31
40,Fail,46,31,1,11,35
40,Fail,50,22,2,13,37
40,Fail,38,38,0,14,24
40,Fail,49,26,6,12,37
40,Fail,47,28,0,12,35
40,Success,56,14,3,14,42
40,Fail,46,25,5,13,33
40,Fail,45,31,0,16,29
40,Fail,46,28,0,14,32
40,Success,52,26,4,10,42
40,Fail,49,30,0,10,39
40,Fail,45,32,0,14,31
40,Fail,46,28,0,14,32
40,Fail,49,31,0,10,39
40,Fail,49,29,3,10,39
40,Success,52,29,0,8,44
40,Fail,48,36,0,9,39
40,Fail,45,28,0,17,28
40,Fail,44,31,0,16,28
40,Success,48,37,0,8,40
40,Success,51,30,0,7,44
40,Success,53,22,0,13,40
40,Fail,46,23,5,15,31
40,Fail,46,32,1,12,34
40,Fail,45,28,0,20,25
40,Fail,45,35,0,10,35
40,Fail,50,24,0,12,38
40,Fail,47,25,1,17,30
40,Fail,49,27,0,15,34
40,Fail,41,28,5,15,26
40,Fail,51,25,1,13,38
40,Fail,45,34,0,11,34
40,Fail,39,21,5,21,18
40,Success,52,32,0,7,45
40,Fail,45,23,12,12,33
40,Fail,41,30,4,14,27
40,Fail,47,26,0,19,28
40,Fail,39,35,0,13,26
40,Fail,43,32,5,12,31
40,Fail,50,30,0,11,39
40,Success,51,24,0,11,40
40,Success,55,18,3,14,41
40,Fail,48,28,0,13,35
40,Fail,50,30,0,11,39
40,Fail,50,23,0,15,35
40,Fail,45,38,0,9,36
40,Fail,49,23,4,14,35
40,Fail,46,33,0,14,32
40,Fail,46,28,2,12,34
40,Fail,40,29,8,14,26
40,Fail,45,33,9,7,38
40,Fail,40,32,0,18,22
40,Success,57,18,0,10,47
40,Success,53,26,0,10,43
40,Fail,48,27,6,9,39
40,Success,51,31,0,9,42
40,Fail,41,35,0,16,25
40,Fail,46,25,5,15,31
40,Fail,48,28,0,13,35
40,Success,58,18,0,13,45
40,Fail,45,28,0,13,32
40,Success,52,26,0,8,44
40,Success,50,25,4,10,40
40,Success,53,35,0,7,46
40,Fail,49,20,0,22,27
40,Success,55,26,0,8,47
40,Fail,44,32,0,16,28
40,Fail,42,37,0,16,26
40,Fail,48,24,4,14,34
40,Success,58,16,3,12,46
40,Success,55,18,0,12,43
40,Fail,51,24,0,16,35
40,Success,49,28,0,9,40
40,Fail,37,30,6,16,21
40,Fail,44,26,5,19,25
40,Fail,49,21,6,18,31
40,Fail,47,33,0,13,34
40,Fail,45,28,0,15,30
40,Success,54,18,5,12,42
40,Fail,46,21,6,18,28
40,Fail,46,30,0,11,35
40,Fail,46,28,9,10,36
40,Fail,52,19,6,15,37
40,Fail,47,31,0,12,35
40,Fail,49,31,6,10,39
40,Fail,44,29,3,13,31
40,Success,54,23,0,14,40
40,Success,49,27,2,8,41
40,Success,55,29,0,6,49
40,Fail,36,27,3,27,9
40,Fail,50,30,1,11,39
40,Success,54,24,2,12,42
40,Success,58,26,0,7,51
40,Success,48,30,2,8,40
40,Success,52,30,0,9,43
40,Success,53,28,0,8,45
40,Success,53,23,4,10,43
40,Fail,45,32,5,11,34
40,Fail,53,22,0,17,36
40,Success,52,26,0,7,45
40,Fail,47,35,0,9,38
40,Fail,50,24,2,13,37
40,Fail,53,21,1,16,37
40,Fail,52,25,0,13,39
40,Fail,44,24,3,18,26
40,Success,53,25,1,9,44
40,Success,49,26,7,8,41
40,Success,52,19,9,11,41
40,Success,55,24,5,9,46
40,Success,52,24,1,10,42
40,Fail,40,29,0,19,21
40,Fail,51,27,0,12,39
40,Success,49,31,0,8,41
40,Success,57,18,0,13,44
40,Success,50,25,1,10,40
40,Fail,49,25,1,15,34
40,Success,59,21,0,8,51
40,Fail,43,34,0,13,30
40,Success,56,17,0,9,47
40,Fail,46,25,3,12,34
40,Fail,44,34,0,9,35
40,Fail,47,20,4,15,32
40,Fail,53,16,1,16,37
40,Fail,46,25,0,18,28
40,Success,52,24,3,10,42
40,Fail,49,24,0,17,32
40,Fail,45,28,7,13,32
40,Fail,50,21,1,15,35
40,Fail,42,31,5,13,29
40,Fail,46,24,0,18,28
40,Success,52,26,2,11,41
40,Fail,46,29,0,12,34
40,Success,55,29,0,7,48
40,Success,56,24,1,12,44
40,Fail,45,31,0,11,34
40,Success,57,23,0,10,47
40,Fail,49,33,0,13,36
40,Fail,45,35,0,11,34
40,Fail,41,25,7,18,23
40,Fail,49,25,3,16,33
40,Fail,44,25,1,16,28
40,Fail,48,27,0,11,37
40,Fail,50,27,0,11,39
40,Fail,44,34,0,14,30
40,Fail,41,36,0,8,33
40,Success,50,26,5,5,45
40,Fail,39,37,0,15,24
40,Fail,48,19,4,15,33
40,Fail,46,32,0,9,37
40,Success,50,31,0,8,42
40,Fail,40,28,3,19,21
40,Fail,42,25,2,19,23
40,Success,51,25,0,10,41
40,Fail,47,36,0,8,39
40,Fail,49,32,0,10,39
40,Fail,43,31,0,12,31
40,Fail,40,34,10,6,34
40,Fail,45,38,0,7,38
40,Fail,49,23,0,15,34
40,Fail,41,33,7,11,30
40,Fail,51,20,6,13,38
40,Fail,43,28,0,15,28
40,Fail,49,26,2,11,38
40,Success,56,23,0,11,45
40,Fail,50,17,1,17,33
40,Fail,48,23,5,12,36
40,Fail,44,32,6,11,33
40,Fail,50,21,0,16,34
40,Success,59,18,0,12,47
40,Success,52,20,0,12,40
40,Success,51,29,0,8,43
40,Fail,50,28,0,13,37
40,Fail,48,25,5,14,34
40,Fail,51,17,5,15,36
40,Fail,46,32,0,12,34
40,Fail,44,41,0,7,37
40,Fail,43,28,8,9,34
40,Fail,44,32,0,15,29
40,Success,48,32,3,8,40
40,Fail,50,21,3,15,35
40,Fail,49,20,6,13,36
40,Fail,48,32,0,11,37
40,Success,54,26,0,13,41
40,Success,55,21,3,12,43
40,Fail,42,34,0,15,27
40,Fail,42,21,10,21,21
40,Fail,46,33,0,10,36
40,Fail,42,33,4,8,34
40,Fail,51,24,0,13,38
40,Success,51,36,0,6,45
40,Fail,40,31,0,15,25
40,Fail,47,31,1,9,38
40,Fail,52,19,3,17,35
40,Fail,50,30,0,15,35
40,Fail,43,34,0,11,32
40,Fail,46,28,4,13,33
40,Success,57,15,1,14,43
40,Fail,41,35,0,14,27
40,Success,49,35,0,7,42
40,Success,56,19,1,12,44
40,Success,57,21,2,11,46
40,Fail,47,31,0,9,38
40,Fail,40,45,0,6,34
40,Fail,48,26,0,15,33
40,Fail,42,36,0,12,30
40,Fail,43,38,0,11,32
40,Success,54,23,0,12,42
40,Success,50,29,0,10,40
40,Fail,47,30,0,12,35
40,Success,54,19,4,12,42
40,Fail,43,16,10,22,21
40,Fail,50,27,5,11,39
40,Fail,49,24,0,16,33
40,Success,53,24,0,13,40
40,Fail,49,15,6,17,32
40,Fail,44,35,0,9,35
40,Fail,54,18,5,15,39
40,Success,53,18,4,11,42
40,Success,56,20,0,10,46
40,Fail,40,26,8,15,25
40,Success,51,26,4,10,41
40,Fail,47,31,0,12,35
40,Fail,44,33,0,12,32
40,Fail,49,24,0,17,32
40,Fail,53,18,3,16,37
40,Success,51,30,0,11,40
40,Fail,51,15,7,17,34
40,Success,53,24,0,10,43
40,Success,52,26,5,9,43
40,Fail,50,25,0,14,36
40,Fail,42,27,0,13,29
40,Fail,40,43,0,10,30
40,Fail,46,26,4,14,32
40,Fail,47,23,12,15,32
40,Fail,43,26,8,14,29
40,Fail,49,33,0,10,39
40,Fail,37,34,0,18,19
40,Success,52,25,4,8,44
40,Fail,43,24,6,18,25
40,Success,49,27,6,9,40
40,Success,50,28,0,9,41
40,Fail,41,33,6,11,30
40,Fail,44,25,6,14,30
40,Success,50,30,1,9,41
40,Fail,45,22,6,21,24
40,Success,52,20,1,12,40
40,Fail,45,32,0,12,33
40,Success,51,27,3,10,41
40,Fail,48,23,1,14,34
40,Fail,47,26,0,17,30
40,Fail,43,23,4,20,23
40,Fail,44,36,0,10,34
40,Fail,52,23,0,14,38
40,Fail,51,28,0,13,38
40,Fail,39,35,0,16,23
40,Fail,52,20,2,18,34
40,Fail,36,35,0,17,19
40,Fail,46,26,2,13,33
40,Success,55,29,0,9,46
40,Success,55,22,0,10,45
40,Fail,47,23,6,13,34
40,Fail,39,34,4,14,25
40,Success,51,29,4,8,43
40,Success,53,25,0,12,41
40,Fail,45,25,0,12,33
40,Fail,44,32,2,11,33
40,Success,54,21,2,13,41
40,Fail,45,25,4,14,31
40,Fail,44,28,6,11,33
40,Fail,45,29,0,14,31
40,Success,54,17,6,12,42
40,Fail,42,37,0,15,27
40,Fail,50,21,4,14,36
40,Success,55,18,1,15,40
40,Fail,46,26,8,14,32
40,Success,53,22,2,11,42
40,Success,52,24,0,11,41
40,Fail,43,29,9,12,31
40,Fail,49,24,2,12,37
40,Success,52,13,19,10,42
40,Success,53,23,0,11,42
40,Fail,44,22,0,19,25
40,Fail,46,28,1,9,37
40,Fail,46,29,0,13,33
40,Success,49,25,11,9,40
40,Success,60,17,3,9,51
40,Fail,49,29,0,12,37
40,Fail,36,29,16,10,26
40,Success,57,27,0,3,54
40,Fail,47,28,4,10,37
40,Success,55,26,0,8,47
40,Fail,42,28,1,17,25
40,Fail,44,32,6,10,34
40,Fail,45,25,6,16,29
40,Fail,52,19,1,14,38
40,Fail,52,19,8,14,38
40,Success,50,29,0,10,40
40,Success,52,29,1,7,45
40,Fail,45,30,8,13,32
40,Success,52,22,2,10,42
40,Fail,47,31,2,9,38
40,Success,53,22,0,10,43
40,Fail,48,23,5,13,35
40,Fail,51,21,0,14,37
40,Fail,49,31,0,11,38
40,Success,56,26,2,7,49
40,Fail,43,30,5,11,32
40,Success,49,29,6,7,42
40,Fail,52,23,0,16,36
40,Fail,48,29,0,15,33
40,Fail,49,22,0,13,36
40,Success,48,34,0,7,41
40,Fail,45,32,0,11,34
40,Fail,36,48,0,12,24
40,Success,54,21,0,10,44
40,Success,50,31,0,6,44
40,Fail,44,28,9,10,34
40,Fail,48,21,9,10,38
40,Fail,45,27,1,14,31
40,Success,53,18,5,12,41
40,Fail,49,27,0,12,37
40,Fail,50,24,0,15,35
40,Fail,48,27,2,11,37
40,Success,54,24,2,8,46
40,Fail,47,26,0,18,29
40,Success,53,24,2,11,42
40,Success,53,17,8,11,42
40,Fail,50,28,0,12,38
40,Fail,48,29,4,9,39
40,Fail,49,24,3,13,36
40,Success,51,27,0,11,40
40,Fail,48,31,0,11,37
40,Fail,49,21,2,17,32
40,Fail,37,31,3,16,21
40,Fail,47,37,0,9,38
40,Fail,41,38,0,14,27
40,Success,54,23,1,8,46
40,Fail,48,26,1,16,32
40,Fail,50,24,1,11,39
40,Fail,48,30,0,11,37
40,Fail,49,29,0,12,37
40,Fail,45,31,0,12,33
40,Fail,51,20,1,16,35
40,Fail,47,36,0,8,39
40,Success,53,18,3,13,40
40,Fail,49,31,0,10,39
40,Fail,48,27,0,15,33
40,Fail,47,28,0,14,33
40,Fail,46,32,0,13,33
40,Success,48,34,0,7,41
40,Success,55,25,3,7,48
40,Success,51,28,2,9,42
40,Fail,33,47,0,12,21
40,Fail,41,34,0,12,29
40,Fail,50,28,3,11,39
40,Success,50,30,0,8,42
40,Success,53,19,2,11,42
40,Success,52,27,0,12,40
40,Fail,48,32,0,9,39
40,Success,59,19,0,7,52
40,Fail,48,18,7,18,30
40,Fail,50,27,0,13,37
40,Fail,51,24,0,14,37
40,Success,52,26,0,8,44
40,Fail,50,16,3,17,33
40,Success,58,15,0,13,45
40,Fail,47,23,6,16,31
40,Fail,46,36,0,10,36
40,Success,57,19,2,9,48
40,Success,51,26,5,11,40
40,Fail,46,36,0,8,38
40,Success,56,21,0,12,44
40,Success,51,24,6,6,45
40,Fail,43,36,0,13,30
40,Success,51,32,2,8,43
40,Success,51,27,0,11,40
40,Fail,49,22,2,15,34
40,Success,51,31,0,6,45
40,Fail,39,34,2,16,23
40,Fail,48,24,0,16,32
40,Fail,47,22,8,14,33
40,Success,50,24,4,8,42
40,Fail,49,28,0,12,37
40,Fail,52,19,0,15,37
40,Success,49,30,1,9,40
40,Fail,39,35,0,18,21
40,Fail,46,22,3,16,30
40,Fail,49,15,10,17,32
40,Fail,42,36,0,12,30
40,Fail,46,28,1,12,34
40,Fail,49,26,2,11,38
40,Fail,45,29,0,18,27
40,Fail,49,30,0,13,36
40,Success,53,28,0,8,45
40,Fail,43,23,6,19,24
40,Fail,49,27,0,15,34
40,Fail,48,25,6,12,36
40,Fail,49,23,5,14,35
40,Fail,49,30,0,10,39
40,Fail,41,30,0,15,26
40,Success,50,31,1,8,42
40,Fail,46,25,2,13,33
40,Fail,46,23,8,16,30
40,Fail,51,18,3,17,34
40,Fail,48,29,4,12,36
40,Success,53,20,12,9,44
40,Fail,49,27,0,11,38
40,Success,48,33,0,8,40
40,Success,51,25,4,8,43
40,Fail,47,27,0,14,33
40,Fail,49,24,3,15,34
40,Fail,52,17,7,13,39
40,Fail,43,31,0,14,29
40,Fail,47,27,0,12,35
40,Fail,49,27,0,13,36
40,Fail,46,24,2,16,30
40,Fail,44,33,0,15,29
40,Fail,48,25,0,13,35
40,Fail,44,26,6,15,29
40,Fail,49,30,0,14,35
40,Fail,48,34,0,11,37
40,Fail,46,33,0,15,31
40,Fail,44,39,0,10,34
40,Success,53,19,7,13,40
40,Fail,43,27,6,14,29
40,Success,55,18,2,15,40
40,Fail,50,29,0,13,37
40,Fail,50,20,1,19,31
40,Fail,45,27,0,16,29
40,Success,54,18,0,13,41
40,Success,59,21,0,7,52
40,Fail,43,33,4,12,31
40,Success,57,21,0,12,45
40,Fail,51,23,7,12,39
40,Success,49,22,5,8,41
40,Fail,42,33,0,18,24
40,Fail,49,25,1,12,37
40,Fail,43,36,1,10,33
40,Success,53,28,0,13,40
40,Fail,46,29,0,10,36
40,Fail,51,26,0,13,38
40,Success,54,19,3,11,43
40,Fail,42,37,0,11,31
40,Success,54,28,1,6,48
40,Fail,44,25,5,15,29
40,Success,52,24,2,8,44
40,Fail,45,33,0,12,33
40,Fail,44,28,3,12,32
40,Fail,47,34,0,11,36
40,Success,50,29,0,10,40
40,Fail,50,25,2,12,38
40,Fail,50,23,0,13,37
40,Fail,43,39,0,9,34
40,Fail,50,22,3,13,37
40,Success,55,23,6,9,46
40,Success,50,19,10,10,40
40,Success,49,28,2,7,42
40,Fail,47,28,0,10,37
40,Success,54,22,2,10,44
40,Fail,50,23,5,11,39
40,Fail,46,25,0,17,29
40,Fail,43,19,11,16,27
40,Fail,47,30,0,13,34
40,Fail,46,23,0,14,32
40,Fail,46,29,0,15,31
40,Success,53,21,0,13,40
40,Fail,41,32,3,12,29
40,Success,48,31,3,7,41
40,Fail,45,32,0,14,31
40,Fail,54,18,1,15,39
40,Success,55,31,0,5,50
40,Fail,46,30,0,13,33
40,Fail,48,24,1,18,30
40,Fail,49,23,3,10,39
40,Fail,50,22,4,12,38
40,Fail,48,35,0,10,38
40,Fail,43,32,3,15,28
40,Success,51,32,0,9,42
40,Fail,51,24,0,12,39
40,Success,49,33,0,8,41
40,Fail,54,23,0,15,39
40,Fail,51,23,0,13,38
40,Fail,42,33,0,13,29
40,Fail,49,18,8,11,38
40,Success,52,26,0,11,41
40,Success,53,26,0,11,42
40,Fail,48,31,0,10,38
40,Fail,46,33,1,8,38
40,Fail,39,34,0,17,22
40,Fail,44,29,0,19,25
40,Fail,41,34,0,15,26
40,Fail,50,24,3,13,37
40,Fail,41,38,0,8,33
40,Success,46,35,0,5,41
40,Fail,49,27,0,12,37
40,Fail,45,23,2,14,31
40,Fail,49,22,0,13,36
40,Fail,51,18,5,15,36
40,Fail,48,25,1,13,35
40,Fail,45,35,0,11,34
40,Fail,46,34,0,9,37
40,Fail,43,34,0,14,29
40,Fail,46,32,0,11,35
40,Fail,51,23,2,14,37
40,Success,52,22,9,7,45
40,Fail,50,24,0,16,34
40,Fail,38,34,8,12,26
40,Fail,50,26,0,17,33
40,Fail,48,18,5,14,34
40,Fail,43,36,4,8,35
40,Fail,46,25,3,14,32
40,Success,52,25,0,12,40
40,Fail,49,22,7,10,39
40,Fail,45,37,0,10,35
40,Fail,49,24,0,18,31
40,Fail,49,25,0,13,36
40,Fail,45,37,0,10,35
40,Fail,45,20,12,11,34
40,Fail,48,25,0,15,33
40,Fail,42,27,2,15,27
40,Fail,38,33,7,11,27
40,Fail,39,42,0,15,24
40,Fail,39,27,14,12,27
40,Fail,43,20,15,12,31
40,Success,52,27,0,12,40
40,Fail,41,37,0,14,27
40,Fail,46,25,4,11,35
40,Success,50,30,1,8,42
40,Success,53,25,0,9,44
40,Success,51,33,0,8,43
40,Fail,45,26,7,10,35
40,Fail,45,21,13,11,34
40,Fail,44,28,2,15,29
40,Fail,46,32,0,9,37
40,Success,49,32,2,9,40
40,Fail,45,25,1,17,28
40,Success,57,24,0,6,51
40,Fail,48,25,4,11,37
40,Fail,53,22,0,16,37
40,Fail,42,39,0,11,31
40,Fail,50,24,0,16,34
40,Success,55,18,0,12,43
40,Fail,44,26,3,16,28
40,Fail,46,32,4,10,36
40,Fail,42,30,10,11,31
40,Fail,52,21,0,14,38
40,Fail,44,34,0,13,31
40,Fail,48,26,0,16,32
40,Success,54,23,0,12,42
40,Fail,50,21,0,15,35
40,Fail,46,29,4,10,36
40,Success,53,23,1,9,44
40,Fail,44,33,3,13,31
40,Fail,48,26,0,16,32
40,Fail,50,19,7,12,38
40,Success,51,26,0,11,40
40,Fail,43,32,0,16,27
40,Fail,46,28,0,12,34
40,Fail,49,30,0,12,37
40,Fail,48,26,4,11,37
40,Fail,35,37,1,17,18
40,Fail,39,32,10,14,25
40,Fail,49,27,0,13,36
40,Success,51,31,0,8,43
40,Fail,49,28,0,11,38
40,Success,50,24,7,9,41
40,Fail,50,27,3,11,39
40,Fail,39,33,1,15,24
40,Success,53,25,1,10,43
40,Fail,51,25,2,12,39
40,Success,52,28,2,6,46
40,Success,49,33,0,6,43
40,Fail,42,31,0,15,27
40,Success,51,24,0,11,40
40,Fail,47,20,0,16,31
40,Fail,41,26,6,11,30
40,Fail,49,27,2,11,38
40,Fail,48,19,11,15,33
40,Success,50,37,0,8,42
40,Success,51,30,0,10,41
40,Fail,42,28,6,15,27
40,Success,54,21,1,10,44
40,Fail,47,26,0,19,28
40,Fail,52,22,4,13,39
40,Fail,45,31,0,14,31
40,Fail,51,21,5,14,37
40,Fail,49,21,2,19,30
40,Success,51,21,4,11,40
40,Fail,51,22,0,13,38
40,Fail,48,26,2,12,36
40,Success,58,30,0,5,53
40,Fail,47,26,0,13,34
40,Fail,43,32,0,15,28
40,Fail,42,36,0,12,30
40,Fail,45,26,3,17,28
40,Fail,43,30,5,10,33
40,Success,55,20,0,12,43
40,Fail,47,22,3,17,30
40,Fail,48,23,1,13,35
40,Fail,49,27,3,12,37
40,Fail,50,26,0,13,37
40,Fail,52,20,1,16,36
40,Fail,47,26,1,13,34
40,Fail,43,32,1,17,26
40,Success,54,26,0,10,44
40,Fail,49,29,0,12,37
40,Fail,50,30,0,12,38
40,Fail,49,33,0,11,38
40,Fail,42,31,8,11,31
40,Success,53,19,10,10,43
40,Success,51,25,2,10,41
40,Fail,47,31,0,11,36
40,Fail,50,22,4,11,39
40,Fail,44,28,5,14,30
40,Fail,43,31,6,13,30
40,Fail,44,35,0,12,32
40,Fail,45,34,0,14,31
40,Fail,44,23,6,13,31
40,Fail,49,22,6,12,37
40,Success,53,27,0,9,44
40,Fail,52,21,0,16,36
40,Fail,50,25,0,13,37
40,Fail,45,30,1,11,34
40,Success,53,23,1,10,43
40,Success,54,26,2,8,46
40,Success,49,36,0,8,41
40,Fail,42,38,0,15,27
40,Success,53,23,0,9,44
40,Fail,48,21,0,16,32
40,Fail,41,38,0,14,27
40,Success,50,26,5,9,41
40,Fail,38,25,14,17,21
40,Fail,50,24,0,12,38
40,Fail,49,24,0,10,39
40,Fail,49,29,0,12,37
40,Success,60,17,0,9,51
40,Success,57,24,0,9,48
40,Success,55,20,1,12,43
40,Fail,52,25,0,13,39
40,Fail,48,25,0,14,34
40,Success,51,26,4,11,40
40,Fail,46,32,0,13,33
40,Fail,43,24,6,16,27
40,Success,49,24,4,8,41
40,Fail,46,32,0,11,35
40,Success,52,20,5,9,43
40,Fail,46,30,0,14,32
40,Fail,46,27,0,17,29
40,Success,53,24,2,9,44
40,Success,50,25,0,10,40
40,Fail,47,25,0,19,28
40,Success,58,19,0,8,50
40,Fail,47,19,6,17,30
40,Fail,48,31,0,9,39
40,Fail,51,19,5,16,35
40,Fail,50,23,0,13,37
40,Success,52,24,3,12,40
40,Fail,45,33,0,11,34
40,Fail,46,26,1,17,29
40,Success,51,28,6,9,42
40,Success,53,18,0,13,40
40,Fail,47,31,0,14,33
40,Fail,48,31,0,10,38
40,Fail,44,35,0,12,32
40,Fail,46,28,0,15,31
40,Fail,45,30,0,12,33
40,Fail,46,26,4,12,34
40,Fail,47,23,7,15,32
40,Fail,36,25,12,16,20
40,Fail,45,32,5,10,35
40,Success,49,24,12,9,40
40,Success,51,21,6,10,41
40,Fail,40,28,0,16,24
40,Success,50,20,0,10,40
40,Success,49,27,6,9,40
40,Success,53,21,7,10,43
40,Success,53,25,1,9,44
40,Fail,37,33,7,15,22
40,Success,51,22,7,11,40
40,Fail,45,33,1,9,36
40,Fail,47,23,1,14,33
40,Fail,45,27,0,15,30
40,Success,53,20,0,12,41
40,Fail,50,27,0,12,38
40,Fail,45,29,3,10,35
40,Fail,43,32,5,8,35
40,Success,46,41,0,6,40
40,Fail,42,28,6,13,29
40,Fail,42,29,5,12,30
40,Fail,45,30,0,16,29
40,Fail,42,30,1,15,27
40,Fail,46,35,0,9,37
40,Fail,46,29,3,11,35
40,Success,50,26,1,10,40
40,Success,58,17,0,10,48
40,Success,52,25,5,10,42
40,Fail,50,24,1,15,35
40,Success,59,19,2,8,51
40,Fail,43,30,0,16,27
40,Fail,51,25,2,13,38
40,Success,50,35,0,7,43
40,Fail,50,28,2,12,38
40,Fail,46,30,0,16,30
40,Success,52,27,0,9,43
40,Success,53,29,0,10,43
40,Success,54,23,2,10,44
40,Fail,49,25,2,12,37
40,Fail,49,18,0,15,34
40,Fail,40,24,16,14,26
40,Success,57,27,1,5,52
40,Fail,47,28,3,12,35
40,Fail,45,28,5,12,33
40,Fail,48,26,4,12,36
40,Fail,47,24,1,13,34
40,Fail,48,27,0,13,35
40,Fail,46,34,0,13,33
40,Fail,45,23,2,17,28
40,Fail,49,21,3,14,35
40,Fail,45,30,0,16,29
40,Fail,37,36,0,15,22
40,Fail,48,23,0,16,32
40,Fail,40,35,0,14,26
40,Fail,45,24,3,17,28
40,Fail,49,29,0,13,36
40,Fail,44,36,0,12,32
40,Success,52,29,0,8,44
40,Fail,48,25,0,13,35
40,Fail,42,34,0,12,30
40,Success,58,20,6,7,51
40,Fail,46,25,3,14,32
40,Fail,47,24,0,14,33
40,Fail,49,25,0,13,36
40,Success,54,25,0,11,43
40,Fail,46,27,0,15,31
40,Success,55,25,0,11,44
40,Fail,40,23,8,17,23
40,Fail,47,22,10,13,34
40,Fail,44,36,0,13,31
40,Fail,51,23,0,12,39
40,Success,54,29,0,10,44
40,Success,51,23,13,9,42
40,Fail,50,25,1,11,39
40,Fail,46,24,5,19,27
40,Fail,51,27,0,13,38
40,Fail,37,33,3,14,23
40,Success,52,22,7,11,41
40,Fail,48,26,8,10,38
40,Fail,49,30,0,11,38
40,Fail,46,29,5,8,38
40,Fail,53,23,0,15,38
40,Fail,43,28,4,14,29
40,Fail,51,30,0,13,38
40,Fail,47,22,7,13,34
40,Fail,43,24,15,11,32
40,Fail,46,31,3,12,34
40,Fail,43,27,5,14,29
40,Fail,46,30,0,11,35
40,Fail,41,29,5,18,23
40,Fail,48,17,5,20,28
40,Fail,38,28,4,15,23
40,Success,57,19,2,12,45
40,Fail,45,30,8,8,37
40,Fail,46,25,5,12,34
40,Fail,47,27,0,11,36
40,Success,51,28,7,7,44
40,Success,51,26,4,9,42
40,Success,53,25,0,11,42
40,Fail,49,29,0,10,39
40,Fail,40,33,0,18,22
40,Success,51,30,0,10,41
40,Fail,42,25,10,12,30
40,Fail,43,40,0,10,33
40,Success,53,19,6,9,44
40,Fail,44,30,0,13,31
40,Success,51,25,0,11,40
40,Fail,48,26,1,18,30
40,Success,54,29,0,11,43
40,Fail,45,24,2,15,30
40,Fail,50,27,0,11,39
40,Fail,47,27,0,17,30
40,Success,50,25,5,8,42
40,Fail,51,23,0,16,35
40,Fail,46,25,9,11,35
40,Fail,51,24,0,15,36
40,Fail,43,30,0,17,26
40,Fail,45,27,4,12,33
40,Fail,44,32,4,9,35
40,Success,47,22,14,7,40
40,Success,51,24,0,8,43
40,Success,60,19,0,12,48
40,Fail,43,25,1,20,23
40,Fail,49,24,6,15,34
40,Fail,51,25,0,15,36
40,Fail,46,35,0,11,35
40,Fail,41,25,5,21,20
40,Fail,49,30,0,11,38
40,Fail,50,26,1,11,39
40,Fail,43,25,1,17,26
40,Fail,46,30,0,17,29
40,Fail,46,33,0,13,33
40,Fail,45,29,0,19,26
40,Fail,51,24,4,15,36
40,Success,53,25,1,5,48
40,Success,55,25,6,8,47
40,Fail,47,31,0,13,34
40,Fail,46,29,0,14,32
40,Fail,39,35,0,17,22
40,Success,52,26,0,12,40
40,Fail,42,35,0,13,29
40,Success,52,25,0,9,43
40,Success,47,31,7,6,41
40,Fail,46,27,0,11,35
40,Fail,43,35,0,15,28
40,Fail,42,30,0,16,26
40,Fail,49,29,0,13,36
40,Success,51,30,0,7,44
40,Success,56,22,0,12,44
40,Fail,43,33,0,11,32
40,Fail,45,28,5,13,32
40,Success,56,24,0,9,47
40,Fail,52,24,0,16,36
40,Fail,44,25,1,18,26
40,Fail,45,30,0,12,33
40,Success,56,17,1,13,43
40,Fail,49,28,6,11,38
40,Fail,51,19,3,12,39
40,Fail,41,35,0,14,27
40,Fail,41,37,0,10,31
40,Success,51,26,0,9,42
40,Fail,46,30,0,15,31
40,Fail,48,27,0,10,38
40,Fail,50,20,2,17,33
40,Fail,50,26,0,14,36
40,Success,50,32,0,10,40
40,Success,56,24,0,10,46
40,Fail,51,24,0,14,37
40,Fail,43,34,0,13,30
40,Fail,43,19,3,20,23
40,Success,55,21,1,11,44
40,Fail,46,30,0,14,32
40,Fail,53,19,0,16,37
40,Success,51,33,0,6,45
40,Success,54,24,2,8,46
40,Fail,51,22,0,16,35
40,Fail,45,28,0,16,29
40,Success,53,25,0,13,40
40,Fail,52,24,0,14,38
40,Fail,44,28,0,20,24
40,Fail,45,33,0,15,30
40,Fail,49,27,0,13,36
40,Success,54,22,0,13,41
40,Fail,45,34,0,11,34
40,Fail,48,28,0,17,31
40,Fail,49,26,0,14,35
40,Fail,36,33,4,20,16
40,Fail,50,26,3,11,39
40,Fail,47,29,0,17,30
40,Fail,48,25,5,9,39
40,Success,51,29,0,11,40
40,Fail,44,31,0,15,29
40,Fail,52,28,0,13,39
40,Fail,44,30,3,15,29
40,Fail,40,26,4,16,24
40,Fail,47,25,3,13,34
40,Fail,43,36,0,11,32
40,Fail,49,27,0,11,38
40,Fail,44,29,0,12,32
40,Fail,46,23,1,18,28
40,Success,55,23,0,8,47
40,Success,54,21,0,11,43
40,Fail,44,24,2,16,28
40,Fail,41,30,2,16,25
40,Fail,47,30,5,9,38
40,Success,52,26,0,12,40
40,Fail,47,32,4,8,39
40,Fail,49,26,0,14,35
40,Fail,42,29,4,14,28
40,Fail,39,37,0,16,23
40,Fail,41,34,1,12,29
40,Success,52,24,1,10,42
40,Fail,44,26,1,15,29
40,Fail,40,37,0,13,27
40,Fail,40,38,0,17,23
40,Success,51,25,0,10,41
40,Fail,45,39,0,11,34
40,Fail,46,31,3,7,39
40,Fail,46,25,1,15,31
40,Fail,47,24,5,17,30
40,Success,52,26,0,12,40
40,Fail,47,25,0,16,31
40,Fail,48,27,0,15,33
40,Fail,42,30,6,12,30
40,Fail,42,31,0,15,27
40,Fail,48,27,0,14,34
40,Success,54,31,0,6,48
40,Fail,48,23,0,15,33
40,Fail,45,34,0,9,36
40,Fail,42,36,0,13,29
40,Success,54,25,0,10,44
40,Fail,45,29,2,10,35
40,Fail,47,32,0,15,32
40,Fail,54,16,2,17,37
40,Success,56,24,0,6,50
40,Success,52,22,4,12,40
40,Fail,44,20,12,17,27
40,Fail,43,35,0,11,32
40,Fail,48,24,0,15,33
40,Fail,51,29,0,12,39
40,Success,55,19,0,14,41
40,Fail,40,36,0,13,27
40,Success,51,30,0,9,42
40,Fail,50,25,5,12,38
40,Fail,44,27,2,18,26
40,Fail,38,39,0,15,23
40,Fail,52,20,4,13,39
40,Success,54,23,1,10,44
40,Fail,44,31,0,18,26
40,Fail,41,32,0,18,23
40,Success,58,18,2,11,47
40,Fail,41,37,0,13,28
40,Fail,46,28,5,15,31
40,Fail,49,26,1,13,36
40,Fail,44,26,3,15,29
40,Fail,43,38,0,12,31
40,Success,44,44,0,3,41
40,Fail,48,28,0,10,38
40,Success,53,22,0,9,44
40,Success,51,22,7,11,40
40,Fail,49,28,0,13,36
40,Fail,45,28,0,13,32
40,Fail,48,27,0,12,36
40,Fail,42,24,5,14,28
40,Fail,48,31,0,16,32
40,Fail,42,27,0,22,20
40,Fail,41,29,3,16,25
40,Success,52,25,6,11,41
40,Success,57,19,2,13,44
40,Fail,47,32,0,11,36
40,Fail,43,27,0,15,28
40,Fail,47,29,5,9,38
40,Fail,51,26,0,16,35
40,Fail,51,33,0,12,39
40,Fail,45,24,7,12,33
40,Fail,46,30,1,10,36
40,Fail,47,33,0,13,34
40,Fail,39,44,0,14,25
40,Fail,49,26,0,12,37
40,Fail,42,30,5,12,30
40,Fail,47,21,0,19,28
40,Success,54,25,2,11,43
40,Fail,47,31,0,13,34
40,Success,57,22,0,9,48
40,Success,48,32,2,8,40
40,Fail,46,27,0,17,29
40,Fail,46,20,1,20,26
40,Fail,49,23,1,16,33
40,Fail,43,25,10,14,29
40,Success,51,23,1,11,40
40,Fail,48,31,0,11,37
40,Fail,49,28,0,13,36
40,Fail,47,25,4,15,32
40,Fail,42,23,7,19,23
40,Success,55,17,8,9,46
40,Fail,50,25,2,12,38
40,Success,50,28,0,9,41
40,Fail,46,31,3,11,35
40,Fail,50,26,0,11,39
40,Fail,46,29,0,15,31
40,Fail,36,39,3,13,23
40,Success,57,15,0,12,45
40,Fail,49,35,0,10,39
40,Success,53,23,4,8,45
40,Success,56,19,6,10,46
40,Fail,47,24,3,11,36
40,Success,55,27,0,10,45
40,Fail,55,16,2,16,39
40,Fail,42,30,0,15,27
40,Fail,40,34,6,12,28
40,Fail,46,23,10,13,33
40,Fail,51,16,3,20,31
40,Fail,46,27,5,10,36
40,Success,53,22,0,12,41
40,Fail,50,28,0,12,38
40,Fail,42,33,0,16,26
40,Fail,50,26,0,14,36
40,Success,54,16,1,12,42
40,Fail,46,31,0,11,35
40,Fail,47,22,12,12,35
40,Success,54,20,4,10,44
40,Success,50,24,1,9,41
40,Fail,44,32,4,9,35
40,Fail,40,31,9,12,28
40,Fail,47,29,0,16,31
40,Fail,44,35,0,14,30
40,Fail,46,36,0,12,34
40,Fail,44,27,4,16,28
40,Success,52,29,0,8,44
40,Fail,50,23,0,18,32
40,Fail,45,30,4,12,33
40,Success,56,22,0,13,43
40,Fail,46,28,6,15,31
40,Fail,48,28,3,10,38
40,Fail,48,28,0,15,33
40,Fail,44,25,8,17,27
40,Success,52,27,0,11,41
40,Fail,44,27,9,16,28
40,Success,48,33,0,8,40
40,Success,57,21,2,8,49
40,Success,50,25,2,9,41
40,Success,49,33,0,7,42
40,Fail,48,26,4,14,34
40,Fail,47,20,5,15,32
40,Success,51,28,1,11,40
40,Fail,51,21,2,14,37
40,Success,52,27,0,7,45
40,Fail,52,17,4,16,36
40,Fail,50,24,5,13,37
40,Fail,50,22,0,15,35
40,Fail,48,27,4,9,39
40,Fail,50,28,0,14,36
40,Fail,50,18,4,19,31
40,Fail,44,22,5,19,25
40,Fail,43,36,0,12,31
40,Fail,48,29,2,13,35
40,Fail,52,19,3,13,39
40,Fail,45,25,0,17,28
40,Success,55,20,0,12,43
40,Fail,43,27,8,14,29
40,Fail,47,25,3,14,33
40,Fail,46,24,3,16,30
40,Fail,46,32,0,11,35
40,Fail,49,25,3,16,33
40,Fail,42,29,3,15,27
40,Fail,43,35,0,15,28
40,Fail,48,30,3,11,37
40,Success,53,23,0,11,42
40,Fail,45,32,0,10,35
40,Fail,45,23,6,18,27
40,Fail,47,26,8,13,34
40,Fail,42,28,2,20,22
40,Success,54,24,0,9,45
40,Fail,48,25,3,12,36
40,Fail,47,19,7,17,30
40,Success,58,17,0,10,48
40,Success,52,24,6,10,42
40,Fail,40,35,0,13,27
40,Fail,44,34,0,9,35
40,Success,50,29,0,10,40
40,Fail,50,19,0,16,34
40,Success,53,20,4,11,42
40,Success,53,23,0,10,43
40,Fail,49,23,0,16,33
40,Success,51,24,1,11,40
40,Fail,44,30,0,19,25
40,Fail,43,27,5,13,30
40,Fail,44,33,0,11,33
40,Success,53,23,3,12,41
40,Fail,43,34,0,12,31
40,Fail,44,33,5,9,35
40,Fail,44,28,6,13,31
40,Fail,41,30,0,17,24
40,Fail,50,26,0,12,38
40,Fail,48,22,0,19,29
40,Fail,46,29,0,14,32
40,Fail,46,33,0,12,34
40,Success,48,37,0,8,40
40,Fail,50,28,0,14,36
40,Success,51,25,2,11,40
40,Fail,52,20,0,16,36
40,Fail,47,35,0,13,34
40,Success,55,26,0,7,48
40,Fail,49,27,1,10,39
40,Fail,40,40,0,11,29
40,Fail,48,30,3,11,37
40,Fail,50,28,0,12,38
40,Fail,48,23,2,16,32
40,Fail,37,32,1,18,19
40,Success,52,28,0,10,42
40,Fail,46,25,8,11,35
40,Fail,49,21,0,14,35
40,Fail,47,24,1,17,30
40,Fail,43,31,6,12,31
40,Fail,49,32,0,11,38
40,Success,53,18,2,13,40
40,Fail,42,26,3,15,27
40,Success,51,24,1,11,40
40,Success,57,20,0,12,45
40,Success,58,19,1,11,47
40,Fail,48,36,0,10,38
40,Fail,40,28,12,11,29
40,Fail,48,29,0,13,35
40,Fail,45,24,0,17,28
40,Success,49,29,3,9,40
40,Fail,49,25,5,12,37
40,Fail,44,29,4,17,27
40,Success,51,29,1,9,42
40,Success,54,28,0,13,41
40,Fail,45,30,0,15,30
40,Fail,47,28,3,14,33
40,Success,54,25,0,10,44
40,Fail,44,36,0,11,33
40,Fail,43,30,3,13,30
40,Fail,42,33,0,17,25
40,Fail,49,29,0,16,33
40,Fail,45,33,0,12,33
40,Fail,46,30,0,13,33
40,Fail,45,30,0,15,30
40,Fail,48,28,1,11,37
40,Fail,49,29,0,10,39
40,Fail,41,24,11,15,26
40,Fail,51,25,0,12,39
40,Fail,51,20,3,12,39
40,Success,47,35,8,3,44
40,Fail,39,30,7,12,27
40,Success,53,20,1,12,41
40,Success,56,20,5,8,48
40,Fail,51,22,3,12,39
40,Fail,44,24,2,18,26
40,Fail,48,38,0,10,38
40,Success,49,32,0,7,42
40,Success,55,22,4,9,46
40,Fail,46,30,0,15,31
40,Fail,47,35,0,9,38
40,Fail,51,20,8,13,38
40,Fail,49,31,0,10,39
40,Success,55,20,0,10,45
40,Fail,50,23,0,12,38
40,Fail,43,30,5,14,29
40,Fail,50,26,5,11,39
40,Fail,50,22,1,16,34
40,Fail,47,35,0,10,37
40,Fail,41,31,2,14,27
40,Fail,40,26,4,19,21
40,Success,53,28,0,11,42
40,Fail,42,32,0,13,29
40,Fail,47,25,0,13,34
40,Fail,50,18,4,19,31
40,Fail,50,21,7,14,36
40,Success,51,26,4,9,42
40,Fail,42,33,0,14,28
40,Success,55,19,0,14,41
40,Success,51,23,3,8,43
40,Fail,48,25,0,15,33
40,Fail,49,26,0,15,34
40,Fail,46,24,1,15,31
40,Fail,48,28,1,9,39
40,Fail,47,21,1,15,32
40,Success,56,24,0,11,45
40,Fail,50,24,0,11,39
40,Fail,49,25,4,12,37
40,Fail,46,29,3,12,34
40,Fail,43,30,2,10,33
40,Fail,50,25,0,13,37
40,Fail,46,33,0,10,36
40,Fail,49,34,0,11,38
40,Fail,46,27,1,13,33
40,Fail,46,37,0,9,37
40,Fail,43,37,0,8,35
40,Fail,49,27,0,13,36
40,Fail,41,37,0,13,28
40,Fail,42,34,5,8,34
40,Fail,47,24,6,11,36
40,Success,51,28,0,9,42
40,Fail,50,20,5,11,39
40,Fail,40,22,7,19,21
40,Success,51,21,7,11,40
40,Fail,43,23,12,17,26
40,Success,51,24,2,7,44
40,Fail,49,21,8,13,36
40,Fail,48,28,0,15,33
40,Fail,41,31,0,17,24
40,Fail,44,24,0,21,23
40,Success,50,29,0,10,40
40,Fail,50,20,1,15,35
40,Fail,42,36,0,13,29
40,Fail,48,27,3,10,38
40,Fail,39,32,2,16,23
40,Success,54,24,0,13,41
40,Fail,45,34,0,13,32
40,Fail,45,32,0,13,32
40,Fail,49,26,0,15,34
40,Fail,49,26,0,16,33
40,Fail,52,24,1,13,39
40,Fail,47,31,0,11,36
40,Fail,47,30,0,11,36
40,Fail,48,22,9,15,33
40,Fail,48,22,1,17,31
40,Success,50,29,1,7,43
40,Fail,46,31,0,12,34
40,Fail,43,34,0,17,26
40,Fail,46,32,0,12,34
40,Success,51,29,0,10,41
40,Success,53,26,0,12,41
40,Success,57,22,4,6,51
40,Fail,40,36,0,12,28
40,Fail,44,30,0,15,29
40,Fail,43,27,4,17,26
40,Fail,47,29,4,13,34
40,Fail,48,25,0,16,32
40,Fail,49,25,5,11,38
40,Fail,46,27,0,12,34
40,Fail,48,27,0,13,35
40,Fail,46,27,2,10,36
40,Fail,47,32,0,11,36
40,Success,52,24,0,12,40
40,Fail,45,24,0,18,27
40,Fail,40,27,5,13,27
40,Fail,41,42,0,12,29
40,Fail,45,27,2,13,32
40,Success,49,32,5,7,42
40,Fail,51,24,0,15,36
40,Fail,45,29,0,16,29
40,Success,52,22,3,12,40
40,Fail,45,31,0,17,28
40,Fail,44,27,0,16,28
40,Success,51,27,1,10,41
40,Fail,43,24,6,16,27
40,Fail,47,28,0,13,34
40,Fail,49,28,0,13,36
40,Fail,48,22,10,11,37
40,Fail,46,22,4,20,26
40,Success,53,23,2,11,42
40,Fail,51,22,1,13,38
40,Fail,45,26,0,17,28
40,Success,56,21,1,13,43
40,Fail,45,22,10,15,30
40,Success,51,22,11,7,44
40,Fail,46,36,0,11,35
40,Fail,46,27,0,12,34
40,Success,50,33,0,9,41
40,Success,49,30,0,7,42
40,Fail,45,34,4,6,39
40,Fail,37,34,0,20,17
40,Success,55,25,0,12,43
40,Fail,45,25,1,19,26
40,Fail,48,23,0,18,30
40,Fail,44,32,0,16,28
40,Fail,47,30,5,9,38
40,Success,55,20,0,15,40
40,Fail,48,30,0,10,38
40,Success,57,20,0,10,47
40,Fail,43,38,0,11,32
40,Fail,48,24,0,14,34
40,Fail,47,21,0,20,27
40,Fail,48,33,0,11,37
40,Fail,44,24,9,15,29
40,Fail,48,26,0,17,31
40,Fail,39,35,0,14,25
40,Fail,48,20,0,19,29
40,Success,56,17,5,10,46
40,Fail,43,30,0,13,30
40,Fail,47,29,0,12,35
40,Fail,46,31,0,11,35
40,Success,56,18,1,12,44
40,Fail,44,35,0,7,37
40,Fail,41,32,1,19,22
40,Fail,44,36,0,7,37
40,Fail,45,30,0,17,28
40,Success,57,18,2,10,47
40,Fail,46,30,4,8,38
40,Success,56,21,0,10,46
40,Fail,46,33,0,11,35
40,Fail,48,27,1,12,36
40,Fail,51,23,2,12,39
40,Success,49,34,0,9,40
40,Success,52,29,1,9,43
40,Fail,50,26,0,11,39
40,Success,59,24,0,6,53
40,Success,54,24,0,10,44
40,Fail,44,40,0,9,35
40,Fail,42,32,5,10,32
40,Success,50,34,0,10,40
40,Fail,38,38,0,14,24
40,Fail,49,26,1,11,38
40,Fail,50,28,0,13,37
40,Fail,49,29,0,10,39
40,Success,52,23,0,11,41
40,Fail,48,26,0,15,33
40,Fail,50,25,0,13,37
40,Fail,50,22,5,12,38
40,Fail,48,26,11,11,37
40,Fail,41,36,0,13,28
40,Fail,47,33,0,11,36
40,Success,54,30,1,4,50
40,Success,54,25,1,9,45
40,Fail,45,26,0,16,29
40,Fail,50,19,2,16,34
40,Fail,43,35,0,12,31
40,Fail,42,34,0,14,28
40,Success,54,24,0,11,43
40,Fail,49,31,0,10,39
40,Success,58,22,0,9,49
40,Fail,44,21,5,18,26
40,Success,48,31,0,7,41
40,Fail,38,37,0,12,26
40,Fail,52,16,0,16,36
40,Fail,39,35,2,12,27
40,Fail,49,29,0,16,33
40,Fail,48,24,5,12,36
40,Fail,36,35,6,13,23
40,Fail,41,26,8,16,25
40,Success,55,16,0,15,40
40,Fail,47,33,0,12,35
40,Fail,44,33,6,9,35
40,Success,50,29,4,9,41
40,Fail,44,20,17,15,29
40,Fail,51,21,0,16,35
40,Fail,46,28,0,14,32
40,Success,58,24,0,8,50
40,Fail,46,30,2,11,35
40,Fail,45,34,0,11,34
40,Fail,50,21,1,15,35
40,Fail,53,20,0,14,39
40,Fail,50,25,0,13,37
40,Fail,53,15,2,15,38
40,Fail,49,29,0,12,37
40,Fail,49,25,4,14,35
40,Success,49,32,0,7,42
40,Fail,47,29,0,10,37
40,Fail,42,26,2,18,24
40,Fail,45,31,0,14,31
40,Fail,40,38,0,11,29
40,Fail,39,37,0,13,26
40,Fail,48,27,0,17,31
40,Fail,48,23,3,13,35
40,Success,57,24,3,8,49
40,Fail,50,29,0,12,38
40,Fail,47,33,1,10,37
40,Fail,41,34,4,10,31
40,Fail,48,30,0,10,38
40,Fail,38,34,0,19,19
40,Fail,47,26,5,10,37
40,Fail,48,28,1,11,37
40,Success,46,40,0,5,41
40,Fail,48,15,1,19,29
40,Success,48,27,6,8,40
40,Success,48,28,8,7,41
40,Fail,48,22,0,19,29
40,Success,49,28,7,7,42
40,Fail,47,31,1,12,35
40,Fail,44,25,6,18,26
40,Fail,40,37,0,14,26
40,Fail,45,32,0,12,33
40,Fail,41,31,7,16,25
40,Fail,48,25,1,17,31
40,Fail,47,26,0,16,31
40,Success,55,21,7,10,45
40,Fail,46,34,3,7,39
40,Success,58,20,0,8,50
40,Fail,47,26,1,13,34
40,Fail,47,27,0,15,32
40,Fail,44,23,0,18,26
40,Fail,38,33,6,13,25
40,Fail,45,29,0,15,30
40,Fail,52,21,1,13,39
40,Fail,50,26,0,15,35
40,Fail,44,28,0,17,27
40,Fail,48,21,8,12,36
40,Fail,47,26,0,16,31
40,Fail,48,29,0,15,33
40,Fail,50,25,0,13,37
40,Success,52,25,0,11,41
40,Fail,46,27,6,11,35
40,Success,53,23,4,11,42
40,Fail,50,26,0,13,37
40,Fail,39,46,0,10,29
40,Success,56,21,2,9,47
40,Fail,53,20,1,14,39
40,Fail,46,24,1,15,31
40,Success,50,34,0,8,42
40,Fail,42,35,3,12,30
40,Fail,48,27,0,14,34
40,Fail,44,36,0,11,33
40,Fail,44,32,0,13,31
40,Fail,49,28,0,15,34
40,Fail,41,34,0,16,25
40,Fail,46,25,1,16,30
40,Success,55,19,1,12,43
40,Fail,45,29,5,11,34
40,Fail,47,23,6,15,32
40,Fail,40,28,5,15,25
40,Fail,49,21,0,17,32
40,Fail,45,27,5,13,32
40,Fail,50,22,5,12,38
40,Fail,51,24,0,14,37
40,Fail,46,29,0,15,31
40,Success,53,24,0,13,40
40,Fail,48,22,2,14,34
40,Fail,46,25,0,15,31
40,Success,52,27,0,12,40
40,Fail,47,29,4,11,36
40,Success,57,20,2,10,47
40,Fail,48,30,2,10,38
40,Fail,48,28,0,10,38
40,Fail,43,36,0,12,31
40,Fail,42,32,0,15,27
40,Fail,50,21,2,12,38
40,Fail,41,36,0,13,28
40,Fail,48,20,6,13,35
40,Success,57,23,0,8,49
40,Fail,44,36,0,11,33
40,Fail,44,29,0,15,29
40,Success,49,33,0,9,40
40,Success,51,27,2,9,42
40,Fail,46,30,0,8,38
40,Fail,45,32,0,13,32
40,Fail,47,23,2,13,34
40,Fail,48,22,4,15,33
40,Success,54,20,3,11,43
40,Success,58,17,0,12,46
40,Fail,43,36,0,11,32
40,Success,51,30,0,8,43
40,Success,50,32,0,9,41
40,Success,53,17,11,7,46
40,Success,59,17,0,12,47
40,Fail,49,21,4,14,35
40,Fail,50,20,1,13,37
40,Fail,37,37,0,17,20
40,Success,51,28,0,10,41
40,Fail,47,29,3,14,33
40,Success,53,23,0,13,40
40,Success,54,28,0,9,45
40,Success,59,18,4,8,51
40,Fail,44,24,6,18,26
40,Fail,51,20,0,16,35
40,Success,54,20,5,11,43
40,Fail,43,37,0,12,31
40,Fail,45,21,11,13,32
40,Fail,55,16,0,16,39
40,Fail,46,35,0,8,38
40,Fail,51,19,0,16,35
40,Fail,46,25,3,12,34
40,Fail,46,29,2,13,33
40,Fail,46,40,0,9,37
40,Fail,39,45,0,9,30
40,Fail,46,32,3,11,35
40,Fail,45,30,3,10,35
40,Fail,43,28,8,7,36
40,Success,52,22,0,9,43
40,Fail,51,23,0,15,36
40,Success,49,26,8,7,42
40,Success,51,29,0,11,40
40,Fail,47,31,0,15,32
40,Fail,37,38,0,18,19
40,Success,49,31,2,5,44
40,Fail,45,26,2,16,29
40,Fail,49,24,0,13,36
40,Fail,51,27,0,14,37
40,Success,54,25,0,9,45
40,Fail,51,24,0,13,38
40,Fail,43,25,9,14,29
40,Success,54,24,0,10,44
40,Fail,46,39,0,10,36
40,Fail,43,30,0,20,23
40,Fail,47,30,0,12,35
40,Fail,47,31,6,8,39
40,Fail,48,25,1,15,33
40,Success,55,26,0,12,43
40,Success,59,19,0,12,47
40,Fail,40,32,10,11,29
40,Fail,45,34,0,13,32
40,Fail,48,29,2,9,39
40,Fail,43,28,3,13,30
40,Fail,48,27,0,13,35
40,Success,53,27,1,10,43
40,Fail,51,22,0,14,37
40,Fail,45,30,0,17,28
40,Fail,47,29,0,15,32
40,Success,53,23,0,13,40
40,Fail,45,31,7,7,38
40,Fail,50,23,0,13,37
40,Fail,49,26,3,13,36
40,Fail,52,24,0,13,39
40,Fail,46,36,0,11,35
40,Fail,51,28,0,12,39
40,Fail,41,32,5,13,28
40,Success,53,29,0,11,42
40,Success,58,22,3,8,50
40,Fail,45,33,0,12,33
40,Fail,45,29,0,14,31
40,Fail,47,21,13,11,36
40,Success,52,33,0,7,45
40,Fail,44,28,2,14,30
40,Fail,47,24,0,19,28
40,Fail,46,34,0,12,34
40,Fail,45,25,9,11,34
40,Fail,49,22,10,12,37
40,Fail,51,24,0,16,35
40,Success,55,24,2,10,45
40,Fail,52,22,0,13,39
40,Success,55,23,0,9,46
40,Fail,48,22,0,12,36
40,Success,47,33,0,7,40
40,Success,57,28,0,7,50
40,Success,54,27,0,9,45
40,Fail,50,23,1,12,38
40,Fail,50,26,3,11,39
40,Fail,52,16,7,15,37
40,Fail,43,34,1,12,31
40,Fail,50,25,0,12,38
40,Fail,50,26,0,15,35
40,Fail,41,37,0,17,24
40,Fail,47,33,0,8,39
40,Fail,39,29,7,13,26
40,Fail,49,23,6,10,39
40,Fail,47,27,1,14,33
40,Success,57,15,4,16,41
40,Fail,43,22,13,14,29
40,Success,55,25,0,7,48
40,Success,56,24,0,8,48
40,Success,60,21,0,6,54
40,Success,50,27,5,6,44
40,Fail,44,34,0,11,33
40,Fail,47,27,5,12,35
40,Fail,52,21,0,14,38
40,Fail,44,33,0,14,30
40,Fail,44,29,0,16,28
40,Success,51,24,1,11,40
40,Fail,46,33,0,11,35
40,Fail,44,26,6,17,27
40,Success,53,24,0,13,40
40,Fail,40,31,3,17,23
40,Fail,45,24,5,17,28
40,Fail,45,32,0,14,31
40,Fail,49,27,0,11,38
40,Fail,44,41,0,9,35
40,Fail,49,22,0,13,36
40,Fail,46,34,0,12,34
40,Fail,54,17,5,15,39
40,Fail,49,31,0,12,37
40,Fail,37,34,0,18,19
40,Fail,45,30,0,14,31
40,Fail,45,30,0,13,32
40,Fail,48,26,0,16,32
40,Fail,42,32,2,15,27
40,Fail,47,27,0,11,36
40,Fail,49,22,0,13,36
40,Fail,48,26,1,15,33
40,Fail,45,31,1,11,34
40,Fail,46,29,0,14,32
40,Fail,49,31,0,10,39
40,Success,53,19,6,13,40
40,Fail,50,28,0,13,37
40,Fail,45,26,7,11,34
40,Fail,46,28,1,11,35
40,Fail,48,29,0,11,37
40,Fail,43,30,0,18,25
40,Success,55,20,4,8,47
40,Success,53,19,2,13,40
40,Fail,48,22,0,16,32
40,Fail,49,27,0,16,33
40,Success,51,24,4,10,41
40,Fail,50,26,0,13,37
40,Fail,38,27,4,17,21
40,Fail,43,33,0,14,29
40,Success,55,28,0,10,45
40,Fail,48,27,5,10,38
40,Success,52,26,0,10,42
40,Fail,41,36,0,16,25
40,Success,49,29,0,9,40
40,Fail,43,30,0,17,26
40,Fail,48,20,8,13,35
40,Fail,47,31,0,12,35
40,Fail,45,27,0,15,30
40,Fail,50,29,0,13,37
40,Fail,48,28,0,15,33
40,Fail,45,25,3,15,30
40,Success,49,30,0,8,41
40,Fail,38,40,0,17,21
40,Fail,49,24,5,12,37
40,Fail,51,28,0,12,39
40,Success,52,24,0,10,42
40,Success,52,27,0,9,43
40,Success,54,23,0,12,42
40,Fail,50,24,0,18,32
40,Success,53,33,0,9,44
40,Success,56,21,0,10,46
40,Success,57,23,0,8,49
40,Fail,48,30,0,13,35
40,Fail,46,19,4,17,29
40,Success,56,21,0,11,45
40,Fail,49,27,6,10,39
40,Fail,47,32,0,12,35
40,Fail,51,20,1,13,38
40,Fail,49,24,5,10,39
40,Fail,50,25,2,11,39
40,Success,52,20,2,12,40
40,Success,55,21,0,12,43
40,Fail,42,29,11,10,32
40,Fail,47,32,0,11,36
40,Fail,42,34,2,18,24
40,Fail,51,31,0,13,38
40,Fail,43,32,0,17,26
40,Fail,48,22,6,14,34
40,Success,54,19,0,10,44
40,Fail,49,29,0,11,38
40,Fail,48,38,0,10,38
40,Fail,47,33,0,10,37
40,Fail,49,28,0,10,39
40,Success,51,30,0,8,43
40,Success,50,29,2,9,41
40,Success,57,23,2,7,50
40,Fail,46,33,0,8,38
40,Success,53,20,9,10,43
40,Fail,43,35,0,11,32
40,Fail,46,26,1,13,33
40,Success,52,24,0,11,41
40,Success,51,25,2,11,40
40,Fail,50,22,0,16,34
40,Fail,44,25,7,11,33
40,Fail,52,23,1,16,36
40,Fail,46,24,1,14,32
40,Fail,48,28,0,12,36
40,Fail,42,26,0,20,22
40,Fail,42,32,9,9,33
40,Fail,44,29,4,11,33
40,Success,51,25,6,7,44
40,Success,54,20,2,13,41
40,Fail,44,27,0,13,31
40,Success,53,25,0,7,46
40,Fail,48,32,0,9,39
40,Fail,53,17,1,20,33
40,Success,50,25,0,10,40
40,Fail,45,24,10,15,30
40,Fail,38,39,0,17,21
40,Fail,50,27,2,11,39
40,Success,52,27,0,10,42
40,Fail,49,27,0,15,34
40,Fail,38,44,0,11,27
40,Fail,47,32,0,9,38
40,Fail,52,24,0,14,38
40,Fail,45,35,0,14,31
40,Fail,44,32,6,11,33
40,Success,54,25,0,12,42
40,Fail,48,28,0,17,31
40,Fail,47,33,0,11,36
40,Fail,47,24,2,11,36
40,Fail,45,32,5,12,33
40,Fail,49,29,0,12,37
40,Success,57,22,0,14,43
40,Fail,44,24,7,13,31
40,Success,50,27,0,7,43
40,Fail,48,23,4,11,37
40,Fail,49,28,0,13,36
40,Fail,49,31,0,13,36
40,Fail,35,41,0,18,17
40,Fail,49,29,0,10,39
40,Fail,50,16,3,18,32
40,Success,52,27,0,9,43
40,Success,55,19,0,14,41
40,Fail,47,26,1,15,32
40,Fail,46,34,0,11,35
40,Success,55,24,0,8,47
40,Success,52,27,0,11,41
40,Fail,49,26,1,14,35
40,Fail,50,23,0,14,36
40,Success,51,25,0,7,44
40,Fail,46,33,0,8,38
40,Fail,43,23,4,18,25
40,Fail,46,31,0,17,29
40,Success,53,19,1,13,40
40,Success,49,33,0,9,40
40,Fail,42,32,0,11,31
40,Fail,45,28,0,14,31
40,Fail,50,25,1,11,39
40,Fail,52,20,3,13,39
40,Fail,44,30,10,8,36
40,Fail,47,27,9,11,36
40,Fail,45,30,0,16,29
40,Fail,41,36,0,17,24
40,Fail,46,22,5,18,28
40,Fail,41,28,3,17,24
40,Fail,43,30,4,10,33
40,Fail,49,28,0,11,38
40,Fail,43,30,5,13,30
40,Fail,45,26,0,16,29
40,Fail,50,28,0,13,37
40,Fail,42,32,2,13,29
40,Success,51,28,0,11,40
40,Success,53,26,0,9,44
40,Fail,42,37,1,10,32
40,Fail,45,31,0,18,27
40,Fail,52,20,4,14,38
40,Success,54,33,0,8,46
40,Fail,48,28,0,12,36
40,Fail,50,29,0,12,38
40,Fail,51,18,3,16,35
40,Success,51,25,0,8,43
40,Fail,48,27,2,12,36
40,Fail,48,24,0,19,29
40,Fail,41,22,5,22,19
40,Fail,44,28,2,13,31
40,Fail,46,22,8,17,29
40,Fail,43,23,1,21,22
40,Success,56,20,0,12,44
40,Fail,44,27,0,16,28
40,Fail,51,24,0,13,38
40,Fail,47,24,6,13,34
40,Success,51,29,1,7,44
40,Success,54,23,0,11,43
40,Fail,46,28,0,18,28
40,Fail,42,28,5,16,26
40,Fail,51,28,0,12,39
40,Fail,41,25,6,18,23
40,Fail,44,34,0,10,34
40,Success,53,26,2,7,46
40,Success,48,26,8,8,40
40,Fail,49,24,6,12,37
40,Success,57,24,0,9,48
40,Fail,51,24,0,12,39
40,Fail,45,27,0,16,29
40,Fail,39,33,3,15,24
40,Fail,48,24,0,19,29
40,Fail,45,33,0,7,38
40,Fail,40,33,0,15,25
40,Fail,44,33,0,12,32
40,Success,50,34,0,9,41
40,Fail,50,28,2,12,38
40,Fail,47,32,1,9,38
40,Fail,43,24,5,17,26
40,Fail,43,30,4,11,32
40,Success,57,22,0,10,47
40,Fail,52,23,2,15,37
40,Fail,49,32,0,11,38
40,Fail,46,24,7,14,32
40,Success,48,36,0,7,41
40,Success,52,23,5,11,41
40,Success,56,24,0,8,48
40,Fail,45,35,0,10,35
40,Fail,49,26,0,13,36
40,Fail,38,41,0,13,25
40,Fail,46,25,5,15,31
40,Fail,48,28,1,11,37
40,Fail,41,35,0,14,27
40,Fail,48,26,1,15,33
40,Success,50,31,0,10,40
40,Success,48,24,8,8,40
40,Fail,43,30,9,10,33
40,Fail,41,34,0,19,22
40,Fail,47,32,0,12,35
40,Success,51,27,0,8,43
40,Fail,45,31,0,11,34
40,Fail,44,29,1,12,32
40,Fail,46,28,0,19,27
40,Fail,49,24,5,14,35
40,Fail,44,24,10,13,31
40,Fail,48,28,1,13,35
40,Fail,50,20,4,13,37
40,Success,60,21,1,7,53
40,Fail,44,32,0,14,30
40,Success,56,20,2,13,43
40,Fail,43,26,0,22,21
40,Fail,47,29,6,10,37
40,Fail,51,27,0,12,39
40,Fail,51,23,5,13,38
40,Success,49,27,6,7,42
40,Fail,44,26,4,16,28
40,Success,51,26,5,8,43
40,Success,49,28,1,8,41
40,Fail,45,28,2,12,33
40,Success,55,21,0,13,42
40,Fail,44,29,10,10,34
40,Success,50,24,3,10,40
40,Success,50,28,0,10,40
40,Fail,44,34,3,8,36
40,Success,50,35,0,8,42
40,Fail,43,29,6,11,32
40,Success,51,25,0,11,40
40,Success,51,28,0,11,40
40,Fail,49,23,4,14,35
40,Success,53,22,1,12,41
40,Success,53,28,0,11,42
40,Success,54,27,0,7,47
40,Fail,48,34,0,12,36
40,Fail,49,26,0,13,36
40,Fail,44,25,0,21,23
40,Success,52,23,0,12,40
40,Fail,46,24,9,14,32
40,Fail,48,35,0,10,38
40,Fail,48,32,0,10,38
40,Success,51,30,0,9,42
40,Fail,46,26,0,16,30
40,Fail,44,26,3,17,27
40,Fail,48,22,5,13,35
40,Fail,47,29,0,14,33
40,Fail,46,31,0,16,30
40,Fail,43,26,0,19,24
40,Fail,50,25,2,11,39
40,Fail,49,29,0,10,39
40,Fail,44,27,3,15,29
40,Fail,46,34,0,11,35
40,Fail,43,33,0,13,30
40,Fail,46,32,0,12,34
40,Success,53,22,3,10,43
40,Fail,47,27,3,13,34
40,Fail,41,28,3,20,21
40,Fail,44,33,0,15,29
40,Success,52,27,0,12,40
40,Fail,50,21,8,11,39
40,Fail,43,33,4,10,33
40,Success,57,18,0,13,44
40,Fail,47,22,0,18,29
40,Fail,51,24,0,15,36
40,Fail,44,40,0,9,35
40,Fail,50,31,0,13,37
40,Fail,44,24,6,18,26
40,Fail,50,25,1,13,37
40,Fail,43,32,0,17,26
40,Fail,48,27,0,17,31
40,Success,54,23,0,11,43
40,Fail,47,32,0,12,35
40,Fail,47,26,7,14,33
40,Fail,39,31,3,17,22
40,Fail,47,31,4,11,36
40,Success,48,37,0,8,40
40,Fail,40,40,0,10,30
40,Success,51,27,0,10,41
40,Success,55,23,0,8,47
40,Success,52,29,0,5,47
40,Fail,51,24,1,13,38
40,Fail,45,35,0,9,36
40,Fail,50,26,2,11,39
40,Success,56,25,0,10,46
40,Fail,49,31,0,12,37
40,Success,55,26,0,8,47
40,Fail,42,24,3,21,21
40,Success,52,26,0,10,42
40,Fail,48,22,7,13,35
40,Fail,48,21,0,18,30
40,Success,52,29,0,8,44
40,Success,55,19,9,9,46
40,Fail,47,30,3,10,37
40,Success,49,23,7,9,40
40,Fail,40,38,0,16,24
40,Success,52,25,0,10,42
40,Fail,49,26,0,12,37
40,Fail,39,27,3,23,16
40,Fail,50,27,0,12,38
40,Fail,41,38,0,13,28
40,Success,58,20,0,10,48
40,Fail,42,36,0,10,32
40,Success,56,21,0,7,49
40,Fail,47,33,0,11,36
40,Fail,39,28,9,14,25
40,Fail,49,19,6,14,35
40,Fail,46,31,3,10,36
40,Success,53,24,1,10,43
40,Fail,41,37,4,10,31
40,Fail,42,30,6,15,27
40,Fail,46,26,0,14,32
40,Fail,50,23,0,19,31
40,Fail,48,26,0,12,36
40,Fail,48,23,0,17,31
40,Fail,45,37,0,6,39
40,Success,52,22,3,11,41
40,Success,52,24,0,12,40
40,Success,57,24,0,9,48
40,Fail,50,28,0,13,37
40,Fail,49,29,0,13,36
40,Success,53,19,8,10,43
40,Fail,51,24,0,13,38
40,Success,55,22,0,11,44
40,Fail,48,31,0,10,38
40,Fail,51,23,0,18,33
40,Success,50,31,0,10,40
40,Fail,50,25,5,11,39
40,Fail,47,24,4,16,31
40,Fail,39,37,5,9,30
40,Fail,45,34,0,10,35
40,Fail,46,25,1,14,32
40,Fail,44,31,1,10,34
40,Fail,50,20,0,18,32
40,Fail,45,31,0,12,33
40,Fail,48,26,0,13,35
40,Fail,48,24,0,14,34
40,Fail,48,29,0,11,37
40,Fail,41,34,1,13,28
40,Success,51,27,0,9,42
40,Fail,49,26,1,13,36
40,Fail,45,26,4,15,30
40,Success,53,30,0,6,47
40,Fail,41,37,2,13,28
40,Fail,49,26,1,16,33
40,Fail,47,27,0,12,35
40,Fail,46,29,0,11,35
40,Fail,41,29,7,14,27
40,Fail,52,18,1,17,35
40,Fail,40,29,1,20,20
40,Fail,49,24,2,17,32
40,Fail,48,29,0,12,36
40,Fail,53,21,1,14,39
40,Success,56,21,0,11,45
40,Fail,49,30,0,11,38
40,Success,46,38,0,6,40
40,Fail,48,26,7,13,35
40,Fail,48,21,5,13,35
40,Fail,49,24,1,15,34
40,Fail,43,29,7,14,29
40,Fail,51,19,8,12,39
40,Success,54,26,0,12,42
40,Fail,46,37,0,10,36
40,Fail,51,21,5,16,35
40,Success,52,26,4,8,44
40,Success,56,22,0,9,47
40,Success,56,23,0,12,44
40,Success,48,34,0,8,40
40,Success,55,24,0,8,47
40,Success,55,20,0,10,45
40,Fail,42,24,1,21,21
40,Success,54,28,0,10,44
40,Success,48,28,9,6,42
40,Success,55,21,0,13,42
40,Fail,51,22,0,14,37
40,Fail,50,19,5,17,33
40,Fail,39,36,8,10,29
40,Fail,44,21,3,18,26
40,Fail,48,25,0,17,31
40,Success,45,29,13,5,40
40,Fail,45,25,5,10,35
40,Fail,44,33,0,8,36
40,Fail,51,25,0,12,39
40,Fail,50,19,1,17,33
40,Success,52,28,0,6,46
40,Fail,48,25,2,14,34
40,Fail,52,17,8,13,39
40,Fail,48,32,0,12,36
40,Success,52,28,0,11,41
40,Fail,46,29,0,13,33
40,Fail,48,21,1,16,32
40,Fail,51,22,0,16,35
40,Success,56,25,0,10,46
40,Success,58,17,1,14,44
40,Success,49,28,5,9,40
40,Fail,47,24,0,18,29
40,Fail,44,35,0,11,33
40,Fail,50,28,0,14,36
40,Fail,47,26,0,16,31
40,Success,54,20,5,10,44
40,Fail,46,30,1,10,36
40,Fail,42,29,10,9,33
40,Fail,49,25,1,14,35
40,Fail,41,29,1,14,27
40,Success,53,26,0,10,43
40,Success,53,18,3,12,41
40,Fail,46,24,4,15,31
40,Fail,47,25,6,13,34
40,Fail,45,28,0,17,28
40,Fail,47,27,8,11,36
40,Success,51,28,0,10,41
40,Fail,43,31,0,16,27
40,Success,55,21,0,13,42
40,Fail,44,32,0,16,28
40,Fail,44,37,0,11,33
40,Fail,44,21,4,19,25
40,Fail,52,26,0,13,39
40,Fail,45,21,5,15,30
40,Fail,46,33,0,7,39
40,Fail,45,26,5,14,31
40,Fail,43,27,0,18,25
40,Fail,45,29,11,7,38
40,Success,60,25,0,7,53
40,Success,54,21,0,11,43
40,Success,50,30,2,6,44
40,Fail,52,23,2,15,37
40,Fail,52,25,0,14,38
40,Fail,47,29,1,12,35
40,Success,53,27,0,9,44
40,Success,56,21,0,10,46
40,Success,50,29,2,9,41
40,Fail,43,35,0,14,29
40,Success,51,23,5,9,42
40,Fail,43,30,0,16,27
40,Success,54,18,0,12,42
40,Fail,47,27,1,14,33
40,Fail,41,30,0,14,27
40,Fail,47,32,0,13,34
40,Fail,39,24,11,15,24
40,Success,51,31,0,10,41
40,Fail,50,26,0,12,38
40,Success,52,28,2,6,46
40,Fail,43,34,0,14,29
40,Success,53,21,0,13,40
40,Fail,49,22,2,16,33
40,Fail,45,30,3,12,33
40,Fail,44,25,0,16,28
40,Fail,48,19,10,13,35
40,Fail,50,27,0,11,39
40,Fail,54,18,3,15,39
40,Fail,50,24,2,13,37
40,Fail,43,27,10,11,32
40,Success,51,27,1,9,42
40,Fail,42,33,4,12,30
40,Fail,42,33,0,15,27
40,Fail,45,31,5,12,33
40,Success,52,25,0,10,42
40,Fail,41,32,0,14,27
40,Fail,43,34,0,12,31
40,Fail,44,38,0,9,35
40,Success,54,24,0,6,48
40,Fail,45,35,0,15,30
40,Success,57,25,0,6,51
40,Fail,47,27,0,15,32
40,Success,48,28,6,6,42
40,Success,52,34,0,7,45
40,Fail,45,28,11,9,36
40,Success,53,25,0,13,40
40,Success,54,29,0,9,45
40,Fail,46,29,0,16,30
40,Fail,42,26,8,14,28
40,Fail,43,28,3,18,25
40,Success,61,20,1,5,56
40,Fail,48,28,2,14,34
40,Fail,43,35,0,9,34
40,Fail,48,25,1,14,34
40,Fail,47,26,4,9,38
40,Fail,46,21,8,17,29
40,Fail,46,26,3,13,33
40,Success,53,19,2,13,40
40,Fail,40,33,2,16,24
40,Fail,46,26,4,17,29
40,Fail,45,30,3,11,34
40,Fail,47,25,0,12,35
40,Success,53,28,0,8,45
40,Fail,44,34,0,9,35
40,Fail,51,22,0,14,37
40,Fail,44,28,2,14,30
40,Fail,51,31,0,14,37
40,Fail,47,27,7,14,33
40,Fail,44,33,0,16,28
40,Fail,41,30,9,14,27
40,Success,52,26,0,9,43
40,Fail,47,26,0,17,30
40,Success,54,22,0,12,42
40,Fail,43,31,5,12,31
40,Success,56,27,0,7,49
40,Fail,51,24,0,14,37
40,Fail,44,31,0,15,29
40,Fail,46,35,4,7,39
40,Success,53,26,1,9,44
40,Success,55,18,1,12,43
40,Fail,49,32,0,12,37
40,Fail,40,28,7,15,25
40,Fail,46,33,0,11,35
40,Success,57,24,1,7,50
40,Fail,44,24,0,19,25
40,Fail,42,31,2,13,29
40,Fail,43,25,6,15,28
40,Fail,46,34,0,9,37
40,Success,49,35,0,8,41
40,Fail,45,31,0,13,32
40,Fail,33,36,0,20,13
40,Fail,49,26,0,16,33
40,Fail,47,26,1,12,35
40,Success,50,29,1,9,41
40,Fail,49,22,4,14,35
40,Fail,49,18,10,16,33
40,Fail,45,29,0,13,32
40,Fail,41,22,3,21,20
40,Success,50,36,0,7,43
40,Fail,47,35,0,11,36
40,Fail,46,25,0,16,30
40,Fail,44,28,4,11,33
40,Fail,43,27,12,8,35
40,Success,56,27,0,7,49
40,Fail,53,21,0,14,39
40,Fail,46,33,0,11,35
40,Fail,43,31,6,12,31
40,Fail,49,24,0,15,34
40,Fail,53,15,0,22,31
40,Fail,44,23,5,17,27
40,Fail,39,39,0,12,27
40,Success,55,24,1,8,47
40,Fail,45,27,0,13,32
40,Fail,38,22,8,23,15
40,Fail,50,22,0,14,36
40,Fail,46,32,0,12,34
40,Fail,46,27,0,17,29
40,Fail,41,34,0,15,26
40,Success,52,26,0,12,40
40,Fail,35,38,0,18,17
40,Fail,46,29,0,15,31
40,Fail,51,17,6,13,38
40,Success,49,23,4,9,40
40,Fail,48,32,0,11,37
40,Success,52,26,0,12,40
40,Fail,47,25,4,13,34
40,Success,56,22,0,12,44
40,Fail,43,23,6,17,26
40,Success,53,24,0,11,42
40,Fail,47,25,2,17,30
40,Fail,45,22,0,18,27
40,Success,57,26,1,6,51
40,Fail,46,34,0,10,36
40,Fail,46,29,0,11,35
40,Fail,45,24,7,14,31
40,Success,52,36,0,5,47
40,Success,53,17,12,11,42
40,Fail,46,27,1,11,35
40,Success,51,18,10,11,40
40,Fail,47,31,4,8,39
40,Success,52,29,0,9,43
40,Fail,48,22,4,14,34
40,Success,57,17,5,10,47
40,Fail,42,25,9,16,26
40,Fail,50,30,0,11,39
40,Fail,45,37,0,10,35
40,Success,46,31,5,6,40
40,Fail,48,26,7,10,38
40,Success,52,27,0,9,43
40,Success,54,22,0,13,41
40,Fail,44,27,6,13,31
40,Success,52,32,0,8,44
40,Success,54,20,0,12,42
40,Fail,39,40,0,12,27
40,Success,58,18,2,9,49
40,Success,56,22,0,10,46
40,Fail,50,20,1,14,36
40,Fail,43,32,0,16,27
40,Success,55,24,1,9,46
40,Fail,47,33,0,11,36
40,Success,53,22,0,11,42
40,Fail,40,40,0,12,28
40,Success,52,27,2,9,43
40,Success,53,20,1,13,40
40,Success,54,23,4,11,43
40,Fail,47,32,0,9,38
40,Fail,48,24,3,13,35
40,Fail,45,33,1,11,34
40,Fail,48,22,0,19,29
40,Fail,48,22,10,12,36
40,Success,52,23,0,12,40
40,Fail,45,24,1,14,31
40,Fail,51,21,2,12,39
40,Fail,42,43,0,8,34
40,Fail,46,23,3,15,31
40,Success,51,33,1,8,43
40,Fail,46,28,0,10,36
40,Success,55,17,1,13,42
40,Fail,48,26,2,14,34
40,Fail,35,44,0,15,20
40,Fail,52,24,0,14,38
40,Success,54,22,0,11,43
40,Fail,43,27,3,18,25
40,Success,55,22,0,11,44
40,Fail,45,27,0,20,25
40,Success,49,26,4,8,41
40,Fail,40,22,5,21,19
40,Fail,48,27,0,17,31
40,Success,56,22,1,14,42
40,Fail,46,30,1,12,34
40,Fail,49,29,0,14,35
40,Fail,47,27,10,8,39
40,Fail,50,23,0,12,38
40,Fail,48,26,7,11,37
40,Success,57,15,0,15,42
40,Success,51,27,0,9,42
40,Fail,46,31,7,8,38
40,Fail,52,17,3,17,35
40,Fail,51,25,0,13,38
40,Fail,48,26,0,16,32
40,Fail,46,28,0,14,32
40,Fail,46,29,1,12,34
40,Fail,46,28,0,15,31
40,Fail,46,19,1,20,26
40,Fail,43,35,2,8,35
40,Success,55,24,0,12,43
40,Success,53,25,0,8,45
40,Fail,45,28,0,14,31
40,Fail,48,30,0,13,35
40,Fail,45,28,6,15,30
40,Fail,53,18,0,15,38
40,Fail,45,32,0,14,31
40,Fail,50,19,4,20,30
40,Success,49,32,0,9,40
40,Fail,48,25,5,13,35
40,Success,51,24,4,9,42
40,Success,55,27,0,6,49
40,Success,51,26,2,10,41
40,Success,49,24,9,9,40
40,Fail,47,24,0,16,31
40,Fail,43,37,0,10,33
40,Fail,52,25,3,14,38
40,Success,52,23,7,9,43
40,Fail,51,25,0,16,35
40,Success,47,41,0,7,40
40,Fail,49,27,0,11,38
40,Fail,49,29,2,12,37
40,Fail,44,32,0,13,31
40,Fail,44,32,0,11,33
40,Success,53,23,0,13,40
40,Success,54,25,4,6,48
40,Fail,47,28,4,10,37
40,Fail,47,19,0,19,28
40,Fail,47,21,0,15,32
40,Success,52,28,0,10,42
40,Fail,50,29,0,12,38
40,Fail,42,29,5,17,25
40,Fail,40,30,8,15,25
40,Fail,40,31,2,14,26
40,Success,51,27,0,11,40
40,Fail,52,25,0,15,37
40,Success,56,27,0,8,48
40,Success,53,27,0,11,42
40,Fail,47,25,4,14,33
40,Fail,47,32,0,10,37
40,Fail,54,20,3,15,39
40,Fail,43,37,0,15,28
40,Success,56,23,0,12,44
40,Fail,42,32,0,12,30
40,Fail,47,28,2,16,31
40,Fail,46,26,2,14,32
40,Fail,51,21,7,12,39
40,Success,51,30,0,9,42
40,Success,47,30,9,7,40
40,Fail,45,22,4,21,24
40,Fail,49,33,0,13,36
40,Success,53,19,8,10,43
40,Success,46,25,11,6,40
40,Fail,43,26,0,19,24
40,Fail,47,31,0,9,38
40,Fail,40,29,7,16,24
40,Fail,51,24,0,12,39
40,Fail,49,22,7,10,39
40,Fail,43,31,12,8,35
40,Fail,42,37,0,12,30
40,Fail,48,28,0,16,32
40,Fail,44,30,0,14,30
40,Fail,48,31,0,9,39
40,Fail,48,24,2,12,36
40,Fail,51,26,0,12,39
40,Fail,44,23,9,16,28
40,Fail,49,26,2,13,36
40,Fail,50,25,5,12,38
40,Fail,50,23,6,14,36
40,Fail,51,18,3,17,34
40,Fail,50,22,0,19,31
40,Success,52,28,0,11,41
40,Fail,45,30,3,15,30
40,Success,51,25,1,9,42
40,Fail,48,30,2,9,39
40,Success,51,29,0,8,43
40,Success,52,26,0,12,40
40,Success,52,24,0,10,42
40,Fail,41,33,0,14,27
40,Success,50,28,0,9,41
40,Fail,48,23,0,16,32
40,Fail,47,19,1,22,25
40,Success,52,33,0,7,45
40,Success,51,32,0,8,43
40,Fail,45,31,0,12,33
40,Success,56,28,0,10,46
40,Fail,45,32,1,13,32
40,Fail,46,26,6,13,33
40,Success,59,17,3,10,49
40,Fail,44,24,4,17,27
40,Fail,45,27,4,16,29
40,Success,51,25,4,9,42
40,Fail,46,28,4,13,33
40,Fail,50,26,0,11,39
40,Success,55,25,3,10,45
40,Success,54,22,0,13,41
40,Fail,44,29,0,20,24
40,Success,57,23,0,9,48
40,Fail,51,24,4,13,38
40,Fail,42,33,6,10,32
40,Fail,50,25,0,15,35
40,Fail,46,22,2,17,29
40,Fail,39,41,0,13,26
40,Fail,41,23,7,19,22
40,Fail,40,34,2,13,27
40,Success,53,29,0,6,47
40,Fail,48,23,0,15,33
40,Fail,46,31,0,12,34
40,Fail,49,27,1,12,37
40,Fail,50,23,1,13,37
40,Fail,50,24,1,11,39
40,Success,59,22,4,6,53
40,Fail,49,22,8,13,36
40,Fail,49,29,0,11,38
40,Success,50,31,3,6,44
40,Fail,52,31,0,13,39
40,Fail,49,29,0,14,35
40,Fail,50,23,0,13,37
40,Fail,45,26,4,17,28
40,Success,55,17,3,14,41
40,Fail,45,32,0,16,29
40,Fail,42,36,0,9,33
40,Fail,48,24,2,14,34
40,Fail,52,23,0,15,37
40,Fail,49,34,0,10,39
40,Fail,41,28,1,19,22
40,Fail,47,27,10,9,38
40,Fail,41,29,4,16,25
40,Fail,47,22,0,17,30
40,Success,54,25,2,8,46
40,Fail,48,33,0,11,37
40,Fail,44,28,11,10,34
40,Fail,45,20,2,16,29
40,Fail,41,30,8,13,28
40,Success,54,21,2,10,44
40,Fail,45,29,3,15,30
40,Success,54,29,1,4,50
40,Fail,39,41,2,9,30
40,Fail,51,22,1,14,37
40,Fail,49,31,0,13,36
40,Fail,50,26,0,12,38
40,Fail,48,27,4,10,38
40,Fail,45,32,0,12,33
40,Fail,42,29,8,11,31
40,Fail,46,29,0,15,31
40,Fail,50,27,5,11,39
40,Fail,41,31,8,11,30
40,Success,53,21,0,12,41
40,Success,48,30,4,7,41
40,Fail,49,22,0,16,33
40,Success,53,29,0,11,42
40,Success,53,24,8,10,43
40,Success,54,16,7,13,41
40,Fail,45,32,0,15,30
40,Success,51,27,0,11,40
40,Success,55,19,1,13,42
40,Success,55,27,0,9,46
40,Success,54,23,3,9,45
40,Fail,49,25,0,14,35
40,Fail,42,27,7,15,27
40,Fail,40,25,11,14,26
40,Fail,47,25,0,17,30
40,Fail,46,26,9,13,33
40,Fail,50,24,0,13,37
40,Fail,50,19,0,17,33
40,Fail,47,26,5,9,38
40,Success,48,31,0,7,41
40,Fail,44,26,3,15,29
40,Fail,44,37,0,10,34
40,Fail,50,16,4,17,33
40,Fail,41,36,0,11,30
40,Fail,47,29,0,11,36
40,Success,51,33,0,10,41
40,Fail,46,30,0,12,34
40,Fail,48,32,0,12,36
40,Fail,50,26,0,11,39
40,Success,54,18,0,11,43
40,Success,54,28,0,7,47
40,Fail,45,34,0,10,35
40,Fail,48,30,0,15,33
40,Fail,50,28,0,12,38
40,Fail,46,33,0,11,35
40,Fail,42,38,0,12,30
40,Success,53,20,0,13,40
40,Success,55,31,0,5,50
40,Fail,44,27,5,13,31
40,Fail,46,22,6,15,31
40,Fail,46,30,5,11,35
40,Success,50,26,8,8,42
40,Success,52,29,0,10,42
40,Fail,42,35,0,9,33
40,Fail,47,26,6,9,38
40,Fail,37,29,7,17,20
40,Fail,51,21,2,20,31
40,Fail,41,32,0,16,25
40,Success,56,23,0,10,46
40,Fail,37,31,6,18,19
40,Fail,40,37,0,12,28
40,Fail,46,30,0,16,30
40,Fail,42,31,4,14,28
40,Fail,47,26,1,13,34
40,Fail,45,31,0,12,33
40,Fail,48,26,5,9,39
40,Fail,48,21,1,15,33
40,Success,50,31,0,10,40
40,Fail,49,24,2,11,38
40,Fail,48,24,7,15,33
40,Success,54,20,1,11,43
40,Success,54,23,0,10,44
40,Fail,39,40,0,12,27
40,Fail,43,36,0,13,30
40,Success,50,21,8,9,41
40,Fail,46,32,0,13,33
40,Fail,47,24,0,18,29
40,Fail,46,23,6,17,29
40,Success,53,27,4,5,48
40,Fail,50,24,1,12,38
40,Success,51,21,7,10,41
40,Fail,41,38,0,7,34
40,Fail,50,22,3,15,35
40,Fail,48,24,10,9,39
40,Fail,47,22,9,12,35
40,Success,55,20,0,9,46
40,Success,51,35,0,6,45
40,Fail,51,17,5,19,32
40,Fail,50,23,0,14,36
40,Fail,53,23,0,14,39
40,Fail,43,28,3,18,25
40,Fail,45,31,0,13,32
40,Fail,47,26,1,10,37
40,Success,52,29,0,8,44
40,Fail,47,30,0,14,33
40,Success,53,29,0,6,47
40,Fail,48,27,0,12,36
40,Success,56,25,0,8,48
40,Success,54,30,0,9,45
40,Fail,46,28,0,14,32
40,Fail,39,30,1,18,21
40,Fail,45,28,8,11,34
40,Fail,52,22,0,13,39
40,Fail,44,27,7,9,35
40,Fail,44,33,0,11,33
40,Fail,47,34,0,12,35
40,Fail,46,30,2,10,36
40,Fail,44,27,4,13,31
40,Fail,46,22,0,18,28
40,Fail,55,18,0,16,39
40,Success,54,15,2,14,40
40,Fail,49,22,0,19,30
40,Fail,49,24,2,14,35
40,Fail,45,23,12,14,31
40,Fail,38,36,0,12,26
40,Fail,43,26,6,14,29
40,Fail,44,32,5,9,35
40,Fail,42,42,0,10,32
40,Fail,44,33,0,13,31
40,Fail,46,30,0,20,26
40,Fail,49,24,0,16,33
40,Fail,49,21,1,13,36
40,Fail,45,28,10,9,36
40,Fail,50,27,5,12,38
40,Fail,49,23,6,14,35
40,Fail,49,26,0,17,32
40,Fail,49,25,0,11,38
40,Fail,35,31,11,17,18
40,Fail,41,32,6,13,28
40,Fail,44,30,0,12,32
40,Success,53,22,7,11,42
40,Fail,46,21,0,18,28
40,Success,56,20,0,15,41
40,Fail,51,22,0,15,36
40,Fail,44,28,0,15,29
40,Fail,52,24,0,14,38
40,Fail,46,30,1,13,33
40,Success,53,28,0,7,46
40,Fail,45,26,11,11,34
40,Success,50,34,0,9,41
40,Fail,42,32,0,15,27
40,Fail,47,31,0,12,35
40,Success,54,21,3,12,42
40,Fail,52,17,0,13,39
40,Fail,48,28,0,14,34
40,Fail,43,33,8,10,33
40,Fail,47,28,0,13,34
40,Fail,46,20,12,14,32
40,Fail,42,31,0,19,23
40,Fail,46,25,0,19,27
40,Success,58,23,0,8,50
40,Fail,48,22,7,16,32
40,Success,47,38,0,7,40
40,Fail,47,27,2,14,33
40,Fail,53,21,0,14,39
40,Fail,48,21,4,14,34
40,Fail,50,23,1,13,37
40,Fail,47,29,3,9,38
40,Fail,40,34,6,8,32
40,Fail,44,36,0,10,34
40,Fail,45,32,2,11,34
40,Fail,47,29,2,12,35
40,Success,51,30,0,11,40
40,Fail,47,25,0,17,30
40,Fail,51,25,0,16,35
40,Fail,43,25,12,11,32
40,Fail,48,27,3,14,34
40,Fail,46,38,0,9,37
40,Success,53,20,0,13,40
40,Success,52,31,0,6,46
40,Success,48,32,5,8,40
40,Fail,38,38,0,16,22
40,Success,52,22,1,11,41
40,Success,56,26,0,9,47
40,Success,48,31,0,8,40
40,Fail,46,33,0,11,35
40,Fail,46,26,0,16,30
40,Fail,48,27,4,13,35
40,Fail,47,23,3,18,29
40,Fail,44,28,9,8,36
40,Success,52,27,0,12,40
40,Fail,48,31,0,14,34
40,Success,50,26,3,8,42
40,Success,50,27,0,10,40
40,Success,56,21,7,6,50
40,Fail,44,29,5,14,30
40,Success,52,23,2,12,40
40,Fail,43,23,2,17,26
40,Success,51,31,3,9,42
40,Success,56,24,0,10,46
40,Fail,40,33,0,14,26
40,Fail,48,30,0,12,36
40,Success,53,20,4,12,41
40,Fail,49,26,0,11,38
40,Success,62,21,0,6,56
40,Fail,44,34,0,15,29
40,Success,52,25,0,9,43
40,Fail,46,22,7,11,35
40,Success,53,22,4,11,42
40,Fail,49,23,4,13,36
40,Fail,45,27,0,16,29
40,Fail,47,26,1,19,28
40,Fail,43,26,3,19,24
40,Fail,50,21,0,15,35
40,Fail,49,28,0,11,38
40,Fail,48,30,0,11,37
40,Fail,36,32,7,18,18
40,Success,54,20,1,10,44
40,Fail,53,20,4,16,37
40,Fail,46,32,0,14,32
40,Fail,48,22,1,17,31
40,Fail,49,32,0,10,39
40,Success,55,24,0,9,46
40,Success,53,26,0,12,41
40,Fail,44,30,5,11,33
40,Success,53,19,0,13,40
40,Success,56,27,1,4,52
40,Fail,43,35,4,10,33
40,Fail,47,31,0,12,35
40,Fail,47,33,0,12,35
40,Fail,48,17,9,17,31
40,Success,55,28,0,10,45
40,Fail,41,42,0,10,31
40,Fail,45,41,0,8,37
40,Success,58,14,5,15,43
40,Fail,49,30,0,10,39
40,Fail,46,32,0,12,34
40,Fail,50,18,4,16,34
40,Fail,52,23,3,13,39
40,Fail,47,32,0,11,36
40,Success,47,35,3,6,41
40,Fail,49,23,2,11,38
40,Fail,41,30,8,13,28
40,Fail,50,24,3,12,38
40,Fail,47,28,0,13,34
40,Fail,38,36,0,17,21
40,Success,53,25,0,13,40
40,Fail,46,24,4,18,28
40,Fail,47,23,3,13,34
40,Fail,48,19,11,15,33
40,Fail,47,26,0,15,32
40,Fail,45,35,4,9,36
40,Fail,45,39,0,11,34
40,Success,54,20,0,14,40
40,Fail,48,24,0,12,36
40,Fail,48,29,0,10,38
40,Fail,37,26,16,15,22
40,Fail,48,31,0,12,36
40,Success,52,32,0,7,45
40,Success,50,27,1,8,42
40,Fail,47,30,0,15,32
40,Fail,45,32,0,15,30
40,Fail,42,29,6,15,27
40,Fail,49,24,6,11,38
40,Fail,44,26,3,16,28
40,Fail,49,26,0,14,35
40,Fail,44,27,6,15,29
40,Fail,40,24,10,19,21
40,Fail,40,24,10,16,24
40,Success,49,31,2,8,41
40,Fail,47,22,3,15,32
40,Fail,45,29,5,12,33
40,Success,56,26,2,6,50
40,Success,54,29,0,6,48
40,Fail,46,30,0,14,32
40,Fail,44,24,9,13,31
40,Fail,51,25,0,13,38
40,Success,55,28,0,10,45
40,Fail,51,22,5,13,38
40,Fail,54,20,1,15,39
40,Fail,44,29,7,13,31
40,Fail,50,33,0,12,38
40,Fail,45,32,0,15,30
40,Fail,44,27,12,8,36
40,Fail,38,33,0,20,18
40,Fail,48,32,0,10,38
40,Fail,44,27,3,15,29
40,Fail,45,36,0,13,32
40,Fail,41,25,9,18,23
40,Success,49,28,4,7,42
40,Fail,47,30,0,12,35
40,Fail,49,25,2,14,35
40,Success,57,22,1,11,46
40,Success,51,25,0,11,40
40,Fail,47,27,1,14,33
40,Fail,48,22,0,16,32
40,Success,53,32,0,6,47
40,Fail,51,26,0,14,37
40,Success,52,27,0,11,41
40,Fail,43,28,3,12,31
40,Fail,49,19,3,12,37
40,Fail,47,32,0,13,34
40,Fail,51,22,0,17,34
40,Fail,42,26,4,18,24
40,Fail,44,24,2,20,24
40,Fail,44,35,0,12,32
40,Fail,45,26,5,13,32
40,Fail,50,31,0,11,39
40,Fail,45,31,0,12,33
40,Success,53,23,0,13,40
40,Fail,48,18,4,15,33
40,Fail,49,26,0,11,38
40,Fail,39,28,5,18,21
40,Success,52,22,7,12,40
40,Success,54,19,5,14,40
40,Fail,41,35,0,12,29
40,Fail,41,39,0,13,28
40,Fail,48,31,0,9,39
40,Success,51,25,1,10,41
40,Success,53,21,9,8,45
40,Success,49,30,0,9,40
40,Fail,51,25,0,13,38
40,Success,61,20,0,6,55
40,Fail,42,30,0,15,27
40,Fail,48,32,0,13,35
40,Success,52,27,4,7,45
40,Fail,37,44,0,14,23
40,Fail,47,28,0,13,34
40,Fail,46,31,0,11,35
40,Fail,47,21,6,12,35
40,Fail,44,22,13,15,29
40,Fail,51,27,0,13,38
40,Fail,50,21,5,13,37
40,Fail,43,32,0,14,29
40,Success,51,26,0,7,44
40,Fail,47,27,0,12,35
40,Fail,51,21,9,12,39
40,Fail,47,25,2,15,32
40,Fail,50,24,2,13,37
40,Fail,52,20,1,14,38
40,Fail,39,39,0,16,23
40,Fail,39,44,0,6,33
40,Success,59,26,0,5,54
40,Fail,44,29,0,15,29
40,Success,53,22,2,11,42
40,Fail,46,27,0,16,30
40,Success,54,20,3,12,42
40,Fail,48,28,0,12,36
40,Fail,43,35,0,9,34
40,Success,59,23,0,8,51
40,Success,54,18,6,13,41
40,Success,54,23,1,8,46
40,Fail,51,24,3,12,39
40,Fail,37,31,2,20,17
40,Success,56,22,0,10,46
40,Fail,46,25,2,15,31
40,Fail,44,29,0,20,24
40,Fail,49,32,0,12,37
40,Fail,46,29,0,18,28
40,Fail,40,31,10,11,29
40,Fail,48,34,0,9,39
40,Success,59,17,0,12,47
40,Success,52,21,12,7,45
40,Fail,47,26,0,15,32
40,Success,54,24,0,14,40
40,Fail,47,30,0,14,33
40,Success,56,29,0,9,47
40,Fail,43,23,3,18,25
40,Fail,46,31,0,14,32
40,Fail,44,34,0,13,31
40,Success,51,26,5,10,41
40,Success,60,17,4,8,52
40,Fail,43,25,6,18,25
40,Fail,43,40,0,10,33
40,Fail,49,24,4,13,36
40,Fail,44,27,3,15,29
40,Fail,46,25,6,11,35
40,Success,57,19,0,12,45
40,Fail,45,36,0,11,34
40,Fail,45,23,7,14,31
40,Success,52,21,0,11,41
40,Fail,48,27,4,12,36
40,Success,53,23,1,12,41
40,Fail,44,29,0,15,29
40,Fail,45,33,0,12,33
40,Fail,45,28,1,14,31
40,Fail,51,22,0,16,35
40,Success,54,24,3,9,45
40,Fail,51,25,0,13,38
40,Fail,51,22,0,14,37
40,Success,60,12,0,10,50
40,Fail,47,31,0,12,35
40,Success,55,26,0,10,45
40,Fail,48,30,0,9,39
40,Fail,40,30,0,21,19
40,Success,50,33,0,5,45
40,Fail,52,24,3,13,39
40,Fail,47,28,0,11,36
40,Fail,50,18,5,13,37
40,Fail,45,26,3,15,30
40,Fail,47,26,5,12,35
40,Fail,44,35,0,14,30
40,Fail,51,23,1,15,36
40,Success,55,26,0,4,51
40,Fail,40,37,0,15,25
40,Success,56,18,1,13,43
40,Fail,46,23,7,17,29
40,Fail,45,31,3,13,32
40,Fail,42,41,0,11,31
40,Fail,43,28,0,17,26
40,Fail,47,31,0,10,37
40,Success,51,27,2,8,43
40,Fail,43,37,0,11,32
40,Success,52,29,0,7,45
40,Fail,48,22,5,13,35
40,Success,56,17,9,7,49
40,Success,50,24,7,8,42
40,Fail,34,33,18,13,21
40,Success,53,24,1,11,42
40,Success,51,30,0,9,42
40,Fail,51,22,3,16,35
40,Fail,44,29,2,12,32
40,Fail,48,31,0,12,36
40,Fail,47,23,3,16,31
40,Success,52,30,0,7,45
40,Fail,46,29,0,17,29
40,Fail,42,30,0,19,23
40,Fail,46,31,0,13,33
40,Fail,48,29,0,14,34
40,Fail,49,32,0,12,37
40,Fail,48,31,0,11,37
40,Fail,46,32,0,13,33
40,Fail,47,20,7,15,32
40,Fail,43,22,7,19,24
40,Fail,37,38,0,17,20
40,Success,50,30,0,8,42
40,Fail,45,36,0,14,31
40,Fail,42,30,2,17,25
40,Fail,47,29,0,12,35
40,Fail,44,28,6,10,34
40,Fail,49,18,3,14,35
40,Fail,45,24,7,15,30
40,Fail,37,41,4,7,30
40,Fail,43,31,0,15,28
40,Fail,48,25,0,16,32
40,Fail,48,28,0,13,35
40,Fail,43,24,3,18,25
40,Fail,47,32,0,10,37
40,Fail,45,25,4,13,32
40,Fail,44,23,8,17,27
40,Fail,45,35,0,13,32
40,Fail,47,24,0,15,32
40,Success,53,28,0,8,45
40,Success,55,24,0,10,45
40,Success,55,18,0,11,44
40,Fail,48,34,0,10,38
40,Success,51,24,6,8,43
40,Fail,50,28,0,11,39
40,Fail,43,20,0,21,22
40,Fail,42,30,0,18,24
40,Fail,40,30,0,20,20
40,Success,52,32,0,9,43
40,Fail,41,37,0,16,25
40,Fail,49,23,0,14,35
40,Fail,48,23,2,11,37
40,Fail,46,34,0,7,39
40,Success,51,22,7,9,42
40,Success,54,17,2,13,41
40,Success,51,25,4,11,40
40,Fail,41,37,0,15,26
40,Fail,47,26,0,18,29
40,Fail,48,24,5,14,34
40,Fail,51,24,0,12,39
40,Fail,40,34,3,13,27
40,Success,49,27,3,9,40
40,Success,50,28,6,7,43
40,Fail,36,28,9,19,17
40,Fail,48,29,0,9,39
40,Success,47,31,6,6,41
40,Success,58,24,2,6,52
40,Fail,47,20,0,21,26
40,Fail,43,27,9,12,31
40,Fail,50,25,2,11,39
40,Fail,45,28,0,12,33
40,Success,60,18,0,11,49
40,Success,52,21,2,12,40
40,Fail,45,33,0,12,33
40,Success,56,20,2,11,45
40,Fail,48,28,0,11,37
40,Success,54,25,3,9,45
40,Fail,46,28,3,8,38
40,Success,49,31,0,9,40
40,Fail,52,21,1,15,37
40,Fail,43,27,10,13,30
40,Fail,50,33,0,11,39
40,Fail,46,29,0,13,33
40,Success,56,24,4,8,48
40,Fail,44,35,0,10,34
40,Fail,48,23,5,14,34
40,Fail,43,26,0,19,24
40,Fail,48,36,0,10,38
40,Fail,45,27,4,14,31
40,Fail,44,32,0,14,30
40,Success,58,16,2,12,46
40,Fail,47,26,6,13,34
40,Success,51,27,0,10,41
40,Success,52,34,0,5,47
40,Fail,49,33,0,10,39
40,Success,54,23,2,12,42
40,Fail,45,29,1,13,32
40,Fail,48,23,1,15,33
40,Success,47,36,0,7,40
40,Fail,43,29,7,12,31
40,Fail,40,25,10,10,30
40,Success,53,29,0,10,43
40,Fail,48,20,5,20,28
40,Fail,49,21,6,12,37
40,Fail,51,25,0,15,36
40,Fail,49,28,0,11,38
40,Success,54,23,0,12,42
40,Fail,48,26,12,9,39
40,Fail,52,23,5,16,36
40,Success,50,28,0,10,40
40,Fail,42,38,0,12,30
40,Success,62,12,0,14,48
40,Success,53,23,0,11,42
40,Fail,50,23,1,13,37
40,Fail,51,21,3,14,37
40,Success,49,26,10,7,42
40,Fail,45,29,4,13,32
40,Success,61,19,0,6,55
40,Success,50,24,5,9,41
40,Fail,47,31,0,15,32
40,Success,50,30,3,6,44
40,Fail,42,24,8,15,27
40,Fail,46,25,0,16,30
40,Fail,47,26,0,11,36
40,Success,52,29,1,10,42
40,Success,50,27,5,10,40
40,Fail,47,33,0,12,35
40,Fail,45,31,0,16,29
40,Fail,50,24,4,11,39
40,Fail,45,30,4,10,35
40,Fail,38,36,0,13,25
40,Fail,53,24,0,14,39
40,Fail,48,31,0,12,36
40,Fail,50,25,2,11,39
40,Fail,46,24,0,18,28
40,Success,50,28,7,6,44
40,Success,50,28,0,9,41
40,Success,50,27,4,9,41
40,Success,53,26,3,12,41
40,Success,57,22,0,9,48
40,Fail,42,36,0,14,28
40,Fail,51,23,0,16,35
40,Fail,45,29,4,8,37
40,Success,58,16,3,10,48
40,Fail,48,29,0,11,37
40,Fail,48,29,2,11,37
40,Fail,43,37,0,6,37
40,Fail,44,29,1,16,28
40,Success,54,28,0,8,46
40,Fail,40,27,2,16,24
40,Fail,46,28,0,15,31
40,Fail,44,20,5,21,23
40,Fail,50,21,3,15,35
40,Fail,45,33,0,9,36
40,Fail,52,22,0,15,37
40,Fail,50,24,0,15,35
40,Fail,47,33,0,9,38
40,Success,52,24,0,8,44
40,Success,54,21,0,14,40
40,Fail,51,19,4,14,37
40,Fail,49,16,7,19,30
40,Fail,46,25,0,15,31
40,Success,57,23,0,8,49
40,Fail,49,28,0,12,37
40,Fail,43,34,0,13,30
40,Fail,46,32,1,10,36
40,Success,54,20,0,14,40
40,Fail,48,33,0,13,35
40,Fail,42,34,0,13,29
40,Fail,47,32,0,14,33
40,Fail,53,18,1,14,39
40,Fail,40,29,10,11,29
40,Fail,45,32,6,8,37
40,Fail,43,32,0,18,25
40,Success,54,22,0,10,44
40,Fail,44,34,0,13,31
40,Fail,50,21,0,15,35
40,Fail,51,27,0,14,37
40,Fail,46,20,2,16,30
40,Success,49,33,0,9,40
40,Fail,47,27,0,13,34
40,Fail,42,29,7,12,30
40,Fail,49,25,0,13,36
40,Success,52,24,0,8,44
40,Fail,50,21,0,12,38
40,Fail,48,25,5,10,38
40,Fail,43,33,0,15,28
40,Success,49,34,0,7,42
40,Fail,45,25,8,14,31
40,Fail,47,32,0,12,35
40,Fail,43,31,0,13,30
40,Success,54,18,4,11,43
40,Fail,50,20,2,17,33
40,Fail,49,22,8,12,37
40,Fail,53,20,0,15,38
40,Fail,46,37,0,7,39
40,Fail,47,25,0,18,29
40,Fail,48,22,0,14,34
40,Success,52,22,1,12,40
40,Fail,44,24,6,10,34
40,Fail,44,25,2,14,30
40,Fail,48,28,0,17,31
40,Success,54,24,0,10,44
40,Success,57,24,0,7,50
40,Fail,43,30,7,12,31
40,Fail,49,27,5,12,37
40,Success,54,22,3,9,45
40,Fail,45,22,1,20,25
40,Fail,44,32,0,11,33
40,Success,52,33,0,8,44
40,Fail,39,31,4,16,23
40,Fail,44,24,5,14,30
40,Fail,47,28,0,13,34
40,Fail,43,31,0,12,31
40,Fail,37,33,0,21,16
40,Success,54,24,0,12,42
40,Fail,48,35,0,9,39
40,Success,51,28,1,8,43
40,Fail,39,35,0,16,23
40,Success,50,29,0,10,40
40,Fail,43,35,0,13,30
40,Fail,42,36,0,13,29
40,Fail,45,32,2,13,32
40,Fail,44,31,0,20,24
40,Fail,48,28,0,15,33
40,Fail,47,27,1,13,34
40,Fail,43,26,12,11,32
40,Fail,42,31,5,15,27
40,Success,51,24,0,10,41
40,Fail,45,29,5,10,35
40,Fail,43,35,0,11,32
40,Success,54,24,2,8,46
40,Success,49,27,6,9,40
40,Success,50,36,0,6,44
40,Success,55,17,3,11,44
40,Fail,41,21,9,18,23
40,Success,54,22,0,11,43
40,Fail,43,33,2,13,30
40,Fail,50,20,4,18,32
40,Fail,49,30,0,12,37
40,Success,53,27,0,12,41
40,Fail,44,29,0,12,32
40,Fail,46,27,3,14,32
40,Success,53,26,0,9,44
40,Fail,45,33,3,9,36
40,Success,56,17,3,8,48
40,Fail,43,35,0,12,31
40,Fail,47,31,0,13,34
40,Fail,48,30,0,11,37
40,Fail,46,29,0,15,31
40,Fail,48,31,0,14,34
40,Fail,48,32,0,13,35
40,Fail,43,29,0,15,28
40,Fail,44,33,5,7,37
40,Success,60,24,0,7,53
40,Fail,40,39,0,14,26
40,Fail,37,33,12,11,26
40,Fail,46,29,0,13,33
40,Success,52,26,0,8,44
40,Success,58,17,2,11,47
40,Fail,47,30,0,15,32
40,Fail,41,27,2,19,22
40,Success,50,29,3,8,42
40,Fail,47,33,0,11,36
40,Fail,46,36,0,10,36
40,Fail,44,30,0,13,31
40,Fail,48,29,0,9,39
40,Fail,41,32,4,14,27
40,Fail,44,29,1,14,30
40,Success,55,26,0,11,44
40,Fail,47,31,0,13,34
40,Success,58,22,0,8,50
40,Fail,50,22,2,12,38
40,Fail,46,31,0,14,32
40,Fail,45,27,11,9,36
40,Fail,43,36,0,11,32
40,Fail,52,23,0,19,33
40,Success,52,27,0,9,43
40,Fail,41,28,2,16,25
40,Fail,55,24,0,16,39
40,Fail,42,31,3,14,28
40,Fail,48,27,0,12,36
40,Fail,40,31,4,14,26
40,Fail,40,32,5,11,29
40,Fail,41,30,0,16,25
40,Success,56,23,0,9,47
40,Fail,49,30,0,10,39
40,Fail,44,18,7,20,24
40,Fail,49,29,0,15,34
40,Success,53,23,4,10,43
40,Fail,44,34,0,13,31
40,Success,51,28,2,11,40
40,Success,59,16,4,9,50
40,Fail,47,24,3,15,32
40,Success,49,31,0,8,41
40,Success,55,26,0,11,44
40,Fail,48,22,9,13,35
40,Success,51,26,0,11,40
40,Fail,41,30,9,12,29
40,Fail,51,18,0,15,36
40,Fail,53,23,1,15,38
40,Success,51,28,0,9,42
40,Success,49,28,0,8,41
40,Fail,48,24,1,16,32
40,Fail,43,28,5,13,30
40,Fail,43,25,0,18,25
40,Fail,42,31,8,12,30
40,Fail,49,26,5,10,39
40,Fail,49,25,0,16,33
40,Success,56,29,0,6,50
40,Fail,38,39,1,10,28
40,Fail,42,35,0,12,30
40,Success,53,20,6,9,44
40,Fail,50,26,0,13,37
40,Fail,51,22,2,17,34
40,Fail,46,21,1,19,27
40,Success,58,14,0,15,43
40,Fail,47,32,0,13,34
40,Fail,47,35,0,9,38
40,Fail,45,31,0,12,33
40,Fail,46,32,0,11,35
40,Fail,46,25,0,17,29
40,Success,51,27,4,9,42
40,Success,52,23,4,12,40
40,Fail,41,26,6,17,24
40,Fail,50,27,0,13,37
40,Fail,44,33,0,12,32
40,Fail,46,31,3,7,39
40,Fail,42,40,0,12,30
40,Success,56,26,0,6,50
40,Fail,43,30,3,16,27
40,Fail,51,23,0,16,35
40,Fail,51,16,0,23,28
40,Fail,51,27,0,13,38
40,Success,56,24,0,8,48
40,Success,53,27,0,11,42
40,Fail,52,23,0,13,39
40,Fail,51,17,0,22,29
40,Success,55,17,3,10,45
40,Fail,47,26,0,16,31
40,Fail,49,20,1,19,30
40,Fail,50,22,0,16,34
40,Success,52,26,0,8,44
40,Fail,41,28,4,16,25
40,Fail,50,22,0,12,38
40,Fail,51,22,0,18,33
40,Success,51,25,4,7,44
40,Fail,47,22,4,15,32
40,Fail,47,32,0,11,36
40,Fail,42,34,0,18,24
40,Fail,44,23,1,21,23
40,Fail,48,30,0,12,36
40,Success,57,23,0,9,48
40,Fail,52,17,3,13,39
40,Success,53,28,1,6,47
40,Success,50,22,9,10,40
40,Fail,49,26,0,16,33
40,Fail,49,22,2,16,33
40,Fail,40,35,0,19,21
40,Fail,51,24,1,16,35
40,Fail,46,27,3,13,33
40,Success,52,31,0,8,44
40,Fail,50,21,4,12,38
40,Fail,41,41,0,10,31
40,Fail,46,32,2,11,35
40,Fail,44,33,0,15,29
40,Fail,45,27,10,12,33
40,Success,52,19,9,9,43
40,Fail,47,27,0,15,32
40,Fail,41,21,7,22,19
40,Fail,44,29,0,18,26
40,Success,51,27,6,6,45
40,Success,57,22,0,9,48
40,Success,53,22,0,12,41
40,Success,50,23,0,10,40
40,Fail,45,32,0,16,29
40,Fail,48,17,5,18,30
40,Fail,43,26,6,15,28
40,Fail,44,28,0,16,28
40,Fail,50,26,4,12,38
40,Fail,36,37,0,17,19
40,Success,54,24,0,11,43
40,Success,52,25,0,11,41
40,Fail,45,31,3,12,33
40,Success,53,23,2,12,41
40,Success,52,25,1,10,42
40,Success,53,28,0,10,43
40,Fail,44,33,0,13,31
40,Fail,50,24,1,15,35
40,Success,50,29,4,8,42
40,Success,54,19,0,13,41
40,Fail,46,24,0,16,30
40,Fail,44,24,2,20,24
40,Fail,50,26,0,11,39
40,Fail,45,25,7,13,32
40,Fail,52,21,0,14,38
40,Success,53,31,0,9,44
40,Fail,41,37,0,13,28
40,Success,53,31,0,10,43
40,Fail,45,30,1,13,32
40,Fail,52,17,6,15,37
40,Fail,51,24,6,12,39
40,Success,60,22,0,9,51
40,Fail,48,28,3,11,37
40,Fail,46,24,0,16,30
40,Fail,51,27,0,13,38
40,Fail,43,32,0,13,30
40,Success,50,24,6,10,40
40,Fail,49,14,8,16,33
40,Fail,47,29,8,8,39
40,Success,55,27,0,6,49
40,Fail,44,30,0,13,31
40,Fail,45,26,0,15,30
40,Fail,48,22,11,12,36
40,Fail,48,23,9,13,35
40,Success,52,22,3,9,43
40,Fail,44,25,5,17,27
40,Fail,48,34,0,10,38
40,Fail,48,28,4,12,36
40,Fail,42,29,5,14,28
40,Success,57,18,0,13,44
40,Fail,47,28,9,11,36
40,Fail,52,19,0,13,39
40,Success,58,22,2,8,50
40,Fail,37,31,11,14,23
40,Fail,43,25,9,12,31
40,Fail,41,37,0,13,28
40,Fail,50,21,11,12,38
40,Success,51,30,0,10,41
40,Fail,51,19,1,18,33
40,Fail,47,25,2,14,33
40,Success,49,29,1,8,41
40,Success,52,24,0,7,45
40,Success,58,24,0,9,49
40,Fail,41,40,0,14,27
40,Fail,44,37,0,9,35
40,Fail,46,27,0,12,34
40,Fail,42,30,5,11,31
40,Fail,51,22,0,15,36
40,Success,52,26,1,10,42
40,Fail,41,29,0,20,21
40,Fail,38,25,1,23,15
40,Fail,47,27,4,13,34
40,Fail,48,18,1,20,28
40,Fail,48,39,0,9,39
40,Fail,47,34,0,10,37
40,Fail,50,23,0,16,34
40,Fail,48,23,6,14,34
40,Fail,47,27,3,14,33
40,Fail,47,26,0,20,27
40,Fail,50,22,1,16,34
40,Fail,45,34,0,13,32
40,Fail,49,33,0,11,38
40,Fail,43,23,0,17,26
40,Fail,39,26,9,16,23
40,Fail,37,33,4,14,23
40,Fail,41,29,0,19,22
40,Fail,45,27,0,18,27
40,Success,58,23,0,7,51
40,Success,55,21,1,10,45
40,Success,57,25,0,9,48
40,Fail,50,24,5,11,39
40,Fail,42,24,9,18,24
40,Success,56,18,2,10,46
40,Success,54,22,1,10,44
40,Fail,48,28,1,13,35
40,Fail,50,22,11,12,38
40,Fail,41,34,9,10,31
40,Success,53,18,1,13,40
40,Success,55,23,7,8,47
40,Fail,44,30,11,9,35
40,Fail,49,26,0,13,36
40,Fail,47,26,3,15,32
40,Fail,45,24,14,9,36
40,Fail,46,26,1,15,31
40,Success,49,31,2,8,41
40,Fail,48,31,0,13,35
40,Fail,43,32,0,17,26
40,Success,49,30,0,8,41
40,Fail,37,42,0,16,21
40,Success,51,29,0,11,40
40,Fail,51,24,0,13,38
40,Fail,41,24,6,21,20
40,Fail,49,26,6,10,39
40,Fail,45,21,9,16,29
40,Success,54,26,0,11,43
40,Fail,44,30,3,14,30
40,Fail,40,32,8,10,30
40,Fail,44,27,3,18,26
40,Success,55,23,4,11,44
40,Fail,46,26,2,12,34
40,Fail,44,29,0,13,31
40,Fail,51,25,4,13,38
40,Fail,49,25,0,15,34
40,Fail,53,18,2,14,39
40,Fail,48,32,0,12,36
40,Fail,44,33,0,11,33
40,Fail,45,31,0,12,33
40,Success,64,22,0,6,58
40,Fail,51,22,0,14,37
40,Fail,49,20,12,13,36
40,Fail,52,22,0,15,37
40,Fail,43,30,0,15,28
40,Fail,45,36,0,13,32
40,Success,54,24,3,12,42
40,Success,61,23,1,3,58
40,Fail,47,26,3,12,35
40,Success,54,21,0,11,43
40,Fail,43,35,0,14,29
40,Fail,45,27,0,14,31
40,Success,52,25,0,10,42
40,Fail,40,27,10,15,25
40,Fail,47,19,5,18,29
40,Success,54,20,3,11,43
40,Fail,50,31,0,12,38
40,Fail,49,30,0,11,38
40,Fail,51,20,8,14,37
40,Success,57,22,0,10,47
40,Fail,47,31,0,14,33
40,Fail,47,26,0,15,32
40,Fail,47,31,0,13,34
40,Fail,50,20,1,16,34
40,Fail,46,27,1,14,32
40,Fail,48,29,0,16,32
40,Fail,47,26,6,9,38
40,Fail,45,32,0,11,34
40,Fail,45,33,0,16,29
40,Fail,51,27,0,14,37
40,Fail,44,29,0,17,27
40,Fail,52,20,0,18,34
40,Fail,33,45,0,13,20
40,Success,55,27,0,6,49
40,Fail,44,32,0,14,30
40,Success,54,24,0,10,44
40,Fail,47,35,0,10,37
40,Success,54,24,0,11,43
40,Fail,48,25,3,15,33
40,Fail,52,24,3,13,39
40,Success,58,9,4,13,45
40,Fail,53,20,1,15,38
40,Success,57,22,2,6,51
40,Fail,48,26,7,13,35
40,Success,51,33,0,4,47
40,Fail,50,25,0,12,38
40,Fail,41,32,6,10,31
40,Fail,49,29,1,11,38
40,Fail,45,26,0,18,27
40,Fail,47,24,12,12,35
40,Success,59,23,0,6,53
40,Fail,50,23,4,11,39
40,Fail,45,34,0,14,31
40,Fail,46,36,0,12,34
40,Success,50,24,0,10,40
40,Fail,51,22,3,12,39
40,Fail,46,33,0,10,36
40,Fail,48,32,0,11,37
40,Fail,44,35,0,12,32
40,Fail,46,32,0,15,31
40,Fail,47,26,0,13,34
40,Success,57,23,1,7,50
40,Success,55,16,8,11,44
40,Fail,52,20,5,13,39
40,Fail,43,25,0,22,21
40,Success,52,23,3,9,43
40,Fail,48,26,6,14,34
40,Fail,46,26,1,15,31
40,Fail,43,27,5,16,27
40,Fail,45,33,0,13,32
40,Success,56,21,0,8,48
40,Success,54,19,3,11,43
40,Fail,45,35,0,10,35
40,Fail,41,35,3,14,27
40,Fail,38,28,15,12,26
40,Success,56,23,1,10,46
40,Fail,47,17,7,19,28
40,Fail,43,37,0,12,31
40,Fail,45,26,0,16,29
40,Success,57,20,0,11,46
40,Fail,42,26,0,19,23
40,Fail,49,24,0,14,35
40,Fail,48,26,0,14,34
40,Success,55,22,1,13,42
40,Success,50,31,0,9,41
40,Fail,42,27,0,18,24
40,Success,57,23,2,9,48
40,Success,49,30,1,9,40
40,Success,59,14,0,14,45
40,Fail,50,20,0,17,33
40,Success,50,26,8,9,41
40,Fail,49,25,4,12,37
40,Fail,46,24,6,14,32
40,Fail,50,28,0,13,37
40,Fail,52,23,3,13,39
40,Success,58,18,5,7,51
40,Fail,42,25,5,20,22
40,Fail,45,29,0,19,26
40,Fail,45,19,3,22,23
40,Fail,48,26,0,12,36
40,Success,51,26,3,9,42
40,Fail,54,21,0,16,38
40,Success,52,23,0,12,40
40,Fail,50,28,0,14,36
40,Success,51,33,0,11,40
40,Fail,47,26,1,13,34
40,Success,55,22,0,10,45
40,Fail,50,27,0,11,39
40,Fail,41,41,0,12,29
40,Fail,47,34,0,11,36
40,Fail,46,31,0,11,35
40,Success,52,29,0,8,44
40,Fail,50,28,0,12,38
40,Fail,48,22,0,13,35
40,Fail,47,27,11,9,38
40,Fail,51,24,0,13,38
40,Fail,40,28,9,17,23
40,Fail,47,27,0,15,32
40,Fail,49,28,3,11,38
40,Fail,46,30,0,12,34
40,Fail,45,30,3,12,33
40,Success,53,18,0,13,40
40,Success,52,27,0,11,41
40,Success,50,25,4,7,43
40,Fail,48,25,2,15,33
40,Success,59,20,2,8,51
40,Fail,52,18,7,16,36
40,Fail,47,31,0,8,39
40,Fail,38,34,0,17,21
40,Fail,50,25,0,14,36
40,Success,54,21,0,10,44
40,Fail,48,28,7,10,38
40,Fail,38,30,9,13,25
40,Fail,49,34,0,13,36
40,Success,52,24,0,12,40
40,Fail,41,31,0,15,26
40,Fail,50,23,1,13,37
40,Fail,50,28,0,11,39
40,Fail,43,36,0,10,33
40,Fail,44,26,3,16,28
40,Fail,47,22,4,14,33
40,Success,49,22,15,7,42
40,Fail,50,24,0,14,36
40,Fail,43,26,6,16,27
40,Success,52,20,4,12,40
40,Fail,50,26,0,15,35
40,Fail,46,29,0,11,35
40,Fail,50,24,0,15,35
40,Fail,47,28,0,17,30
40,Fail,50,23,1,16,34
40,Fail,42,32,0,16,26
40,Success,49,33,0,7,42
40,Fail,39,40,0,11,28
40,Fail,44,24,6,14,30
40,Fail,44,29,3,16,28
40,Fail,48,16,5,21,27
40,Fail,48,25,3,13,35
40,Fail,49,34,0,10,39
40,Fail,47,19,0,19,28
40,Success,55,24,3,8,47
40,Fail,47,29,0,15,32
40,Fail,50,26,4,12,38
40,Success,54,25,0,10,44
40,Fail,49,24,0,11,38
40,Fail,43,26,10,10,33
40,Fail,51,21,1,13,38
40,Fail,48,29,0,15,33
40,Fail,50,23,2,14,36
40,Success,54,26,0,11,43
40,Fail,40,28,6,15,25
40,Fail,49,26,1,14,35
40,Success,54,22,0,14,40
40,Fail,41,36,0,12,29
40,Success,47,30,0,7,40
40,Success,55,26,2,9,46
40,Fail,47,29,0,11,36
40,Fail,40,30,6,12,28
40,Success,50,28,3,7,43
40,Fail,48,25,2,11,37
40,Success,57,20,0,11,46
40,Success,53,23,6,8,45
40,Fail,43,29,6,14,29
40,Fail,50,25,0,13,37
40,Success,54,26,0,12,42
40,Fail,36,37,0,16,20
40,Fail,49,23,1,15,34
40,Fail,51,22,5,12,39
40,Fail,46,31,0,14,32
40,Fail,50,25,1,14,36
40,Fail,50,28,0,11,39
40,Fail,47,25,8,12,35
40,Fail,45,26,6,11,34
40,Fail,48,28,3,11,37
40,Fail,49,28,0,14,35
40,Fail,43,31,0,15,28
40,Fail,47,29,4,12,35
40,Fail,48,31,0,14,34
40,Fail,55,21,0,16,39
40,Fail,50,27,0,13,37
40,Fail,42,43,0,9,33
40,Fail,41,30,8,11,30
40,Fail,45,25,11,12,33
40,Fail,50,29,0,11,39
40,Fail,45,26,0,16,29
40,Fail,48,27,0,14,34
40,Success,55,24,0,11,44
40,Fail,45,24,5,13,32
40,Fail,43,34,0,15,28
40,Fail,45,32,0,15,30
40,Fail,46,25,0,16,30
40,Fail,48,24,2,10,38
40,Success,51,25,2,10,41
40,Success,53,27,0,13,40
40,Success,52,26,0,8,44
40,Success,56,16,6,11,45
40,Fail,46,32,0,12,34
40,Fail,50,27,1,11,39
40,Fail,44,35,0,10,34
40,Fail,51,25,0,14,37
40,Success,54,24,5,7,47
40,Success,49,31,0,8,41
40,Success,50,25,5,8,42
40,Fail,46,24,8,13,33
40,Success,51,28,6,8,43
40,Fail,45,28,0,20,25
40,Fail,47,27,2,13,34
40,Fail,51,27,0,13,38
40,Success,52,28,0,9,43
40,Fail,44,30,0,12,32
40,Fail,44,23,10,14,30
40,Fail,43,25,11,13,30
40,Fail,50,23,4,14,36
40,Fail,48,25,4,12,36
40,Fail,48,28,3,13,35
40,Fail,43,31,0,17,26
40,Fail,42,26,6,15,27
40,Fail,46,29,7,8,38
40,Success,52,22,6,10,42
40,Fail,47,30,0,15,32
40,Fail,45,33,0,13,32
40,Success,54,25,1,10,44
40,Fail,42,31,0,16,26
40,Fail,43,28,8,15,28
40,Success,56,21,1,9,47
40,Fail,39,39,0,15,24
40,Success,53,25,0,10,43
40,Fail,45,39,0,10,35
40,Fail,44,25,6,13,31
40,Fail,48,23,8,9,39
40,Success,47,39,0,5,42
40,Fail,43,28,8,13,30
40,Success,50,26,0,9,41
40,Fail,44,29,0,12,32
40,Fail,45,36,0,16,29
40,Fail,44,23,11,14,30
40,Fail,51,23,0,15,36
40,Fail,44,37,0,10,34
40,Success,55,21,3,8,47
40,Success,48,36,0,8,40
40,Fail,50,21,8,11,39
40,Fail,44,25,3,14,30
40,Fail,47,23,0,16,31
40,Fail,45,26,6,11,34
40,Fail,40,29,12,13,27
40,Fail,41,32,0,14,27
40,Fail,38,33,2,18,20
40,Fail,47,27,0,16,31
40,Fail,39,31,0,14,25
40,Success,48,29,0,7,41
40,Fail,47,29,0,14,33
40,Fail,45,28,3,10,35
40,Fail,46,23,1,13,33
40,Success,50,30,0,9,41
40,Success,49,33,0,8,41
40,Success,48,33,0,6,42
40,Fail,41,28,8,16,25
40,Fail,41,39,0,12,29
40,Fail,40,24,12,16,24
40,Fail,48,17,3,21,27
40,Fail,53,24,0,14,39
40,Fail,48,25,0,15,33
40,Fail,49,26,0,12,37
40,Fail,48,27,0,13,35
40,Fail,44,23,2,15,29
40,Success,51,26,3,10,41
40,Fail,47,25,1,17,30
40,Fail,50,24,1,13,37
40,Fail,48,21,0,24,24
40,Fail,46,27,0,15,31
40,Fail,47,28,2,11,36
40,Fail,46,26,0,18,28
40,Fail,46,36,0,10,36
40,Fail,42,34,3,7,35
40,Success,54,21,0,12,42
40,Fail,49,29,2,13,36
40,Fail,45,33,1,12,33
40,Success,52,28,0,7,45
40,Success,56,19,0,14,42
40,Fail,41,25,10,14,27
40,Fail,47,28,5,10,37
40,Fail,52,22,5,14,38
40,Fail,44,32,1,13,31
40,Success,56,26,0,6,50
40,Fail,44,39,0,9,35
40,Success,59,17,0,10,49
40,Success,56,26,0,9,47
40,Fail,48,26,0,17,31
40,Success,51,29,0,10,41
40,Fail,37,28,7,21,16
40,Fail,43,23,6,18,25
40,Fail,53,22,0,15,38
40,Success,56,19,0,13,43
40,Success,55,21,5,9,46
40,Success,48,30,3,8,40
40,Fail,50,24,0,15,35
40,Fail,49,30,0,11,38
40,Success,52,31,0,5,47
40,Fail,48,25,0,19,29
40,Success,49,39,0,3,46
40,Fail,47,25,2,13,34
40,Fail,50,21,0,13,37
40,Fail,45,26,6,12,33
40,Success,53,19,0,12,41
40,Success,50,30,0,8,42
40,Success,54,24,2,11,43
40,Fail,43,25,2,15,28
40,Fail,48,30,0,16,32
40,Fail,44,32,3,11,33
40,Fail,38,31,0,18,20
40,Fail,42,41,0,10,32
40,Fail,39,39,0,10,29
40,Fail,42,27,0,21,21
40,Success,54,25,0,9,45
40,Success,51,28,2,10,41
40,Fail,46,20,5,20,26
40,Fail,52,19,5,14,38
40,Fail,46,32,0,13,33
40,Success,55,29,0,7,48
40,Fail,45,28,0,17,28
40,Fail,44,23,12,10,34
40,Success,54,26,1,12,42
40,Success,57,22,0,8,49
40,Success,55,25,0,8,47
40,Fail,52,22,0,14,38
40,Fail,49,28,0,12,37
40,Fail,50,26,0,14,36
40,Fail,51,23,0,12,39
40,Success,53,22,1,13,40
40,Success,55,24,0,9,46
40,Success,58,20,0,9,49
40,Fail,50,26,1,13,37
40,Fail,48,30,0,11,37
40,Fail,50,20,4,12,38
40,Fail,37,33,0,20,17
40,Fail,46,32,0,15,31
40,Success,54,31,0,6,48
40,Fail,43,25,6,13,30
40,Fail,47,28,3,12,35
40,Fail,48,26,7,12,36
40,Fail,41,32,0,16,25
40,Success,50,28,0,9,41
40,Fail,43,35,0,16,27
40,Fail,41,30,2,15,26
40,Fail,48,28,0,14,34
40,Success,51,28,2,8,43
40,Success,50,32,1,10,40
40,Fail,44,31,0,16,28
40,Fail,47,31,0,13,34
40,Success,50,29,0,10,40
40,Fail,47,25,4,15,32
40,Fail,49,22,3,15,34
40,Fail,47,26,7,10,37
40,Success,53,20,1,12,41
40,Fail,49,27,0,12,37
40,Fail,50,30,0,11,39
40,Success,51,26,1,7,44
40,Fail,50,23,0,13,37
40,Fail,36,41,0,15,21
40,Fail,53,25,0,14,39
40,Success,53,24,1,11,42
40,Fail,45,25,0,15,30
40,Fail,46,30,4,11,35
40,Fail,47,24,5,12,35
40,Fail,46,36,0,10,36
40,Fail,40,28,3,19,21
40,Fail,49,29,0,12,37
40,Fail,41,43,0,11,30
40,Fail,46,28,0,15,31
40,Fail,49,28,0,11,38
40,Success,54,27,0,12,42
40,Fail,50,21,0,16,34
40,Fail,49,23,0,11,38
40,Success,55,25,0,10,45
40,Fail,41,35,2,15,26
40,Fail,44,24,7,18,26
40,Fail,49,27,1,12,37
40,Fail,47,28,5,12,35
40,Fail,40,31,0,21,19
40,Success,51,26,0,11,40
40,Fail,46,28,5,10,36
40,Fail,38,27,5,17,21
40,Fail,49,21,1,14,35
40,Success,52,26,0,9,43
40,Success,54,25,0,13,41
40,Fail,42,35,0,14,28
40,Fail,47,36,0,12,35
40,Fail,44,23,0,20,24
40,Fail,46,24,2,13,33
40,Fail,51,20,7,12,39
40,Success,56,18,0,12,44
40,Success,54,21,0,12,42
40,Fail,50,26,0,12,38
40,Success,50,29,0,8,42
40,Fail,43,30,0,15,28
40,Fail,46,25,5,13,33
40,Fail,48,28,2,13,35
40,Fail,50,23,7,14,36
40,Fail,51,20,3,14,37
40,Success,52,24,2,12,40
40,Fail,40,23,8,20,20
40,Fail,41,29,0,17,24
40,Success,57,14,5,11,46
40,Fail,42,30,3,13,29
40,Fail,49,28,1,11,38
40,Success,53,26,0,12,41
40,Fail,47,30,0,11,36
40,Fail,35,38,6,12,23
40,Fail,52,21,1,14,38
40,Fail,44,34,0,12,32
40,Fail,44,35,0,13,31
40,Fail,39,37,0,13,26
40,Success,52,32,0,6,46
40,Success,54,25,0,11,43
40,Fail,45,34,0,13,32
40,Fail,51,19,1,14,37
40,Fail,52,21,0,14,38
40,Fail,48,19,5,20,28
40,Success,56,24,0,9,47
40,Success,46,25,7,6,40
40,Fail,46,24,2,16,30
40,Fail,51,25,0,13,38
40,Fail,43,32,0,16,27
40,Fail,54,23,0,16,38
40,Success,54,25,0,13,41
40,Fail,50,21,0,18,32
40,Success,56,20,5,7,49
40,Fail,49,26,0,14,35
40,Success,53,20,2,11,42
40,Fail,48,25,1,14,34
40,Success,54,23,1,10,44
40,Fail,45,22,5,18,27
40,Fail,44,37,0,14,30
40,Fail,40,45,0,11,29
40,Success,52,24,0,11,41
40,Fail,45,28,3,14,31
40,Fail,44,32,0,11,33
40,Fail,48,22,4,19,29
40,Fail,48,29,6,12,36
40,Fail,52,19,0,15,37
40,Fail,48,30,1,10,38
40,Fail,43,33,3,12,31
40,Success,49,29,1,7,42
40,Fail,53,18,2,14,39
40,Fail,44,24,0,20,24
40,Fail,43,35,0,15,28
40,Fail,49,23,0,13,36
40,Success,50,26,4,8,42
40,Success,50,29,0,10,40
40,Fail,48,24,9,9,39
40,Fail,48,22,0,15,33
40,Fail,48,20,3,20,28
40,Fail,43,29,0,20,23
40,Fail,50,23,0,15,35
40,Fail,40,44,0,9,31
40,Fail,42,29,0,18,24
40,Success,55,24,0,8,47
40,Fail,45,28,0,13,32
40,Success,52,25,2,8,44
40,Success,58,17,1,12,46
40,Fail,42,28,8,13,29
40,Fail,43,41,0,7,36
40,Success,55,19,0,14,41
40,Fail,46,21,5,18,28
40,Fail,49,23,0,12,37
40,Success,50,27,3,7,43
40,Success,49,29,5,9,40
40,Success,51,24,6,11,40
40,Fail,49,25,4,13,36
40,Fail,49,21,5,10,39
40,Fail,49,24,5,12,37
40,Fail,50,21,4,13,37
40,Fail,49,21,1,15,34
40,Success,56,20,0,12,44
40,Fail,44,28,9,10,34
40,Fail,44,37,0,11,33
40,Fail,46,25,4,12,34
40,Success,52,23,4,11,41
40,Success,54,25,0,10,44
40,Fail,44,27,0,18,26
40,Fail,46,18,12,17,29
40,Fail,37,36,0,16,21
40,Fail,45,31,0,12,33
40,Fail,45,25,9,12,33
40,Fail,45,25,1,15,30
40,Fail,49,25,0,14,35
40,Fail,44,31,0,16,28
40,Success,51,27,4,6,45
40,Fail,46,26,0,15,31
40,Fail,49,28,0,13,36
40,Fail,43,28,8,13,30
40,Success,52,29,3,8,44
40,Fail,44,29,3,16,28
40,Fail,48,23,3,15,33
40,Fail,50,25,0,12,38
40,Fail,48,21,2,12,36
40,Fail,46,30,5,10,36
40,Fail,52,26,0,15,37
40,Fail,48,27,7,9,39
40,Fail,41,29,4,18,23
40,Fail,42,33,5,11,31
40,Success,53,26,0,8,45
40,Fail,45,30,1,12,33
40,Fail,43,27,0,19,24
40,Fail,51,27,0,14,37
40,Success,53,26,0,11,42
40,Fail,51,19,2,13,38
40,Fail,47,26,0,12,35
40,Fail,42,29,14,9,33
40,Fail,46,30,0,11,35
40,Success,54,28,3,3,51
40,Success,48,31,1,7,41
40,Fail,41,31,0,17,24
40,Fail,54,24,0,17,37
40,Success,54,25,1,11,43
40,Fail,53,23,0,14,39
40,Fail,52,18,0,15,37
40,Fail,45,30,8,11,34
40,Success,59,23,1,9,50
40,Fail,45,24,3,18,27
40,Fail,42,21,3,22,20
40,Fail,45,29,0,15,30
40,Fail,39,44,0,12,27
40,Fail,42,24,4,18,24
40,Fail,35,34,9,15,20
40,Fail,48,17,6,19,29
40,Success,51,26,0,9,42
40,Success,52,26,0,12,40
40,Fail,50,27,0,12,38
40,Fail,46,31,5,8,38
40,Fail,47,23,7,13,34
40,Success,51,29,0,11,40
40,Success,52,22,6,11,41
40,Success,51,22,5,11,40
40,Success,46,37,0,5,41
40,Success,53,21,1,12,41
40,Fail,45,28,0,15,30
40,Fail,41,32,1,18,23
40,Fail,38,36,0,16,22
40,Success,51,26,4,10,41
40,Success,50,28,2,10,40
40,Fail,48,29,0,12,36
40,Fail,44,36,4,8,36
40,Success,56,22,3,7,49
40,Success,49,26,4,8,41
40,Success,53,25,7,6,47
40,Success,50,27,4,10,40
40,Fail,47,29,0,15,32
40,Success,54,20,1,13,41
40,Fail,51,26,0,12,39
40,Fail,45,32,0,13,32
40,Fail,44,29,3,13,31
40,Success,53,31,0,9,44
40,Fail,42,37,0,9,33
40,Fail,49,20,6,11,38
40,Success,52,30,0,9,43
40,Fail,41,33,0,15,26
40,Fail,42,42,0,9,33
40,Fail,49,27,0,12,37
40,Fail,48,28,1,14,34
40,Success,51,24,2,11,40
40,Fail,39,29,7,18,21
40,Fail,42,37,0,14,28
40,Fail,41,29,11,11,30
40,Success,51,25,0,11,40
40,Fail,46,26,4,13,33
40,Fail,46,31,0,12,34
40,Fail,41,34,0,11,30
40,Success,49,32,0,8,41
40,Fail,49,26,4,11,38
40,Fail,44,30,8,12,32
40,Fail,49,25,4,12,37
40,Fail,46,23,6,13,33
40,Success,57,19,0,9,48
40,Fail,50,29,0,12,38
40,Fail,49,24,2,13,36
40,Fail,47,31,0,11,36
40,Fail,48,27,4,12,36
40,Fail,48,23,8,13,35
40,Success,49,32,0,7,42
40,Success,56,27,0,11,45
40,Fail,42,33,0,16,26
40,Fail,49,23,0,16,33
40,Fail,49,27,5,10,39
40,Fail,49,33,0,11,38
40,Fail,43,30,6,10,33
40,Fail,47,31,0,11,36
40,Fail,42,31,3,13,29
40,Success,56,23,0,11,45
40,Fail,43,35,0,14,29
40,Fail,50,26,0,15,35
40,Success,53,26,0,8,45
40,Success,52,26,3,8,44
40,Fail,47,27,0,10,37
40,Fail,46,29,0,16,30
40,Fail,52,24,3,13,39
40,Fail,41,31,0,18,23
40,Fail,44,35,0,10,34
40,Fail,50,24,2,14,36
40,Fail,47,31,0,8,39
40,Fail,42,31,6,15,27
40,Fail,45,31,0,14,31
40,Success,57,20,2,8,49
40,Fail,46,25,1,18,28
40,Success,50,29,2,9,41
40,Fail,45,25,6,14,31
40,Fail,44,35,0,11,33
40,Fail,50,29,0,11,39
40,Fail,46,25,0,14,32
40,Fail,44,33,0,12,32
40,Fail,46,29,0,12,34
40,Success,50,27,2,9,41
40,Success,49,26,2,8,41
40,Success,52,26,0,9,43
40,Fail,52,20,0,17,35
40,Success,52,26,0,7,45
40,Fail,45,31,0,11,34
40,Fail,50,28,0,12,38
40,Success,54,25,0,10,44
40,Fail,49,24,1,11,38
40,Fail,47,28,0,12,35
40,Fail,45,32,0,15,30
40,Fail,54,19,0,16,38
40,Fail,41,27,3,19,22
40,Success,50,30,2,8,42
40,Success,51,25,4,10,41
40,Fail,49,25,4,13,36
40,Fail,48,28,3,9,39
40,Fail,52,22,0,14,38
40,Fail,44,33,0,14,30
40,Fail,55,16,3,16,39
40,Fail,42,28,0,18,24
40,Fail,44,29,2,14,30
40,Success,53,17,2,13,40
40,Fail,45,29,0,13,32
40,Success,52,28,0,10,42
40,Fail,50,24,1,12,38
40,Fail,42,28,1,20,22
40,Fail,41,40,0,11,30
40,Fail,50,25,0,14,36
40,Fail,48,23,5,13,35
40,Fail,45,23,2,17,28
40,Success,58,20,2,6,52
40,Fail,43,29,0,19,24
40,Fail,42,36,0,9,33
40,Fail,51,18,2,17,34
40,Success,51,24,3,11,40
40,Success,53,23,5,3,50
40,Fail,44,26,3,13,31
40,Success,55,26,0,8,47
40,Success,49,33,0,7,42
40,Fail,54,17,2,15,39
40,Fail,49,26,3,13,36
40,Success,52,29,2,8,44
40,Fail,50,31,0,11,39
40,Fail,48,30,0,12,36
40,Success,57,24,0,10,47
40,Success,53,23,5,9,44
40,Success,53,24,0,13,40
40,Fail,39,37,6,7,32
40,Success,50,35,0,8,42
40,Fail,44,34,0,12,32
40,Fail,48,31,0,11,37
40,Success,53,25,0,11,42
40,Success,52,27,1,8,44
40,Success,53,20,0,13,40
40,Success,52,29,0,12,40
40,Fail,48,23,3,13,35
40,Fail,43,30,0,16,27
40,Fail,45,25,8,16,29
40,Fail,51,21,0,12,39
40,Fail,47,22,6,16,31
40,Success,53,22,2,12,41
40,Success,51,28,0,11,40
40,Success,50,24,4,10,40
40,Fail,43,27,3,18,25
40,Fail,44,25,9,15,29
40,Fail,47,35,0,9,38
40,Fail,48,27,0,10,38
40,Success,60,13,0,12,48
40,Fail,49,28,5,12,37
40,Fail,47,27,2,14,33
40,Fail,44,32,0,12,32
40,Fail,48,34,0,9,39
40,Fail,49,28,0,11,38
40,Fail,50,22,6,13,37
40,Success,55,22,0,12,43
40,Fail,45,35,0,8,37
40,Fail,53,23,0,14,39
40,Fail,41,24,11,14,27
40,Fail,46,27,0,15,31
40,Fail,39,36,0,13,26
40,Fail,51,26,0,15,36
40,Fail,47,29,0,13,34
40,Fail,44,26,3,17,27
40,Fail,47,22,7,13,34
40,Fail,44,32,0,16,28
40,Success,54,29,1,8,46
40,Fail,52,24,0,15,37
40,Fail,50,27,0,11,39
40,Success,56,21,0,12,44
40,Fail,46,25,7,12,34
40,Success,53,27,0,9,44
40,Success,54,21,1,10,44
40,Fail,44,28,2,17,27
40,Fail,49,24,5,12,37
40,Fail,48,26,2,15,33
40,Fail,42,28,0,18,24
40,Fail,48,27,0,14,34
40,Fail,42,30,1,17,25
40,Success,52,23,3,12,40
40,Success,53,24,0,13,40
40,Fail,46,29,0,14,32
40,Fail,47,28,0,13,34
40,Fail,51,25,1,15,36
40,Fail,49,25,1,16,33
40,Fail,44,25,2,18,26
40,Fail,46,27,0,13,33
40,Fail,47,27,1,11,36
40,Fail,43,31,0,12,31
40,Fail,42,29,0,17,25
40,Fail,45,24,1,17,28
40,Fail,50,20,7,15,35
40,Success,50,21,9,10,40
40,Fail,51,20,2,14,37
40,Fail,44,29,1,14,30
40,Fail,47,28,0,15,32
40,Success,54,20,1,14,40
40,Success,52,24,5,8,44
40,Fail,43,36,0,14,29
40,Success,54,23,5,12,42
40,Fail,47,29,0,16,31
40,Fail,45,29,1,15,30
40,Fail,47,28,4,15,32
40,Success,52,28,0,10,42
40,Success,54,22,0,9,45
40,Fail,51,21,0,14,37
40,Success,53,22,3,12,41
40,Fail,45,27,1,16,29
40,Success,48,26,4,7,41
40,Fail,46,28,0,12,34
40,Fail,48,26,4,12,36
40,Fail,45,36,0,12,33
40,Fail,43,28,6,17,26
40,Success,55,25,5,5,50
40,Success,54,28,0,8,46
40,Fail,54,20,0,17,37
40,Success,49,24,9,7,42
40,Fail,43,34,0,13,30
40,Fail,46,27,2,9,37
40,Fail,46,30,0,17,29
40,Success,55,20,0,14,41
40,Fail,46,37,0,10,36
40,Success,52,23,5,12,40
40,Success,53,28,0,6,47
40,Fail,47,30,0,12,35
40,Fail,50,19,8,15,35
40,Success,49,28,0,9,40
40,Fail,38,44,0,11,27
40,Fail,46,25,0,18,28
40,Fail,51,20,0,15,36
40,Fail,43,27,5,16,27
40,Fail,47,28,0,14,33
40,Fail,54,23,0,15,39
40,Fail,43,26,0,19,24
40,Fail,46,22,9,15,31
40,Fail,49,29,5,10,39
40,Fail,47,21,0,19,28
40,Success,51,29,0,11,40
40,Success,56,26,0,8,48
40,Fail,50,20,0,18,32
40,Fail,46,26,0,13,33
40,Success,50,31,0,10,40
40,Fail,40,29,8,17,23
40,Fail,46,29,0,15,31
40,Success,54,23,1,13,41
40,Fail,45,30,1,11,34
40,Fail,49,30,0,12,37
40,Fail,43,35,0,12,31
40,Fail,50,27,0,15,35
40,Fail,45,28,2,15,30
40,Success,50,31,1,5,45
40,Success,49,33,0,8,41
40,Fail,46,24,4,16,30
40,Success,52,29,0,9,43
40,Success,54,24,0,14,40
40,Success,52,28,4,6,46
40,Fail,42,33,0,13,29
40,Fail,48,23,5,17,31
40,Fail,44,23,4,15,29
40,Fail,49,22,3,13,36
40,Fail,45,31,0,15,30
40,Fail,36,36,0,20,16
40,Fail,43,31,0,17,26
40,Success,54,20,8,10,44
40,Fail,44,32,0,16,28
40,Fail,46,30,0,13,33
40,Fail,49,22,0,13,36
40,Success,55,27,0,7,48
40,Fail,46,27,0,15,31
40,Fail,49,26,0,14,35
40,Fail,47,24,0,16,31
40,Fail,48,19,5,18,30
40,Fail,45,33,4,9,36
40,Fail,45,27,5,16,29
40,Success,48,36,0,8,40
40,Fail,40,32,0,15,25
40,Success,51,26,0,11,40
40,Fail,49,23,2,11,38
40,Fail,47,23,0,17,30
40,Fail,47,21,3,17,30
40,Fail,49,25,0,15,34
40,Fail,49,25,1,13,36
40,Success,48,38,0,8,40
40,Success,52,26,0,7,45
40,Fail,47,26,2,17,30
40,Success,57,20,0,12,45
40,Fail,40,26,11,12,28
40,Fail,48,30,0,12,36
40,Success,52,30,3,7,45
40,Success,53,19,1,13,40
40,Fail,46,31,0,13,33
40,Fail,41,37,0,11,30
40,Fail,42,28,8,15,27
40,Success,53,27,0,10,43
40,Fail,44,32,0,12,32
40,Success,50,31,0,10,40
40,Success,52,24,0,12,40
40,Fail,47,22,10,13,34
40,Fail,52,21,0,14,38
40,Fail,47,29,0,14,33
40,Fail,52,25,0,16,36
40,Fail,46,18,9,14,32
40,Fail,43,40,0,8,35
40,Fail,49,30,0,11,38
40,Fail,38,41,0,17,21
40,Fail,51,29,0,13,38
40,Fail,53,22,2,15,38
40,Fail,47,23,0,17,30
40,Fail,40,35,0,15,25
40,Success,54,29,0,3,51
40,Fail,46,31,0,13,33
40,Fail,44,30,1,13,31
40,Success,55,20,3,9,46
40,Fail,49,29,0,15,34
40,Fail,43,28,9,12,31
40,Fail,49,15,5,16,33
40,Fail,49,28,0,11,38
40,Fail,49,23,0,14,35
40,Fail,42,28,1,17,25
40,Fail,41,28,8,17,24
40,Fail,48,25,0,16,32
40,Fail,39,32,9,14,25
40,Fail,45,33,0,10,35
40,Fail,45,27,4,12,33
40,Fail,40,31,5,14,26
40,Fail,48,27,4,11,37
40,Fail,50,27,0,12,38
40,Fail,50,19,6,13,37
40,Success,55,28,0,8,47
40,Fail,45,28,6,13,32
40,Success,51,27,2,8,43
40,Fail,42,31,0,16,26
40,Fail,51,24,0,14,37
40,Fail,45,26,6,16,29
40,Fail,44,27,0,18,26
40,Fail,49,24,2,11,38
40,Fail,43,33,0,13,30
40,Fail,49,21,0,20,29
40,Fail,46,30,0,17,29
40,Fail,47,34,0,10,37
40,Success,52,24,0,11,41
40,Fail,52,21,5,13,39
40,Success,58,16,5,13,45
40,Fail,39,40,0,13,26
40,Fail,48,23,8,12,36
40,Fail,47,27,0,13,34
40,Fail,45,28,5,7,38
40,Fail,46,30,0,9,37
40,Fail,51,29,0,13,38
40,Success,52,25,0,9,43
40,Fail,48,33,0,10,38
40,Success,49,27,6,7,42
40,Success,52,26,3,11,41
40,Fail,49,29,0,10,39
40,Fail,47,29,7,10,37
40,Success,55,18,1,15,40
40,Fail,46,24,3,15,31
40,Fail,47,30,0,11,36
40,Fail,52,20,0,19,33
40,Fail,47,28,2,13,34
40,Fail,45,35,0,12,33
40,Success,50,30,0,10,40
40,Fail,52,26,0,13,39
40,Fail,52,21,0,14,38
40,Fail,45,31,0,13,32
40,Fail,53,22,0,15,38
40,Success,53,16,4,12,41
40,Fail,41,40,0,6,35
40,Success,51,29,4,10,41
40,Fail,52,22,1,13,39
40,Fail,47,29,0,13,34
40,Fail,50,27,0,13,37
40,Success,55,21,0,11,44
40,Fail,50,26,0,11,39
40,Fail,44,31,0,17,27
40,Fail,48,26,0,17,31
40,Fail,45,24,16,10,35
40,Fail,44,30,8,10,34
40,Success,49,24,4,8,41
40,Fail,48,21,2,19,29
40,Fail,49,24,6,10,39
40,Fail,46,26,0,16,30
40,Fail,51,25,2,14,37
40,Fail,51,19,0,18,33
40,Fail,51,23,0,14,37
40,Fail,46,26,2,15,31
40,Fail,36,30,0,24,12
40,Success,56,23,0,11,45
40,Success,61,19,1,7,54
40,Fail,41,38,0,12,29
40,Fail,46,34,0,10,36
40,Fail,48,24,4,13,35
40,Fail,50,22,0,15,35
40,Success,51,25,0,11,40
40,Success,56,26,0,7,49
40,Success,50,30,0,9,41
40,Success,54,18,1,13,41
40,Success,57,29,0,6,51
40,Success,55,23,2,8,47
40,Success,58,25,0,7,51
40,Fail,48,23,0,15,33
40,Fail,38,44,0,11,27
40,Success,55,21,0,15,40
40,Success,51,22,5,10,41
40,Fail,38,29,11,16,22
40,Fail,45,28,1,13,32
40,Success,53,23,3,10,43
40,Success,51,25,1,10,41
40,Fail,44,32,0,15,29
40,Fail,46,30,0,13,33
40,Fail,46,24,14,11,35
40,Success,55,25,0,9,46
40,Success,51,28,0,9,42
40,Fail,51,17,8,16,35
40,Fail,46,27,6,11,35
40,Fail,44,33,0,13,31
40,Success,52,24,0,12,40
40,Fail,52,21,0,17,35
40,Fail,46,25,9,13,33
40,Fail,44,29,1,16,28
40,Success,51,31,0,6,45
40,Fail,52,20,0,16,36
40,Success,52,32,0,7,45
40,Fail,52,23,0,14,38
40,Fail,45,24,3,18,27
40,Fail,52,17,6,13,39
40,Fail,50,31,0,11,39
40,Fail,48,31,0,14,34
40,Fail,47,23,9,10,37
40,Success,52,23,0,11,41
40,Success,56,19,4,9,47
40,Success,50,23,0,7,43
40,Success,49,33,0,9,40
40,Success,54,30,0,9,45
40,Success,51,31,4,8,43
40,Success,49,31,0,9,40
40,Fail,46,29,1,15,31
40,Fail,43,23,7,13,30
40,Fail,41,26,2,20,21
40,Fail,43,27,2,14,29
40,Success,50,22,8,9,41
40,Fail,48,24,4,14,34
40,Fail,44,29,10,9,35
40,Fail,48,30,0,10,38
40,Fail,43,26,9,13,30
40,Fail,47,30,0,9,38
40,Fail,47,23,0,21,26
40,Success,51,26,1,8,43
40,Success,52,23,0,12,40
40,Fail,45,32,2,9,36
40,Fail,45,30,4,13,32
40,Fail,49,22,0,16,33
40,Fail,46,31,2,9,37
40,Success,55,21,0,13,42
40,Fail,50,25,0,12,38
40,Fail,40,33,0,14,26
40,Fail,44,27,2,17,27
40,Success,59,19,0,11,48
40,Fail,48,30,0,10,38
40,Fail,42,34,7,11,31
40,Fail,40,30,0,18,22
40,Fail,43,27,0,15,28
40,Fail,42,29,3,13,29
40,Fail,46,26,2,13,33
40,Fail,46,29,4,12,34
40,Fail,49,25,0,15,34
40,Fail,47,26,0,16,31
40,Fail,47,32,0,14,33
40,Success,55,29,0,5,50
40,Success,53,24,0,9,44
40,Fail,39,33,0,20,19
40,Fail,49,27,0,18,31
40,Fail,44,25,0,20,24
40,Fail,40,38,0,12,28
40,Fail,40,40,2,9,31
40,Fail,42,29,4,13,29
40,Success,56,22,1,8,48
40,Fail,43,28,0,19,24
40,Fail,50,26,0,12,38
40,Fail,48,29,0,13,35
40,Fail,47,20,7,16,31
40,Fail,39,28,0,21,18
40,Fail,50,24,0,13,37
40,Success,54,26,3,7,47
40,Fail,52,25,0,13,39
40,Fail,43,33,0,14,29
40,Fail,42,28,13,12,30
40,Fail,46,24,8,13,33
40,Success,47,39,0,5,42
40,Fail,46,24,7,11,35
40,Fail,49,24,0,12,37
40,Fail,38,30,1,21,17
40,Fail,44,33,2,15,29
40,Fail,46,35,0,12,34
40,Success,55,16,1,11,44
40,Fail,50,22,1,13,37
40,Success,54,24,3,11,43
40,Fail,41,32,0,13,28
40,Success,55,22,0,12,43
40,Success,52,24,4,10,42
40,Fail,44,29,0,14,30
40,Fail,48,31,1,11,37
40,Success,58,15,0,12,46
40,Fail,40,27,7,15,25
40,Success,56,23,0,10,46
40,Fail,37,30,7,15,22
40,Fail,42,29,6,11,31
40,Success,54,24,2,10,44
40,Fail,44,30,3,15,29
40,Fail,47,26,2,17,30
40,Success,52,29,1,12,40
40,Fail,44,29,0,17,27
40,Fail,51,25,0,14,37
40,Fail,46,29,2,14,32
40,Fail,46,24,0,17,29
40,Fail,33,48,0,15,18
40,Success,56,23,0,9,47
40,Fail,47,26,0,13,34
40,Success,57,21,1,10,47
40,Fail,48,26,0,13,35
40,Fail,46,28,4,9,37
40,Fail,50,25,7,11,39
40,Success,57,21,4,10,47
40,Fail,49,32,0,10,39
40,Success,55,25,0,9,46
40,Fail,47,22,4,14,33
40,Fail,44,31,0,15,29
40,Success,56,20,0,14,42
40,Fail,40,35,0,19,21
40,Fail,39,31,6,16,23
40,Success,51,25,2,10,41
40,Fail,38,34,0,17,21
40,Fail,46,25,4,13,33
40,Fail,46,29,0,11,35
40,Fail,43,33,0,10,33
40,Fail,42,28,0,17,25
40,Fail,49,31,0,12,37
40,Fail,42,32,5,10,32
40,Success,58,17,0,12,46
40,Success,58,15,4,10,48
40,Fail,51,26,0,14,37
40,Fail,54,18,0,16,38
40,Fail,49,27,2,15,34
40,Fail,47,35,0,8,39
40,Success,52,17,6,12,40
40,Fail,42,30,9,13,29
40,Fail,42,24,3,19,23
40,Fail,41,36,0,12,29
40,Fail,48,25,2,17,31
40,Fail,49,21,5,17,32
40,Fail,49,29,0,13,36
40,Fail,46,28,0,17,29
40,Fail,45,20,2,25,20
40,Fail,49,26,0,11,38
40,Success,51,27,1,9,42
40,Fail,44,30,0,15,29
40,Fail,50,26,9,12,38
40,Success,56,24,0,6,50
40,Success,53,25,0,13,40
40,Fail,36,32,8,15,21
40,Fail,52,22,0,16,36
40,Success,55,26,0,6,49
40,Success,58,23,0,9,49
40,Success,52,27,0,11,41
40,Fail,53,19,0,15,38
40,Success,51,27,0,8,43
40,Fail,45,29,2,16,29
40,Fail,47,29,0,11,36
40,Fail,48,29,0,14,34
40,Fail,50,32,0,11,39
40,Fail,49,24,1,14,35
40,Success,60,13,5,11,49
40,Fail,45,33,0,14,31
40,Fail,49,28,2,10,39
40,Fail,40,33,0,16,24
40,Fail,46,30,0,15,31
40,Fail,47,24,5,13,34
40,Fail,50,23,3,13,37
40,Fail,41,22,15,16,25
40,Fail,50,23,8,16,34
40,Success,55,23,0,10,45
40,Fail,46,19,0,21,25
40,Success,48,30,0,8,40
40,Fail,45,24,1,17,28
40,Fail,47,30,0,9,38
40,Success,55,21,0,10,45
40,Success,55,27,0,10,45
40,Fail,49,28,1,12,37
40,Fail,44,31,5,12,32
40,Fail,51,26,0,14,37
40,Fail,44,33,0,9,35
40,Fail,49,22,1,15,34
40,Fail,49,21,7,12,37
40,Fail,47,29,3,13,34
40,Success,54,18,2,11,43
40,Fail,49,26,0,16,33
40,Success,55,18,6,13,42
40,Success,49,28,0,8,41
40,Fail,48,16,9,15,33
40,Fail,47,27,1,14,33
40,Success,55,24,0,9,46
40,Success,59,20,1,12,47
40,Fail,44,22,5,18,26
40,Success,54,29,0,8,46
40,Success,50,31,0,10,40
40,Fail,44,32,3,11,33
40,Fail,50,21,0,15,35
40,Success,54,23,1,13,41
40,Success,52,30,0,9,43
40,Fail,46,30,0,9,37
40,Fail,48,24,7,11,37
40,Success,55,28,0,9,46
40,Fail,48,26,0,13,35
40,Fail,43,35,0,11,32
40,Fail,46,29,5,11,35
40,Fail,41,35,6,11,30
40,Fail,47,28,0,14,33
40,Fail,48,28,0,15,33
40,Fail,44,31,1,12,32
40,Success,57,17,0,11,46
40,Success,54,18,8,13,41
40,Fail,43,27,0,19,24
40,Success,54,23,0,12,42
40,Fail,48,25,0,12,36
40,Fail,44,34,0,12,32
40,Fail,45,29,3,11,34
40,Success,48,31,0,7,41
40,Fail,52,21,0,19,33
40,Fail,44,34,0,15,29
40,Fail,52,20,4,14,38
40,Success,51,29,0,6,45
40,Fail,44,34,0,11,33
40,Success,49,35,0,7,42
40,Fail,47,24,9,9,38
40,Fail,44,26,2,16,28
40,Fail,48,20,2,16,32
40,Success,56,22,0,12,44
40,Fail,50,25,1,12,38
40,Fail,39,37,0,12,27
40,Success,50,28,0,10,40
40,Fail,44,27,9,13,31
40,Fail,44,29,0,13,31
40,Fail,48,31,0,13,35
40,Fail,50,26,0,14,36
40,Success,53,25,0,10,43
40,Fail,51,23,1,16,35
40,Success,55,25,6,7,48
40,Fail,44,26,5,15,29
40,Fail,48,23,0,18,30
40,Success,49,34,0,7,42
40,Fail,47,28,0,13,34
40,Success,48,32,0,8,40
40,Fail,50,24,0,14,36
40,Fail,43,36,4,7,36
40,Fail,44,40,0,8,36
40,Fail,51,26,0,16,35
40,Fail,45,24,12,9,36
40,Success,53,30,0,6,47
40,Fail,48,24,2,11,37
40,Fail,51,26,0,13,38
40,Fail,48,29,1,11,37
40,Fail,44,19,6,17,27
40,Success,57,24,0,9,48
40,Fail,52,26,0,14,38
40,Fail,42,37,0,13,29
40,Success,57,24,2,2,55
40,Success,51,27,0,11,40
40,Fail,39,40,0,13,26
40,Fail,44,32,0,16,28
40,Fail,49,23,2,15,34
40,Fail,44,28,4,11,33
40,Fail,47,27,0,9,38
40,Fail,49,34,0,10,39
40,Fail,47,30,0,15,32
40,Fail,43,27,7,12,31
40,Fail,50,22,7,12,38
40,Fail,49,27,1,12,37
40,Fail,48,24,0,14,34
40,Success,54,29,0,7,47
40,Success,51,27,3,10,41
40,Success,53,21,2,13,40
40,Fail,50,25,3,12,38
40,Fail,46,25,6,14,32
40,Fail,47,30,0,14,33
40,Fail,49,26,0,14,35
40,Fail,49,24,0,10,39
40,Fail,43,39,0,11,32
40,Fail,42,29,2,14,28
40,Fail,53,24,0,14,39
40,Fail,48,32,0,13,35
40,Fail,49,30,0,11,38
40,Success,50,31,0,8,42
40,Fail,42,35,0,15,27
40,Success,55,24,0,10,45
40,Fail,46,35,4,8,38
40,Fail,48,33,0,11,37
40,Fail,47,32,0,11,36
40,Fail,47,30,1,10,37
40,Fail,48,26,5,13,35
40,Fail,44,20,7,18,26
40,Success,54,21,2,9,45
40,Fail,47,29,0,13,34
40,Fail,42,36,0,15,27
40,Fail,43,31,0,15,28
40,Success,54,23,0,11,43
40,Fail,50,26,6,13,37
40,Fail,48,26,1,13,35
40,Fail,47,29,0,11,36
40,Fail,46,34,0,11,35
40,Fail,44,24,10,16,28
40,Fail,46,21,7,18,28
40,Fail,47,26,0,17,30
40,Fail,43,35,0,13,30
40,Fail,39,36,0,15,24
40,Success,49,34,0,9,40
40,Fail,44,32,0,15,29
40,Fail,42,38,0,11,31
40,Fail,51,21,0,16,35
40,Success,53,25,4,10,43
40,Fail,45,33,0,11,34
40,Fail,41,39,0,13,28
40,Fail,46,34,0,10,36
40,Fail,47,28,0,13,34
40,Fail,45,29,5,11,34
40,Fail,49,24,4,11,38
40,Fail,45,26,6,11,34
40,Success,48,30,4,8,40
40,Fail,46,29,6,8,38
40,Fail,49,23,0,18,31
40,Fail,46,33,0,11,35
40,Fail,47,28,0,14,33
40,Fail,49,28,0,10,39
40,Success,53,21,3,13,40
40,Fail,43,34,0,12,31
40,Success,56,19,0,10,46
40,Success,57,24,0,10,47
40,Fail,42,32,9,11,31
40,Fail,48,30,0,14,34
40,Fail,49,25,0,13,36
40,Fail,42,33,3,11,31
40,Fail,50,26,0,14,36
40,Fail,52,18,0,13,39
40,Success,57,21,0,11,46
40,Success,57,27,0,7,50
40,Fail,49,26,1,12,37
40,Success,50,35,0,6,44
40,Fail,43,33,0,13,30
40,Fail,46,28,0,14,32
40,Success,51,30,0,9,42
40,Fail,42,33,3,10,32
40,Success,52,34,0,6,46
40,Fail,50,27,0,13,37
40,Fail,46,36,0,12,34
40,Fail,38,29,0,25,13
40,Fail,47,28,0,13,34
40,Success,54,17,7,12,42
40,Success,54,30,0,6,48
40,Fail,43,29,5,13,30
40,Fail,47,28,1,10,37
40,Fail,46,22,3,13,33
40,Fail,47,27,1,10,37
40,Success,52,21,7,12,40
40,Fail,47,24,4,16,31
40,Success,51,29,0,11,40
40,Fail,47,26,0,18,29
40,Success,55,22,3,9,46
40,Fail,45,24,3,17,28
40,Fail,45,32,0,10,35
40,Fail,47,27,3,15,32
40,Success,52,17,7,12,40
40,Fail,43,33,0,16,27
40,Fail,47,30,0,13,34
40,Fail,44,34,0,13,31
40,Success,56,17,1,16,40
40,Fail,47,30,0,14,33
40,Success,53,24,5,8,45
40,Fail,47,30,0,17,30
40,Fail,48,25,0,12,36
40,Success,55,25,0,12,43
40,Fail,52,26,0,13,39
40,Fail,43,29,4,16,27
40,Fail,49,31,0,10,39
40,Fail,46,23,2,19,27
40,Fail,44,27,1,15,29
40,Success,50,29,0,9,41
40,Success,55,26,0,7,48
40,Fail,44,29,0,15,29
40,Success,56,24,0,6,50
40,Fail,53,18,1,15,38
40,Fail,43,37,0,11,32
40,Fail,48,26,0,13,35
40,Success,51,28,2,11,40
40,Fail,49,19,8,15,34
40,Fail,49,28,0,12,37
40,Fail,53,24,0,16,37
40,Fail,46,31,0,13,33
40,Fail,46,30,0,12,34
40,Fail,49,25,8,13,36
40,Fail,45,27,8,10,35
40,Fail,45,29,0,18,27
40,Fail,46,25,0,20,26
40,Fail,47,22,1,18,29
40,Fail,46,24,9,12,34
40,Success,53,28,0,9,44
40,Success,51,29,0,7,44
40,Success,55,23,0,10,45
40,Success,55,23,4,7,48
40,Fail,46,30,0,15,31
40,Fail,41,31,11,9,32
40,Fail,51,25,0,13,38
40,Fail,47,21,13,10,37
40,Success,51,24,0,9,42
40,Fail,47,26,0,11,36
40,Fail,37,34,8,14,23
40,Fail,51,23,0,12,39
40,Fail,53,16,5,16,37
40,Fail,45,25,0,13,32
40,Fail,46,29,6,11,35
40,Fail,47,31,0,11,36
40,Fail,47,26,2,16,31
40,Fail,51,21,6,12,39
40,Success,50,30,0,10,40
40,Success,52,26,0,12,40
40,Fail,49,35,0,11,38
40,Success,52,23,0,11,41
40,Success,54,23,0,12,42
40,Fail,40,29,11,14,26
40,Fail,53,17,0,18,35
40,Fail,46,31,0,8,38
40,Fail,46,30,0,14,32
40,Success,54,21,2,8,46
40,Fail,47,31,0,15,32
40,Fail,50,23,0,12,38
40,Fail,45,31,3,11,34
40,Fail,48,24,3,15,33
40,Fail,39,27,3,16,23
40,Success,54,31,0,5,49
40,Fail,50,25,1,11,39
40,Fail,51,22,1,14,37
40,Fail,48,29,0,13,35
40,Success,57,18,7,8,49
40,Fail,39,33,0,18,21
40,Success,47,31,3,7,40
40,Fail,49,24,3,10,39
40,Fail,46,31,0,13,33
40,Success,57,22,0,9,48
40,Fail,49,20,9,12,37
40,Fail,46,23,3,14,32
40,Fail,47,25,7,15,32
40,Fail,52,27,0,13,39
40,Fail,46,28,11,10,36
40,Success,49,29,0,8,41
40,Fail,45,28,2,10,35
40,Fail,49,23,0,18,31
40,Success,55,18,4,11,44
40,Fail,48,26,0,14,34
40,Fail,48,26,0,15,33
40,Fail,48,29,0,15,33
40,Fail,44,27,7,11,33
40,Success,50,28,1,9,41
40,Success,58,19,0,7,51
40,Fail,45,28,3,13,32
40,Fail,49,25,6,10,39
40,Fail,39,40,0,14,25
40,Fail,42,32,0,20,22
40,Fail,48,20,4,17,31
40,Fail,38,24,15,15,23
40,Success,49,31,4,8,41
40,Fail,44,29,0,18,26
40,Fail,45,28,10,13,32
40,Fail,44,28,12,9,35
40,Fail,48,23,1,16,32
40,Fail,43,29,10,10,33
40,Fail,48,20,0,15,33
40,Fail,46,30,4,9,37
40,Fail,47,26,1,14,33
40,Success,55,24,0,8,47
40,Fail,39,26,7,16,23
40,Fail,47,22,4,17,30
40,Fail,50,30,0,12,38
40,Fail,43,34,0,11,32
40,Success,47,36,0,6,41
40,Fail,47,31,0,12,35
40,Success,51,21,7,9,42
40,Fail,48,24,5,13,35
40,Fail,47,24,6,12,35
40,Fail,40,42,0,14,26
40,Fail,50,25,0,17,33
40,Fail,39,30,0,20,19
40,Fail,50,19,7,15,35
40,Fail,47,32,0,11,36
40,Fail,46,25,4,15,31
40,Fail,46,33,0,10,36
40,Success,55,26,0,8,47
40,Fail,48,29,0,11,37
40,Success,64,16,4,8,56
40,Success,54,26,1,10,44
40,Fail,46,22,5,19,27
40,Fail,47,28,0,14,33
40,Success,55,24,0,13,42
40,Fail,47,28,0,15,32
40,Fail,45,34,3,9,36
40,Fail,41,32,3,17,24
40,Fail,46,32,0,8,38
40,Fail,44,28,7,14,30
40,Success,51,29,1,7,44
40,Fail,42,29,2,15,27
40,Fail,45,24,11,13,32
40,Fail,51,20,2,12,39
40,Success,54,23,2,8,46
40,Fail,46,33,0,13,33
40,Fail,41,41,0,11,30
40,Fail,49,30,0,11,38
40,Fail,43,33,0,15,28
40,Success,51,23,0,10,41
40,Fail,46,30,0,14,32
40,Fail,46,27,4,11,35
40,Fail,48,33,0,12,36
40,Fail,35,32,6,19,16
40,Fail,48,27,0,15,33
40,Fail,43,33,0,15,28
40,Fail,49,26,0,13,36
40,Fail,46,39,0,8,38
40,Fail,39,38,0,10,29
40,Fail,44,30,4,11,33
40,Fail,46,28,0,15,31
40,Fail,47,24,0,16,31
40,Fail,37,31,0,21,16
40,Fail,45,31,0,13,32
40,Fail,47,36,0,9,38
40,Fail,46,26,0,14,32
40,Fail,45,32,0,12,33
40,Fail,47,27,0,16,31
40,Fail,52,25,0,14,38
40,Fail,45,23,0,20,25
40,Fail,48,23,0,12,36
40,Fail,45,32,0,15,30
40,Fail,52,23,2,13,39
40,Fail,48,31,0,16,32
40,Success,54,21,3,11,43
40,Success,55,19,7,9,46
40,Fail,43,31,0,18,25
40,Fail,46,29,1,14,32
40,Success,53,24,2,9,44
40,Success,50,23,4,10,40
40,Fail,39,40,0,16,23
40,Fail,46,37,0,12,34
40,Fail,51,20,0,16,35
40,Fail,43,34,5,11,32
40,Success,51,28,2,9,42
40,Success,51,31,0,11,40
40,Fail,45,27,7,17,28
40,Success,51,24,3,10,41
40,Fail,42,30,0,12,30
40,Success,49,26,1,9,40
40,Fail,44,28,0,14,30
40,Fail,41,30,0,16,25
40,Success,53,26,0,13,40
40,Success,57,24,0,7,50
40,Fail,49,30,0,11,38
40,Fail,51,29,0,13,38
40,Fail,41,25,6,19,22
40,Fail,43,30,3,12,31
40,Success,50,29,5,7,43
40,Fail,44,40,0,8,36
40,Success,51,32,0,10,41
40,Fail,47,28,7,12,35
40,Fail,48,27,0,12,36
40,Success,52,24,0,11,41
40,Fail,48,16,14,12,36
40,Success,51,26,1,10,41
40,Fail,48,33,0,10,38
40,Fail,48,28,0,15,33
40,Fail,45,29,7,7,38
40,Fail,46,25,4,13,33
40,Fail,44,25,2,13,31
40,Success,51,27,0,10,41
40,Fail,49,27,1,16,33
40,Fail,49,30,0,11,38
40,Fail,43,26,9,13,30
40,Success,51,20,5,10,41
40,Fail,51,19,0,19,32
40,Fail,49,31,0,11,38
40,Success,55,25,4,7,48
40,Success,48,28,7,8,40
40,Fail,45,21,2,19,26
40,Fail,44,23,4,17,27
40,Fail,44,29,2,16,28
40,Success,52,29,0,8,44
40,Fail,42,29,0,16,26
40,Fail,39,27,7,19,20
40,Fail,43,31,0,14,29
40,Success,49,29,0,9,40
40,Fail,43,40,0,7,36
40,Fail,44,36,0,11,33
40,Fail,41,36,0,17,24
40,Fail,47,31,0,9,38
40,Fail,49,26,0,16,33
40,Success,49,30,4,4,45
40,Fail,42,36,0,14,28
40,Fail,50,22,6,14,36
40,Fail,47,28,6,9,38
40,Fail,44,26,0,11,33
40,Success,55,16,3,14,41
40,Success,51,30,0,7,44
40,Fail,49,24,0,13,36
40,Fail,44,31,0,15,29
40,Fail,49,24,5,11,38
40,Fail,52,27,0,13,39
40,Fail,47,20,1,16,31
40,Success,54,24,2,12,42
40,Success,53,23,0,13,40
40,Fail,49,29,0,15,34
40,Success,54,21,0,14,40
40,Fail,49,24,4,11,38
40,Success,55,19,0,13,42
40,Fail,46,24,11,14,32
40,Fail,38,27,8,18,20
40,Success,52,29,0,7,45
40,Success,52,28,5,8,44
40,Fail,46,29,7,12,34
40,Fail,46,36,0,12,34
40,Fail,44,26,4,13,31
40,Fail,36,26,6,27,9
40,Fail,42,24,10,12,30
40,Fail,43,29,2,12,31
40,Fail,50,29,0,14,36
40,Fail,47,27,2,13,34
40,Fail,54,16,0,16,38
40,Fail,44,29,5,15,29
40,Fail,47,25,3,11,36
40,Success,53,24,0,10,43
40,Success,65,17,0,9,56
40,Success,55,20,0,13,42
40,Fail,42,40,0,12,30
40,Fail,48,25,0,17,31
40,Fail,42,21,1,26,16
40,Success,49,36,0,7,42
40,Fail,44,25,5,13,31
40,Fail,47,32,0,11,36
40,Success,53,24,3,10,43
40,Fail,53,21,0,16,37
40,Fail,49,18,8,15,34
40,Fail,51,27,0,12,39
40,Fail,48,26,0,14,34
40,Success,55,24,0,11,44
40,Success,54,23,0,10,44
40,Fail,55,12,1,18,37
40,Fail,48,23,1,14,34
40,Fail,46,25,2,11,35
40,Fail,49,28,0,12,37
40,Fail,46,25,1,17,29
40,Fail,51,20,7,12,39
40,Fail,42,26,0,19,23
40,Fail,43,30,2,13,30
40,Fail,45,27,5,14,31
40,Fail,39,38,0,17,22
40,Success,53,24,2,10,43
40,Fail,48,27,0,9,39
40,Fail,47,36,0,8,39
40,Fail,43,24,4,17,26
40,Success,54,19,0,14,40
40,Fail,47,30,0,12,35
40,Fail,49,28,0,14,35
40,Fail,46,22,0,16,30
40,Fail,49,28,0,14,35
40,Fail,46,31,0,13,33
40,Fail,42,25,6,17,25
40,Success,53,23,0,11,42
40,Fail,51,22,3,17,34
40,Success,55,25,1,12,43
40,Fail,46,25,5,14,32
40,Success,51,27,0,11,40
40,Fail,44,39,0,8,36
40,Fail,48,24,6,16,32
40,Fail,49,27,0,10,39
40,Fail,44,29,1,14,30
40,Fail,45,32,0,13,32
40,Fail,43,30,4,11,32
40,Fail,39,34,2,12,27
40,Fail,44,29,4,7,37
40,Fail,48,28,0,16,32
40,Fail,46,25,5,12,34
40,Success,52,22,1,10,42
40,Success,52,23,1,12,40
40,Fail,42,34,0,11,31
40,Fail,44,32,0,16,28
40,Fail,42,36,4,8,34
40,Fail,47,24,0,16,31
40,Fail,50,21,8,15,35
40,Fail,46,27,0,17,29
40,Success,59,21,3,8,51
40,Fail,47,34,0,14,33
40,Fail,46,30,5,10,36
40,Fail,42,30,0,15,27
40,Success,51,21,1,10,41
40,Fail,51,19,0,16,35
40,Fail,46,35,0,12,34
40,Fail,48,24,0,16,32
40,Fail,48,22,0,16,32
40,Fail,44,31,5,15,29
40,Fail,52,24,0,14,38
40,Fail,50,25,0,14,36
40,Success,58,18,5,9,49
40,Fail,36,43,0,12,24
40,Fail,50,28,0,11,39
40,Fail,48,24,2,14,34
40,Fail,47,25,5,15,32
40,Fail,47,35,0,12,35
40,Fail,42,29,0,16,26
40,Success,59,17,0,15,44
40,Success,52,24,0,12,40
40,Success,54,24,0,12,42
40,Fail,48,27,0,13,35
40,Success,53,24,0,13,40
40,Success,50,26,6,10,40
40,Success,57,20,2,11,46
40,Fail,48,25,0,16,32
40,Fail,45,26,5,13,32
40,Fail,47,36,0,8,39
40,Fail,48,27,0,12,36
40,Fail,45,32,0,16,29
40,Success,55,21,0,11,44
40,Fail,49,20,4,15,34
40,Success,52,20,3,11,41
40,Fail,48,23,4,14,34
40,Fail,48,24,1,11,37
40,Fail,46,25,5,14,32
40,Success,52,23,1,12,40
40,Success,51,32,0,11,40
40,Fail,47,29,0,11,36
40,Fail,43,25,2,16,27
40,Fail,46,32,1,12,34
40,Success,58,23,0,7,51
40,Fail,51,19,0,17,34
40,Fail,48,19,2,15,33
40,Fail,46,36,0,10,36
40,Fail,42,25,8,15,27
40,Success,50,28,3,10,40
40,Fail,48,23,5,14,34
40,Success,54,27,3,10,44
40,Fail,49,29,0,11,38
40,Success,52,28,2,7,45
40,Success,51,25,0,10,41
40,Fail,43,35,0,16,27
40,Fail,53,22,0,14,39
40,Fail,48,17,6,21,27
40,Fail,47,22,7,9,38
40,Fail,45,26,6,14,31
40,Success,52,27,0,9,43
40,Success,49,29,0,9,40
40,Success,52,25,6,6,46
40,Success,52,25,2,8,44
40,Fail,47,28,0,16,31
40,Fail,41,33,0,13,28
40,Success,52,23,4,9,43
40,Fail,44,26,0,17,27
40,Fail,46,35,0,11,35
40,Success,54,27,0,9,45
40,Success,55,15,0,12,43
40,Success,51,24,5,10,41
40,Fail,44,38,0,10,34
40,Success,53,22,0,13,40
40,Fail,48,31,0,12,36
40,Fail,48,32,0,9,39
40,Success,52,29,1,7,45
40,Fail,44,29,8,13,31
40,Fail,36,26,8,18,18
40,Fail,51,26,0,13,38
40,Success,52,21,6,10,42
40,Fail,46,31,3,11,35
40,Success,53,31,0,10,43
40,Fail,48,25,0,17,31
40,Fail,40,40,0,13,27
40,Fail,50,24,4,12,38
40,Fail,42,31,1,15,27
40,Fail,45,28,0,18,27
40,Success,51,23,7,11,40
40,Fail,49,21,5,13,36
40,Fail,47,26,2,9,38
40,Success,52,25,0,9,43
40,Fail,40,39,0,11,29
40,Fail,46,28,3,11,35
40,Fail,44,28,0,12,32
40,Fail,42,29,0,19,23
40,Fail,37,39,0,15,22
40,Fail,49,27,1,10,39
40,Fail,48,29,3,10,38
40,Fail,48,24,6,15,33
40,Fail,51,21,2,17,34
40,Fail,47,22,9,13,34
40,Fail,40,33,0,15,25
40,Fail,50,25,0,16,34
40,Fail,42,35,0,12,30
40,Success,52,21,0,12,40
40,Success,58,16,3,10,48
40,Success,53,29,0,10,43
40,Fail,47,20,1,19,28
40,Fail,52,22,0,15,37
40,Success,53,23,0,12,41
40,Fail,51,15,3,16,35
40,Success,53,28,0,12,41
40,Fail,44,29,6,10,34
40,Success,53,16,6,13,40
40,Fail,46,31,0,17,29
40,Fail,44,31,1,10,34
40,Fail,48,24,5,13,35
40,Fail,46,23,3,16,30
40,Fail,35,32,9,17,18
40,Fail,52,22,3,14,38
40,Success,53,26,0,8,45
40,Fail,49,25,4,11,38
40,Fail,53,21,0,16,37
40,Fail,48,25,2,11,37
40,Fail,49,27,0,15,34
40,Fail,47,26,0,16,31
40,Fail,44,34,0,12,32
40,Fail,49,24,0,15,34
40,Fail,49,24,2,14,35
40,Fail,49,21,2,16,33
40,Fail,50,20,2,16,34
40,Fail,52,20,0,15,37
40,Fail,48,27,8,11,37
40,Fail,44,30,1,14,30
40,Success,50,27,0,8,42
40,Fail,46,31,0,8,38
40,Fail,48,25,3,12,36
40,Fail,43,26,0,17,26
40,Success,53,28,0,8,45
40,Fail,47,38,0,9,38
40,Success,52,30,0,6,46
40,Fail,47,23,0,19,28
40,Fail,49,20,2,15,34
40,Fail,47,30,0,10,37
40,Fail,41,33,0,18,23
40,Fail,42,34,0,14,28
40,Fail,41,28,6,14,27
40,Fail,47,26,0,17,30
40,Fail,43,28,4,13,30
40,Success,53,22,3,11,42
40,Success,57,20,0,10,47
40,Success,50,26,3,10,40
40,Success,52,30,0,8,44
40,Success,50,31,0,9,41
40,Fail,40,35,0,18,22
40,Fail,47,27,0,12,35
40,Success,54,20,0,14,40
40,Fail,47,20,3,17,30
40,Fail,47,28,0,16,31
40,Fail,44,34,0,13,31
40,Success,54,25,0,11,43
40,Fail,47,29,1,14,33
40,Success,55,22,0,10,45
40,Fail,47,33,0,14,33
40,Fail,45,31,0,16,29
40,Success,52,29,0,11,41
40,Fail,45,28,4,15,30
40,Success,50,29,0,8,42
40,Fail,52,19,2,13,39
40,Fail,39,24,9,17,22
40,Fail,48,26,1,14,34
40,Success,54,22,1,11,43
40,Fail,49,24,7,10,39
40,Fail,46,26,3,17,29
40,Fail,49,28,0,14,35
40,Fail,46,25,7,13,33
40,Fail,47,33,0,14,33
40,Fail,49,29,0,12,37
40,Fail,53,19,2,14,39
40,Success,53,27,6,8,45
40,Fail,50,23,3,12,38
40,Fail,42,33,0,12,30
40,Success,55,26,3,4,51
40,Fail,40,34,0,15,25
40,Fail,46,28,0,12,34
40,Fail,42,30,0,17,25
40,Fail,45,27,7,10,35
40,Fail,40,45,0,9,31
40,Fail,41,30,4,19,22
40,Success,51,26,0,10,41
40,Fail,48,29,1,13,35
40,Fail,49,22,0,18,31
40,Fail,45,30,5,12,33
40,Fail,37,43,0,13,24
40,Fail,44,31,0,16,28
40,Fail,48,26,2,11,37
40,Fail,47,29,3,10,37
40,Success,53,19,3,11,42
40,Fail,52,20,0,18,34
40,Fail,48,27,0,13,35
40,Success,53,24,2,9,44
40,Success,50,25,5,10,40
40,Fail,43,38,0,13,30
40,Fail,45,24,6,14,31
40,Fail,46,29,1,14,32
40,Fail,40,32,0,18,22
40,Fail,51,25,0,15,36
40,Fail,51,25,2,12,39
40,Fail,48,24,2,13,35
40,Fail,45,26,7,12,33
40,Success,51,26,0,9,42
40,Fail,49,31,0,11,38
40,Fail,36,44,0,12,24
40,Fail,47,26,4,13,34
40,Fail,46,38,0,7,39
40,Success,52,27,0,5,47
40,Fail,40,34,6,13,27
40,Fail,49,23,0,18,31
40,Fail,49,22,4,12,37
40,Fail,47,24,1,12,35
40,Success,56,16,1,13,43
40,Fail,41,30,5,13,28
40,Success,51,27,1,3,48
40,Fail,42,33,3,13,29
40,Success,58,24,0,5,53
40,Fail,43,38,0,9,34
40,Fail,53,12,3,17,36
40,Fail,48,26,0,15,33
40,Fail,44,32,0,19,25
40,Success,51,25,0,9,42
40,Fail,46,26,2,13,33
40,Success,61,18,0,7,54
40,Fail,47,31,5,9,38
40,Success,52,21,0,11,41
40,Fail,48,27,0,15,33
40,Success,54,28,0,8,46
40,Fail,48,25,1,16,32
40,Success,54,30,0,6,48
40,Success,54,24,0,13,41
40,Fail,48,17,10,13,35
40,Fail,51,24,2,12,39
40,Success,53,24,0,11,42
40,Success,54,17,9,12,42
40,Fail,48,26,3,14,34
40,Success,52,20,7,12,40
40,Fail,44,26,9,10,34
40,Success,51,26,1,9,42
40,Fail,45,33,0,14,31
40,Fail,46,26,0,14,32
40,Fail,50,27,0,13,37
40,Fail,47,31,0,11,36
40,Fail,48,25,0,14,34
40,Fail,40,24,13,16,24
40,Success,53,26,0,10,43
40,Success,52,27,0,8,44
40,Success,57,22,0,12,45
40,Fail,47,26,0,15,32
40,Fail,43,29,0,16,27
40,Success,56,29,0,8,48
40,Success,51,29,1,9,42
40,Fail,42,32,0,17,25
40,Success,54,25,0,8,46
40,Fail,47,28,0,15,32
40,Success,55,26,0,10,45
40,Fail,45,35,0,14,31
40,Fail,44,27,3,18,26
40,Fail,51,25,0,12,39
40,Fail,50,27,0,12,38
40,Fail,45,25,1,13,32
40,Fail,52,21,4,15,37
40,Success,50,33,0,5,45
40,Fail,51,23,2,15,36
40,Fail,48,27,7,11,37
40,Fail,44,36,0,10,34
40,Success,50,32,0,10,40
40,Success,56,22,4,6,50
40,Success,54,24,0,12,42
40,Fail,47,25,1,12,35
40,Fail,46,30,0,13,33
40,Fail,40,31,0,20,20
40,Fail,47,34,0,11,36
40,Fail,50,18,0,19,31
40,Success,51,26,0,8,43
40,Fail,43,35,0,15,28
40,Fail,45,34,0,10,35
40,Fail,40,41,0,13,27
40,Fail,43,30,5,10,33
40,Fail,51,20,3,12,39
40,Fail,43,32,4,14,29
40,Success,54,17,6,13,41
40,Success,53,25,8,10,43
40,Success,52,28,0,11,41
40,Fail,40,33,0,18,22
40,Fail,48,24,3,14,34
40,Fail,45,26,3,12,33
40,Fail,53,20,0,15,38
40,Success,53,25,5,7,46
40,Fail,47,39,0,9,38
40,Fail,47,27,7,9,38
40,Fail,45,30,0,15,30
40,Fail,44,27,8,15,29
40,Fail,51,25,3,15,36
40,Success,53,24,0,10,43
40,Success,54,23,0,9,45
40,Fail,47,29,0,9,38
40,Fail,49,34,0,10,39
40,Fail,52,19,5,14,38
40,Success,48,34,0,8,40
40,Fail,48,24,1,16,32
40,Success,49,26,3,8,41
40,Success,52,27,2,10,42
40,Fail,47,38,0,8,39
40,Fail,44,27,6,12,32
40,Fail,49,23,0,15,34
40,Fail,44,31,0,13,31
40,Success,49,35,0,8,41
40,Fail,48,20,0,20,28
40,Fail,46,35,0,11,35
40,Fail,46,30,1,12,34
40,Success,51,28,0,10,41
40,Fail,48,19,5,14,34
40,Fail,48,27,2,14,34
40,Success,55,26,0,8,47
40,Fail,46,31,0,12,34
40,Fail,49,26,0,11,38
40,Fail,52,16,2,16,36
40,Fail,42,28,4,19,23
40,Fail,51,25,0,13,38
40,Success,49,32,0,8,41
40,Fail,51,22,0,12,39
40,Fail,48,26,0,14,34
40,Fail,46,25,4,13,33
40,Success,58,22,0,10,48
40,Fail,46,31,0,14,32
40,Fail,41,32,5,14,27
40,Success,51,30,0,8,43
40,Success,51,31,0,9,42
40,Success,56,22,0,6,50
40,Fail,47,29,0,12,35
40,Fail,46,31,0,12,34
40,Fail,42,21,4,17,25
40,Fail,51,22,0,15,36
40,Fail,52,25,0,13,39
40,Success,56,23,0,14,42
40,Success,56,29,4,7,49
40,Fail,43,27,9,11,32
40,Fail,49,33,0,12,37
40,Success,52,26,0,10,42
40,Fail,39,41,0,9,30
40,Fail,48,21,2,17,31
40,Fail,39,33,3,15,24
40,Success,53,16,0,13,40
40,Success,51,26,1,10,41
40,Success,50,26,2,9,41
40,Fail,49,24,1,12,37
40,Fail,50,25,0,14,36
40,Fail,46,35,0,7,39
40,Fail,44,28,1,16,28
40,Success,53,25,0,11,42
40,Fail,48,30,0,12,36
40,Fail,44,33,0,14,30
40,Fail,43,41,0,11,32
40,Success,59,18,0,9,50
40,Fail,51,26,0,13,38
40,Fail,47,22,0,17,30
40,Fail,50,24,1,13,37
40,Fail,46,32,0,14,32
40,Success,53,27,1,11,42
40,Fail,49,27,0,13,36
40,Fail,46,24,0,18,28
40,Success,56,21,2,11,45
40,Fail,47,29,0,14,33
40,Fail,43,34,1,12,31
40,Fail,38,29,11,15,23
40,Success,55,21,1,11,44
40,Fail,47,31,0,9,38
40,Fail,47,31,0,10,37
40,Fail,44,36,0,10,34
40,Success,51,26,1,7,44
40,Fail,43,27,5,18,25
40,Fail,49,27,5,12,37
40,Fail,48,28,2,11,37
40,Fail,50,22,0,18,32
40,Success,59,20,0,9,50
40,Success,54,26,5,6,48
40,Fail,48,29,0,12,36
40,Fail,46,29,2,11,35
40,Fail,47,22,5,19,28
40,Fail,51,17,2,16,35
40,Fail,52,19,4,14,38
40,Fail,45,34,0,11,34
40,Fail,47,27,3,15,32
40,Fail,48,26,6,13,35
40,Fail,48,29,0,16,32
40,Fail,49,34,0,10,39
40,Success,52,25,1,8,44
40,Fail,41,33,3,16,25
40,Success,50,26,5,10,40
40,Fail,39,31,7,14,25
40,Fail,47,26,0,16,31
40,Fail,53,18,0,17,36
40,Success,55,18,7,12,43
40,Fail,44,27,11,9,35
40,Fail,45,23,3,17,28
40,Success,52,30,1,9,43
40,Fail,48,28,5,10,38
40,Fail,45,33,0,8,37
40,Fail,43,27,0,16,27
40,Fail,49,25,2,14,35
40,Success,53,28,0,9,44
40,Fail,48,27,3,12,36
40,Success,56,19,10,7,49
40,Fail,32,48,0,13,19
40,Success,49,30,1,9,40
40,Fail,52,21,5,13,39
40,Fail,48,27,0,17,31
40,Fail,47,28,10,8,39
40,Fail,45,28,1,15,30
40,Fail,44,39,0,10,34
40,Fail,44,31,2,13,31
40,Fail,36,34,0,17,19
40,Success,52,29,0,11,41
40,Fail,46,30,0,12,34
40,Fail,43,32,0,14,29
40,Fail,47,21,7,15,32
40,Fail,52,18,3,16,36
40,Fail,44,41,0,12,32
40,Fail,45,34,0,11,34
40,Fail,47,28,3,12,35
40,Success,49,28,3,7,42
40,Fail,44,30,7,8,36
40,Fail,50,21,4,12,38
40,Success,51,27,4,8,43
40,Fail,43,27,0,13,30
40,Fail,44,29,3,15,29
40,Fail,46,31,0,14,32
40,Fail,51,20,3,14,37
40,Success,51,33,0,11,40
40,Fail,47,28,6,14,33
40,Fail,46,26,12,11,35
40,Fail,53,23,0,15,38
40,Fail,42,34,0,13,29
40,Fail,51,25,0,12,39
40,Fail,50,27,0,12,38
40,Success,55,21,0,13,42
40,Fail,42,31,4,13,29
40,Fail,44,34,0,12,32
40,Fail,43,25,7,14,29
40,Fail,49,28,2,10,39
40,Fail,50,17,6,14,36
40,Fail,45,27,0,18,27
40,Fail,52,22,0,16,36
40,Fail,43,35,4,10,33
40,Fail,46,23,0,14,32
40,Fail,46,29,0,14,32
40,Fail,43,27,12,14,29
40,Fail,43,34,0,9,34
40,Fail,43,32,0,15,28
40,Fail,44,32,2,13,31
40,Fail,50,23,1,15,35
40,Fail,49,23,6,13,36
40,Success,58,20,0,7,51
40,Success,56,28,0,9,47
40,Fail,51,23,0,13,38
40,Fail,44,29,0,15,29
40,Success,51,25,3,11,40
40,Fail,49,22,4,17,32
40,Success,53,26,3,5,48
40,Fail,51,28,0,15,36
40,Fail,46,29,1,13,33
40,Fail,49,26,0,12,37
40,Fail,34,36,2,16,18
40,Fail,43,24,2,19,24
40,Success,49,23,4,9,40
40,Fail,51,20,4,15,36
40,Fail,46,33,0,11,35
40,Fail,44,39,0,9,35
40,Success,50,34,0,6,44
40,Fail,52,23,1,13,39
40,Fail,48,29,0,13,35
40,Fail,46,37,0,13,33
40,Success,61,22,0,9,52
40,Fail,53,20,3,15,38
40,Fail,46,27,0,15,31
40,Success,53,25,0,13,40
40,Fail,43,36,0,14,29
40,Fail,46,24,1,15,31
40,Fail,52,22,0,13,39
40,Fail,44,33,0,14,30
40,Fail,48,32,0,9,39
40,Success,54,31,0,7,47
40,Fail,34,35,0,20,14
40,Fail,49,21,8,14,35
40,Success,52,23,0,12,40
40,Success,48,30,2,8,40
40,Fail,51,17,0,20,31
40,Fail,49,29,2,10,39
40,Fail,51,18,1,14,37
40,Success,48,35,0,7,41
40,Fail,49,26,0,12,37
40,Fail,44,32,4,10,34
40,Fail,45,36,0,7,38
40,Fail,50,29,0,13,37
40,Success,47,35,0,4,43
40,Fail,49,25,4,12,37
40,Fail,44,29,9,11,33
40,Fail,48,27,1,12,36
40,Fail,47,29,0,10,37
40,Fail,45,35,0,14,31
40,Fail,53,18,0,14,39
40,Success,55,23,0,12,43
40,Fail,43,35,0,14,29
40,Fail,44,26,1,16,28
40,Fail,49,27,0,15,34
40,Fail,45,23,3,14,31
40,Success,50,31,0,8,42
40,Fail,45,28,0,15,30
40,Fail,46,25,13,11,35
40,Success,51,24,2,9,42
40,Fail,50,23,0,18,32
40,Fail,46,20,5,19,27
40,Fail,43,26,6,12,31
40,Fail,52,19,2,17,35
40,Fail,46,26,4,12,34
40,Fail,45,27,0,16,29
40,Success,53,25,0,11,42
40,Fail,45,23,6,14,31
40,Success,51,26,0,9,42
40,Fail,49,24,0,16,33
40,Success,54,24,0,9,45
40,Fail,50,32,0,11,39
40,Fail,36,36,0,20,16
40,Fail,45,33,0,12,33
40,Fail,55,17,2,17,38
40,Fail,51,22,0,15,36
40,Success,54,28,0,11,43
40,Fail,50,21,8,13,37
40,Fail,49,26,0,13,36
40,Fail,46,25,11,12,34
40,Fail,38,48,0,9,29
40,Success,49,28,0,9,40
40,Fail,45,30,4,11,34
40,Success,53,22,7,9,44
40,Fail,49,27,0,13,36
40,Fail,49,27,0,17,32
40,Fail,47,33,0,10,37
40,Fail,38,27,11,14,24
40,Fail,46,24,4,14,32
40,Fail,48,25,0,12,36
40,Success,53,32,0,7,46
40,Success,61,17,0,11,50
40,Success,53,23,0,12,41
40,Fail,46,30,0,14,32
40,Fail,42,30,0,16,26
40,Fail,51,28,0,12,39
40,Fail,45,27,4,14,31
40,Fail,48,26,2,13,35
40,Fail,43,30,1,16,27
40,Fail,47,31,0,12,35
40,Fail,47,26,2,12,35
40,Success,50,31,0,8,42
40,Fail,50,17,8,16,34
40,Fail,42,30,9,13,29
40,Fail,47,23,0,19,28
40,Fail,50,23,4,13,37
40,Fail,45,39,0,9,36
40,Fail,50,30,0,15,35
40,Success,52,24,0,12,40
40,Fail,48,22,10,13,35
40,Success,52,21,7,8,44
40,Fail,38,31,13,12,26
40,Fail,45,29,9,8,37
40,Fail,43,31,0,13,30
40,Fail,45,29,2,12,33
40,Fail,51,20,0,14,37
40,Success,59,16,7,10,49
40,Fail,44,34,0,9,35
40,Fail,44,34,0,8,36
40,Success,50,24,1,10,40
40,Success,51,28,9,7,44
40,Fail,47,33,0,9,38
40,Success,56,21,2,10,46
40,Success,55,17,4,11,44
40,Success,48,32,0,8,40
40,Success,53,23,0,12,41
40,Fail,46,24,4,14,32
40,Fail,41,33,0,17,24
40,Success,55,17,0,12,43
40,Fail,47,29,0,16,31
40,Fail,44,27,3,18,26
40,Fail,43,28,0,19,24
40,Fail,50,22,3,16,34
40,Success,54,28,0,7,47
40,Fail,47,27,6,15,32
40,Success,51,25,0,10,41
40,Fail,45,23,11,10,35
40,Success,52,34,1,3,49
40,Fail,46,31,0,14,32
40,Success,48,32,3,7,41
40,Success,50,27,3,8,42
40,Fail,45,31,0,11,34
40,Fail,52,22,0,17,35
40,Fail,43,24,5,17,26
40,Fail,37,28,10,19,18
40,Fail,46,24,2,13,33
40,Success,49,29,2,8,41
40,Success,53,22,3,11,42
40,Fail,48,29,6,10,38
40,Success,55,25,3,9,46
40,Fail,43,25,12,13,30
40,Fail,44,23,7,17,27
40,Fail,48,25,0,15,33
40,Fail,49,24,0,14,35
40,Fail,51,19,1,12,39
40,Success,56,23,0,9,47
40,Fail,50,26,0,13,37
40,Success,50,27,4,10,40
40,Fail,47,30,0,10,37
40,Fail,48,25,0,14,34
40,Success,50,21,12,9,41
40,Fail,50,25,0,11,39
40,Fail,42,28,2,17,25
40,Fail,45,24,8,14,31
40,Success,57,29,0,7,50
40,Fail,53,22,0,14,39
40,Success,54,23,4,10,44
40,Fail,52,24,1,13,39
40,Fail,47,32,0,8,39
40,Fail,47,31,0,8,39
40,Fail,49,22,2,15,34
40,Success,55,26,1,8,47
40,Fail,43,28,2,13,30
40,Fail,45,28,0,18,27
40,Fail,43,32,0,17,26
40,Success,54,21,0,13,41
40,Fail,48,27,7,12,36
40,Fail,47,26,0,16,31
40,Fail,47,25,2,12,35
40,Fail,46,24,3,17,29
40,Fail,49,27,0,12,37
40,Fail,49,23,3,15,34
40,Success,52,28,2,11,41
40,Fail,42,36,0,9,33
40,Success,55,26,4,4,51
40,Fail,47,25,3,13,34
40,Fail,51,21,0,15,36
40,Fail,48,24,0,13,35
40,Fail,45,35,0,11,34
40,Fail,40,23,13,14,26
40,Success,57,18,6,10,47
40,Success,52,29,0,9,43
40,Fail,51,22,2,14,37
40,Fail,46,32,3,11,35
40,Fail,47,31,0,14,33
40,Fail,53,22,0,14,39
40,Fail,45,27,0,14,31
40,Fail,41,34,0,13,28
40,Fail,48,28,0,13,35
40,Fail,53,26,0,14,39
40,Success,51,28,0,8,43
40,Fail,39,37,7,11,28
40,Fail,43,28,0,18,25
40,Fail,49,26,0,18,31
40,Fail,46,31,3,11,35
40,Success,54,28,0,7,47
40,Fail,50,26,0,12,38
40,Fail,52,20,0,15,37
40,Fail,46,28,0,16,30
40,Success,52,28,0,9,43
40,Fail,50,21,0,17,33
40,Fail,43,28,10,7,36
40,Fail,43,29,11,10,33
40,Fail,44,28,0,18,26
40,Fail,49,31,0,10,39
40,Fail,50,26,0,12,38
40,Fail,40,39,0,13,27
40,Fail,42,40,0,10,32
40,Success,51,31,0,10,41
40,Success,53,25,2,8,45
40,Fail,50,20,3,18,32
40,Success,56,22,0,13,43
40,Fail,47,26,2,13,34
40,Fail,47,30,0,15,32
40,Fail,49,23,8,11,38
40,Fail,49,30,0,10,39
40,Fail,46,27,0,15,31
40,Success,54,23,4,6,48
40,Fail,44,29,6,13,31
40,Fail,52,25,0,13,39
40,Fail,44,35,0,11,33
40,Success,54,29,0,8,46
40,Fail,51,26,2,12,39
40,Fail,49,26,0,15,34
40,Success,53,24,0,11,42
40,Fail,44,28,6,10,34
40,Fail,44,30,1,15,29
40,Success,49,34,0,8,41
40,Fail,48,24,1,12,36
40,Fail,47,25,5,14,33
40,Fail,49,29,0,14,35
40,Fail,47,29,0,12,35
40,Success,51,26,2,10,41
40,Fail,47,32,0,10,37
40,Fail,39,26,14,14,25
40,Fail,45,30,0,14,31
40,Fail,37,38,0,14,23
40,Fail,49,23,0,14,35
40,Success,49,30,0,9,40
40,Success,53,20,6,11,42
40,Success,51,30,0,10,41
40,Fail,50,34,0,11,39
40,Fail,36,27,13,15,21
40,Success,56,17,0,12,44
40,Fail,41,33,0,15,26
40,Fail,42,25,11,11,31
40,Fail,47,26,0,14,33
40,Fail,44,23,11,12,32
40,Success,54,30,0,7,47
40,Fail,44,33,5,9,35
40,Fail,45,32,0,14,31
40,Fail,48,22,3,17,31
40,Fail,45,31,0,14,31
40,Fail,39,32,6,14,25
40,Success,52,24,3,11,41
40,Fail,43,32,0,14,29
40,Success,54,26,0,9,45
40,Fail,46,22,0,18,28
40,Fail,43,25,4,16,27
40,Fail,46,23,8,12,34
40,Fail,48,28,0,15,33
40,Success,49,34,0,7,42
40,Fail,42,33,0,15,27
40,Success,50,29,0,9,41
40,Fail,48,36,0,9,39
40,Fail,48,24,0,16,32
40,Fail,47,22,13,9,38
40,Fail,43,30,0,14,29
40,Fail,44,28,5,13,31
40,Fail,50,18,2,18,32
40,Fail,47,24,2,13,34
40,Fail,45,32,0,12,33
40,Success,49,32,0,8,41
40,Success,55,20,0,13,42
40,Fail,48,30,0,15,33
40,Fail,51,18,3,13,38
40,Fail,49,23,0,19,30
40,Success,54,28,0,7,47
40,Fail,50,24,3,13,37
40,Fail,44,26,2,14,30
40,Success,53,22,4,7,46
40,Success,52,26,1,10,42
40,Fail,48,22,4,15,33
40,Success,52,21,6,12,40
40,Fail,49,30,0,10,39
40,Fail,50,26,2,14,36
40,Fail,48,27,0,14,34
40,Fail,46,26,4,14,32
40,Fail,47,27,0,15,32
40,Fail,47,24,3,17,30
40,Fail,48,27,5,12,36
40,Fail,46,28,2,10,36
40,Fail,45,32,0,18,27
40,Fail,49,28,0,15,34
40,Fail,39,38,1,6,33
40,Success,51,26,0,10,41
40,Fail,49,18,5,15,34
40,Fail,47,33,0,13,34
40,Fail,50,23,4,13,37
40,Fail,42,36,0,13,29
40,Success,52,30,1,8,44
40,Fail,44,38,0,8,36
40,Fail,43,33,0,12,31
40,Success,52,22,8,11,41
40,Success,52,26,2,5,47
40,Success,60,16,0,15,45
40,Fail,48,29,0,17,31
40,Fail,51,26,0,14,37
40,Fail,49,22,1,15,34
40,Success,54,24,4,8,46
40,Success,50,32,0,7,43
40,Fail,49,26,0,14,35
40,Fail,43,31,5,11,32
40,Success,50,24,0,10,40
40,Fail,48,30,0,9,39
40,Success,57,21,0,12,45
40,Success,56,23,0,13,43
40,Success,51,20,7,10,41
40,Fail,47,27,9,10,37
40,Fail,45,33,0,11,34
40,Success,54,30,0,6,48
40,Fail,50,28,4,12,38
40,Fail,46,32,0,13,33
40,Fail,45,32,3,9,36
40,Fail,50,22,1,18,32
40,Fail,44,26,10,13,31
40,Fail,45,30,0,14,31
40,Fail,46,26,0,15,31
40,Fail,43,27,11,13,30
40,Fail,42,28,0,15,27
40,Success,51,26,0,11,40
40,Success,53,20,5,10,43
40,Success,51,26,3,10,41
40,Fail,46,27,1,11,35
40,Fail,52,23,0,16,36
40,Fail,52,23,0,13,39
40,Fail,43,20,8,20,23
40,Success,51,29,8,5,46
40,Fail,44,30,0,14,30
40,Fail,51,24,2,14,37
40,Fail,47,26,1,14,33
40,Success,56,27,3,8,48
40,Success,51,24,2,10,41
40,Fail,49,27,0,12,37
40,Success,53,23,0,13,40
40,Fail,50,25,1,16,34
40,Fail,35,44,0,12,23
40,Fail,47,36,0,11,36
40,Success,50,25,9,10,40
40,Success,52,34,0,7,45
40,Fail,51,20,1,14,37
40,Fail,51,23,0,15,36
40,Fail,44,29,5,9,35
40,Success,53,27,0,7,46
40,Fail,46,25,8,12,34
40,Fail,40,35,0,13,27
40,Success,54,22,0,13,41
40,Success,51,26,0,11,40
40,Fail,48,20,8,14,34
40,Success,56,32,0,4,52
40,Fail,48,29,0,11,37
40,Fail,47,29,0,15,32
40,Fail,47,21,2,20,27
40,Fail,46,31,0,13,33
40,Fail,38,29,0,22,16
40,Fail,47,27,0,17,30
40,Fail,44,32,0,13,31
40,Fail,44,34,0,12,32
40,Fail,48,31,0,11,37
40,Fail,50,23,0,17,33
40,Fail,49,21,8,11,38
40,Fail,48,31,0,13,35
40,Success,51,33,0,5,46
40,Fail,50,27,0,13,37
40,Fail,49,24,0,11,38
40,Fail,40,35,0,15,25
40,Fail,41,32,8,8,33
40,Fail,51,26,1,13,38
40,Fail,48,22,5,18,30
40,Success,55,25,0,7,48
40,Fail,42,31,0,16,26
40,Fail,49,21,1,20,29
40,Fail,47,21,4,16,31
40,Fail,48,31,5,9,39
40,Fail,47,32,0,11,36
40,Fail,50,28,0,11,39
40,Fail,43,34,4,13,30
40,Fail,50,22,0,15,35
40,Fail,45,21,0,18,27
40,Fail,38,30,0,19,19
40,Fail,45,33,0,12,33
40,Success,51,23,9,11,40
40,Fail,49,22,4,12,37
40,Fail,44,26,6,12,32
40,Fail,38,31,0,19,19
40,Fail,45,34,0,15,30
40,Fail,45,26,5,12,33
40,Fail,45,28,0,18,27
40,Fail,48,24,3,15,33
40,Success,50,23,12,7,43
40,Fail,43,32,5,12,31
40,Fail,46,30,0,14,32
40,Success,57,19,3,12,45
40,Success,58,22,0,12,46
40,Success,54,20,1,11,43
40,Fail,50,26,0,15,35
40,Fail,49,27,0,15,34
40,Fail,54,15,0,17,37
40,Fail,47,22,5,14,33
40,Fail,47,28,0,14,33
40,Fail,48,29,2,12,36
40,Fail,51,23,3,12,39
40,Fail,38,28,3,20,18
40,Fail,46,31,2,11,35
40,Success,54,30,0,10,44
40,Success,51,24,0,9,42
40,Fail,43,20,7,18,25
40,Fail,42,23,8,13,29
40,Success,50,35,0,9,41
40,Fail,51,23,0,17,34
40,Success,56,19,0,15,41
40,Fail,46,30,3,8,38
40,Fail,39,32,3,15,24
40,Fail,44,32,5,8,36
40,Fail,44,23,5,18,26
40,Success,50,26,5,10,40
40,Success,52,35,0,6,46
40,Fail,43,30,0,15,28
40,Fail,42,27,0,18,24
40,Success,51,22,2,11,40
40,Fail,46,32,0,11,35
40,Fail,43,30,3,16,27
40,Fail,44,24,1,21,23
40,Fail,43,28,5,14,29
40,Fail,45,18,7,18,27
40,Success,54,26,0,9,45
40,Fail,48,31,0,13,35
40,Fail,48,27,0,10,38
40,Success,52,27,0,10,42
40,Success,54,23,4,11,43
40,Fail,43,24,9,11,32
40,Fail,47,31,0,10,37
40,Fail,39,30,5,15,24
40,Fail,51,28,0,13,38
40,Fail,47,34,0,11,36
40,Fail,43,31,0,15,28
40,Fail,42,28,5,16,26
40,Fail,48,31,0,11,37
40,Fail,43,30,0,14,29
40,Fail,50,25,1,13,37
40,Fail,45,35,0,10,35
40,Fail,49,29,0,10,39
40,Fail,46,25,1,14,32
40,Fail,47,25,0,15,32
40,Success,56,20,0,10,46
40,Fail,43,29,5,10,33
40,Fail,51,24,0,14,37
40,Fail,48,32,0,12,36
40,Fail,44,37,0,7,37
40,Fail,39,27,12,17,22
40,Fail,42,36,0,12,30
40,Fail,49,26,4,12,37
40,Fail,47,21,4,16,31
40,Fail,46,28,2,16,30
40,Success,53,24,0,12,41
40,Fail,33,42,1,18,15
40,Fail,37,32,1,22,15
40,Success,49,27,1,8,41
40,Fail,45,30,5,11,34
40,Success,45,40,0,5,40
40,Fail,45,33,0,16,29
40,Fail,49,24,5,12,37
40,Fail,45,25,7,14,31
40,Fail,45,28,0,16,29
40,Success,50,26,4,10,40
40,Success,51,30,0,9,42
40,Success,57,19,0,9,48
40,Fail,48,33,0,9,39
40,Fail,46,28,6,12,34
40,Fail,49,29,0,13,36
40,Success,53,21,2,10,43
40,Fail,46,34,0,11,35
40,Fail,47,23,3,14,33
40,Success,51,23,4,11,40
40,Fail,47,24,0,18,29
40,Fail,47,29,10,8,39
40,Fail,47,20,7,15,32
40,Fail,44,26,5,16,28
40,Fail,46,26,2,13,33
40,Fail,51,26,1,13,38
40,Fail,51,23,0,15,36
40,Success,52,25,7,11,41
40,Success,53,25,0,10,43
40,Success,51,23,4,11,40
40,Fail,47,26,0,13,34
40,Success,51,34,0,9,42
40,Fail,48,21,3,15,33
40,Success,54,19,9,9,45
40,Fail,44,30,0,13,31
40,Fail,50,24,2,15,35
40,Fail,44,23,4,19,25
40,Fail,42,30,2,12,30
40,Fail,47,23,4,16,31
40,Fail,52,27,0,13,39
40,Fail,49,28,3,11,38
40,Success,49,28,8,8,41
40,Success,57,25,0,7,50
40,Success,55,23,0,10,45
40,Fail,43,25,0,19,24
40,Fail,46,31,0,10,36
40,Fail,50,23,2,11,39
40,Fail,49,30,0,11,38
40,Success,53,22,5,9,44
40,Success,53,23,4,9,44
40,Success,51,21,6,10,41
40,Fail,47,20,8,19,28
40,Success,56,20,0,9,47
40,Fail,43,31,0,15,28
40,Fail,47,24,5,13,34
40,Fail,45,29,0,15,30
40,Success,49,30,0,9,40
40,Success,57,19,0,12,45
40,Success,56,22,3,10,46
40,Fail,43,25,5,22,21
40,Fail,37,32,0,22,15
40,Fail,49,17,2,21,28
40,Success,49,34,0,8,41
40,Fail,51,21,3,14,37
40,Fail,46,39,0,10,36
40,Fail,50,31,0,11,39
40,Fail,47,30,0,14,33
40,Fail,50,23,0,13,37
40,Fail,49,28,1,13,36
40,Fail,46,25,3,16,30
40,Fail,43,37,1,12,31
40,Fail,40,26,5,19,21
40,Success,51,26,3,7,44
40,Success,51,28,0,9,42
40,Success,54,20,0,13,41
40,Fail,44,28,0,17,27
40,Fail,48,27,0,14,34
40,Fail,48,29,0,10,38
40,Fail,49,22,5,18,31
40,Fail,46,26,11,12,34
40,Fail,47,24,0,15,32
40,Fail,44,29,4,13,31
40,Fail,45,18,5,23,22
40,Fail,41,35,0,11,30
40,Success,51,28,3,9,42
40,Fail,39,37,0,18,21
40,Fail,45,26,0,16,29
40,Success,55,29,0,8,47
40,Success,56,14,3,13,43
40,Fail,48,28,0,12,36
40,Success,60,19,0,11,49
40,Fail,50,23,0,15,35
40,Fail,43,34,0,10,33
40,Fail,48,31,0,9,39
40,Fail,46,26,5,13,33
40,Fail,48,19,6,19,29
40,Success,55,22,0,12,43
40,Fail,53,24,0,16,37
40,Success,52,23,2,12,40
40,Fail,41,43,0,8,33
40,Fail,39,36,0,15,24
40,Fail,54,21,2,15,39
40,Fail,51,24,0,12,39
40,Fail,45,32,0,14,31
40,Fail,42,27,0,14,28
40,Fail,42,27,10,14,28
40,Fail,43,35,6,8,35
40,Success,52,23,2,12,40
40,Fail,45,29,0,15,30
40,Fail,43,28,0,15,28
40,Fail,49,20,5,16,33
40,Success,50,31,3,10,40
40,Success,54,22,2,14,40
40,Success,51,24,0,8,43
40,Fail,42,29,3,16,26
40,Success,55,24,0,9,46
40,Success,52,22,1,10,42
40,Fail,42,24,7,17,25
40,Success,54,25,0,12,42
40,Fail,48,20,2,18,30
40,Fail,49,24,0,12,37
40,Success,52,25,3,11,41
40,Fail,32,50,0,13,19
40,Success,56,18,0,11,45
40,Success,56,20,2,11,45
40,Success,51,29,0,11,40
40,Fail,42,25,10,13,29
40,Fail,41,28,0,18,23
40,Fail,38,30,1,17,21
40,Fail,44,21,0,22,22
40,Fail,42,26,10,11,31
40,Fail,46,26,8,13,33
40,Fail,37,29,5,19,18
40,Fail,49,26,0,15,34
40,Success,52,27,0,10,42
40,Fail,46,35,0,12,34
40,Fail,43,28,8,9,34
40,Success,53,20,5,13,40
40,Fail,39,42,0,10,29
40,Fail,45,25,3,17,28
40,Success,55,21,0,10,45
40,Fail,52,25,0,16,36
40,Success,55,22,0,10,45
40,Fail,52,23,0,15,37
40,Fail,45,26,4,16,29
40,Fail,45,31,0,15,30
40,Fail,45,29,0,13,32
40,Fail,44,26,6,14,30
40,Fail,50,24,0,17,33
40,Success,50,32,0,6,44
40,Success,53,26,0,12,41
40,Success,55,23,1,10,45
40,Fail,47,32,0,15,32
40,Fail,44,32,2,13,31
40,Success,52,24,0,9,43
40,Fail,48,28,0,12,36
40,Success,52,24,4,8,44
40,Fail,49,23,4,13,36
40,Fail,41,37,0,13,28
40,Success,51,19,6,11,40
40,Fail,44,26,7,13,31
40,Success,57,26,0,6,51
40,Success,46,31,4,5,41
40,Fail,50,23,0,16,34
40,Success,55,20,2,11,44
40,Fail,42,29,0,18,24
40,Fail,45,26,1,15,30
40,Fail,46,26,3,11,35
40,Fail,43,26,11,11,32
40,Fail,39,28,7,15,24
40,Fail,46,26,0,15,31
40,Success,54,21,1,13,41
40,Success,52,29,0,6,46
40,Fail,51,23,0,14,37
40,Fail,36,40,0,18,18
40,Success,56,24,0,12,44
40,Fail,48,28,0,17,31
40,Success,54,27,0,7,47
40,Fail,35,38,2,18,17
40,Fail,44,25,9,14,30
40,Fail,38,29,5,13,25
40,Success,50,28,0,7,43
40,Fail,47,23,7,15,32
40,Success,50,23,6,10,40
40,Fail,42,29,0,20,22
40,Success,49,27,0,9,40
40,Fail,45,24,8,12,33
40,Success,51,24,0,11,40
40,Fail,42,31,1,15,27
40,Success,56,17,4,14,42
40,Fail,43,29,0,14,29
40,Fail,47,32,0,12,35
40,Fail,51,21,2,13,38
40,Success,55,24,2,10,45
40,Fail,48,25,0,14,34
40,Fail,46,28,0,15,31
40,Fail,49,29,0,11,38
40,Success,54,20,0,9,45
40,Success,53,19,9,8,45
40,Success,56,24,0,10,46
40,Success,56,20,5,9,47
40,Fail,47,26,0,16,31
40,Success,56,24,0,11,45
40,Success,52,19,8,11,41
40,Fail,45,27,0,20,25
40,Fail,45,28,0,12,33
40,Fail,45,30,0,15,30
40,Success,50,29,0,7,43
40,Fail,42,31,0,15,27
40,Success,52,26,3,9,43
40,Fail,46,23,2,17,29
40,Success,56,21,0,13,43
40,Fail,51,14,0,23,28
40,Success,52,25,0,11,41
40,Fail,41,33,0,17,24
40,Fail,42,30,0,16,26
40,Fail,46,29,0,14,32
40,Success,60,19,9,5,55
40,Fail,45,32,0,13,32
40,Success,56,17,2,10,46
40,Fail,51,19,3,13,38
40,Fail,45,31,3,10,35
40,Fail,39,37,0,14,25
40,Fail,50,33,0,12,38
40,Fail,49,30,0,11,38
40,Fail,43,34,0,11,32
40,Fail,47,26,0,14,33
40,Fail,46,26,7,13,33
40,Fail,41,32,0,15,26
40,Fail,44,23,3,16,28
40,Fail,48,32,0,14,34
40,Fail,47,28,0,15,32
40,Fail,47,25,1,17,30
40,Fail,40,28,7,16,24
40,Fail,42,37,0,11,31
40,Fail,49,21,0,19,30
40,Fail,40,34,0,16,24
40,Fail,47,28,1,12,35
40,Fail,42,36,2,8,34
40,Fail,40,35,0,14,26
40,Fail,48,30,0,13,35
40,Fail,33,40,6,12,21
40,Success,49,34,0,8,41
40,Fail,48,23,0,14,34
40,Fail,44,26,15,8,36
40,Fail,48,23,8,12,36
40,Fail,43,39,0,9,34
40,Fail,52,16,7,13,39
40,Fail,50,21,5,14,36
40,Fail,45,28,6,14,31
40,Fail,42,28,6,15,27
40,Fail,45,29,6,16,29
40,Fail,44,31,0,14,30
40,Fail,45,24,7,12,33
40,Fail,47,23,5,13,34
40,Fail,47,35,0,10,37
40,Fail,47,25,0,18,29
40,Fail,45,24,0,19,26
40,Fail,49,26,0,13,36
40,Fail,48,31,0,11,37
40,Fail,41,36,0,16,25
40,Fail,50,14,1,22,28
40,Fail,44,33,0,14,30
40,Fail,52,23,0,14,38
40,Fail,46,24,0,16,30
40,Fail,41,34,0,14,27
40,Success,57,13,8,13,44
40,Fail,50,25,2,14,36
40,Fail,50,20,6,11,39
40,Fail,44,24,3,16,28
40,Fail,43,31,4,11,32
40,Fail,50,27,0,13,37
40,Fail,47,27,4,16,31
40,Success,54,22,3,12,42
40,Fail,44,31,3,11,33
40,Success,51,22,2,9,42
40,Success,50,36,0,9,41
40,Fail,51,21,0,13,38
40,Fail,40,34,0,17,23
40,Fail,44,30,0,16,28
40,Fail,48,32,0,11,37
40,Fail,50,29,0,15,35
40,Fail,49,32,0,14,35
40,Success,57,20,0,12,45
40,Fail,45,26,4,16,29
40,Fail,45,31,0,14,31
40,Fail,40,29,2,17,23
40,Success,52,25,0,12,40
40,Fail,40,39,0,15,25
40,Fail,51,23,1,12,39
40,Fail,41,24,13,16,25
40,Success,54,23,3,8,46
40,Fail,42,23,10,14,28
40,Fail,48,32,0,10,38
40,Fail,40,42,0,11,29
40,Fail,50,24,2,11,39
40,Fail,48,29,0,10,38
40,Fail,47,26,0,16,31
40,Fail,50,24,0,15,35
40,Success,59,25,0,7,52
40,Fail,43,36,0,9,34
40,Fail,41,35,4,11,30
40,Fail,45,27,0,14,31
40,Fail,46,35,1,10,36
40,Success,51,22,4,9,42
40,Fail,51,23,0,12,39
40,Fail,45,35,3,8,37
40,Success,55,22,6,10,45
40,Fail,40,34,0,16,24
40,Success,51,26,1,8,43
40,Fail,46,27,7,12,34
40,Success,53,24,2,10,43
40,Fail,48,23,0,18,30
40,Fail,44,28,4,15,29
40,Fail,48,19,11,10,38
40,Fail,48,22,11,12,36
40,Fail,48,21,3,16,32
40,Success,53,34,0,6,47
40,Fail,43,32,0,19,24
40,Fail,44,22,5,20,24
40,Fail,43,33,0,15,28
40,Fail,46,27,1,13,33
40,Fail,48,25,1,11,37
40,Success,49,31,0,9,40
40,Success,59,21,0,12,47
40,Fail,49,29,4,12,37
40,Success,53,27,1,7,46
40,Fail,39,27,4,19,20
40,Fail,34,36,0,22,12
40,Fail,49,27,0,10,39
40,Fail,48,29,2,9,39
40,Fail,46,29,6,11,35
40,Fail,41,41,0,9,32
40,Fail,45,26,4,16,29
40,Fail,43,26,0,19,24
40,Fail,48,26,0,14,34
40,Success,52,26,0,11,41
40,Success,55,25,1,10,45
40,Fail,45,30,6,6,39
40,Fail,43,38,0,8,35
40,Fail,48,32,0,11,37
40,Fail,41,24,0,22,19
40,Fail,44,29,2,14,30
40,Fail,48,24,9,14,34
40,Success,57,21,2,14,43
40,Fail,48,32,0,9,39
40,Success,50,30,0,9,41
40,Fail,39,32,0,19,20
40,Fail,41,23,7,19,22
40,Fail,45,32,0,14,31
40,Fail,37,40,0,12,25
40,Fail,48,33,0,10,38
40,Fail,49,26,0,13,36
40,Fail,50,31,0,11,39
40,Success,53,27,3,7,46
40,Fail,48,23,0,17,31
40,Success,54,22,0,10,44
40,Fail,48,26,3,11,37
40,Fail,48,31,1,9,39
40,Fail,49,26,1,14,35
40,Fail,41,31,0,16,25
40,Fail,47,18,13,15,32
40,Fail,44,30,0,15,29
40,Fail,45,27,9,12,33
40,Fail,48,21,0,18,30
40,Success,54,26,5,8,46
40,Success,50,24,2,10,40
40,Success,53,25,0,13,40
40,Fail,47,36,0,8,39
40,Fail,51,24,0,14,37
40,Fail,45,32,0,14,31
40,Success,55,20,0,15,40
40,Fail,45,31,5,11,34
40,Success,58,26,0,5,53
40,Fail,52,23,3,13,39
40,Success,60,12,1,15,45
40,Fail,50,27,0,16,34
40,Fail,46,30,0,11,35
40,Fail,49,25,2,12,37
40,Success,53,21,4,12,41
40,Fail,47,30,0,13,34
40,Fail,52,21,7,13,39
40,Fail,43,23,3,18,25
40,Fail,46,30,0,11,35
40,Fail,52,21,4,13,39
40,Success,51,27,0,11,40
40,Fail,48,30,0,13,35
40,Fail,45,29,4,15,30
40,Fail,39,34,0,13,26
40,Fail,46,30,0,16,30
40,Fail,46,28,8,12,34
40,Fail,47,27,0,14,33
40,Fail,47,19,6,18,29
40,Success,54,22,0,10,44
40,Success,47,35,0,5,42
40,Success,56,22,4,6,50
40,Fail,47,30,6,9,38
40,Fail,47,22,6,16,31
40,Fail,44,34,0,14,30
40,Fail,47,26,2,13,34
40,Fail,46,33,1,8,38
40,Success,56,24,0,7,49
40,Fail,42,24,2,20,22
40,Success,52,22,3,12,40
40,Fail,44,27,2,13,31
40,Success,49,30,0,8,41
40,Fail,48,30,0,10,38
40,Fail,40,33,3,13,27
40,Success,52,30,0,9,43
40,Fail,46,23,7,11,35
40,Fail,40,37,0,12,28
40,Success,53,20,0,10,43
40,Fail,46,30,0,9,37
40,Fail,46,30,0,15,31
40,Success,55,26,3,4,51
40,Fail,52,14,3,19,33
40,Success,51,25,0,8,43
40,Fail,44,32,0,13,31
40,Fail,51,25,0,12,39
40,Fail,48,28,1,10,38
40,Success,56,22,1,10,46
40,Success,52,27,0,10,42
40,Success,55,20,3,6,49
40,Fail,46,28,0,16,30
40,Success,53,18,7,11,42
40,Success,56,22,0,11,45
40,Success,49,31,0,8,41
40,Success,52,26,0,10,42
40,Success,51,27,0,8,43
40,Fail,49,21,9,11,38
40,Success,50,29,0,10,40
40,Fail,52,16,6,15,37
40,Fail,42,25,2,18,24
40,Fail,35,47,0,13,22
40,Success,53,30,0,8,45
40,Fail,48,25,5,14,34
40,Success,49,32,0,8,41
40,Fail,42,32,0,16,26
40,Fail,48,28,0,16,32
40,Fail,40,22,9,19,21
40,Fail,52,27,0,14,38
40,Fail,48,24,1,14,34
40,Success,56,19,4,11,45
40,Success,49,33,1,7,42
40,Fail,47,30,4,10,37
40,Success,51,26,7,9,42
40,Fail,43,37,0,9,34
40,Fail,45,23,5,17,28
40,Success,51,22,7,9,42
40,Success,53,27,0,8,45
40,Success,52,27,0,11,41
40,Fail,49,28,0,13,36
40,Success,54,28,0,3,51
40,Fail,35,30,11,17,18
40,Success,52,25,6,10,42
40,Fail,45,34,0,11,34
40,Success,52,27,0,12,40
40,Success,52,27,0,11,41
40,Success,50,34,0,8,42
40,Success,51,30,0,10,41
40,Success,54,22,0,11,43
40,Fail,39,28,9,16,23
40,Fail,42,32,0,11,31
40,Success,53,23,5,8,45
40,Success,53,30,0,8,45
40,Fail,38,29,6,18,20
40,Fail,46,31,1,13,33
40,Fail,44,35,0,10,34
40,Success,49,31,0,9,40
40,Success,61,17,0,12,49
40,Fail,42,31,0,13,29
40,Fail,50,30,0,12,38
40,Success,51,27,0,10,41
40,Fail,48,35,0,9,39
40,Fail,51,22,0,13,38
40,Fail,46,27,0,15,31
40,Fail,38,37,0,13,25
40,Fail,41,40,0,15,26
40,Fail,39,30,10,15,24
40,Fail,41,29,7,11,30
40,Success,51,28,0,8,43
40,Fail,47,24,0,18,29
40,Success,49,31,3,8,41
40,Success,58,21,0,9,49
40,Fail,37,43,0,13,24
40,Fail,43,44,0,7,36
40,Fail,49,20,0,20,29
40,Fail,47,29,0,13,34
40,Fail,49,27,5,11,38
40,Fail,52,23,0,15,37
40,Success,55,29,3,7,48
40,Fail,43,29,7,13,30
40,Success,50,30,5,9,41
40,Success,55,28,0,5,50
40,Fail,44,28,0,14,30
40,Fail,42,36,0,14,28
40,Fail,46,26,0,19,27
40,Fail,46,22,10,17,29
40,Fail,51,27,0,13,38
40,Fail,46,25,2,15,31
40,Fail,43,33,6,10,33
40,Fail,49,24,0,15,34
40,Fail,45,32,0,12,33
40,Fail,46,20,13,11,35
40,Fail,50,21,3,13,37
40,Success,52,28,5,11,41
40,Success,54,19,2,12,42
40,Fail,49,25,0,15,34
40,Success,47,36,0,6,41
40,Fail,49,29,0,11,38
40,Fail,44,29,2,15,29
40,Fail,42,36,0,15,27
40,Fail,49,15,5,19,30
40,Success,54,22,0,14,40
40,Fail,40,35,3,14,26
40,Fail,39,23,13,18,21
40,Success,53,28,0,9,44
40,Fail,46,31,0,12,34
40,Fail,44,32,0,13,31
40,Success,53,23,0,13,40
40,Fail,47,24,1,18,29
40,Success,53,18,2,13,40
40,Fail,48,26,2,15,33
40,Fail,45,30,0,15,30
40,Fail,42,33,0,17,25
40,Fail,48,23,2,16,32
40,Success,55,19,2,10,45
40,Fail,46,25,2,15,31
40,Success,56,21,0,10,46
40,Success,55,26,3,9,46
40,Fail,48,27,1,14,34
40,Fail,39,33,0,18,21
40,Fail,44,29,0,15,29
40,Fail,42,33,0,12,30
40,Fail,45,27,5,15,30
40,Fail,45,30,1,12,33
40,Fail,47,34,0,11,36
40,Fail,39,33,6,15,24
40,Success,46,33,0,4,42
40,Fail,50,25,0,13,37
40,Fail,48,27,0,11,37
40,Fail,42,33,0,15,27
40,Fail,39,33,0,14,25
40,Success,54,22,1,7,47
40,Fail,47,25,6,11,36
40,Fail,44,24,5,15,29
40,Fail,41,36,0,13,28
40,Fail,46,24,1,14,32
40,Success,51,30,0,6,45
40,Fail,47,21,4,16,31
40,Fail,44,31,0,15,29
40,Fail,42,26,7,16,26
40,Fail,37,33,4,20,17
40,Fail,48,24,0,17,31
40,Fail,49,26,0,11,38
40,Success,49,30,4,9,40
40,Fail,50,28,1,11,39
40,Fail,42,32,5,10,32
40,Fail,40,28,10,9,31
40,Fail,51,22,0,17,34
40,Fail,46,28,0,12,34
40,Success,56,25,0,9,47
40,Fail,43,33,4,13,30
40,Fail,47,26,0,20,27
40,Success,52,28,0,9,43
40,Success,57,20,0,9,48
40,Fail,47,31,0,11,36
40,Fail,46,29,0,13,33
40,Fail,48,23,4,10,38
40,Fail,49,29,0,12,37
40,Fail,48,30,4,12,36
40,Fail,48,33,0,9,39
40,Fail,51,24,2,13,38
40,Fail,46,28,0,15,31
40,Success,52,27,0,12,40
40,Success,52,24,2,12,40
40,Success,47,33,7,7,40
40,Success,62,19,0,8,54
40,Fail,46,32,0,12,34
40,Success,54,21,1,10,44
40,Fail,50,17,5,20,30
40,Fail,50,21,0,15,35
40,Fail,47,23,3,13,34
40,Fail,47,25,1,18,29
40,Fail,45,31,0,13,32
40,Success,54,24,0,10,44
40,Success,51,24,0,11,40
40,Fail,46,26,4,14,32
40,Success,57,23,0,10,47
40,Success,49,34,0,6,43
40,Success,55,26,0,7,48
40,Success,53,28,2,7,46
40,Fail,45,32,5,10,35
40,Success,53,18,1,12,41
40,Fail,51,25,0,13,38
40,Success,56,20,2,10,46
40,Fail,51,18,7,15,36
40,Fail,48,22,9,12,36
40,Fail,47,35,0,8,39
40,Success,54,21,5,9,45
40,Fail,41,22,7,17,24
40,Success,57,15,3,15,42
40,Success,48,28,1,8,40
40,Success,53,18,3,13,40
40,Fail,47,22,4,16,31
40,Fail,43,28,1,17,26
40,Success,48,31,4,7,41
40,Fail,40,33,4,13,27
40,Fail,51,24,4,12,39
40,Fail,44,34,0,15,29
40,Fail,44,35,0,12,32
40,Fail,50,30,0,13,37
40,Success,57,26,0,7,50
40,Success,57,26,0,7,50
40,Fail,48,24,1,17,31
40,Success,51,23,2,9,42
40,Fail,47,23,10,13,34
40,Fail,46,26,2,11,35
40,Success,50,31,0,9,41
40,Fail,46,29,0,14,32
40,Fail,46,28,0,14,32
40,Success,56,21,2,8,48
40,Fail,50,22,0,16,34
40,Fail,41,38,0,12,29
40,Fail,48,25,6,9,39
40,Fail,52,22,1,13,39
40,Fail,45,31,0,12,33
40,Fail,42,22,11,15,27
40,Fail,38,31,0,20,18
40,Success,55,22,0,11,44
40,Fail,42,30,0,15,27
40,Fail,45,21,6,13,32
40,Fail,45,27,1,12,33
40,Fail,41,35,0,13,28
40,Fail,45,25,0,15,30
40,Fail,41,36,0,15,26
40,Success,53,30,0,5,48
40,Fail,44,30,4,12,32
40,Fail,49,30,0,10,39
40,Fail,42,43,0,8,34
40,Success,53,22,3,11,42
40,Fail,52,19,4,19,33
40,Fail,45,22,8,14,31
40,Success,52,21,1,12,40
40,Fail,49,25,0,11,38
40,Fail,49,26,2,12,37
40,Fail,49,27,0,14,35
40,Success,50,33,0,8,42
40,Fail,48,27,0,15,33
40,Fail,44,31,0,18,26
40,Fail,50,22,3,13,37
40,Fail,50,30,0,11,39
40,Fail,43,34,9,8,35
40,Fail,47,27,2,12,35
40,Success,53,21,9,8,45
40,Success,53,25,2,8,45
40,Fail,44,34,0,10,34
40,Fail,45,33,0,13,32
40,Fail,42,40,0,10,32
40,Success,50,28,0,8,42
40,Fail,44,27,4,13,31
40,Fail,48,31,0,12,36
40,Fail,48,28,0,16,32
40,Success,57,20,4,10,47
40,Fail,47,15,12,17,30
40,Fail,52,19,0,14,38
40,Fail,55,15,8,16,39
40,Fail,42,37,0,15,27
40,Success,49,31,0,9,40
40,Success,59,23,0,6,53
40,Fail,51,23,0,14,37
40,Fail,41,20,10,18,23
40,Fail,49,26,0,12,37
40,Success,52,22,4,12,40
40,Fail,44,29,4,14,30
40,Fail,45,26,8,14,31
40,Fail,48,25,0,15,33
40,Fail,46,34,0,12,34
40,Fail,42,28,11,10,32
40,Fail,46,29,1,11,35
40,Fail,48,21,0,15,33
40,Fail,46,31,0,10,36
40,Fail,47,25,6,11,36
40,Fail,48,28,0,12,36
40,Success,53,25,0,10,43
40,Success,52,23,3,12,40
40,Fail,46,31,0,10,36
40,Success,51,29,6,6,45
40,Fail,49,24,0,16,33
40,Fail,47,28,6,10,37
40,Fail,45,30,5,12,33
40,Success,54,24,6,7,47
40,Fail,48,25,4,13,35
40,Success,52,23,0,9,43
40,Fail,47,30,0,11,36
40,Success,50,24,11,9,41
40,Fail,42,39,0,10,32
40,Success,53,22,3,8,45
40,Fail,42,22,10,16,26
40,Success,53,27,3,8,45
40,Fail,49,23,0,15,34
40,Fail,45,28,4,12,33
40,Fail,50,23,2,13,37
40,Fail,47,27,0,16,31
40,Success,55,24,0,9,46
40,Fail,49,25,0,15,34
40,Fail,49,28,4,11,38
40,Fail,47,28,0,13,34
40,Fail,42,33,2,12,30
40,Success,51,22,4,11,40
40,Fail,42,30,1,15,27
40,Fail,48,29,0,9,39
40,Success,51,27,0,11,40
40,Fail,44,34,0,15,29
40,Fail,45,31,0,14,31
40,Fail,45,30,0,13,32
40,Fail,50,24,0,14,36
40,Success,49,27,6,8,41
40,Fail,48,24,7,15,33
40,Success,58,19,0,11,47
40,Success,55,19,0,13,42
40,Success,47,37,0,4,43
40,Fail,45,33,0,12,33
40,Success,53,18,1,13,40
40,Success,55,28,1,10,45
40,Fail,43,29,4,10,33
40,Success,50,25,7,8,42
40,Fail,53,23,0,17,36
40,Fail,48,23,8,12,36
40,Fail,46,25,3,12,34
40,Fail,39,29,9,17,22
40,Fail,50,26,4,11,39
40,Fail,44,29,3,10,34
40,Fail,45,32,0,15,30
40,Fail,52,23,0,15,37
40,Fail,45,29,0,14,31
40,Success,50,30,0,9,41
40,Fail,42,28,4,14,28
40,Success,50,30,0,10,40
40,Fail,48,24,0,16,32
40,Success,54,24,2,11,43
40,Fail,52,23,0,14,38
40,Success,52,27,0,8,44
40,Success,53,22,0,12,41
40,Fail,52,22,1,15,37
40,Success,53,21,3,12,41
40,Fail,48,20,9,9,39
40,Fail,48,34,0,11,37
40,Success,56,28,0,9,47
40,Fail,41,37,0,15,26
40,Fail,43,25,13,15,28
40,Fail,47,32,1,10,37
40,Fail,44,26,0,18,26
40,Success,53,31,2,5,48
40,Fail,49,27,0,12,37
40,Fail,48,24,1,14,34
40,Fail,40,32,1,17,23
40,Success,49,36,0,8,41
40,Fail,49,23,2,14,35
40,Fail,46,20,7,15,31
40,Fail,48,27,0,13,35
40,Fail,41,27,0,20,21
40,Fail,49,22,9,14,35
40,Fail,45,31,1,14,31
40,Fail,43,33,0,16,27
40,Fail,47,29,0,18,29
40,Fail,45,27,9,15,30
40,Fail,44,29,0,15,29
40,Fail,46,30,5,9,37
40,Success,56,25,0,8,48
40,Success,51,27,1,6,45
40,Success,54,22,0,12,42
40,Fail,41,42,0,11,30
40,Success,51,29,1,11,40
40,Fail,55,16,0,19,36
40,Fail,46,32,0,11,35
40,Fail,45,31,0,16,29
40,Fail,46,25,4,17,29
40,Success,56,19,2,12,44
40,Fail,51,22,0,14,37
40,Fail,40,35,0,15,25
40,Fail,47,26,0,15,32
40,Fail,43,33,0,13,30
40,Fail,44,33,0,13,31
40,Fail,39,25,0,27,12
40,Fail,46,23,0,15,31
40,Success,51,26,0,8,43
40,Fail,49,29,0,13,36
40,Success,52,31,0,7,45
40,Fail,41,25,7,15,26
40,Success,51,30,0,10,41
40,Fail,42,26,4,16,26
40,Success,54,23,3,11,43
40,Fail,50,25,0,13,37
40,Success,54,24,0,11,43
40,Fail,47,34,0,9,38
40,Fail,49,19,3,16,33
40,Fail,40,30,8,12,28
40,Fail,45,28,0,14,31
40,Fail,42,35,0,11,31
40,Fail,44,32,0,12,32
40,Success,59,16,2,12,47
40,Fail,41,25,4,17,24
40,Fail,49,16,7,19,30
40,Fail,46,37,0,12,34
40,Fail,46,27,2,13,33
40,Success,53,23,2,9,44
40,Fail,41,29,6,16,25
40,Fail,51,23,0,12,39
40,Fail,43,34,0,17,26
40,Fail,45,26,7,12,33
40,Success,48,34,0,7,41
40,Success,49,31,0,8,41
40,Fail,50,28,0,12,38
40,Fail,45,25,4,16,29
40,Success,50,24,5,9,41
40,Success,53,23,3,11,42
40,Fail,52,20,0,14,38
40,Success,52,29,0,10,42
40,Success,54,29,0,9,45
40,Fail,53,21,3,15,38
40,Fail,45,26,0,18,27
40,Success,57,20,2,7,50
40,Fail,37,29,16,13,24
40,Fail,50,26,0,15,35
40,Success,47,30,3,7,40
40,Fail,47,31,0,12,35
40,Fail,44,26,0,19,25
40,Fail,51,20,4,13,38
40,Fail,48,24,1,16,32
40,Success,52,24,1,12,40
40,Fail,51,21,1,14,37
40,Fail,43,27,2,15,28
40,Fail,47,20,9,15,32
40,Fail,47,29,0,11,36
40,Fail,50,26,0,15,35
40,Fail,39,32,0,19,20
40,Fail,40,31,7,13,27
40,Fail,41,29,0,21,20
40,Fail,45,28,0,13,32
40,Fail,49,28,0,16,33
40,Fail,46,25,0,15,31
40,Fail,44,25,9,13,31
40,Fail,47,22,4,14,33
40,Fail,44,28,1,15,29
40,Success,51,21,6,11,40
40,Fail,42,31,0,19,23
40,Fail,36,40,0,13,23
40,Success,55,28,0,5,50
40,Fail,47,26,10,12,35
40,Success,55,23,0,13,42
40,Fail,52,19,0,21,31
40,Fail,40,37,0,12,28
40,Fail,45,37,0,11,34
40,Fail,48,31,0,11,37
40,Fail,44,33,0,14,30
40,Success,55,23,0,11,44
40,Fail,44,34,0,15,29
40,Fail,48,29,0,13,35
40,Success,53,24,2,9,44
40,Fail,43,32,3,15,28
40,Success,50,29,1,10,40
40,Fail,40,28,5,14,26
40,Success,49,31,1,8,41
40,Fail,50,28,0,11,39
40,Fail,51,25,0,12,39
40,Fail,39,30,6,18,21
40,Success,49,25,11,9,40
40,Fail,44,34,0,14,30
40,Success,56,20,7,10,46
40,Success,49,33,0,9,40
40,Fail,44,29,0,19,25
40,Fail,44,29,0,14,30
40,Fail,46,26,0,19,27
40,Success,49,23,2,9,40
40,Fail,47,25,0,14,33
40,Fail,37,40,0,15,22
40,Fail,46,24,1,15,31
40,Success,47,34,2,7,40
40,Fail,49,31,0,13,36
40,Success,53,27,0,7,46
40,Fail,51,22,2,14,37
40,Success,55,20,2,9,46
40,Fail,52,22,0,14,38
40,Fail,48,29,0,13,35
40,Success,54,20,2,13,41
40,Fail,48,20,8,14,34
40,Fail,42,38,0,19,23
40,Fail,38,29,8,15,23
40,Fail,46,27,0,13,33
40,Success,51,24,1,11,40
40,Fail,46,20,7,18,28
40,Fail,44,29,2,16,28
40,Success,58,17,4,10,48
40,Fail,43,28,1,16,27
40,Fail,45,27,5,10,35
40,Fail,51,21,1,15,36
40,Fail,50,27,0,14,36
40,Fail,46,26,4,14,32
40,Fail,47,30,2,12,35
40,Fail,49,23,2,13,36
40,Fail,50,21,2,15,35
40,Success,54,26,1,9,45
40,Fail,48,25,10,10,38
40,Fail,44,32,0,12,32
40,Fail,49,22,8,11,38
40,Success,52,21,1,10,42
40,Success,51,23,5,11,40
40,Success,51,25,1,10,41
40,Fail,43,29,4,13,30
40,Fail,48,27,0,13,35
40,Fail,44,17,6,22,22
40,Fail,45,27,5,15,30
40,Fail,41,39,0,14,27
40,Success,52,32,4,6,46
40,Fail,44,28,2,15,29
40,Fail,49,22,6,13,36
40,Success,58,23,0,7,51
40,Fail,47,27,0,17,30
40,Success,53,26,0,9,44
40,Fail,48,27,0,15,33
40,Fail,50,21,0,17,33
40,Fail,45,28,5,10,35
40,Fail,48,20,4,18,30
40,Fail,45,31,8,8,37
40,Fail,49,25,2,13,36
40,Success,52,27,0,7,45
40,Fail,45,27,1,15,30
40,Fail,50,18,5,18,32
40,Fail,47,31,0,14,33
40,Fail,48,28,0,14,34
40,Fail,42,29,8,11,31
40,Fail,42,29,2,16,26
40,Fail,51,24,0,14,37
40,Fail,48,30,0,15,33
40,Fail,37,31,3,19,18
40,Success,52,20,6,11,41
40,Fail,46,21,8,16,30
40,Fail,52,23,0,13,39
40,Fail,46,29,5,11,35
40,Fail,47,30,0,17,30
40,Success,55,21,0,12,43
40,Fail,36,40,0,13,23
40,Fail,49,28,0,14,35
40,Success,56,20,0,12,44
40,Fail,45,30,5,11,34
40,Success,54,22,5,13,41
40,Fail,48,32,0,13,35
40,Fail,45,28,0,15,30
40,Fail,47,30,0,14,33
40,Fail,50,24,2,12,38
40,Success,55,22,0,9,46
40,Fail,46,26,2,15,31
40,Fail,44,25,4,17,27
40,Fail,46,34,0,15,31
40,Success,51,25,0,10,41
40,Success,54,26,0,11,43
40,Fail,42,32,0,17,25
40,Fail,47,27,0,16,31
40,Fail,44,29,2,17,27
40,Fail,49,26,0,10,39
40,Fail,42,22,3,21,21
40,Fail,44,25,0,18,26
40,Fail,43,37,0,10,33
40,Success,49,30,1,8,41
40,Fail,49,23,3,16,33
40,Fail,51,27,0,14,37
40,Fail,39,40,0,11,28
40,Fail,49,26,0,13,36
40,Fail,46,29,0,16,30
40,Fail,48,23,11,14,34
40,Fail,49,20,4,17,32
40,Fail,49,21,3,14,35
40,Fail,49,27,0,10,39
40,Fail,38,34,0,16,22
40,Fail,47,21,9,14,33
40,Fail,48,27,0,17,31
40,Fail,46,38,0,8,38
40,Success,48,35,0,8,40
40,Success,57,21,0,10,47
40,Fail,44,36,0,11,33
40,Success,56,24,0,12,44
40,Fail,48,25,1,15,33
40,Success,51,26,3,10,41
40,Success,47,35,0,5,42
40,Success,50,31,0,8,42
40,Fail,51,19,0,16,35
40,Success,53,24,0,10,43
40,Fail,52,26,0,14,38
40,Fail,44,29,3,12,32
40,Fail,47,27,0,14,33
40,Fail,47,26,0,15,32
40,Fail,36,31,0,26,10
40,Fail,44,31,8,10,34
40,Success,51,32,0,9,42
40,Fail,48,23,0,17,31
40,Fail,44,27,8,10,34
40,Fail,46,27,0,18,28
40,Fail,50,23,7,13,37
40,Success,52,25,0,12,40
40,Success,49,30,0,7,42
40,Success,56,22,1,9,47
40,Fail,42,25,2,19,23
40,Success,57,16,7,10,47
40,Success,54,18,6,12,42
40,Success,53,25,1,10,43
40,Fail,46,30,0,10,36
40,Fail,45,25,11,12,33
40,Success,51,23,4,10,41
40,Success,53,23,2,11,42
40,Fail,44,28,5,15,29
40,Fail,49,27,0,17,32
40,Fail,43,35,0,14,29
40,Fail,51,24,0,18,33
40,Success,53,20,0,13,40
40,Fail,45,26,1,16,29
40,Fail,47,26,3,11,36
40,Fail,50,23,2,14,36
40,Fail,43,27,0,21,22
40,Fail,46,24,0,18,28
40,Fail,52,22,0,15,37
40,Fail,49,21,3,16,33
40,Success,52,26,0,12,40
40,Fail,53,19,0,14,39
40,Success,49,32,0,7,42
40,Fail,42,38,0,12,30
40,Success,52,26,0,12,40
40,Fail,52,20,1,16,36
40,Fail,48,30,1,10,38
40,Fail,46,30,0,13,33
40,Fail,43,35,0,13,30
40,Fail,54,17,3,15,39
40,Success,54,25,0,8,46
40,Fail,46,26,7,11,35
40,Fail,49,23,0,13,36
40,Fail,40,30,8,11,29
40,Fail,48,28,0,14,34
40,Fail,43,29,7,9,34
40,Fail,46,23,3,15,31
40,Success,56,20,0,14,42
40,Fail,46,30,3,10,36
40,Fail,46,24,11,11,35
40,Success,53,24,0,11,42
40,Success,55,20,0,13,42
40,Fail,43,36,4,11,32
40,Success,51,28,6,7,44
40,Fail,44,29,0,15,29
40,Fail,47,28,0,12,35
40,Fail,48,29,0,12,36
40,Fail,46,27,6,9,37
40,Fail,52,18,0,18,34
40,Success,51,27,0,11,40
40,Fail,43,25,9,15,28
40,Fail,48,30,0,14,34
40,Fail,41,24,2,20,21
40,Fail,54,15,1,17,37
40,Fail,49,26,0,14,35
40,Fail,45,29,5,11,34
40,Success,51,23,3,11,40
40,Fail,48,28,0,13,35
40,Success,54,24,0,12,42
40,Success,50,28,1,10,40
40,Fail,45,25,3,14,31
40,Fail,42,29,4,15,27
40,Success,52,23,2,12,40
40,Success,51,25,4,9,42
40,Success,54,25,0,9,45
40,Fail,44,25,0,19,25
40,Success,57,18,2,11,46
40,Fail,41,23,9,18,23
40,Fail,46,29,0,13,33
40,Fail,46,26,8,12,34
40,Fail,45,34,0,12,33
40,Fail,47,34,0,8,39
40,Success,53,24,3,10,43
40,Fail,49,22,4,13,36
40,Fail,41,32,2,15,26
40,Fail,50,32,0,12,38
40,Fail,47,26,5,15,32
40,Success,49,26,2,8,41
40,Fail,47,36,0,10,37
40,Fail,51,21,0,14,37
40,Fail,46,33,0,11,35
40,Fail,43,32,1,12,31
40,Fail,48,29,0,10,38
40,Fail,46,24,0,16,30
40,Success,53,27,7,5,48
40,Success,53,24,6,11,42
40,Fail,48,22,8,14,34
40,Fail,44,31,2,14,30
40,Success,57,17,0,12,45
40,Fail,42,39,0,9,33
40,Fail,49,34,0,10,39
40,Fail,50,23,1,17,33
40,Success,53,21,6,12,41
40,Fail,45,21,9,15,30
40,Success,55,21,0,11,44
40,Fail,46,29,4,10,36
40,Fail,50,24,0,21,29
40,Fail,45,31,0,11,34
40,Fail,50,26,0,12,38
40,Fail,43,24,12,14,29
40,Fail,52,20,0,14,38
40,Fail,52,20,7,14,38
40,Fail,44,25,2,16,28
40,Fail,48,28,0,14,34
40,Fail,48,21,7,14,34
40,Fail,46,35,0,10,36
40,Success,55,23,0,12,43
40,Fail,42,23,9,19,23
40,Success,50,27,0,8,42
40,Success,58,29,0,5,53
40,Success,57,23,0,6,51
40,Fail,47,32,0,10,37
40,Fail,49,30,0,10,39
40,Fail,48,25,9,9,39
40,Success,50,25,9,9,41
40,Success,46,38,0,6,40
40,Success,51,32,0,7,44
40,Success,53,30,2,7,46
40,Fail,53,22,0,16,37
40,Fail,48,36,0,9,39
40,Fail,47,33,0,9,38
40,Success,53,32,0,5,48
40,Fail,48,32,0,9,39
40,Success,49,28,5,9,40
40,Fail,41,31,4,12,29
40,Success,53,23,0,11,42
40,Fail,45,26,12,12,33
40,Fail,41,28,5,14,27
40,Fail,44,29,0,20,24
40,Success,58,22,3,4,54
40,Success,54,22,0,13,41
40,Fail,45,36,0,12,33
40,Fail,47,23,3,17,30
40,Fail,41,39,0,10,31
40,Fail,49,21,8,13,36
40,Fail,42,29,9,17,25
40,Fail,44,31,0,16,28
40,Fail,48,22,9,15,33
40,Fail,52,24,0,13,39
40,Fail,45,35,0,15,30
40,Fail,43,31,0,16,27
40,Fail,45,33,0,13,32
40,Success,56,24,4,10,46
40,Success,48,32,0,8,40
40,Fail,43,38,0,12,31
40,Success,54,18,3,14,40
40,Fail,48,22,2,14,34
40,Success,51,28,0,9,42
40,Success,51,28,0,10,41
40,Fail,40,36,0,14,26
40,Fail,46,35,0,7,39
40,Fail,47,24,2,15,32
40,Fail,51,26,0,12,39
40,Fail,47,28,6,11,36
40,Fail,42,30,7,11,31
40,Fail,51,23,0,12,39
40,Success,54,19,8,11,43
40,Fail,48,25,1,12,36
40,Success,53,29,0,8,45
40,Fail,46,33,0,13,33
40,Fail,44,30,3,16,28
40,Fail,37,28,9,15,22
40,Success,53,27,0,10,43
40,Success,55,24,0,9,46
40,Fail,43,32,4,12,31
40,Fail,47,33,0,11,36
40,Success,53,21,0,13,40
40,Fail,44,30,0,16,28
40,Fail,48,29,0,13,35
40,Fail,47,29,0,13,34
40,Fail,49,21,9,14,35
40,Fail,52,20,0,14,38
40,Fail,48,29,0,12,36
40,Fail,48,30,1,13,35
40,Fail,46,26,5,14,32
40,Fail,50,30,0,12,38
40,Fail,42,35,0,10,32
40,Success,59,17,0,15,44
40,Fail,47,26,0,14,33
40,Fail,47,28,0,16,31
40,Success,50,26,8,6,44
40,Success,56,21,1,9,47
40,Success,55,26,0,8,47
40,Success,55,24,4,6,49
40,Fail,51,21,1,13,38
40,Fail,51,25,0,13,38
40,Fail,48,24,1,13,35
40,Fail,54,21,0,16,38
40,Fail,42,25,14,12,30
40,Success,58,19,1,12,46
40,Success,55,20,1,12,43
40,Fail,41,36,1,13,28
40,Fail,35,28,8,22,13
40,Fail,51,24,6,12,39
40,Fail,39,43,0,12,27
40,Fail,49,25,0,16,33
40,Fail,37,33,9,16,21
40,Fail,49,21,9,12,37
40,Fail,40,36,0,16,24
40,Fail,47,26,3,13,34
40,Fail,49,28,0,14,35
40,Fail,35,32,0,20,15
40,Fail,51,25,0,12,39
40,Success,57,24,0,8,49
40,Fail,40,23,9,19,21
40,Fail,36,38,2,15,21
40,Fail,37,37,9,10,27
40,Success,48,32,2,8,40
40,Fail,42,28,0,19,23
40,Fail,48,25,5,11,37
40,Fail,52,21,2,13,39
40,Success,52,24,3,9,43
40,Fail,52,20,4,13,39
40,Success,54,21,3,10,44
40,Success,56,21,0,12,44
40,Fail,45,28,6,11,34
40,Fail,48,30,0,12,36
40,Success,54,19,0,13,41
40,Success,54,25,0,13,41
40,Fail,53,15,5,14,39
40,Success,54,23,3,10,44
40,Fail,39,39,0,11,28
40,Success,54,20,5,14,40
40,Fail,46,36,0,10,36
40,Fail,52,24,0,13,39
40,Fail,49,19,9,14,35
40,Success,51,29,0,10,41
40,Success,52,22,0,11,41
40,Fail,44,31,4,13,31
40,Success,53,21,0,13,40
40,Fail,43,29,0,16,27
40,Success,56,21,1,14,42
40,Fail,49,26,5,12,37
40,Fail,47,28,0,15,32
40,Success,57,20,0,12,45
40,Fail,40,31,5,17,23
40,Success,54,23,0,10,44
40,Success,57,20,0,10,47
40,Fail,49,30,0,10,39
40,Success,53,25,3,9,44
40,Success,52,24,0,10,42
40,Fail,41,30,5,17,24
40,Fail,47,27,4,9,38
40,Success,59,18,0,12,47
40,Success,54,29,0,8,46
40,Fail,42,36,0,17,25
40,Fail,44,24,5,13,31
40,Fail,39,28,10,18,21
40,Fail,45,25,4,17,28
40,Fail,45,28,1,13,32
40,Fail,52,25,0,14,38
40,Fail,47,29,0,11,36
40,Fail,45,36,0,13,32
40,Success,56,21,0,11,45
40,Fail,51,26,0,14,37
40,Fail,48,28,0,11,37
40,Fail,48,22,2,17,31
40,Fail,49,26,0,12,37
40,Success,52,24,2,8,44
40,Success,50,31,0,8,42
40,Success,52,27,0,10,42
40,Fail,50,26,0,11,39
40,Fail,44,28,5,11,33
40,Success,51,31,0,8,43
40,Fail,45,30,3,12,33
40,Success,55,18,10,8,47
40,Success,52,23,3,10,42
40,Fail,45,27,3,15,30
40,Fail,41,36,7,8,33
40,Fail,45,31,0,13,32
40,Fail,46,26,1,14,32
40,Fail,44,32,0,14,30
40,Success,55,27,0,10,45
40,Success,56,25,2,10,46
40,Success,53,28,0,9,44
40,Fail,48,25,3,16,32
40,Success,46,39,0,6,40
40,Success,52,25,8,8,44
40,Success,49,29,0,9,40
40,Fail,39,37,10,6,33
40,Success,56,21,0,8,48
40,Fail,50,26,0,13,37
40,Success,54,21,1,12,42
40,Fail,40,38,0,11,29
40,Fail,47,23,3,16,31
40,Fail,43,29,8,13,30
40,Fail,45,28,6,13,32
40,Success,53,23,0,8,45
40,Fail,43,35,0,13,30
40,Fail,48,31,0,14,34
40,Success,51,25,5,9,42
40,Success,56,31,0,4,52
40,Fail,52,19,0,14,38
40,Success,55,23,0,9,46
40,Fail,51,21,0,16,35
40,Fail,49,22,2,12,37
40,Fail,43,31,4,12,31
40,Success,59,15,4,5,54
40,Fail,42,30,1,18,24
40,Fail,47,23,0,19,28
40,Fail,50,26,3,11,39
40,Fail,47,24,7,15,32
40,Success,52,32,3,6,46
40,Success,52,21,4,10,42
40,Fail,47,17,15,16,31
40,Fail,40,30,4,12,28
40,Success,53,27,1,9,44
40,Fail,48,33,2,11,37
40,Fail,47,30,0,14,33
40,Fail,49,34,0,10,39
40,Fail,46,26,5,10,36
40,Fail,45,26,4,14,31
40,Success,58,21,0,9,49
40,Fail,48,30,0,13,35
40,Success,51,26,0,10,41
40,Success,54,27,0,10,44
40,Fail,47,28,3,12,35
40,Fail,45,30,0,18,27
40,Fail,44,30,0,16,28
40,Fail,42,26,6,17,25
40,Success,53,27,0,8,45
40,Success,58,20,0,10,48
40,Fail,45,29,0,16,29
40,Fail,39,22,9,21,18
40,Fail,50,23,0,11,39
40,Success,55,22,0,13,42
40,Fail,46,33,0,13,33
40,Fail,47,23,5,13,34
40,Fail,39,33,8,12,27
40,Fail,50,21,3,16,34
40,Fail,49,25,0,13,36
40,Fail,51,25,0,14,37
40,Fail,42,26,5,18,24
40,Fail,48,25,8,11,37
40,Fail,46,34,0,13,33
40,Fail,48,28,0,11,37
40,Success,57,20,0,12,45
40,Fail,45,30,0,16,29
40,Success,49,25,5,8,41
40,Fail,48,25,4,12,36
40,Fail,42,31,0,17,25
40,Fail,44,33,0,13,31
40,Fail,47,25,0,17,30
40,Success,52,28,0,12,40
40,Success,55,23,1,10,45
40,Success,54,28,0,8,46
40,Fail,47,30,0,14,33
40,Success,51,27,0,10,41
40,Fail,41,25,3,15,26
40,Fail,48,23,1,16,32
40,Success,61,17,0,7,54
40,Success,53,27,2,9,44
40,Fail,47,27,7,10,37
40,Fail,51,23,0,17,34
40,Fail,51,25,1,13,38
40,Fail,49,27,0,14,35
40,Success,52,23,0,11,41
40,Fail,43,36,0,12,31
40,Fail,45,28,2,12,33
40,Fail,42,28,5,11,31
40,Fail,48,33,0,11,37
40,Success,53,25,0,8,45
40,Fail,43,27,2,17,26
40,Fail,46,32,1,11,35
40,Fail,49,25,2,13,36
40,Fail,47,29,0,10,37
40,Fail,43,31,6,13,30
40,Fail,47,29,6,12,35
40,Fail,45,28,0,17,28
40,Fail,48,32,0,9,39
40,Fail,45,28,5,11,34
40,Fail,50,27,0,12,38
40,Fail,47,24,2,16,31
40,Fail,45,25,3,17,28
40,Fail,46,26,11,8,38
40,Fail,38,43,0,11,27
40,Fail,48,28,0,13,35
40,Success,50,28,3,8,42
40,Fail,45,33,0,14,31
40,Fail,43,30,0,12,31
40,Fail,48,24,4,13,35
40,Success,55,19,2,12,43
40,Fail,45,24,12,10,35
40,Fail,49,28,1,12,37
40,Fail,45,27,5,17,28
40,Fail,42,26,8,16,26
40,Success,52,24,5,10,42
40,Success,55,18,7,10,45
40,Fail,44,36,0,6,38
40,Fail,46,32,1,8,38
40,Fail,50,26,0,12,38
40,Fail,46,30,0,17,29
40,Fail,52,22,2,13,39
40,Success,51,26,2,11,40
40,Success,49,31,0,7,42
40,Success,54,24,1,10,44
40,Fail,44,24,0,16,28
40,Success,53,20,1,12,41
40,Fail,43,31,0,15,28
40,Fail,48,29,3,13,35
40,Fail,43,35,0,12,31
40,Success,56,19,1,13,43
40,Success,55,24,0,10,45
40,Fail,51,24,0,14,37
40,Fail,42,28,2,16,26
40,Fail,49,24,8,13,36
40,Fail,45,33,0,12,33
40,Success,51,30,0,10,41
40,Fail,43,27,0,14,29
40,Fail,48,29,4,13,35
40,Fail,46,34,0,13,33
40,Fail,50,24,4,14,36
40,Fail,44,38,0,8,36
40,Fail,42,35,0,14,28
40,Fail,45,36,0,11,34
40,Fail,39,43,0,12,27
40,Success,50,23,4,10,40
40,Fail,48,31,0,12,36
40,Fail,49,23,0,17,32
40,Success,51,30,2,7,44
40,Fail,46,23,0,19,27
40,Fail,46,29,0,12,34
40,Success,49,27,8,9,40
40,Fail,42,33,0,14,28
40,Fail,45,28,6,12,33
40,Fail,44,25,0,13,31
40,Success,58,25,1,6,52
40,Fail,47,22,8,12,35
40,Fail,42,27,4,19,23
40,Fail,54,20,5,16,38
40,Success,46,38,0,4,42
40,Fail,50,25,3,12,38
40,Fail,47,29,3,10,37
40,Success,60,14,1,10,50
40,Success,53,27,0,7,46
40,Fail,44,28,0,15,29
40,Fail,51,20,0,18,33
40,Fail,53,17,1,16,37
40,Success,52,23,0,8,44
40,Success,55,21,0,13,42
40,Fail,53,21,0,14,39
40,Fail,49,26,3,13,36
40,Fail,49,28,3,13,36
40,Fail,42,27,2,16,26
40,Fail,43,34,0,13,30
40,Fail,54,15,0,19,35
40,Success,53,17,6,13,40
40,Fail,46,34,0,11,35
40,Success,49,32,0,7,42
40,Fail,52,19,4,14,38
40,Fail,48,22,4,16,32
40,Success,53,19,3,13,40
40,Fail,43,36,0,12,31
40,Fail,41,27,5,15,26
40,Fail,48,25,0,17,31
40,Fail,50,26,0,13,37
40,Fail,49,27,0,12,37
40,Fail,50,21,6,13,37
40,Fail,47,35,0,9,38
40,Success,52,28,1,10,42
40,Fail,43,29,8,12,31
40,Fail,48,31,0,12,36
40,Fail,48,28,0,18,30
40,Fail,44,30,0,8,36
40,Fail,51,26,0,12,39
40,Fail,46,29,0,14,32
40,Success,53,20,6,13,40
40,Success,56,24,0,8,48
40,Fail,43,26,6,15,28
40,Fail,49,27,1,11,38
40,Fail,44,31,0,11,33
40,Fail,52,23,1,17,35
40,Fail,43,37,0,10,33
40,Fail,48,28,0,14,34
40,Fail,49,24,3,12,37
40,Success,55,19,4,14,41
40,Fail,40,39,0,11,29
40,Fail,44,32,0,14,30
40,Fail,45,27,3,15,30
40,Fail,42,21,16,12,30
40,Fail,42,29,0,16,26
40,Success,52,23,2,11,41
40,Fail,44,24,9,14,30
40,Fail,53,25,0,14,39
40,Success,54,20,0,14,40
40,Fail,53,18,2,14,39
40,Fail,42,31,5,13,29
40,Success,53,30,0,10,43
40,Fail,49,26,7,10,39
40,Fail,42,32,0,16,26
40,Fail,40,34,6,13,27
40,Fail,51,20,7,14,37
40,Fail,50,22,2,17,33
40,Fail,49,26,0,16,33
40,Fail,43,23,7,19,24
40,Fail,47,30,2,11,36
40,Fail,44,29,0,15,29
40,Fail,49,21,2,14,35
40,Success,50,23,1,10,40
40,Success,54,23,0,9,45
40,Fail,50,27,0,11,39
40,Fail,48,29,0,11,37
40,Success,53,31,0,8,45
40,Success,56,27,0,8,48
40,Fail,46,30,0,15,31
40,Fail,50,29,1,11,39
40,Fail,44,40,0,8,36
40,Fail,45,31,5,12,33
40,Fail,48,25,1,10,38
40,Fail,46,27,7,10,36
40,Fail,47,29,4,9,38
40,Success,53,20,3,12,41
40,Success,50,26,0,10,40
40,Fail,50,20,8,12,38
40,Fail,51,28,0,12,39
40,Fail,46,30,0,15,31
40,Fail,41,34,4,14,27
40,Success,52,27,1,9,43
40,Fail,47,29,0,12,35
40,Fail,45,31,0,11,34
40,Fail,45,29,2,12,33
40,Fail,50,33,0,11,39
40,Fail,48,23,2,14,34
40,Fail,42,33,0,14,28
40,Fail,46,29,0,15,31
40,Fail,47,31,0,11,36
40,Success,50,30,0,7,43
40,Fail,44,30,2,12,32
40,Fail,44,23,7,16,28
40,Fail,47,22,8,16,31
40,Success,51,28,0,10,41
40,Success,55,20,0,12,43
40,Fail,44,35,0,12,32
40,Success,53,26,0,12,41
40,Fail,51,28,0,12,39
40,Fail,40,29,2,20,20
40,Success,50,28,6,9,41
40,Fail,45,24,1,15,30
40,Success,51,27,4,11,40
40,Fail,50,25,0,12,38
40,Fail,47,21,1,19,28
40,Fail,41,32,11,9,32
40,Fail,51,25,0,13,38
40,Fail,47,23,5,14,33
40,Fail,50,23,2,15,35
40,Fail,45,32,0,16,29
40,Fail,48,36,0,9,39
40,Fail,49,25,0,15,34
40,Fail,44,26,0,15,29
40,Fail,43,28,8,10,33
40,Fail,53,22,0,14,39
40,Fail,50,27,0,17,33
40,Fail,47,29,0,15,32
40,Fail,49,23,6,15,34
40,Fail,44,28,0,16,28
40,Fail,36,41,0,12,24
40,Success,50,30,0,7,43
40,Fail,47,19,10,18,29
40,Fail,47,23,1,15,32
40,Fail,47,30,0,10,37
40,Success,50,30,0,10,40
40,Fail,49,26,0,16,33
40,Fail,41,30,0,20,21
40,Fail,48,28,5,10,38
40,Fail,46,33,0,9,37
40,Fail,40,31,10,13,27
40,Fail,49,34,0,12,37
40,Fail,46,24,3,11,35
40,Fail,51,27,0,12,39
40,Fail,49,31,0,11,38
40,Fail,46,27,6,12,34
40,Fail,44,32,0,13,31
40,Fail,49,20,0,18,31
40,Fail,41,36,0,17,24
40,Fail,50,24,6,11,39
40,Fail,53,22,0,14,39
40,Success,56,29,0,9,47
40,Success,53,32,0,7,46
40,Success,58,19,1,10,48
40,Fail,43,30,0,15,28
40,Fail,50,21,1,12,38
40,Fail,46,28,6,13,33
40,Fail,43,29,2,16,27
40,Fail,44,34,0,13,31
40,Success,53,19,2,12,41
40,Success,47,32,0,7,40
40,Fail,50,24,0,15,35
40,Fail,46,28,0,20,26
40,Success,53,24,4,13,40
40,Success,51,30,1,6,45
40,Success,54,24,1,9,45
40,Fail,49,19,0,18,31
40,Success,57,20,0,8,49
40,Fail,48,26,0,14,34
40,Fail,52,22,0,15,37
40,Fail,50,25,0,16,34
40,Fail,50,21,0,16,34
40,Fail,43,29,5,13,30
40,Fail,48,35,0,11,37
40,Fail,47,26,3,17,30
40,Fail,48,33,0,10,38
40,Fail,49,25,0,14,35
40,Success,53,23,7,8,45
40,Fail,48,25,4,11,37
40,Success,51,31,0,10,41
40,Fail,51,22,6,12,39
40,Success,50,28,3,10,40
40,Success,54,32,0,7,47
40,Fail,46,23,5,10,36
40,Fail,47,32,0,10,37
40,Fail,51,19,2,16,35
40,Fail,48,20,1,15,33
40,Fail,43,26,0,22,21
40,Fail,39,31,0,17,22
40,Fail,51,26,0,12,39
40,Success,53,21,2,12,41
40,Fail,41,39,0,7,34
40,Fail,48,24,0,17,31
40,Fail,42,26,11,16,26
40,Fail,48,17,7,21,27
40,Fail,42,32,0,20,22
40,Fail,44,38,0,9,35
40,Fail,40,30,0,17,23
40,Fail,46,21,4,17,29
40,Fail,45,26,5,14,31
40,Success,49,27,1,6,43
40,Success,56,24,0,9,47
40,Success,48,32,5,8,40
40,Fail,47,23,3,13,34
40,Fail,44,32,0,13,31
40,Fail,45,29,0,12,33
40,Fail,48,29,0,10,38
40,Fail,45,34,0,10,35
40,Fail,48,24,4,11,37
40,Success,55,17,0,15,40
40,Fail,46,26,1,12,34
40,Success,52,27,0,7,45
40,Success,54,14,7,12,42
40,Success,52,24,0,12,40
40,Fail,43,27,3,15,28
40,Fail,45,33,0,13,32
40,Success,49,32,0,9,40
40,Fail,47,21,0,19,28
40,Fail,44,34,5,8,36
40,Fail,46,36,4,9,37
40,Fail,46,26,1,15,31
40,Success,52,24,1,9,43
40,Success,51,26,5,7,44
40,Fail,50,21,0,12,38
40,Success,51,26,0,11,40
40,Fail,49,26,1,16,33
40,Fail,47,21,6,19,28
40,Fail,47,30,0,13,34
40,Fail,47,19,1,20,27
40,Success,53,28,1,6,47
40,Fail,44,34,0,13,31
40,Fail,44,34,0,11,33
40,Fail,46,32,0,10,36
40,Fail,43,32,1,15,28
40,Fail,46,31,0,11,35
40,Success,47,29,7,7,40
40,Fail,47,27,0,14,33
40,Fail,44,27,0,15,29
40,Fail,49,21,0,17,32
40,Fail,49,26,0,10,39
40,Success,51,19,5,11,40
40,Fail,45,31,1,15,30
40,Fail,46,24,11,9,37
40,Success,57,20,6,7,50
40,Fail,43,24,7,15,28
40,Success,51,28,2,10,41
40,Fail,49,25,0,15,34
40,Success,51,25,5,10,41
40,Fail,44,35,0,11,33
40,Fail,51,24,1,14,37
40,Fail,45,24,2,17,28
40,Fail,43,30,0,19,24
40,Success,58,19,0,12,46
40,Fail,50,23,0,16,34
40,Fail,48,28,0,14,34
40,Success,52,31,0,10,42
40,Fail,52,27,0,14,38
40,Fail,50,27,0,12,38
40,Fail,54,19,0,19,35
40,Fail,50,23,1,14,36
40,Success,53,22,0,12,41
40,Fail,51,19,4,16,35
40,Fail,52,26,0,14,38
40,Fail,41,38,0,13,28
40,Fail,49,25,2,15,34
40,Fail,42,30,5,15,27
40,Success,54,21,1,11,43
40,Fail,45,28,0,16,29
40,Fail,49,28,0,13,36
40,Fail,45,32,0,15,30
40,Fail,48,26,3,13,35
40,Success,52,22,5,8,44
40,Fail,43,27,4,17,26
40,Fail,47,23,1,15,32
40,Fail,44,30,1,11,33
40,Fail,40,41,0,8,32
40,Fail,47,36,0,9,38
40,Fail,45,20,11,14,31
40,Success,59,23,0,10,49
40,Fail,48,27,0,11,37
40,Fail,46,27,0,18,28
40,Fail,52,22,0,16,36
40,Fail,42,34,0,16,26
40,Fail,46,31,0,11,35
40,Fail,48,26,7,11,37
40,Fail,42,37,0,14,28
40,Fail,48,26,5,11,37
40,Fail,44,37,0,11,33
40,Fail,51,22,8,12,39
40,Fail,49,27,0,14,35
40,Fail,45,25,0,19,26
40,Fail,48,27,0,14,34
40,Fail,52,22,4,15,37
40,Fail,49,16,6,20,29
40,Fail,46,22,8,14,32
40,Success,55,24,2,8,47
40,Fail,52,16,7,13,39
40,Fail,51,21,0,15,36
40,Fail,37,24,15,16,21
40,Fail,52,21,2,13,39
40,Success,52,23,0,12,40
40,Fail,50,21,5,11,39
40,Fail,42,36,0,13,29
40,Fail,45,32,4,10,35
40,Success,52,28,0,10,42
40,Fail,41,34,0,17,24
40,Fail,45,25,0,16,29
40,Fail,50,24,0,14,36
40,Success,54,23,2,12,42
40,Fail,42,31,0,16,26
40,Fail,46,29,1,10,36
40,Fail,49,26,0,15,34
40,Success,55,21,11,6,49
40,Fail,40,42,0,13,27
40,Fail,39,27,9,18,21
40,Success,54,18,6,11,43
40,Fail,44,27,1,21,23
40,Fail,38,35,0,17,21
40,Fail,47,29,0,9,38
40,Fail,49,19,11,17,32
40,Fail,47,24,5,16,31
40,Success,53,29,0,10,43
40,Fail,39,40,0,14,25
40,Fail,50,23,1,13,37
40,Fail,46,25,5,10,36
40,Fail,47,26,0,15,32
40,Fail,43,24,2,16,27
40,Fail,47,30,0,14,33
40,Fail,49,28,0,13,36
40,Success,52,27,0,8,44
40,Fail,44,32,4,10,34
40,Fail,44,27,0,21,23
40,Fail,49,24,3,13,36
40,Success,57,13,1,13,44
40,Fail,45,20,9,12,33
40,Fail,42,36,0,16,26
40,Fail,44,26,0,19,25
40,Fail,46,24,0,19,27
40,Fail,43,34,0,12,31
40,Success,56,20,1,9,47
40,Success,55,17,6,12,43
40,Success,52,19,7,12,40
40,Fail,45,36,4,9,36
40,Fail,51,22,0,13,38
40,Success,55,24,0,8,47
40,Success,53,29,0,11,42
40,Fail,46,23,5,17,29
40,Fail,50,28,0,16,34
40,Fail,46,27,4,11,35
40,Fail,49,32,0,11,38
40,Success,51,28,0,7,44
40,Success,53,24,0,13,40
40,Fail,42,27,1,19,23
40,Fail,48,20,13,10,38
40,Fail,45,29,2,11,34
40,Success,49,30,0,8,41
40,Success,52,25,0,11,41
40,Fail,46,32,0,14,32
40,Success,51,24,4,10,41
40,Fail,43,32,0,15,28
40,Fail,39,34,0,18,21
40,Fail,45,36,0,8,37
40,Success,53,21,0,11,42
40,Success,50,27,4,8,42
40,Fail,46,31,0,11,35
40,Success,51,23,7,7,44
40,Success,49,28,5,9,40
40,Fail,47,27,0,15,32
40,Fail,40,37,0,18,22
40,Success,55,23,0,12,43
40,Success,54,16,9,12,42
40,Fail,49,22,4,15,34
40,Success,52,27,5,3,49
40,Fail,47,21,5,16,31
40,Success,50,25,4,9,41
40,Success,54,25,1,8,46
40,Success,53,20,4,13,40
40,Success,55,26,0,11,44
40,Success,55,23,0,12,43
40,Fail,41,35,0,16,25
40,Success,54,28,0,10,44
40,Success,53,25,6,10,43
40,Fail,47,33,0,10,37
40,Success,55,19,0,12,43
40,Fail,41,38,0,12,29
40,Success,55,26,0,7,48
40,Fail,45,26,10,11,34
40,Fail,40,27,3,18,22
40,Fail,44,30,0,16,28
40,Success,54,22,1,11,43
40,Fail,49,27,1,14,35
40,Fail,41,35,0,13,28
40,Fail,45,31,0,14,31
40,Success,53,18,3,12,41
40,Success,54,31,0,8,46
40,Fail,41,45,0,9,32
40,Fail,43,33,0,14,29
40,Fail,44,31,4,11,33
40,Fail,43,29,0,19,24
40,Success,50,29,0,10,40
40,Success,53,17,4,12,41
40,Success,50,30,0,9,41
40,Fail,46,34,0,12,34
40,Fail,45,34,0,9,36
40,Success,55,20,3,9,46
40,Fail,46,29,5,14,32
40,Fail,43,36,0,10,33
40,Success,52,26,2,8,44
40,Fail,49,21,11,11,38
40,Success,58,16,0,11,47
40,Fail,46,25,6,11,35
40,Success,49,29,7,9,40
40,Fail,42,32,1,11,31
40,Fail,45,27,5,11,34
40,Fail,44,25,7,15,29
40,Fail,45,36,0,11,34
40,Fail,47,36,0,10,37
40,Success,53,29,0,8,45
40,Success,55,20,2,13,42
40,Fail,40,39,0,12,28
40,Fail,41,24,7,20,21
40,Fail,49,24,1,12,37
40,Fail,37,26,12,21,16
40,Success,52,21,0,11,41
40,Fail,42,33,0,17,25
40,Success,57,23,0,6,51
40,Fail,43,30,3,12,31
40,Fail,49,24,0,15,34
40,Fail,46,29,2,11,35
40,Fail,46,29,0,16,30
40,Fail,48,21,2,14,34
40,Success,54,19,4,7,47
40,Fail,51,25,0,16,35
40,Fail,49,24,5,11,38
40,Success,53,23,1,9,44
40,Success,54,23,1,8,46
40,Fail,44,26,6,14,30
40,Success,53,22,1,10,43
40,Fail,45,26,5,14,31
40,Success,59,18,0,10,49
40,Success,53,21,3,11,42
40,Success,48,26,5,8,40
40,Fail,44,29,3,14,30
40,Fail,47,29,0,14,33
40,Success,51,33,0,8,43
40,Success,52,23,7,12,40
40,Success,48,32,2,8,40
40,Fail,51,24,0,15,36
40,Fail,46,31,2,11,35
40,Success,52,27,4,10,42
40,Fail,48,30,0,13,35
40,Fail,47,31,0,8,39
40,Fail,44,25,5,17,27
40,Fail,42,26,0,18,24
40,Fail,49,29,0,11,38
40,Fail,54,21,0,16,38
40,Fail,52,28,0,13,39
40,Fail,47,30,3,9,38
40,Fail,46,17,7,16,30
40,Success,50,22,12,8,42
40,Fail,47,26,1,15,32
40,Fail,49,27,1,13,36
40,Fail,48,32,0,9,39
40,Fail,44,33,5,11,33
40,Fail,39,38,0,14,25
40,Fail,38,28,7,18,20
40,Success,53,27,0,6,47
40,Fail,49,30,0,13,36
40,Success,56,21,1,12,44
40,Success,53,24,0,10,43
40,Fail,40,37,0,18,22
40,Fail,49,25,0,18,31
40,Fail,39,28,10,17,22
40,Fail,46,24,11,12,34
40,Fail,47,23,6,14,33
40,Fail,40,27,0,22,18
40,Fail,46,28,0,14,32
40,Fail,51,21,4,17,34
40,Fail,47,32,0,9,38
40,Fail,45,35,0,11,34
40,Fail,43,30,5,12,31
40,Fail,44,30,2,17,27
40,Success,60,21,1,7,53
40,Fail,45,29,3,15,30
40,Fail,46,30,0,16,30
40,Success,50,30,1,10,40
40,Fail,46,28,0,14,32
40,Success,54,25,0,13,41
40,Success,52,27,0,10,42
40,Fail,44,36,0,8,36
40,Fail,45,33,3,11,34
40,Success,52,25,0,12,40
40,Success,53,18,3,9,44
40,Success,57,20,2,10,47
40,Fail,42,36,0,12,30
40,Fail,48,23,0,17,31
40,Fail,49,24,7,10,39
40,Fail,30,36,7,15,15
40,Fail,46,32,0,12,34
40,Fail,50,26,0,12,38
40,Fail,46,26,3,10,36
40,Fail,41,40,0,11,30
40,Success,52,25,5,10,42
40,Fail,41,33,0,13,28
40,Success,59,18,0,7,52
40,Fail,44,32,1,12,32
40,Success,49,31,0,7,42
40,Fail,40,28,7,18,22
40,Fail,50,23,6,11,39
40,Success,56,18,6,10,46
40,Success,54,23,0,13,41
40,Success,57,19,0,12,45
40,Fail,47,31,1,12,35
40,Fail,48,20,0,18,30
40,Success,49,28,0,9,40
40,Fail,46,28,0,21,25
40,Fail,50,19,3,16,34
40,Fail,47,30,0,9,38
40,Fail,52,25,2,14,38
40,Success,46,33,0,6,40
40,Fail,43,30,1,17,26
40,Success,50,31,0,8,42
40,Fail,46,27,2,14,32
40,Fail,41,32,5,12,29
40,Success,51,24,0,10,41
40,Fail,45,28,3,15,30
40,Fail,49,21,8,11,38
40,Fail,35,32,5,17,18
40,Fail,45,29,4,12,33
40,Fail,49,22,11,11,38
40,Success,51,28,0,9,42
40,Success,51,32,0,6,45
40,Fail,43,32,10,8,35
40,Fail,48,27,0,11,37
40,Success,51,29,1,8,43
40,Fail,41,30,8,12,29
40,Fail,43,26,3,19,24
40,Success,55,22,0,9,46
40,Fail,45,28,0,20,25
40,Fail,45,35,0,7,38
40,Fail,42,33,0,13,29
40,Fail,48,31,0,10,38
40,Success,52,31,0,7,45
40,Fail,47,32,4,8,39
40,Fail,47,26,8,10,37
40,Fail,43,30,0,15,28
40,Fail,46,19,0,21,25
40,Success,52,18,4,11,41
40,Fail,49,35,0,13,36
40,Fail,47,24,1,17,30
40,Fail,49,27,0,11,38
40,Fail,45,32,0,13,32
40,Fail,42,37,0,13,29
40,Success,54,26,0,6,48
40,Success,51,28,7,5,46
40,Fail,45,27,0,17,28
40,Fail,52,23,1,13,39
40,Fail,46,30,0,10,36
40,Fail,45,25,3,17,28
40,Success,52,24,4,8,44
40,Fail,52,27,0,14,38
40,Success,57,21,0,13,44
40,Fail,46,25,5,8,38
40,Fail,51,23,0,15,36
40,Fail,39,29,9,16,23
40,Fail,41,33,0,17,24
40,Success,55,21,0,14,41
40,Success,48,30,1,7,41
40,Success,55,22,0,12,43
40,Fail,48,26,0,13,35
40,Success,55,19,0,14,41
40,Success,55,22,0,15,40
40,Fail,45,28,6,12,33
40,Success,52,20,4,12,40
40,Fail,46,27,0,14,32
40,Fail,42,36,0,13,29
40,Fail,51,23,1,12,39
40,Success,51,24,5,11,40
40,Fail,43,22,0,24,19
40,Fail,52,26,0,13,39
40,Fail,51,25,0,14,37
40,Success,53,21,2,12,41
40,Fail,46,37,0,7,39
40,Fail,44,29,5,13,31
40,Fail,50,27,0,12,38
40,Fail,49,27,0,13,36
40,Fail,48,26,0,13,35
40,Fail,48,31,0,14,34
40,Fail,42,32,0,13,29
40,Fail,45,35,0,10,35
40,Success,52,21,12,8,44
40,Fail,45,37,0,12,33
40,Fail,49,29,0,13,36
40,Fail,42,27,10,14,28
40,Fail,51,24,0,14,37
40,Fail,49,26,0,14,35
40,Fail,50,29,0,13,37
40,Fail,43,35,0,14,29
40,Success,56,20,0,13,43
40,Fail,47,30,0,12,35
40,Success,53,28,0,12,41
40,Fail,51,25,3,12,39
40,Fail,47,34,0,10,37
40,Fail,46,29,0,17,29
40,Fail,46,33,0,11,35
40,Success,51,32,0,8,43
40,Fail,43,34,6,12,31
40,Fail,47,24,8,8,39
40,Fail,50,27,0,16,34
40,Fail,44,24,2,16,28
40,Fail,47,29,0,14,33
40,Fail,47,33,0,9,38
40,Fail,49,27,9,11,38
40,Success,51,25,0,10,41
40,Fail,49,25,0,14,35
40,Fail,48,23,0,15,33
40,Success,55,20,0,14,41
40,Success,52,26,0,9,43
40,Fail,41,35,0,15,26
40,Success,53,30,0,4,49
40,Fail,48,23,0,17,31
40,Success,52,30,0,11,41
40,Fail,47,30,0,11,36
40,Fail,46,27,0,11,35
40,Fail,45,35,0,12,33
40,Success,57,21,3,6,51
40,Success,48,36,0,7,41
40,Fail,51,26,0,13,38
40,Success,51,27,0,10,41
40,Fail,50,26,0,13,37
40,Fail,44,35,0,9,35
40,Success,49,32,1,9,40
40,Fail,51,24,0,14,37
40,Fail,46,23,14,10,36
40,Fail,48,33,0,9,39
40,Success,55,26,0,9,46
40,Fail,39,24,11,18,21
40,Success,52,25,6,8,44
40,Fail,37,44,0,9,28
40,Fail,41,28,8,14,27
40,Fail,40,31,1,18,22
40,Fail,48,22,2,14,34
40,Fail,48,25,6,11,37
40,Fail,44,34,5,8,36
40,Fail,49,27,0,12,37
40,Fail,46,28,2,11,35
40,Fail,41,31,0,19,22
40,Fail,45,29,0,15,30
40,Fail,48,30,0,11,37
40,Fail,49,23,1,10,39
40,Fail,40,26,2,16,24
40,Success,56,19,3,13,43
40,Fail,48,30,0,11,37
40,Fail,39,37,0,18,21
40,Fail,46,29,6,11,35
40,Success,54,20,4,10,44
40,Fail,51,23,2,12,39
40,Fail,46,30,0,13,33
40,Success,57,22,0,11,46
40,Fail,48,28,0,11,37
40,Fail,51,26,0,15,36
40,Fail,47,28,0,16,31
40,Fail,46,28,0,12,34
40,Success,60,16,3,13,47
40,Fail,44,29,0,16,28
40,Fail,41,28,0,22,19
40,Fail,48,30,5,13,35
40,Success,56,24,0,10,46
40,Fail,48,27,0,13,35
40,Fail,48,18,4,19,29
40,Fail,44,24,3,15,29
40,Fail,50,25,3,11,39
40,Fail,44,39,0,7,37
40,Fail,34,36,0,18,16
40,Fail,44,28,3,18,26
40,Success,51,27,3,4,47
40,Fail,37,32,7,18,19
40,Success,51,26,0,11,40
40,Fail,40,35,0,15,25
40,Success,52,27,4,8,44
40,Fail,49,28,5,11,38
40,Success,57,16,3,14,43
40,Success,53,23,1,8,45
40,Fail,50,24,0,16,34
40,Fail,43,36,0,16,27
40,Fail,41,27,10,13,28
40,Fail,42,33,0,11,31
40,Fail,40,36,0,14,26
40,Fail,47,25,7,13,34
40,Success,49,30,0,8,41
40,Fail,45,32,0,17,28
40,Fail,39,32,15,8,31
40,Fail,43,29,8,12,31
40,Fail,50,30,0,11,39
40,Success,54,18,5,14,40
40,Fail,42,31,0,14,28
40,Fail,48,28,0,13,35
40,Fail,49,24,0,13,36
40,Success,50,33,2,3,47
40,Fail,51,17,8,12,39
40,Fail,40,40,0,14,26
40,Success,52,23,1,10,42
40,Fail,52,20,4,13,39
40,Success,54,32,0,4,50
40,Success,51,27,1,9,42
40,Fail,48,22,5,13,35
40,Fail,45,36,0,10,35
40,Fail,53,22,0,14,39
40,Success,52,23,1,10,42
40,Fail,39,28,7,13,26
40,Success,53,28,3,7,46
40,Success,58,20,1,10,48
40,Fail,37,38,2,12,25
40,Fail,46,29,0,15,31
40,Fail,50,18,10,14,36
40,Fail,48,27,0,16,32
40,Fail,45,29,9,10,35
40,Fail,44,22,6,17,27
40,Fail,49,27,6,10,39
40,Success,52,25,2,10,42
40,Fail,48,27,1,11,37
40,Fail,44,33,0,10,34
40,Fail,50,27,1,11,39
40,Fail,48,23,2,17,31
40,Fail,49,24,6,10,39
40,Success,55,25,0,12,43
40,Fail,48,28,0,13,35
40,Fail,42,39,0,13,29
40,Fail,47,23,3,10,37
40,Success,48,28,5,8,40
40,Fail,50,24,0,11,39
40,Fail,42,30,0,19,23
40,Fail,50,26,0,13,37
40,Success,56,23,0,10,46
40,Fail,48,31,3,9,39
40,Success,56,23,0,10,46
40,Fail,45,33,6,7,38
40,Fail,43,28,0,19,24
40,Fail,48,29,2,14,34
40,Fail,42,28,5,16,26
40,Fail,48,21,5,15,33
40,Fail,43,33,4,12,31
40,Fail,46,23,1,20,26
40,Fail,49,26,0,20,29
40,Fail,43,30,9,13,30
40,Fail,51,25,0,17,34
40,Fail,49,25,0,14,35
40,Fail,41,37,0,15,26
40,Success,53,32,0,5,48
40,Success,56,21,2,9,47
40,Fail,45,26,0,19,26
40,Success,51,30,0,9,42
40,Fail,47,25,7,9,38
40,Fail,51,24,4,14,37
40,Fail,40,31,3,15,25
40,Success,51,23,1,11,40
40,Fail,48,32,5,10,38
40,Fail,44,20,6,19,25
40,Fail,43,38,0,12,31
40,Fail,48,24,4,17,31
40,Fail,46,23,8,13,33
40,Fail,44,22,8,12,32
40,Fail,45,29,9,7,38
40,Success,55,25,4,7,48
40,Fail,45,30,0,15,30
40,Fail,51,22,5,15,36
40,Success,58,16,1,11,47
40,Fail,50,21,0,12,38
40,Fail,46,31,0,11,35
40,Fail,49,18,9,12,37
40,Success,53,22,0,12,41
40,Fail,39,24,11,17,22
40,Success,54,25,0,7,47
40,Fail,48,23,9,13,35
40,Success,53,23,1,10,43
40,Fail,45,26,7,12,33
40,Fail,49,32,0,11,38
40,Fail,45,27,0,17,28
40,Fail,48,26,1,11,37
40,Fail,47,22,4,16,31
40,Fail,42,24,4,17,25
40,Success,55,24,1,7,48
40,Fail,42,32,3,12,30
40,Fail,45,35,0,10,35
40,Fail,49,24,4,14,35
40,Fail,44,40,0,8,36
40,Fail,49,23,1,16,33
40,Fail,43,30,2,13,30
40,Fail,46,26,0,15,31
40,Success,52,27,1,7,45
40,Fail,48,21,0,16,32
40,Fail,45,30,0,13,32
40,Success,51,23,1,11,40
40,Success,49,32,0,9,40
40,Success,52,23,1,11,41
40,Fail,47,28,2,12,35
40,Success,53,21,3,10,43
40,Fail,52,22,3,15,37
40,Success,60,18,2,11,49
40,Success,51,22,3,11,40
40,Fail,52,17,4,14,38
40,Success,50,29,0,10,40
40,Success,53,23,0,12,41
40,Fail,44,41,0,8,36
40,Fail,41,32,1,15,26
40,Fail,45,32,0,11,34
40,Success,54,28,1,5,49
40,Fail,45,31,7,10,35
40,Fail,48,22,4,15,33
40,Fail,41,27,5,21,20
40,Success,52,31,0,9,43
40,Success,47,39,0,7,40
40,Fail,42,35,0,15,27
40,Success,56,22,0,13,43
40,Success,53,24,0,12,41
40,Success,54,26,2,7,47
40,Fail,44,23,8,15,29
40,Fail,45,31,2,9,36
40,Fail,44,20,2,15,29
40,Success,55,16,0,14,41
40,Success,54,22,0,11,43
40,Fail,45,26,3,13,32
40,Success,52,23,3,10,42
40,Fail,45,30,2,11,34
40,Fail,45,24,4,13,32
40,Success,54,21,0,12,42
40,Success,50,24,8,10,40
40,Fail,52,20,0,18,34
40,Fail,49,26,2,13,36
40,Success,54,30,0,10,44
40,Fail,42,30,0,17,25
40,Fail,40,28,3,17,23
40,Fail,50,20,5,16,34
40,Fail,48,28,2,13,35
40,Fail,43,36,0,12,31
40,Fail,43,25,1,15,28
40,Fail,47,24,0,19,28
40,Fail,46,34,0,12,34
40,Fail,47,20,7,16,31
40,Fail,50,23,0,17,33
40,Fail,50,22,0,13,37
40,Success,58,19,2,5,53
40,Fail,50,25,3,11,39
40,Fail,49,27,5,10,39
40,Fail,45,27,7,11,34
40,Fail,46,29,3,10,36
40,Fail,48,28,2,14,34
40,Fail,42,25,7,14,28
40,Fail,47,26,2,15,32
40,Fail,46,31,8,7,39
40,Fail,45,30,0,19,26
40,Fail,40,43,0,8,32
40,Fail,48,26,0,16,32
40,Fail,50,25,0,15,35
40,Fail,47,26,8,11,36
40,Fail,51,25,3,12,39
40,Fail,46,30,4,7,39
40,Success,52,23,1,11,41
40,Success,50,29,0,9,41
40,Success,54,24,0,11,43
40,Success,54,28,0,9,45
40,Fail,39,32,9,9,30
40,Fail,48,21,0,16,32
40,Fail,49,19,4,15,34
40,Fail,52,20,5,16,36
40,Fail,50,21,0,14,36
40,Fail,49,22,6,11,38
40,Success,53,24,4,12,41
40,Fail,50,21,3,16,34
40,Fail,43,33,3,12,31
40,Fail,48,29,0,13,35
40,Fail,53,25,0,14,39
40,Fail,47,27,0,18,29
40,Fail,43,24,7,13,30
40,Fail,47,31,0,11,36
40,Fail,44,26,5,11,33
40,Success,49,35,0,9,40
40,Fail,53,22,0,14,39
40,Fail,40,36,0,11,29
40,Fail,48,29,0,14,34
40,Fail,45,27,0,15,30
40,Fail,49,27,0,15,34
40,Fail,49,23,2,12,37
40,Fail,51,22,0,15,36
40,Fail,46,34,0,12,34
40,Success,49,27,4,8,41
40,Fail,48,26,0,12,36
40,Success,55,21,0,15,40
40,Fail,42,28,3,16,26
40,Fail,43,33,5,10,33
40,Fail,47,26,0,17,30
40,Fail,42,43,0,10,32
40,Fail,47,25,0,18,29
40,Fail,40,37,5,12,28
40,Fail,49,30,4,10,39
40,Fail,42,24,4,20,22
40,Fail,39,34,0,17,22
40,Fail,48,27,5,9,39
40,Fail,42,26,0,20,22
40,Success,59,19,0,11,48
40,Fail,50,26,0,11,39
40,Success,52,31,0,6,46
40,Fail,50,23,0,14,36
40,Fail,45,30,0,16,29
40,Success,56,22,2,11,45
40,Fail,40,35,7,12,28
40,Fail,49,21,8,13,36
40,Success,51,27,2,7,44
40,Fail,49,22,1,15,34
40,Fail,44,31,0,17,27
40,Fail,44,21,6,14,30
40,Fail,39,36,0,21,18
40,Success,52,23,1,10,42
40,Fail,46,29,0,15,31
40,Fail,49,26,0,15,34
40,Success,54,25,0,12,42
40,Fail,49,21,4,15,34
40,Fail,45,32,0,11,34
40,Success,57,19,0,11,46
40,Fail,46,27,0,17,29
40,Fail,48,26,0,16,32
40,Fail,49,28,0,13,36
40,Fail,48,23,0,15,33
40,Fail,47,24,2,18,29
40,Fail,47,28,0,11,36
40,Fail,52,21,1,14,38
40,Fail,45,28,0,16,29
40,Success,51,25,0,11,40
40,Fail,41,31,0,17,24
40,Fail,48,23,8,11,37
40,Fail,53,22,0,17,36
40,Fail,49,19,12,15,34
40,Fail,48,25,3,13,35
40,Success,51,22,7,9,42
40,Success,46,30,12,4,42
40,Success,53,25,0,10,43
40,Fail,46,33,0,9,37
40,Fail,40,29,3,16,24
40,Fail,35,35,13,11,24
40,Fail,32,35,7,17,15
40,Fail,52,22,0,14,38
40,Fail,44,33,4,11,33
40,Fail,52,27,0,14,38
40,Fail,50,19,9,14,36
40,Fail,45,25,1,16,29
40,Success,54,24,0,11,43
40,Fail,49,29,0,11,38
40,Success,51,28,1,10,41
40,Success,52,24,4,8,44
40,Fail,44,27,4,14,30
40,Success,54,19,4,12,42
40,Success,54,26,2,10,44
40,Fail,49,26,0,14,35
40,Fail,52,24,0,14,38
40,Fail,45,32,0,9,36
40,Fail,52,25,0,13,39
40,Success,61,19,1,9,52
40,Fail,46,29,4,13,33
40,Fail,45,32,0,13,32
40,Fail,48,26,0,14,34
40,Fail,46,29,4,12,34
40,Fail,51,20,4,12,39
40,Fail,42,41,0,10,32
40,Fail,46,25,5,17,29
40,Fail,45,18,1,18,27
40,Fail,44,36,0,12,32
40,Fail,49,31,0,11,38
40,Success,52,27,2,9,43
40,Fail,46,28,0,16,30
40,Fail,46,22,1,20,26
40,Fail,45,30,0,15,30
40,Fail,54,17,1,16,38
40,Success,52,22,1,12,40
40,Fail,44,23,8,13,31
40,Fail,45,28,0,11,34
40,Fail,44,29,10,8,36
40,Fail,49,21,1,17,32
40,Success,54,23,0,13,41
40,Fail,43,28,3,16,27
40,Fail,42,34,0,15,27
40,Fail,51,22,1,14,37
40,Fail,49,29,1,10,39
40,Success,53,24,0,13,40
40,Fail,52,24,0,16,36
40,Fail,43,25,3,19,24
40,Fail,50,26,0,11,39
40,Fail,44,29,12,9,35
40,Fail,47,33,3,8,39
40,Fail,49,34,0,10,39
40,Fail,51,28,0,12,39
40,Success,52,26,0,11,41
40,Fail,47,23,7,16,31
40,Fail,46,32,0,10,36
40,Success,51,31,0,10,41
40,Fail,46,30,3,14,32
40,Success,55,21,1,12,43
40,Fail,44,32,4,10,34
40,Success,54,19,0,14,40
40,Success,51,27,0,10,41
40,Fail,45,28,4,13,32
40,Fail,42,34,0,12,30
40,Fail,37,33,0,21,16
40,Fail,45,28,0,16,29
40,Fail,49,27,0,13,36
40,Fail,47,31,0,10,37
40,Fail,48,28,0,12,36
40,Fail,45,32,0,12,33
40,Fail,48,28,0,13,35
40,Fail,48,25,0,14,34
40,Success,60,22,0,9,51
40,Fail,42,30,0,17,25
40,Fail,50,20,0,15,35
40,Success,52,24,0,12,40
40,Fail,44,31,0,16,28
40,Fail,46,27,0,15,31
40,Fail,41,29,7,16,25
40,Fail,47,28,0,15,32
40,Fail,42,28,6,15,27
40,Success,49,32,0,8,41
40,Fail,48,32,0,12,36
40,Fail,47,23,9,11,36
40,Fail,48,32,1,10,38
40,Fail,47,26,4,13,34
40,Success,48,24,15,7,41
40,Success,54,25,0,7,47
40,Success,55,16,7,13,42
40,Success,50,32,0,10,40
40,Fail,46,33,0,12,34
40,Fail,47,21,5,15,32
40,Fail,53,20,1,14,39
40,Fail,45,25,7,15,30
40,Fail,47,23,2,19,28
40,Fail,52,24,2,14,38
40,Fail,49,22,3,13,36
40,Success,51,26,0,10,41
40,Fail,49,26,1,11,38
40,Fail,41,40,0,14,27
40,Fail,44,29,3,11,33
40,Fail,52,22,1,13,39
40,Fail,48,35,0,12,36
40,Fail,48,24,6,13,35
40,Fail,46,31,4,8,38
40,Fail,48,29,1,14,34
40,Fail,44,29,0,15,29
40,Success,55,23,3,8,47
40,Success,51,24,1,9,42
40,Fail,51,23,0,16,35
40,Success,55,19,3,14,41
40,Fail,50,24,3,15,35
40,Fail,48,31,0,12,36
40,Fail,50,23,0,17,33
40,Fail,50,25,0,12,38
40,Fail,48,27,0,13,35
40,Fail,47,29,0,15,32
40,Success,51,31,0,6,45
40,Success,49,33,0,9,40
40,Fail,49,19,0,17,32
40,Fail,51,25,0,13,38
40,Fail,45,32,8,6,39
40,Success,52,23,0,12,40
40,Fail,48,25,4,15,33
40,Fail,49,22,1,13,36
40,Fail,49,32,0,11,38
40,Fail,48,31,0,11,37
40,Fail,43,38,0,11,32
40,Success,49,33,0,8,41
40,Fail,50,24,0,14,36
40,Fail,43,36,0,14,29
40,Fail,53,28,0,14,39
40,Fail,47,33,0,11,36
40,Success,51,30,0,7,44
40,Fail,46,28,0,11,35
40,Fail,45,27,0,18,27
40,Fail,47,31,0,12,35
40,Success,61,18,0,7,54
40,Success,56,28,0,6,50
40,Fail,36,33,8,16,20
40,Success,58,18,0,13,45
40,Success,56,23,0,7,49
40,Fail,40,28,3,17,23
40,Fail,48,29,0,12,36
40,Success,56,21,0,11,45
40,Fail,48,29,0,14,34
40,Success,48,27,5,8,40
40,Success,52,30,0,10,42
40,Fail,38,27,7,19,19
40,Fail,46,30,0,14,32
40,Success,52,23,1,11,41
40,Fail,39,39,0,14,25
40,Success,52,29,0,8,44
40,Fail,48,28,0,11,37
40,Success,53,24,1,11,42
40,Fail,45,28,1,13,32
40,Success,52,30,0,7,45
40,Fail,39,47,0,9,30
40,Fail,42,26,4,15,27
40,Success,58,20,0,11,47
40,Fail,44,26,9,15,29
40,Fail,45,33,0,12,33
40,Fail,48,31,0,9,39
40,Fail,39,27,3,18,21
40,Fail,46,31,0,13,33
40,Success,49,25,7,9,40
40,Fail,49,24,2,11,38
40,Fail,47,24,8,11,36
40,Success,52,25,4,10,42
40,Fail,49,25,0,19,30
40,Fail,50,30,0,13,37
40,Fail,46,32,0,10,36
40,Fail,50,29,0,11,39
40,Fail,49,23,5,10,39
40,Fail,43,28,4,16,27
40,Success,52,28,0,11,41
40,Fail,46,26,0,15,31
40,Fail,44,27,9,10,34
40,Fail,50,25,0,13,37
40,Fail,42,27,3,13,29
40,Fail,49,23,0,15,34
40,Success,51,29,0,9,42
40,Success,53,22,1,9,44
40,Fail,48,21,5,13,35
40,Fail,50,22,4,11,39
40,Success,56,29,0,6,50
40,Fail,44,32,8,9,35
40,Fail,43,37,0,12,31
40,Success,54,27,0,10,44
40,Success,50,22,6,9,41
40,Fail,46,30,2,13,33
40,Fail,47,25,6,12,35
40,Fail,45,32,0,10,35
40,Fail,47,23,3,15,32
40,Fail,48,22,0,15,33
40,Fail,44,29,8,9,35
40,Fail,48,20,0,21,27
40,Fail,41,36,0,17,24
40,Success,54,24,1,10,44
40,Fail,41,34,0,10,31
40,Success,53,25,0,10,43
40,Success,51,27,1,10,41
40,Success,52,36,0,3,49
40,Fail,42,32,0,18,24
40,Success,59,18,0,9,50
40,Success,56,26,0,8,48
40,Success,49,29,0,8,41
40,Fail,46,35,0,10,36
40,Fail,51,21,1,16,35
40,Fail,44,29,1,15,29
40,Fail,36,42,0,13,23
40,Success,51,20,2,10,41
40,Fail,48,29,0,17,31
40,Success,53,22,4,11,42
40,Fail,51,25,0,13,38
40,Fail,40,28,5,15,25
40,Fail,51,16,9,15,36
40,Fail,47,27,0,16,31
40,Fail,46,39,0,11,35
40,Fail,46,24,5,15,31
40,Fail,53,23,2,14,39
40,Fail,47,24,0,11,36
40,Fail,44,25,6,19,25
40,Success,58,23,2,11,47
40,Success,52,24,6,10,42
40,Success,57,22,1,10,47
40,Fail,47,29,8,8,39
40,Fail,51,22,5,12,39
40,Fail,46,28,1,10,36
40,Fail,44,29,4,10,34
40,Fail,44,31,0,14,30
40,Success,47,35,0,6,41
40,Success,59,22,1,8,51
40,Success,57,22,0,10,47
40,Fail,38,31,10,15,23
40,Success,54,18,3,12,42
40,Fail,50,30,0,14,36
40,Fail,45,30,0,11,34
40,Success,58,21,0,11,47
40,Fail,46,34,0,12,34
40,Fail,48,23,0,19,29
40,Fail,51,22,2,12,39
40,Success,56,28,0,4,52
40,Fail,46,26,0,17,29
40,Fail,38,41,0,12,26
40,Success,54,23,0,8,46
40,Success,54,21,3,10,44
40,Fail,42,24,13,14,28
40,Fail,47,24,5,11,36
40,Success,55,26,0,8,47
40,Fail,46,32,0,10,36
40,Success,51,21,4,8,43
40,Fail,48,23,0,14,34
40,Fail,45,33,0,11,34
40,Success,53,24,1,10,43
40,Fail,50,22,9,12,38
40,Fail,50,20,3,15,35
40,Fail,42,34,0,14,28
40,Fail,47,29,0,13,34
40,Success,53,26,1,10,43
40,Fail,44,25,7,13,31
40,Fail,50,25,0,12,38
40,Success,59,21,3,8,51
40,Success,50,31,0,5,45
40,Success,52,28,0,10,42
40,Fail,42,28,4,14,28
40,Fail,41,31,5,10,31
40,Fail,44,25,6,16,28
40,Success,60,17,7,9,51
40,Fail,40,41,0,11,29
40,Fail,48,30,6,9,39
40,Success,48,33,1,8,40
40,Fail,48,20,2,13,35
40,Fail,40,23,12,16,24
40,Fail,52,14,5,16,36
40,Fail,48,23,9,9,39
40,Fail,45,25,6,15,30
40,Fail,49,24,0,19,30
40,Fail,45,28,0,13,32
40,Success,53,23,3,9,44
40,Fail,51,25,0,14,37
40,Fail,47,22,0,17,30
40,Fail,47,23,1,17,30
40,Success,51,28,0,11,40
40,Success,51,25,0,11,40
40,Success,52,28,0,11,41
40,Fail,48,31,0,13,35
40,Fail,49,23,1,17,32
40,Fail,52,22,2,14,38
40,Fail,42,35,0,13,29
40,Fail,38,35,2,11,27
40,Fail,48,23,3,15,33
40,Success,56,20,0,8,48
40,Success,54,26,0,10,44
40,Success,60,23,0,5,55
40,Fail,43,29,6,15,28
40,Fail,50,29,0,13,37
40,Fail,40,25,3,21,19
40,Fail,46,25,5,17,29
40,Fail,49,30,0,10,39
40,Fail,45,24,0,21,24
40,Fail,48,25,7,12,36
40,Fail,49,21,3,14,35
40,Fail,43,34,0,14,29
40,Fail,45,26,3,18,27
40,Success,52,23,4,11,41
40,Fail,49,29,0,12,37
40,Success,50,28,0,8,42
40,Fail,49,24,3,16,33
40,Fail,44,37,0,9,35
40,Success,55,18,2,13,42
40,Success,58,23,3,5,53
40,Fail,45,22,0,21,24
40,Fail,49,22,2,16,33
40,Fail,49,32,2,10,39
40,Fail,51,25,0,12,39
40,Fail,48,29,4,11,37
40,Fail,44,31,0,13,31
40,Fail,43,34,0,13,30
40,Success,48,32,0,8,40
40,Fail,49,26,3,13,36
40,Fail,44,26,9,16,28
40,Fail,52,20,1,16,36
40,Fail,40,38,0,14,26
40,Success,55,24,0,11,44
40,Fail,48,18,8,14,34
40,Fail,46,30,2,10,36
40,Fail,48,21,4,15,33
40,Success,53,29,0,8,45
40,Success,51,25,5,10,41
40,Success,52,25,1,11,41
40,Fail,48,32,0,13,35
40,Success,57,23,0,11,46
40,Success,55,20,2,11,44
40,Fail,46,29,0,14,32
40,Fail,46,33,0,13,33
40,Success,54,22,0,11,43
40,Fail,49,24,4,14,35
40,Success,54,26,0,9,45
40,Fail,41,35,0,15,26
40,Fail,47,27,0,10,37
40,Fail,49,19,2,17,32
40,Fail,41,34,0,17,24
40,Fail,51,22,6,12,39
40,Success,50,28,0,9,41
40,Fail,43,32,0,13,30
40,Fail,41,27,9,13,28
40,Success,52,21,8,8,44
40,Success,51,30,0,11,40
40,Success,54,30,0,9,45
40,Fail,48,26,0,18,30
40,Fail,50,27,0,15,35
40,Success,51,28,1,9,42
40,Fail,46,26,1,11,35
40,Fail,50,29,0,12,38
40,Success,52,26,0,10,42
40,Fail,51,22,6,13,38
40,Success,52,29,0,11,41
40,Fail,42,28,4,18,24
40,Fail,50,20,8,13,37
40,Success,56,15,5,12,44
40,Success,59,18,0,13,46
40,Fail,46,30,0,10,36
40,Success,52,27,4,8,44
40,Fail,46,22,2,17,29
40,Fail,40,30,2,19,21
40,Fail,45,29,0,13,32
40,Success,49,29,0,9,40
40,Fail,45,28,4,13,32
40,Fail,50,27,0,15,35
40,Fail,44,33,0,12,32
40,Fail,49,32,0,10,39
40,Fail,50,24,2,12,38
40,Fail,49,28,0,13,36
40,Fail,49,33,0,10,39
40,Fail,44,25,8,17,27
40,Success,51,26,0,10,41
40,Success,57,27,0,12,45
40,Fail,46,23,0,18,28
40,Success,54,26,2,13,41
40,Fail,49,27,0,14,35
40,Fail,46,24,3,14,32
40,Fail,49,13,7,17,32
40,Fail,43,23,3,18,25
40,Fail,44,38,0,9,35
40,Fail,43,38,0,11,32
40,Fail,36,39,0,15,21
40,Success,53,21,4,11,42
40,Fail,46,27,0,15,31
40,Success,54,25,0,10,44
40,Success,53,26,2,8,45
40,Fail,44,30,5,14,30
40,Fail,47,27,2,13,34
40,Fail,51,16,1,17,34
40,Fail,50,21,0,19,31
40,Fail,48,31,0,12,36
40,Success,55,27,0,8,47
40,Success,55,24,3,10,45
40,Success,58,21,1,10,48
40,Fail,43,24,9,19,24
40,Fail,48,27,3,10,38
40,Fail,47,28,1,13,34
40,Success,54,20,2,12,42
40,Fail,53,23,0,15,38
40,Fail,44,21,3,19,25
40,Success,53,27,0,7,46
40,Fail,53,17,0,18,35
40,Fail,50,19,5,12,38
40,Fail,50,27,0,11,39
40,Success,52,21,4,11,41
40,Fail,46,27,1,14,32
40,Fail,52,20,0,17,35
40,Fail,48,18,0,21,27
40,Fail,48,25,1,16,32
40,Success,53,23,2,9,44
40,Fail,45,25,0,16,29
40,Fail,47,25,4,14,33
40,Fail,47,28,2,13,34
40,Success,53,29,0,9,44
40,Fail,44,36,2,8,36
40,Fail,43,23,0,24,19
40,Success,48,29,3,7,41
40,Fail,41,28,13,12,29
40,Success,52,28,0,9,43
40,Fail,44,24,13,12,32
40,Success,49,28,5,9,40
40,Fail,45,37,0,9,36
40,Success,53,29,0,9,44
40,Fail,47,20,8,14,33
40,Success,52,27,0,12,40
40,Fail,44,32,3,12,32
40,Fail,51,26,0,14,37
40,Fail,44,26,3,16,28
40,Success,53,30,0,8,45
40,Fail,41,29,9,14,27
40,Fail,43,24,3,19,24
40,Success,51,25,4,7,44
40,Success,58,16,2,10,48
40,Fail,44,24,7,17,27
40,Success,54,24,0,8,46
40,Success,55,30,0,7,48
40,Fail,49,31,0,11,38
40,Fail,51,26,0,15,36
40,Fail,45,23,5,18,27
40,Fail,49,27,0,13,36
40,Success,56,25,1,5,51
40,Success,55,21,0,15,40
40,Fail,52,23,1,13,39
40,Success,56,16,0,14,42
40,Fail,51,23,0,13,38
40,Success,50,26,4,9,41
40,Success,50,24,4,10,40
40,Fail,47,29,2,9,38
40,Fail,50,26,1,12,38
40,Fail,43,29,4,14,29
40,Fail,45,27,0,18,27
40,Success,51,26,5,10,41
40,Success,54,13,4,13,41
40,Fail,45,36,0,10,35
40,Fail,48,25,1,14,34
40,Fail,48,26,1,17,31
40,Fail,43,32,0,18,25
40,Success,54,25,5,9,45
40,Fail,47,24,1,16,31
40,Fail,49,30,0,14,35
40,Fail,46,30,0,14,32
40,Fail,52,19,2,15,37
40,Fail,49,27,0,14,35
40,Fail,48,28,3,9,39
40,Fail,49,26,0,16,33
40,Fail,41,30,8,10,31
40,Success,57,21,0,12,45
40,Success,57,26,0,6,51
40,Success,51,35,0,4,47
40,Fail,42,34,0,14,28
40,Success,50,33,0,9,41
40,Success,50,22,8,7,43
40,Success,50,31,0,10,40
40,Success,52,26,2,9,43
40,Fail,42,28,9,13,29
40,Success,51,33,0,9,42
40,Success,54,26,0,7,47
40,Success,50,30,1,7,43
40,Fail,41,33,5,14,27
40,Success,52,24,0,10,42
40,Fail,47,25,0,18,29
40,Fail,42,28,3,17,25
40,Fail,47,25,0,16,31
40,Fail,46,22,6,15,31
40,Success,51,29,0,8,43
40,Fail,48,26,0,16,32
40,Fail,48,24,1,12,36
40,Fail,47,22,4,12,35
40,Fail,51,28,0,15,36
40,Fail,43,39,0,10,33
40,Fail,44,23,5,16,28
40,Fail,41,37,0,15,26
40,Fail,49,23,1,21,28
40,Fail,47,32,0,10,37
40,Success,49,29,0,8,41
40,Fail,48,31,0,16,32
40,Success,50,25,7,8,42
40,Fail,45,28,3,10,35
40,Success,55,17,6,13,42
40,Fail,45,30,0,10,35
40,Fail,47,26,3,16,31
40,Success,49,28,0,9,40
40,Success,52,29,0,11,41
40,Fail,50,23,2,14,36
40,Fail,42,20,8,20,22
40,Fail,41,37,0,13,28
40,Fail,52,21,2,13,39
40,Success,52,27,0,11,41
40,Success,52,22,3,10,42
40,Fail,47,24,8,10,37
40,Fail,47,25,0,15,32
40,Fail,47,25,0,16,31
40,Success,55,16,10,9,46
40,Fail,42,29,1,14,28
40,Success,52,29,0,10,42
40,Fail,45,23,4,16,29
40,Fail,42,35,0,13,29
40,Fail,46,28,6,12,34
40,Fail,46,34,0,10,36
40,Fail,43,27,1,15,28
40,Fail,51,24,2,14,37
40,Fail,42,29,0,21,21
40,Success,51,25,4,8,43
40,Fail,54,18,2,17,37
40,Fail,43,27,2,17,26
40,Fail,46,28,0,13,33
40,Fail,40,36,0,16,24
40,Fail,44,29,11,8,36
40,Fail,47,25,8,13,34
40,Fail,46,25,1,16,30
40,Success,60,20,1,7,53
40,Fail,52,21,7,13,39
40,Fail,47,16,11,16,31
40,Fail,50,22,3,12,38
40,Fail,38,41,0,14,24
40,Success,55,17,2,12,43
40,Fail,43,32,0,13,30
40,Fail,46,36,0,11,35
40,Fail,51,24,0,12,39
40,Success,54,25,7,6,48
40,Fail,47,30,0,11,36
40,Fail,47,27,8,9,38
40,Fail,48,25,0,15,33
40,Fail,39,38,0,10,29
40,Fail,44,27,0,13,31
40,Success,53,18,0,12,41
40,Success,52,24,2,12,40
40,Fail,43,29,0,16,27
40,Success,48,36,0,7,41
40,Fail,43,31,0,13,30
40,Fail,44,26,0,15,29
40,Success,48,37,0,7,41
40,Fail,44,29,3,15,29
40,Success,54,23,1,12,42
40,Fail,50,28,0,13,37
40,Fail,43,30,0,15,28
40,Fail,49,27,6,11,38
40,Success,51,32,0,6,45
40,Fail,48,24,0,14,34
40,Fail,49,27,0,14,35
40,Fail,49,29,0,11,38
40,Fail,46,24,1,17,29
40,Fail,50,25,0,11,39
40,Fail,44,30,0,13,31
40,Success,55,24,1,14,41
40,Fail,51,25,1,14,37
40,Fail,45,36,0,12,33
40,Fail,52,22,0,19,33
40,Success,58,24,0,9,49
40,Fail,51,19,0,18,33
40,Fail,45,26,1,17,28
40,Success,54,26,0,9,45
40,Fail,43,28,1,18,25
40,Fail,50,26,0,12,38
40,Fail,41,31,5,15,26
40,Success,51,23,10,6,45
40,Fail,44,35,8,6,38
40,Fail,42,27,7,14,28
40,Success,58,19,2,9,49
40,Fail,47,30,0,12,35
40,Success,54,23,3,10,44
40,Success,53,23,0,10,43
40,Fail,48,24,3,17,31
40,Fail,49,29,0,15,34
40,Success,54,21,7,9,45
40,Fail,47,29,0,13,34
40,Success,51,30,0,9,42
40,Fail,43,29,0,20,23
40,Fail,47,27,0,12,35
40,Fail,39,35,0,17,22
40,Success,47,30,4,7,40
40,Fail,42,30,5,12,30
40,Fail,50,26,0,11,39
40,Fail,52,22,3,15,37
40,Fail,53,18,2,15,38
40,Fail,46,33,0,12,34
40,Fail,44,21,10,17,27
40,Fail,46,24,5,15,31
40,Success,51,31,6,5,46
40,Fail,43,28,6,12,31
40,Fail,46,25,4,15,31
40,Fail,38,43,0,10,28
40,Fail,52,22,0,15,37
40,Fail,45,25,10,12,33
40,Fail,47,30,2,10,37
40,Fail,44,28,5,14,30
40,Fail,51,24,3,12,39
40,Fail,41,33,0,12,29
40,Success,53,23,3,7,46
40,Fail,36,39,7,8,28
40,Fail,46,26,4,12,34
40,Fail,49,22,6,13,36
40,Success,55,17,0,14,41
40,Fail,48,26,0,13,35
40,Success,53,28,0,9,44
40,Fail,50,27,0,12,38
40,Success,51,28,0,10,41
40,Fail,48,24,6,12,36
40,Success,50,23,2,9,41
40,Success,55,21,1,14,41
40,Fail,49,27,0,10,39
40,Success,52,22,3,12,40
40,Success,56,22,1,10,46
40,Fail,49,27,4,12,37
40,Fail,43,32,0,13,30
40,Fail,43,36,0,9,34
40,Success,55,21,0,15,40
40,Fail,46,36,0,11,35
40,Fail,49,31,0,12,37
40,Fail,49,25,1,12,37
40,Fail,46,29,7,15,31
40,Fail,50,24,0,13,37
40,Success,49,32,0,9,40
40,Fail,50,25,0,13,37
40,Success,54,27,0,10,44
40,Fail,47,28,0,12,35
40,Fail,44,33,0,12,32
40,Fail,46,27,0,18,28
40,Fail,47,31,3,9,38
40,Fail,40,21,14,13,27
40,Fail,45,26,1,15,30
40,Fail,44,36,0,13,31
40,Fail,42,25,5,19,23
40,Fail,52,28,0,13,39
40,Fail,46,21,4,19,27
40,Fail,48,25,2,13,35
40,Fail,46,25,3,15,31
40,Success,53,24,0,12,41
40,Success,51,27,0,11,40
40,Fail,45,27,3,14,31
40,Fail,49,21,8,11,38
40,Success,52,25,0,9,43
40,Fail,49,21,6,15,34
40,Success,55,22,0,11,44
40,Fail,48,29,1,9,39
40,Success,57,23,1,8,49
40,Fail,49,30,0,11,38
40,Fail,41,41,0,10,31
40,Fail,46,32,0,14,32
40,Success,55,24,2,15,40
40,Fail,41,34,0,14,27
40,Fail,44,33,4,7,37
40,Fail,44,32,0,17,27
40,Fail,43,26,10,15,28
40,Fail,40,39,0,13,27
40,Success,48,31,0,7,41
40,Fail,51,25,0,13,38
40,Fail,42,27,6,12,30
40,Fail,44,28,0,18,26
40,Success,51,23,8,7,44
40,Fail,49,26,2,10,39
40,Fail,53,17,3,14,39
40,Fail,47,25,0,13,34
40,Success,54,24,0,9,45
40,Fail,46,22,9,15,31
40,Success,51,27,0,11,40
40,Fail,50,21,7,15,35
40,Fail,45,33,0,14,31
40,Fail,46,32,0,13,33
40,Fail,47,23,0,16,31
40,Fail,44,25,0,20,24
40,Fail,42,26,7,15,27
40,Fail,46,32,1,12,34
40,Success,53,22,2,9,44
40,Success,53,21,5,11,42
40,Fail,49,26,1,12,37
40,Fail,47,28,0,10,37
40,Fail,47,24,4,18,29
40,Success,50,30,0,6,44
40,Fail,43,24,5,13,30
40,Fail,47,21,4,15,32
40,Fail,48,27,8,11,37
40,Fail,45,35,0,10,35
40,Fail,38,32,5,17,21
40,Fail,46,22,9,14,32
40,Success,56,22,1,14,42
40,Success,50,33,0,7,43
40,Success,55,19,5,13,42
40,Fail,37,45,0,10,27
40,Fail,47,32,0,14,33
40,Fail,49,26,0,16,33
40,Fail,43,30,5,14,29
40,Fail,47,34,0,13,34
40,Success,50,33,0,10,40
40,Success,54,22,2,12,42
40,Success,51,34,0,8,43
40,Fail,45,30,0,14,31
40,Fail,42,35,0,12,30
40,Success,50,30,0,8,42
40,Success,53,25,1,12,41
40,Fail,49,22,7,12,37
40,Success,50,27,4,10,40
40,Fail,45,31,0,17,28
40,Success,55,24,5,8,47
40,Fail,40,28,7,18,22
40,Success,56,23,0,12,44
40,Fail,46,34,0,12,34
40,Fail,49,30,0,14,35
40,Fail,44,39,0,10,34
40,Fail,45,31,0,10,35
40,Success,51,28,0,9,42
40,Fail,51,22,0,14,37
40,Success,52,21,3,11,41
40,Fail,45,28,0,15,30
40,Fail,45,30,0,9,36
40,Fail,47,35,0,10,37
40,Success,50,35,0,10,40
50,Fail,45,25,1,15,30
50,Fail,51,23,12,11,40
50,Fail,53,21,0,16,37
50,Fail,58,12,5,14,44
50,Fail,46,32,0,13,33
50,Fail,46,30,0,14,32
50,Fail,56,23,0,8,48
50,Fail,45,25,5,14,31
50,Fail,54,25,1,8,46
50,Fail,46,24,4,14,32
50,Fail,44,38,0,8,36
50,Fail,54,25,4,7,47
50,Fail,48,26,5,10,38
50,Fail,50,24,8,10,40
50,Fail,49,29,0,12,37
50,Fail,51,26,5,9,42
50,Fail,50,31,0,10,40
50,Fail,42,29,7,13,29
50,Fail,47,19,4,19,28
50,Fail,48,25,1,13,35
50,Fail,54,23,1,10,44
50,Fail,41,26,7,20,21
50,Fail,43,37,1,10,33
50,Fail,55,20,1,11,44
50,Fail,46,29,0,15,31
50,Fail,51,28,0,11,40
50,Fail,44,32,0,16,28
50,Fail,51,26,1,11,40
50,Fail,48,19,7,13,35
50,Fail,50,26,3,14,36
50,Fail,54,25,0,8,46
50,Fail,47,34,0,7,40
50,Fail,48,32,0,10,38
50,Fail,43,28,2,15,28
50,Fail,53,17,0,15,38
50,Fail,54,27,0,9,45
50,Fail,46,26,5,11,35
50,Fail,44,25,3,19,25
50,Fail,48,30,0,13,35
50,Fail,48,23,4,13,35
50,Fail,41,32,1,13,28
50,Fail,39,30,5,20,19
50,Fail,50,26,7,8,42
50,Fail,49,22,7,13,36
50,Fail,54,24,0,13,41
50,Fail,43,31,0,15,28
50,Fail,46,29,0,18,28
50,Fail,54,22,4,12,42
50,Fail,44,29,1,12,32
50,Fail,49,28,0,10,39
50,Fail,50,25,0,14,36
50,Fail,50,17,0,20,30
50,Fail,47,25,1,11,36
50,Fail,48,24,8,12,36
50,Fail,44,22,5,15,29
50,Fail,45,34,0,11,34
50,Fail,51,23,2,15,36
50,Fail,42,39,0,16,26
50,Fail,42,32,0,14,28
50,Fail,47,34,2,6,41
50,Fail,55,23,1,12,43
50,Fail,50,26,0,14,36
50,Fail,51,23,2,15,36
50,Fail,41,33,0,16,25
50,Fail,41,27,9,19,22
50,Fail,46,31,0,15,31
50,Fail,49,25,2,14,35
50,Fail,45,39,0,7,38
50,Fail,41,28,0,20,21
50,Fail,49,21,4,14,35
50,Fail,53,22,6,10,43
50,Fail,39,34,0,19,20
50,Fail,53,24,0,10,43
50,Fail,45,29,3,9,36
50,Fail,54,29,0,5,49
50,Fail,50,30,0,10,40
50,Fail,40,30,4,17,23
50,Fail,43,38,0,11,32
50,Fail,55,22,0,10,45
50,Fail,46,24,2,16,30
50,Fail,45,24,1,15,30
50,Fail,56,24,4,8,48
50,Fail,50,24,2,14,36
50,Fail,40,42,0,10,30
50,Fail,53,18,9,10,43
50,Fail,55,24,2,12,43
50,Fail,51,21,6,13,38
50,Fail,40,31,1,15,25
50,Fail,54,23,0,13,41
50,Fail,48,25,2,11,37
50,Fail,47,35,0,11,36
50,Fail,56,23,1,9,47
50,Fail,37,27,10,16,21
50,Fail,54,30,0,7,47
50,Fail,46,33,0,13,33
50,Fail,45,35,0,8,37
50,Fail,45,18,9,20,25
50,Fail,42,40,0,8,34
50,Fail,48,23,5,14,34
50,Fail,46,28,0,17,29
50,Fail,48,27,0,12,36
50,Fail,41,42,0,10,31
50,Fail,54,28,0,9,45
50,Fail,50,26,1,5,45
50,Fail,46,26,0,15,31
50,Fail,42,40,0,10,32
50,Fail,47,36,0,10,37
50,Fail,51,32,0,10,41
50,Fail,49,23,0,14,35
50,Fail,50,23,1,17,33
50,Fail,50,22,3,11,39
50,Fail,49,26,0,13,36
50,Fail,45,24,12,12,33
50,Fail,51,22,1,12,39
50,Fail,40,28,7,16,24
50,Fail,49,28,0,13,36
50,Fail,56,20,2,10,46
50,Fail,55,22,0,7,48
50,Fail,45,37,0,9,36
50,Fail,51,35,0,10,41
50,Fail,48,28,3,11,37
50,Fail,53,33,0,6,47
50,Fail,44,38,0,8,36
50,Fail,45,32,5,9,36
50,Fail,47,33,0,14,33
50,Fail,46,28,4,12,34
50,Fail,52,27,3,8,44
50,Fail,45,29,4,13,32
50,Fail,43,27,2,15,28
50,Fail,42,35,0,13,29
50,Fail,37,36,8,16,21
50,Success,58,24,0,8,50
50,Fail,52,27,0,11,41
50,Fail,52,27,0,14,38
50,Fail,51,24,0,15,36
50,Fail,46,22,9,14,32
50,Fail,51,28,0,12,39
50,Fail,47,23,11,13,34
50,Fail,51,22,2,12,39
50,Fail,51,25,3,12,39
50,Fail,48,27,0,12,36
50,Fail,42,35,2,10,32
50,Fail,43,26,1,20,23
50,Fail,54,14,2,18,36
50,Fail,49,18,3,18,31
50,Fail,51,29,0,10,41
50,Fail,41,32,0,16,25
50,Fail,52,25,0,13,39
50,Fail,55,23,0,11,44
50,Fail,46,34,0,10,36
50,Fail,43,27,8,13,30
50,Fail,51,26,1,11,40
50,Fail,48,29,0,13,35
50,Fail,53,16,4,16,37
50,Fail,45,27,0,16,29
50,Fail,45,30,0,13,32
50,Fail,51,21,10,12,39
50,Fail,46,27,2,14,32
50,Fail,47,29,3,11,36
50,Fail,51,25,0,12,39
50,Fail,51,26,0,12,39
50,Fail,43,31,0,16,27
50,Fail,52,24,0,9,43
50,Fail,54,30,0,7,47
50,Fail,46,33,0,13,33
50,Fail,48,26,0,16,32
50,Fail,51,21,1,16,35
50,Fail,53,22,1,13,40
50,Fail,46,26,2,16,30
50,Fail,46,32,1,9,37
50,Fail,44,26,15,10,34
50,Fail,47,24,1,13,34
50,Fail,53,18,5,14,39
50,Fail,45,34,0,13,32
50,Fail,54,22,0,15,39
50,Fail,49,32,0,7,42
50,Fail,46,32,0,8,38
50,Fail,47,27,2,15,32
50,Fail,47,26,0,16,31
50,Fail,46,18,8,18,28
50,Fail,47,30,0,14,33
50,Fail,38,22,9,22,16
50,Fail,48,25,1,11,37
50,Fail,55,25,2,7,48
50,Fail,51,29,0,14,37
50,Fail,46,28,2,11,35
50,Fail,51,24,2,12,39
50,Fail,43,33,0,16,27
50,Fail,49,26,2,14,35
50,Fail,53,24,3,10,43
50,Fail,44,33,0,15,29
50,Fail,50,18,0,20,30
50,Fail,52,30,0,7,45
50,Fail,49,19,12,15,34
50,Fail,52,26,2,9,43
50,Fail,50,25,0,15,35
50,Fail,47,28,0,16,31
50,Fail,47,27,2,13,34
50,Fail,48,32,0,10,38
50,Fail,43,38,0,12,31
50,Fail,45,24,7,13,32
50,Fail,47,30,3,11,36
50,Fail,40,34,0,16,24
50,Fail,52,24,0,12,40
50,Fail,56,22,0,10,46
50,Fail,49,29,0,11,38
50,Fail,41,29,10,13,28
50,Fail,49,24,0,16,33
50,Fail,43,27,3,16,27
50,Fail,46,35,0,11,35
50,Fail,51,26,0,12,39
50,Fail,48,21,9,14,34
50,Fail,55,22,0,12,43
50,Fail,49,26,5,13,36
50,Fail,50,26,6,10,40
50,Fail,46,25,3,12,34
50,Fail,47,25,0,13,34
50,Fail,48,28,5,11,37
50,Fail,43,33,0,14,29
50,Fail,46,29,0,14,32
50,Fail,41,41,0,8,33
50,Fail,49,23,5,12,37
50,Fail,50,27,4,9,41
50,Success,60,17,1,9,51
50,Fail,44,32,0,12,32
50,Fail,55,26,0,8,47
50,Fail,48,20,2,16,32
50,Fail,50,28,0,14,36
50,Fail,49,25,0,13,36
50,Fail,45,29,0,12,33
50,Fail,55,17,0,14,41
50,Fail,44,34,0,12,32
50,Success,58,20,6,7,51
50,Fail,46,29,0,16,30
50,Fail,41,36,6,7,34
50,Fail,44,25,5,17,27
50,Fail,43,34,0,16,27
50,Fail,50,25,0,13,37
50,Fail,52,18,3,14,38
50,Fail,43,32,0,16,27
50,Fail,41,35,2,10,31
50,Fail,46,35,0,14,32
50,Success,58,26,0,8,50
50,Fail,45,24,0,19,26
50,Fail,50,29,0,11,39
50,Fail,47,34,0,11,36
50,Fail,49,22,2,13,36
50,Fail,49,32,0,12,37
50,Fail,51,23,0,11,40
50,Fail,54,23,0,12,42
50,Success,55,27,4,5,50
50,Fail,46,26,0,17,29
50,Fail,57,20,2,10,47
50,Fail,47,27,10,12,35
50,Fail,44,32,0,15,29
50,Fail,49,21,4,14,35
50,Success,59,19,2,9,50
50,Fail,45,33,0,11,34
50,Fail,46,32,0,16,30
50,Fail,52,27,0,10,42
50,Fail,42,30,0,12,30
50,Fail,51,24,1,13,38
50,Fail,47,25,2,16,31
50,Fail,53,27,0,11,42
50,Fail,43,26,9,13,30
50,Fail,54,24,0,10,44
50,Fail,48,35,0,11,37
50,Fail,54,25,0,10,44
50,Fail,54,20,0,17,37
50,Fail,51,22,0,15,36
50,Fail,39,24,6,20,19
50,Fail,35,48,0,12,23
50,Fail,47,27,0,16,31
50,Fail,55,22,0,16,39
50,Fail,53,29,0,11,42
50,Fail,50,25,3,11,39
50,Fail,45,37,0,11,34
50,Fail,49,31,0,10,39
50,Fail,53,26,9,4,49
50,Fail,50,23,0,14,36
50,Fail,57,23,2,9,48
50,Fail,51,23,2,9,42
50,Fail,48,36,0,11,37
50,Fail,45,32,6,10,35
50,Fail,44,26,6,13,31
50,Fail,47,30,0,11,36
50,Fail,46,28,2,12,34
50,Fail,52,25,0,15,37
50,Fail,53,26,0,10,43
50,Fail,50,21,0,12,38
50,Fail,44,29,0,15,29
50,Fail,53,29,0,10,43
50,Fail,48,26,0,13,35
50,Fail,46,32,0,11,35
50,Fail,44,36,0,12,32
50,Fail,46,35,0,9,37
50,Fail,50,29,0,10,40
50,Fail,45,30,0,15,30
50,Fail,52,25,2,10,42
50,Fail,47,29,0,11,36
50,Fail,54,22,0,13,41
50,Fail,51,28,0,10,41
50,Fail,40,35,0,13,27
50,Fail,38,36,0,16,22
50,Fail,48,25,3,14,34
50,Fail,45,21,10,15,30
50,Fail,44,21,1,15,29
50,Fail,46,31,0,11,35
50,Fail,49,28,0,9,40
50,Fail,49,30,0,9,40
50,Fail,49,23,0,14,35
50,Fail,46,34,0,10,36
50,Fail,51,28,0,10,41
50,Fail,54,24,0,11,43
50,Fail,49,35,0,9,40
50,Fail,45,30,0,13,32
50,Fail,37,40,0,12,25
50,Fail,46,26,2,12,34
50,Fail,46,23,9,16,30
50,Fail,52,28,0,14,38
50,Fail,46,27,5,14,32
50,Fail,52,26,4,13,39
50,Fail,53,25,0,11,42
50,Fail,49,25,1,14,35
50,Fail,50,20,13,9,41
50,Fail,39,32,6,14,25
50,Fail,43,30,3,16,27
50,Fail,46,21,1,17,29
50,Fail,48,33,0,10,38
50,Fail,48,22,4,16,32
50,Fail,43,35,0,12,31
50,Fail,53,18,0,17,36
50,Fail,36,34,2,19,17
50,Fail,49,29,0,10,39
50,Fail,58,19,0,13,45
50,Fail,44,34,0,9,35
50,Fail,56,24,0,10,46
50,Fail,49,30,0,9,40
50,Fail,44,28,0,16,28
50,Fail,42,37,0,15,27
50,Fail,49,26,2,13,36
50,Fail,48,26,0,15,33
50,Fail,47,33,0,10,37
50,Fail,54,23,2,13,41
50,Fail,54,27,1,6,48
50,Fail,51,25,0,9,42
50,Fail,48,31,7,8,40
50,Fail,42,33,0,15,27
50,Fail,52,21,2,15,37
50,Fail,45,33,0,11,34
50,Fail,48,27,1,16,32
50,Fail,52,23,2,11,41
50,Fail,54,23,0,10,44
50,Fail,41,31,5,11,30
50,Fail,38,31,5,16,22
50,Fail,47,28,0,13,34
50,Fail,48,22,12,11,37
50,Fail,54,23,3,8,46
50,Fail,47,22,0,15,32
50,Fail,53,23,0,12,41
50,Fail,46,24,2,17,29
50,Fail,43,32,0,14,29
50,Fail,49,33,0,4,45
50,Fail,50,22,0,16,34
50,Fail,51,24,1,10,41
50,Fail,43,30,0,19,24
50,Fail,53,28,0,11,42
50,Fail,47,28,0,13,34
50,Fail,52,17,0,17,35
50,Fail,47,29,0,14,33
50,Fail,46,32,0,13,33
50,Fail,49,32,0,9,40
50,Fail,50,26,0,11,39
50,Fail,47,32,0,12,35
50,Fail,55,22,6,10,45
50,Fail,37,29,7,17,20
50,Fail,45,29,1,15,30
50,Fail,41,33,5,11,30
50,Fail,46,23,4,14,32
50,Fail,41,26,11,10,31
50,Fail,48,27,3,11,37
50,Fail,43,37,0,10,33
50,Fail,55,29,0,10,45
50,Fail,46,29,2,13,33
50,Fail,47,31,0,11,36
50,Fail,52,21,4,13,39
50,Fail,47,20,14,17,30
50,Fail,52,23,6,8,44
50,Fail,51,29,0,9,42
50,Fail,39,38,0,13,26
50,Fail,47,23,1,17,30
50,Fail,53,30,0,9,44
50,Fail,46,28,0,13,33
50,Fail,45,28,3,10,35
50,Fail,46,26,2,13,33
50,Fail,50,26,6,11,39
50,Fail,45,33,3,8,37
50,Fail,47,25,2,13,34
50,Fail,51,26,0,12,39
50,Fail,46,25,9,12,34
50,Fail,46,18,9,15,31
50,Fail,46,26,1,12,34
50,Fail,48,28,0,16,32
50,Fail,44,28,7,12,32
50,Fail,47,27,1,15,32
50,Fail,47,27,5,13,34
50,Fail,44,20,6,18,26
50,Fail,42,33,2,11,31
50,Fail,52,29,0,9,43
50,Fail,39,40,0,10,29
50,Fail,42,21,0,21,21
50,Fail,42,33,0,15,27
50,Fail,47,31,0,13,34
50,Fail,39,31,0,18,21
50,Fail,46,30,2,11,35
50,Fail,45,39,0,7,38
50,Fail,48,26,0,15,33
50,Fail,54,24,0,11,43
50,Fail,49,29,0,13,36
50,Fail,45,28,6,12,33
50,Fail,39,29,10,14,25
50,Fail,42,31,6,12,30
50,Fail,52,25,3,10,42
50,Fail,45,28,5,11,34
50,Fail,56,17,1,16,40
50,Fail,57,18,3,12,45
50,Fail,41,29,0,16,25
50,Fail,50,25,0,11,39
50,Fail,54,29,1,9,45
50,Fail,43,27,5,13,30
50,Fail,48,21,0,17,31
50,Fail,44,33,7,12,32
50,Fail,48,27,1,13,35
50,Fail,45,32,5,13,32
50,Fail,46,29,0,15,31
50,Fail,43,31,6,13,30
50,Fail,46,29,0,15,31
50,Fail,51,33,0,10,41
50,Fail,57,11,0,17,40
50,Fail,49,27,6,10,39
50,Fail,50,25,0,10,40
50,Fail,47,21,5,11,36
50,Fail,46,28,0,15,31
50,Fail,49,28,0,11,38
50,Fail,56,23,0,11,45
50,Fail,44,28,8,14,30
50,Fail,50,31,0,11,39
50,Fail,47,25,3,14,33
50,Fail,46,34,0,9,37
50,Fail,44,34,0,14,30
50,Fail,41,31,4,15,26
50,Fail,41,28,11,10,31
50,Fail,48,29,0,13,35
50,Fail,44,28,0,20,24
50,Fail,47,29,1,12,35
50,Fail,58,18,0,12,46
50,Fail,49,25,0,12,37
50,Fail,41,30,0,20,21
50,Fail,49,21,5,12,37
50,Fail,46,24,6,15,31
50,Fail,52,18,2,17,35
50,Fail,53,23,6,8,45
50,Fail,48,31,0,13,35
50,Fail,45,30,3,12,33
50,Fail,51,28,0,12,39
50,Fail,45,35,0,11,34
50,Fail,47,31,0,12,35
50,Fail,48,25,1,14,34
50,Fail,47,31,0,11,36
50,Fail,55,22,0,13,42
50,Fail,49,25,0,16,33
50,Fail,46,23,5,18,28
50,Fail,40,30,12,11,29
50,Fail,48,29,0,13,35
50,Fail,46,28,11,10,36
50,Fail,52,27,0,11,41
50,Fail,48,20,0,15,33
50,Fail,55,21,0,11,44
50,Fail,50,37,0,6,44
50,Fail,50,22,4,15,35
50,Fail,42,28,3,12,30
50,Fail,54,22,0,17,37
50,Fail,46,22,13,11,35
50,Fail,42,32,4,11,31
50,Success,57,28,0,7,50
50,Fail,53,27,0,12,41
50,Fail,50,24,2,12,38
50,Fail,37,38,0,18,19
50,Fail,51,25,0,14,37
50,Fail,51,28,0,11,40
50,Fail,44,24,10,11,33
50,Fail,54,21,0,15,39
50,Fail,56,21,0,12,44
50,Fail,44,27,0,16,28
50,Fail,46,25,4,18,28
50,Fail,40,24,1,21,19
50,Fail,50,28,4,7,43
50,Fail,53,22,1,11,42
50,Fail,42,24,9,12,30
50,Fail,48,20,10,13,35
50,Fail,45,26,5,16,29
50,Fail,53,24,0,12,41
50,Fail,41,41,0,9,32
50,Fail,47,31,0,13,34
50,Fail,45,28,0,14,31
50,Fail,53,21,3,10,43
50,Fail,50,21,6,13,37
50,Fail,44,24,6,17,27
50,Fail,45,23,1,16,29
50,Fail,44,29,4,15,29
50,Fail,45,24,0,16,29
50,Fail,40,35,1,16,24
50,Fail,49,32,0,9,40
50,Fail,47,33,0,9,38
50,Fail,43,26,3,15,28
50,Fail,45,33,0,12,33
50,Fail,52,24,1,13,39
50,Fail,42,32,1,14,28
50,Fail,52,17,6,13,39
50,Fail,44,23,9,13,31
50,Fail,52,27,0,7,45
50,Fail,46,28,0,15,31
50,Fail,48,23,1,14,34
50,Fail,42,32,0,14,28
50,Fail,54,20,1,11,43
50,Fail,50,23,0,16,34
50,Fail,52,20,0,13,39
50,Fail,45,36,0,12,33
50,Fail,41,29,8,14,27
50,Fail,52,24,0,14,38
50,Fail,49,31,0,9,40
50,Fail,46,30,0,14,32
50,Fail,41,35,0,15,26
50,Fail,55,27,0,10,45
50,Fail,56,28,0,11,45
50,Success,59,20,0,9,50
50,Fail,45,30,0,9,36
50,Fail,45,31,2,11,34
50,Fail,49,29,0,10,39
50,Fail,44,28,0,14,30
50,Fail,49,27,0,12,37
50,Fail,48,19,0,20,28
50,Fail,53,29,0,8,45
50,Fail,53,25,0,11,42
50,Fail,49,21,5,14,35
50,Fail,52,23,0,12,40
50,Fail,47,22,7,18,29
50,Fail,56,18,2,11,45
50,Fail,46,23,1,17,29
50,Fail,52,28,0,7,45
50,Fail,48,26,6,8,40
50,Fail,44,30,0,13,31
50,Fail,47,31,0,10,37
50,Fail,46,32,5,11,35
50,Fail,46,28,0,15,31
50,Fail,51,27,0,8,43
50,Fail,51,26,0,13,38
50,Fail,46,25,10,12,34
50,Fail,46,28,0,15,31
50,Fail,46,24,8,14,32
50,Fail,43,23,0,14,29
50,Fail,44,30,5,10,34
50,Fail,49,30,0,10,39
50,Fail,50,17,0,17,33
50,Fail,46,27,3,12,34
50,Fail,56,22,0,11,45
50,Fail,43,29,0,19,24
50,Fail,44,29,6,14,30
50,Fail,51,27,0,12,39
50,Fail,52,27,0,10,42
50,Fail,59,17,1,13,46
50,Fail,43,34,0,13,30
50,Fail,51,19,7,11,40
50,Fail,44,30,5,11,33
50,Fail,41,38,0,15,26
50,Fail,48,28,0,14,34
50,Fail,47,26,2,17,30
50,Fail,45,30,1,12,33
50,Fail,51,19,5,15,36
50,Fail,57,21,0,9,48
50,Fail,51,27,3,9,42
50,Fail,42,29,6,15,27
50,Fail,52,24,0,13,39
50,Fail,45,35,0,5,40
50,Fail,50,27,0,9,41
50,Fail,47,28,0,15,32
50,Fail,52,27,0,6,46
50,Fail,41,40,0,11,30
50,Fail,53,22,2,14,39
50,Fail,50,31,0,11,39
50,Fail,56,17,1,13,43
50,Fail,52,29,0,11,41
50,Fail,46,29,0,16,30
50,Fail,46,31,0,12,34
50,Fail,45,25,4,14,31
50,Fail,54,22,0,12,42
50,Fail,49,27,0,10,39
50,Fail,47,21,8,15,32
50,Fail,48,34,0,10,38
50,Fail,43,32,1,14,29
50,Fail,54,20,0,12,42
50,Fail,43,33,0,12,31
50,Fail,47,34,0,10,37
50,Fail,47,25,3,13,34
50,Fail,47,27,0,16,31
50,Fail,55,27,0,9,46
50,Fail,43,28,0,15,28
50,Fail,50,28,0,8,42
50,Fail,50,23,3,13,37
50,Fail,40,31,0,14,26
50,Fail,52,27,7,8,44
50,Fail,49,33,0,11,38
50,Fail,41,30,0,16,25
50,Fail,49,25,0,15,34
50,Fail,36,28,5,23,13
50,Fail,50,28,0,14,36
50,Fail,49,26,0,11,38
50,Fail,44,35,0,11,33
50,Fail,53,25,1,13,40
50,Fail,44,36,0,10,34
50,Fail,57,18,1,11,46
50,Fail,44,22,5,18,26
50,Fail,43,28,13,12,31
50,Fail,46,25,5,14,32
50,Fail,51,34,0,6,45
50,Fail,52,26,0,13,39
50,Fail,48,22,4,15,33
50,Fail,54,23,0,11,43
50,Fail,54,18,0,18,36
50,Fail,39,27,7,15,24
50,Fail,46,29,0,15,31
50,Fail,51,36,0,4,47
50,Fail,47,24,0,14,33
50,Fail,43,33,0,14,29
50,Fail,50,18,14,12,38
50,Fail,53,22,3,5,48
50,Fail,45,22,5,21,24
50,Fail,48,23,6,16,32
50,Fail,46,30,0,8,38
50,Fail,43,37,0,13,30
50,Fail,40,33,0,16,24
50,Fail,41,35,0,12,29
50,Fail,54,25,0,8,46
50,Fail,54,24,2,10,44
50,Fail,53,22,2,8,45
50,Fail,50,23,3,13,37
50,Fail,48,28,0,12,36
50,Fail,43,37,0,9,34
50,Fail,43,32,2,12,31
50,Fail,48,29,0,12,36
50,Fail,46,24,5,12,34
50,Fail,53,25,0,12,41
50,Fail,50,23,1,16,34
50,Fail,48,25,4,11,37
50,Fail,55,24,1,8,47
50,Fail,54,22,0,12,42
50,Fail,49,20,12,14,35
50,Fail,50,25,1,13,37
50,Fail,44,22,0,22,22
50,Fail,50,34,0,9,41
50,Fail,51,25,0,11,40
50,Fail,51,29,0,8,43
50,Fail,46,29,2,12,34
50,Fail,40,26,1,20,20
50,Fail,53,21,0,12,41
50,Fail,42,38,0,13,29
50,Fail,46,29,2,13,33
50,Fail,50,28,4,6,44
50,Fail,47,29,0,16,31
50,Fail,41,29,4,18,23
50,Fail,46,33,0,8,38
50,Fail,50,29,0,10,40
50,Fail,42,23,8,16,26
50,Fail,45,30,4,10,35
50,Fail,50,22,0,13,37
50,Fail,47,29,1,16,31
50,Fail,43,31,11,7,36
50,Fail,53,22,0,15,38
50,Fail,48,34,0,13,35
50,Fail,50,18,7,11,39
50,Fail,45,38,0,11,34
50,Fail,49,21,6,13,36
50,Fail,46,29,2,9,37
50,Fail,53,19,2,16,37
50,Fail,50,29,0,11,39
50,Fail,46,28,0,12,34
50,Fail,48,23,0,17,31
50,Fail,42,31,4,12,30
50,Fail,40,25,13,15,25
50,Fail,46,32,0,9,37
50,Fail,47,28,3,14,33
50,Fail,50,31,0,10,40
50,Fail,52,23,2,13,39
50,Fail,44,28,0,14,30
50,Fail,43,35,0,15,28
50,Fail,52,24,0,12,40
50,Fail,51,23,0,12,39
50,Fail,47,27,4,11,36
50,Fail,52,25,6,8,44
50,Fail,56,19,2,10,46
50,Fail,50,25,2,10,40
50,Fail,43,30,7,14,29
50,Fail,45,29,3,14,31
50,Fail,43,27,0,16,27
50,Fail,52,30,0,10,42
50,Fail,52,24,0,15,37
50,Fail,50,24,1,12,38
50,Fail,52,26,0,9,43
50,Fail,53,21,1,13,40
50,Fail,48,27,5,11,37
50,Fail,54,22,0,9,45
50,Fail,48,30,0,10,38
50,Fail,55,23,0,10,45
50,Fail,47,34,0,11,36
50,Fail,46,32,2,10,36
50,Fail,49,25,0,16,33
50,Fail,53,22,10,7,46
50,Fail,51,25,0,13,38
50,Fail,58,18,0,12,46
50,Fail,51,21,2,10,41
50,Fail,57,20,4,10,47
50,Fail,51,23,0,11,40
50,Fail,50,24,0,10,40
50,Fail,47,37,0,10,37
50,Fail,48,29,0,11,37
50,Fail,50,23,0,17,33
50,Fail,43,35,0,9,34
50,Fail,46,30,2,10,36
50,Fail,48,19,3,18,30
50,Fail,58,16,0,13,45
50,Fail,46,27,2,14,32
50,Fail,49,29,0,12,37
50,Fail,50,22,0,16,34
50,Fail,45,31,1,11,34
50,Fail,53,25,0,12,41
50,Fail,40,36,0,16,24
50,Fail,40,32,0,17,23
50,Fail,41,39,0,11,30
50,Fail,50,24,0,15,35
50,Fail,44,28,0,18,26
50,Fail,43,32,0,16,27
50,Fail,51,24,7,8,43
50,Fail,50,35,0,6,44
50,Fail,44,30,4,11,33
50,Fail,35,32,10,17,18
50,Fail,57,18,0,14,43
50,Fail,54,24,0,9,45
50,Fail,48,26,9,10,38
50,Fail,48,24,6,13,35
50,Fail,47,20,8,15,32
50,Fail,47,29,2,13,34
50,Fail,42,22,12,14,28
50,Fail,45,21,3,20,25
50,Fail,47,31,0,10,37
50,Fail,49,32,0,12,37
50,Fail,38,38,0,17,21
50,Fail,37,29,13,17,20
50,Fail,45,23,5,19,26
50,Fail,48,25,0,14,34
50,Fail,53,27,0,11,42
50,Fail,46,28,0,14,32
50,Fail,45,28,3,15,30
50,Fail,43,27,1,19,24
50,Fail,53,20,2,10,43
50,Fail,47,30,1,9,38
50,Fail,40,29,6,14,26
50,Fail,44,22,7,19,25
50,Fail,47,35,0,9,38
50,Fail,46,31,0,13,33
50,Fail,38,30,13,13,25
50,Fail,47,30,4,9,38
50,Fail,40,34,3,17,23
50,Fail,45,36,0,11,34
50,Fail,48,25,0,12,36
50,Fail,41,39,0,10,31
50,Fail,44,24,6,12,32
50,Fail,47,25,7,13,34
50,Fail,51,22,0,17,34
50,Fail,46,25,3,15,31
50,Fail,47,34,0,10,37
50,Fail,46,23,9,16,30
50,Fail,51,23,5,6,45
50,Fail,42,36,0,13,29
50,Fail,49,23,3,17,32
50,Fail,46,26,2,13,33
50,Fail,51,28,0,10,41
50,Fail,43,40,0,10,33
50,Fail,46,34,0,10,36
50,Fail,54,19,9,11,43
50,Fail,51,31,0,10,41
50,Fail,52,26,0,10,42
50,Fail,48,31,1,11,37
50,Success,56,25,2,6,50
50,Fail,45,16,4,24,21
50,Fail,44,34,0,12,32
50,Fail,41,37,0,13,28
50,Fail,45,32,2,10,35
50,Fail,48,24,1,16,32
50,Fail,51,22,0,17,34
50,Fail,47,28,4,11,36
50,Fail,46,32,0,10,36
50,Fail,50,23,0,13,37
50,Fail,51,25,2,10,41
50,Fail,55,26,0,11,44
50,Fail,44,32,0,13,31
50,Fail,48,21,4,20,28
50,Fail,45,25,1,15,30
50,Fail,48,32,0,9,39
50,Fail,49,24,9,10,39
50,Fail,53,18,3,13,40
50,Fail,51,28,0,14,37
50,Fail,54,22,1,11,43
50,Fail,47,25,0,14,33
50,Fail,47,22,10,11,36
50,Fail,43,30,0,17,26
50,Fail,46,22,9,13,33
50,Fail,52,24,0,9,43
50,Fail,42,29,5,13,29
50,Fail,52,24,0,12,40
50,Fail,48,30,8,6,42
50,Fail,44,26,6,13,31
50,Fail,45,32,2,12,33
50,Fail,43,27,5,15,28
50,Fail,46,26,13,8,38
50,Fail,48,28,6,11,37
50,Fail,48,20,3,18,30
50,Fail,48,27,2,10,38
50,Fail,48,23,3,12,36
50,Fail,45,29,5,14,31
50,Fail,50,27,0,12,38
50,Fail,38,34,0,19,19
50,Fail,38,25,9,20,18
50,Fail,52,19,5,16,36
50,Fail,54,25,1,9,45
50,Fail,46,29,2,14,32
50,Fail,47,25,6,14,33
50,Fail,53,25,0,9,44
50,Success,57,25,0,7,50
50,Fail,53,27,0,11,42
50,Fail,52,21,4,11,41
50,Fail,44,33,0,14,30
50,Fail,53,26,4,8,45
50,Success,56,29,0,6,50
50,Fail,47,31,1,12,35
50,Fail,44,34,0,10,34
50,Fail,46,31,0,14,32
50,Fail,44,31,0,21,23
50,Fail,44,27,6,11,33
50,Fail,45,26,0,20,25
50,Fail,46,35,0,9,37
50,Fail,45,34,0,10,35
50,Fail,56,17,4,13,43
50,Fail,41,33,0,15,26
50,Fail,46,32,0,7,39
50,Fail,50,25,0,10,40
50,Fail,45,27,7,14,31
50,Fail,53,30,0,6,47
50,Fail,43,26,5,14,29
50,Fail,46,25,4,14,32
50,Fail,47,28,0,14,33
50,Fail,43,33,2,11,32
50,Fail,47,24,3,15,32
50,Fail,54,21,3,11,43
50,Fail,50,21,0,13,37
50,Fail,50,33,0,9,41
50,Fail,44,36,7,3,41
50,Fail,43,30,2,12,31
50,Fail,53,20,0,14,39
50,Fail,46,33,0,13,33
50,Fail,49,20,0,20,29
50,Fail,42,23,16,12,30
50,Fail,46,26,0,20,26
50,Fail,42,38,0,14,28
50,Fail,51,21,0,10,41
50,Fail,55,15,0,14,41
50,Fail,56,18,3,12,44
50,Fail,51,27,0,10,41
50,Fail,52,28,0,10,42
50,Fail,52,30,0,9,43
50,Fail,45,34,0,15,30
50,Fail,49,35,0,6,43
50,Fail,56,21,0,10,46
50,Fail,52,28,0,9,43
50,Fail,42,38,0,12,30
50,Fail,48,31,0,12,36
50,Fail,46,19,2,18,28
50,Fail,48,24,1,16,32
50,Fail,52,24,0,15,37
50,Fail,47,32,0,11,36
50,Fail,41,36,0,18,23
50,Fail,43,33,0,13,30
50,Fail,45,35,0,15,30
50,Fail,46,32,0,13,33
50,Fail,51,29,0,10,41
50,Fail,46,31,8,9,37
50,Fail,47,30,0,9,38
50,Fail,57,22,1,10,47
50,Fail,53,23,2,9,44
50,Fail,51,23,0,14,37
50,Fail,47,19,3,15,32
50,Fail,53,26,0,11,42
50,Fail,52,22,7,7,45
50,Fail,46,30,1,14,32
50,Fail,47,30,0,12,35
50,Fail,44,30,0,12,32
50,Fail,55,16,0,15,40
50,Fail,43,28,6,13,30
50,Fail,56,20,1,9,47
50,Fail,42,38,0,13,29
50,Fail,52,25,0,8,44
50,Fail,45,33,0,11,34
50,Fail,51,27,4,9,42
50,Fail,54,14,7,10,44
50,Fail,43,26,8,15,28
50,Fail,51,21,0,14,37
50,Fail,52,26,0,11,41
50,Fail,48,29,0,8,40
50,Fail,51,27,0,11,40
50,Fail,41,32,0,19,22
50,Fail,36,32,4,17,19
50,Fail,47,35,0,9,38
50,Fail,50,24,4,15,35
50,Fail,41,30,0,20,21
50,Fail,46,28,0,16,30
50,Fail,52,27,0,8,44
50,Fail,54,22,0,11,43
50,Fail,48,27,0,16,32
50,Fail,53,28,0,7,46
50,Fail,47,26,1,16,31
50,Fail,51,26,2,7,44
50,Fail,51,27,0,12,39
50,Fail,48,27,2,9,39
50,Fail,51,29,1,10,41
50,Fail,50,19,0,11,39
50,Fail,49,26,0,11,38
50,Fail,49,34,0,7,42
50,Fail,49,27,0,11,38
50,Fail,45,26,8,7,38
50,Fail,43,36,0,12,31
50,Fail,54,23,0,8,46
50,Fail,43,26,12,12,31
50,Fail,45,27,3,10,35
50,Fail,53,31,0,10,43
50,Fail,45,40,0,8,37
50,Fail,49,26,0,16,33
50,Fail,53,26,0,9,44
50,Fail,44,34,0,12,32
50,Fail,54,23,1,8,46
50,Fail,43,30,0,17,26
50,Fail,55,20,1,8,47
50,Fail,54,17,7,12,42
50,Fail,50,23,0,16,34
50,Fail,47,22,7,17,30
50,Fail,41,31,3,12,29
50,Fail,46,31,0,17,29
50,Fail,47,25,4,13,34
50,Fail,47,27,1,18,29
50,Fail,43,29,0,18,25
50,Fail,46,28,0,17,29
50,Fail,46,28,2,12,34
50,Fail,48,31,5,7,41
50,Fail,48,31,0,15,33
50,Fail,53,24,2,12,41
50,Fail,43,33,0,15,28
50,Fail,45,28,2,11,34
50,Fail,46,28,12,10,36
50,Fail,50,25,0,13,37
50,Fail,48,25,7,12,36
50,Fail,44,35,0,11,33
50,Fail,55,19,6,8,47
50,Fail,45,35,0,13,32
50,Fail,52,28,0,10,42
50,Fail,46,30,0,10,36
50,Fail,53,23,0,12,41
50,Fail,50,24,4,9,41
50,Fail,45,27,0,17,28
50,Fail,54,20,0,12,42
50,Fail,48,24,3,12,36
50,Fail,42,27,8,15,27
50,Fail,51,22,1,16,35
50,Fail,50,28,0,9,41
50,Fail,51,29,0,8,43
50,Fail,37,33,4,16,21
50,Fail,43,26,0,23,20
50,Fail,44,31,0,16,28
50,Fail,49,25,2,12,37
50,Fail,46,27,2,16,30
50,Fail,54,16,0,19,35
50,Fail,53,22,0,16,37
50,Fail,49,25,5,8,41
50,Fail,47,24,5,13,34
50,Fail,42,26,10,13,29
50,Fail,54,27,4,9,45
50,Fail,48,35,0,9,39
50,Fail,51,23,1,13,38
50,Fail,51,23,4,13,38
50,Fail,51,22,0,16,35
50,Fail,55,20,0,12,43
50,Fail,47,26,2,11,36
50,Fail,52,26,0,9,43
50,Fail,50,32,0,10,40
50,Fail,43,33,0,17,26
50,Fail,49,30,0,12,37
50,Fail,50,26,2,13,37
50,Fail,48,26,0,14,34
50,Fail,51,27,2,11,40
50,Fail,50,24,0,11,39
50,Fail,43,23,8,16,27
50,Fail,38,30,7,13,25
50,Fail,41,27,12,12,29
50,Fail,44,32,0,16,28
50,Fail,45,27,4,12,33
50,Fail,41,37,0,12,29
50,Fail,53,24,0,12,41
50,Fail,52,21,0,14,38
50,Fail,52,22,0,16,36
50,Fail,47,28,0,15,32
50,Fail,47,24,6,11,36
50,Fail,44,35,0,13,31
50,Fail,43,25,0,22,21
50,Fail,52,27,0,14,38
50,Fail,40,27,5,16,24
50,Fail,43,36,0,12,31
50,Fail,53,22,6,11,42
50,Fail,51,26,2,13,38
50,Fail,47,31,0,12,35
50,Fail,49,29,0,12,37
50,Fail,50,23,0,12,38
50,Fail,50,31,0,8,42
50,Fail,54,20,3,10,44
50,Fail,44,29,4,13,31
50,Fail,46,33,0,12,34
50,Fail,47,26,0,16,31
50,Fail,47,32,3,9,38
50,Fail,45,24,3,16,29
50,Fail,56,16,3,13,43
50,Fail,46,39,0,9,37
50,Fail,54,24,0,10,44
50,Fail,51,15,6,14,37
50,Fail,47,28,1,11,36
50,Fail,44,29,0,13,31
50,Fail,47,24,4,15,32
50,Fail,49,21,8,15,34
50,Fail,49,27,5,10,39
50,Fail,54,15,0,13,41
50,Fail,45,25,6,13,32
50,Fail,51,24,0,17,34
50,Fail,48,25,1,11,37
50,Fail,52,27,1,9,43
50,Fail,50,30,0,12,38
50,Fail,45,22,11,15,30
50,Fail,41,29,6,15,26
50,Fail,47,30,0,10,37
50,Fail,54,22,0,12,42
50,Fail,56,20,1,14,42
50,Fail,39,32,7,11,28
50,Fail,53,25,0,10,43
50,Fail,52,27,0,10,42
50,Fail,49,30,1,6,43
50,Fail,54,28,0,9,45
50,Fail,49,28,0,12,37
50,Fail,55,25,0,12,43
50,Fail,47,25,10,9,38
50,Fail,55,20,2,10,45
50,Fail,50,26,0,12,38
50,Fail,49,25,0,14,35
50,Fail,47,28,0,13,34
50,Fail,42,34,0,12,30
50,Fail,48,24,8,12,36
50,Fail,43,23,2,17,26
50,Success,58,24,2,6,52
50,Fail,48,35,0,10,38
50,Fail,48,32,0,10,38
50,Fail,46,27,1,16,30
50,Fail,50,25,0,13,37
50,Fail,43,30,6,11,32
50,Success,60,15,4,9,51
50,Fail,45,26,8,8,37
50,Fail,44,31,0,15,29
50,Fail,53,30,0,7,46
50,Fail,36,32,9,14,22
50,Fail,48,30,0,16,32
50,Fail,49,22,0,15,34
50,Fail,41,36,9,9,32
50,Fail,41,35,0,13,28
50,Fail,49,34,0,8,41
50,Fail,34,43,0,19,15
50,Fail,44,30,2,13,31
50,Fail,56,23,0,11,45
50,Fail,48,26,6,8,40
50,Fail,43,29,0,17,26
50,Fail,46,29,4,12,34
50,Fail,43,27,9,13,30
50,Fail,50,32,3,4,46
50,Success,59,23,0,8,51
50,Fail,44,25,7,14,30
50,Fail,47,27,6,13,34
50,Fail,53,24,0,6,47
50,Fail,55,20,0,10,45
50,Fail,51,24,1,12,39
50,Fail,57,17,2,10,47
50,Fail,51,25,4,6,45
50,Fail,38,29,9,15,23
50,Fail,43,32,5,9,34
50,Fail,50,31,0,10,40
50,Fail,49,29,0,9,40
50,Fail,45,28,3,13,32
50,Fail,51,32,0,10,41
50,Fail,46,36,0,9,37
50,Fail,53,22,0,14,39
50,Fail,51,24,0,12,39
50,Fail,49,29,2,9,40
50,Fail,45,29,0,13,32
50,Fail,44,27,9,13,31
50,Fail,45,32,0,13,32
50,Fail,45,27,2,14,31
50,Fail,48,29,0,11,37
50,Fail,53,23,0,10,43
50,Fail,42,41,0,13,29
50,Fail,44,38,0,11,33
50,Fail,45,32,0,12,33
50,Fail,53,20,1,15,38
50,Fail,44,36,0,9,35
50,Fail,40,33,12,8,32
50,Fail,51,22,3,16,35
50,Fail,51,26,0,11,40
50,Fail,45,36,0,14,31
50,Fail,43,36,0,13,30
50,Fail,53,23,4,9,44
50,Fail,58,20,0,9,49
50,Fail,58,15,1,11,47
50,Fail,58,23,1,9,49
50,Fail,57,25,0,8,49
50,Fail,52,27,0,13,39
50,Fail,42,33,0,14,28
50,Fail,53,23,0,14,39
50,Fail,43,25,8,13,30
50,Fail,49,24,5,8,41
50,Fail,47,22,6,18,29
50,Fail,54,20,4,12,42
50,Fail,48,24,0,18,30
50,Fail,47,19,3,15,32
50,Fail,46,23,8,11,35
50,Fail,51,28,13,4,47
50,Fail,56,19,0,7,49
50,Fail,50,21,4,12,38
50,Fail,49,22,0,15,34
50,Fail,57,17,0,13,44
50,Fail,45,37,0,11,34
50,Fail,54,19,2,13,41
50,Fail,44,27,5,12,32
50,Fail,45,27,6,10,35
50,Fail,49,24,0,11,38
50,Fail,50,28,0,13,37
50,Fail,42,30,0,17,25
50,Fail,48,25,2,12,36
50,Fail,55,24,0,10,45
50,Fail,47,28,4,12,35
50,Fail,45,27,4,13,32
50,Fail,48,24,2,14,34
50,Fail,37,40,0,14,23
50,Fail,47,34,0,7,40
50,Fail,52,25,0,12,40
50,Fail,46,27,0,15,31
50,Fail,46,32,4,9,37
50,Fail,56,19,3,11,45
50,Fail,45,22,1,18,27
50,Fail,52,22,2,12,40
50,Fail,49,30,0,11,38
50,Fail,55,26,0,10,45
50,Fail,56,17,3,9,47
50,Fail,37,28,13,16,21
50,Fail,52,26,1,8,44
50,Fail,44,25,0,19,25
50,Fail,46,29,0,10,36
50,Fail,46,28,0,17,29
50,Fail,45,35,0,10,35
50,Fail,51,29,0,9,42
50,Fail,53,22,1,11,42
50,Fail,54,20,7,11,43
50,Fail,46,26,0,15,31
50,Fail,48,27,0,13,35
50,Fail,46,29,0,11,35
50,Fail,50,18,1,18,32
50,Fail,46,26,9,9,37
50,Fail,43,37,0,14,29
50,Fail,50,23,0,13,37
50,Fail,43,36,1,7,36
50,Fail,52,19,4,13,39
50,Fail,48,23,1,14,34
50,Fail,43,32,0,14,29
50,Fail,47,34,0,11,36
50,Fail,44,30,0,14,30
50,Fail,52,28,6,6,46
50,Fail,46,24,4,13,33
50,Fail,49,20,7,17,32
50,Fail,52,25,6,11,41
50,Fail,52,22,5,12,40
50,Fail,52,23,1,12,40
50,Fail,41,30,0,18,23
50,Fail,51,28,0,9,42
50,Fail,46,26,0,17,29
50,Fail,48,25,1,13,35
50,Fail,36,42,0,14,22
50,Fail,48,21,10,11,37
50,Success,55,28,0,5,50
50,Fail,40,31,4,18,22
50,Fail,49,28,0,10,39
50,Fail,44,25,6,15,29
50,Fail,48,27,4,12,36
50,Fail,47,16,13,15,32
50,Fail,53,24,1,9,44
50,Fail,49,19,15,14,35
50,Fail,50,30,0,10,40
50,Fail,44,25,10,13,31
50,Fail,48,24,0,16,32
50,Fail,48,25,4,13,35
50,Success,58,21,0,8,50
50,Fail,51,29,0,9,42
50,Fail,45,29,0,14,31
50,Fail,42,32,0,17,25
50,Fail,51,26,0,10,41
50,Fail,49,32,0,9,40
50,Fail,55,21,0,14,41
50,Fail,48,28,1,12,36
50,Fail,41,37,0,15,26
50,Fail,45,27,0,15,30
50,Fail,43,39,0,9,34
50,Fail,47,21,14,13,34
50,Fail,51,25,0,13,38
50,Fail,50,27,0,13,37
50,Fail,52,21,0,13,39
50,Fail,41,41,0,11,30
50,Fail,45,27,5,14,31
50,Fail,45,27,0,19,26
50,Fail,52,26,3,12,40
50,Fail,50,31,0,10,40
50,Fail,49,27,0,14,35
50,Fail,51,22,5,13,38
50,Fail,49,27,0,14,35
50,Fail,50,30,0,9,41
50,Fail,50,23,0,16,34
50,Fail,44,32,0,16,28
50,Fail,46,26,10,12,34
50,Fail,43,22,6,19,24
50,Fail,47,20,18,11,36
50,Fail,44,23,1,20,24
50,Fail,48,24,4,14,34
50,Fail,54,19,1,14,40
50,Fail,48,31,0,14,34
50,Fail,47,27,1,13,34
50,Fail,45,29,7,10,35
50,Fail,46,29,0,14,32
50,Success,55,28,0,5,50
50,Fail,39,29,6,15,24
50,Fail,48,28,0,14,34
50,Fail,46,28,0,17,29
50,Fail,47,28,5,13,34
50,Fail,47,25,8,10,37
50,Fail,45,40,0,8,37
50,Fail,39,30,0,18,21
50,Fail,50,21,0,14,36
50,Fail,49,35,0,9,40
50,Fail,44,26,0,20,24
50,Fail,46,25,0,18,28
50,Fail,52,22,0,12,40
50,Fail,36,36,0,19,17
50,Fail,51,21,2,12,39
50,Fail,54,21,0,14,40
50,Fail,48,36,0,8,40
50,Fail,51,25,3,9,42
50,Fail,50,27,1,12,38
50,Fail,45,24,4,15,30
50,Fail,44,25,4,16,28
50,Fail,49,20,1,17,32
50,Fail,48,24,0,16,32
50,Fail,41,31,0,15,26
50,Fail,46,30,0,16,30
50,Fail,49,25,0,12,37
50,Fail,43,27,3,18,25
50,Fail,45,27,0,11,34
50,Fail,49,19,9,12,37
50,Fail,49,20,5,14,35
50,Fail,47,31,4,8,39
50,Fail,45,30,5,7,38
50,Fail,46,25,11,9,37
50,Fail,47,24,0,17,30
50,Fail,50,26,2,9,41
50,Fail,53,23,0,11,42
50,Fail,42,23,3,19,23
50,Fail,51,22,7,13,38
50,Fail,43,31,0,13,30
50,Fail,48,28,0,12,36
50,Fail,53,20,0,13,40
50,Fail,47,21,9,14,33
50,Fail,53,20,2,15,38
50,Fail,51,19,0,18,33
50,Fail,42,26,5,15,27
50,Fail,54,19,2,12,42
50,Fail,53,17,1,14,39
50,Fail,48,25,1,10,38
50,Fail,45,29,8,13,32
50,Fail,50,32,0,9,41
50,Fail,48,22,11,11,37
50,Fail,46,33,0,11,35
50,Fail,49,21,0,16,33
50,Fail,45,32,0,13,32
50,Fail,52,22,0,13,39
50,Fail,52,29,0,9,43
50,Fail,42,27,0,17,25
50,Fail,49,26,0,14,35
50,Fail,53,21,1,14,39
50,Fail,56,26,0,8,48
50,Fail,50,33,5,4,46
50,Fail,53,33,0,8,45
50,Fail,48,32,2,8,40
50,Fail,43,27,2,16,27
50,Fail,45,29,0,15,30
50,Fail,52,21,0,13,39
50,Fail,45,30,0,18,27
50,Fail,52,23,4,10,42
50,Fail,49,23,3,11,38
50,Fail,46,33,0,10,36
50,Fail,51,20,4,14,37
50,Fail,50,31,0,7,43
50,Fail,53,22,0,13,40
50,Fail,49,27,9,10,39
50,Fail,50,28,0,11,39
50,Fail,46,30,6,11,35
50,Fail,40,31,8,11,29
50,Fail,44,31,0,17,27
50,Fail,48,21,2,18,30
50,Fail,44,34,0,15,29
50,Fail,49,22,5,17,32
50,Fail,40,44,0,7,33
50,Fail,54,18,1,15,39
50,Fail,52,24,1,7,45
50,Fail,48,26,5,11,37
50,Fail,41,34,0,14,27
50,Fail,56,20,0,13,43
50,Fail,48,26,3,11,37
50,Fail,43,26,3,14,29
50,Fail,50,18,5,16,34
50,Fail,52,27,5,10,42
50,Fail,52,21,6,13,39
50,Fail,53,30,0,9,44
50,Fail,50,29,0,8,42
50,Fail,51,25,0,14,37
50,Fail,48,22,0,19,29
50,Fail,46,36,0,10,36
50,Fail,48,32,0,10,38
50,Fail,49,27,1,9,40
50,Fail,53,29,0,13,40
50,Fail,50,25,0,13,37
50,Fail,36,29,8,20,16
50,Fail,47,31,0,11,36
50,Fail,38,32,5,18,20
50,Fail,51,26,0,9,42
50,Success,57,26,2,5,52
50,Fail,46,28,0,16,30
50,Fail,45,26,8,12,33
50,Fail,42,34,0,13,29
50,Fail,49,26,3,13,36
50,Fail,47,28,2,13,34
50,Success,56,25,2,6,50
50,Fail,44,28,5,14,30
50,Fail,47,35,0,10,37
50,Fail,52,23,8,10,42
50,Fail,43,27,0,18,25
50,Fail,39,44,0,13,26
50,Fail,51,19,0,12,39
50,Fail,50,27,2,8,42
50,Fail,49,27,0,17,32
50,Fail,41,25,5,20,21
50,Fail,55,23,6,6,49
50,Fail,53,19,0,15,38
50,Fail,36,42,0,16,20
50,Fail,47,31,2,13,34
50,Fail,51,22,3,14,37
50,Fail,51,24,0,13,38
50,Fail,56,21,1,9,47
50,Fail,50,31,0,7,43
50,Fail,44,24,12,15,29
50,Fail,44,27,4,11,33
50,Fail,47,31,3,10,37
50,Fail,54,19,3,9,45
50,Fail,42,35,5,13,29
50,Fail,47,25,3,11,36
50,Fail,48,26,3,13,35
50,Fail,51,21,4,11,40
50,Fail,52,22,4,12,40
50,Fail,47,26,5,15,32
50,Fail,47,25,0,16,31
50,Fail,52,22,3,11,41
50,Fail,56,24,0,9,47
50,Fail,34,31,3,21,13
50,Fail,54,24,4,7,47
50,Fail,47,24,0,23,24
50,Fail,46,23,6,14,32
50,Fail,47,29,3,12,35
50,Fail,42,33,0,13,29
50,Fail,55,25,4,6,49
50,Fail,52,26,1,9,43
50,Fail,49,19,4,14,35
50,Fail,38,26,5,19,19
50,Fail,47,28,6,10,37
50,Fail,47,24,4,11,36
50,Fail,50,26,2,10,40
50,Fail,49,29,0,12,37
50,Fail,51,24,3,11,40
50,Fail,53,19,0,14,39
50,Fail,49,24,3,12,37
50,Fail,47,30,0,13,34
50,Fail,52,25,1,12,40
50,Fail,43,25,11,13,30
50,Fail,48,30,1,14,34
50,Fail,44,30,6,10,34
50,Fail,46,31,0,9,37
50,Fail,44,32,2,12,32
50,Fail,43,29,8,16,27
50,Fail,42,29,0,14,28
50,Fail,43,31,0,14,29
50,Fail,50,26,0,11,39
50,Fail,46,33,0,12,34
50,Fail,44,44,0,7,37
50,Fail,41,26,0,24,17
50,Fail,48,23,4,15,33
50,Fail,50,22,3,14,36
50,Fail,48,30,0,9,39
50,Fail,50,26,6,8,42
50,Fail,43,33,2,14,29
50,Fail,51,24,0,14,37
50,Fail,58,19,0,12,46
50,Fail,45,30,0,15,30
50,Fail,46,28,0,16,30
50,Success,53,26,6,3,50
50,Fail,49,27,0,9,40
50,Fail,55,25,0,9,46
50,Fail,49,18,2,21,28
50,Fail,47,26,3,13,34
50,Fail,45,28,1,12,33
50,Fail,42,29,0,16,26
50,Fail,51,32,0,11,40
50,Fail,40,35,0,15,25
50,Fail,48,25,2,12,36
50,Fail,46,30,6,8,38
50,Fail,48,27,0,13,35
50,Success,56,29,0,6,50
50,Success,58,26,0,7,51
50,Fail,48,33,0,11,37
50,Fail,54,25,0,8,46
50,Fail,48,31,0,9,39
50,Fail,46,21,2,18,28
50,Fail,53,25,1,10,43
50,Fail,55,22,2,10,45
50,Fail,56,20,2,8,48
50,Fail,41,29,4,16,25
50,Fail,45,25,1,19,26
50,Fail,45,28,0,15,30
50,Fail,45,28,3,9,36
50,Fail,55,19,0,10,45
50,Fail,55,27,0,8,47
50,Fail,34,33,6,18,16
50,Fail,51,26,0,14,37
50,Fail,52,28,0,8,44
50,Fail,52,25,3,11,41
50,Fail,47,28,9,7,40
50,Fail,41,36,0,15,26
50,Fail,43,26,2,18,25
50,Fail,48,26,0,11,37
50,Fail,43,23,7,17,26
50,Fail,53,24,0,9,44
50,Fail,53,26,0,8,45
50,Fail,51,25,3,13,38
50,Fail,46,29,1,15,31
50,Fail,44,31,0,15,29
50,Fail,57,18,0,11,46
50,Fail,55,26,0,11,44
50,Fail,48,22,0,21,27
50,Fail,43,31,0,13,30
50,Fail,46,28,3,13,33
50,Fail,56,18,1,12,44
50,Fail,41,33,8,12,29
50,Fail,52,24,0,11,41
50,Fail,57,24,2,8,49
50,Fail,52,21,0,9,43
50,Fail,57,17,4,13,44
50,Fail,53,22,1,11,42
50,Fail,50,30,0,10,40
50,Fail,44,30,1,14,30
50,Fail,50,30,0,9,41
50,Success,57,23,0,7,50
50,Fail,45,38,0,11,34
50,Fail,40,25,3,20,20
50,Fail,36,29,5,22,14
50,Fail,47,27,0,12,35
50,Fail,50,29,3,10,40
50,Fail,44,26,9,14,30
50,Fail,50,28,0,9,41
50,Fail,47,26,0,15,32
50,Fail,47,27,0,13,34
50,Fail,47,30,8,8,39
50,Fail,41,37,0,11,30
50,Fail,40,27,0,21,19
50,Fail,51,25,0,15,36
50,Fail,48,31,5,8,40
50,Fail,53,19,3,13,40
50,Fail,43,29,0,15,28
50,Fail,45,34,0,12,33
50,Fail,50,25,0,16,34
50,Fail,50,31,0,13,37
50,Fail,45,34,0,11,34
50,Fail,48,25,0,17,31
50,Fail,46,31,8,5,41
50,Fail,42,31,3,10,32
50,Fail,51,23,0,13,38
50,Fail,36,34,12,14,22
50,Fail,52,20,0,18,34
50,Fail,49,25,0,16,33
50,Fail,52,23,0,10,42
50,Fail,48,27,4,10,38
50,Fail,49,28,0,11,38
50,Fail,55,25,0,8,47
50,Fail,45,27,0,21,24
50,Fail,54,20,0,11,43
50,Fail,45,29,0,14,31
50,Fail,57,25,1,8,49
50,Fail,40,33,0,11,29
50,Fail,45,26,4,17,28
50,Fail,52,25,0,9,43
50,Fail,49,28,0,15,34
50,Fail,40,33,0,16,24
50,Fail,49,24,3,12,37
50,Success,58,24,0,7,51
50,Fail,52,24,0,12,40
50,Fail,48,26,6,11,37
50,Fail,48,32,0,14,34
50,Fail,46,20,1,20,26
50,Fail,49,26,1,14,35
50,Fail,55,23,0,10,45
50,Fail,47,28,0,9,38
50,Fail,47,27,1,12,35
50,Fail,52,21,0,13,39
50,Fail,42,33,0,13,29
50,Fail,53,18,0,17,36
50,Fail,57,25,0,8,49
50,Fail,39,33,3,13,26
50,Fail,44,31,3,8,36
50,Fail,51,23,0,12,39
50,Fail,45,29,0,14,31
50,Fail,49,31,0,9,40
50,Fail,41,39,0,13,28
50,Fail,56,27,0,10,46
50,Fail,49,29,0,10,39
50,Fail,49,20,3,13,36
50,Fail,46,24,1,15,31
50,Fail,47,26,1,15,32
50,Fail,47,19,5,18,29
50,Fail,35,29,7,19,16
50,Fail,51,23,0,14,37
50,Fail,48,26,0,16,32
50,Fail,46,30,0,16,30
50,Fail,45,25,9,11,34
50,Fail,58,19,0,12,46
50,Fail,46,25,2,17,29
50,Fail,50,25,0,12,38
50,Fail,43,29,0,16,27
50,Fail,55,27,0,9,46
50,Fail,50,32,0,8,42
50,Success,59,22,0,8,51
50,Fail,47,19,7,17,30
50,Fail,46,29,0,14,32
50,Fail,47,27,0,15,32
50,Fail,46,30,7,8,38
50,Fail,37,33,0,20,17
50,Fail,47,31,0,12,35
50,Fail,47,28,0,16,31
50,Fail,56,23,5,7,49
50,Fail,49,28,2,13,36
50,Fail,50,31,0,12,38
50,Fail,53,22,0,15,38
50,Fail,48,27,0,12,36
50,Fail,52,29,4,8,44
50,Fail,47,27,4,13,34
50,Fail,47,27,0,13,34
50,Fail,37,30,10,14,23
50,Fail,53,27,0,9,44
50,Fail,47,35,0,12,35
50,Fail,43,39,0,10,33
50,Fail,50,25,0,16,34
50,Fail,44,27,10,12,32
50,Fail,46,22,6,16,30
50,Fail,53,19,7,11,42
50,Fail,53,20,2,12,41
50,Fail,52,25,0,13,39
50,Fail,53,33,0,6,47
50,Fail,50,25,0,12,38
50,Fail,50,21,4,12,38
50,Fail,51,22,0,10,41
50,Fail,53,26,0,11,42
50,Fail,46,25,2,14,32
50,Fail,40,36,0,17,23
50,Fail,37,34,10,10,27
50,Fail,53,25,0,8,45
50,Fail,44,25,0,21,23
50,Fail,47,29,1,10,37
50,Fail,41,29,11,10,31
50,Fail,49,30,2,10,39
50,Fail,53,25,3,11,42
50,Fail,50,25,2,12,38
50,Fail,55,29,0,9,46
50,Fail,50,30,0,15,35
50,Fail,47,22,6,15,32
50,Fail,55,19,0,12,43
50,Fail,47,35,0,13,34
50,Fail,55,24,0,8,47
50,Fail,46,24,0,16,30
50,Fail,43,27,4,17,26
50,Fail,52,20,6,15,37
50,Fail,49,30,0,13,36
50,Fail,46,29,2,11,35
50,Fail,42,33,0,13,29
50,Fail,53,23,4,8,45
50,Fail,55,18,0,13,42
50,Fail,44,20,6,16,28
50,Fail,51,21,3,16,35
50,Success,60,18,0,9,51
50,Fail,51,24,0,14,37
50,Fail,43,33,0,16,27
50,Fail,45,27,0,15,30
50,Fail,44,31,0,13,31
50,Fail,56,26,0,8,48
50,Fail,55,22,1,10,45
50,Fail,38,38,0,17,21
50,Fail,44,27,7,14,30
50,Fail,47,28,4,14,33
50,Fail,43,32,0,14,29
50,Fail,43,33,2,9,34
50,Fail,50,23,1,13,37
50,Fail,54,17,3,18,36
50,Fail,45,23,0,19,26
50,Fail,47,22,1,18,29
50,Fail,45,26,0,17,28
50,Fail,54,27,4,8,46
50,Fail,46,31,0,13,33
50,Fail,45,26,3,15,30
50,Fail,51,25,0,12,39
50,Fail,49,27,4,8,41
50,Fail,45,28,0,16,29
50,Fail,48,23,4,14,34
50,Fail,53,28,4,8,45
50,Fail,46,40,0,8,38
50,Fail,51,30,0,12,39
50,Fail,48,24,0,16,32
50,Fail,48,28,7,9,39
50,Fail,47,33,0,13,34
50,Fail,54,17,7,13,41
50,Fail,42,37,0,12,30
50,Fail,48,30,2,7,41
50,Fail,47,31,0,13,34
50,Fail,42,31,0,18,24
50,Fail,53,24,0,8,45
50,Fail,45,36,0,11,34
50,Fail,51,21,1,17,34
50,Fail,47,26,1,11,36
50,Fail,48,27,0,13,35
50,Fail,46,25,0,18,28
50,Fail,49,27,0,13,36
50,Fail,46,25,6,14,32
50,Fail,54,25,0,8,46
50,Fail,46,26,6,13,33
50,Fail,48,29,8,9,39
50,Fail,45,30,0,15,30
50,Fail,51,27,0,12,39
50,Fail,37,33,10,15,22
50,Fail,53,22,6,8,45
50,Fail,43,35,0,11,32
50,Fail,41,25,4,18,23
50,Fail,44,28,3,14,30
50,Fail,52,28,2,8,44
50,Fail,42,20,12,14,28
50,Fail,45,29,3,11,34
50,Fail,48,28,1,14,34
50,Fail,45,30,6,12,33
50,Fail,51,32,0,11,40
50,Fail,43,28,2,14,29
50,Fail,45,22,7,17,28
50,Fail,48,28,2,9,39
50,Fail,55,20,0,16,39
50,Fail,42,26,7,16,26
50,Fail,48,31,0,11,37
50,Fail,41,30,0,18,23
50,Fail,41,28,10,11,30
50,Fail,52,23,0,11,41
50,Fail,44,40,0,5,39
50,Fail,50,24,0,10,40
50,Fail,47,28,0,12,35
50,Fail,50,33,0,12,38
50,Fail,46,34,0,11,35
50,Fail,49,34,0,7,42
50,Fail,48,27,0,12,36
50,Fail,48,24,0,14,34
50,Fail,48,22,1,12,36
50,Fail,41,36,0,14,27
50,Fail,49,28,0,10,39
50,Fail,46,33,0,13,33
50,Fail,46,34,0,10,36
50,Fail,40,27,0,18,22
50,Fail,46,27,6,15,31
50,Fail,47,23,1,17,30
50,Success,58,22,6,7,51
50,Fail,50,26,6,8,42
50,Fail,42,27,4,18,24
50,Fail,41,28,4,16,25
50,Fail,38,32,6,16,22
50,Fail,46,25,0,18,28
50,Fail,46,33,0,13,33
50,Fail,48,28,0,12,36
50,Fail,40,29,5,16,24
50,Fail,48,19,5,17,31
50,Fail,54,23,0,10,44
50,Fail,50,20,4,18,32
50,Fail,41,33,0,16,25
50,Fail,48,27,0,15,33
50,Fail,49,28,0,14,35
50,Success,55,30,2,2,53
50,Fail,49,31,0,11,38
50,Fail,43,29,0,17,26
50,Fail,47,26,0,16,31
50,Fail,48,21,8,15,33
50,Fail,49,24,9,10,39
50,Fail,45,30,0,16,29
50,Fail,53,25,6,9,44
50,Fail,45,26,0,15,30
50,Fail,44,22,3,18,26
50,Fail,52,18,3,11,41
50,Fail,54,18,3,13,41
50,Fail,50,23,7,11,39
50,Fail,42,35,0,11,31
50,Fail,49,26,2,14,35
50,Fail,57,18,8,10,47
50,Fail,43,28,7,12,31
50,Fail,48,27,0,15,33
50,Success,58,27,0,3,55
50,Fail,49,29,0,11,38
50,Fail,50,25,0,15,35
50,Fail,49,26,0,12,37
50,Fail,52,27,0,10,42
50,Fail,45,32,5,9,36
50,Fail,38,32,6,13,25
50,Fail,55,24,5,7,48
50,Fail,55,19,7,10,45
50,Fail,42,31,5,11,31
50,Fail,45,32,6,11,34
50,Fail,46,34,0,11,35
50,Fail,40,32,0,15,25
50,Fail,49,28,0,13,36
50,Fail,44,29,3,10,34
50,Fail,54,31,0,8,46
50,Fail,46,29,0,12,34
50,Fail,51,29,0,9,42
50,Fail,48,28,1,15,33
50,Fail,52,36,0,8,44
50,Fail,48,22,3,12,36
50,Fail,51,29,0,10,41
50,Fail,47,23,4,15,32
50,Fail,47,30,6,10,37
50,Fail,46,34,0,11,35
50,Fail,53,20,0,9,44
50,Fail,44,24,6,18,26
50,Fail,49,37,0,5,44
50,Fail,49,22,0,17,32
50,Fail,55,26,0,9,46
50,Fail,46,36,0,10,36
50,Fail,54,22,2,11,43
50,Fail,52,24,0,11,41
50,Fail,52,24,2,10,42
50,Fail,45,24,0,18,27
50,Fail,47,18,12,17,30
50,Fail,44,35,0,12,32
50,Fail,43,24,1,20,23
50,Fail,50,25,0,14,36
50,Fail,55,18,1,11,44
50,Fail,49,26,0,15,34
50,Fail,49,27,0,11,38
50,Fail,56,17,3,14,42
50,Fail,49,32,0,9,40
50,Fail,44,38,0,10,34
50,Fail,59,14,0,17,42
50,Fail,46,23,2,15,31
50,Fail,49,27,0,16,33
50,Fail,49,23,2,15,34
50,Fail,53,23,1,13,40
50,Fail,50,24,4,11,39
50,Fail,50,26,0,14,36
50,Fail,50,22,6,14,36
50,Fail,53,22,0,11,42
50,Fail,49,28,2,9,40
50,Fail,48,26,0,14,34
50,Fail,44,27,0,17,27
50,Fail,59,18,0,12,47
50,Fail,43,23,14,15,28
50,Fail,51,25,0,10,41
50,Fail,55,21,3,9,46
50,Fail,44,26,3,14,30
50,Fail,46,33,0,11,35
50,Fail,57,21,0,12,45
50,Fail,48,26,6,11,37
50,Fail,42,34,4,10,32
50,Fail,47,35,0,6,41
50,Fail,48,25,1,15,33
50,Fail,37,32,0,18,19
50,Fail,49,24,2,11,38
50,Fail,48,29,0,9,39
50,Fail,51,25,0,13,38
50,Fail,50,31,0,9,41
50,Fail,38,37,0,16,22
50,Fail,56,30,0,9,47
50,Fail,41,28,7,13,28
50,Fail,46,27,2,13,33
50,Fail,47,26,9,9,38
50,Fail,44,34,0,15,29
50,Fail,51,19,3,12,39
50,Fail,46,27,0,16,30
50,Fail,48,27,5,7,41
50,Fail,51,23,6,10,41
50,Fail,49,24,1,11,38
50,Fail,44,36,0,7,37
50,Fail,43,35,0,12,31
50,Fail,47,30,0,15,32
50,Fail,40,30,0,18,22
50,Fail,47,23,1,14,33
50,Fail,49,29,0,11,38
50,Fail,50,24,3,14,36
50,Fail,44,28,0,15,29
50,Fail,54,25,0,10,44
50,Fail,36,26,12,19,17
50,Fail,45,18,4,21,24
50,Fail,55,22,0,14,41
50,Fail,46,37,0,11,35
50,Fail,54,30,0,9,45
50,Fail,50,26,0,11,39
50,Fail,54,25,0,12,42
50,Fail,40,26,9,19,21
50,Fail,46,25,3,15,31
50,Fail,50,28,0,9,41
50,Fail,44,34,0,16,28
50,Fail,46,32,0,14,32
50,Fail,47,32,0,9,38
50,Fail,45,30,0,16,29
50,Fail,41,22,10,19,22
50,Fail,51,25,5,11,40
50,Fail,49,26,5,7,42
50,Fail,47,27,0,16,31
50,Fail,51,33,0,7,44
50,Fail,45,32,0,10,35
50,Fail,44,32,0,13,31
50,Fail,41,42,0,12,29
50,Fail,54,29,0,9,45
50,Fail,49,20,5,18,31
50,Fail,52,29,2,8,44
50,Fail,44,27,5,12,32
50,Fail,44,30,3,15,29
50,Fail,46,30,0,13,33
50,Fail,44,23,4,18,26
50,Fail,44,28,1,15,29
50,Fail,45,30,5,8,37
50,Fail,44,32,0,12,32
50,Fail,46,27,0,16,30
50,Fail,44,26,7,12,32
50,Fail,42,33,0,11,31
50,Fail,53,21,1,11,42
50,Fail,49,24,0,13,36
50,Fail,44,37,1,5,39
50,Fail,54,26,0,7,47
50,Fail,55,24,0,13,42
50,Fail,55,26,0,10,45
50,Fail,50,29,0,14,36
50,Fail,44,33,0,11,33
50,Fail,47,33,0,9,38
50,Fail,52,20,3,15,37
50,Fail,56,21,0,8,48
50,Fail,41,28,2,19,22
50,Fail,41,33,4,11,30
50,Fail,57,27,0,8,49
50,Fail,49,29,2,9,40
50,Fail,52,26,0,12,40
50,Fail,47,36,4,4,43
50,Fail,46,26,6,8,38
50,Fail,46,31,0,11,35
50,Fail,53,27,0,11,42
50,Fail,43,28,8,16,27
50,Fail,50,32,0,13,37
50,Fail,46,36,0,7,39
50,Fail,46,28,0,16,30
50,Fail,43,36,0,10,33
50,Fail,49,25,2,11,38
50,Fail,53,26,0,7,46
50,Fail,44,33,0,12,32
50,Fail,46,37,0,7,39
50,Fail,54,20,3,10,44
50,Fail,52,26,0,8,44
50,Fail,48,28,0,12,36
50,Fail,46,24,2,15,31
50,Fail,54,18,0,16,38
50,Fail,51,24,0,15,36
50,Fail,45,24,3,17,28
50,Fail,49,25,0,12,37
50,Fail,50,30,0,9,41
50,Fail,46,31,1,12,34
50,Fail,45,31,4,12,33
50,Fail,50,31,0,13,37
50,Fail,55,21,0,12,43
50,Fail,37,30,5,14,23
50,Fail,45,29,0,12,33
50,Fail,53,24,4,12,41
50,Fail,48,19,2,17,31
50,Fail,47,30,0,19,28
50,Fail,47,24,7,14,33
50,Fail,50,24,3,11,39
50,Fail,53,25,3,9,44
50,Fail,52,26,2,7,45
50,Fail,48,30,2,10,38
50,Fail,48,23,5,15,33
50,Fail,51,27,5,8,43
50,Fail,43,27,0,16,27
50,Fail,46,27,5,8,38
50,Fail,45,33,0,11,34
50,Fail,52,28,0,12,40
50,Fail,44,40,0,9,35
50,Fail,56,19,4,8,48
50,Fail,50,25,0,16,34
50,Fail,43,33,0,14,29
50,Fail,46,29,0,14,32
50,Fail,43,32,5,11,32
50,Fail,39,34,0,18,21
50,Fail,49,23,0,13,36
50,Fail,52,19,0,16,36
50,Fail,55,21,10,8,47
50,Fail,54,26,0,5,49
50,Fail,51,26,0,13,38
50,Fail,47,29,1,13,34
50,Fail,44,24,6,18,26
50,Fail,53,21,1,12,41
50,Fail,54,25,0,11,43
50,Fail,48,30,0,9,39
50,Fail,46,27,5,12,34
50,Fail,54,25,2,12,42
50,Fail,49,26,1,10,39
50,Fail,42,29,12,7,35
50,Fail,48,28,0,12,36
50,Fail,46,26,0,19,27
50,Fail,40,37,0,14,26
50,Fail,49,24,0,15,34
50,Fail,41,31,0,19,22
50,Fail,43,41,0,7,36
50,Fail,46,25,6,11,35
50,Fail,49,20,6,17,32
50,Fail,47,26,1,15,32
50,Fail,48,32,0,12,36
50,Fail,46,28,0,12,34
50,Fail,47,35,2,8,39
50,Fail,41,27,7,13,28
50,Fail,50,34,0,10,40
50,Fail,57,15,2,12,45
50,Fail,51,29,2,7,44
50,Fail,48,22,5,15,33
50,Fail,39,24,10,18,21
50,Fail,47,33,0,9,38
50,Fail,53,28,0,8,45
50,Fail,45,27,3,15,30
50,Fail,47,33,0,7,40
50,Fail,53,27,0,11,42
50,Fail,47,26,0,11,36
50,Fail,42,41,0,9,33
50,Fail,54,18,0,15,39
50,Success,55,25,0,5,50
50,Fail,51,20,0,14,37
50,Fail,55,22,1,13,42
50,Fail,48,37,0,9,39
50,Fail,51,26,0,10,41
50,Fail,52,22,5,14,38
50,Fail,46,28,2,14,32
50,Fail,52,24,0,16,36
50,Fail,44,30,0,15,29
50,Fail,48,21,6,12,36
50,Fail,52,29,0,5,47
50,Fail,38,38,0,16,22
50,Fail,43,25,4,14,29
50,Fail,51,21,4,14,37
50,Fail,47,25,0,15,32
50,Fail,50,26,0,16,34
50,Fail,44,27,3,15,29
50,Fail,50,28,0,14,36
50,Fail,52,21,0,14,38
50,Fail,36,31,9,14,22
50,Fail,47,32,0,10,37
50,Fail,42,33,0,15,27
50,Fail,47,18,18,7,40
50,Fail,40,23,8,18,22
50,Fail,47,25,9,9,38
50,Fail,41,36,0,15,26
50,Fail,46,30,0,14,32
50,Success,56,32,1,3,53
50,Fail,47,34,0,9,38
50,Fail,50,24,1,12,38
50,Fail,53,22,4,11,42
50,Fail,50,28,0,12,38
50,Fail,52,31,0,9,43
50,Fail,49,23,2,14,35
50,Fail,53,19,0,13,40
50,Fail,47,25,0,20,27
50,Fail,42,32,0,21,21
50,Fail,44,31,2,11,33
50,Fail,56,18,0,11,45
50,Fail,49,27,0,15,34
50,Fail,50,28,0,11,39
50,Fail,42,24,6,16,26
50,Fail,42,28,2,19,23
50,Fail,56,23,0,13,43
50,Fail,48,28,1,11,37
50,Fail,45,23,14,11,34
50,Fail,48,18,2,21,27
50,Fail,46,35,0,9,37
50,Fail,37,32,3,16,21
50,Fail,46,27,3,12,34
50,Fail,47,25,2,13,34
50,Fail,61,19,0,12,49
50,Fail,49,27,1,11,38
50,Fail,51,30,0,12,39
50,Fail,44,34,0,14,30
50,Fail,41,37,0,12,29
50,Fail,54,25,3,7,47
50,Fail,55,21,6,10,45
50,Fail,49,31,0,12,37
50,Fail,41,34,0,16,25
50,Fail,54,25,5,6,48
50,Fail,38,23,13,20,18
50,Fail,49,26,0,12,37
50,Fail,41,27,10,10,31
50,Fail,41,27,7,16,25
50,Fail,43,25,5,18,25
50,Fail,52,24,1,9,43
50,Fail,52,27,6,7,45
50,Fail,46,26,3,16,30
50,Fail,47,30,6,8,39
50,Fail,50,23,5,9,41
50,Fail,51,25,0,12,39
50,Fail,44,30,2,14,30
50,Fail,50,29,0,10,40
50,Fail,48,30,0,12,36
50,Fail,43,29,2,16,27
50,Success,58,29,0,4,54
50,Fail,45,30,0,14,31
50,Fail,49,27,2,10,39
50,Fail,49,26,0,14,35
50,Fail,52,22,3,14,38
50,Fail,56,21,0,12,44
50,Fail,44,31,0,16,28
50,Fail,50,21,7,12,38
50,Fail,45,29,2,12,33
50,Fail,50,29,1,11,39
50,Fail,43,32,0,14,29
50,Fail,45,31,0,12,33
50,Fail,49,29,0,15,34
50,Fail,49,28,0,9,40
50,Fail,49,35,0,8,41
50,Fail,55,19,0,15,40
50,Fail,42,24,8,17,25
50,Fail,47,25,5,13,34
50,Fail,52,26,0,10,42
50,Fail,42,37,1,12,30
50,Fail,47,30,2,11,36
50,Fail,42,29,5,9,33
50,Success,58,22,0,6,52
50,Fail,49,35,3,5,44
50,Fail,49,27,2,12,37
50,Fail,41,31,4,13,28
50,Fail,45,27,6,9,36
50,Fail,44,23,7,14,30
50,Fail,56,24,0,7,49
50,Fail,55,22,0,12,43
50,Fail,49,29,0,13,36
50,Fail,53,22,0,10,43
50,Fail,49,27,1,11,38
50,Success,57,26,1,4,53
50,Fail,45,29,0,16,29
50,Fail,49,23,1,14,35
50,Fail,53,18,7,11,42
50,Fail,48,32,0,9,39
50,Fail,47,29,4,10,37
50,Fail,50,29,0,13,37
50,Fail,45,31,0,16,29
50,Fail,49,19,3,19,30
50,Fail,46,24,0,19,27
50,Fail,54,14,5,15,39
50,Fail,45,32,0,12,33
50,Fail,54,25,0,10,44
50,Fail,53,22,2,8,45
50,Fail,48,28,0,14,34
50,Fail,48,22,0,15,33
50,Fail,48,32,0,12,36
50,Fail,54,25,2,10,44
50,Fail,51,24,0,13,38
50,Fail,43,27,9,13,30
50,Fail,49,29,0,10,39
50,Fail,53,14,3,16,37
50,Fail,46,31,0,12,34
50,Fail,50,30,0,9,41
50,Fail,46,23,9,12,34
50,Fail,50,30,0,8,42
50,Fail,47,35,0,7,40
50,Fail,38,34,6,13,25
50,Fail,41,29,0,15,26
50,Fail,46,35,0,11,35
50,Fail,49,22,0,17,32
50,Fail,54,22,6,10,44
50,Fail,51,21,2,12,39
50,Fail,41,29,3,16,25
50,Fail,38,34,0,21,17
50,Fail,53,31,0,6,47
50,Fail,49,26,0,16,33
50,Fail,44,37,1,11,33
50,Fail,49,22,5,14,35
50,Fail,45,24,2,17,28
50,Fail,49,30,0,12,37
50,Fail,43,32,0,14,29
50,Fail,47,19,7,16,31
50,Fail,48,32,0,10,38
50,Fail,52,28,0,10,42
50,Fail,53,23,0,13,40
50,Fail,49,28,1,10,39
50,Fail,45,28,5,12,33
50,Fail,41,29,8,13,28
50,Fail,55,23,3,9,46
50,Fail,46,25,2,14,32
50,Fail,47,26,0,14,33
50,Fail,51,22,8,12,39
50,Fail,49,24,3,13,36
50,Fail,51,24,4,12,39
50,Fail,54,25,0,15,39
50,Fail,45,26,2,14,31
50,Fail,43,29,2,13,30
50,Fail,47,30,0,10,37
50,Fail,47,26,0,15,32
50,Fail,48,28,0,9,39
50,Fail,49,28,0,14,35
50,Fail,49,27,0,16,33
50,Fail,53,19,3,12,41
50,Fail,44,28,7,13,31
50,Fail,40,34,0,18,22
50,Fail,47,31,0,11,36
50,Fail,40,33,0,17,23
50,Fail,46,31,0,13,33
50,Fail,43,35,0,12,31
50,Fail,40,29,0,18,22
50,Fail,52,24,4,9,43
50,Fail,45,25,6,14,31
50,Fail,52,23,2,11,41
50,Fail,43,33,7,8,35
50,Fail,46,33,0,14,32
50,Fail,44,28,0,17,27
50,Fail,42,29,5,12,30
50,Fail,49,21,0,15,34
50,Fail,48,29,0,15,33
50,Fail,46,24,8,15,31
50,Fail,45,25,0,18,27
50,Fail,51,27,0,13,38
50,Fail,49,29,0,12,37
50,Fail,45,25,7,14,31
50,Fail,46,26,5,14,32
50,Fail,51,25,0,14,37
50,Fail,51,24,6,7,44
50,Fail,45,28,2,11,34
50,Fail,43,24,7,18,25
50,Fail,52,29,0,10,42
50,Fail,54,26,3,9,45
50,Fail,52,20,0,17,35
50,Fail,44,35,3,10,34
50,Fail,45,31,0,12,33
50,Fail,44,28,0,18,26
50,Fail,47,26,5,12,35
50,Fail,44,18,0,21,23
50,Fail,41,35,0,12,29
50,Fail,49,27,0,11,38
50,Fail,45,27,4,14,31
50,Fail,45,33,0,15,30
50,Fail,55,24,3,8,47
50,Fail,46,32,0,13,33
50,Fail,46,26,0,16,30
50,Fail,39,27,13,17,22
50,Fail,57,23,0,10,47
50,Fail,53,23,0,10,43
50,Fail,48,41,0,5,43
50,Fail,43,21,7,16,27
50,Fail,50,25,0,15,35
50,Fail,47,30,0,12,35
50,Fail,42,41,0,11,31
50,Fail,48,26,2,12,36
50,Fail,58,20,0,11,47
50,Fail,51,30,0,10,41
50,Fail,42,29,3,16,26
50,Fail,52,28,0,10,42
50,Fail,48,22,0,17,31
50,Fail,48,24,2,17,31
50,Fail,44,27,4,17,27
50,Fail,48,27,4,12,36
50,Success,56,26,0,6,50
50,Fail,41,28,5,15,26
50,Fail,43,37,0,11,32
50,Fail,50,22,3,11,39
50,Fail,49,29,0,12,37
50,Fail,49,30,0,13,36
50,Fail,49,29,0,12,37
50,Fail,50,25,4,9,41
50,Fail,45,28,0,17,28
50,Fail,50,25,2,13,37
50,Fail,53,19,5,13,40
50,Fail,37,33,0,17,20
50,Fail,46,33,0,12,34
50,Fail,44,29,0,12,32
50,Fail,50,22,1,14,36
50,Fail,44,28,7,12,32
50,Fail,43,38,0,12,31
50,Fail,49,18,2,18,31
50,Fail,42,28,0,19,23
50,Fail,51,25,0,13,38
50,Fail,51,28,0,10,41
50,Fail,49,31,0,12,37
50,Fail,46,30,0,11,35
50,Fail,50,25,4,13,37
50,Fail,54,20,6,11,43
50,Fail,54,26,0,7,47
50,Fail,51,30,0,8,43
50,Fail,46,27,0,16,30
50,Fail,48,23,3,16,32
50,Success,58,24,0,8,50
50,Fail,49,28,3,7,42
50,Fail,55,26,0,9,46
50,Fail,40,36,5,12,28
50,Fail,57,25,0,10,47
50,Success,59,22,0,9,50
50,Fail,46,33,0,14,32
50,Fail,49,27,0,12,37
50,Fail,54,13,7,13,41
50,Fail,46,27,0,13,33
50,Fail,48,31,0,9,39
50,Fail,47,28,0,16,31
50,Fail,47,36,0,8,39
50,Fail,47,30,0,11,36
50,Fail,42,33,0,13,29
50,Fail,45,25,7,11,34
50,Fail,51,19,7,12,39
50,Fail,58,23,0,10,48
50,Fail,46,32,0,16,30
50,Fail,41,30,0,20,21
50,Fail,52,29,0,8,44
50,Fail,42,31,0,16,26
50,Fail,52,19,10,12,40
50,Fail,46,31,0,11,35
50,Fail,48,26,2,13,35
50,Fail,50,22,1,16,34
50,Fail,44,30,0,14,30
50,Fail,45,24,0,16,29
50,Fail,47,26,3,8,39
50,Fail,42,34,0,14,28
50,Fail,42,28,3,13,29
50,Fail,45,36,0,13,32
50,Fail,50,30,0,8,42
50,Fail,53,19,3,13,40
50,Fail,46,34,0,14,32
50,Fail,45,31,0,15,30
50,Fail,49,27,0,10,39
50,Fail,50,31,0,9,41
50,Fail,47,31,0,13,34
50,Fail,56,21,1,9,47
50,Fail,54,26,1,7,47
50,Fail,42,33,0,15,27
50,Fail,44,27,6,15,29
50,Fail,45,25,3,13,32
50,Fail,52,26,0,7,45
50,Fail,52,21,0,17,35
50,Fail,51,21,1,14,37
50,Fail,49,27,0,13,36
50,Fail,41,37,7,8,33
50,Fail,39,33,5,13,26
50,Success,57,23,2,7,50
50,Fail,48,28,7,9,39
50,Fail,49,22,0,13,36
50,Fail,46,27,2,13,33
50,Fail,55,20,2,13,42
50,Fail,51,23,0,13,38
50,Fail,45,31,0,13,32
50,Fail,45,29,6,12,33
50,Fail,43,24,6,18,25
50,Fail,40,27,8,19,21
50,Fail,55,20,0,11,44
50,Fail,40,23,10,17,23
50,Fail,46,21,0,19,27
50,Fail,49,30,0,11,38
50,Fail,52,25,0,7,45
50,Fail,55,30,0,7,48
50,Fail,49,26,0,16,33
50,Fail,41,29,2,17,24
50,Fail,47,29,0,10,37
50,Fail,46,30,0,15,31
50,Fail,43,24,10,17,26
50,Fail,51,22,0,13,38
50,Fail,54,25,0,11,43
50,Fail,55,25,0,6,49
50,Fail,46,36,0,8,38
50,Fail,44,36,0,13,31
50,Fail,53,22,4,10,43
50,Fail,52,24,0,12,40
50,Fail,55,18,1,11,44
50,Fail,40,41,0,9,31
50,Fail,41,32,10,11,30
50,Fail,49,24,4,12,37
50,Fail,46,35,0,8,38
50,Fail,41,33,0,14,27
50,Fail,52,28,0,11,41
50,Fail,47,28,4,10,37
50,Fail,39,40,0,15,24
50,Fail,47,34,0,10,37
50,Fail,39,33,7,10,29
50,Fail,47,29,0,18,29
50,Fail,49,19,0,20,29
50,Fail,50,23,0,15,35
50,Fail,44,31,0,13,31
50,Fail,39,30,8,15,24
50,Fail,50,33,0,9,41
50,Fail,46,29,0,10,36
50,Fail,49,27,0,14,35
50,Fail,47,28,5,10,37
50,Fail,53,29,0,6,47
50,Fail,45,32,0,11,34
50,Fail,53,22,2,12,41
50,Fail,48,23,1,13,35
50,Fail,45,25,3,12,33
50,Fail,52,22,0,15,37
50,Fail,51,24,5,7,44
50,Fail,48,39,0,8,40
50,Fail,48,19,5,17,31
50,Fail,57,19,3,9,48
50,Fail,42,37,0,12,30
50,Fail,47,23,5,14,33
50,Fail,54,26,0,9,45
50,Fail,55,23,0,10,45
50,Fail,47,28,4,11,36
50,Fail,41,35,0,14,27
50,Success,58,26,0,3,55
50,Fail,46,23,5,14,32
50,Fail,50,25,3,11,39
50,Fail,54,25,0,11,43
50,Fail,53,22,0,14,39
50,Fail,45,28,1,13,32
50,Fail,47,32,0,9,38
50,Fail,53,25,0,15,38
50,Fail,47,25,0,15,32
50,Fail,42,33,0,18,24
50,Fail,45,32,0,15,30
50,Fail,45,30,0,13,32
50,Fail,45,33,0,14,31
50,Fail,54,23,3,12,42
50,Fail,50,25,0,14,36
50,Fail,46,25,2,19,27
50,Fail,55,22,2,12,43
50,Fail,53,27,4,8,45
50,Fail,48,30,0,15,33
50,Fail,46,30,0,13,33
50,Fail,40,29,0,20,20
50,Fail,44,28,3,14,30
50,Fail,52,24,3,12,40
50,Fail,42,37,0,15,27
50,Fail,52,29,0,10,42
50,Fail,42,30,1,15,27
50,Fail,56,22,0,10,46
50,Fail,44,37,0,9,35
50,Fail,49,24,0,17,32
50,Fail,41,32,0,17,24
50,Fail,46,30,6,11,35
50,Fail,49,24,0,16,33
50,Fail,51,31,0,7,44
50,Fail,46,35,0,13,33
50,Fail,46,23,4,13,33
50,Fail,53,25,0,11,42
50,Fail,46,22,7,17,29
50,Fail,46,24,8,14,32
50,Fail,48,29,0,12,36
50,Fail,46,28,2,10,36
50,Fail,45,29,4,10,35
50,Fail,57,17,0,14,43
50,Fail,47,25,4,15,32
50,Fail,42,32,0,15,27
50,Fail,45,26,5,19,26
50,Fail,50,31,0,12,38
50,Fail,38,29,15,11,27
50,Fail,44,25,0,20,24
50,Fail,53,34,0,8,45
50,Fail,44,31,0,17,27
50,Fail,54,21,0,15,39
50,Fail,46,30,0,14,32
50,Fail,47,24,2,11,36
50,Fail,39,41,0,13,26
50,Fail,42,31,0,15,27
50,Fail,46,32,3,10,36
50,Fail,46,33,0,12,34
50,Fail,37,42,0,14,23
50,Fail,48,22,0,21,27
50,Fail,51,23,0,12,39
50,Fail,44,26,0,17,27
50,Fail,48,24,0,16,32
50,Fail,48,26,5,8,40
50,Fail,46,31,0,13,33
50,Fail,42,32,0,15,27
50,Fail,50,27,0,14,36
50,Fail,50,26,0,15,35
50,Fail,45,32,0,17,28
50,Fail,44,19,8,18,26
50,Fail,47,31,0,12,35
50,Fail,49,37,0,6,43
50,Fail,47,25,3,18,29
50,Fail,54,26,0,9,45
50,Fail,52,25,4,11,41
50,Fail,52,31,0,9,43
50,Fail,48,21,0,18,30
50,Fail,41,33,2,14,27
50,Success,57,22,5,6,51
50,Fail,48,31,0,13,35
50,Fail,53,26,0,8,45
50,Fail,55,18,2,14,41
50,Fail,44,29,1,11,33
50,Fail,45,31,5,8,37
50,Fail,54,19,4,11,43
50,Fail,55,31,0,8,47
50,Fail,49,26,1,12,37
50,Fail,49,21,14,9,40
50,Fail,41,30,9,14,27
50,Fail,51,24,0,15,36
50,Fail,42,37,0,12,30
50,Fail,48,24,1,15,33
50,Fail,36,32,4,20,16
50,Success,56,23,4,4,52
50,Fail,47,38,0,9,38
50,Fail,54,28,0,10,44
50,Fail,51,22,0,15,36
50,Fail,43,36,0,14,29
50,Fail,42,22,3,21,21
50,Fail,49,18,6,15,34
50,Fail,49,21,3,10,39
50,Fail,49,24,0,13,36
50,Fail,48,32,0,11,37
50,Fail,43,29,0,20,23
50,Fail,48,30,0,14,34
50,Fail,43,38,0,11,32
50,Fail,46,27,2,11,35
50,Fail,42,23,7,17,25
50,Fail,49,24,7,13,36
50,Fail,48,29,5,10,38
50,Fail,48,24,1,13,35
50,Fail,47,19,8,17,30
50,Fail,52,22,1,13,39
50,Fail,39,36,0,12,27
50,Fail,43,37,3,9,34
50,Fail,46,33,0,12,34
50,Fail,52,22,0,13,39
50,Fail,46,33,0,10,36
50,Fail,48,33,4,6,42
50,Fail,51,24,0,12,39
50,Fail,51,23,5,9,42
50,Fail,44,21,8,19,25
50,Fail,55,24,2,13,42
50,Fail,50,28,1,12,38
50,Fail,47,27,1,13,34
50,Fail,47,31,0,11,36
50,Fail,50,23,3,11,39
50,Fail,53,20,0,15,38
50,Fail,55,21,1,13,42
50,Fail,53,22,0,14,39
50,Fail,40,37,0,9,31
50,Fail,50,21,6,11,39
50,Fail,43,38,0,11,32
50,Fail,53,24,0,10,43
50,Fail,54,21,5,8,46
50,Fail,53,23,2,8,45
50,Fail,45,32,0,13,32
50,Fail,47,23,9,12,35
50,Fail,52,23,4,13,39
50,Fail,45,27,8,12,33
50,Fail,52,27,0,11,41
50,Fail,44,30,0,16,28
50,Fail,44,33,0,14,30
50,Fail,55,22,5,10,45
50,Fail,45,38,0,11,34
50,Fail,51,24,0,14,37
50,Fail,40,27,11,12,28
50,Fail,45,24,5,17,28
50,Fail,42,26,8,17,25
50,Fail,46,25,6,12,34
50,Fail,53,16,0,16,37
50,Fail,41,32,0,13,28
50,Fail,47,26,1,10,37
50,Fail,48,23,2,13,35
50,Fail,47,28,1,9,38
50,Fail,48,25,1,13,35
50,Fail,49,28,1,12,37
50,Fail,48,25,3,14,34
50,Fail,45,28,6,9,36
50,Fail,43,34,0,11,32
50,Fail,43,19,10,20,23
50,Fail,49,21,0,16,33
50,Fail,50,28,0,12,38
50,Fail,48,22,5,13,35
50,Fail,42,29,0,17,25
50,Fail,41,31,0,15,26
50,Fail,45,33,0,14,31
50,Success,56,24,0,6,50
50,Fail,48,30,0,9,39
50,Fail,50,26,1,9,41
50,Fail,51,24,3,15,36
50,Fail,45,29,3,10,35
50,Fail,47,34,0,9,38
50,Fail,51,29,0,11,40
50,Fail,50,21,8,11,39
50,Fail,51,20,2,12,39
50,Fail,38,39,0,16,22
50,Fail,55,26,0,10,45
50,Fail,55,18,3,14,41
50,Fail,47,26,0,14,33
50,Fail,42,31,5,15,27
50,Fail,44,27,1,16,28
50,Fail,48,22,0,19,29
50,Fail,44,35,0,12,32
50,Fail,45,26,0,17,28
50,Fail,49,27,4,10,39
50,Fail,47,27,5,14,33
50,Fail,46,33,4,7,39
50,Fail,51,25,2,11,40
50,Fail,40,31,0,17,23
50,Fail,40,40,0,14,26
50,Fail,53,23,0,10,43
50,Fail,46,37,0,11,35
50,Fail,47,24,9,11,36
50,Fail,45,37,0,12,33
50,Fail,43,31,0,15,28
50,Fail,46,31,0,13,33
50,Fail,48,34,0,8,40
50,Fail,51,30,0,11,40
50,Fail,45,32,0,14,31
50,Fail,45,29,5,11,34
50,Fail,39,36,0,15,24
50,Fail,36,33,6,17,19
50,Fail,52,30,0,6,46
50,Fail,55,23,1,8,47
50,Fail,41,32,2,15,26
50,Fail,43,31,0,15,28
50,Fail,45,31,0,15,30
50,Fail,57,19,1,11,46
50,Fail,53,24,1,11,42
50,Fail,38,25,12,17,21
50,Fail,49,22,0,15,34
50,Fail,51,22,8,8,43
50,Fail,51,30,0,9,42
50,Fail,51,22,0,17,34
50,Fail,52,23,0,8,44
50,Fail,38,32,10,14,24
50,Fail,43,35,0,11,32
50,Fail,46,33,0,10,36
50,Fail,48,24,2,11,37
50,Fail,54,20,3,13,41
50,Fail,46,31,3,11,35
50,Fail,52,23,2,13,39
50,Fail,45,25,0,20,25
50,Fail,52,25,1,11,41
50,Fail,44,28,0,14,30
50,Fail,45,22,0,18,27
50,Fail,41,30,9,13,28
50,Fail,51,19,0,16,35
50,Fail,44,28,4,12,32
50,Fail,41,27,4,15,26
50,Fail,40,31,0,15,25
50,Fail,48,23,1,14,34
50,Fail,48,23,2,13,35
50,Fail,45,24,3,20,25
50,Fail,51,23,0,13,38
50,Fail,50,26,0,14,36
50,Fail,50,25,0,13,37
50,Fail,45,26,11,10,35
50,Fail,47,31,0,14,33
50,Fail,51,26,0,13,38
50,Fail,49,20,3,16,33
50,Fail,55,20,0,12,43
50,Fail,54,21,0,15,39
50,Fail,47,19,3,13,34
50,Fail,45,32,0,12,33
50,Fail,47,33,0,13,34
50,Fail,45,28,0,11,34
50,Fail,47,29,4,5,42
50,Fail,46,30,0,12,34
50,Fail,50,28,6,10,40
50,Fail,52,18,11,11,41
50,Fail,44,25,7,14,30
50,Fail,46,27,0,18,28
50,Fail,50,24,3,9,41
50,Fail,41,37,0,15,26
50,Fail,52,28,0,10,42
50,Fail,42,40,0,10,32
50,Fail,49,28,0,9,40
50,Fail,42,27,2,21,21
50,Fail,52,24,0,11,41
50,Fail,48,22,7,16,32
50,Fail,41,25,5,17,24
50,Fail,55,24,0,13,42
50,Fail,48,25,8,9,39
50,Fail,45,28,2,19,26
50,Fail,42,36,0,15,27
50,Success,60,17,2,9,51
50,Fail,51,26,2,10,41
50,Fail,47,30,0,12,35
50,Fail,52,26,0,10,42
50,Fail,47,32,0,12,35
50,Fail,44,30,0,14,30
50,Fail,51,27,0,13,38
50,Fail,47,25,2,12,35
50,Fail,52,24,2,9,43
50,Fail,40,31,1,16,24
50,Fail,42,32,5,12,30
50,Fail,46,31,0,10,36
50,Fail,44,31,1,13,31
50,Fail,48,26,7,15,33
50,Fail,45,30,5,10,35
50,Fail,47,24,7,11,36
50,Fail,53,20,4,8,45
50,Fail,53,22,3,8,45
50,Fail,46,24,7,16,30
50,Fail,50,28,0,11,39
50,Fail,46,37,0,10,36
50,Fail,46,26,6,14,32
50,Fail,45,27,4,15,30
50,Fail,45,30,0,16,29
50,Fail,49,32,0,15,34
50,Fail,49,29,0,6,43
50,Fail,42,33,7,9,33
50,Fail,44,32,0,16,28
50,Fail,48,27,0,13,35
50,Fail,49,21,9,13,36
50,Fail,51,27,5,5,46
50,Fail,43,31,0,16,27
50,Fail,50,29,1,10,40
50,Fail,51,22,2,14,37
50,Fail,51,21,5,10,41
50,Fail,52,24,3,12,40
50,Fail,45,21,2,18,27
50,Fail,53,24,5,8,45
50,Fail,45,31,0,15,30
50,Fail,49,26,0,13,36
50,Fail,56,26,0,8,48
50,Fail,51,23,0,17,34
50,Fail,50,30,1,9,41
50,Fail,46,28,0,19,27
50,Fail,48,26,0,13,35
50,Fail,44,32,4,12,32
50,Fail,48,24,2,13,35
50,Fail,57,21,1,10,47
50,Fail,44,28,1,15,29
50,Fail,49,27,1,13,36
50,Fail,56,23,0,9,47
50,Fail,49,27,0,17,32
50,Fail,42,28,10,9,33
50,Fail,45,45,0,8,37
50,Fail,44,32,0,12,32
50,Fail,48,28,7,11,37
50,Fail,48,30,0,11,37
50,Fail,43,27,4,13,30
50,Fail,51,22,2,17,34
50,Fail,45,23,4,18,27
50,Fail,51,17,5,13,38
50,Fail,47,29,7,8,39
50,Fail,47,27,0,15,32
50,Fail,46,28,0,15,31
50,Fail,47,26,2,12,35
50,Fail,37,36,9,13,24
50,Fail,53,26,1,13,40
50,Fail,51,24,0,14,37
50,Fail,49,25,0,11,38
50,Fail,58,21,0,10,48
50,Fail,45,29,0,15,30
50,Fail,51,25,6,11,40
50,Fail,51,23,5,13,38
50,Fail,51,21,0,13,38
50,Fail,54,22,1,13,41
50,Fail,51,21,4,13,38
50,Fail,45,30,5,11,34
50,Fail,48,26,0,17,31
50,Fail,48,33,0,11,37
50,Fail,44,39,0,7,37
50,Fail,48,22,3,16,32
50,Fail,43,32,0,13,30
50,Fail,45,34,0,11,34
50,Fail,48,26,1,14,34
50,Fail,55,21,0,11,44
50,Fail,48,27,1,14,34
50,Fail,49,26,5,13,36
50,Fail,48,20,0,20,28
50,Fail,48,24,0,14,34
50,Fail,44,28,3,15,29
50,Fail,43,27,1,19,24
50,Fail,44,30,2,13,31
50,Fail,52,16,6,14,38
50,Fail,45,25,1,15,30
50,Fail,47,25,2,17,30
50,Fail,54,22,0,13,41
50,Fail,55,21,0,15,40
50,Fail,45,29,2,11,34
50,Fail,47,27,0,13,34
50,Fail,41,27,8,17,24
50,Fail,58,24,0,9,49
50,Fail,49,24,3,14,35
50,Fail,49,24,5,13,36
50,Fail,37,51,0,9,28
50,Fail,55,21,0,14,41
50,Fail,43,19,12,21,22
50,Fail,37,32,1,18,19
50,Fail,52,28,3,10,42
50,Fail,33,41,0,17,16
50,Fail,48,19,0,20,28
50,Fail,44,24,3,15,29
50,Fail,46,25,2,14,32
50,Fail,45,27,7,12,33
50,Fail,49,27,0,11,38
50,Fail,43,32,4,13,30
50,Fail,52,28,0,10,42
50,Fail,47,21,6,14,33
50,Fail,49,21,3,16,33
50,Fail,48,22,1,20,28
50,Fail,46,28,5,11,35
50,Fail,48,32,0,10,38
50,Fail,41,29,8,12,29
50,Fail,43,35,0,13,30
50,Fail,48,32,0,8,40
50,Fail,45,34,0,9,36
50,Fail,43,28,9,11,32
50,Success,58,22,1,8,50
50,Fail,46,27,0,16,30
50,Fail,48,28,0,11,37
50,Fail,54,20,0,11,43
50,Fail,49,27,0,15,34
50,Fail,48,30,0,13,35
50,Success,63,15,2,6,57
50,Fail,49,28,0,13,36
50,Fail,54,22,0,13,41
50,Fail,41,41,0,12,29
50,Fail,43,22,1,22,21
50,Fail,50,27,0,11,39
50,Fail,46,26,6,10,36
50,Fail,48,28,3,12,36
50,Fail,45,28,8,11,34
50,Fail,50,21,0,16,34
50,Fail,43,30,0,17,26
50,Fail,47,26,0,16,31
50,Fail,51,25,4,9,42
50,Fail,45,27,1,13,32
50,Fail,49,27,1,15,34
50,Fail,57,22,0,9,48
50,Fail,52,15,8,13,39
50,Fail,56,18,0,14,42
50,Fail,38,42,0,12,26
50,Fail,45,31,0,14,31
50,Fail,44,30,0,11,33
50,Fail,58,20,1,10,48
50,Fail,57,12,6,11,46
50,Fail,35,36,6,13,22
50,Fail,43,37,0,13,30
50,Fail,35,39,0,19,16
50,Fail,52,24,2,12,40
50,Fail,51,27,0,11,40
50,Fail,52,24,1,11,41
50,Fail,56,15,3,15,41
50,Fail,41,32,6,12,29
50,Fail,37,38,0,17,20
50,Fail,56,15,5,14,42
50,Fail,38,32,12,14,24
50,Fail,45,19,11,13,32
50,Fail,51,29,0,9,42
50,Fail,41,34,0,17,24
50,Fail,42,30,0,18,24
50,Fail,49,28,0,13,36
50,Fail,45,34,4,8,37
50,Fail,47,27,0,15,32
50,Fail,47,22,2,16,31
50,Fail,52,25,0,9,43
50,Fail,47,32,0,14,33
50,Fail,42,32,2,14,28
50,Fail,50,20,2,16,34
50,Fail,51,27,0,11,40
50,Fail,42,34,0,14,28
50,Success,60,25,0,6,54
50,Fail,49,26,0,14,35
50,Fail,47,27,0,11,36
50,Fail,46,31,6,8,38
50,Fail,50,28,1,10,40
50,Fail,49,27,7,11,38
50,Fail,57,20,2,9,48
50,Fail,47,25,5,12,35
50,Fail,51,17,8,16,35
50,Fail,46,32,0,13,33
50,Fail,51,26,1,13,38
50,Fail,48,26,0,12,36
50,Fail,42,18,14,19,23
50,Fail,50,28,0,6,44
50,Fail,46,28,8,7,39
50,Fail,45,28,4,14,31
50,Fail,45,33,0,10,35
50,Fail,49,32,0,6,43
50,Fail,46,30,0,13,33
50,Fail,47,34,0,7,40
50,Fail,47,28,2,14,33
50,Fail,48,25,0,12,36
50,Fail,54,29,0,9,45
50,Fail,52,26,0,12,40
50,Fail,45,27,5,11,34
50,Fail,45,28,1,14,31
50,Fail,44,25,9,14,30
50,Fail,48,25,4,17,31
50,Fail,48,29,1,15,33
50,Fail,54,25,4,8,46
50,Fail,50,30,0,12,38
50,Fail,45,28,6,15,30
50,Fail,46,29,0,17,29
50,Fail,48,21,8,15,33
50,Fail,52,26,3,8,44
50,Fail,44,36,0,12,32
50,Fail,52,22,0,16,36
50,Fail,39,40,0,12,27
50,Fail,50,28,0,14,36
50,Fail,50,25,5,11,39
50,Fail,51,22,2,13,38
50,Fail,48,33,0,10,38
50,Fail,43,26,6,17,26
50,Fail,45,33,0,12,33
50,Fail,43,32,0,14,29
50,Fail,44,31,4,12,32
50,Fail,41,35,4,11,30
50,Fail,58,18,11,10,48
50,Fail,48,33,0,9,39
50,Fail,46,25,0,16,30
50,Fail,52,26,2,11,41
50,Fail,41,36,0,18,23
50,Fail,49,28,2,13,36
50,Fail,46,36,0,8,38
50,Fail,49,27,0,12,37
50,Fail,42,36,0,11,31
50,Fail,40,29,8,15,25
50,Fail,50,32,0,7,43
50,Fail,52,23,0,12,40
50,Fail,41,37,3,13,28
50,Fail,52,34,0,10,42
50,Fail,48,37,0,9,39
50,Fail,48,31,0,11,37
50,Fail,55,27,0,8,47
50,Fail,49,21,13,10,39
50,Fail,46,29,0,17,29
50,Fail,49,21,0,18,31
50,Success,60,19,5,7,53
50,Fail,51,29,0,11,40
50,Fail,47,28,0,14,33
50,Fail,47,24,3,13,34
50,Fail,44,30,3,13,31
50,Fail,47,25,3,14,33
50,Fail,46,26,2,13,33
50,Fail,46,36,2,5,41
50,Fail,45,23,0,19,26
50,Fail,42,36,0,18,24
50,Fail,43,34,0,16,27
50,Fail,55,24,0,12,43
50,Fail,48,22,4,15,33
50,Fail,45,30,0,13,32
50,Fail,46,28,0,12,34
50,Fail,47,35,0,8,39
50,Fail,48,23,2,13,35
50,Fail,41,36,0,14,27
50,Fail,51,24,0,17,34
50,Fail,45,34,0,8,37
50,Fail,51,27,0,16,35
50,Fail,43,32,9,5,38
50,Fail,53,24,3,8,45
50,Fail,56,21,1,8,48
50,Fail,51,23,1,12,39
50,Fail,51,24,1,10,41
50,Fail,51,21,0,19,32
50,Fail,47,24,3,11,36
50,Fail,45,28,0,19,26
50,Fail,47,37,0,6,41
50,Fail,53,27,0,9,44
50,Fail,43,33,6,11,32
50,Fail,48,28,0,15,33
50,Fail,46,25,2,15,31
50,Fail,47,25,6,13,34
50,Fail,56,18,0,14,42
50,Fail,48,27,4,12,36
50,Fail,43,31,0,17,26
50,Fail,55,19,0,12,43
50,Fail,46,25,0,15,31
50,Fail,44,29,8,9,35
50,Fail,55,19,0,13,42
50,Fail,45,27,3,14,31
50,Fail,50,26,2,10,40
50,Fail,41,34,0,13,28
50,Fail,42,20,12,15,27
50,Fail,47,30,0,11,36
50,Fail,55,22,2,10,45
50,Fail,51,27,1,9,42
50,Fail,53,26,0,14,39
50,Fail,50,29,0,12,38
50,Fail,52,20,0,13,39
50,Fail,49,24,3,11,38
50,Fail,50,23,8,11,39
50,Fail,45,29,7,12,33
50,Fail,46,31,0,12,34
50,Fail,46,27,3,14,32
50,Fail,51,27,3,8,43
50,Fail,42,35,0,11,31
50,Fail,47,34,0,15,32
50,Fail,51,25,0,10,41
50,Fail,35,30,6,21,14
50,Fail,47,28,6,9,38
50,Fail,48,24,0,15,33
50,Fail,49,30,7,4,45
50,Fail,53,20,1,16,37
50,Fail,51,18,3,19,32
50,Fail,50,20,0,11,39
50,Fail,50,29,1,8,42
50,Fail,50,27,0,17,33
50,Fail,53,20,2,15,38
50,Fail,50,24,5,12,38
50,Fail,46,31,0,12,34
50,Fail,40,37,0,15,25
50,Fail,49,22,3,11,38
50,Fail,51,25,1,10,41
50,Fail,42,32,0,17,25
50,Fail,48,30,1,10,38
50,Success,56,22,2,6,50
50,Fail,54,27,0,9,45
50,Fail,58,18,0,11,47
50,Fail,44,38,0,10,34
50,Fail,49,28,1,8,41
50,Fail,52,17,1,16,36
50,Fail,44,26,2,12,32
50,Fail,56,21,3,10,46
50,Fail,53,25,2,5,48
50,Fail,43,27,2,12,31
50,Fail,47,21,1,15,32
50,Fail,51,27,0,10,41
50,Fail,46,26,0,16,30
50,Fail,48,22,11,11,37
50,Fail,46,30,4,9,37
50,Fail,45,27,5,13,32
50,Fail,54,23,7,6,48
50,Fail,51,21,6,12,39
50,Fail,47,26,0,11,36
50,Fail,47,27,1,14,33
50,Fail,47,31,0,12,35
50,Fail,44,33,4,7,37
50,Fail,49,21,8,13,36
50,Fail,48,30,0,11,37
50,Fail,42,25,6,17,25
50,Fail,45,30,0,11,34
50,Fail,52,27,0,8,44
50,Fail,52,24,6,8,44
50,Fail,45,27,2,13,32
50,Fail,47,24,9,10,37
50,Fail,46,25,2,17,29
50,Fail,43,32,0,16,27
50,Fail,48,27,1,10,38
50,Fail,48,26,4,9,39
50,Fail,47,23,0,18,29
50,Fail,46,31,0,15,31
50,Fail,47,31,0,13,34
50,Fail,51,23,7,9,42
50,Fail,54,24,6,9,45
50,Fail,39,27,13,15,24
50,Fail,51,22,1,14,37
50,Fail,41,31,0,16,25
50,Fail,48,25,5,14,34
50,Fail,54,22,4,10,44
50,Fail,57,17,2,13,44
50,Fail,52,28,0,12,40
50,Success,61,15,3,9,52
50,Fail,42,32,0,16,26
50,Fail,60,18,0,13,47
50,Fail,42,39,0,12,30
50,Fail,48,28,8,8,40
50,Fail,55,23,4,10,45
50,Fail,47,25,3,18,29
50,Fail,44,25,0,19,25
50,Fail,52,22,0,12,40
50,Fail,50,19,7,10,40
50,Fail,57,22,0,13,44
50,Fail,54,19,1,6,48
50,Fail,50,24,3,11,39
50,Fail,45,36,0,10,35
50,Fail,44,24,4,17,27
50,Fail,40,34,0,14,26
50,Fail,50,23,2,14,36
50,Fail,47,32,6,5,42
50,Fail,48,22,8,10,38
50,Fail,51,24,0,14,37
50,Fail,47,24,0,17,30
50,Fail,49,26,0,10,39
50,Fail,47,31,0,12,35
50,Fail,49,26,5,13,36
50,Fail,46,33,0,10,36
50,Success,58,23,4,6,52
50,Fail,34,34,4,20,14
50,Fail,42,30,1,18,24
50,Fail,51,30,0,7,44
50,Fail,43,33,0,13,30
50,Fail,54,27,0,9,45
50,Fail,44,28,10,13,31
50,Fail,50,25,8,10,40
50,Fail,43,30,2,14,29
50,Fail,51,21,2,13,38
50,Fail,45,20,4,21,24
50,Fail,47,36,0,9,38
50,Fail,52,28,0,12,40
50,Fail,51,24,0,13,38
50,Fail,44,30,0,10,34
50,Fail,52,16,0,14,38
50,Fail,42,31,0,16,26
50,Fail,48,24,0,17,31
50,Fail,42,25,5,18,24
50,Fail,49,27,7,10,39
50,Success,59,19,2,9,50
50,Fail,49,28,1,11,38
50,Fail,44,31,0,15,29
50,Fail,45,29,9,11,34
50,Fail,44,29,5,13,31
50,Fail,48,25,3,12,36
50,Fail,42,30,12,11,31
50,Fail,51,24,2,11,40
50,Fail,44,24,1,20,24
50,Fail,51,30,0,11,40
50,Fail,50,25,2,11,39
50,Fail,42,36,0,17,25
50,Fail,56,11,8,10,46
50,Fail,55,19,2,12,43
50,Fail,49,22,4,10,39
50,Fail,41,34,3,14,27
50,Fail,45,26,6,12,33
50,Fail,50,24,2,15,35
50,Fail,56,19,1,12,44
50,Fail,51,25,2,11,40
50,Fail,44,30,0,14,30
50,Fail,59,15,0,12,47
50,Fail,47,32,0,12,35
50,Fail,41,31,5,14,27
50,Fail,51,30,0,10,41
50,Fail,49,30,0,8,41
50,Fail,45,31,0,15,30
50,Fail,47,26,1,16,31
50,Fail,53,22,0,12,41
50,Fail,56,16,1,12,44
50,Fail,43,34,0,15,28
50,Fail,45,31,0,12,33
50,Fail,51,23,1,16,35
50,Fail,50,31,0,11,39
50,Fail,52,23,0,11,41
50,Fail,55,23,0,8,47
50,Fail,49,26,0,12,37
50,Fail,48,29,0,14,34
50,Fail,49,27,3,9,40
50,Fail,51,18,3,16,35
50,Fail,40,32,4,14,26
50,Success,60,20,0,8,52
50,Fail,52,22,1,8,44
50,Fail,48,26,1,17,31
50,Fail,48,25,0,13,35
50,Fail,46,30,4,9,37
50,Fail,53,26,0,11,42
50,Fail,45,31,0,12,33
50,Fail,49,29,0,13,36
50,Fail,37,37,0,17,20
50,Fail,47,35,0,3,44
50,Fail,53,23,5,12,41
50,Fail,48,27,0,14,34
50,Fail,48,21,6,13,35
50,Fail,43,35,0,14,29
50,Fail,47,26,0,12,35
50,Fail,51,23,3,11,40
50,Fail,53,26,0,13,40
50,Fail,48,22,1,13,35
50,Fail,53,27,2,8,45
50,Fail,46,29,0,16,30
50,Fail,48,30,0,10,38
50,Fail,47,29,0,14,33
50,Fail,41,39,0,9,32
50,Fail,44,34,0,14,30
50,Fail,48,32,0,9,39
50,Fail,49,28,2,7,42
50,Fail,46,33,0,10,36
50,Fail,45,22,3,19,26
50,Fail,42,28,8,17,25
50,Fail,39,33,1,17,22
50,Fail,46,27,6,12,34
50,Fail,47,24,4,14,33
50,Fail,47,29,6,13,34
50,Fail,53,22,0,10,43
50,Fail,46,23,3,16,30
50,Fail,48,24,5,11,37
50,Fail,50,30,0,13,37
50,Fail,52,20,1,15,37
50,Fail,46,33,0,11,35
50,Fail,51,27,0,9,42
50,Fail,57,20,0,12,45
50,Fail,55,17,0,16,39
50,Fail,56,23,0,11,45
50,Fail,44,36,0,12,32
50,Fail,51,16,4,16,35
50,Fail,54,27,0,7,47
50,Fail,47,25,6,14,33
50,Fail,40,32,8,13,27
50,Fail,49,32,0,11,38
50,Fail,44,23,8,15,29
50,Fail,50,29,0,11,39
50,Fail,51,23,0,15,36
50,Fail,53,21,3,11,42
50,Fail,48,33,0,12,36
50,Fail,50,22,4,14,36
50,Fail,51,24,1,14,37
50,Fail,45,28,5,12,33
50,Fail,45,36,0,7,38
50,Fail,50,21,3,11,39
50,Fail,51,23,3,11,40
50,Fail,41,22,8,22,19
50,Fail,37,29,14,12,25
50,Fail,53,27,0,9,44
50,Fail,45,23,0,15,30
50,Fail,42,25,7,16,26
50,Fail,44,29,0,16,28
50,Fail,47,27,0,11,36
50,Fail,49,30,0,7,42
50,Fail,56,25,0,11,45
50,Fail,47,25,0,15,32
50,Fail,48,14,4,20,28
50,Fail,40,39,0,12,28
50,Fail,44,29,8,12,32
50,Fail,52,23,7,8,44
50,Fail,43,30,6,13,30
50,Fail,45,31,0,11,34
50,Fail,52,19,5,14,38
50,Fail,51,27,0,11,40
50,Fail,51,25,0,11,40
50,Fail,46,33,0,14,32
50,Fail,55,20,0,16,39
50,Fail,51,23,3,13,38
50,Fail,42,34,0,16,26
50,Fail,46,28,5,13,33
50,Fail,49,24,6,13,36
50,Fail,46,29,0,14,32
50,Fail,48,25,0,17,31
50,Fail,49,21,3,16,33
50,Fail,53,21,4,11,42
50,Fail,50,26,0,14,36
50,Fail,43,23,6,20,23
50,Fail,48,29,0,12,36
50,Fail,52,19,1,14,38
50,Fail,55,20,0,12,43
50,Fail,47,36,0,9,38
50,Fail,44,35,0,11,33
50,Fail,53,26,2,9,44
50,Fail,51,23,3,12,39
50,Fail,49,23,2,16,33
50,Fail,36,36,0,17,19
50,Fail,49,27,0,14,35
50,Fail,43,26,4,17,26
50,Fail,45,35,0,11,34
50,Fail,39,38,8,11,28
50,Fail,49,25,1,14,35
50,Fail,50,22,9,12,38
50,Fail,50,21,3,14,36
50,Fail,42,28,0,18,24
50,Fail,53,24,4,9,44
50,Fail,51,25,0,12,39
50,Fail,54,29,0,9,45
50,Fail,55,23,0,10,45
50,Fail,41,31,5,14,27
50,Fail,48,32,1,9,39
50,Fail,47,23,7,12,35
50,Fail,52,22,1,12,40
50,Fail,51,19,0,13,38
50,Fail,48,28,0,14,34
50,Fail,46,21,4,15,31
50,Fail,48,28,4,9,39
50,Fail,47,29,0,15,32
50,Fail,53,26,2,9,44
50,Fail,44,33,1,13,31
50,Fail,46,32,0,13,33
50,Fail,47,22,5,15,32
50,Fail,51,24,2,11,40
50,Fail,48,19,3,19,29
50,Fail,42,33,0,16,26
50,Fail,36,38,0,17,19
50,Fail,46,33,1,7,39
50,Fail,45,25,0,17,28
50,Fail,48,26,4,10,38
50,Fail,51,24,4,11,40
50,Fail,47,25,0,14,33
50,Fail,52,28,0,7,45
50,Fail,48,24,6,11,37
50,Fail,50,23,8,8,42
50,Fail,54,19,8,12,42
50,Fail,49,26,1,9,40
50,Success,62,14,2,8,54
50,Fail,53,20,0,12,41
50,Fail,50,20,0,20,30
50,Fail,53,27,0,9,44
50,Fail,52,26,0,14,38
50,Fail,44,24,1,24,20
50,Fail,52,20,8,10,42
50,Fail,52,33,0,10,42
50,Fail,44,20,6,17,27
50,Fail,42,28,0,18,24
50,Fail,50,24,2,11,39
50,Fail,44,33,0,12,32
50,Fail,49,24,2,11,38
50,Fail,39,39,5,10,29
50,Fail,50,27,6,10,40
50,Fail,45,28,3,12,33
50,Fail,48,30,3,9,39
50,Fail,38,41,0,13,25
50,Fail,48,32,0,10,38
50,Fail,52,24,1,10,42
50,Fail,55,25,0,9,46
50,Fail,51,24,2,10,41
50,Fail,47,28,0,18,29
50,Fail,44,27,7,12,32
50,Fail,45,20,10,14,31
50,Fail,51,25,0,9,42
50,Fail,42,34,0,15,27
50,Fail,45,26,6,11,34
50,Fail,45,23,8,15,30
50,Fail,51,17,9,14,37
50,Fail,42,32,4,11,31
50,Fail,46,24,0,16,30
50,Fail,41,29,8,16,25
50,Fail,51,23,1,13,38
50,Fail,61,16,2,12,49
50,Fail,44,27,0,21,23
50,Fail,48,25,1,12,36
50,Fail,56,21,0,12,44
50,Fail,36,45,0,13,23
50,Fail,48,28,0,15,33
50,Fail,47,29,0,14,33
50,Fail,43,32,1,17,26
50,Fail,41,30,5,15,26
50,Fail,51,22,8,13,38
50,Fail,46,26,8,13,33
50,Fail,49,23,4,11,38
50,Fail,50,28,3,10,40
50,Fail,39,26,11,15,24
50,Fail,41,28,4,16,25
50,Fail,50,30,0,12,38
50,Fail,50,25,0,16,34
50,Fail,54,20,0,13,41
50,Fail,44,27,0,13,31
50,Fail,47,28,0,16,31
50,Fail,46,29,0,14,32
50,Fail,50,30,0,7,43
50,Fail,55,26,0,11,44
50,Fail,51,26,0,13,38
50,Fail,49,25,6,10,39
50,Fail,52,20,6,13,39
50,Fail,53,23,2,11,42
50,Fail,38,38,0,17,21
50,Fail,54,20,0,16,38
50,Fail,46,24,0,18,28
50,Fail,56,19,0,14,42
50,Fail,40,37,8,9,31
50,Fail,44,34,0,14,30
50,Success,57,20,0,7,50
50,Fail,48,21,5,14,34
50,Fail,53,29,0,8,45
50,Fail,38,32,0,20,18
50,Fail,51,27,0,8,43
50,Fail,45,30,9,4,41
50,Fail,49,31,0,12,37
50,Fail,39,28,0,22,17
50,Fail,42,32,0,14,28
50,Fail,46,32,0,16,30
50,Fail,42,42,0,7,35
50,Fail,54,27,0,12,42
50,Fail,39,39,0,17,22
50,Fail,54,21,0,12,42
50,Fail,45,37,0,9,36
50,Fail,48,33,0,11,37
50,Fail,46,27,3,11,35
50,Fail,55,20,0,10,45
50,Fail,41,31,11,9,32
50,Fail,51,29,0,10,41
50,Fail,56,20,2,10,46
50,Fail,49,31,0,11,38
50,Fail,45,30,3,11,34
50,Fail,46,34,0,12,34
50,Fail,44,40,0,9,35
50,Fail,45,39,0,6,39
50,Fail,45,31,1,10,35
50,Fail,49,21,6,16,33
50,Fail,46,34,0,10,36
50,Fail,53,25,0,11,42
50,Fail,53,24,0,10,43
50,Fail,49,20,7,17,32
50,Fail,49,24,0,15,34
50,Fail,45,28,4,12,33
50,Fail,44,33,0,15,29
50,Fail,46,26,4,12,34
50,Fail,48,30,0,9,39
50,Fail,46,26,2,15,31
50,Fail,47,20,0,17,30
50,Fail,39,30,0,21,18
50,Fail,43,28,0,16,27
50,Success,56,30,0,6,50
50,Fail,43,35,1,10,33
50,Fail,42,27,6,15,27
50,Fail,52,28,0,13,39
50,Fail,47,21,5,20,27
50,Fail,52,25,0,12,40
50,Fail,55,23,0,10,45
50,Fail,53,26,0,12,41
50,Fail,52,23,0,11,41
50,Fail,52,23,0,14,38
50,Fail,43,32,0,12,31
50,Fail,46,35,0,8,38
50,Fail,46,30,3,13,33
50,Fail,41,33,0,17,24
50,Fail,45,27,3,12,33
50,Fail,46,29,0,16,30
50,Fail,49,20,6,14,35
50,Fail,48,22,7,7,41
50,Fail,46,27,4,14,32
50,Fail,53,20,0,16,37
50,Fail,50,25,0,13,37
50,Fail,39,31,0,20,19
50,Fail,49,24,1,12,37
50,Fail,46,34,0,9,37
50,Fail,52,25,0,13,39
50,Fail,48,25,0,15,33
50,Fail,51,22,0,14,37
50,Success,65,16,0,7,58
50,Fail,42,28,4,16,26
50,Fail,48,32,0,10,38
50,Fail,46,31,0,12,34
50,Fail,48,25,0,17,31
50,Fail,39,36,2,14,25
50,Fail,50,24,0,14,36
50,Fail,52,25,0,11,41
50,Fail,49,25,7,8,41
50,Fail,52,26,2,7,45
50,Fail,53,17,6,14,39
50,Fail,44,30,1,14,30
50,Fail,41,32,9,9,32
50,Fail,47,20,8,18,29
50,Fail,54,23,0,12,42
50,Fail,51,27,0,14,37
50,Fail,43,26,14,10,33
50,Fail,49,19,3,13,36
50,Fail,43,36,0,13,30
50,Fail,48,26,8,9,39
50,Fail,43,37,0,10,33
50,Fail,54,22,0,10,44
50,Fail,52,22,3,14,38
50,Fail,53,24,0,15,38
50,Fail,45,33,0,11,34
50,Fail,47,26,9,11,36
50,Fail,56,23,2,9,47
50,Fail,45,21,4,19,26
50,Fail,51,28,0,14,37
50,Fail,51,24,3,11,40
50,Fail,50,29,1,4,46
50,Fail,42,25,3,17,25
50,Fail,57,25,1,9,48
50,Fail,51,28,5,7,44
50,Fail,46,29,0,14,32
50,Fail,49,30,0,11,38
50,Fail,44,32,1,15,29
50,Fail,51,27,0,10,41
50,Fail,45,29,0,13,32
50,Fail,43,33,4,12,31
50,Fail,43,36,0,13,30
50,Fail,44,26,7,16,28
50,Fail,48,22,2,14,34
50,Fail,49,22,3,16,33
50,Fail,43,29,4,13,30
50,Fail,39,40,0,14,25
50,Fail,53,29,0,9,44
50,Fail,48,32,0,11,37
50,Fail,50,21,0,17,33
50,Fail,49,32,0,8,41
50,Fail,45,34,0,13,32
50,Fail,49,29,0,14,35
50,Fail,53,23,0,9,44
50,Fail,50,30,0,12,38
50,Fail,46,27,0,17,29
50,Fail,47,23,7,14,33
50,Success,60,20,0,6,54
50,Fail,54,19,0,17,37
50,Fail,48,32,0,10,38
50,Fail,46,30,0,13,33
50,Fail,57,21,1,11,46
50,Fail,47,23,0,20,27
50,Fail,48,31,0,11,37
50,Fail,51,25,0,14,37
50,Fail,47,28,0,13,34
50,Fail,48,36,0,8,40
50,Fail,45,22,1,19,26
50,Fail,44,36,0,10,34
50,Fail,54,20,0,14,40
50,Fail,54,26,2,9,45
50,Fail,43,43,0,11,32
50,Fail,50,25,3,12,38
50,Fail,56,20,0,13,43
50,Fail,53,22,0,13,40
50,Fail,43,30,6,12,31
50,Fail,48,29,3,12,36
50,Fail,49,22,4,12,37
50,Fail,48,32,0,15,33
50,Success,55,28,1,5,50
50,Success,58,25,3,4,54
50,Fail,47,33,0,10,37
50,Fail,45,29,4,12,33
50,Fail,48,35,0,6,42
50,Fail,54,24,0,13,41
50,Fail,49,26,7,12,37
50,Fail,54,30,0,9,45
50,Fail,43,29,3,13,30
50,Fail,45,38,0,11,34
50,Fail,54,20,7,8,46
50,Fail,32,36,9,16,16
50,Fail,36,39,0,16,20
50,Fail,41,31,0,17,24
50,Fail,53,16,6,12,41
50,Fail,51,26,0,12,39
50,Fail,53,22,0,16,37
50,Fail,44,25,5,19,25
50,Fail,48,28,0,10,38
50,Fail,44,28,6,12,32
50,Fail,50,24,10,6,44
50,Fail,48,20,3,18,30
50,Fail,52,31,0,10,42
50,Fail,43,33,0,13,30
50,Fail,51,24,2,13,38
50,Fail,42,34,0,18,24
50,Fail,54,20,1,9,45
50,Fail,48,29,0,14,34
50,Fail,42,30,0,11,31
50,Fail,48,30,0,9,39
50,Fail,48,22,5,14,34
50,Fail,41,42,0,9,32
50,Fail,45,32,3,11,34
50,Fail,49,26,4,12,37
50,Fail,49,28,0,12,37
50,Fail,44,26,2,13,31
50,Success,57,24,0,7,50
50,Fail,49,28,0,12,37
50,Fail,42,35,0,17,25
50,Fail,46,31,3,9,37
50,Fail,53,26,0,11,42
50,Fail,43,25,11,14,29
50,Fail,43,36,0,12,31
50,Fail,51,27,0,10,41
50,Fail,41,31,0,15,26
50,Fail,46,29,8,11,35
50,Fail,48,28,6,10,38
50,Fail,47,29,2,12,35
50,Fail,49,28,0,13,36
50,Fail,47,28,8,7,40
50,Fail,42,29,0,19,23
50,Fail,53,27,0,9,44
50,Fail,49,21,3,18,31
50,Fail,48,26,0,12,36
50,Fail,49,21,0,15,34
50,Fail,48,27,0,14,34
50,Fail,44,32,0,16,28
50,Fail,47,28,0,13,34
50,Fail,46,26,2,13,33
50,Fail,51,25,0,15,36
50,Fail,50,25,0,13,37
50,Fail,41,30,3,16,25
50,Fail,47,33,0,7,40
50,Fail,49,26,0,9,40
50,Fail,47,24,0,20,27
50,Fail,48,26,2,13,35
50,Fail,49,25,0,12,37
50,Fail,45,26,2,16,29
50,Fail,52,25,0,10,42
50,Fail,54,24,1,12,42
50,Fail,46,27,0,17,29
50,Fail,50,32,0,10,40
50,Fail,52,23,3,15,37
50,Fail,57,22,2,9,48
50,Fail,56,20,0,10,46
50,Fail,48,33,0,7,41
50,Fail,54,18,0,14,40
50,Fail,55,19,0,15,40
50,Fail,53,24,4,11,42
50,Fail,56,27,0,7,49
50,Fail,43,32,0,15,28
50,Fail,47,32,3,10,37
50,Fail,54,22,5,7,47
50,Fail,45,35,0,8,37
50,Fail,47,34,0,5,42
50,Fail,48,25,0,20,28
50,Fail,53,17,0,17,36
50,Fail,45,26,2,13,32
50,Fail,46,26,3,14,32
50,Fail,47,28,2,9,38
50,Fail,52,25,1,10,42
50,Fail,47,22,7,15,32
50,Fail,56,21,3,7,49
50,Fail,52,20,1,12,40
50,Fail,47,35,0,7,40
50,Fail,51,20,7,14,37
50,Fail,51,25,1,12,39
50,Fail,45,28,4,11,34
50,Fail,45,30,0,17,28
50,Fail,46,40,0,8,38
50,Fail,52,26,0,13,39
50,Fail,49,25,0,15,34
50,Fail,49,26,1,15,34
50,Fail,46,28,15,6,40
50,Fail,47,22,6,12,35
50,Fail,58,16,0,15,43
50,Fail,42,31,0,10,32
50,Fail,54,26,0,9,45
50,Fail,50,23,0,13,37
50,Fail,45,24,2,17,28
50,Fail,48,31,0,13,35
50,Fail,49,29,0,12,37
50,Fail,46,32,0,13,33
50,Fail,49,29,0,13,36
50,Fail,53,19,0,17,36
50,Fail,52,22,2,12,40
50,Fail,51,26,3,11,40
50,Fail,50,24,4,13,37
50,Fail,45,30,0,16,29
50,Fail,48,27,2,13,35
50,Fail,50,25,3,11,39
50,Fail,44,36,0,12,32
50,Fail,44,33,0,18,26
50,Fail,50,22,0,19,31
50,Fail,51,28,0,11,40
50,Fail,43,35,5,10,33
50,Fail,48,30,0,9,39
50,Fail,48,27,0,11,37
50,Fail,46,27,4,10,36
50,Fail,52,24,10,7,45
50,Fail,47,36,0,7,40
50,Fail,48,26,1,12,36
50,Fail,48,16,9,20,28
50,Fail,45,36,0,10,35
50,Fail,51,29,0,9,42
50,Fail,48,23,3,13,35
50,Fail,40,34,0,18,22
50,Fail,45,29,0,13,32
50,Fail,47,34,0,7,40
50,Fail,46,27,2,15,31
50,Fail,44,35,0,15,29
50,Fail,40,36,0,15,25
50,Fail,51,30,0,10,41
50,Fail,47,28,0,13,34
50,Fail,54,20,0,12,42
50,Fail,51,29,0,11,40
50,Fail,60,17,0,12,48
50,Fail,48,32,0,11,37
50,Fail,51,26,0,12,39
50,Fail,50,20,5,13,37
50,Fail,38,32,5,13,25
50,Fail,45,37,0,7,38
50,Fail,50,31,0,12,38
50,Fail,44,30,2,15,29
50,Fail,52,32,0,8,44
50,Fail,43,32,0,17,26
50,Fail,50,27,0,12,38
50,Fail,52,21,6,14,38
50,Fail,39,37,0,18,21
50,Fail,49,23,4,11,38
50,Fail,45,31,8,9,36
50,Fail,55,24,0,9,46
50,Fail,49,24,1,16,33
50,Fail,54,29,2,8,46
50,Fail,48,31,0,12,36
50,Fail,44,29,0,16,28
50,Fail,44,29,11,9,35
50,Fail,51,29,0,13,38
50,Fail,55,20,2,12,43
50,Fail,50,30,0,10,40
50,Fail,54,22,2,10,44
50,Fail,54,17,0,18,36
50,Fail,51,24,6,11,40
50,Fail,46,37,0,6,40
50,Fail,52,27,0,9,43
50,Fail,50,25,0,15,35
50,Fail,49,18,14,10,39
50,Fail,45,29,0,15,30
50,Fail,47,30,0,12,35
50,Fail,45,30,4,14,31
50,Fail,56,26,0,7,49
50,Fail,36,23,17,20,16
50,Fail,38,35,0,15,23
50,Fail,51,22,0,16,35
50,Fail,48,26,6,13,35
50,Fail,46,27,0,12,34
50,Fail,56,26,0,8,48
50,Fail,49,22,5,14,35
50,Fail,52,30,0,8,44
50,Fail,47,21,3,16,31
50,Fail,47,31,0,13,34
50,Fail,50,30,0,10,40
50,Fail,52,20,5,13,39
50,Fail,45,24,12,12,33
50,Fail,49,23,1,15,34
50,Fail,44,28,0,15,29
50,Fail,52,26,0,15,37
50,Fail,55,18,0,15,40
50,Fail,49,30,0,8,41
50,Fail,45,20,5,17,28
50,Fail,53,20,4,14,39
50,Fail,39,42,0,9,30
50,Fail,49,27,0,15,34
50,Fail,52,30,0,11,41
50,Fail,47,27,0,17,30
50,Fail,47,32,0,13,34
50,Fail,43,25,6,16,27
50,Fail,45,35,0,9,36
50,Fail,47,36,0,10,37
50,Fail,47,28,2,13,34
50,Fail,43,30,0,15,28
50,Fail,45,39,0,12,33
50,Fail,49,23,1,14,35
50,Fail,51,24,4,8,43
50,Fail,41,28,5,17,24
50,Fail,45,26,4,16,29
50,Fail,49,30,1,10,39
50,Success,59,22,1,8,51
50,Fail,53,18,10,12,41
50,Fail,38,29,5,18,20
50,Fail,45,27,0,14,31
50,Fail,51,26,0,10,41
50,Fail,49,20,4,17,32
50,Fail,46,30,1,11,35
50,Fail,50,25,6,11,39
50,Fail,48,31,0,12,36
50,Fail,45,29,0,12,33
50,Fail,46,25,7,13,33
50,Fail,53,25,0,9,44
50,Fail,49,18,2,21,28
50,Fail,39,41,0,12,27
50,Fail,37,38,0,17,20
50,Fail,53,29,0,12,41
50,Fail,48,29,0,8,40
50,Fail,46,28,0,15,31
50,Fail,44,36,0,10,34
50,Fail,45,29,2,11,34
50,Fail,46,26,1,16,30
50,Fail,54,20,7,10,44
50,Fail,40,37,0,15,25
50,Fail,49,26,0,18,31
50,Fail,49,27,0,11,38
50,Fail,44,38,0,12,32
50,Fail,51,22,0,18,33
50,Fail,43,33,0,12,31
50,Fail,40,33,0,13,27
50,Fail,55,22,5,8,47
50,Fail,48,21,4,12,36
50,Fail,53,27,0,9,44
50,Fail,45,30,0,14,31
50,Fail,35,37,0,18,17
50,Fail,50,18,1,18,32
50,Fail,47,23,5,14,33
50,Fail,44,35,0,14,30
50,Fail,49,26,5,10,39
50,Fail,47,23,2,16,31
50,Fail,48,26,2,13,35
50,Fail,42,23,3,20,22
50,Fail,44,24,1,16,28
50,Fail,52,23,3,12,40
50,Fail,54,22,2,10,44
50,Fail,50,29,0,12,38
50,Fail,51,26,0,12,39
50,Fail,40,30,4,12,28
50,Fail,41,35,0,13,28
50,Fail,53,27,0,8,45
50,Fail,53,28,0,9,44
50,Fail,51,17,5,16,35
50,Fail,46,29,4,12,34
50,Fail,49,25,10,6,43
50,Fail,54,24,0,10,44
50,Fail,50,28,1,11,39
50,Fail,48,33,0,9,39
50,Fail,50,26,2,11,39
50,Fail,49,18,0,19,30
50,Fail,51,28,4,10,41
50,Fail,43,30,1,14,29
50,Fail,48,26,0,15,33
50,Fail,44,30,0,16,28
50,Fail,43,30,2,15,28
50,Fail,48,26,3,10,38
50,Fail,44,36,0,11,33
50,Fail,54,22,0,10,44
50,Fail,51,18,0,15,36
50,Fail,54,22,3,10,44
50,Fail,46,26,5,17,29
50,Fail,50,25,0,12,38
50,Fail,52,21,2,14,38
50,Fail,46,28,0,14,32
50,Fail,47,34,0,8,39
50,Fail,44,35,1,10,34
50,Fail,43,37,0,11,32
50,Fail,46,27,1,14,32
50,Fail,49,33,0,11,38
50,Fail,46,26,4,14,32
50,Fail,46,26,4,10,36
50,Fail,49,19,9,14,35
50,Fail,48,32,0,13,35
50,Fail,46,23,4,14,32
50,Fail,48,23,0,16,32
50,Fail,53,21,0,14,39
50,Fail,38,39,0,13,25
50,Fail,49,29,0,15,34
50,Fail,49,30,0,10,39
50,Fail,51,27,1,11,40
50,Fail,42,35,0,14,28
50,Fail,40,24,6,18,22
50,Fail,47,28,0,15,32
50,Fail,54,20,4,9,45
50,Fail,45,28,3,16,29
50,Fail,56,21,0,10,46
50,Fail,55,30,0,9,46
50,Fail,49,27,5,10,39
50,Fail,55,23,0,9,46
50,Fail,40,31,8,9,31
50,Fail,38,33,12,11,27
50,Fail,55,20,1,13,42
50,Fail,52,20,4,13,39
50,Fail,52,24,0,10,42
50,Fail,56,18,0,15,41
50,Fail,50,24,1,12,38
50,Fail,42,26,7,16,26
50,Fail,50,31,0,11,39
50,Fail,55,23,0,7,48
50,Fail,47,22,7,14,33
50,Fail,50,20,8,10,40
50,Fail,50,28,0,11,39
50,Fail,55,18,5,9,46
50,Fail,41,34,0,14,27
50,Fail,48,29,0,12,36
50,Fail,42,24,1,19,23
50,Fail,45,32,0,14,31
50,Fail,49,28,0,11,38
50,Fail,43,38,0,13,30
50,Fail,51,14,5,20,31
50,Fail,49,27,0,12,37
50,Fail,52,24,3,12,40
50,Fail,52,26,0,9,43
50,Fail,43,37,0,10,33
50,Fail,43,24,11,16,27
50,Fail,54,17,2,14,40
50,Fail,53,24,0,11,42
50,Fail,53,18,3,12,41
50,Fail,51,20,0,14,37
50,Fail,48,19,3,15,33
50,Fail,48,26,0,15,33
50,Fail,47,33,0,11,36
50,Fail,52,27,1,10,42
50,Fail,49,23,1,14,35
50,Fail,41,28,10,9,32
50,Fail,54,18,1,12,42
50,Fail,49,27,0,16,33
50,Success,55,27,0,4,51
50,Fail,42,39,0,12,30
50,Fail,47,32,4,7,40
50,Fail,51,24,2,12,39
50,Fail,49,25,0,14,35
50,Fail,54,24,0,13,41
50,Fail,42,29,6,16,26
50,Fail,49,31,0,7,42
50,Fail,49,28,8,8,41
50,Fail,44,28,0,16,28
50,Fail,45,24,6,15,30
50,Fail,49,25,4,10,39
50,Fail,44,36,0,15,29
50,Fail,54,30,0,8,46
50,Fail,43,27,4,17,26
50,Fail,43,33,0,17,26
50,Fail,45,29,5,12,33
50,Fail,51,23,4,14,37
50,Fail,53,28,0,10,43
50,Fail,51,19,1,17,34
50,Fail,43,33,0,16,27
50,Fail,52,23,0,16,36
50,Fail,49,24,0,10,39
50,Fail,48,27,0,16,32
50,Fail,47,29,0,12,35
50,Fail,55,25,2,7,48
50,Fail,49,28,1,13,36
50,Fail,49,31,0,10,39
50,Fail,47,26,2,11,36
50,Fail,54,23,0,13,41
50,Fail,48,17,7,21,27
50,Fail,56,22,1,9,47
50,Fail,52,19,8,9,43
50,Fail,44,35,0,16,28
50,Fail,37,34,5,16,21
50,Fail,48,28,0,12,36
50,Fail,47,26,0,15,32
50,Fail,48,26,3,12,36
50,Fail,51,24,0,13,38
50,Fail,47,28,0,13,34
50,Success,58,23,0,7,51
50,Fail,43,34,0,15,28
50,Fail,51,21,6,10,41
50,Fail,56,24,0,12,44
50,Fail,43,26,1,17,26
50,Fail,40,31,8,11,29
50,Fail,48,29,6,11,37
50,Fail,33,47,0,14,19
50,Fail,52,23,2,14,38
50,Fail,45,33,2,11,34
50,Fail,52,23,7,12,40
50,Fail,43,33,0,14,29
50,Fail,50,28,0,12,38
50,Fail,52,21,10,9,43
50,Fail,55,25,0,11,44
50,Fail,52,26,0,13,39
50,Fail,53,28,0,8,45
50,Fail,47,27,0,16,31
50,Fail,45,26,5,15,30
50,Fail,46,17,13,14,32
50,Fail,56,20,0,11,45
50,Fail,50,29,0,11,39
50,Fail,48,28,0,14,34
50,Fail,53,28,0,10,43
50,Fail,52,22,3,11,41
50,Fail,53,27,0,10,43
50,Fail,48,32,0,11,37
50,Fail,44,29,6,13,31
50,Fail,53,29,0,12,41
50,Fail,49,27,1,14,35
50,Fail,51,26,0,14,37
50,Fail,46,24,6,17,29
50,Fail,45,29,1,16,29
50,Fail,48,28,0,13,35
50,Fail,38,32,0,16,22
50,Fail,54,28,2,7,47
50,Fail,49,31,0,8,41
50,Fail,55,22,6,7,48
50,Fail,38,38,0,14,24
50,Fail,48,37,0,9,39
50,Fail,42,33,0,11,31
50,Fail,45,25,0,15,30
50,Fail,48,25,0,14,34
50,Fail,45,27,0,18,27
50,Fail,47,29,0,15,32
50,Fail,47,19,5,16,31
50,Fail,50,24,2,10,40
50,Fail,49,32,0,10,39
50,Fail,50,23,1,12,38
50,Fail,37,32,6,16,21
50,Fail,52,22,2,9,43
50,Fail,57,21,0,11,46
50,Fail,37,30,9,17,20
50,Fail,47,26,5,13,34
50,Fail,51,24,5,12,39
50,Fail,47,28,7,11,36
50,Fail,49,29,4,5,44
50,Fail,49,28,0,14,35
50,Fail,47,29,0,12,35
50,Fail,50,21,0,13,37
50,Fail,47,26,0,13,34
50,Fail,47,28,0,16,31
50,Fail,48,30,0,12,36
50,Fail,40,28,7,19,21
50,Fail,48,32,0,10,38
50,Fail,51,19,3,12,39
50,Fail,44,27,0,15,29
50,Fail,40,26,9,15,25
50,Fail,46,29,0,14,32
50,Fail,52,31,0,8,44
50,Fail,49,33,0,8,41
50,Fail,42,37,0,13,29
50,Fail,44,26,0,16,28
50,Fail,56,21,0,10,46
50,Fail,57,18,6,8,49
50,Fail,54,32,0,7,47
50,Fail,52,25,0,13,39
50,Fail,52,26,0,12,40
50,Fail,51,26,0,12,39
50,Fail,38,26,15,17,21
50,Fail,54,21,8,10,44
50,Fail,44,29,3,12,32
50,Fail,40,32,3,17,23
50,Fail,43,29,4,11,32
50,Fail,41,29,2,17,24
50,Fail,49,25,4,10,39
50,Fail,34,37,10,12,22
50,Fail,51,26,1,14,37
50,Fail,49,29,0,13,36
50,Fail,48,25,0,18,30
50,Fail,52,17,0,15,37
50,Fail,55,24,0,9,46
50,Fail,48,24,3,10,38
50,Fail,49,26,3,13,36
50,Fail,45,27,5,16,29
50,Fail,52,29,0,7,45
50,Fail,44,31,2,13,31
50,Fail,50,28,0,11,39
50,Fail,54,22,0,8,46
50,Fail,45,28,4,14,31
50,Fail,42,36,0,14,28
50,Fail,50,26,0,12,38
50,Fail,54,21,1,14,40
50,Fail,41,34,2,11,30
50,Fail,54,22,6,11,43
50,Fail,49,26,6,9,40
50,Fail,44,26,7,14,30
50,Success,58,21,0,7,51
50,Fail,47,27,12,10,37
50,Fail,49,31,0,10,39
50,Fail,40,27,8,19,21
50,Fail,49,30,0,7,42
50,Fail,58,20,0,9,49
50,Fail,50,18,0,13,37
50,Fail,45,28,7,16,29
50,Fail,43,23,4,17,26
50,Fail,47,28,3,11,36
50,Fail,45,25,4,17,28
50,Fail,51,18,8,14,37
50,Fail,51,22,3,16,35
50,Fail,45,34,0,12,33
50,Fail,50,29,0,10,40
50,Fail,49,28,0,15,34
50,Fail,56,19,0,15,41
50,Fail,53,25,0,11,42
50,Fail,55,20,3,11,44
50,Fail,51,24,3,12,39
50,Fail,51,26,0,12,39
50,Fail,42,32,2,13,29
50,Fail,49,26,0,14,35
50,Fail,47,34,0,10,37
50,Fail,53,21,10,8,45
50,Fail,49,22,7,14,35
50,Fail,49,30,2,12,37
50,Fail,50,30,0,13,37
50,Fail,42,34,0,13,29
50,Fail,38,36,0,16,22
50,Fail,37,33,8,13,24
50,Fail,42,33,0,15,27
50,Fail,53,20,2,12,41
50,Fail,45,39,0,6,39
50,Fail,50,24,0,12,38
50,Fail,51,25,1,10,41
50,Fail,44,34,0,15,29
50,Fail,49,21,5,14,35
50,Fail,56,22,1,10,46
50,Fail,53,28,0,9,44
50,Fail,46,31,0,11,35
50,Fail,43,28,0,19,24
50,Fail,42,28,12,12,30
50,Fail,53,25,0,10,43
50,Fail,48,29,2,9,39
50,Fail,47,28,4,12,35
50,Fail,45,30,0,16,29
50,Fail,42,29,8,14,28
50,Fail,49,29,0,12,37
50,Fail,47,20,8,16,31
50,Fail,41,29,0,20,21
50,Fail,42,28,5,18,24
50,Fail,46,30,0,18,28
50,Fail,46,28,9,8,38
50,Fail,41,29,6,14,27
50,Fail,36,33,0,18,18
50,Fail,56,20,0,12,44
50,Fail,39,33,6,13,26
50,Fail,46,31,0,9,37
50,Fail,48,24,0,16,32
50,Success,57,29,0,5,52
50,Fail,46,24,4,17,29
50,Fail,42,32,0,13,29
50,Fail,48,26,8,8,40
50,Fail,43,38,0,11,32
50,Fail,48,25,3,14,34
50,Fail,62,14,1,14,48
50,Success,59,20,6,7,52
50,Fail,47,25,0,10,37
50,Fail,47,27,5,12,35
50,Fail,52,24,0,9,43
50,Fail,46,20,5,15,31
50,Fail,47,34,0,11,36
50,Fail,46,21,2,17,29
50,Fail,47,25,2,14,33
50,Fail,46,31,6,7,39
50,Fail,43,25,3,14,29
50,Fail,45,30,0,14,31
50,Fail,50,27,0,13,37
50,Fail,51,26,0,12,39
50,Fail,42,31,0,14,28
50,Fail,51,25,0,13,38
50,Fail,57,20,0,11,46
50,Fail,42,31,4,16,26
50,Fail,52,25,3,11,41
50,Fail,43,21,12,18,25
50,Fail,44,34,5,11,33
50,Fail,50,24,4,13,37
50,Fail,50,25,4,17,33
50,Fail,53,24,1,13,40
50,Fail,45,24,7,13,32
50,Fail,41,35,0,15,26
50,Fail,47,30,0,13,34
50,Fail,44,25,5,14,30
50,Fail,42,34,3,10,32
50,Fail,54,19,0,17,37
50,Fail,53,20,0,14,39
50,Fail,45,33,0,10,35
50,Fail,52,20,1,16,36
50,Fail,45,23,6,17,28
50,Fail,46,28,0,16,30
50,Fail,50,24,7,13,37
50,Fail,45,20,7,15,30
50,Fail,47,28,0,12,35
50,Fail,56,23,0,8,48
50,Fail,50,24,0,15,35
50,Fail,49,24,5,11,38
50,Fail,48,25,0,15,33
50,Fail,52,28,0,8,44
50,Fail,51,26,0,13,38
50,Fail,46,31,0,12,34
50,Fail,36,31,0,22,14
50,Fail,57,20,4,10,47
50,Fail,49,27,0,13,36
50,Fail,44,25,7,16,28
50,Fail,44,26,7,12,32
50,Success,57,24,0,7,50
50,Fail,45,34,0,8,37
50,Fail,49,21,5,15,34
50,Fail,53,19,4,15,38
50,Fail,44,19,9,16,28
50,Fail,56,23,0,10,46
50,Fail,46,31,0,13,33
50,Fail,56,23,0,12,44
50,Fail,50,31,0,8,42
50,Fail,50,26,0,13,37
50,Fail,48,28,0,13,35
50,Fail,51,19,0,16,35
50,Fail,53,21,0,16,37
50,Fail,48,20,0,17,31
50,Fail,46,31,0,12,34
50,Fail,39,42,0,10,29
50,Fail,46,33,6,6,40
50,Fail,40,30,3,20,20
50,Fail,52,20,0,11,41
50,Fail,49,23,1,12,37
50,Fail,46,23,6,16,30
50,Fail,44,31,0,14,30
50,Fail,46,29,0,14,32
50,Fail,51,28,0,7,44
50,Fail,44,36,0,11,33
50,Fail,49,28,0,16,33
50,Fail,45,28,4,14,31
50,Fail,49,26,4,13,36
50,Fail,52,23,0,13,39
50,Fail,41,36,0,16,25
50,Fail,50,27,2,9,41
50,Fail,37,40,0,11,26
50,Fail,52,20,0,13,39
50,Fail,48,27,0,14,34
50,Fail,51,20,4,14,37
50,Fail,50,33,0,10,40
50,Fail,46,23,8,11,35
50,Fail,47,36,0,12,35
50,Fail,44,28,0,15,29
50,Fail,52,25,4,8,44
50,Fail,47,31,0,9,38
50,Fail,47,25,1,14,33
50,Fail,53,26,0,10,43
50,Fail,48,27,0,13,35
50,Fail,43,32,2,12,31
50,Fail,51,28,0,10,41
50,Fail,39,29,0,20,19
50,Fail,44,32,3,12,32
50,Fail,49,23,0,17,32
50,Fail,44,32,0,14,30
50,Fail,47,21,3,20,27
50,Fail,49,25,9,7,42
50,Fail,52,27,1,11,41
50,Fail,45,24,7,14,31
50,Fail,49,22,3,15,34
50,Fail,52,25,0,8,44
50,Fail,45,32,0,12,33
50,Fail,44,28,0,13,31
50,Fail,45,29,0,17,28
50,Fail,51,22,0,16,35
50,Fail,53,21,8,6,47
50,Fail,48,22,3,14,34
50,Fail,51,35,0,6,45
50,Fail,47,31,0,13,34
50,Fail,43,24,2,18,25
50,Fail,45,33,0,12,33
50,Fail,53,29,0,10,43
50,Fail,47,26,6,11,36
50,Fail,48,24,5,12,36
50,Fail,47,22,3,18,29
50,Fail,44,41,0,9,35
50,Fail,57,16,0,14,43
50,Fail,52,21,2,16,36
50,Fail,47,33,0,8,39
50,Fail,49,30,0,10,39
50,Fail,52,22,0,11,41
50,Fail,54,27,0,6,48
50,Fail,44,24,3,17,27
50,Fail,43,33,0,13,30
50,Fail,51,19,1,16,35
50,Fail,44,27,1,15,29
50,Fail,43,31,6,14,29
50,Fail,42,28,4,15,27
50,Fail,46,28,0,13,33
50,Fail,55,26,5,7,48
50,Fail,52,22,2,15,37
50,Fail,48,34,0,9,39
50,Fail,41,30,1,11,30
50,Fail,47,27,2,12,35
50,Fail,54,20,4,12,42
50,Fail,38,49,0,8,30
50,Fail,49,18,0,22,27
50,Fail,43,34,4,11,32
50,Success,57,28,0,4,53
50,Fail,51,21,1,17,34
50,Fail,49,25,1,12,37
50,Fail,53,21,3,11,42
50,Fail,46,26,7,13,33
50,Fail,51,19,0,15,36
50,Fail,54,22,0,9,45
50,Fail,54,23,1,11,43
50,Fail,50,22,6,13,37
50,Fail,46,35,0,8,38
50,Fail,47,25,6,12,35
50,Fail,51,25,1,10,41
50,Fail,48,26,4,12,36
50,Fail,48,29,2,10,38
50,Fail,52,22,2,13,39
50,Fail,50,25,1,12,38
50,Fail,42,30,8,13,29
50,Fail,46,30,0,11,35
50,Fail,45,32,0,11,34
50,Fail,46,29,0,13,33
50,Fail,50,29,0,14,36
50,Success,62,19,5,6,56
50,Fail,46,26,5,14,32
50,Fail,41,37,2,11,30
50,Fail,44,34,0,13,31
50,Success,63,17,3,6,57
50,Fail,51,25,4,9,42
50,Fail,46,27,4,12,34
50,Fail,47,22,3,17,30
50,Fail,40,41,0,14,26
50,Fail,48,30,0,11,37
50,Fail,48,28,0,15,33
50,Fail,47,27,4,14,33
50,Fail,49,30,0,12,37
50,Fail,49,19,9,14,35
50,Fail,56,27,0,9,47
50,Fail,54,20,4,10,44
50,Fail,54,24,0,12,42
50,Fail,51,27,0,8,43
50,Fail,43,28,0,20,23
50,Fail,55,21,6,9,46
50,Fail,48,27,5,8,40
50,Fail,52,29,0,12,40
50,Fail,48,22,7,15,33
50,Fail,45,24,0,17,28
50,Fail,46,26,0,17,29
50,Fail,53,28,0,8,45
50,Fail,52,28,6,7,45
50,Fail,56,15,0,14,42
50,Fail,48,28,0,11,37
50,Fail,51,20,1,15,36
50,Fail,48,28,1,16,32
50,Fail,46,31,0,16,30
50,Fail,45,29,0,14,31
50,Fail,48,22,8,12,36
50,Fail,43,31,4,11,32
50,Fail,52,29,0,8,44
50,Fail,49,28,0,13,36
50,Fail,45,32,0,17,28
50,Fail,42,37,0,13,29
50,Fail,55,22,0,7,48
50,Fail,48,20,2,20,28
50,Fail,48,28,7,8,40
50,Fail,46,28,0,14,32
50,Fail,48,29,0,10,38
50,Fail,49,30,0,10,39
50,Fail,51,28,0,13,38
50,Fail,51,23,3,10,41
50,Fail,48,31,3,8,40
50,Fail,52,15,3,13,39
50,Fail,52,30,1,7,45
50,Fail,57,25,0,8,49
50,Fail,44,27,4,14,30
50,Fail,47,27,0,14,33
50,Fail,49,26,0,17,32
50,Fail,50,25,0,14,36
50,Fail,51,30,0,11,40
50,Fail,49,26,0,9,40
50,Fail,52,26,0,9,43
50,Fail,50,21,4,11,39
50,Fail,48,27,3,12,36
50,Fail,48,29,0,11,37
50,Fail,45,25,0,20,25
50,Fail,53,23,3,11,42
50,Fail,55,19,2,14,41
50,Fail,44,32,2,10,34
50,Fail,50,33,0,9,41
50,Fail,53,28,0,7,46
50,Fail,49,24,0,18,31
50,Fail,52,23,6,10,42
50,Fail,53,25,0,11,42
50,Fail,48,25,4,13,35
50,Fail,48,31,0,10,38
50,Fail,47,36,0,9,38
50,Fail,40,24,14,12,28
50,Fail,49,25,4,14,35
50,Fail,49,26,1,13,36
50,Fail,49,26,0,10,39
50,Fail,53,25,0,11,42
50,Fail,48,28,6,10,38
50,Fail,46,27,4,16,30
50,Fail,48,21,9,14,34
50,Fail,47,27,0,14,33
50,Fail,54,25,0,9,45
50,Fail,44,31,0,21,23
50,Fail,49,21,3,14,35
50,Fail,48,33,0,12,36
50,Fail,48,26,0,13,35
50,Fail,47,23,2,14,33
50,Fail,60,22,0,12,48
50,Fail,57,17,0,16,41
50,Fail,44,35,0,15,29
50,Fail,47,24,1,14,33
50,Fail,41,28,4,19,22
50,Fail,46,24,0,21,25
50,Fail,49,27,0,14,35
50,Fail,50,28,5,11,39
50,Success,56,22,5,5,51
50,Fail,47,29,0,12,35
50,Fail,53,16,5,9,44
50,Fail,49,29,0,12,37
50,Fail,54,22,2,8,46
50,Fail,54,16,0,18,36
50,Fail,52,23,6,10,42
50,Fail,44,30,8,9,35
50,Fail,45,25,1,18,27
50,Fail,42,31,10,12,30
50,Fail,48,28,0,12,36
50,Fail,53,21,6,9,44
50,Fail,45,26,4,13,32
50,Fail,45,24,8,8,37
50,Fail,53,25,0,12,41
50,Fail,49,22,4,15,34
50,Fail,43,28,4,15,28
50,Fail,53,28,0,8,45
50,Fail,47,31,0,12,35
50,Fail,46,25,6,15,31
50,Fail,43,29,2,17,26
50,Fail,50,20,2,15,35
50,Fail,48,20,5,15,33
50,Fail,49,24,3,15,34
50,Fail,49,27,0,12,37
50,Fail,45,30,0,14,31
50,Success,57,22,1,7,50
50,Fail,53,27,5,10,43
50,Fail,59,14,2,12,47
50,Fail,57,21,3,8,49
50,Fail,48,25,2,10,38
50,Fail,48,38,0,9,39
50,Fail,53,17,5,14,39
50,Fail,55,20,0,16,39
50,Fail,50,20,6,14,36
50,Fail,49,29,3,5,44
50,Fail,48,29,0,17,31
50,Fail,52,25,0,12,40
50,Fail,50,21,0,15,35
50,Fail,40,30,9,15,25
50,Fail,55,14,0,18,37
50,Fail,44,30,3,14,30
50,Fail,46,33,0,12,34
50,Fail,42,32,0,14,28
50,Fail,38,32,2,16,22
50,Fail,46,29,0,16,30
50,Fail,47,29,6,11,36
50,Fail,55,22,0,13,42
50,Fail,50,20,0,15,35
50,Fail,45,31,3,11,34
50,Fail,39,44,0,14,25
50,Fail,45,35,0,13,32
50,Fail,49,24,0,15,34
50,Fail,46,24,4,14,32
50,Fail,46,22,0,20,26
50,Fail,48,24,2,17,31
50,Fail,45,24,0,20,25
50,Fail,46,27,4,16,30
50,Fail,46,31,0,12,34
50,Fail,47,31,0,13,34
50,Fail,50,17,5,16,34
50,Fail,44,38,1,4,40
50,Fail,45,26,2,17,28
50,Fail,53,21,2,9,44
50,Fail,42,28,4,20,22
50,Fail,46,27,0,14,32
50,Fail,48,30,0,10,38
50,Fail,46,39,0,10,36
50,Fail,54,29,0,10,44
50,Fail,41,29,5,16,25
50,Fail,41,36,0,13,28
50,Fail,46,21,0,15,31
50,Fail,53,30,0,7,46
50,Fail,45,30,0,12,33
50,Fail,48,22,4,18,30
50,Fail,47,21,6,18,29
50,Fail,51,22,3,14,37
50,Fail,53,26,0,11,42
50,Fail,55,21,6,9,46
50,Fail,51,26,0,12,39
50,Fail,46,20,0,21,25
50,Fail,57,26,0,9,48
50,Fail,56,24,1,7,49
50,Fail,44,19,4,19,25
50,Fail,51,24,0,10,41
50,Fail,47,22,11,13,34
50,Fail,54,25,4,8,46
50,Fail,35,33,5,20,15
50,Fail,57,25,0,8,49
50,Fail,43,35,0,12,31
50,Fail,38,45,0,10,28
50,Fail,46,32,2,11,35
50,Fail,48,23,0,20,28
50,Fail,53,20,8,11,42
50,Fail,51,31,0,11,40
50,Fail,47,25,8,13,34
50,Fail,45,34,0,14,31
50,Fail,47,25,10,10,37
50,Fail,48,32,0,11,37
50,Fail,49,24,1,15,34
50,Fail,43,21,8,17,26
50,Fail,51,25,0,13,38
50,Fail,50,25,1,11,39
50,Fail,45,35,0,12,33
50,Fail,46,30,0,14,32
50,Fail,50,24,7,10,40
50,Fail,43,26,9,12,31
50,Fail,49,28,0,14,35
50,Fail,54,25,0,6,48
50,Fail,49,25,1,11,38
50,Fail,43,27,11,11,32
50,Fail,39,34,3,14,25
50,Fail,51,15,7,18,33
50,Fail,45,27,0,13,32
50,Fail,52,31,0,10,42
50,Fail,49,24,3,13,36
50,Fail,40,27,3,17,23
50,Fail,50,22,3,15,35
50,Fail,46,38,0,10,36
50,Fail,47,30,0,14,33
50,Fail,43,27,0,18,25
50,Fail,46,26,2,12,34
50,Fail,48,27,0,14,34
50,Fail,50,35,0,8,42
50,Fail,53,28,0,9,44
50,Fail,53,23,0,14,39
50,Fail,44,29,0,12,32
50,Fail,41,36,0,11,30
50,Fail,43,25,0,19,24
50,Fail,51,23,10,8,43
50,Fail,48,28,5,11,37
50,Fail,43,33,0,12,31
50,Fail,50,29,0,13,37
50,Fail,49,23,3,16,33
50,Fail,43,40,0,10,33
50,Fail,55,25,1,9,46
50,Fail,46,25,5,15,31
50,Fail,41,31,8,15,26
50,Fail,58,19,1,10,48
50,Fail,41,31,0,15,26
50,Fail,54,24,0,13,41
50,Fail,43,40,0,7,36
50,Fail,49,28,1,9,40
50,Success,64,17,0,8,56
50,Fail,46,27,5,13,33
50,Fail,47,33,0,12,35
50,Fail,39,30,3,17,22
50,Fail,47,30,0,15,32
50,Fail,56,25,0,7,49
50,Fail,47,26,2,15,32
50,Fail,43,33,0,11,32
50,Fail,56,22,0,8,48
50,Fail,43,26,3,14,29
50,Fail,50,28,9,5,45
50,Fail,41,32,0,17,24
50,Fail,56,24,0,7,49
50,Fail,49,28,0,10,39
50,Fail,47,25,4,10,37
50,Fail,43,30,0,19,24
50,Fail,47,29,0,12,35
50,Fail,49,25,3,14,35
50,Fail,50,27,0,13,37
50,Fail,47,32,1,11,36
50,Fail,42,28,3,12,30
50,Fail,42,32,0,13,29
50,Fail,46,34,0,13,33
50,Fail,53,25,4,9,44
50,Fail,43,25,3,14,29
50,Fail,40,37,0,17,23
50,Fail,44,33,0,14,30
50,Fail,51,32,0,9,42
50,Fail,52,16,6,11,41
50,Fail,50,28,3,11,39
50,Fail,51,29,0,13,38
50,Success,59,18,1,9,50
50,Fail,51,30,0,10,41
50,Fail,48,27,4,15,33
50,Fail,48,24,0,18,30
50,Fail,48,28,0,16,32
50,Fail,51,22,0,18,33
50,Fail,51,19,8,14,37
50,Fail,55,15,4,18,37
50,Fail,49,26,6,11,38
50,Fail,52,27,0,9,43
50,Fail,40,29,8,12,28
50,Fail,49,26,0,11,38
50,Fail,50,34,0,7,43
50,Fail,53,29,0,10,43
50,Fail,43,35,0,13,30
50,Fail,53,20,0,17,36
50,Fail,47,34,0,11,36
50,Fail,50,20,4,12,38
50,Fail,49,30,0,11,38
50,Fail,55,19,0,12,43
50,Fail,44,27,0,16,28
50,Fail,48,25,7,12,36
50,Fail,46,30,0,12,34
50,Fail,54,21,3,11,43
50,Fail,51,22,1,14,37
50,Fail,48,22,0,20,28
50,Fail,46,30,0,16,30
50,Fail,45,20,0,21,24
50,Fail,46,31,1,13,33
50,Fail,40,23,0,23,17
50,Fail,47,32,0,10,37
50,Fail,46,22,7,16,30
50,Fail,44,27,6,12,32
50,Fail,49,31,2,10,39
50,Fail,51,22,0,12,39
50,Fail,44,34,0,13,31
50,Fail,48,25,0,10,38
50,Fail,50,27,3,13,37
50,Fail,49,26,0,14,35
50,Fail,55,19,2,9,46
50,Fail,54,26,0,10,44
50,Fail,51,30,0,8,43
50,Fail,46,24,7,14,32
50,Fail,50,30,0,10,40
50,Fail,45,31,0,12,33
50,Fail,50,25,0,11,39
50,Fail,46,33,0,12,34
50,Fail,48,29,0,16,32
50,Fail,57,17,4,9,48
50,Fail,49,27,0,13,36
50,Fail,48,16,11,14,34
50,Fail,46,22,8,12,34
50,Fail,52,22,2,11,41
50,Fail,52,24,0,10,42
50,Fail,58,18,0,15,43
50,Fail,42,28,2,15,27
50,Fail,46,40,0,5,41
50,Fail,46,30,0,14,32
50,Fail,47,27,0,12,35
50,Fail,49,27,0,9,40
50,Fail,47,31,0,14,33
50,Fail,54,24,1,9,45
50,Fail,51,31,0,9,42
50,Fail,49,28,2,12,37
50,Fail,40,34,8,13,27
50,Fail,50,19,4,14,36
50,Fail,46,30,0,15,31
50,Fail,52,26,0,11,41
50,Fail,53,22,0,11,42
50,Fail,42,33,0,12,30
50,Fail,44,29,7,10,34
50,Fail,45,28,2,13,32
50,Fail,43,27,0,18,25
50,Fail,50,24,1,13,37
50,Fail,51,20,8,10,41
50,Fail,46,29,8,9,37
50,Fail,56,29,0,8,48
50,Fail,51,26,0,12,39
50,Fail,47,27,8,10,37
50,Fail,50,23,1,14,36
50,Fail,50,22,0,17,33
50,Fail,36,36,7,12,24
50,Fail,53,23,1,12,41
50,Fail,49,26,4,10,39
50,Fail,50,27,0,11,39
50,Fail,54,16,3,11,43
50,Fail,54,20,3,11,43
50,Fail,46,26,6,12,34
50,Fail,55,22,8,8,47
50,Fail,48,23,0,19,29
50,Fail,52,23,0,12,40
50,Fail,54,20,3,9,45
50,Fail,50,25,3,9,41
50,Fail,49,24,4,12,37
50,Fail,46,30,0,13,33
50,Fail,45,37,0,8,37
50,Fail,47,33,0,9,38
50,Fail,48,28,5,8,40
50,Fail,50,26,0,15,35
50,Fail,44,31,2,10,34
50,Fail,43,34,0,16,27
50,Fail,55,20,0,14,41
50,Fail,41,23,14,14,27
50,Fail,47,21,9,14,33
50,Fail,43,33,0,13,30
50,Fail,51,20,0,16,35
50,Fail,56,20,1,10,46
50,Fail,51,25,2,9,42
50,Fail,47,25,0,16,31
50,Fail,37,41,0,14,23
50,Fail,44,31,3,13,31
50,Fail,54,13,5,15,39
50,Fail,45,26,4,13,32
50,Fail,47,29,1,10,37
50,Fail,52,21,0,14,38
50,Fail,49,23,0,15,34
50,Fail,48,22,10,12,36
50,Fail,55,29,0,6,49
50,Fail,54,26,0,9,45
50,Fail,41,37,0,12,29
50,Fail,47,24,0,15,32
50,Fail,54,25,4,11,43
50,Fail,47,23,0,14,33
50,Fail,51,29,1,7,44
50,Fail,55,24,1,7,48
50,Fail,48,25,4,12,36
50,Fail,53,28,0,7,46
50,Fail,44,36,0,14,30
50,Fail,43,32,0,14,29
50,Fail,51,17,0,19,32
50,Fail,54,23,0,12,42
50,Fail,47,30,0,13,34
50,Fail,51,22,3,15,36
50,Fail,49,25,0,13,36
50,Fail,51,22,0,17,34
50,Fail,47,26,0,17,30
50,Fail,44,31,0,14,30
50,Fail,51,32,0,6,45
50,Fail,51,33,0,9,42
50,Fail,45,23,5,13,32
50,Fail,46,28,3,14,32
50,Fail,49,33,0,8,41
50,Fail,56,19,1,14,42
50,Fail,53,25,0,13,40
50,Fail,41,32,2,14,27
50,Fail,39,32,3,18,21
50,Fail,53,22,0,9,44
50,Fail,49,26,4,10,39
50,Fail,48,27,0,15,33
50,Fail,48,36,0,8,40
50,Fail,48,26,3,12,36
50,Fail,39,34,4,16,23
50,Fail,45,27,0,14,31
50,Fail,47,23,6,17,30
50,Fail,51,29,1,9,42
50,Fail,50,29,0,14,36
50,Fail,43,29,2,10,33
50,Fail,51,32,0,6,45
50,Fail,46,32,0,15,31
50,Fail,50,28,1,11,39
50,Fail,42,38,0,10,32
50,Fail,47,26,2,14,33
50,Fail,43,26,2,17,26
50,Fail,52,30,0,6,46
50,Fail,53,22,1,15,38
50,Fail,48,30,0,17,31
50,Fail,51,28,0,9,42
50,Fail,42,37,0,11,31
50,Fail,42,34,0,14,28
50,Fail,49,24,0,16,33
50,Fail,46,34,0,10,36
50,Fail,50,24,0,13,37
50,Fail,46,25,2,14,32
50,Fail,46,24,9,12,34
50,Fail,45,24,7,12,33
50,Fail,53,21,0,14,39
50,Fail,46,31,0,17,29
50,Fail,51,23,2,14,37
50,Fail,50,24,0,13,37
50,Fail,46,28,0,18,28
50,Fail,52,21,6,14,38
50,Fail,49,27,1,17,32
50,Fail,56,23,1,10,46
50,Fail,47,35,0,8,39
50,Fail,41,29,6,15,26
50,Fail,48,31,0,14,34
50,Fail,44,32,4,10,34
50,Fail,54,21,5,8,46
50,Fail,47,26,3,14,33
50,Fail,50,24,8,11,39
50,Fail,56,25,0,9,47
50,Fail,54,22,0,15,39
50,Fail,51,25,7,8,43
50,Fail,54,26,0,7,47
50,Fail,49,24,7,7,42
50,Fail,45,33,0,11,34
50,Fail,42,28,11,12,30
50,Fail,48,36,0,7,41
50,Fail,48,23,4,15,33
50,Fail,49,23,1,13,36
50,Fail,50,31,0,10,40
50,Fail,52,23,0,12,40
50,Fail,38,36,0,15,23
50,Fail,45,28,0,14,31
50,Fail,46,37,0,6,40
50,Fail,53,18,3,9,44
50,Fail,49,27,0,11,38
50,Fail,40,30,0,19,21
50,Fail,45,29,0,15,30
50,Fail,44,27,0,16,28
50,Fail,48,32,0,11,37
50,Fail,55,24,4,7,48
50,Fail,48,20,0,18,30
50,Fail,55,20,1,10,45
50,Fail,48,24,5,12,36
50,Fail,53,27,0,8,45
50,Fail,40,31,0,17,23
50,Fail,46,29,0,14,32
50,Fail,45,32,3,10,35
50,Fail,44,31,0,12,32
50,Fail,47,28,0,13,34
50,Fail,49,26,0,17,32
50,Fail,47,34,0,10,37
50,Fail,50,25,4,11,39
50,Fail,46,33,0,12,34
50,Fail,50,34,0,10,40
50,Fail,42,28,5,11,31
50,Fail,48,22,8,15,33
50,Fail,44,31,7,10,34
50,Fail,44,39,0,8,36
50,Fail,51,25,0,14,37
50,Fail,48,22,5,16,32
50,Fail,48,27,4,10,38
50,Fail,51,20,5,17,34
50,Fail,44,34,0,12,32
50,Fail,48,26,2,13,35
50,Fail,48,35,0,12,36
50,Fail,41,29,0,17,24
50,Fail,55,25,0,10,45
50,Success,59,25,0,7,52
50,Fail,48,26,0,13,35
50,Success,61,23,0,6,55
50,Fail,47,28,3,11,36
50,Fail,46,22,3,16,30
50,Fail,45,32,4,10,35
50,Fail,41,35,0,14,27
50,Fail,45,34,0,14,31
50,Fail,48,33,1,8,40
50,Fail,52,27,1,5,47
50,Fail,46,27,1,15,31
50,Success,59,20,0,5,54
50,Fail,49,29,0,12,37
50,Fail,55,26,0,10,45
50,Fail,53,21,2,15,38
50,Fail,50,29,0,10,40
50,Fail,49,27,2,12,37
50,Fail,51,25,0,10,41
50,Fail,45,25,3,15,30
50,Fail,54,20,0,13,41
50,Fail,49,20,4,18,31
50,Fail,49,35,0,7,42
50,Fail,50,32,0,9,41
50,Fail,49,24,6,14,35
50,Fail,47,25,4,14,33
50,Fail,56,23,0,13,43
50,Fail,42,34,0,15,27
50,Fail,46,26,0,13,33
50,Fail,45,29,5,11,34
50,Fail,52,23,5,9,43
50,Fail,47,29,0,15,32
50,Fail,40,34,0,16,24
50,Fail,39,31,0,15,24
50,Fail,48,26,1,15,33
50,Fail,46,28,1,12,34
50,Fail,50,26,2,9,41
50,Fail,45,32,4,10,35
50,Fail,48,26,7,14,34
50,Fail,47,25,0,18,29
50,Fail,47,28,0,15,32
50,Fail,55,24,0,11,44
50,Fail,45,26,2,18,27
50,Fail,52,34,0,8,44
50,Fail,48,22,2,16,32
50,Fail,46,27,1,14,32
50,Fail,43,29,6,11,32
50,Fail,37,22,15,21,16
50,Fail,52,25,1,8,44
50,Fail,51,23,0,13,38
50,Fail,51,22,1,17,34
50,Fail,47,28,0,11,36
50,Fail,48,29,0,12,36
50,Fail,47,25,0,15,32
50,Fail,48,23,10,10,38
50,Fail,49,28,5,10,39
50,Fail,41,37,0,16,25
50,Fail,52,27,0,7,45
50,Fail,45,33,5,9,36
50,Fail,52,22,8,8,44
50,Fail,52,26,0,11,41
50,Fail,46,30,0,14,32
50,Fail,50,24,3,14,36
50,Fail,46,26,4,13,33
50,Fail,45,25,7,13,32
50,Fail,48,34,0,9,39
50,Success,59,20,1,8,51
50,Fail,49,24,0,13,36
50,Fail,52,25,3,10,42
50,Fail,52,26,0,16,36
50,Fail,48,26,3,12,36
50,Fail,51,33,0,8,43
50,Fail,44,37,0,12,32
50,Fail,46,31,5,7,39
50,Fail,53,26,0,8,45
50,Fail,52,26,0,12,40
50,Fail,46,35,0,8,38
50,Fail,40,34,0,13,27
50,Fail,53,23,0,14,39
50,Fail,53,21,1,12,41
50,Fail,52,24,8,10,42
50,Fail,49,28,0,11,38
50,Fail,47,29,0,13,34
50,Fail,46,27,8,11,35
50,Fail,47,26,0,12,35
50,Fail,50,26,0,8,42
50,Fail,47,26,7,11,36
50,Fail,53,20,4,14,39
50,Fail,50,24,1,14,36
50,Fail,45,25,7,14,31
50,Fail,51,29,0,10,41
50,Fail,49,25,0,13,36
50,Fail,51,30,0,10,41
50,Fail,47,29,2,10,37
50,Fail,43,35,0,11,32
50,Fail,43,33,0,9,34
50,Fail,47,34,0,9,38
50,Fail,57,20,3,10,47
50,Fail,48,29,2,11,37
50,Fail,41,30,4,18,23
50,Fail,42,23,4,19,23
50,Fail,52,24,5,9,43
50,Fail,51,24,0,14,37
50,Fail,46,28,0,16,30
50,Fail,46,26,1,15,31
50,Fail,55,23,0,13,42
50,Fail,48,22,7,10,38
50,Fail,51,21,12,9,42
50,Fail,49,30,0,11,38
50,Fail,51,18,5,15,36
50,Fail,52,24,0,9,43
50,Fail,47,21,2,21,26
50,Fail,46,27,3,13,33
50,Fail,41,29,7,14,27
50,Fail,51,28,0,10,41
50,Fail,35,40,0,16,19
50,Fail,52,23,0,12,40
50,Fail,52,26,2,11,41
50,Fail,45,27,3,16,29
50,Fail,36,34,6,16,20
50,Fail,45,36,0,11,34
50,Fail,49,24,5,13,36
50,Fail,44,28,4,14,30
50,Fail,56,21,0,11,45
50,Fail,55,21,1,14,41
50,Fail,43,35,0,10,33
50,Fail,44,28,4,11,33
50,Fail,38,24,10,17,21
50,Fail,46,36,0,10,36
50,Fail,56,19,0,14,42
50,Fail,44,27,4,10,34
50,Fail,50,24,0,13,37
50,Fail,50,31,0,11,39
50,Fail,43,27,0,18,25
50,Fail,50,19,3,16,34
50,Fail,46,30,0,13,33
50,Fail,38,29,5,18,20
50,Fail,50,16,0,20,30
50,Fail,48,30,1,11,37
50,Fail,43,34,0,12,31
50,Success,58,27,1,5,53
50,Fail,44,33,0,10,34
50,Fail,48,25,9,8,40
50,Fail,51,22,5,12,39
50,Fail,42,30,0,16,26
50,Fail,46,26,6,12,34
50,Fail,46,30,0,12,34
50,Fail,57,15,0,13,44
50,Fail,45,32,0,13,32
50,Fail,46,26,0,19,27
50,Fail,53,23,2,9,44
50,Fail,49,27,0,10,39
50,Fail,45,23,7,16,29
50,Fail,51,25,0,13,38
50,Fail,46,33,0,13,33
50,Fail,52,27,1,8,44
50,Fail,46,26,3,16,30
50,Fail,52,18,3,13,39
50,Fail,52,25,5,8,44
50,Fail,44,27,2,13,31
50,Fail,53,31,0,8,45
50,Fail,43,29,1,13,30
50,Fail,47,35,0,8,39
50,Fail,42,29,3,13,29
50,Fail,49,28,0,11,38
50,Fail,56,26,0,9,47
50,Fail,53,25,0,10,43
50,Fail,44,24,7,16,28
50,Fail,49,25,2,12,37
50,Fail,45,38,0,13,32
50,Fail,44,25,6,19,25
50,Fail,39,32,5,12,27
50,Fail,46,30,3,12,34
50,Fail,51,25,0,17,34
50,Fail,53,30,0,6,47
50,Fail,53,20,4,9,44
50,Fail,51,34,0,8,43
50,Fail,56,29,0,7,49
50,Fail,38,36,3,12,26
50,Fail,45,29,9,6,39
50,Fail,52,31,0,9,43
50,Fail,43,29,0,15,28
50,Fail,49,29,0,12,37
50,Fail,50,27,0,13,37
50,Fail,53,30,0,9,44
50,Fail,50,29,0,11,39
50,Fail,44,35,0,13,31
50,Fail,48,22,4,14,34
50,Fail,42,32,0,15,27
50,Fail,45,21,11,17,28
50,Fail,38,29,1,22,16
50,Fail,44,30,8,10,34
50,Fail,43,25,9,14,29
50,Fail,53,23,6,7,46
50,Fail,40,25,10,16,24
50,Fail,54,28,0,8,46
50,Fail,41,27,13,15,26
50,Fail,46,26,3,14,32
50,Fail,48,20,5,14,34
50,Fail,47,30,0,13,34
50,Fail,50,23,3,13,37
50,Fail,52,24,0,11,41
50,Fail,46,31,0,12,34
50,Fail,44,35,0,11,33
50,Fail,43,27,5,13,30
50,Fail,56,21,4,10,46
50,Fail,41,38,0,16,25
50,Fail,46,30,0,11,35
50,Fail,39,32,9,12,27
50,Fail,49,16,4,19,30
50,Fail,51,27,0,17,34
50,Fail,40,36,0,14,26
50,Fail,46,32,0,12,34
50,Fail,52,27,0,9,43
50,Fail,49,31,0,8,41
50,Fail,48,28,2,11,37
50,Fail,47,22,0,15,32
50,Fail,51,27,0,14,37
50,Fail,40,36,0,14,26
50,Fail,51,27,0,13,38
50,Fail,52,20,0,16,36
50,Fail,47,30,0,13,34
50,Fail,52,16,3,15,37
50,Fail,48,29,0,12,36
50,Fail,48,23,0,21,27
50,Fail,48,31,0,8,40
50,Fail,46,26,1,17,29
50,Fail,48,23,1,12,36
50,Fail,38,40,0,15,23
50,Fail,47,38,0,7,40
50,Fail,47,31,0,13,34
50,Fail,46,23,2,15,31
50,Fail,41,34,0,12,29
50,Fail,46,27,4,13,33
50,Fail,52,27,2,9,43
50,Fail,52,24,10,7,45
50,Fail,48,25,5,11,37
50,Fail,50,27,0,10,40
50,Fail,43,25,12,13,30
50,Fail,47,26,0,15,32
50,Fail,46,30,0,15,31
50,Fail,51,27,2,9,42
50,Fail,45,30,2,15,30
50,Fail,50,29,1,12,38
50,Fail,54,19,2,12,42
50,Fail,49,23,0,15,34
50,Fail,43,38,0,9,34
50,Fail,49,34,0,12,37
50,Fail,49,28,5,8,41
50,Fail,47,26,2,17,30
50,Fail,48,20,8,14,34
50,Fail,48,23,7,10,38
50,Fail,48,29,0,14,34
50,Fail,51,30,0,7,44
50,Fail,50,25,0,13,37
50,Fail,56,20,0,11,45
50,Fail,41,35,8,7,34
50,Fail,53,26,0,7,46
50,Fail,48,28,0,16,32
50,Fail,43,27,7,15,28
50,Fail,56,23,0,8,48
50,Fail,40,27,5,18,22
50,Fail,44,29,1,13,31
50,Fail,53,25,0,6,47
50,Fail,51,22,4,11,40
50,Fail,54,24,0,12,42
50,Fail,50,27,0,10,40
50,Fail,52,23,2,17,35
50,Fail,43,28,3,15,28
50,Fail,47,24,3,15,32
50,Fail,48,26,5,8,40
50,Fail,47,26,5,13,34
50,Fail,48,33,0,12,36
50,Fail,55,25,0,10,45
50,Fail,54,27,0,7,47
50,Fail,47,27,0,15,32
50,Fail,45,29,0,13,32
50,Fail,52,22,0,15,37
50,Fail,53,22,0,16,37
50,Fail,42,32,0,16,26
50,Fail,50,32,0,10,40
50,Fail,42,32,2,9,33
50,Fail,45,29,8,10,35
50,Fail,47,31,2,11,36
50,Fail,58,18,0,12,46
50,Fail,46,28,0,15,31
50,Fail,52,30,0,6,46
50,Fail,47,35,1,9,38
50,Fail,49,31,0,9,40
50,Fail,49,27,4,12,37
50,Fail,55,27,0,8,47
50,Fail,45,24,9,16,29
50,Fail,42,32,0,16,26
50,Fail,47,27,0,12,35
50,Fail,47,30,0,10,37
50,Fail,47,22,6,12,35
50,Fail,45,30,5,10,35
50,Fail,46,31,0,12,34
50,Fail,48,29,0,14,34
50,Fail,45,21,10,16,29
50,Fail,54,22,1,9,45
50,Fail,47,35,0,11,36
50,Fail,52,32,0,6,46
50,Fail,47,26,1,11,36
50,Fail,48,24,0,17,31
50,Fail,50,26,4,10,40
50,Fail,46,25,0,15,31
50,Fail,52,20,0,16,36
50,Fail,44,30,1,14,30
50,Fail,51,30,2,5,46
50,Fail,45,38,0,8,37
50,Fail,48,27,0,14,34
50,Fail,46,26,3,13,33
50,Fail,44,29,0,15,29
50,Fail,45,23,6,15,30
50,Fail,46,23,7,12,34
50,Fail,56,22,0,12,44
50,Fail,45,26,13,10,35
50,Fail,49,29,2,12,37
50,Fail,47,31,0,11,36
50,Fail,52,27,0,9,43
50,Fail,47,23,9,10,37
50,Fail,45,27,5,17,28
50,Fail,47,29,2,14,33
50,Fail,50,23,0,11,39
50,Fail,52,25,0,15,37
50,Fail,50,24,5,12,38
50,Fail,56,18,0,15,41
50,Fail,45,24,0,15,30
50,Fail,44,27,0,16,28
50,Fail,50,26,2,12,38
50,Fail,42,32,3,14,28
50,Fail,45,30,0,13,32
50,Fail,43,28,1,17,26
50,Fail,49,26,7,11,38
50,Fail,52,22,0,12,40
50,Fail,50,26,0,11,39
50,Fail,50,28,0,9,41
50,Fail,47,25,0,16,31
50,Fail,43,32,0,14,29
50,Fail,48,22,6,16,32
50,Fail,47,27,0,11,36
50,Fail,52,26,2,10,42
50,Fail,43,30,1,14,29
50,Fail,55,19,7,9,46
50,Fail,44,32,3,15,29
50,Fail,44,26,4,18,26
50,Fail,52,24,0,13,39
50,Fail,43,28,2,14,29
50,Fail,52,23,4,14,38
50,Fail,48,28,0,10,38
50,Fail,48,24,5,10,38
50,Fail,42,38,0,11,31
50,Fail,49,29,0,12,37
50,Fail,47,33,0,9,38
50,Fail,50,27,0,12,38
50,Fail,47,35,3,6,41
50,Fail,48,23,1,19,29
50,Fail,45,26,0,17,28
50,Fail,48,28,0,12,36
50,Fail,56,23,0,12,44
50,Fail,50,28,5,9,41
50,Fail,46,25,4,14,32
50,Fail,51,23,0,17,34
50,Fail,45,36,0,12,33
50,Fail,38,40,0,11,27
50,Fail,51,32,0,5,46
50,Fail,44,27,0,13,31
50,Fail,50,35,0,7,43
50,Fail,53,27,0,9,44
50,Fail,50,26,1,12,38
50,Fail,47,30,0,14,33
50,Fail,48,31,0,10,38
50,Fail,49,22,3,10,39
50,Fail,52,26,0,11,41
50,Fail,47,31,1,11,36
50,Fail,53,19,0,17,36
50,Fail,44,29,4,11,33
50,Fail,54,20,3,12,42
50,Fail,50,19,0,22,28
50,Fail,47,32,0,11,36
50,Fail,37,33,11,9,28
50,Fail,56,26,0,7,49
50,Fail,43,31,0,16,27
50,Fail,49,31,0,8,41
50,Fail,43,32,1,13,30
50,Fail,51,28,0,9,42
50,Fail,46,35,6,5,41
50,Fail,52,25,0,11,41
50,Fail,44,28,0,15,29
50,Fail,57,18,3,11,46
50,Fail,47,28,0,15,32
50,Fail,51,30,0,10,41
50,Fail,40,37,0,14,26
50,Fail,43,28,3,10,33
50,Fail,42,33,0,14,28
50,Fail,51,23,1,10,41
50,Fail,51,24,2,11,40
50,Fail,48,25,0,12,36
50,Fail,48,28,0,12,36
50,Success,57,24,0,6,51
50,Fail,48,33,0,9,39
50,Fail,54,20,0,10,44
50,Fail,50,22,1,16,34
50,Fail,46,27,0,17,29
50,Fail,48,30,0,13,35
50,Fail,38,37,3,13,25
50,Fail,51,23,2,16,35
50,Fail,41,34,0,14,27
50,Fail,44,28,4,17,27
50,Fail,51,22,7,11,40
50,Fail,48,22,0,20,28
50,Fail,53,26,2,12,41
50,Fail,48,33,0,8,40
50,Fail,43,32,3,13,30
50,Fail,51,25,6,8,43
50,Fail,50,23,1,14,36
50,Fail,55,22,5,9,46
50,Fail,47,24,3,14,33
50,Fail,38,33,5,14,24
50,Fail,45,28,6,13,32
50,Fail,52,26,0,11,41
50,Fail,54,27,0,11,43
50,Fail,47,30,0,11,36
50,Fail,43,31,2,14,29
50,Fail,58,19,0,11,47
50,Fail,42,28,5,18,24
50,Fail,45,28,1,18,27
50,Fail,46,19,11,17,29
50,Fail,49,28,0,10,39
50,Fail,42,42,0,8,34
50,Fail,45,25,6,14,31
50,Fail,52,24,0,10,42
50,Fail,59,20,0,11,48
50,Fail,42,38,0,12,30
50,Fail,44,25,1,20,24
50,Fail,44,32,0,14,30
50,Fail,38,32,6,11,27
50,Fail,52,24,0,14,38
50,Fail,51,24,1,11,40
50,Fail,45,26,1,17,28
50,Fail,39,39,0,16,23
50,Fail,50,31,0,8,42
50,Fail,41,30,1,17,24
50,Fail,45,31,0,10,35
50,Fail,49,24,0,14,35
50,Fail,38,28,8,14,24
50,Fail,45,20,14,13,32
50,Success,64,21,0,5,59
50,Fail,48,22,11,16,32
50,Fail,49,20,8,12,37
50,Fail,42,28,6,13,29
50,Fail,45,30,4,13,32
50,Fail,34,42,0,16,18
50,Fail,44,38,0,7,37
50,Fail,49,25,1,15,34
50,Fail,51,25,0,12,39
50,Fail,55,23,1,9,46
50,Fail,49,28,0,15,34
50,Fail,53,27,0,10,43
50,Fail,41,31,3,14,27
50,Fail,51,23,0,13,38
50,Fail,47,28,1,11,36
50,Fail,48,31,0,12,36
50,Fail,51,25,0,11,40
50,Fail,49,28,1,10,39
50,Fail,50,25,0,14,36
50,Fail,46,24,0,17,29
50,Fail,57,25,0,9,48
50,Fail,50,24,5,14,36
50,Fail,51,31,0,12,39
50,Fail,46,30,0,14,32
50,Fail,50,25,0,14,36
50,Fail,48,23,2,15,33
50,Fail,52,22,0,13,39
50,Fail,43,38,0,12,31
50,Fail,55,21,0,12,43
50,Fail,53,24,2,12,41
50,Fail,51,22,5,14,37
50,Fail,46,23,8,15,31
50,Fail,42,23,4,20,22
50,Fail,47,25,0,18,29
50,Fail,48,25,4,13,35
50,Fail,43,28,3,11,32
50,Fail,43,28,2,17,26
50,Fail,49,33,0,7,42
50,Fail,56,28,0,7,49
50,Fail,48,26,9,9,39
50,Fail,40,31,4,17,23
50,Fail,41,30,8,9,32
50,Fail,54,17,5,13,41
50,Fail,49,29,0,9,40
50,Fail,51,24,7,12,39
50,Fail,50,29,0,6,44
50,Fail,35,36,6,13,22
50,Fail,45,26,4,16,29
50,Fail,49,27,0,10,39
50,Fail,47,21,0,20,27
50,Fail,42,30,8,12,30
50,Fail,40,38,0,16,24
50,Fail,44,27,0,18,26
50,Fail,49,36,0,10,39
50,Fail,50,25,6,9,41
50,Fail,44,27,4,15,29
50,Fail,47,31,2,11,36
50,Fail,46,25,0,14,32
50,Fail,48,29,0,14,34
50,Success,60,22,0,8,52
50,Fail,51,25,1,11,40
50,Fail,50,19,2,16,34
50,Fail,43,34,0,13,30
50,Fail,45,31,2,11,34
50,Fail,53,22,0,12,41
50,Fail,47,26,0,19,28
50,Fail,56,21,1,12,44
50,Fail,49,32,0,10,39
50,Fail,47,28,3,12,35
50,Fail,47,27,0,16,31
50,Fail,42,30,0,15,27
50,Fail,43,32,0,13,30
50,Fail,56,18,0,10,46
50,Fail,44,32,0,13,31
50,Fail,60,12,0,17,43
50,Fail,47,27,0,13,34
50,Fail,54,23,1,11,43
50,Fail,44,36,0,12,32
50,Fail,46,23,6,13,33
50,Fail,48,26,3,11,37
50,Fail,46,30,0,13,33
50,Fail,41,26,3,17,24
50,Fail,57,14,2,15,42
50,Fail,48,29,0,11,37
50,Fail,48,24,0,19,29
50,Fail,45,23,0,17,28
50,Fail,50,29,0,10,40
50,Fail,56,18,1,9,47
50,Fail,39,29,10,16,23
50,Fail,48,29,0,13,35
50,Fail,45,29,0,17,28
50,Fail,44,39,0,11,33
50,Success,59,24,0,5,54
50,Fail,53,28,2,7,46
50,Fail,39,36,0,17,22
50,Fail,46,34,0,13,33
50,Fail,47,29,0,10,37
50,Fail,45,29,7,10,35
50,Fail,49,34,0,11,38
50,Fail,42,33,3,13,29
50,Fail,44,24,10,16,28
50,Fail,45,30,1,12,33
50,Fail,53,23,0,13,40
50,Fail,47,31,0,13,34
50,Fail,43,32,0,12,31
50,Fail,54,25,3,8,46
50,Fail,45,37,0,9,36
50,Fail,43,32,5,12,31
50,Fail,49,26,0,10,39
50,Fail,53,23,0,11,42
50,Fail,52,24,2,10,42
50,Fail,47,27,4,8,39
50,Fail,51,21,4,11,40
50,Fail,43,29,0,15,28
50,Fail,50,19,1,16,34
50,Fail,51,26,0,11,40
50,Fail,53,18,4,12,41
50,Fail,45,25,11,10,35
50,Fail,51,24,1,17,34
50,Success,62,17,1,9,53
50,Fail,50,26,0,15,35
50,Fail,52,23,5,9,43
50,Fail,54,22,0,10,44
50,Fail,49,27,0,15,34
50,Fail,51,24,0,13,38
50,Fail,52,24,0,11,41
50,Fail,47,27,3,9,38
50,Fail,48,31,0,8,40
50,Success,58,22,2,8,50
50,Fail,50,21,0,17,33
50,Fail,44,29,3,13,31
50,Fail,41,25,7,19,22
50,Fail,44,35,0,13,31
50,Fail,48,19,10,15,33
50,Fail,57,23,0,9,48
50,Fail,40,33,2,16,24
50,Fail,48,25,0,13,35
50,Fail,48,27,2,15,33
50,Fail,43,37,0,13,30
50,Fail,48,22,3,15,33
50,Fail,56,23,0,11,45
50,Fail,49,25,0,17,32
50,Fail,48,31,1,13,35
50,Fail,51,23,0,14,37
50,Fail,50,25,0,10,40
50,Fail,46,29,0,15,31
50,Fail,53,19,4,13,40
50,Fail,50,22,7,14,36
50,Fail,49,21,12,9,40
50,Fail,37,32,3,17,20
50,Fail,48,21,5,15,33
50,Fail,45,31,0,12,33
50,Fail,48,22,0,20,28
50,Fail,49,23,10,10,39
50,Fail,50,30,4,8,42
50,Fail,53,26,0,8,45
50,Fail,41,24,5,16,25
50,Fail,35,28,15,12,23
50,Fail,52,27,2,11,41
50,Fail,46,31,0,14,32
50,Fail,40,43,0,11,29
50,Fail,48,29,0,14,34
50,Fail,47,25,0,18,29
50,Fail,55,21,1,13,42
50,Fail,49,25,5,11,38
50,Fail,46,21,3,18,28
50,Fail,48,30,0,16,32
50,Fail,43,27,9,13,30
50,Fail,48,27,0,13,35
50,Fail,47,23,7,16,31
50,Fail,46,30,0,14,32
50,Fail,48,26,0,15,33
50,Fail,56,22,1,8,48
50,Fail,49,23,0,16,33
50,Fail,48,26,2,15,33
50,Fail,51,32,0,9,42
50,Fail,50,24,4,15,35
50,Fail,46,27,13,5,41
50,Fail,47,25,0,12,35
50,Fail,56,20,2,12,44
50,Fail,49,22,0,17,32
50,Fail,44,32,0,13,31
50,Fail,51,20,2,13,38
50,Success,56,29,0,6,50
50,Fail,46,32,0,11,35
50,Fail,42,31,0,16,26
50,Fail,42,30,4,15,27
50,Fail,38,33,3,16,22
50,Fail,43,26,10,13,30
50,Fail,46,31,0,13,33
50,Fail,47,31,0,12,35
50,Fail,44,35,0,13,31
50,Fail,45,21,5,17,28
50,Fail,44,30,0,14,30
50,Fail,48,30,0,10,38
50,Fail,56,20,0,11,45
50,Fail,55,27,0,11,44
50,Fail,39,32,3,14,25
50,Fail,52,17,7,12,40
50,Fail,49,22,0,18,31
50,Fail,54,23,0,14,40
50,Fail,43,37,0,9,34
50,Fail,45,33,0,12,33
50,Fail,54,19,3,12,42
50,Fail,54,25,6,8,46
50,Fail,48,35,0,11,37
50,Fail,45,34,0,11,34
50,Fail,50,24,4,16,34
50,Fail,41,31,5,14,27
50,Fail,45,31,8,8,37
50,Fail,50,19,3,15,35
50,Fail,50,29,0,13,37
50,Fail,48,25,3,11,37
50,Fail,45,25,1,15,30
50,Fail,54,25,1,7,47
50,Fail,47,32,0,12,35
50,Fail,47,26,0,16,31
50,Fail,48,32,0,10,38
50,Fail,57,20,0,10,47
50,Fail,43,30,2,17,26
50,Fail,58,21,0,9,49
50,Fail,46,27,0,12,34
50,Fail,49,30,0,11,38
50,Fail,47,25,4,14,33
50,Fail,58,22,0,9,49
50,Fail,41,34,0,15,26
50,Fail,54,19,0,11,43
50,Fail,48,31,0,11,37
50,Fail,45,32,0,12,33
50,Fail,50,21,2,12,38
50,Fail,49,26,5,11,38
50,Fail,46,28,2,11,35
50,Fail,44,34,0,12,32
50,Fail,46,30,3,12,34
50,Fail,54,30,0,7,47
50,Fail,50,22,2,15,35
50,Fail,38,36,0,17,21
50,Fail,48,24,5,11,37
50,Fail,53,29,0,9,44
50,Success,60,24,2,5,55
50,Fail,52,26,0,12,40
50,Fail,51,26,0,9,42
50,Fail,43,33,0,12,31
50,Fail,46,28,6,13,33
50,Fail,51,26,1,9,42
50,Fail,49,24,6,14,35
50,Fail,46,31,0,13,33
50,Fail,44,24,11,14,30
50,Fail,45,29,4,9,36
50,Fail,44,29,2,15,29
50,Fail,39,28,7,16,23
50,Fail,45,29,0,14,31
50,Fail,55,26,0,7,48
50,Fail,49,26,4,12,37
50,Fail,50,31,0,9,41
50,Fail,40,38,0,15,25
50,Fail,49,21,8,14,35
50,Fail,43,28,3,18,25
50,Fail,51,28,0,12,39
50,Fail,51,28,3,8,43
50,Fail,50,17,7,13,37
50,Fail,43,32,0,16,27
50,Fail,47,21,4,18,29
50,Fail,38,38,5,13,25
50,Fail,51,22,0,12,39
50,Fail,46,31,0,13,33
50,Fail,47,37,0,9,38
50,Fail,53,23,0,10,43
50,Fail,41,30,4,13,28
50,Fail,39,39,2,9,30
50,Fail,49,23,5,10,39
50,Fail,40,27,2,18,22
50,Fail,52,22,7,11,41
50,Fail,39,37,0,15,24
50,Fail,49,25,3,10,39
50,Fail,50,23,1,14,36
50,Fail,41,34,0,10,31
50,Fail,47,29,4,11,36
50,Fail,48,20,2,19,29
50,Fail,43,25,10,14,29
50,Fail,47,35,0,10,37
50,Fail,44,24,3,14,30
50,Fail,46,31,0,12,34
50,Fail,43,27,7,13,30
50,Fail,48,26,2,12,36
50,Fail,47,28,0,15,32
50,Fail,46,26,2,17,29
50,Fail,49,34,0,10,39
50,Fail,46,37,0,10,36
50,Fail,45,30,0,13,32
50,Fail,50,28,0,11,39
50,Fail,51,33,0,7,44
50,Fail,46,28,0,11,35
50,Fail,48,31,0,12,36
50,Fail,49,24,0,18,31
50,Fail,46,29,0,13,33
50,Fail,49,26,0,14,35
50,Fail,56,17,2,14,42
50,Fail,46,35,0,9,37
50,Fail,44,26,11,12,32
50,Fail,48,23,4,12,36
50,Fail,40,34,4,12,28
50,Fail,41,41,0,11,30
50,Fail,49,28,0,7,42
50,Fail,53,18,10,12,41
50,Fail,50,21,4,16,34
50,Fail,42,39,0,14,28
50,Fail,48,22,3,13,35
50,Fail,49,22,0,16,33
50,Fail,41,28,7,13,28
50,Fail,52,22,3,10,42
50,Fail,46,25,7,14,32
50,Fail,49,27,1,10,39
50,Fail,52,22,5,15,37
50,Fail,51,28,0,11,40
50,Fail,50,32,0,11,39
50,Fail,47,28,0,14,33
50,Fail,46,32,0,14,32
50,Fail,46,22,1,15,31
50,Fail,57,19,0,12,45
50,Fail,40,32,2,17,23
50,Fail,47,28,0,12,35
50,Fail,50,28,0,12,38
50,Fail,46,20,8,16,30
50,Fail,53,22,2,13,40
50,Fail,47,22,6,14,33
50,Fail,51,32,0,7,44
50,Fail,44,36,6,8,36
50,Fail,43,31,4,13,30
50,Fail,46,29,0,13,33
50,Fail,45,25,1,16,29
50,Fail,48,30,0,12,36
50,Fail,44,29,4,13,31
50,Fail,50,28,0,9,41
50,Fail,50,25,4,11,39
50,Fail,43,32,0,18,25
50,Fail,45,26,1,16,29
50,Fail,41,24,4,20,21
50,Fail,50,24,2,12,38
50,Fail,49,27,2,12,37
50,Fail,50,24,1,11,39
50,Fail,46,35,0,10,36
50,Fail,43,27,6,18,25
50,Fail,43,33,0,14,29
50,Fail,42,34,2,9,33
50,Fail,54,23,5,8,46
50,Fail,47,30,1,11,36
50,Fail,47,28,0,12,35
50,Fail,50,18,6,16,34
50,Fail,41,29,11,14,27
50,Fail,41,27,7,14,27
50,Fail,54,24,0,10,44
50,Fail,44,33,0,13,31
50,Fail,41,26,12,11,30
50,Fail,57,24,0,12,45
50,Fail,40,37,0,13,27
50,Fail,53,18,4,13,40
50,Fail,50,31,0,12,38
50,Fail,47,31,0,10,37
50,Fail,47,21,7,16,31
50,Fail,48,32,1,10,38
50,Fail,44,23,0,21,23
50,Fail,48,23,2,16,32
50,Fail,52,21,5,9,43
50,Fail,43,30,4,13,30
50,Fail,41,29,9,13,28
50,Fail,45,32,0,16,29
50,Fail,57,19,0,12,45
50,Fail,50,30,0,9,41
50,Fail,46,31,0,9,37
50,Fail,54,18,3,10,44
50,Fail,45,28,4,14,31
50,Fail,53,19,4,9,44
50,Fail,59,20,1,12,47
50,Fail,50,30,0,8,42
50,Fail,48,29,0,13,35
50,Fail,44,29,0,19,25
50,Fail,53,28,6,6,47
50,Fail,45,29,0,14,31
50,Fail,55,24,0,12,43
50,Fail,52,26,2,10,42
50,Fail,57,21,0,9,48
50,Fail,47,27,3,13,34
50,Fail,41,28,16,10,31
50,Fail,49,28,0,11,38
50,Fail,47,28,3,10,37
50,Fail,49,24,4,15,34
50,Fail,52,23,0,14,38
50,Fail,49,28,0,16,33
50,Fail,44,30,0,12,32
50,Fail,48,28,0,15,33
50,Fail,45,31,7,11,34
50,Fail,46,22,10,10,36
50,Fail,55,25,0,10,45
50,Fail,41,33,0,14,27
50,Fail,51,28,0,11,40
50,Fail,49,31,2,9,40
50,Fail,54,25,0,11,43
50,Fail,46,30,0,8,38
50,Fail,48,23,0,17,31
50,Fail,48,31,0,14,34
50,Fail,50,30,0,11,39
50,Fail,60,22,0,11,49
50,Fail,51,23,0,13,38
50,Fail,50,24,0,11,39
50,Fail,47,25,3,14,33
50,Fail,50,23,3,11,39
50,Fail,51,25,0,11,40
50,Fail,53,20,0,12,41
50,Fail,46,28,0,15,31
50,Fail,53,29,0,4,49
50,Fail,58,19,1,10,48
50,Fail,48,26,8,9,39
50,Fail,34,36,8,11,23
50,Fail,44,33,0,15,29
50,Fail,53,22,1,14,39
50,Fail,49,27,2,14,35
50,Fail,53,29,2,5,48
50,Fail,41,25,5,15,26
50,Fail,49,22,0,15,34
50,Fail,52,21,0,14,38
50,Fail,44,32,0,12,32
50,Fail,41,32,8,11,30
50,Fail,49,30,0,12,37
50,Fail,49,26,0,11,38
50,Fail,47,20,4,19,28
50,Fail,45,32,0,11,34
50,Fail,48,22,11,11,37
50,Success,59,22,0,7,52
50,Fail,45,25,4,16,29
50,Fail,44,33,3,11,33
50,Fail,53,27,0,7,46
50,Fail,52,25,0,11,41
50,Fail,46,31,0,14,32
50,Fail,39,39,0,15,24
50,Fail,49,30,0,12,37
50,Fail,47,30,0,11,36
50,Fail,44,26,5,15,29
50,Fail,43,27,0,13,30
50,Fail,53,23,1,12,41
50,Fail,42,29,2,17,25
50,Fail,41,31,1,18,23
50,Fail,49,30,0,13,36
50,Fail,49,25,0,17,32
50,Fail,45,32,8,9,36
50,Fail,56,19,0,9,47
50,Fail,48,25,0,15,33
50,Fail,48,34,0,11,37
50,Fail,45,23,2,19,26
50,Fail,46,25,4,16,30
50,Fail,52,26,4,10,42
50,Fail,53,29,4,5,48
50,Fail,44,32,11,8,36
50,Fail,54,16,0,17,37
50,Fail,41,37,0,15,26
50,Fail,46,28,0,11,35
50,Fail,52,22,0,12,40
50,Fail,46,30,10,6,40
50,Fail,40,33,0,15,25
50,Fail,54,20,6,13,41
50,Fail,53,21,0,8,45
50,Fail,42,25,13,14,28
50,Fail,54,28,0,9,45
50,Fail,55,20,4,13,42
50,Fail,47,31,0,13,34
50,Fail,40,32,0,15,25
50,Fail,46,31,4,10,36
50,Fail,45,28,3,15,30
50,Fail,56,18,0,13,43
50,Fail,51,32,0,8,43
50,Fail,50,25,2,14,36
50,Fail,41,29,0,18,23
50,Fail,48,23,5,17,31
50,Fail,57,25,0,8,49
50,Fail,53,24,0,11,42
50,Fail,56,18,2,12,44
50,Fail,53,25,1,11,42
50,Fail,44,31,2,11,33
50,Fail,56,18,2,10,46
50,Fail,54,21,4,11,43
50,Fail,46,27,0,20,26
50,Fail,41,30,4,12,29
50,Fail,45,27,0,17,28
50,Fail,49,29,0,13,36
50,Fail,50,27,0,12,38
50,Fail,48,33,0,12,36
50,Fail,47,27,0,15,32
50,Fail,48,31,0,13,35
50,Fail,45,29,0,10,35
50,Fail,48,29,0,15,33
50,Fail,50,30,0,11,39
50,Fail,48,27,0,13,35
50,Fail,42,26,8,11,31
50,Fail,41,34,0,16,25
50,Fail,41,40,0,14,27
50,Fail,55,25,0,10,45
50,Fail,52,22,1,14,38
50,Fail,40,30,0,19,21
50,Fail,53,18,0,17,36
50,Fail,47,24,2,15,32
50,Fail,45,30,0,15,30
50,Fail,37,30,4,20,17
50,Fail,45,31,2,14,31
50,Fail,52,26,0,12,40
50,Fail,48,23,9,7,41
50,Fail,51,27,4,10,41
50,Fail,49,34,0,11,38
50,Fail,44,34,0,15,29
50,Fail,51,25,4,11,40
50,Fail,55,27,0,9,46
50,Fail,47,31,3,9,38
50,Fail,52,23,3,12,40
50,Fail,46,27,5,12,34
50,Fail,56,20,2,14,42
50,Fail,51,22,0,18,33
50,Fail,44,33,0,16,28
50,Fail,48,27,0,12,36
50,Fail,45,28,1,13,32
50,Fail,43,44,0,7,36
50,Fail,57,18,7,9,48
50,Fail,48,29,0,13,35
50,Fail,48,24,1,15,33
50,Fail,44,31,3,11,33
50,Fail,46,29,0,15,31
50,Fail,49,34,0,8,41
50,Fail,54,27,0,11,43
50,Fail,54,25,0,10,44
50,Fail,50,26,0,12,38
50,Success,61,21,0,5,56
50,Fail,51,20,0,13,38
50,Fail,56,22,0,10,46
50,Fail,51,22,4,15,36
50,Fail,54,19,2,12,42
50,Fail,43,30,2,16,27
50,Fail,50,22,3,16,34
50,Fail,45,31,6,8,37
50,Fail,55,25,0,13,42
50,Fail,44,38,0,9,35
50,Fail,52,23,1,13,39
50,Fail,51,20,1,18,33
50,Fail,48,29,3,13,35
50,Fail,50,29,5,9,41
50,Fail,36,33,4,15,21
50,Fail,45,26,2,16,29
50,Fail,54,25,0,11,43
50,Fail,44,32,0,14,30
50,Fail,48,27,1,11,37
50,Fail,50,28,0,14,36
50,Fail,47,34,0,8,39
50,Fail,50,21,0,13,37
50,Fail,46,32,0,13,33
50,Fail,46,30,0,11,35
50,Fail,52,29,0,6,46
50,Fail,44,23,8,19,25
50,Fail,47,26,1,14,33
50,Fail,43,30,1,15,28
50,Fail,49,21,3,15,34
50,Fail,51,30,0,9,42
50,Fail,49,28,0,13,36
50,Fail,49,32,0,10,39
50,Fail,47,25,0,17,30
50,Fail,53,23,4,7,46
50,Fail,50,18,6,12,38
50,Fail,49,16,7,19,30
50,Fail,45,33,0,15,30
50,Fail,41,25,8,17,24
50,Fail,49,25,0,11,38
50,Fail,51,28,0,12,39
50,Fail,47,20,3,15,32
50,Fail,40,32,5,14,26
50,Fail,42,30,12,11,31
50,Fail,39,32,0,18,21
50,Fail,48,25,3,12,36
50,Fail,44,28,0,13,31
50,Fail,47,23,5,14,33
50,Fail,49,32,0,11,38
50,Fail,48,27,0,16,32
50,Success,55,26,1,5,50
50,Fail,50,29,0,9,41
50,Fail,54,21,1,11,43
50,Fail,39,44,0,11,28
50,Fail,44,32,1,12,32
50,Fail,51,20,0,16,35
50,Fail,43,32,0,15,28
50,Fail,43,29,0,18,25
50,Fail,35,42,0,13,22
50,Fail,48,25,4,12,36
50,Fail,51,24,0,13,38
50,Fail,43,38,0,8,35
50,Fail,47,28,8,12,35
50,Fail,48,24,0,15,33
50,Fail,50,28,0,10,40
50,Fail,43,30,6,8,35
50,Fail,45,28,0,19,26
50,Fail,45,25,6,14,31
50,Fail,52,24,1,14,38
50,Fail,44,27,3,15,29
50,Fail,45,27,1,13,32
50,Fail,40,29,0,18,22
50,Fail,50,27,2,13,37
50,Fail,43,32,2,13,30
50,Fail,44,35,0,12,32
50,Fail,48,26,6,13,35
50,Fail,51,22,2,17,34
50,Fail,44,32,0,12,32
50,Fail,54,26,0,10,44
50,Fail,53,25,5,8,45
50,Fail,52,18,6,17,35
50,Fail,49,24,0,15,34
50,Fail,52,28,0,9,43
50,Fail,45,24,3,15,30
50,Fail,54,27,0,9,45
50,Fail,54,17,1,14,40
50,Fail,45,30,4,14,31
50,Fail,56,20,2,10,46
50,Fail,42,43,0,10,32
50,Fail,49,21,1,16,33
50,Fail,49,27,1,12,37
50,Fail,48,31,0,9,39
50,Fail,47,35,0,11,36
50,Fail,46,36,0,13,33
50,Fail,45,29,2,15,30
50,Fail,53,24,4,8,45
50,Fail,54,20,0,10,44
50,Fail,50,23,1,13,37
50,Fail,50,28,0,12,38
50,Fail,49,33,0,8,41
50,Fail,48,28,1,13,35
50,Fail,51,21,8,14,37
50,Fail,49,23,1,12,37
50,Fail,53,26,0,11,42
50,Fail,51,25,0,12,39
50,Fail,55,23,0,10,45
50,Fail,50,25,12,3,47
50,Fail,51,26,0,11,40
50,Fail,46,22,7,13,33
50,Fail,45,34,0,15,30
50,Fail,41,36,0,15,26
50,Fail,55,21,0,13,42
50,Fail,42,36,0,13,29
50,Fail,48,24,6,16,32
50,Success,59,22,2,9,50
50,Fail,38,32,10,13,25
50,Fail,42,29,4,17,25
50,Fail,40,31,7,11,29
50,Fail,54,24,0,10,44
50,Fail,43,32,3,12,31
50,Fail,57,24,0,10,47
50,Fail,42,31,0,15,27
50,Fail,49,34,0,11,38
50,Fail,52,25,1,11,41
50,Fail,51,20,3,14,37
50,Fail,51,24,1,14,37
50,Fail,49,31,0,14,35
50,Fail,51,24,0,15,36
50,Fail,49,22,0,17,32
50,Fail,53,17,3,13,40
50,Fail,42,32,8,10,32
50,Fail,49,30,0,10,39
50,Fail,54,24,0,15,39
50,Fail,44,33,0,11,33
50,Fail,43,33,0,11,32
50,Fail,49,25,0,12,37
50,Fail,40,34,1,12,28
50,Fail,52,22,2,12,40
50,Fail,37,34,0,15,22
50,Fail,50,29,0,12,38
50,Fail,52,28,0,6,46
50,Fail,51,21,8,10,41
50,Fail,53,19,3,12,41
50,Fail,50,30,0,11,39
50,Fail,51,25,10,12,39
50,Fail,53,24,0,12,41
50,Fail,45,34,0,12,33
50,Fail,48,27,1,13,35
50,Fail,54,28,2,8,46
50,Fail,48,17,5,18,30
50,Fail,31,44,0,18,13
50,Fail,56,22,0,8,48
50,Fail,36,29,9,16,20
50,Fail,42,28,4,16,26
50,Fail,49,24,9,6,43
50,Fail,52,30,0,10,42
50,Fail,40,43,0,10,30
50,Fail,50,28,0,7,43
50,Fail,47,28,3,15,32
50,Fail,49,21,8,12,37
50,Fail,40,28,0,17,23
50,Fail,46,23,9,15,31
50,Fail,51,23,0,12,39
50,Fail,45,34,0,14,31
50,Fail,52,25,0,9,43
50,Fail,44,31,0,17,27
50,Fail,46,31,0,14,32
50,Fail,47,28,4,10,37
50,Fail,45,39,0,7,38
50,Fail,55,23,0,12,43
50,Fail,48,28,2,15,33
50,Fail,56,21,0,8,48
50,Fail,50,30,0,11,39
50,Fail,57,20,0,8,49
50,Fail,50,28,0,10,40
50,Fail,48,29,0,11,37
50,Fail,53,20,0,15,38
50,Fail,46,23,9,13,33
50,Fail,50,29,0,12,38
50,Fail,50,29,0,7,43
50,Fail,51,24,1,12,39
50,Fail,45,22,7,16,29
50,Success,60,16,4,10,50
50,Fail,45,32,10,7,38
50,Fail,50,25,0,14,36
50,Fail,43,27,15,10,33
50,Fail,47,24,4,10,37
50,Fail,51,26,0,8,43
50,Fail,47,25,2,15,32
50,Fail,56,19,3,14,42
50,Fail,52,27,0,12,40
50,Fail,54,25,0,10,44
50,Fail,47,25,7,14,33
50,Fail,45,26,0,18,27
50,Fail,51,26,0,14,37
50,Fail,46,21,0,20,26
50,Fail,47,23,9,13,34
50,Fail,50,19,4,13,37
50,Fail,45,31,0,16,29
50,Fail,49,29,0,10,39
50,Fail,43,22,3,20,23
50,Fail,44,31,0,12,32
50,Fail,47,35,0,10,37
50,Fail,49,32,0,12,37
50,Fail,53,28,0,6,47
50,Fail,42,29,1,11,31
50,Fail,46,31,0,14,32
50,Fail,51,21,3,10,41
50,Fail,47,27,0,16,31
50,Fail,47,30,1,11,36
50,Fail,38,32,2,19,19
50,Fail,41,39,0,9,32
50,Fail,43,25,5,16,27
50,Fail,40,34,0,16,24
50,Fail,43,29,4,14,29
50,Fail,47,26,8,15,32
50,Fail,48,26,0,14,34
50,Fail,50,27,0,13,37
50,Fail,50,21,3,15,35
50,Fail,44,31,0,15,29
50,Fail,52,25,1,11,41
50,Fail,47,25,0,13,34
50,Fail,53,27,0,12,41
50,Fail,41,39,0,15,26
50,Fail,41,28,5,16,25
50,Fail,49,20,0,18,31
50,Fail,50,21,7,14,36
50,Fail,40,27,0,20,20
50,Fail,57,20,0,12,45
50,Fail,45,31,0,14,31
50,Fail,48,22,5,14,34
50,Fail,48,30,0,12,36
50,Fail,45,32,2,10,35
50,Fail,52,26,2,11,41
50,Fail,54,22,0,9,45
50,Fail,53,21,1,10,43
50,Fail,47,29,0,16,31
50,Fail,56,20,0,14,42
50,Fail,47,34,0,12,35
50,Fail,45,35,0,11,34
50,Fail,48,32,0,13,35
50,Fail,47,30,0,14,33
50,Fail,43,35,0,15,28
50,Fail,50,22,0,16,34
50,Fail,41,32,5,11,30
50,Fail,52,27,3,9,43
50,Fail,41,33,0,16,25
50,Fail,40,37,0,12,28
50,Fail,44,24,14,11,33
50,Fail,45,28,10,9,36
50,Fail,51,25,6,8,43
50,Fail,47,31,0,11,36
50,Fail,47,29,0,13,34
50,Fail,50,29,2,9,41
50,Fail,45,37,0,10,35
50,Fail,44,38,0,9,35
50,Fail,45,26,0,16,29
50,Fail,47,23,3,13,34
50,Fail,46,29,0,14,32
50,Fail,42,29,0,17,25
50,Fail,46,31,0,16,30
50,Fail,36,27,9,19,17
50,Fail,38,35,0,16,22
50,Fail,38,27,14,15,23
50,Fail,36,34,6,15,21
50,Fail,36,40,0,15,21
50,Fail,46,19,14,14,32
50,Fail,47,29,3,7,40
50,Fail,49,20,2,16,33
50,Fail,43,31,4,11,32
50,Fail,51,28,5,9,42
50,Fail,40,28,4,18,22
50,Fail,53,27,0,10,43
50,Fail,40,32,10,9,31
50,Fail,51,22,0,12,39
50,Fail,48,22,11,10,38
50,Fail,42,27,1,20,22
50,Fail,50,24,0,15,35
50,Fail,49,28,0,11,38
50,Fail,47,33,0,14,33
50,Fail,45,31,0,10,35
50,Fail,49,19,6,18,31
50,Fail,57,22,0,8,49
50,Fail,51,23,5,6,45
50,Fail,50,24,0,15,35
50,Fail,49,17,8,10,39
50,Fail,48,25,0,14,34
50,Fail,49,29,0,8,41
50,Fail,51,27,0,15,36
50,Fail,55,19,1,11,44
50,Fail,42,32,0,13,29
50,Fail,48,24,4,14,34
50,Fail,51,25,0,8,43
50,Fail,39,27,9,18,21
50,Fail,51,30,0,10,41
50,Fail,54,21,0,10,44
50,Fail,42,26,4,15,27
50,Fail,42,34,0,13,29
50,Fail,50,23,4,12,38
50,Fail,39,31,0,22,17
50,Fail,52,22,4,12,40
50,Fail,55,18,7,14,41
50,Fail,46,26,7,9,37
50,Fail,37,40,0,13,24
50,Fail,40,39,0,15,25
50,Fail,50,25,1,14,36
50,Fail,38,29,3,16,22
50,Fail,47,26,0,15,32
50,Fail,45,30,5,13,32
50,Fail,55,26,2,8,47
50,Fail,52,25,0,11,41
50,Fail,45,33,0,12,33
50,Fail,43,36,0,16,27
50,Fail,54,23,1,10,44
50,Fail,53,21,3,12,41
50,Fail,51,32,0,7,44
50,Fail,48,33,0,11,37
50,Fail,51,17,11,12,39
50,Fail,52,24,5,9,43
50,Fail,47,27,1,12,35
50,Fail,48,30,0,13,35
50,Fail,46,31,1,8,38
50,Fail,54,25,0,11,43
50,Fail,39,32,0,19,20
50,Fail,47,28,0,14,33
50,Fail,51,20,2,16,35
50,Fail,43,38,0,11,32
50,Fail,48,28,0,11,37
50,Fail,50,35,0,6,44
50,Fail,40,33,5,13,27
50,Fail,51,23,1,12,39
50,Fail,58,15,2,12,46
50,Fail,43,30,4,9,34
50,Fail,46,24,0,15,31
50,Fail,56,23,2,10,46
50,Fail,45,28,0,16,29
50,Fail,48,25,0,16,32
50,Fail,49,24,6,13,36
50,Fail,51,21,8,8,43
50,Fail,56,22,0,13,43
50,Fail,48,29,0,16,32
50,Fail,43,34,0,13,30
50,Fail,46,35,0,14,32
50,Fail,44,26,0,19,25
50,Fail,48,29,3,13,35
50,Fail,48,31,0,15,33
50,Fail,48,25,7,11,37
50,Fail,51,23,0,14,37
50,Fail,48,29,0,13,35
50,Fail,52,25,0,9,43
50,Fail,49,30,0,9,40
50,Fail,46,32,0,12,34
50,Success,60,19,1,9,51
50,Fail,44,23,0,24,20
50,Fail,46,26,0,18,28
50,Fail,52,23,4,11,41
50,Fail,47,24,5,12,35
50,Fail,49,28,3,12,37
50,Fail,49,16,11,17,32
50,Fail,46,29,0,17,29
50,Fail,35,41,0,15,20
50,Fail,48,30,0,13,35
50,Fail,39,28,3,16,23
50,Fail,46,31,1,10,36
50,Fail,45,35,0,14,31
50,Fail,46,25,3,9,37
50,Fail,48,19,11,15,33
50,Fail,53,26,0,11,42
50,Fail,47,30,0,13,34
50,Fail,53,19,3,15,38
50,Fail,44,28,0,17,27
50,Fail,49,25,6,11,38
50,Fail,44,25,0,15,29
50,Fail,55,25,1,8,47
50,Fail,50,24,0,14,36
50,Fail,54,26,0,11,43
50,Fail,48,28,1,10,38
50,Fail,43,26,0,17,26
50,Fail,47,22,0,18,29
50,Fail,50,20,0,18,32
50,Fail,47,23,0,18,29
50,Fail,48,31,0,9,39
50,Fail,51,21,10,9,42
50,Fail,46,22,4,19,27
50,Fail,50,26,0,13,37
50,Fail,42,35,0,16,26
50,Fail,49,33,0,11,38
50,Fail,52,28,1,7,45
50,Fail,50,27,0,15,35
50,Fail,47,23,1,16,31
50,Fail,50,20,4,14,36
50,Fail,42,29,0,17,25
50,Fail,45,22,6,19,26
50,Fail,44,31,0,14,30
50,Fail,49,34,0,13,36
50,Fail,51,21,6,10,41
50,Fail,48,25,2,13,35
50,Fail,48,27,6,11,37
50,Fail,48,23,0,15,33
50,Fail,50,21,2,12,38
50,Fail,45,24,1,19,26
50,Fail,44,23,7,17,27
50,Fail,51,21,3,13,38
50,Fail,47,26,1,18,29
50,Fail,48,31,0,9,39
50,Fail,53,22,4,11,42
50,Fail,52,19,0,16,36
50,Fail,40,31,8,11,29
50,Fail,50,29,0,12,38
50,Fail,54,26,0,8,46
50,Fail,50,26,0,12,38
50,Fail,48,31,0,13,35
50,Fail,45,31,0,13,32
50,Fail,47,31,0,11,36
50,Fail,39,43,0,8,31
50,Fail,51,22,4,9,42
50,Fail,45,30,4,11,34
50,Fail,49,22,3,14,35
50,Fail,51,31,0,6,45
50,Fail,45,21,3,16,29
50,Fail,52,22,7,11,41
50,Fail,50,24,9,13,37
50,Fail,49,22,8,12,37
50,Fail,41,33,0,16,25
50,Fail,51,27,0,11,40
50,Fail,39,43,0,11,28
50,Fail,53,19,0,13,40
50,Fail,50,22,2,15,35
50,Fail,48,24,4,15,33
50,Fail,49,23,2,14,35
50,Fail,48,24,0,17,31
50,Fail,45,32,0,11,34
50,Fail,48,31,0,13,35
50,Fail,45,27,0,19,26
50,Fail,47,34,0,10,37
50,Fail,38,37,0,13,25
50,Fail,47,26,4,15,32
50,Fail,50,24,0,13,37
50,Fail,50,31,0,13,37
50,Fail,51,21,0,15,36
50,Fail,46,27,1,16,30
50,Fail,46,26,0,18,28
50,Fail,48,26,0,16,32
50,Fail,49,28,3,10,39
50,Fail,45,35,0,7,38
50,Fail,52,20,0,18,34
50,Fail,50,21,4,14,36
50,Fail,56,28,0,8,48
50,Fail,57,27,0,10,47
50,Fail,39,38,0,12,27
50,Fail,44,36,0,12,32
50,Fail,50,24,4,9,41
50,Fail,40,35,0,13,27
50,Fail,54,16,0,18,36
50,Fail,53,23,0,12,41
50,Fail,49,24,0,17,32
50,Fail,50,21,0,18,32
50,Fail,49,23,3,12,37
50,Fail,53,26,0,9,44
50,Fail,42,25,5,19,23
50,Fail,53,24,4,5,48
50,Fail,44,40,0,11,33
50,Fail,49,21,10,11,38
50,Fail,48,22,0,17,31
50,Fail,46,27,3,14,32
50,Fail,46,29,0,12,34
50,Fail,54,25,0,13,41
50,Fail,46,29,0,12,34
50,Fail,52,24,0,13,39
50,Success,55,29,0,5,50
50,Fail,45,29,3,11,34
50,Fail,46,28,0,17,29
50,Fail,43,30,2,13,30
50,Fail,53,21,1,10,43
50,Fail,49,25,0,15,34
50,Fail,52,21,2,13,39
50,Fail,51,30,0,7,44
50,Fail,50,36,0,5,45
50,Fail,53,23,0,10,43
50,Fail,56,28,0,8,48
50,Fail,40,28,10,11,29
50,Fail,45,35,0,10,35
50,Fail,45,30,4,10,35
50,Fail,45,29,0,17,28
50,Fail,50,29,0,11,39
50,Fail,44,21,5,16,28
50,Fail,51,25,0,11,40
50,Fail,46,27,0,18,28
50,Fail,49,26,0,16,33
50,Fail,49,28,0,13,36
50,Fail,50,23,4,13,37
50,Fail,48,27,4,10,38
50,Fail,46,28,0,14,32
50,Fail,53,34,0,5,48
50,Fail,40,39,0,11,29
50,Fail,45,20,7,15,30
50,Fail,55,25,1,9,46
50,Fail,49,29,0,15,34
50,Fail,54,24,0,11,43
50,Fail,47,27,0,14,33
50,Fail,42,26,8,11,31
50,Fail,53,20,1,11,42
50,Fail,50,24,6,9,41
50,Fail,52,26,0,13,39
50,Fail,45,33,0,16,29
50,Fail,46,24,6,11,35
50,Success,60,21,3,6,54
50,Fail,42,35,3,11,31
50,Fail,45,25,6,12,33
50,Fail,45,29,4,13,32
50,Fail,51,25,3,10,41
50,Fail,53,22,3,14,39
50,Fail,50,30,1,8,42
50,Fail,44,24,3,14,30
50,Fail,46,24,9,14,32
50,Success,57,22,2,7,50
50,Fail,46,30,0,14,32
50,Fail,33,27,16,17,16
50,Fail,51,22,2,13,38
50,Fail,43,26,5,14,29
50,Fail,45,24,0,19,26
50,Fail,49,30,0,12,37
50,Fail,44,25,3,20,24
50,Fail,41,37,0,11,30
50,Fail,43,33,0,17,26
50,Fail,52,28,0,12,40
50,Fail,44,35,0,8,36
50,Fail,50,22,2,12,38
50,Fail,49,24,0,13,36
50,Fail,44,31,0,13,31
50,Fail,47,18,8,17,30
50,Fail,50,28,2,8,42
50,Fail,50,27,2,13,37
50,Fail,48,24,0,19,29
50,Fail,47,30,0,10,37
50,Fail,42,23,9,14,28
50,Fail,47,33,0,12,35
50,Fail,51,29,0,13,38
50,Fail,52,22,5,13,39
50,Fail,52,19,0,18,34
50,Fail,46,31,0,14,32
50,Fail,57,21,0,15,42
50,Fail,51,24,0,8,43
50,Fail,46,23,8,12,34
50,Fail,46,36,0,14,32
50,Fail,53,22,2,8,45
50,Fail,48,27,10,9,39
50,Fail,46,27,0,12,34
50,Fail,48,30,0,10,38
50,Fail,52,22,2,8,44
50,Fail,46,29,3,14,32
50,Fail,50,22,0,15,35
50,Fail,43,31,7,10,33
50,Fail,49,30,0,11,38
50,Fail,54,21,0,15,39
50,Fail,48,29,0,10,38
50,Fail,41,42,0,5,36
50,Fail,51,25,0,12,39
50,Fail,49,23,11,10,39
50,Fail,47,20,5,14,33
50,Fail,49,25,3,13,36
50,Fail,51,28,0,11,40
50,Fail,52,21,0,13,39
50,Fail,51,27,0,11,40
50,Fail,44,35,3,10,34
50,Fail,49,24,1,12,37
50,Fail,41,29,2,17,24
50,Fail,38,33,5,14,24
50,Fail,51,23,5,12,39
50,Fail,45,27,8,11,34
50,Fail,53,21,1,14,39
50,Fail,52,19,4,10,42
50,Fail,45,30,7,7,38
50,Fail,50,28,5,8,42
50,Fail,48,25,0,15,33
50,Fail,54,15,7,10,44
50,Fail,44,24,4,18,26
50,Fail,51,22,5,11,40
50,Fail,41,33,0,16,25
50,Fail,48,20,3,15,33
50,Fail,50,21,3,15,35
50,Fail,51,22,0,12,39
50,Fail,38,37,0,15,23
50,Fail,43,32,6,9,34
50,Fail,44,37,0,13,31
50,Fail,45,27,5,10,35
50,Fail,48,28,0,11,37
50,Fail,47,25,1,16,31
50,Fail,56,16,2,17,39
50,Fail,48,19,4,14,34
50,Fail,47,21,9,16,31
50,Fail,48,26,3,14,34
50,Fail,36,27,6,22,14
50,Fail,43,26,10,12,31
50,Fail,52,18,9,12,40
50,Fail,53,23,6,8,45
50,Fail,46,26,1,18,28
50,Fail,47,25,9,8,39
50,Fail,51,32,0,10,41
50,Fail,47,28,1,9,38
50,Fail,46,39,0,7,39
50,Fail,45,29,0,14,31
50,Fail,49,24,3,10,39
50,Fail,55,28,1,9,46
50,Fail,53,26,1,11,42
50,Fail,41,28,7,15,26
50,Fail,50,16,4,18,32
50,Fail,52,26,0,13,39
50,Fail,41,29,4,15,26
50,Fail,51,24,7,11,40
50,Fail,45,31,0,11,34
50,Fail,42,30,0,13,29
50,Fail,43,32,0,14,29
50,Fail,50,30,0,9,41
50,Fail,55,23,0,7,48
50,Fail,34,41,0,12,22
50,Fail,48,25,6,12,36
50,Fail,49,22,0,17,32
50,Fail,50,21,0,20,30
50,Fail,50,23,0,14,36
50,Fail,44,30,2,13,31
50,Fail,48,27,0,16,32
50,Fail,43,23,7,17,26
50,Fail,47,26,15,8,39
50,Fail,45,28,3,12,33
50,Fail,47,25,0,15,32
50,Fail,50,23,4,12,38
50,Fail,49,25,0,18,31
50,Fail,48,28,0,13,35
50,Fail,38,34,5,16,22
50,Fail,48,25,0,17,31
50,Fail,48,28,0,13,35
50,Fail,45,36,0,14,31
50,Fail,46,26,0,14,32
50,Fail,41,35,0,12,29
50,Fail,55,24,0,9,46
50,Fail,39,29,3,21,18
50,Fail,47,33,0,7,40
50,Fail,47,29,1,9,38
50,Fail,43,31,0,17,26
50,Fail,51,17,11,10,41
50,Fail,49,33,0,10,39
50,Fail,49,31,2,6,43
50,Success,59,26,0,6,53
50,Fail,56,22,3,8,48
50,Fail,49,19,10,14,35
50,Fail,47,30,0,11,36
50,Fail,44,31,0,12,32
50,Fail,45,25,0,16,29
50,Fail,49,27,0,14,35
50,Fail,55,19,5,13,42
50,Fail,48,27,0,13,35
50,Fail,50,27,0,11,39
50,Fail,47,23,4,14,33
50,Fail,44,31,0,13,31
50,Fail,52,27,0,8,44
50,Fail,49,16,13,13,36
50,Fail,43,33,0,14,29
50,Fail,51,28,3,9,42
50,Fail,49,28,0,11,38
50,Fail,44,31,0,12,32
50,Fail,48,29,0,14,34
50,Fail,48,27,5,12,36
50,Fail,48,32,0,10,38
50,Fail,56,18,0,13,43
50,Fail,51,24,10,9,42
50,Fail,51,31,0,10,41
50,Fail,55,26,0,11,44
50,Fail,39,35,0,18,21
50,Fail,59,17,1,11,48
50,Fail,55,16,8,12,43
50,Fail,48,27,0,13,35
50,Fail,47,24,0,15,32
50,Fail,51,27,4,9,42
50,Fail,49,25,0,15,34
50,Fail,50,28,2,6,44
50,Fail,43,28,5,18,25
50,Fail,54,17,2,16,38
50,Fail,47,23,7,13,34
50,Fail,49,22,3,18,31
50,Fail,48,23,0,15,33
50,Fail,42,28,3,17,25
50,Fail,47,22,8,15,32
50,Fail,51,26,5,7,44
50,Fail,43,36,0,12,31
50,Fail,47,29,2,10,37
50,Fail,47,26,0,14,33
50,Fail,49,27,0,11,38
50,Fail,52,25,0,10,42
50,Fail,50,25,0,15,35
50,Fail,42,29,1,14,28
50,Fail,46,32,0,13,33
50,Fail,54,24,6,5,49
50,Fail,51,23,3,13,38
50,Fail,50,29,0,11,39
50,Fail,51,23,5,10,41
50,Fail,48,23,6,13,35
50,Fail,49,27,0,11,38
50,Fail,49,28,2,9,40
50,Fail,50,18,3,14,36
50,Fail,47,28,0,10,37
50,Fail,50,28,0,12,38
50,Fail,55,24,1,10,45
50,Fail,50,31,0,9,41
50,Fail,47,35,0,12,35
50,Fail,45,30,1,11,34
50,Fail,42,28,1,17,25
50,Fail,46,25,5,14,32
50,Fail,49,29,0,9,40
50,Fail,47,33,0,11,36
50,Fail,45,19,10,17,28
50,Fail,43,28,1,14,29
50,Fail,48,25,7,11,37
50,Fail,56,26,0,12,44
50,Fail,53,21,3,11,42
50,Fail,56,14,0,13,43
50,Fail,41,32,0,17,24
50,Fail,57,19,0,16,41
50,Fail,42,26,11,15,27
50,Fail,46,26,0,18,28
50,Fail,50,28,0,10,40
50,Fail,50,27,6,6,44
50,Fail,46,33,0,12,34
50,Fail,51,28,0,10,41
50,Fail,43,24,5,17,26
50,Fail,45,32,0,14,31
50,Fail,47,24,7,11,36
50,Fail,48,29,0,12,36
50,Fail,48,18,0,22,26
50,Fail,46,19,11,12,34
50,Fail,39,30,0,17,22
50,Fail,53,23,1,9,44
50,Fail,46,36,0,11,35
50,Fail,55,23,2,11,44
50,Fail,40,36,5,8,32
50,Fail,52,26,0,12,40
50,Fail,53,22,0,11,42
50,Fail,51,26,0,13,38
50,Fail,46,23,1,19,27
50,Fail,48,27,9,13,35
50,Fail,49,26,0,11,38
50,Fail,49,31,0,11,38
50,Fail,49,28,0,10,39
50,Fail,50,25,1,13,37
50,Fail,40,26,10,16,24
50,Fail,44,26,3,16,28
50,Fail,42,34,0,12,30
50,Fail,56,19,0,11,45
50,Fail,49,25,0,14,35
50,Fail,49,28,5,7,42
50,Fail,44,22,8,19,25
50,Fail,45,32,0,13,32
50,Fail,52,18,4,14,38
50,Fail,52,24,0,15,37
50,Fail,51,21,0,13,38
50,Fail,48,30,0,14,34
50,Fail,48,28,0,11,37
50,Fail,43,34,0,13,30
50,Fail,58,16,1,10,48
50,Fail,50,23,3,14,36
50,Fail,50,31,2,8,42
50,Success,57,27,0,6,51
50,Fail,48,28,0,11,37
50,Fail,41,31,8,12,29
50,Fail,43,33,0,15,28
50,Fail,44,23,8,14,30
50,Fail,45,27,8,14,31
50,Fail,48,26,2,15,33
50,Fail,59,15,4,10,49
50,Fail,45,28,9,10,35
50,Fail,47,32,3,10,37
50,Fail,46,28,0,15,31
50,Fail,39,34,0,16,23
50,Fail,43,36,0,14,29
50,Fail,49,33,0,9,40
50,Fail,50,21,1,12,38
50,Fail,48,25,5,13,35
50,Fail,45,30,5,9,36
50,Fail,46,23,9,12,34
50,Fail,48,31,0,11,37
50,Fail,44,28,6,10,34
50,Fail,47,29,0,12,35
50,Fail,42,31,0,16,26
50,Fail,55,26,4,7,48
50,Fail,46,33,0,12,34
50,Fail,52,22,4,12,40
50,Fail,53,21,8,12,41
50,Fail,50,27,0,11,39
50,Fail,47,30,0,15,32
50,Fail,56,22,1,12,44
50,Fail,54,19,4,9,45
50,Fail,49,29,0,10,39
50,Fail,42,26,2,19,23
50,Fail,44,24,7,13,31
50,Fail,42,32,0,14,28
50,Fail,44,31,0,14,30
50,Fail,49,29,1,13,36
50,Fail,44,22,10,13,31
50,Fail,49,33,0,10,39
50,Fail,53,22,0,10,43
50,Fail,48,25,5,12,36
50,Fail,45,28,0,18,27
50,Fail,43,27,4,18,25
50,Fail,46,20,4,17,29
50,Fail,51,22,0,17,34
50,Fail,41,32,1,13,28
50,Success,59,21,5,8,51
50,Fail,47,24,0,16,31
50,Fail,44,31,5,10,34
50,Fail,48,30,5,11,37
50,Fail,45,31,4,13,32
50,Fail,41,45,0,10,31
50,Fail,47,30,3,6,41
50,Fail,46,29,0,14,32
50,Fail,49,24,7,10,39
50,Fail,47,27,6,10,37
50,Fail,41,43,0,11,30
50,Fail,37,42,0,14,23
50,Fail,56,23,0,7,49
50,Fail,49,31,3,6,43
50,Fail,48,24,0,17,31
50,Fail,60,16,0,11,49
50,Fail,49,20,4,13,36
50,Fail,51,23,6,12,39
50,Fail,42,35,0,14,28
50,Fail,46,34,0,13,33
50,Fail,46,33,0,11,35
50,Fail,42,28,0,14,28
50,Fail,50,20,0,12,38
50,Fail,45,20,7,15,30
50,Fail,48,25,0,16,32
50,Fail,47,31,0,12,35
50,Fail,48,28,3,9,39
50,Fail,41,28,3,13,28
50,Fail,51,26,0,11,40
50,Fail,49,30,0,9,40
50,Fail,49,30,0,12,37
50,Fail,53,28,0,10,43
50,Fail,43,33,0,17,26
50,Fail,53,27,0,10,43
50,Fail,40,39,0,13,27
50,Fail,52,24,0,11,41
50,Fail,48,28,0,13,35
50,Fail,49,27,0,12,37
50,Fail,53,24,1,11,42
50,Fail,51,26,0,13,38
50,Fail,50,26,3,10,40
50,Fail,51,26,0,11,40
50,Fail,47,25,0,13,34
50,Fail,47,27,0,13,34
50,Fail,54,20,0,15,39
50,Fail,48,23,2,19,29
50,Fail,44,22,0,19,25
50,Fail,47,30,4,10,37
50,Fail,42,27,1,21,21
50,Fail,42,30,0,21,21
50,Fail,45,28,5,13,32
50,Fail,52,24,3,12,40
50,Fail,44,28,15,8,36
50,Fail,39,32,0,13,26
50,Fail,44,25,0,17,27
50,Fail,47,28,0,8,39
50,Fail,42,41,0,11,31
50,Fail,53,31,0,10,43
50,Fail,47,33,0,9,38
50,Fail,47,29,9,8,39
50,Fail,51,31,0,10,41
50,Fail,43,29,4,11,32
50,Fail,50,30,0,14,36
50,Fail,44,29,4,11,33
50,Fail,53,23,0,12,41
50,Fail,46,33,0,11,35
50,Fail,41,26,3,18,23
50,Fail,50,19,0,16,34
50,Fail,50,30,0,12,38
50,Fail,50,29,0,13,37
50,Fail,51,24,2,9,42
50,Fail,52,27,1,11,41
50,Fail,45,28,9,12,33
50,Fail,53,19,0,12,41
50,Fail,46,29,0,13,33
50,Fail,50,29,0,5,45
50,Fail,53,24,0,8,45
50,Fail,51,35,0,9,42
50,Fail,43,32,3,11,32
50,Fail,44,21,5,17,27
50,Fail,50,30,0,7,43
50,Fail,51,27,0,9,42
50,Fail,51,30,0,5,46
50,Fail,57,18,1,11,46
50,Fail,47,35,0,12,35
50,Fail,47,26,3,14,33
50,Fail,47,29,7,9,38
50,Fail,52,27,1,12,40
50,Fail,54,24,0,11,43
50,Fail,54,20,0,15,39
50,Fail,46,32,0,16,30
50,Fail,43,29,5,15,28
50,Fail,44,35,0,12,32
50,Fail,55,22,0,8,47
50,Fail,52,22,0,14,38
50,Fail,42,24,7,20,22
50,Fail,46,25,10,8,38
50,Fail,47,30,0,15,32
50,Fail,54,28,0,6,48
50,Fail,43,33,7,11,32
50,Fail,47,35,0,8,39
50,Fail,47,28,1,12,35
50,Fail,48,29,0,15,33
50,Success,62,20,0,9,53
50,Fail,43,32,3,10,33
50,Fail,45,22,7,17,28
50,Success,60,17,8,8,52
50,Fail,49,22,5,16,33
50,Fail,47,29,4,6,41
50,Fail,51,26,6,6,45
50,Fail,54,19,0,15,39
50,Fail,50,32,0,10,40
50,Fail,44,22,6,17,27
50,Fail,45,36,0,9,36
50,Fail,51,31,0,8,43
50,Fail,53,18,1,14,39
50,Fail,47,31,0,10,37
50,Fail,47,27,5,9,38
50,Fail,45,25,10,8,37
50,Fail,47,23,3,17,30
50,Fail,44,25,0,21,23
50,Fail,52,27,0,11,41
50,Fail,46,27,5,15,31
50,Fail,50,17,5,15,35
50,Fail,45,24,5,16,29
50,Fail,47,26,4,14,33
50,Fail,42,24,14,14,28
50,Fail,50,28,0,13,37
50,Success,55,26,1,5,50
50,Fail,46,29,0,12,34
50,Fail,47,18,7,16,31
50,Fail,42,26,2,17,25
50,Fail,50,26,0,14,36
50,Fail,46,35,0,10,36
50,Fail,51,31,0,10,41
50,Fail,51,24,1,12,39
50,Fail,48,30,1,9,39
50,Fail,49,24,0,14,35
50,Fail,41,37,0,13,28
50,Fail,45,24,4,14,31
50,Fail,54,21,0,12,42
50,Fail,43,30,0,17,26
50,Fail,45,31,0,16,29
50,Fail,55,27,0,6,49
50,Fail,49,28,0,15,34
50,Fail,43,33,0,14,29
50,Fail,45,33,3,9,36
50,Fail,48,30,0,9,39
50,Fail,53,28,0,9,44
50,Fail,53,21,0,10,43
50,Fail,43,32,4,10,33
50,Fail,49,22,10,10,39
50,Fail,50,19,5,15,35
50,Fail,56,19,3,14,42
50,Fail,48,31,1,9,39
50,Fail,48,28,0,13,35
50,Fail,50,24,0,15,35
50,Fail,44,29,0,13,31
50,Fail,49,30,3,7,42
50,Fail,47,34,0,9,38
50,Fail,43,32,0,13,30
50,Fail,44,25,8,14,30
50,Fail,51,26,0,15,36
50,Fail,35,40,0,16,19
50,Fail,51,23,6,11,40
50,Fail,49,23,0,16,33
50,Fail,52,26,0,12,40
50,Fail,50,23,3,13,37
50,Fail,43,30,9,7,36
50,Fail,48,27,0,12,36
50,Fail,45,35,0,9,36
50,Fail,45,32,0,13,32
50,Fail,47,27,1,14,33
50,Fail,39,37,9,9,30
50,Fail,46,29,3,12,34
50,Fail,50,31,2,5,45
50,Fail,45,30,14,8,37
50,Fail,51,28,2,12,39
50,Fail,52,25,2,14,38
50,Fail,46,37,0,12,34
50,Fail,49,22,4,11,38
50,Fail,46,32,0,12,34
50,Fail,48,23,8,11,37
50,Fail,45,23,0,17,28
50,Fail,49,29,1,8,41
50,Fail,46,28,2,11,35
50,Fail,53,25,0,11,42
50,Fail,43,35,0,13,30
50,Fail,48,28,0,14,34
50,Fail,54,24,0,14,40
50,Fail,49,24,3,10,39
50,Fail,49,24,7,12,37
50,Fail,39,37,1,11,28
50,Fail,45,26,7,11,34
50,Fail,45,26,1,14,31
50,Fail,49,30,0,11,38
50,Fail,46,30,0,13,33
50,Fail,48,24,0,14,34
50,Fail,44,28,0,13,31
50,Fail,43,33,7,8,35
50,Fail,53,23,6,9,44
50,Fail,40,30,5,14,26
50,Fail,46,22,2,24,22
50,Fail,37,36,5,13,24
50,Fail,44,23,14,14,30
50,Fail,54,29,0,8,46
50,Fail,48,20,0,19,29
50,Fail,39,28,8,20,19
50,Fail,50,27,0,12,38
50,Fail,41,29,5,12,29
50,Fail,46,32,0,12,34
50,Fail,43,26,1,17,26
50,Fail,46,24,3,15,31
50,Fail,54,26,0,6,48
50,Fail,48,27,3,14,34
50,Fail,44,34,0,11,33
50,Fail,51,32,0,10,41
50,Fail,48,32,0,9,39
50,Fail,47,29,0,10,37
50,Fail,52,23,3,9,43
50,Fail,43,22,4,21,22
50,Fail,47,25,2,16,31
50,Fail,42,39,0,9,33
50,Fail,52,18,4,14,38
50,Fail,43,28,0,16,27
50,Fail,42,24,3,19,23
50,Fail,46,31,2,10,36
50,Fail,48,33,0,11,37
50,Fail,44,21,10,14,30
50,Fail,46,27,4,15,31
50,Fail,45,30,0,16,29
50,Fail,54,20,0,13,41
50,Fail,50,29,0,10,40
50,Fail,49,29,0,13,36
50,Fail,46,20,11,13,33
50,Fail,52,26,0,12,40
50,Fail,46,23,8,11,35
50,Fail,40,28,5,16,24
50,Fail,48,35,0,11,37
50,Fail,57,24,4,9,48
50,Success,57,24,0,7,50
50,Fail,50,30,0,11,39
50,Fail,44,30,3,13,31
50,Fail,45,24,4,15,30
50,Fail,51,25,4,13,38
50,Fail,45,32,0,11,34
50,Fail,47,26,0,17,30
50,Fail,45,33,0,11,34
50,Fail,42,29,11,12,30
50,Fail,48,26,3,15,33
50,Fail,45,24,0,18,27
50,Fail,47,33,0,10,37
50,Fail,48,23,4,10,38
50,Fail,49,26,1,9,40
50,Fail,45,28,3,13,32
50,Fail,47,27,7,10,37
50,Fail,48,32,0,9,39
50,Fail,53,27,0,9,44
50,Fail,54,25,2,9,45
50,Fail,49,31,0,10,39
50,Fail,43,36,0,10,33
50,Fail,54,21,0,12,42
50,Fail,52,22,1,10,42
50,Fail,44,28,10,11,33
50,Fail,45,24,5,17,28
50,Success,59,19,6,5,54
50,Fail,45,31,0,15,30
50,Fail,53,24,5,10,43
50,Fail,46,32,0,15,31
50,Fail,49,30,0,10,39
50,Fail,49,23,1,16,33
50,Fail,46,30,2,7,39
50,Fail,51,30,0,8,43
50,Fail,47,26,1,15,32
50,Fail,47,23,0,16,31
50,Fail,48,30,0,11,37
50,Fail,50,24,1,13,37
50,Fail,52,24,0,14,38
50,Fail,42,35,0,13,29
50,Fail,51,26,0,15,36
50,Fail,49,25,0,14,35
50,Fail,47,27,0,12,35
50,Fail,45,35,0,12,33
50,Fail,49,29,0,12,37
50,Fail,53,17,1,11,42
50,Fail,46,26,3,16,30
50,Fail,53,20,0,15,38
50,Fail,51,27,5,6,45
50,Fail,47,26,8,9,38
50,Fail,43,32,3,13,30
50,Fail,48,27,0,14,34
50,Fail,51,21,0,18,33
50,Fail,48,24,6,15,33
50,Fail,52,25,1,10,42
50,Fail,47,32,0,12,35
50,Fail,41,30,0,15,26
50,Fail,58,23,0,9,49
50,Fail,49,20,5,13,36
50,Fail,50,20,5,13,37
50,Fail,45,23,3,17,28
50,Fail,43,25,2,19,24
50,Fail,48,33,0,11,37
50,Fail,45,35,2,10,35
50,Fail,51,24,0,13,38
50,Fail,51,22,5,11,40
50,Fail,48,27,6,8,40
50,Fail,38,41,0,13,25
50,Fail,49,24,7,15,34
50,Fail,49,26,5,12,37
50,Fail,52,24,5,8,44
50,Fail,44,32,0,15,29
50,Fail,52,25,0,9,43
50,Fail,48,28,0,12,36
50,Fail,51,22,4,14,37
50,Fail,47,28,0,13,34
50,Fail,47,27,0,12,35
50,Fail,46,29,0,14,32
50,Fail,50,25,2,13,37
50,Fail,50,29,1,11,39
50,Fail,48,28,0,14,34
50,Fail,49,30,0,10,39
50,Fail,41,27,8,13,28
50,Fail,46,25,4,10,36
50,Fail,47,25,0,14,33
50,Fail,55,19,2,12,43
50,Fail,51,25,2,11,40
50,Fail,52,21,11,10,42
50,Fail,50,21,2,12,38
50,Fail,40,28,9,18,22
50,Fail,51,27,0,10,41
50,Fail,42,30,0,16,26
50,Fail,54,18,5,12,42
50,Fail,51,21,0,16,35
50,Fail,52,20,8,11,41
50,Fail,41,31,5,15,26
50,Fail,51,25,0,12,39
50,Fail,37,31,13,12,25
50,Fail,52,29,0,7,45
50,Fail,45,19,3,17,28
50,Fail,50,23,3,14,36
50,Fail,48,29,0,13,35
50,Fail,55,23,3,6,49
50,Fail,43,28,2,16,27
50,Fail,52,22,3,12,40
50,Fail,56,17,0,11,45
50,Fail,50,19,0,19,31
50,Fail,53,27,0,9,44
50,Fail,50,21,0,17,33
50,Fail,40,32,3,15,25
50,Fail,45,27,1,13,32
50,Fail,55,24,0,11,44
50,Fail,45,27,0,13,32
50,Fail,45,21,8,16,29
50,Fail,43,25,0,21,22
50,Fail,49,32,1,8,41
50,Fail,46,22,3,18,28
50,Fail,42,34,0,16,26
50,Fail,52,20,4,11,41
50,Fail,44,33,0,15,29
50,Fail,54,22,0,12,42
50,Fail,47,29,5,7,40
50,Fail,55,20,5,10,45
50,Fail,52,25,0,10,42
50,Fail,49,30,0,15,34
50,Fail,52,20,0,15,37
50,Fail,49,23,2,15,34
50,Fail,50,23,5,15,35
50,Fail,53,25,0,10,43
50,Fail,45,24,1,14,31
50,Fail,44,31,0,13,31
50,Fail,49,24,3,16,33
50,Fail,53,23,0,12,41
50,Fail,55,24,3,9,46
50,Fail,48,30,1,11,37
50,Fail,49,27,0,11,38
50,Fail,49,29,0,11,38
50,Fail,46,34,0,13,33
50,Fail,50,26,5,10,40
50,Fail,48,25,1,14,34
50,Fail,47,23,4,15,32
50,Fail,51,31,0,9,42
50,Fail,47,31,4,11,36
50,Fail,48,19,10,15,33
50,Fail,48,25,8,13,35
50,Fail,42,34,0,12,30
50,Fail,50,29,4,6,44
50,Fail,55,17,2,15,40
50,Fail,47,19,5,17,30
50,Fail,44,22,5,19,25
50,Fail,50,30,0,11,39
50,Fail,45,46,0,5,40
50,Fail,37,44,0,8,29
50,Fail,45,42,0,7,38
50,Fail,48,26,1,13,35
50,Fail,43,28,0,17,26
50,Fail,54,28,0,9,45
50,Fail,55,21,0,10,45
50,Fail,48,22,3,14,34
50,Fail,44,36,0,13,31
50,Fail,52,26,0,11,41
50,Fail,42,31,0,22,20
50,Fail,51,21,0,15,36
50,Fail,47,26,4,12,35
50,Fail,47,25,8,9,38
50,Fail,52,19,0,13,39
50,Fail,44,32,0,13,31
50,Fail,50,26,0,10,40
50,Fail,54,24,0,9,45
50,Fail,52,25,4,8,44
50,Fail,48,26,2,15,33
50,Fail,49,24,6,8,41
50,Fail,50,32,0,6,44
50,Fail,54,24,0,11,43
50,Fail,51,27,3,10,41
50,Fail,48,20,1,19,29
50,Fail,45,30,0,14,31
50,Fail,49,28,0,14,35
50,Fail,49,31,0,12,37
50,Fail,49,21,0,17,32
50,Fail,53,27,0,11,42
50,Fail,47,30,0,13,34
50,Fail,46,20,9,19,27
50,Fail,47,18,7,18,29
50,Fail,45,35,0,13,32
50,Fail,47,26,7,9,38
50,Fail,46,30,2,10,36
50,Fail,51,20,0,18,33
50,Fail,53,27,0,9,44
50,Fail,50,24,0,13,37
50,Fail,47,28,0,11,36
50,Fail,45,34,0,12,33
50,Fail,49,31,0,11,38
50,Fail,52,28,0,12,40
50,Fail,50,24,1,14,36
50,Fail,50,22,1,16,34
50,Fail,55,20,6,9,46
50,Fail,52,26,0,12,40
50,Fail,49,30,0,9,40
50,Fail,49,36,0,6,43
50,Fail,51,23,6,13,38
50,Fail,44,31,0,14,30
50,Fail,45,23,11,18,27
50,Fail,51,21,3,15,36
50,Fail,53,22,2,13,40
50,Fail,40,40,0,12,28
50,Fail,55,23,0,12,43
50,Fail,47,29,0,15,32
50,Fail,51,21,5,12,39
50,Fail,49,21,7,14,35
50,Fail,45,25,4,14,31
50,Fail,49,31,0,9,40
50,Fail,48,34,0,9,39
50,Fail,47,26,2,16,31
50,Fail,46,32,0,12,34
50,Fail,44,27,11,13,31
50,Fail,49,21,1,19,30
50,Fail,50,23,0,14,36
50,Fail,53,25,0,8,45
50,Fail,49,24,0,14,35
50,Fail,46,25,2,18,28
50,Fail,48,28,6,10,38
50,Fail,48,23,0,13,35
50,Fail,54,25,5,13,41
50,Fail,45,37,0,11,34
50,Fail,43,30,0,17,26
50,Fail,57,20,0,13,44
50,Fail,46,27,0,15,31
50,Fail,52,25,0,12,40
50,Fail,47,30,0,10,37
50,Fail,49,24,0,14,35
50,Fail,51,25,0,11,40
50,Fail,41,34,0,17,24
50,Fail,50,18,7,16,34
50,Fail,53,29,0,10,43
50,Fail,44,24,1,18,26
50,Fail,43,29,0,17,26
50,Fail,47,25,4,12,35
50,Fail,48,26,1,13,35
50,Fail,49,26,2,11,38
50,Fail,45,23,8,13,32
50,Fail,53,33,0,8,45
50,Fail,42,30,0,18,24
50,Fail,41,36,0,18,23
50,Fail,36,41,0,15,21
50,Fail,39,32,0,20,19
50,Fail,51,28,0,13,38
50,Fail,39,27,6,18,21
50,Fail,52,25,0,13,39
50,Fail,54,23,2,8,46
50,Fail,45,31,4,9,36
50,Fail,51,19,0,17,34
50,Fail,43,38,0,12,31
50,Fail,38,44,0,13,25
50,Fail,42,29,4,15,27
50,Fail,55,25,0,9,46
50,Fail,47,36,0,9,38
50,Fail,40,38,0,12,28
50,Fail,47,27,1,10,37
50,Fail,54,26,1,9,45
50,Fail,51,21,0,13,38
50,Fail,49,23,0,16,33
50,Fail,50,28,0,10,40
50,Fail,51,25,0,13,38
50,Fail,42,37,0,13,29
50,Fail,49,24,3,12,37
50,Fail,47,28,3,13,34
50,Fail,45,26,4,15,30
50,Fail,45,31,0,13,32
50,Fail,53,24,0,11,42
50,Fail,43,31,8,10,33
50,Fail,53,22,1,13,40
50,Fail,47,23,0,17,30
50,Fail,48,20,8,13,35
50,Fail,45,32,0,11,34
50,Fail,49,22,3,16,33
50,Fail,39,37,0,10,29
50,Fail,49,23,0,14,35
50,Fail,47,26,5,8,39
50,Fail,49,28,0,13,36
50,Success,59,19,2,9,50
50,Fail,51,25,0,13,38
50,Fail,43,30,0,16,27
50,Fail,42,29,3,15,27
50,Fail,56,18,1,11,45
50,Fail,47,23,2,19,28
50,Fail,45,29,0,13,32
50,Fail,46,26,5,16,30
50,Fail,46,28,0,15,31
50,Fail,50,31,0,10,40
50,Fail,45,23,4,17,28
50,Fail,47,24,6,10,37
50,Fail,52,33,0,5,47
50,Fail,49,25,3,11,38
50,Fail,53,25,0,14,39
50,Fail,56,21,1,12,44
50,Fail,41,33,0,20,21
50,Fail,49,28,0,11,38
50,Fail,54,22,3,14,40
50,Fail,51,21,1,14,37
50,Fail,57,24,1,8,49
50,Fail,52,28,1,9,43
50,Fail,48,25,2,15,33
50,Fail,45,23,2,17,28
50,Fail,45,25,2,15,30
50,Fail,51,28,0,12,39
50,Fail,42,29,5,19,23
50,Fail,47,22,5,20,27
50,Fail,41,30,2,17,24
50,Fail,44,24,5,18,26
50,Fail,37,45,0,7,30
50,Fail,46,29,2,13,33
50,Fail,43,21,5,21,22
50,Fail,50,18,2,15,35
50,Fail,48,30,2,12,36
50,Fail,47,35,0,9,38
50,Fail,47,23,9,12,35
50,Fail,47,31,0,13,34
50,Fail,59,15,0,15,44
50,Fail,43,31,5,10,33
50,Fail,46,27,5,12,34
50,Fail,50,23,5,12,38
50,Fail,45,26,2,18,27
50,Fail,49,33,0,9,40
50,Fail,55,19,7,7,48
50,Fail,38,28,1,20,18
50,Fail,43,29,0,18,25
50,Fail,49,32,0,11,38
50,Fail,50,33,0,10,40
50,Fail,44,27,4,16,28
50,Fail,49,29,0,10,39
50,Fail,50,27,0,12,38
50,Fail,51,19,2,13,38
50,Fail,45,27,3,18,27
50,Fail,50,24,1,17,33
50,Fail,52,30,0,10,42
50,Fail,48,33,0,8,40
50,Fail,47,31,0,12,35
50,Fail,48,24,5,14,34
50,Fail,54,24,0,10,44
50,Fail,46,22,0,20,26
50,Fail,48,19,5,18,30
50,Fail,42,38,0,12,30
50,Fail,47,29,0,11,36
50,Fail,49,29,3,11,38
50,Fail,45,28,1,15,30
50,Fail,47,25,0,16,31
50,Fail,53,24,0,10,43
50,Fail,46,25,4,13,33
50,Fail,53,26,2,10,43
50,Fail,47,24,3,13,34
50,Fail,51,14,3,20,31
50,Fail,55,25,0,7,48
50,Fail,48,21,4,17,31
50,Fail,51,21,8,12,39
50,Fail,41,34,3,13,28
50,Fail,55,24,1,11,44
50,Fail,43,20,11,18,25
50,Fail,42,26,1,20,22
50,Fail,52,22,0,12,40
50,Fail,50,27,0,11,39
50,Fail,46,30,0,12,34
50,Fail,48,30,0,9,39
50,Fail,48,24,0,17,31
50,Fail,57,17,5,10,47
50,Fail,49,26,2,12,37
50,Fail,38,31,5,15,23
50,Fail,43,30,0,16,27
50,Fail,58,18,1,14,44
50,Fail,48,25,2,12,36
50,Fail,42,28,5,13,29
50,Fail,47,26,0,12,35
50,Fail,47,29,0,11,36
50,Fail,45,31,5,14,31
50,Fail,50,22,0,14,36
50,Fail,42,24,13,14,28
50,Fail,54,22,3,14,40
50,Fail,43,27,13,11,32
50,Fail,55,17,9,9,46
50,Fail,49,27,0,14,35
50,Fail,55,28,0,7,48
50,Fail,46,29,0,7,39
50,Fail,53,21,0,13,40
50,Fail,47,31,0,11,36
50,Fail,49,30,0,11,38
50,Fail,51,17,11,8,43
50,Fail,46,26,0,20,26
50,Fail,47,31,0,10,37
50,Fail,50,36,0,7,43
50,Fail,49,30,0,9,40
50,Fail,51,22,0,13,38
50,Fail,50,33,0,9,41
50,Fail,43,35,0,11,32
50,Fail,48,27,6,13,35
50,Fail,55,27,0,12,43
50,Fail,52,32,0,8,44
50,Fail,56,23,0,12,44
50,Fail,49,31,0,11,38
50,Fail,45,32,1,11,34
50,Fail,48,24,0,15,33
50,Fail,45,27,5,15,30
50,Fail,46,25,4,13,33
50,Fail,41,29,5,14,27
50,Fail,46,30,0,11,35
50,Fail,43,31,0,14,29
50,Fail,49,30,4,7,42
50,Fail,52,21,5,11,41
50,Fail,56,27,0,7,49
50,Fail,45,28,0,17,28
50,Fail,42,33,0,15,27
50,Fail,50,25,4,9,41
50,Fail,50,21,9,11,39
50,Fail,41,28,7,14,27
50,Fail,51,33,0,7,44
50,Fail,54,26,5,7,47
50,Fail,45,22,0,20,25
50,Fail,45,27,0,14,31
50,Fail,45,27,4,16,29
50,Fail,52,25,0,12,40
50,Fail,43,27,0,20,23
50,Fail,50,25,4,15,35
50,Fail,53,25,0,10,43
50,Fail,51,33,0,7,44
50,Fail,54,24,0,10,44
50,Fail,46,33,0,8,38
50,Fail,46,29,0,16,30
50,Fail,34,33,9,15,19
50,Fail,40,30,0,18,22
50,Fail,37,46,0,10,27
50,Fail,46,27,2,11,35
50,Fail,54,27,0,13,41
50,Fail,49,31,0,5,44
50,Fail,44,31,0,17,27
50,Fail,48,21,0,20,28
50,Fail,46,40,0,6,40
50,Fail,57,26,0,8,49
50,Fail,44,28,4,13,31
50,Fail,44,23,13,15,29
50,Fail,39,40,0,11,28
50,Fail,54,26,0,9,45
50,Fail,42,33,0,16,26
50,Fail,47,25,0,19,28
50,Fail,43,24,12,14,29
50,Fail,46,27,0,16,30
50,Fail,45,26,6,13,32
50,Fail,44,30,0,14,30
50,Fail,41,29,8,15,26
50,Fail,48,30,0,14,34
50,Fail,49,21,0,15,34
50,Fail,55,23,0,13,42
50,Fail,52,25,0,12,40
50,Fail,52,21,1,12,40
50,Fail,48,30,6,6,42
50,Fail,46,23,7,16,30
50,Fail,41,27,5,17,24
50,Fail,49,23,0,18,31
50,Fail,53,22,0,11,42
50,Fail,45,33,8,7,38
50,Fail,50,23,2,12,38
50,Fail,43,26,3,19,24
50,Fail,54,22,7,7,47
50,Fail,52,25,0,13,39
50,Fail,44,37,0,13,31
50,Fail,46,34,0,13,33
50,Fail,33,45,0,15,18
50,Fail,46,25,8,11,35
50,Fail,51,28,0,7,44
50,Fail,51,28,0,14,37
50,Fail,46,25,7,13,33
50,Fail,48,27,0,14,34
50,Fail,49,28,1,11,38
50,Fail,52,24,2,10,42
50,Fail,50,27,0,13,37
50,Fail,45,31,0,16,29
50,Fail,54,24,0,13,41
50,Fail,51,24,0,11,40
50,Fail,44,38,0,10,34
50,Fail,51,25,0,7,44
50,Fail,49,29,3,11,38
50,Fail,47,32,0,13,34
50,Fail,38,34,0,17,21
50,Fail,49,28,0,11,38
50,Fail,52,29,0,11,41
50,Fail,52,25,3,5,47
50,Fail,52,25,1,8,44
50,Fail,42,34,0,15,27
50,Fail,53,27,0,9,44
50,Fail,56,21,0,9,47
50,Fail,45,24,10,12,33
50,Fail,53,26,0,6,47
50,Success,60,19,1,9,51
50,Fail,43,39,0,9,34
50,Fail,58,18,1,10,48
50,Fail,45,31,1,15,30
50,Fail,45,19,9,16,29
50,Fail,38,35,0,16,22
50,Fail,47,24,0,14,33
50,Fail,55,20,3,11,44
50,Fail,51,24,3,12,39
50,Fail,40,33,8,12,28
50,Fail,39,29,11,14,25
50,Fail,41,36,1,11,30
50,Fail,45,33,0,11,34
50,Fail,48,28,0,10,38
50,Fail,47,29,0,14,33
50,Fail,43,33,0,18,25
50,Fail,46,25,0,13,33
50,Fail,44,33,0,12,32
50,Fail,46,29,0,13,33
50,Fail,46,24,2,13,33
50,Fail,55,25,0,9,46
50,Fail,55,20,0,13,42
50,Fail,43,32,0,15,28
50,Fail,47,29,0,14,33
50,Fail,47,28,0,11,36
50,Fail,50,22,0,14,36
50,Fail,56,21,1,12,44
50,Fail,45,22,2,17,28
50,Fail,45,36,0,13,32
50,Fail,45,34,0,10,35
50,Fail,48,28,0,12,36
50,Fail,43,30,3,15,28
50,Fail,51,23,0,9,42
50,Fail,45,32,0,12,33
50,Fail,46,32,0,8,38
50,Fail,44,27,0,19,25
50,Fail,43,26,5,16,27
50,Fail,45,30,5,10,35
50,Fail,52,25,0,15,37
50,Fail,49,26,0,17,32
50,Fail,51,18,5,15,36
50,Fail,47,23,0,13,34
50,Fail,46,22,6,15,31
50,Fail,36,27,14,12,24
50,Fail,42,31,6,14,28
50,Fail,49,25,8,8,41
50,Fail,44,37,0,14,30
50,Fail,50,25,0,16,34
50,Fail,49,28,0,12,37
50,Fail,49,23,1,14,35
50,Fail,52,24,1,11,41
50,Fail,44,27,8,10,34
50,Fail,43,36,0,13,30
50,Fail,54,23,7,6,48
50,Fail,59,14,3,11,48
50,Fail,42,29,0,16,26
50,Fail,46,29,6,12,34
50,Fail,50,30,6,8,42
50,Fail,49,27,0,14,35
50,Fail,51,19,6,12,39
50,Fail,44,23,8,18,26
50,Fail,55,21,0,10,45
50,Fail,47,33,0,11,36
50,Fail,48,23,1,16,32
50,Fail,51,26,0,14,37
50,Fail,49,30,0,12,37
50,Fail,48,28,0,13,35
50,Fail,50,23,0,19,31
50,Fail,47,28,0,16,31
50,Fail,48,28,4,9,39
50,Fail,56,20,1,12,44
50,Fail,52,25,0,12,40
50,Fail,41,26,10,14,27
50,Fail,42,35,0,12,30
50,Fail,36,32,0,21,15
50,Fail,46,26,5,13,33
50,Fail,46,28,1,13,33
50,Fail,50,26,5,8,42
50,Fail,47,25,0,15,32
50,Fail,44,32,5,9,35
50,Fail,57,20,0,10,47
50,Fail,44,34,0,13,31
50,Fail,52,27,0,10,42
50,Fail,52,24,3,9,43
50,Fail,47,31,0,8,39
50,Fail,44,26,0,19,25
50,Fail,43,26,8,11,32
50,Fail,46,27,7,14,32
50,Fail,45,26,6,13,32
50,Fail,44,27,0,20,24
50,Fail,40,34,5,11,29
50,Fail,54,28,1,5,49
50,Fail,39,31,0,17,22
50,Fail,48,28,0,13,35
50,Fail,49,27,4,10,39
50,Fail,47,30,3,10,37
50,Fail,44,26,1,18,26
50,Fail,48,25,5,13,35
50,Fail,57,17,2,13,44
50,Fail,46,27,2,13,33
50,Fail,44,25,7,15,29
50,Fail,52,18,5,14,38
50,Fail,44,30,0,16,28
50,Fail,46,30,0,11,35
50,Fail,41,36,3,12,29
50,Fail,57,21,0,10,47
50,Fail,45,33,0,11,34
50,Fail,42,34,0,16,26
50,Fail,47,35,0,7,40
50,Fail,48,20,0,18,30
50,Fail,47,26,0,17,30
50,Fail,36,37,0,14,22
50,Fail,50,32,0,11,39
50,Fail,43,29,0,22,21
50,Fail,46,20,8,14,32
50,Fail,52,25,3,6,46
50,Fail,50,24,2,13,37
50,Fail,47,32,0,14,33
50,Fail,58,17,0,13,45
50,Fail,43,34,0,10,33
50,Fail,46,19,8,16,30
50,Fail,51,33,0,7,44
50,Fail,50,21,0,13,37
50,Fail,55,26,0,8,47
50,Fail,52,20,3,13,39
50,Fail,50,25,0,17,33
50,Fail,43,39,0,8,35
50,Fail,47,23,6,11,36
50,Fail,50,19,2,15,35
50,Fail,55,23,0,13,42
50,Fail,53,22,4,12,41
50,Fail,45,27,6,12,33
50,Fail,39,38,0,17,22
50,Fail,56,23,0,7,49
50,Fail,54,19,0,15,39
50,Fail,50,25,0,12,38
50,Fail,54,13,8,15,39
50,Success,61,20,0,9,52
50,Fail,52,30,0,11,41
50,Fail,42,30,9,13,29
50,Fail,48,20,8,13,35
50,Fail,49,34,0,9,40
50,Fail,46,29,0,16,30
50,Fail,55,25,0,10,45
50,Fail,48,30,0,13,35
50,Fail,51,30,3,8,43
50,Fail,51,22,1,13,38
50,Fail,44,35,0,12,32
50,Fail,56,22,0,10,46
50,Fail,51,22,1,13,38
50,Fail,54,16,5,14,40
50,Fail,44,32,0,16,28
50,Fail,47,20,7,14,33
50,Fail,47,35,0,8,39
50,Fail,46,22,5,16,30
50,Fail,47,25,5,13,34
50,Fail,51,30,0,7,44
50,Fail,46,26,0,19,27
50,Fail,49,26,10,9,40
50,Fail,50,28,0,11,39
50,Fail,51,23,0,10,41
50,Fail,46,27,6,10,36
50,Fail,53,30,0,6,47
50,Fail,51,27,0,13,38
50,Fail,49,24,4,12,37
50,Fail,43,34,0,13,30
50,Fail,48,25,0,17,31
50,Fail,40,31,4,16,24
50,Fail,51,25,0,16,35
50,Fail,54,24,0,12,42
50,Fail,43,29,1,14,29
50,Fail,44,35,0,11,33
50,Fail,49,28,0,13,36
50,Fail,51,27,0,10,41
50,Fail,38,38,0,18,20
50,Fail,48,25,1,13,35
50,Fail,51,22,3,13,38
50,Fail,47,26,7,11,36
50,Fail,44,39,0,10,34
50,Fail,43,26,0,16,27
50,Fail,46,29,0,13,33
50,Fail,43,36,0,9,34
50,Fail,43,26,6,17,26
50,Fail,49,30,0,9,40
50,Fail,48,26,5,12,36
50,Fail,52,32,0,7,45
50,Fail,42,32,4,13,29
50,Fail,53,24,0,15,38
50,Fail,49,26,5,6,43
50,Fail,49,30,0,8,41
50,Fail,49,33,2,7,42
50,Fail,49,23,0,13,36
50,Fail,44,34,0,9,35
50,Fail,53,26,3,7,46
50,Fail,46,31,0,15,31
50,Fail,47,24,5,11,36
50,Fail,54,15,6,17,37
50,Fail,52,22,7,10,42
50,Fail,46,26,5,12,34
50,Fail,55,17,1,12,43
50,Fail,48,32,2,4,44
50,Fail,50,23,5,11,39
50,Fail,45,27,4,14,31
50,Fail,44,35,0,10,34
50,Fail,42,30,2,12,30
50,Fail,52,24,0,12,40
50,Fail,51,23,0,14,37
50,Fail,50,28,0,10,40
50,Fail,51,28,0,9,42
50,Fail,49,24,5,10,39
50,Fail,43,22,4,17,26
50,Fail,40,33,11,9,31
50,Fail,43,35,0,13,30
50,Fail,45,24,8,11,34
50,Fail,55,24,0,9,46
50,Fail,45,33,0,12,33
50,Fail,47,24,5,9,38
50,Fail,58,17,0,11,47
50,Fail,48,27,0,13,35
50,Fail,54,27,0,7,47
50,Fail,47,29,0,11,36
50,Fail,46,30,0,11,35
50,Fail,43,25,6,14,29
50,Fail,51,25,0,16,35
50,Fail,39,43,0,11,28
50,Fail,51,32,0,7,44
50,Fail,52,19,5,11,41
50,Fail,49,29,4,6,43
50,Fail,46,24,3,14,32
50,Fail,45,29,0,17,28
50,Fail,47,18,8,19,28
50,Fail,43,31,0,13,30
50,Fail,40,31,3,13,27
50,Fail,48,22,4,15,33
50,Fail,51,26,0,12,39
50,Fail,46,27,6,13,33
50,Fail,46,26,0,16,30
50,Fail,49,32,0,5,44
50,Fail,50,21,1,17,33
50,Fail,51,22,4,12,39
50,Fail,42,32,0,16,26
50,Fail,47,23,8,15,32
50,Fail,40,26,17,13,27
50,Fail,37,34,3,15,22
50,Fail,49,25,9,11,38
50,Fail,52,26,0,13,39
50,Fail,48,30,0,9,39
50,Fail,47,22,1,14,33
50,Fail,52,22,7,10,42
50,Fail,45,27,0,19,26
50,Fail,53,24,0,11,42
50,Fail,41,32,6,16,25
50,Fail,45,25,5,17,28
50,Fail,44,28,1,12,32
50,Fail,48,24,14,10,38
50,Fail,52,21,6,11,41
50,Fail,48,30,0,12,36
50,Fail,47,26,0,13,34
50,Fail,42,35,4,11,31
50,Fail,54,26,2,6,48
50,Fail,46,27,0,18,28
50,Fail,44,27,0,18,26
50,Fail,38,31,5,16,22
50,Fail,43,24,9,16,27
50,Fail,47,27,0,13,34
50,Fail,43,28,0,19,24
50,Fail,50,33,0,10,40
50,Fail,49,34,0,7,42
50,Fail,50,28,0,11,39
50,Fail,46,28,2,17,29
50,Fail,53,27,0,9,44
50,Fail,47,20,0,18,29
50,Fail,54,20,0,14,40
50,Fail,51,17,1,19,32
50,Fail,46,31,5,9,37
50,Fail,51,27,0,16,35
50,Fail,48,28,0,10,38
50,Fail,49,24,3,13,36
50,Fail,48,31,4,9,39
50,Fail,52,19,6,15,37
50,Fail,50,21,0,14,36
50,Fail,44,25,3,18,26
50,Fail,50,24,0,17,33
50,Fail,53,22,0,14,39
50,Fail,44,29,0,14,30
50,Fail,45,27,9,12,33
50,Fail,48,19,11,13,35
50,Fail,48,26,0,16,32
50,Fail,48,26,7,9,39
50,Fail,48,24,8,15,33
50,Fail,46,25,0,19,27
50,Fail,53,23,0,11,42
50,Fail,47,30,0,15,32
50,Fail,47,22,5,10,37
50,Fail,45,28,8,9,36
50,Fail,41,28,3,18,23
50,Fail,49,26,0,10,39
50,Fail,48,26,0,12,36
50,Fail,49,27,0,10,39
50,Fail,53,21,6,12,41
50,Fail,47,30,0,13,34
50,Fail,50,23,4,14,36
50,Fail,41,37,0,13,28
50,Fail,50,21,4,10,40
50,Fail,49,19,4,16,33
50,Fail,45,22,2,17,28
50,Fail,39,36,0,16,23
50,Fail,52,23,0,15,37
50,Fail,40,33,1,16,24
50,Fail,43,34,0,11,32
50,Fail,49,33,0,10,39
50,Fail,53,32,0,10,43
50,Fail,46,34,0,10,36
50,Fail,51,29,0,11,40
50,Fail,38,45,0,9,29
50,Fail,51,21,5,15,36
50,Fail,51,26,0,13,38
50,Fail,52,16,6,12,40
50,Fail,46,24,4,16,30
50,Fail,55,24,1,10,45
50,Fail,44,27,0,19,25
50,Fail,45,32,3,14,31
50,Fail,45,25,4,16,29
50,Fail,48,24,2,16,32
50,Fail,45,30,0,15,30
50,Fail,52,26,3,12,40
50,Fail,38,22,6,21,17
50,Fail,44,32,0,11,33
50,Fail,42,33,3,12,30
50,Fail,47,30,0,13,34
50,Fail,42,33,0,14,28
50,Fail,45,34,0,14,31
50,Success,62,15,0,11,51
50,Fail,42,27,4,16,26
50,Fail,52,31,0,6,46
50,Fail,58,20,0,10,48
50,Fail,45,27,11,13,32
50,Success,62,18,0,9,53
50,Success,58,24,1,7,51
50,Fail,39,27,0,22,17
50,Fail,47,31,0,11,36
50,Fail,49,30,3,8,41
50,Fail,49,28,0,12,37
50,Fail,43,29,4,15,28
50,Fail,45,34,0,11,34
50,Fail,51,27,2,11,40
50,Fail,47,22,13,10,37
50,Fail,48,29,0,14,34
50,Fail,43,34,0,14,29
50,Fail,46,26,0,14,32
50,Fail,47,34,0,10,37
50,Fail,51,28,1,9,42
50,Fail,48,21,3,16,32
50,Fail,46,30,0,14,32
50,Fail,49,28,0,12,37
50,Fail,47,28,0,14,33
50,Fail,46,31,5,9,37
50,Fail,44,28,3,15,29
50,Fail,49,32,0,8,41
50,Fail,47,26,3,12,35
50,Fail,40,39,0,16,24
50,Fail,47,32,0,12,35
50,Fail,47,32,0,11,36
50,Fail,45,31,1,14,31
50,Fail,48,26,0,15,33
50,Fail,52,22,2,14,38
50,Fail,45,34,0,8,37
50,Fail,50,22,2,15,35
50,Fail,49,24,6,13,36
50,Fail,51,34,0,8,43
50,Fail,51,23,5,10,41
50,Fail,38,51,0,8,30
50,Fail,53,17,2,15,38
50,Fail,49,30,1,9,40
50,Fail,50,29,0,14,36
50,Fail,55,21,1,10,45
50,Fail,44,35,0,13,31
50,Fail,51,32,0,8,43
50,Fail,45,25,0,14,31
50,Fail,49,22,9,15,34
50,Fail,48,30,1,10,38
50,Fail,46,35,0,15,31
50,Fail,49,27,2,13,36
50,Fail,56,21,0,8,48
50,Fail,42,24,4,16,26
50,Fail,43,25,2,19,24
50,Fail,48,24,1,16,32
50,Fail,44,26,3,16,28
50,Fail,38,27,13,14,24
50,Fail,43,32,3,9,34
50,Fail,42,31,0,14,28
50,Fail,56,19,0,10,46
50,Fail,44,23,4,15,29
50,Fail,51,22,12,7,44
50,Fail,46,30,1,11,35
50,Fail,55,14,4,16,39
50,Fail,51,22,0,12,39
50,Fail,46,25,7,14,32
50,Fail,51,21,3,12,39
50,Fail,51,32,0,6,45
50,Fail,50,23,0,13,37
50,Fail,55,27,0,9,46
50,Fail,42,43,0,11,31
50,Fail,49,29,0,12,37
50,Fail,49,26,2,11,38
50,Fail,39,35,0,15,24
50,Fail,47,25,0,13,34
50,Fail,45,26,11,11,34
50,Fail,45,22,7,15,30
50,Fail,51,28,0,10,41
50,Fail,47,22,7,13,34
50,Fail,47,32,0,10,37
50,Fail,45,28,1,15,30
50,Fail,56,19,2,11,45
50,Fail,53,25,0,13,40
50,Fail,46,32,0,14,32
50,Fail,52,20,2,15,37
50,Fail,44,25,0,19,25
50,Fail,52,25,6,9,43
50,Fail,45,21,9,16,29
50,Fail,44,28,0,16,28
50,Fail,43,25,10,12,31
50,Fail,44,34,0,11,33
50,Fail,35,42,0,15,20
50,Fail,44,31,11,6,38
50,Fail,48,26,1,8,40
50,Fail,47,30,0,15,32
50,Fail,55,20,3,9,46
50,Fail,41,29,1,15,26
50,Fail,44,35,2,10,34
50,Fail,43,28,8,13,30
50,Fail,39,27,13,14,25
50,Fail,42,32,0,18,24
50,Fail,49,30,0,9,40
50,Fail,46,33,0,12,34
50,Fail,52,27,0,10,42
50,Fail,48,23,0,13,35
50,Fail,49,29,3,9,40
50,Fail,50,26,0,14,36
50,Fail,46,22,4,13,33
50,Fail,48,26,0,12,36
50,Fail,52,18,3,15,37
50,Fail,52,23,3,10,42
50,Fail,50,32,0,6,44
50,Fail,47,33,0,11,36
50,Fail,48,30,4,10,38
50,Fail,50,21,3,11,39
50,Fail,47,24,1,13,34
50,Fail,39,34,2,19,20
50,Fail,46,22,4,19,27
50,Fail,41,31,0,18,23
50,Fail,51,26,0,12,39
50,Fail,47,28,2,10,37
50,Fail,51,26,0,17,34
50,Fail,53,29,3,8,45
50,Fail,51,23,4,12,39
50,Fail,50,17,3,16,34
50,Fail,44,38,0,10,34
50,Fail,51,25,0,11,40
50,Fail,46,32,0,15,31
50,Fail,53,22,0,15,38
50,Fail,48,23,3,13,35
50,Fail,45,20,7,16,29
50,Fail,54,29,0,10,44
50,Fail,51,19,0,15,36
50,Fail,50,27,0,8,42
50,Fail,38,31,4,11,27
50,Fail,44,37,0,13,31
50,Fail,47,29,0,13,34
50,Fail,45,31,0,16,29
50,Fail,46,31,0,12,34
50,Fail,50,22,7,12,38
50,Fail,54,30,0,9,45
50,Fail,57,21,0,13,44
50,Fail,49,22,0,15,34
50,Fail,53,20,0,12,41
50,Fail,55,21,2,12,43
50,Fail,50,26,3,11,39
50,Fail,53,24,0,14,39
50,Fail,53,23,0,15,38
50,Fail,41,35,2,12,29
50,Fail,47,28,0,10,37
50,Fail,46,31,0,10,36
50,Fail,49,27,3,11,38
50,Fail,44,34,0,13,31
50,Fail,42,32,2,14,28
50,Fail,46,31,8,6,40
50,Fail,50,27,0,13,37
50,Fail,40,36,0,19,21
50,Fail,45,29,0,15,30
50,Fail,49,33,0,11,38
50,Fail,45,21,9,15,30
50,Fail,42,42,0,8,34
50,Fail,50,26,7,8,42
50,Fail,56,23,0,10,46
50,Fail,45,31,0,11,34
50,Fail,58,23,0,11,47
50,Fail,44,25,12,9,35
50,Fail,39,25,3,20,19
50,Fail,46,33,3,5,41
50,Fail,48,30,0,11,37
50,Success,57,23,2,6,51
50,Fail,53,31,0,7,46
50,Fail,55,22,0,12,43
50,Fail,53,25,0,12,41
50,Fail,52,24,5,12,40
50,Fail,48,25,3,12,36
50,Fail,47,35,0,11,36
50,Fail,51,25,4,10,41
50,Fail,48,27,0,14,34
50,Fail,50,25,1,12,38
50,Fail,44,27,5,14,30
50,Fail,44,31,0,13,31
50,Fail,49,27,0,14,35
50,Fail,53,20,5,9,44
50,Fail,44,31,2,9,35
50,Fail,43,35,0,14,29
50,Fail,48,23,2,17,31
50,Fail,49,31,0,7,42
50,Fail,51,22,0,15,36
50,Fail,52,19,2,15,37
50,Fail,48,22,6,15,33
50,Fail,54,26,0,7,47
50,Fail,40,35,6,11,29
50,Fail,47,27,2,11,36
50,Fail,54,24,0,13,41
50,Fail,46,25,0,17,29
50,Fail,52,22,2,15,37
50,Fail,48,30,2,8,40
50,Fail,55,13,2,15,40
50,Fail,41,33,12,7,34
50,Fail,41,32,0,16,25
50,Fail,45,31,0,18,27
50,Fail,51,24,0,14,37
50,Fail,53,29,1,7,46
50,Fail,42,31,0,16,26
50,Fail,50,21,2,14,36
50,Fail,52,28,1,7,45
50,Fail,51,29,0,10,41
50,Fail,54,22,0,11,43
50,Fail,49,22,7,12,37
50,Fail,57,23,0,9,48
50,Fail,51,28,0,11,40
50,Fail,48,23,5,9,39
50,Fail,45,33,0,9,36
50,Fail,52,30,0,7,45
50,Fail,53,21,1,13,40
50,Fail,50,23,4,13,37
50,Fail,52,30,0,8,44
50,Fail,48,23,0,16,32
50,Fail,45,22,3,15,30
50,Fail,45,27,1,12,33
50,Fail,51,33,0,8,43
50,Fail,57,18,0,15,42
50,Fail,45,36,0,10,35
50,Fail,42,30,8,9,33
50,Fail,48,28,0,10,38
50,Fail,47,33,0,11,36
50,Fail,56,20,0,14,42
50,Fail,47,25,2,15,32
50,Fail,45,32,0,13,32
50,Fail,53,22,0,11,42
50,Fail,46,27,0,14,32
50,Fail,46,25,5,12,34
50,Fail,55,27,3,7,48
50,Fail,50,19,9,14,36
50,Fail,45,31,1,15,30
50,Fail,58,24,0,11,47
50,Fail,54,27,1,9,45
50,Fail,53,26,0,9,44
50,Fail,47,30,0,14,33
50,Fail,45,38,0,11,34
50,Fail,42,34,0,16,26
50,Fail,39,34,9,8,31
50,Fail,49,24,0,17,32
50,Fail,46,35,3,8,38
50,Fail,54,25,0,11,43
50,Fail,50,19,8,10,40
50,Fail,48,32,0,9,39
50,Fail,45,31,0,11,34
50,Fail,54,23,0,13,41
50,Fail,44,33,0,12,32
50,Fail,44,34,3,7,37
50,Fail,41,31,0,15,26
50,Fail,54,18,2,15,39
50,Fail,45,30,0,14,31
50,Fail,55,21,0,14,41
50,Fail,50,27,3,12,38
50,Fail,42,33,0,15,27
50,Fail,54,21,1,11,43
50,Fail,50,23,0,15,35
50,Fail,48,29,0,10,38
50,Fail,41,35,5,10,31
50,Fail,48,21,0,18,30
50,Fail,43,37,0,8,35
50,Fail,49,25,2,11,38
50,Fail,53,21,6,9,44
50,Fail,51,16,3,17,34
50,Fail,52,22,0,15,37
50,Fail,45,30,0,14,31
50,Fail,44,29,10,10,34
50,Fail,56,20,3,8,48
50,Fail,51,29,0,12,39
50,Fail,52,23,0,14,38
50,Fail,46,27,0,17,29
50,Fail,46,24,5,14,32
50,Fail,53,28,0,6,47
50,Fail,52,34,0,7,45
50,Fail,52,15,4,19,33
50,Fail,44,31,0,13,31
50,Fail,48,22,2,17,31
50,Fail,47,26,9,9,38
50,Fail,46,30,0,14,32
50,Fail,47,36,0,9,38
50,Fail,45,22,3,19,26
50,Fail,50,27,1,12,38
50,Fail,52,25,3,9,43
50,Fail,48,24,0,14,34
50,Fail,57,19,0,14,43
50,Fail,46,25,7,14,32
50,Fail,41,28,0,21,20
50,Fail,42,38,0,8,34
50,Fail,52,26,5,12,40
50,Fail,42,31,6,12,30
50,Fail,47,28,0,15,32
50,Fail,45,29,5,10,35
50,Fail,47,27,0,15,32
50,Fail,49,24,3,12,37
50,Fail,53,27,5,6,47
50,Fail,53,24,0,7,46
50,Fail,55,25,0,8,47
50,Fail,47,33,0,13,34
50,Fail,48,20,3,18,30
50,Fail,48,24,2,17,31
50,Fail,46,29,5,12,34
50,Fail,40,29,8,12,28
50,Fail,49,23,6,14,35
50,Fail,42,28,3,12,30
50,Fail,46,33,0,10,36
50,Fail,51,26,0,11,40
50,Fail,48,26,0,13,35
50,Fail,45,32,0,12,33
50,Fail,53,20,2,8,45
50,Success,56,25,0,6,50
50,Fail,48,26,0,20,28
50,Fail,52,26,1,9,43
50,Fail,50,24,0,11,39
50,Fail,47,33,0,9,38
50,Fail,45,37,0,12,33
50,Fail,55,23,0,11,44
50,Fail,50,31,0,10,40
50,Fail,41,30,5,13,28
50,Success,59,20,5,5,54
50,Fail,50,27,0,10,40
50,Fail,46,25,1,16,30
50,Fail,47,21,0,20,27
50,Fail,51,20,6,12,39
50,Fail,55,22,0,12,43
50,Fail,43,37,0,13,30
50,Fail,44,26,0,13,31
50,Fail,46,31,0,13,33
50,Fail,50,19,6,14,36
50,Fail,46,29,0,14,32
50,Fail,45,30,0,14,31
50,Fail,51,19,4,14,37
50,Fail,45,25,0,17,28
50,Fail,38,32,11,10,28
50,Fail,50,23,7,11,39
50,Fail,46,25,7,12,34
50,Fail,49,24,0,17,32
50,Fail,41,20,13,16,25
50,Fail,42,36,0,15,27
50,Fail,58,22,1,10,48
50,Fail,52,19,3,12,40
50,Fail,47,33,0,8,39
50,Fail,45,38,0,9,36
50,Fail,42,30,0,16,26
50,Fail,46,29,0,11,35
50,Fail,46,34,0,10,36
50,Fail,51,26,0,13,38
50,Fail,51,21,2,17,34
50,Fail,49,28,0,8,41
50,Fail,49,18,4,18,31
50,Fail,56,23,0,10,46
50,Fail,50,24,8,6,44
50,Fail,45,20,0,21,24
50,Fail,49,29,0,10,39
50,Fail,42,35,0,13,29
50,Fail,46,25,1,17,29
50,Fail,44,32,0,16,28
50,Fail,45,23,2,21,24
50,Fail,49,26,0,10,39
50,Fail,52,23,0,14,38
50,Fail,42,36,0,14,28
50,Fail,46,30,0,16,30
50,Fail,55,25,0,12,43
50,Fail,47,24,1,16,31
50,Fail,42,26,10,12,30
50,Fail,48,32,0,6,42
50,Fail,43,29,1,14,29
50,Fail,48,23,6,13,35
50,Fail,46,26,11,8,38
50,Fail,46,29,0,12,34
50,Fail,43,32,0,13,30
50,Fail,51,24,0,13,38
50,Fail,49,27,0,11,38
50,Fail,49,24,0,12,37
50,Fail,48,29,1,11,37
50,Fail,49,28,0,15,34
50,Fail,46,34,0,10,36
50,Fail,49,29,0,10,39
50,Fail,50,27,1,8,42
50,Fail,34,41,0,18,16
50,Fail,52,22,0,20,32
50,Fail,50,28,0,12,38
50,Fail,49,23,3,15,34
50,Fail,46,26,5,13,33
50,Fail,45,25,8,15,30
50,Fail,48,33,0,8,40
50,Fail,46,36,0,13,33
50,Fail,47,27,4,12,35
50,Fail,52,21,3,11,41
50,Fail,42,26,5,21,21
50,Fail,42,28,4,12,30
50,Fail,50,27,0,13,37
50,Fail,56,23,0,15,41
50,Fail,44,37,0,9,35
50,Fail,52,27,0,8,44
50,Fail,47,26,0,12,35
50,Fail,46,34,0,10,36
50,Fail,45,30,4,14,31
50,Fail,54,25,3,7,47
50,Fail,49,32,0,9,40
50,Fail,51,23,5,10,41
50,Fail,47,32,0,7,40
50,Fail,43,35,0,12,31
50,Fail,49,24,1,14,35
50,Fail,42,33,0,14,28
50,Fail,44,31,2,12,32
50,Fail,47,29,0,14,33
50,Fail,52,32,0,7,45
50,Fail,42,31,0,16,26
50,Fail,38,39,2,13,25
50,Fail,49,24,4,14,35
50,Fail,53,26,4,9,44
50,Fail,53,23,0,14,39
50,Fail,51,22,0,12,39
50,Fail,46,26,0,17,29
50,Fail,47,25,5,15,32
50,Fail,38,38,0,13,25
50,Fail,51,31,0,9,42
50,Fail,51,26,0,14,37
50,Fail,51,26,0,15,36
50,Fail,42,29,3,16,26
50,Fail,49,23,2,14,35
50,Fail,49,31,0,11,38
50,Fail,50,22,4,11,39
50,Fail,44,29,1,13,31
50,Fail,47,33,0,8,39
50,Fail,51,22,0,18,33
50,Fail,45,33,0,10,35
50,Fail,46,24,0,19,27
50,Fail,53,21,0,11,42
50,Fail,49,21,0,16,33
50,Fail,49,29,0,12,37
50,Fail,50,23,0,14,36
50,Fail,45,25,4,16,29
50,Fail,43,31,0,18,25
50,Fail,51,26,0,11,40
50,Fail,45,22,8,13,32
50,Fail,54,19,0,17,37
50,Fail,51,25,0,11,40
50,Fail,53,21,1,11,42
50,Fail,52,22,7,8,44
50,Fail,46,22,7,15,31
50,Fail,40,39,0,14,26
50,Fail,45,28,0,18,27
50,Fail,51,25,0,15,36
50,Fail,45,24,0,17,28
50,Fail,47,27,0,14,33
50,Fail,50,27,0,12,38
50,Fail,48,29,0,12,36
50,Fail,45,30,0,14,31
50,Fail,48,26,1,10,38
50,Fail,44,32,5,14,30
50,Fail,53,22,4,13,40
50,Fail,45,23,4,16,29
50,Fail,49,31,0,11,38
50,Fail,47,31,0,13,34
50,Fail,47,20,2,18,29
50,Fail,50,24,0,16,34
50,Fail,49,28,0,11,38
50,Fail,54,24,0,12,42
50,Fail,54,19,1,16,38
50,Fail,43,21,3,21,22
50,Fail,46,25,0,18,28
50,Fail,50,27,2,9,41
50,Fail,52,27,3,7,45
50,Fail,46,33,0,10,36
50,Fail,49,29,2,9,40
50,Fail,50,21,0,20,30
50,Fail,50,30,0,14,36
50,Fail,54,24,0,10,44
50,Fail,49,28,0,14,35
50,Fail,39,33,4,13,26
50,Fail,49,31,0,5,44
50,Fail,39,38,0,13,26
50,Fail,38,34,0,21,17
50,Fail,48,29,0,13,35
50,Fail,51,30,0,8,43
50,Fail,56,22,0,8,48
50,Fail,51,22,4,12,39
50,Fail,45,25,0,18,27
50,Fail,47,33,0,9,38
50,Fail,52,30,0,8,44
50,Fail,37,42,3,12,25
50,Fail,51,25,0,15,36
50,Fail,45,26,7,14,31
50,Fail,45,32,0,13,32
50,Fail,52,22,10,9,43
50,Fail,46,32,0,10,36
50,Fail,54,23,0,10,44
50,Fail,50,29,1,8,42
50,Fail,45,31,0,14,31
50,Fail,54,19,3,14,40
50,Fail,53,24,0,11,42
50,Fail,52,25,2,10,42
50,Fail,44,32,0,13,31
50,Fail,49,33,0,10,39
50,Fail,46,29,0,15,31
50,Fail,49,22,5,13,36
50,Fail,41,31,0,19,22
50,Fail,48,28,0,13,35
50,Fail,43,38,0,11,32
50,Fail,47,29,4,12,35
50,Fail,51,21,6,12,39
50,Fail,53,20,0,16,37
50,Fail,54,20,0,11,43
50,Fail,46,25,0,14,32
50,Fail,48,24,8,15,33
50,Fail,49,24,0,11,38
50,Fail,47,31,0,17,30
50,Fail,58,26,0,9,49
50,Fail,48,27,0,13,35
50,Success,59,26,0,6,53
50,Fail,53,26,0,10,43
50,Fail,54,31,0,9,45
50,Fail,50,26,1,9,41
50,Fail,52,26,0,11,41
50,Fail,52,33,0,7,45
50,Fail,50,23,4,12,38
50,Fail,50,28,0,11,39
50,Fail,42,38,0,10,32
50,Fail,58,20,0,15,43
50,Fail,48,17,6,19,29
50,Fail,51,24,0,14,37
50,Success,59,21,0,7,52
50,Fail,52,23,5,10,42
50,Fail,54,19,0,11,43
50,Fail,53,26,1,9,44
50,Fail,42,27,2,16,26
50,Fail,47,31,1,13,34
50,Fail,58,17,0,13,45
50,Fail,55,13,3,17,38
50,Fail,43,34,1,11,32
50,Fail,44,24,8,17,27
50,Fail,50,21,0,16,34
50,Fail,43,29,9,12,31
50,Fail,47,33,0,8,39
50,Fail,49,32,0,10,39
50,Fail,40,36,0,14,26
50,Fail,55,22,2,6,49
50,Fail,45,24,11,13,32
50,Fail,43,33,0,14,29
50,Fail,46,22,6,15,31
50,Fail,58,16,0,16,42
50,Fail,45,29,2,14,31
50,Fail,39,38,0,12,27
50,Fail,49,25,0,16,33
50,Fail,47,24,0,16,31
50,Fail,55,24,4,9,46
50,Fail,48,20,7,15,33
50,Fail,42,37,0,10,32
50,Success,57,23,1,7,50
50,Fail,55,21,2,12,43
50,Fail,48,27,6,8,40
50,Fail,37,39,0,15,22
50,Fail,48,26,2,12,36
50,Fail,47,32,0,14,33
50,Fail,42,31,0,18,24
50,Fail,49,30,0,4,45
50,Fail,52,28,5,8,44
50,Fail,37,28,5,23,14
50,Fail,40,41,0,12,28
50,Fail,50,22,3,11,39
50,Fail,48,23,4,14,34
50,Fail,41,29,2,15,26
50,Fail,52,27,0,14,38
50,Fail,41,30,3,15,26
50,Fail,43,30,0,15,28
50,Fail,49,27,0,13,36
50,Fail,47,27,0,14,33
50,Fail,57,20,4,9,48
50,Fail,56,17,3,11,45
50,Fail,51,25,9,11,40
50,Fail,41,32,0,16,25
50,Fail,49,28,0,15,34
50,Fail,54,21,10,11,43
50,Fail,50,31,1,7,43
50,Fail,52,23,0,14,38
50,Fail,47,31,0,11,36
50,Fail,43,29,0,18,25
50,Fail,46,32,2,9,37
50,Fail,40,32,5,12,28
50,Fail,47,25,6,12,35
50,Fail,52,21,3,13,39
50,Fail,52,24,0,13,39
50,Fail,49,28,6,12,37
50,Fail,42,31,0,14,28
50,Fail,47,35,0,8,39
50,Fail,50,26,3,8,42
50,Fail,46,23,6,16,30
50,Fail,52,22,3,11,41
50,Fail,51,21,0,15,36
50,Fail,51,25,0,14,37
50,Fail,55,24,0,11,44
50,Fail,40,35,1,11,29
50,Fail,44,36,0,15,29
50,Fail,45,28,3,13,32
50,Fail,54,20,5,8,46
50,Fail,44,25,9,10,34
50,Fail,56,18,8,11,45
50,Fail,53,25,0,12,41
50,Fail,48,26,0,10,38
50,Fail,47,31,8,9,38
50,Fail,51,23,0,14,37
50,Fail,52,24,2,11,41
50,Fail,50,25,2,12,38
50,Fail,56,20,0,11,45
50,Fail,50,29,0,10,40
50,Fail,49,30,0,12,37
50,Fail,51,29,0,9,42
50,Fail,51,14,6,19,32
50,Fail,50,21,3,11,39
50,Fail,49,33,0,10,39
50,Fail,50,29,0,7,43
50,Fail,46,30,0,15,31
50,Fail,44,26,0,22,22
50,Fail,49,27,0,13,36
50,Fail,44,32,4,11,33
50,Fail,43,25,7,15,28
50,Fail,44,33,0,12,32
50,Fail,54,22,4,9,45
50,Fail,52,18,11,10,42
50,Fail,47,26,2,15,32
50,Fail,44,31,0,12,32
50,Fail,40,33,0,18,22
50,Fail,50,28,0,10,40
50,Fail,54,21,1,9,45
50,Fail,44,26,9,14,30
50,Fail,47,27,1,10,37
50,Fail,51,26,3,9,42
50,Fail,49,24,7,11,38
50,Fail,46,30,0,14,32
50,Fail,45,21,0,24,21
50,Fail,46,34,0,12,34
50,Fail,37,41,0,11,26
50,Fail,47,25,0,15,32
50,Fail,51,18,4,13,38
50,Fail,46,21,4,16,30
50,Fail,39,30,2,20,19
50,Fail,54,25,0,10,44
50,Fail,45,28,0,17,28
50,Fail,49,23,6,10,39
50,Fail,47,28,5,11,36
50,Fail,41,36,0,15,26
50,Fail,45,26,6,11,34
50,Fail,48,30,4,7,41
50,Fail,52,23,0,15,37
50,Fail,44,25,0,19,25
50,Fail,49,20,0,17,32
50,Success,58,23,0,7,51
50,Fail,47,30,0,14,33
50,Fail,45,34,0,11,34
50,Fail,45,37,0,10,35
50,Fail,55,19,2,12,43
50,Fail,44,25,3,18,26
50,Fail,51,22,1,13,38
50,Fail,45,21,3,18,27
50,Fail,45,25,0,17,28
50,Fail,51,26,0,12,39
50,Fail,46,28,0,16,30
50,Fail,45,27,11,15,30
50,Fail,51,23,0,15,36
50,Fail,47,25,1,12,35
50,Fail,41,32,4,13,28
50,Fail,58,20,4,10,48
50,Fail,53,30,0,7,46
50,Fail,45,30,2,12,33
50,Fail,50,24,6,9,41
50,Fail,48,27,1,14,34
50,Fail,51,23,0,13,38
50,Fail,49,27,0,13,36
50,Fail,49,21,1,17,32
50,Fail,50,32,0,9,41
50,Fail,42,26,8,11,31
50,Fail,51,28,0,11,40
50,Fail,53,26,0,9,44
50,Fail,49,25,0,17,32
50,Fail,53,26,0,8,45
50,Fail,51,21,2,14,37
50,Fail,47,26,0,15,32
50,Fail,43,28,0,19,24
50,Fail,42,37,0,11,31
50,Fail,47,28,0,12,35
50,Fail,47,26,1,16,31
50,Fail,45,25,7,14,31
50,Fail,45,29,0,15,30
50,Fail,48,25,4,12,36
50,Fail,48,29,5,8,40
50,Fail,44,31,0,12,32
50,Success,59,21,0,8,51
50,Fail,51,36,0,8,43
50,Fail,50,27,0,13,37
50,Fail,42,29,4,12,30
50,Fail,47,29,5,11,36
50,Fail,56,20,0,8,48
50,Fail,52,26,0,12,40
50,Fail,45,29,8,9,36
50,Fail,41,42,0,12,29
50,Fail,48,21,14,12,36
50,Fail,50,32,0,11,39
50,Fail,47,33,0,11,36
50,Fail,52,21,0,13,39
50,Fail,34,39,5,11,23
50,Fail,46,26,0,16,30
50,Fail,46,30,3,13,33
50,Fail,48,21,0,16,32
50,Fail,45,26,0,21,24
50,Fail,40,35,0,16,24
50,Fail,44,29,0,17,27
50,Fail,47,27,7,11,36
50,Fail,47,26,3,14,33
50,Fail,47,23,6,15,32
50,Fail,45,28,0,15,30
50,Fail,43,28,6,12,31
50,Fail,49,25,8,7,42
50,Fail,38,36,0,15,23
50,Fail,52,26,0,10,42
50,Fail,44,24,7,15,29
50,Fail,55,25,0,6,49
50,Fail,36,41,0,16,20
50,Fail,44,29,2,10,34
50,Fail,48,38,0,6,42
50,Fail,49,22,3,10,39
50,Fail,46,35,0,9,37
50,Fail,49,30,0,10,39
50,Fail,48,24,0,18,30
50,Fail,51,29,0,11,40
50,Fail,50,27,2,12,38
50,Fail,45,36,0,14,31
50,Fail,47,22,0,17,30
50,Fail,45,25,6,14,31
50,Fail,50,23,1,14,36
50,Fail,46,16,9,13,33
50,Success,58,24,0,7,51
50,Fail,41,31,0,17,24
50,Fail,52,31,0,11,41
50,Fail,45,27,0,13,32
50,Fail,45,20,7,15,30
50,Fail,47,29,3,8,39
50,Fail,44,29,0,19,25
50,Fail,49,31,0,8,41
50,Fail,46,31,0,13,33
50,Fail,52,20,4,12,40
50,Fail,52,21,3,13,39
50,Fail,52,19,0,13,39
50,Fail,47,31,4,9,38
50,Fail,53,19,5,13,40
50,Fail,48,19,0,18,30
50,Fail,51,17,0,21,30
50,Fail,46,31,0,12,34
50,Fail,49,23,4,15,34
50,Fail,48,26,3,14,34
50,Fail,45,28,3,18,27
50,Fail,50,23,3,11,39
50,Fail,48,27,5,10,38
50,Fail,46,31,4,11,35
50,Fail,38,36,0,16,22
50,Fail,43,33,0,10,33
50,Fail,52,21,3,12,40
50,Fail,52,22,0,11,41
50,Fail,43,34,0,13,30
50,Fail,42,29,0,21,21
50,Fail,52,25,0,14,38
50,Fail,51,19,6,16,35
50,Fail,53,21,4,10,43
50,Fail,44,28,4,12,32
50,Fail,48,29,0,9,39
50,Fail,45,25,2,17,28
50,Fail,49,28,0,10,39
50,Success,57,27,0,7,50
50,Fail,48,25,3,12,36
50,Fail,55,26,0,8,47
50,Fail,43,34,0,13,30
50,Fail,45,26,3,15,30
50,Fail,50,21,2,15,35
50,Fail,50,28,3,6,44
50,Fail,47,27,8,7,40
50,Fail,50,23,0,16,34
50,Fail,47,25,5,10,37
50,Fail,49,21,3,14,35
50,Fail,45,31,0,12,33
50,Fail,56,18,5,11,45
50,Fail,50,31,3,7,43
50,Fail,43,29,9,11,32
50,Fail,47,29,0,9,38
50,Fail,51,21,2,15,36
50,Fail,46,26,4,14,32
50,Fail,57,26,0,9,48
50,Fail,47,32,0,9,38
50,Fail,44,44,0,7,37
50,Fail,52,22,0,13,39
50,Fail,49,33,0,12,37
50,Fail,41,40,0,14,27
50,Fail,53,23,0,14,39
50,Fail,48,27,0,17,31
50,Fail,42,27,9,15,27
50,Fail,49,21,4,17,32
50,Fail,56,20,1,13,43
50,Fail,43,29,0,19,24
50,Fail,46,22,5,13,33
50,Fail,48,21,0,18,30
50,Fail,53,27,0,7,46
50,Fail,48,29,1,9,39
50,Fail,50,27,0,11,39
50,Fail,48,35,2,6,42
50,Fail,51,30,0,7,44
50,Fail,50,31,0,6,44
50,Fail,47,21,8,12,35
50,Fail,41,39,0,14,27
50,Fail,45,29,0,16,29
50,Fail,52,25,0,15,37
50,Fail,46,36,0,12,34
50,Fail,44,32,0,13,31
50,Fail,39,35,0,16,23
50,Fail,47,36,0,10,37
50,Fail,46,23,8,14,32
50,Fail,40,39,0,12,28
50,Fail,53,30,0,9,44
50,Fail,41,24,3,16,25
50,Success,57,30,0,5,52
50,Fail,45,26,0,14,31
50,Fail,37,35,8,12,25
50,Fail,49,26,3,14,35
50,Fail,54,23,7,10,44
50,Fail,47,21,0,17,30
50,Fail,48,28,0,11,37
50,Fail,45,28,0,17,28
50,Fail,49,23,2,14,35
50,Fail,47,25,1,12,35
50,Fail,47,27,4,12,35
50,Fail,52,24,0,9,43
50,Fail,42,36,0,12,30
50,Fail,53,23,0,7,46
50,Fail,50,27,0,14,36
50,Fail,45,26,11,6,39
50,Fail,41,37,0,12,29
50,Fail,49,28,0,11,38
50,Fail,48,22,4,14,34
50,Fail,44,32,0,16,28
50,Fail,47,31,0,9,38
50,Fail,53,26,0,11,42
50,Fail,53,19,0,14,39
50,Fail,50,28,0,8,42
50,Fail,50,28,0,12,38
50,Fail,45,36,0,11,34
50,Fail,54,22,0,12,42
50,Fail,54,20,2,14,40
50,Fail,48,25,0,14,34
50,Fail,45,31,0,9,36
50,Fail,44,34,0,13,31
50,Fail,42,31,1,16,26
50,Fail,50,33,0,9,41
50,Fail,53,22,0,16,37
50,Fail,43,27,7,15,28
50,Fail,47,25,2,15,32
50,Fail,44,27,15,10,34
50,Fail,41,24,3,18,23
50,Fail,41,28,9,16,25
50,Fail,46,40,0,6,40
50,Fail,46,29,0,11,35
50,Fail,46,27,3,14,32
50,Fail,55,22,0,11,44
50,Fail,50,27,2,12,38
50,Fail,45,30,0,13,32
50,Fail,48,28,0,14,34
50,Fail,53,23,3,10,43
50,Fail,45,27,0,18,27
50,Fail,49,27,0,10,39
50,Fail,48,30,0,8,40
50,Fail,47,24,4,16,31
50,Fail,46,26,0,14,32
50,Fail,43,33,0,9,34
50,Fail,48,26,0,13,35
50,Fail,46,32,0,13,33
50,Fail,48,22,4,17,31
50,Fail,44,34,8,7,37
50,Fail,40,26,8,15,25
50,Fail,50,18,1,22,28
50,Fail,52,20,6,12,40
50,Fail,43,34,1,13,30
50,Fail,48,31,8,7,41
50,Fail,48,27,6,12,36
50,Fail,41,33,2,15,26
50,Fail,41,25,8,15,26
50,Fail,44,28,3,13,31
50,Fail,53,30,0,11,42
50,Fail,42,30,11,9,33
50,Fail,43,37,0,13,30
50,Fail,46,27,0,12,34
50,Fail,53,14,2,16,37
50,Fail,49,22,7,12,37
50,Fail,48,27,0,12,36
50,Fail,51,27,0,13,38
50,Fail,39,33,0,18,21
50,Fail,47,23,6,11,36
50,Fail,46,27,3,11,35
50,Fail,57,19,0,12,45
50,Fail,39,41,0,13,26
50,Fail,53,22,0,11,42
50,Fail,50,25,3,13,37
50,Fail,48,29,0,14,34
50,Fail,42,35,0,13,29
50,Fail,44,33,1,13,31
50,Fail,54,22,3,9,45
50,Fail,43,32,0,14,29
50,Fail,49,30,1,8,41
50,Fail,42,35,0,16,26
50,Fail,51,25,0,13,38
50,Fail,48,33,0,10,38
50,Fail,50,21,5,14,36
50,Fail,47,25,5,13,34
50,Fail,49,19,0,21,28
50,Fail,45,31,2,11,34
50,Fail,46,31,1,9,37
50,Fail,43,34,0,11,32
50,Fail,43,39,0,12,31
50,Fail,47,25,0,18,29
50,Fail,49,41,0,3,46
50,Fail,53,22,5,5,48
50,Fail,46,22,0,21,25
50,Fail,51,26,1,9,42
50,Fail,52,23,0,13,39
50,Fail,53,20,0,14,39
50,Fail,43,38,0,10,33
50,Fail,58,15,0,17,41
50,Fail,45,34,0,8,37
50,Fail,47,29,0,9,38
50,Fail,54,28,0,10,44
50,Fail,54,21,0,12,42
50,Fail,51,23,4,14,37
50,Fail,44,32,0,12,32
50,Fail,47,26,8,12,35
50,Fail,41,39,0,11,30
50,Fail,44,27,12,8,36
50,Fail,45,27,8,14,31
50,Fail,51,23,2,12,39
50,Fail,42,26,6,16,26
50,Fail,53,18,2,14,39
50,Fail,50,22,2,17,33
50,Fail,44,39,0,8,36
50,Fail,45,22,0,20,25
50,Fail,47,26,1,13,34
50,Fail,50,27,0,14,36
50,Fail,45,26,7,16,29
50,Fail,55,22,4,10,45
50,Fail,37,30,8,19,18
50,Fail,41,29,0,21,20
50,Fail,44,30,7,10,34
50,Fail,48,26,0,11,37
50,Fail,39,28,9,17,22
50,Fail,43,33,0,13,30
50,Fail,47,32,0,8,39
50,Fail,39,28,5,19,20
50,Fail,41,26,0,24,17
50,Fail,41,26,7,17,24
50,Fail,39,37,5,9,30
50,Fail,42,31,0,16,26
50,Fail,48,23,3,16,32
50,Fail,49,28,2,10,39
50,Fail,42,38,0,13,29
50,Fail,52,25,3,8,44
50,Fail,42,34,0,17,25
50,Fail,49,23,0,16,33
50,Fail,48,17,7,16,32
50,Fail,53,22,1,14,39
50,Fail,57,21,4,9,48
50,Fail,47,21,3,17,30
50,Fail,48,22,4,14,34
50,Fail,50,24,0,13,37
50,Success,62,21,0,5,57
50,Fail,49,27,3,9,40
50,Fail,43,30,0,20,23
50,Fail,46,29,8,11,35
50,Fail,47,25,0,18,29
50,Fail,50,29,8,3,47
50,Success,56,26,0,6,50
50,Fail,46,27,6,13,33
50,Fail,48,29,0,9,39
50,Fail,39,40,6,8,31
50,Fail,54,26,0,10,44
50,Fail,46,25,3,16,30
50,Fail,54,27,0,8,46
50,Fail,48,32,1,9,39
50,Fail,52,21,0,13,39
50,Fail,49,30,1,11,38
50,Fail,48,31,0,10,38
50,Fail,49,27,5,15,34
50,Fail,41,26,9,14,27
50,Fail,50,21,6,10,40
50,Fail,47,31,1,14,33
50,Fail,50,22,4,10,40
50,Fail,54,22,0,11,43
50,Fail,50,33,0,9,41
50,Fail,45,25,1,17,28
50,Fail,54,24,0,8,46
50,Fail,52,22,2,10,42
50,Fail,48,31,0,13,35
50,Fail,45,29,0,9,36
50,Fail,58,16,2,13,45
50,Fail,56,20,3,9,47
50,Fail,49,33,0,11,38
50,Fail,39,44,0,10,29
50,Fail,48,22,1,16,32
50,Fail,43,35,9,6,37
50,Fail,40,35,0,15,25
50,Fail,46,28,8,11,35
50,Fail,55,21,2,12,43
50,Fail,43,41,0,10,33
50,Fail,55,21,3,9,46
50,Fail,52,24,0,16,36
50,Fail,43,28,12,10,33
50,Fail,50,28,0,10,40
50,Success,66,13,0,10,56
50,Fail,42,29,0,16,26
50,Fail,53,26,0,12,41
50,Fail,56,23,0,11,45
50,Fail,44,29,0,18,26
50,Fail,47,26,7,12,35
50,Fail,56,18,2,13,43
50,Fail,50,28,3,9,41
50,Fail,37,38,0,18,19
50,Fail,52,24,0,9,43
50,Fail,49,20,2,11,38
50,Fail,51,28,0,11,40
50,Fail,49,24,3,15,34
50,Fail,40,30,0,16,24
50,Fail,54,22,1,14,40
50,Fail,44,34,1,9,35
50,Fail,52,20,3,13,39
50,Fail,44,36,0,10,34
50,Fail,47,20,5,17,30
50,Fail,49,29,0,10,39
50,Fail,50,22,0,15,35
50,Fail,41,41,0,10,31
50,Fail,49,31,0,12,37
50,Fail,56,22,0,11,45
50,Fail,48,23,5,13,35
50,Fail,49,24,4,14,35
50,Fail,52,22,0,11,41
50,Fail,40,32,0,19,21
50,Fail,36,45,0,12,24
50,Fail,52,18,9,18,34
50,Fail,44,28,4,17,27
50,Fail,55,17,1,14,41
50,Fail,50,22,6,12,38
50,Fail,51,21,6,12,39
50,Fail,48,18,8,15,33
50,Fail,46,31,0,11,35
50,Fail,55,20,1,13,42
50,Fail,52,20,0,15,37
50,Fail,50,20,4,16,34
50,Fail,46,34,0,10,36
50,Fail,44,23,7,19,25
50,Fail,49,26,0,15,34
50,Fail,50,24,2,14,36
50,Fail,45,28,0,16,29
50,Fail,50,23,11,13,37
50,Fail,49,25,1,10,39
50,Fail,48,26,3,13,35
50,Fail,46,19,10,15,31
50,Fail,42,31,1,13,29
50,Fail,51,24,3,10,41
50,Fail,46,31,0,14,32
50,Fail,48,29,0,10,38
50,Fail,54,30,0,11,43
50,Fail,41,33,0,16,25
50,Fail,42,25,3,16,26
50,Fail,46,34,0,13,33
50,Fail,55,16,12,10,45
50,Fail,50,22,1,12,38
50,Fail,48,22,3,11,37
50,Fail,49,20,3,14,35
50,Fail,43,25,6,17,26
50,Fail,54,22,0,13,41
50,Fail,39,31,12,13,26
50,Fail,50,24,5,7,43
50,Fail,51,25,1,9,42
50,Fail,49,22,3,18,31
50,Fail,48,23,3,16,32
50,Fail,46,30,0,14,32
50,Fail,52,20,8,13,39
50,Fail,42,26,0,17,25
50,Fail,48,26,3,13,35
50,Fail,41,22,0,22,19
50,Fail,52,25,1,13,39
50,Fail,55,26,1,8,47
50,Fail,48,32,5,8,40
50,Fail,51,26,0,13,38
50,Fail,48,26,5,11,37
50,Fail,44,37,1,9,35
50,Fail,46,26,0,15,31
50,Fail,53,25,1,11,42
50,Fail,46,28,0,13,33
50,Fail,50,31,2,7,43
50,Fail,53,27,0,12,41
50,Fail,48,28,0,17,31
50,Fail,50,16,3,18,32
50,Fail,52,21,4,16,36
50,Success,59,21,1,7,52
50,Fail,46,25,0,14,32
50,Fail,48,27,0,13,35
50,Fail,53,29,0,5,48
50,Fail,49,24,4,13,36
50,Fail,47,26,6,13,34
50,Fail,50,28,0,10,40
50,Fail,51,23,3,16,35
50,Fail,49,27,0,14,35
50,Fail,55,28,0,11,44
50,Fail,38,32,9,15,23
50,Fail,57,19,0,11,46
50,Fail,51,20,7,13,38
50,Fail,54,21,0,11,43
50,Fail,45,30,0,16,29
50,Fail,49,21,0,15,34
50,Fail,49,32,0,12,37
50,Fail,50,28,0,13,37
50,Fail,51,21,1,15,36
50,Fail,50,22,2,16,34
50,Fail,41,15,6,24,17
50,Fail,54,24,0,10,44
50,Fail,49,22,0,12,37
50,Fail,55,23,2,9,46
50,Fail,49,30,0,12,37
50,Fail,45,25,1,17,28
50,Fail,49,21,4,12,37
50,Fail,41,21,11,20,21
50,Fail,50,18,4,18,32
50,Fail,48,21,8,14,34
50,Fail,44,30,5,12,32
50,Fail,42,34,0,12,30
50,Fail,51,24,0,14,37
50,Fail,44,30,1,13,31
50,Fail,47,25,6,17,30
50,Fail,44,24,6,19,25
50,Fail,51,28,0,10,41
50,Fail,49,25,0,14,35
50,Fail,42,33,0,14,28
50,Fail,44,30,5,12,32
50,Fail,50,31,0,12,38
50,Fail,50,24,0,14,36
50,Fail,52,21,7,13,39
50,Fail,47,23,0,18,29
50,Fail,43,35,0,13,30
50,Fail,43,28,2,17,26
50,Fail,45,37,0,9,36
50,Fail,47,33,0,6,41
50,Fail,47,33,0,12,35
50,Success,57,22,0,4,53
50,Fail,47,31,10,7,40
50,Fail,50,27,2,11,39
50,Fail,49,28,0,11,38
50,Fail,51,20,4,10,41
50,Fail,40,35,0,11,29
50,Fail,47,30,0,12,35
50,Fail,49,21,3,16,33
50,Fail,54,22,0,13,41
50,Fail,51,24,0,14,37
50,Fail,49,25,6,11,38
50,Fail,49,33,0,9,40
50,Fail,50,21,0,16,34
50,Fail,48,29,0,15,33
50,Fail,46,20,2,23,23
50,Fail,51,31,0,8,43
50,Fail,45,28,0,14,31
50,Fail,55,23,0,12,43
50,Fail,41,33,4,14,27
50,Fail,41,35,0,13,28
50,Fail,42,32,0,15,27
50,Fail,45,29,0,11,34
50,Fail,53,22,0,13,40
50,Fail,49,30,0,11,38
50,Fail,44,36,2,7,37
50,Fail,57,15,3,14,43
50,Fail,38,28,10,16,22
50,Fail,52,21,4,13,39
50,Fail,48,27,6,9,39
50,Fail,48,29,3,6,42
50,Fail,45,28,0,16,29
50,Fail,50,29,0,11,39
50,Fail,41,28,11,13,28
50,Fail,47,31,0,10,37
50,Fail,39,36,0,18,21
50,Fail,52,27,2,11,41
50,Fail,55,21,0,10,45
50,Fail,55,25,2,9,46
50,Fail,49,28,0,11,38
50,Fail,49,26,1,12,37
50,Fail,44,25,3,17,27
50,Fail,50,25,1,13,37
50,Fail,44,34,0,16,28
50,Fail,49,22,3,10,39
50,Fail,42,37,0,10,32
50,Fail,46,29,2,15,31
50,Fail,50,24,5,11,39
50,Fail,48,29,0,12,36
50,Fail,43,35,0,15,28
50,Success,59,22,0,9,50
50,Fail,51,27,0,9,42
50,Fail,53,25,0,13,40
50,Fail,54,27,0,5,49
50,Fail,44,24,7,12,32
50,Fail,48,29,0,11,37
50,Fail,51,24,1,11,40
50,Fail,50,30,0,11,39
50,Fail,37,36,0,16,21
50,Fail,52,22,3,11,41
50,Fail,45,34,1,10,35
50,Fail,45,31,10,9,36
50,Fail,56,21,1,8,48
50,Success,59,25,0,7,52
50,Success,56,27,0,5,51
50,Fail,51,20,6,10,41
50,Fail,51,22,1,12,39
50,Fail,48,29,9,8,40
50,Fail,46,31,5,7,39
50,Fail,53,17,0,13,40
50,Fail,42,28,9,15,27
50,Fail,49,27,0,11,38
50,Fail,48,29,2,11,37
50,Fail,45,30,1,13,32
50,Fail,42,36,0,16,26
50,Fail,48,26,0,12,36
50,Fail,50,22,0,15,35
50,Fail,46,28,6,11,35
50,Fail,47,27,0,13,34
50,Fail,41,30,6,13,28
50,Fail,52,21,6,12,40
50,Fail,45,32,0,12,33
50,Fail,39,25,5,21,18
50,Fail,56,25,0,10,46
50,Fail,53,22,2,10,43
50,Fail,48,26,12,10,38
50,Fail,47,31,0,9,38
50,Fail,44,31,0,14,30
50,Fail,43,26,6,14,29
50,Fail,50,26,2,11,39
50,Fail,51,19,0,17,34
50,Fail,49,25,3,13,36
50,Fail,47,29,2,12,35
50,Fail,41,34,0,16,25
50,Fail,54,22,2,13,41
50,Fail,49,27,6,9,40
50,Fail,46,27,0,16,30
50,Fail,52,22,1,15,37
50,Fail,40,38,0,14,26
50,Fail,51,24,2,13,38
50,Fail,54,30,0,8,46
50,Fail,57,19,0,15,42
50,Fail,53,23,10,8,45
50,Fail,51,27,0,13,38
50,Fail,47,30,6,9,38
50,Fail,46,33,0,13,33
50,Fail,52,30,0,8,44
50,Fail,51,24,0,13,38
50,Fail,42,41,0,12,30
50,Fail,42,40,0,12,30
50,Fail,46,23,7,12,34
50,Fail,48,29,0,10,38
50,Fail,48,25,4,9,39
50,Fail,48,28,0,16,32
50,Fail,55,19,0,13,42
50,Fail,48,22,6,15,33
50,Fail,49,28,0,10,39
50,Fail,49,22,9,9,40
50,Fail,44,37,0,10,34
50,Fail,52,22,2,13,39
50,Fail,45,27,4,14,31
50,Fail,47,30,0,12,35
50,Fail,54,25,4,6,48
50,Fail,59,19,0,10,49
50,Fail,45,35,0,9,36
50,Fail,52,27,0,10,42
50,Fail,55,22,1,7,48
50,Fail,51,19,2,14,37
50,Fail,51,22,5,14,37
50,Fail,42,34,0,16,26
50,Fail,41,34,0,14,27
50,Fail,51,28,0,10,41
50,Fail,54,19,2,14,40
50,Fail,41,33,0,16,25
50,Fail,36,36,0,19,17
50,Fail,45,36,0,10,35
50,Fail,47,24,3,16,31
50,Fail,46,23,2,13,33
50,Fail,41,30,11,8,33
50,Fail,50,19,7,13,37
50,Fail,54,21,2,9,45
50,Fail,55,26,1,10,45
50,Fail,52,28,2,7,45
50,Fail,49,24,0,15,34
50,Fail,49,25,2,14,35
50,Fail,47,25,0,17,30
50,Fail,47,29,0,14,33
50,Fail,43,32,0,14,29
50,Fail,41,37,0,11,30
50,Fail,52,30,0,10,42
50,Fail,43,29,0,14,29
50,Fail,47,32,0,5,42
50,Fail,52,27,0,10,42
50,Success,59,22,2,7,52
50,Fail,53,22,1,15,38
50,Fail,54,24,0,12,42
50,Fail,54,16,0,17,37
50,Fail,53,30,0,9,44
50,Fail,45,35,0,9,36
50,Fail,54,27,1,6,48
50,Fail,49,33,0,4,45
50,Fail,49,24,3,14,35
50,Fail,47,24,0,18,29
50,Fail,41,28,0,20,21
50,Fail,47,28,0,14,33
50,Fail,51,29,0,9,42
50,Fail,49,36,0,9,40
50,Fail,48,21,4,14,34
50,Fail,49,20,1,19,30
50,Fail,49,32,0,12,37
50,Fail,42,25,10,10,32
50,Fail,50,27,0,13,37
50,Fail,40,39,0,13,27
50,Fail,47,24,5,11,36
50,Fail,53,31,1,6,47
50,Fail,44,30,0,15,29
50,Fail,44,31,0,16,28
50,Fail,51,24,1,11,40
50,Fail,51,33,0,9,42
50,Fail,44,27,0,18,26
50,Fail,46,32,0,13,33
50,Fail,48,39,0,8,40
50,Fail,50,23,0,14,36
50,Fail,44,34,0,16,28
50,Fail,51,27,0,10,41
50,Fail,45,30,0,14,31
50,Fail,41,31,2,15,26
50,Fail,49,33,0,11,38
50,Fail,40,30,4,16,24
50,Fail,56,19,1,11,45
50,Fail,50,21,3,14,36
50,Fail,43,31,0,14,29
50,Fail,53,29,0,8,45
50,Fail,54,20,4,7,47
50,Fail,45,25,10,16,29
50,Fail,46,32,0,13,33
50,Fail,48,21,7,13,35
50,Fail,45,33,0,14,31
50,Fail,49,28,3,10,39
50,Fail,54,20,2,10,44
50,Fail,49,25,3,10,39
50,Fail,56,17,5,13,43
50,Fail,46,29,0,17,29
50,Fail,53,26,2,8,45
50,Fail,44,29,0,15,29
50,Fail,41,36,0,11,30
50,Fail,46,33,0,11,35
50,Fail,43,33,0,17,26
50,Fail,42,35,0,13,29
50,Fail,51,25,0,11,40
50,Fail,40,36,0,15,25
50,Fail,47,21,6,18,29
50,Fail,47,17,7,18,29
50,Fail,48,32,0,7,41
50,Fail,49,27,0,10,39
50,Fail,49,32,0,9,40
50,Fail,51,26,0,10,41
50,Fail,44,34,0,10,34
50,Fail,50,34,0,8,42
50,Fail,47,33,3,6,41
50,Fail,51,22,1,10,41
50,Fail,48,23,1,12,36
50,Fail,48,29,0,14,34
50,Fail,54,20,1,11,43
50,Fail,53,18,6,15,38
50,Fail,52,21,6,10,42
50,Fail,44,27,1,16,28
50,Fail,53,28,0,10,43
50,Fail,37,34,3,16,21
50,Fail,41,27,5,15,26
50,Fail,50,22,3,12,38
50,Fail,50,32,0,8,42
50,Fail,50,22,0,12,38
50,Fail,50,19,2,18,32
50,Fail,53,21,0,15,38
50,Fail,46,25,0,19,27
50,Fail,56,21,2,11,45
50,Fail,50,26,0,13,37
50,Fail,46,19,3,19,27
50,Fail,51,24,0,12,39
50,Fail,45,38,0,9,36
50,Fail,44,26,6,14,30
50,Fail,46,29,0,15,31
50,Fail,49,27,0,14,35
50,Fail,44,39,0,10,34
50,Fail,43,29,2,15,28
50,Fail,46,33,0,14,32
50,Fail,52,24,0,11,41
50,Fail,44,32,1,11,33
50,Fail,54,27,0,6,48
50,Fail,43,29,1,14,29
50,Fail,48,32,0,14,34
50,Fail,44,29,8,10,34
50,Fail,44,34,0,13,31
50,Fail,49,25,5,14,35
50,Fail,43,30,1,14,29
50,Fail,49,28,2,11,38
50,Fail,50,23,0,15,35
50,Fail,41,34,5,9,32
50,Fail,46,25,3,14,32
50,Fail,52,22,0,12,40
50,Fail,44,33,0,12,32
50,Fail,51,24,5,10,41
50,Fail,55,20,0,13,42
50,Fail,49,25,2,14,35
50,Fail,42,35,0,14,28
50,Fail,52,25,0,6,46
50,Fail,49,29,0,10,39
50,Fail,50,25,0,14,36
50,Fail,45,24,2,18,27
50,Fail,35,34,15,11,24
50,Fail,46,29,0,14,32
50,Fail,51,25,0,12,39
50,Fail,49,28,2,7,42
50,Fail,46,31,0,15,31
50,Success,61,20,0,9,52
50,Fail,43,27,5,12,31
50,Fail,42,29,5,16,26
50,Fail,49,25,0,16,33
50,Fail,49,23,0,14,35
50,Fail,55,19,3,9,46
50,Fail,52,24,0,11,41
50,Fail,50,27,1,10,40
50,Fail,54,19,0,10,44
50,Fail,45,21,6,17,28
50,Fail,41,33,3,14,27
50,Fail,47,27,0,18,29
50,Fail,49,30,0,11,38
50,Fail,58,16,1,11,47
50,Fail,47,29,2,11,36
50,Fail,51,28,0,13,38
50,Fail,50,26,0,13,37
50,Fail,56,20,0,14,42
50,Fail,45,31,0,15,30
50,Fail,47,30,0,10,37
50,Fail,46,35,0,10,36
50,Fail,50,29,0,9,41
50,Fail,39,36,0,13,26
50,Fail,48,30,6,8,40
50,Fail,48,25,0,13,35
50,Fail,48,32,0,8,40
50,Fail,51,25,0,10,41
50,Fail,36,30,0,22,14
50,Fail,46,27,7,12,34
50,Fail,41,28,5,18,23
50,Fail,47,24,2,11,36
50,Fail,52,28,0,7,45
50,Fail,45,26,0,20,25
50,Fail,44,30,0,15,29
50,Fail,50,19,3,15,35
50,Fail,52,26,0,11,41
50,Fail,51,20,0,15,36
50,Fail,50,30,0,11,39
50,Fail,48,30,0,10,38
50,Fail,47,35,0,11,36
50,Fail,48,24,0,19,29
50,Fail,54,23,0,9,45
50,Fail,48,24,3,14,34
50,Fail,44,32,0,17,27
50,Fail,50,26,0,13,37
50,Fail,54,23,2,10,44
50,Fail,51,21,3,17,34
50,Fail,45,22,6,14,31
50,Fail,49,24,0,13,36
50,Fail,50,22,0,14,36
50,Fail,46,27,2,12,34
50,Fail,43,30,8,10,33
50,Fail,48,32,0,11,37
50,Fail,38,44,0,11,27
50,Fail,55,20,2,12,43
50,Fail,41,47,0,7,34
50,Fail,46,30,0,15,31
50,Fail,52,24,4,11,41
50,Fail,49,24,0,12,37
50,Success,60,21,0,6,54
50,Fail,47,23,5,13,34
50,Fail,48,22,6,15,33
50,Fail,45,38,0,9,36
50,Fail,41,44,0,9,32
50,Fail,41,33,0,12,29
50,Fail,49,28,0,13,36
50,Fail,50,33,0,9,41
50,Fail,44,33,0,14,30
50,Fail,53,24,0,9,44
50,Fail,45,34,0,15,30
50,Fail,52,26,5,7,45
50,Fail,49,25,6,13,36
50,Fail,49,31,0,13,36
50,Fail,41,31,0,13,28
50,Fail,48,25,1,15,33
50,Fail,52,20,7,11,41
50,Fail,53,25,0,14,39
50,Fail,43,34,0,16,27
50,Fail,46,28,1,16,30
50,Fail,51,24,9,7,44
50,Fail,56,20,3,10,46
50,Fail,45,39,0,14,31
50,Fail,55,22,3,10,45
50,Fail,58,19,1,13,45
50,Fail,39,27,5,17,22
50,Fail,54,25,3,10,44
50,Fail,48,23,0,13,35
50,Fail,46,32,0,14,32
50,Fail,52,23,6,6,46
50,Fail,42,30,0,19,23
50,Fail,44,33,0,11,33
50,Fail,51,33,0,6,45
50,Fail,51,26,0,13,38
50,Fail,46,33,2,9,37
50,Fail,43,35,0,12,31
50,Fail,51,34,0,6,45
50,Fail,44,35,0,14,30
50,Fail,33,42,0,18,15
50,Fail,40,40,0,8,32
50,Fail,51,30,0,9,42
50,Fail,46,27,5,13,33
50,Fail,45,36,0,10,35
50,Fail,46,31,1,11,35
50,Fail,50,24,1,14,36
50,Fail,42,37,0,14,28
50,Fail,54,19,8,7,47
50,Fail,49,20,3,16,33
50,Fail,44,33,0,13,31
50,Fail,50,26,2,13,37
50,Fail,58,24,1,9,49
50,Fail,45,25,8,13,32
50,Fail,44,29,0,19,25
50,Fail,50,24,2,9,41
50,Fail,49,31,0,11,38
50,Fail,52,28,0,8,44
50,Fail,44,25,1,18,26
50,Fail,46,28,0,12,34
50,Fail,54,21,0,12,42
50,Fail,45,21,1,18,27
50,Fail,44,35,0,15,29
50,Fail,37,31,9,13,24
50,Fail,52,28,0,9,43
50,Fail,40,30,0,18,22
50,Fail,55,21,0,13,42
50,Fail,40,31,6,13,27
50,Fail,49,25,3,11,38
50,Fail,45,30,0,11,34
50,Fail,43,30,0,15,28
50,Fail,46,31,0,13,33
50,Fail,46,24,5,15,31
50,Fail,52,26,0,14,38
50,Fail,46,34,0,13,33
50,Success,58,22,0,7,51
50,Fail,47,19,12,15,32
50,Fail,51,22,2,9,42
50,Fail,44,37,0,11,33
50,Fail,51,23,0,17,34
50,Fail,47,27,0,16,31
50,Fail,42,24,8,15,27
50,Fail,40,35,0,19,21
50,Fail,55,23,0,9,46
50,Fail,51,27,0,11,40
50,Fail,56,19,10,9,47
50,Fail,50,26,0,13,37
50,Fail,47,36,0,13,34
50,Fail,45,26,1,18,27
50,Fail,53,21,0,12,41
50,Fail,43,34,0,17,26
50,Fail,47,28,0,13,34
50,Fail,49,23,6,10,39
50,Fail,49,26,2,13,36
50,Fail,47,24,8,11,36
50,Fail,47,26,4,13,34
50,Fail,54,19,3,13,41
50,Fail,51,19,1,19,32
50,Fail,55,23,2,11,44
50,Fail,45,35,0,9,36
50,Fail,47,21,0,20,27
50,Fail,42,29,6,14,28
50,Fail,45,31,0,11,34
50,Fail,50,21,1,19,31
50,Fail,47,34,1,9,38
50,Fail,49,30,0,6,43
50,Fail,42,31,5,9,33
50,Fail,45,29,0,15,30
50,Fail,52,25,4,9,43
50,Fail,46,25,8,15,31
50,Fail,46,32,0,12,34
50,Fail,46,28,3,17,29
50,Fail,50,28,0,15,35
50,Fail,45,33,0,12,33
50,Fail,44,27,1,16,28
50,Fail,45,35,0,15,30
50,Fail,49,30,0,8,41
50,Fail,46,32,0,13,33
50,Fail,52,20,4,11,41
50,Fail,48,36,0,8,40
50,Fail,48,27,1,13,35
50,Fail,57,24,0,10,47
50,Fail,49,21,0,12,37
50,Fail,49,29,0,11,38
50,Fail,50,34,0,10,40
50,Fail,51,25,2,14,37
50,Fail,54,22,0,12,42
50,Fail,43,32,0,12,31
50,Fail,45,36,0,12,33
50,Fail,48,29,1,9,39
50,Fail,48,24,7,11,37
50,Fail,49,20,0,16,33
50,Fail,39,42,0,10,29
50,Fail,49,31,0,11,38
50,Fail,51,15,9,14,37
50,Fail,48,24,0,18,30
50,Fail,40,29,7,16,24
50,Fail,46,30,2,14,32
50,Fail,47,24,9,10,37
50,Fail,54,22,0,13,41
50,Fail,53,21,0,15,38
50,Fail,52,26,0,11,41
50,Fail,47,28,0,15,32
50,Fail,52,26,5,9,43
50,Fail,50,26,0,13,37
50,Fail,49,24,0,15,34
50,Fail,47,25,5,11,36
50,Fail,46,27,9,11,35
50,Fail,47,30,1,12,35
50,Fail,47,24,5,13,34
50,Fail,52,30,0,10,42
50,Fail,46,32,0,12,34
50,Fail,48,24,5,13,35
50,Fail,45,27,1,16,29
50,Fail,56,20,4,14,42
50,Fail,43,34,0,13,30
50,Fail,51,22,1,13,38
50,Fail,51,20,2,14,37
50,Fail,47,23,0,17,30
50,Fail,47,17,11,19,28
50,Fail,43,32,8,12,31
50,Fail,37,24,18,15,22
50,Fail,51,27,0,9,42
50,Fail,56,24,0,12,44
50,Fail,50,30,0,13,37
50,Fail,48,24,3,15,33
50,Fail,49,25,0,13,36
50,Fail,48,23,2,14,34
50,Fail,59,17,0,15,44
50,Fail,45,30,0,16,29
50,Fail,44,26,0,18,26
50,Fail,44,39,0,12,32
50,Fail,54,19,8,9,45
50,Fail,53,28,0,8,45
50,Fail,42,35,7,8,34
50,Fail,50,33,0,5,45
50,Fail,57,25,0,8,49
50,Success,58,23,0,4,54
50,Fail,45,29,5,11,34
50,Fail,43,28,0,16,27
50,Fail,46,28,1,15,31
50,Fail,29,51,0,12,17
50,Fail,44,24,4,16,28
50,Fail,47,34,0,11,36
50,Fail,41,36,0,12,29
50,Fail,48,26,10,11,37
50,Fail,49,26,0,13,36
50,Fail,50,20,3,12,38
50,Fail,37,39,0,17,20
50,Fail,54,23,0,7,47
50,Fail,47,31,0,12,35
50,Fail,52,30,0,7,45
50,Fail,36,38,2,14,22
50,Fail,45,31,0,13,32
50,Fail,54,25,0,5,49
50,Fail,53,22,1,12,41
50,Fail,38,39,0,19,19
50,Fail,48,35,0,9,39
50,Fail,50,26,0,12,38
50,Fail,50,19,7,12,38
50,Fail,52,31,0,8,44
50,Fail,39,27,4,18,21
50,Fail,48,27,0,15,33
50,Fail,50,29,0,10,40
50,Fail,43,27,6,11,32
50,Fail,43,27,9,13,30
50,Fail,48,27,8,9,39
50,Fail,49,25,4,14,35
50,Fail,47,21,12,15,32
50,Fail,47,21,0,18,29
50,Fail,44,27,9,13,31
50,Fail,48,28,2,10,38
50,Fail,53,24,1,7,46
50,Fail,53,28,0,10,43
50,Fail,48,36,0,9,39
50,Fail,57,19,0,9,48
50,Fail,51,28,3,5,46
50,Fail,45,26,6,14,31
50,Fail,51,19,7,10,41
50,Fail,51,34,0,5,46
50,Fail,51,33,0,8,43
50,Fail,43,29,0,17,26
50,Fail,50,30,7,5,45
50,Fail,52,25,4,9,43
50,Fail,49,28,0,9,40
50,Fail,49,26,0,15,34
50,Fail,41,28,1,18,23
50,Fail,50,23,0,11,39
50,Fail,44,26,1,21,23
50,Fail,54,19,1,14,40
50,Fail,54,23,3,8,46
50,Fail,48,25,3,16,32
50,Fail,39,22,0,24,15
50,Fail,52,26,0,15,37
50,Fail,45,35,0,11,34
50,Fail,44,37,0,7,37
50,Fail,44,29,8,11,33
50,Fail,39,40,0,15,24
50,Fail,48,27,0,13,35
50,Fail,51,26,0,11,40
50,Fail,43,26,9,13,30
50,Fail,45,23,8,18,27
50,Fail,44,32,0,12,32
50,Fail,56,23,0,10,46
50,Fail,54,27,0,9,45
50,Fail,49,26,0,15,34
50,Fail,49,23,2,14,35
50,Fail,41,23,4,22,19
50,Fail,49,29,0,13,36
50,Fail,42,23,13,13,29
50,Fail,45,26,0,19,26
50,Fail,49,21,7,11,38
50,Fail,41,38,0,10,31
50,Fail,43,29,0,17,26
50,Fail,56,22,1,13,43
50,Fail,48,28,1,14,34
50,Fail,44,37,0,11,33
50,Fail,40,32,1,16,24
50,Fail,49,25,2,13,36
50,Fail,51,22,6,15,36
50,Fail,47,27,2,13,34
50,Fail,46,33,2,8,38
50,Fail,37,35,0,19,18
50,Fail,46,29,0,12,34
50,Fail,37,43,0,15,22
50,Fail,44,35,0,14,30
50,Fail,38,35,6,17,21
50,Fail,47,27,0,12,35
50,Fail,48,15,0,22,26
50,Fail,52,24,0,12,40
50,Fail,44,38,0,14,30
50,Fail,45,28,0,14,31
50,Fail,47,24,4,13,34
50,Fail,46,26,9,11,35
50,Fail,53,20,0,13,40
50,Fail,50,23,0,14,36
50,Fail,51,22,0,16,35
50,Fail,55,19,0,11,44
50,Fail,55,24,2,8,47
50,Fail,54,17,5,12,42
50,Fail,50,22,5,12,38
50,Fail,44,37,0,9,35
50,Fail,47,25,0,16,31
50,Fail,46,31,0,16,30
50,Fail,49,25,0,12,37
50,Fail,46,27,0,15,31
50,Fail,43,42,0,6,37
50,Fail,50,21,0,14,36
50,Fail,53,22,0,10,43
50,Fail,40,32,0,21,19
50,Fail,48,34,0,10,38
50,Fail,54,22,0,11,43
50,Fail,51,27,1,8,43
50,Fail,53,26,3,8,45
50,Fail,47,27,8,9,38
50,Fail,48,30,0,10,38
50,Fail,41,33,2,13,28
50,Fail,52,20,0,13,39
50,Fail,52,30,0,6,46
50,Fail,33,33,3,20,13
50,Fail,45,30,3,10,35
50,Fail,55,20,0,16,39
50,Fail,55,18,1,16,39
50,Fail,53,19,2,14,39
50,Fail,40,43,0,11,29
50,Fail,47,28,0,18,29
50,Fail,49,33,0,9,40
50,Fail,46,33,0,8,38
50,Fail,48,34,0,10,38
50,Fail,44,35,0,13,31
50,Fail,46,29,2,7,39
50,Fail,51,24,2,9,42
50,Fail,43,34,0,12,31
50,Fail,47,35,0,12,35
50,Fail,40,43,0,12,28
50,Fail,49,29,1,7,42
50,Fail,49,25,1,17,32
50,Fail,54,29,0,9,45
50,Fail,54,27,4,7,47
50,Fail,51,27,0,11,40
50,Success,59,19,0,7,52
50,Fail,50,31,0,10,40
50,Fail,45,33,0,12,33
50,Fail,49,25,6,11,38
50,Fail,46,28,0,15,31
50,Fail,40,32,9,14,26
50,Fail,44,27,4,13,31
50,Fail,55,18,4,16,39
50,Fail,45,29,0,14,31
50,Fail,52,25,0,14,38
50,Fail,54,23,0,11,43
50,Fail,35,38,10,13,22
50,Fail,48,23,8,7,41
50,Fail,39,34,3,13,26
50,Fail,46,27,6,10,36
50,Fail,53,28,0,10,43
50,Fail,50,32,0,10,40
50,Fail,51,22,0,13,38
50,Fail,42,34,0,14,28
50,Fail,41,25,4,16,25
50,Fail,44,25,0,14,30
50,Fail,36,46,0,13,23
50,Fail,43,41,0,8,35
50,Fail,51,28,3,7,44
50,Fail,55,22,0,14,41
50,Fail,55,28,0,9,46
50,Fail,52,23,5,14,38
50,Fail,44,30,0,14,30
50,Fail,40,29,7,12,28
50,Fail,45,23,1,15,30
50,Fail,57,21,0,11,46
50,Fail,54,30,0,6,48
50,Fail,42,29,0,14,28
50,Fail,45,28,0,18,27
50,Fail,49,27,1,11,38
50,Fail,52,26,0,13,39
50,Fail,43,34,0,15,28
50,Fail,51,27,0,14,37
50,Fail,54,25,4,11,43
50,Fail,47,28,0,14,33
50,Fail,54,28,0,9,45
50,Fail,51,21,7,11,40
50,Fail,39,34,0,15,24
50,Fail,42,35,0,14,28
50,Fail,43,36,0,12,31
50,Fail,48,28,0,14,34
50,Fail,47,24,4,15,32
50,Fail,53,20,1,15,38
50,Fail,48,25,0,17,31
50,Fail,51,23,1,13,38
50,Fail,50,23,3,13,37
50,Fail,47,33,2,8,39
50,Fail,48,26,3,17,31
50,Fail,49,31,0,11,38
50,Fail,43,35,0,13,30
50,Fail,45,22,6,16,29
50,Fail,56,20,3,11,45
50,Fail,44,31,0,16,28
50,Fail,53,28,0,12,41
50,Fail,44,33,4,13,31
50,Fail,56,21,10,8,48
50,Fail,47,28,0,16,31
50,Fail,45,25,6,16,29
50,Fail,46,27,4,10,36
50,Fail,38,36,0,14,24
50,Fail,46,28,3,12,34
50,Fail,51,25,0,7,44
50,Fail,51,24,5,9,42
50,Fail,43,38,0,10,33
50,Fail,45,30,9,10,35
50,Fail,49,27,1,12,37
50,Fail,51,26,5,14,37
50,Fail,47,28,3,11,36
50,Fail,43,32,1,12,31
50,Fail,54,22,0,11,43
50,Fail,48,21,5,15,33
50,Fail,44,28,8,9,35
50,Fail,46,30,6,9,37
50,Fail,56,20,1,11,45
50,Fail,50,23,5,12,38
50,Fail,53,26,0,9,44
50,Fail,48,23,8,13,35
50,Fail,51,26,0,11,40
50,Fail,49,34,0,10,39
50,Fail,48,25,9,7,41
50,Fail,47,33,5,2,45
50,Fail,46,25,2,15,31
50,Fail,53,28,0,7,46
50,Fail,50,23,8,11,39
50,Fail,40,25,6,19,21
50,Fail,48,24,3,15,33
50,Fail,52,23,0,11,41
50,Fail,51,19,10,13,38
50,Fail,44,19,9,18,26
50,Fail,49,32,0,11,38
50,Fail,44,34,1,10,34
50,Fail,58,22,0,9,49
50,Fail,45,32,0,14,31
50,Fail,51,28,0,9,42
50,Fail,51,23,2,11,40
50,Fail,47,24,3,15,32
50,Fail,51,27,0,12,39
50,Fail,46,25,8,9,37
50,Fail,46,19,8,17,29
50,Fail,56,23,0,7,49
50,Fail,45,35,0,15,30
50,Fail,49,25,7,7,42
50,Fail,48,24,1,13,35
50,Fail,49,26,3,11,38
50,Fail,47,26,0,15,32
50,Fail,46,31,0,14,32
50,Fail,49,22,1,16,33
50,Fail,53,19,1,12,41
50,Fail,56,19,2,13,43
50,Fail,50,22,1,14,36
50,Fail,47,28,1,13,34
50,Fail,46,29,0,14,32
50,Fail,52,22,2,11,41
50,Fail,50,24,1,10,40
50,Fail,44,38,0,11,33
50,Fail,46,21,3,17,29
50,Fail,45,31,0,12,33
50,Fail,51,25,0,13,38
50,Fail,50,23,2,13,37
50,Fail,54,16,3,13,41
50,Fail,52,24,0,11,41
50,Fail,39,40,0,15,24
50,Fail,44,29,2,16,28
50,Fail,51,24,7,7,44
50,Fail,52,23,2,13,39
50,Fail,47,25,6,13,34
50,Fail,51,21,0,16,35
50,Fail,51,27,0,15,36
50,Fail,43,27,9,11,32
50,Fail,43,28,2,14,29
50,Fail,45,38,0,9,36
50,Fail,46,27,0,13,33
50,Fail,43,26,2,17,26
50,Fail,46,34,0,11,35
50,Fail,47,29,2,13,34
50,Fail,52,24,0,15,37
50,Fail,44,26,8,14,30
50,Fail,42,27,4,19,23
50,Fail,51,20,4,11,40
50,Fail,35,35,6,16,19
50,Fail,48,28,4,10,38
50,Fail,42,37,0,12,30
50,Fail,43,35,0,13,30
50,Fail,55,29,0,6,49
50,Fail,48,21,3,13,35
50,Fail,49,24,0,13,36
50,Fail,47,27,0,10,37
50,Fail,45,25,0,16,29
50,Fail,48,30,0,12,36
50,Fail,44,28,5,17,27
50,Fail,53,18,1,14,39
50,Fail,42,32,0,14,28
50,Fail,42,32,0,16,26
50,Fail,48,23,7,9,39
50,Fail,52,33,0,7,45
50,Fail,51,21,0,12,39
50,Fail,49,26,3,12,37
50,Fail,40,40,0,10,30
50,Fail,43,37,0,12,31
50,Fail,54,25,5,7,47
50,Fail,49,18,4,17,32
50,Fail,54,27,0,8,46
50,Fail,46,31,2,10,36
50,Success,58,26,1,4,54
50,Fail,54,28,0,8,46
50,Fail,48,22,6,20,28
50,Fail,43,33,0,16,27
50,Fail,51,19,4,14,37
50,Fail,46,30,0,12,34
50,Fail,47,32,0,12,35
50,Fail,44,32,0,14,30
50,Fail,43,38,0,8,35
50,Fail,52,19,4,13,39
50,Fail,47,26,0,16,31
50,Fail,48,28,2,17,31
50,Fail,50,22,4,13,37
50,Fail,43,37,0,9,34
50,Fail,42,28,6,15,27
50,Fail,50,24,0,12,38
50,Fail,46,25,4,12,34
50,Fail,38,33,0,15,23
50,Fail,50,26,0,14,36
50,Fail,50,24,0,12,38
50,Fail,51,20,0,17,34
50,Fail,53,24,0,12,41
50,Fail,52,23,2,11,41
50,Fail,56,25,3,8,48
50,Fail,42,30,0,17,25
50,Fail,49,26,5,12,37
50,Fail,50,30,2,9,41
50,Fail,45,25,9,15,30
50,Fail,45,23,1,18,27
50,Fail,44,39,0,13,31
50,Fail,51,28,0,7,44
50,Fail,46,35,0,8,38
50,Fail,46,24,1,17,29
50,Fail,48,27,0,11,37
50,Fail,52,25,0,12,40
50,Fail,52,33,0,5,47
50,Fail,47,31,0,14,33
50,Fail,45,29,2,16,29
50,Fail,44,28,9,11,33
50,Fail,47,25,2,14,33
50,Fail,46,26,2,16,30
50,Fail,42,33,1,13,29
50,Fail,48,30,1,10,38
50,Fail,49,27,6,8,41
50,Fail,52,24,1,9,43
50,Fail,43,26,9,14,29
50,Fail,50,30,0,11,39
50,Fail,54,18,0,15,39
50,Fail,41,36,0,14,27
50,Fail,50,24,0,14,36
50,Fail,53,19,5,16,37
50,Fail,51,23,4,11,40
50,Fail,49,24,0,14,35
50,Fail,50,30,0,11,39
50,Fail,44,31,0,14,30
50,Fail,45,22,0,19,26
50,Fail,54,18,4,10,44
50,Fail,48,25,0,15,33
50,Fail,40,34,0,16,24
50,Fail,48,34,0,8,40
50,Fail,52,27,0,11,41
50,Fail,45,27,4,11,34
50,Fail,46,31,2,9,37
50,Fail,56,23,6,9,47
50,Fail,51,19,3,11,40
50,Fail,51,23,6,8,43
50,Fail,48,37,0,6,42
50,Fail,50,30,0,12,38
50,Fail,45,21,8,15,30
50,Success,56,27,1,5,51
50,Fail,42,31,0,14,28
50,Fail,46,22,0,16,30
50,Fail,49,28,0,14,35
50,Fail,49,25,1,12,37
50,Fail,48,25,2,14,34
50,Fail,53,24,0,11,42
50,Fail,51,32,6,4,47
50,Fail,45,26,1,14,31
50,Fail,46,27,5,10,36
50,Fail,51,18,3,16,35
50,Fail,44,27,4,14,30
50,Fail,48,25,3,12,36
50,Fail,50,24,2,13,37
50,Fail,57,23,0,11,46
50,Fail,48,24,0,16,32
50,Fail,48,29,1,11,37
50,Fail,47,24,0,17,30
50,Fail,51,26,4,9,42
50,Fail,46,29,1,13,33
50,Fail,50,24,0,13,37
50,Fail,55,22,0,11,44
50,Fail,52,26,0,11,41
50,Fail,44,30,0,15,29
50,Fail,47,29,0,14,33
50,Fail,46,23,5,11,35
50,Fail,48,25,8,9,39
50,Fail,42,35,0,12,30
50,Fail,46,31,0,13,33
50,Fail,52,25,0,15,37
50,Fail,50,26,0,12,38
50,Fail,47,25,5,14,33
50,Fail,47,23,10,9,38
50,Fail,39,42,0,12,27
50,Fail,43,33,0,14,29
50,Fail,47,28,0,10,37
50,Fail,42,25,5,20,22
50,Success,61,19,0,10,51
50,Fail,46,19,6,21,25
50,Fail,52,29,0,8,44
50,Fail,44,31,3,14,30
50,Fail,41,30,0,17,24
50,Fail,52,25,6,10,42
50,Fail,45,28,0,16,29
50,Fail,54,25,0,7,47
50,Fail,49,26,0,13,36
50,Fail,51,20,0,14,37
50,Fail,45,24,7,17,28
50,Fail,44,28,3,10,34
50,Fail,48,23,8,12,36
50,Fail,50,20,0,21,29
50,Fail,58,12,2,15,43
50,Fail,42,32,0,17,25
50,Fail,45,32,0,10,35
50,Fail,51,25,5,8,43
50,Fail,44,26,6,13,31
50,Fail,57,18,6,10,47
50,Fail,48,20,6,14,34
50,Fail,48,29,0,16,32
50,Fail,49,26,0,12,37
50,Fail,54,14,0,19,35
50,Fail,50,24,3,10,40
50,Fail,51,28,0,11,40
50,Fail,49,23,3,14,35
50,Fail,48,33,0,12,36
50,Fail,36,41,0,13,23
50,Fail,41,27,2,20,21
50,Fail,44,33,0,16,28
50,Fail,44,32,6,7,37
50,Fail,39,32,7,13,26
50,Fail,48,25,6,14,34
50,Fail,49,27,1,12,37
50,Fail,50,22,0,15,35
50,Fail,49,22,6,12,37
50,Fail,42,29,0,15,27
50,Success,63,19,1,7,56
50,Fail,48,29,7,8,40
50,Fail,47,31,0,12,35
50,Fail,52,24,0,7,45
50,Fail,51,29,0,11,40
50,Fail,50,20,6,13,37
50,Success,57,26,0,7,50
50,Fail,47,25,7,12,35
50,Fail,47,30,0,12,35
50,Fail,39,28,0,21,18
50,Fail,46,30,5,13,33
50,Fail,48,26,4,10,38
50,Fail,50,26,0,12,38
50,Fail,46,31,0,14,32
50,Fail,47,33,0,9,38
50,Fail,52,27,0,10,42
50,Fail,48,27,0,17,31
50,Fail,46,30,2,10,36
50,Fail,52,22,2,15,37
50,Success,54,31,0,4,50
50,Fail,49,35,0,10,39
50,Fail,48,33,0,7,41
50,Fail,48,22,0,16,32
50,Fail,45,22,5,16,29
50,Fail,48,21,2,15,33
50,Fail,48,24,1,14,34
50,Fail,39,30,17,9,30
50,Fail,46,34,0,12,34
50,Fail,47,29,0,13,34
50,Fail,50,24,2,11,39
50,Fail,46,25,8,8,38
50,Fail,44,27,11,11,33
50,Fail,45,27,0,16,29
50,Fail,36,35,0,18,18
50,Fail,44,25,4,19,25
50,Fail,41,35,0,14,27
50,Fail,46,25,9,17,29
50,Fail,41,31,9,11,30
50,Fail,39,30,2,15,24
50,Fail,49,24,1,13,36
50,Fail,41,33,0,16,25
50,Fail,53,29,0,9,44
50,Fail,40,35,0,13,27
50,Fail,43,30,0,14,29
50,Fail,48,32,1,11,37
50,Fail,44,21,7,17,27
50,Fail,48,21,7,13,35
50,Fail,34,35,2,16,18
50,Fail,43,33,0,14,29
50,Fail,47,29,0,15,32
50,Fail,55,27,6,6,49
50,Fail,46,23,0,19,27
50,Fail,43,27,8,15,28
50,Fail,51,22,0,16,35
50,Fail,51,28,0,12,39
50,Fail,52,21,3,13,39
50,Fail,52,17,3,13,39
50,Fail,51,31,0,12,39
50,Fail,50,30,0,12,38
50,Fail,48,27,2,13,35
50,Fail,49,25,2,14,35
50,Fail,53,29,0,12,41
50,Fail,44,28,3,10,34
50,Fail,45,40,0,7,38
50,Fail,49,27,0,10,39
50,Fail,47,23,0,14,33
50,Fail,47,25,6,11,36
50,Fail,55,24,0,12,43
50,Fail,45,20,8,18,27
50,Fail,42,29,0,18,24
50,Fail,44,26,0,15,29
50,Fail,52,22,4,11,41
50,Fail,48,24,1,16,32
50,Fail,47,26,3,17,30
50,Fail,53,27,4,7,46
50,Fail,47,25,4,14,33
50,Fail,46,24,6,15,31
50,Fail,39,39,0,13,26
50,Fail,48,24,2,15,33
50,Fail,41,47,0,7,34
50,Fail,43,26,2,19,24
50,Fail,47,32,9,7,40
50,Fail,43,31,2,14,29
50,Fail,44,33,2,8,36
50,Fail,55,21,0,9,46
50,Fail,46,31,0,12,34
50,Fail,41,31,7,10,31
50,Fail,53,22,0,14,39
50,Fail,45,32,0,9,36
50,Fail,44,33,0,16,28
50,Fail,53,23,2,12,41
50,Fail,48,24,0,15,33
50,Fail,50,27,0,11,39
50,Fail,38,28,13,16,22
50,Fail,41,20,13,17,24
50,Fail,54,25,0,10,44
50,Fail,52,21,0,15,37
50,Fail,50,22,0,13,37
50,Fail,51,21,0,12,39
50,Fail,46,33,0,12,34
50,Fail,47,28,0,13,34
50,Fail,44,32,5,11,33
50,Fail,53,25,0,12,41
50,Fail,51,19,0,16,35
50,Fail,45,30,1,15,30
50,Fail,56,24,0,8,48
50,Fail,46,27,1,12,34
50,Fail,42,33,0,16,26
50,Fail,38,32,3,16,22
50,Fail,43,39,0,9,34
50,Fail,48,23,0,17,31
50,Fail,43,34,5,6,37
50,Fail,48,27,5,11,37
50,Fail,43,31,0,21,22
50,Fail,49,28,0,12,37
50,Fail,45,29,0,17,28
50,Fail,50,27,0,10,40
50,Fail,56,22,0,11,45
50,Fail,37,26,5,17,20
50,Fail,52,26,0,11,41
50,Fail,50,27,0,15,35
50,Fail,41,33,0,14,27
50,Fail,53,17,5,14,39
50,Fail,44,36,0,13,31
50,Fail,55,21,3,9,46
50,Fail,45,29,0,15,30
50,Fail,52,29,4,8,44
50,Success,61,22,0,6,55
50,Fail,51,27,0,8,43
50,Fail,51,28,2,10,41
50,Fail,45,22,6,19,26
50,Fail,46,25,9,14,32
50,Fail,45,37,0,9,36
50,Fail,52,32,0,8,44
50,Fail,45,31,0,17,28
50,Fail,40,33,6,13,27
50,Fail,45,27,6,11,34
50,Fail,41,30,0,18,23
50,Fail,48,30,1,9,39
50,Fail,49,30,0,11,38
50,Fail,44,31,0,14,30
50,Fail,55,15,4,13,42
50,Fail,39,27,6,16,23
50,Fail,42,39,0,10,32
50,Fail,50,25,0,12,38
50,Fail,52,17,2,15,37
50,Fail,44,35,0,9,35
50,Fail,49,27,1,11,38
50,Fail,39,41,0,11,28
50,Fail,50,19,6,15,35
50,Success,66,17,0,7,59
50,Fail,54,18,2,11,43
50,Fail,38,28,9,16,22
50,Fail,54,17,0,17,37
50,Fail,54,19,1,14,40
50,Success,60,20,0,10,50
50,Fail,42,29,0,14,28
50,Fail,46,25,2,18,28
50,Fail,44,21,8,14,30
50,Fail,48,30,0,11,37
50,Fail,50,26,0,14,36
50,Fail,49,25,0,17,32
50,Fail,48,24,1,11,37
50,Fail,51,21,2,15,36
50,Fail,48,29,0,8,40
50,Fail,51,28,0,12,39
50,Fail,47,31,0,14,33
50,Fail,46,27,2,14,32
50,Fail,43,31,0,12,31
50,Fail,53,24,0,12,41
50,Fail,50,23,1,10,40
50,Fail,54,27,2,8,46
50,Fail,47,26,6,11,36
50,Fail,50,25,0,13,37
50,Fail,47,27,0,13,34
50,Fail,50,26,1,9,41
50,Fail,46,27,3,11,35
50,Fail,47,29,0,14,33
50,Fail,46,28,2,13,33
50,Fail,51,29,0,9,42
50,Fail,54,21,0,11,43
50,Fail,37,37,4,11,26
50,Fail,49,24,1,13,36
50,Fail,47,34,0,11,36
50,Fail,55,27,1,7,48
50,Fail,50,28,0,13,37
50,Fail,47,29,0,14,33
50,Fail,48,20,5,17,31
50,Fail,42,34,0,13,29
50,Fail,51,30,0,9,42
50,Fail,49,25,10,9,40
50,Fail,45,30,0,14,31
50,Fail,46,24,6,13,33
50,Fail,49,28,0,14,35
50,Fail,53,32,0,10,43
50,Fail,53,22,0,11,42
50,Fail,56,17,1,14,42
50,Fail,48,21,2,16,32
50,Fail,47,30,0,11,36
50,Fail,46,30,0,14,32
50,Fail,48,25,3,11,37
50,Fail,48,22,8,13,35
50,Fail,56,22,0,10,46
50,Fail,45,28,5,14,31
50,Fail,37,35,0,20,17
50,Fail,51,29,0,6,45
50,Fail,61,15,4,13,48
50,Fail,40,34,0,17,23
50,Fail,44,34,0,13,31
50,Fail,46,30,0,13,33
50,Fail,50,26,3,9,41
50,Fail,38,47,0,7,31
50,Fail,47,23,7,13,34
50,Fail,47,22,0,19,28
50,Fail,53,20,0,13,40
50,Fail,47,24,2,12,35
50,Fail,37,34,18,8,29
50,Fail,55,24,0,10,45
50,Fail,45,29,0,19,26
50,Fail,51,26,3,9,42
50,Fail,48,28,6,11,37
50,Fail,55,26,1,9,46
50,Fail,43,37,0,13,30
50,Fail,40,31,6,11,29
50,Fail,47,26,0,17,30
50,Fail,49,23,4,8,41
50,Fail,50,21,3,15,35
50,Fail,49,21,0,17,32
50,Fail,49,27,1,13,36
50,Fail,53,29,0,5,48
50,Fail,49,28,4,10,39
50,Fail,42,28,8,11,31
50,Fail,46,31,0,10,36
50,Fail,50,28,0,11,39
50,Fail,43,31,0,16,27
50,Fail,51,21,0,16,35
50,Fail,52,19,2,16,36
50,Fail,53,27,0,12,41
50,Fail,46,25,4,13,33
50,Fail,49,23,5,12,37
50,Fail,48,29,0,11,37
50,Fail,46,27,0,18,28
50,Fail,43,31,5,11,32
50,Fail,47,28,5,12,35
50,Fail,44,38,0,10,34
50,Fail,49,30,0,14,35
50,Fail,47,31,0,13,34
50,Fail,46,27,2,14,32
50,Fail,42,30,6,12,30
50,Fail,46,29,0,16,30
50,Fail,46,29,0,14,32
50,Fail,45,28,0,11,34
50,Fail,42,17,11,21,21
50,Fail,45,20,12,15,30
50,Fail,50,26,6,9,41
50,Fail,51,29,0,11,40
50,Fail,46,32,0,12,34
50,Fail,51,30,0,11,40
50,Fail,48,28,3,8,40
50,Fail,49,25,2,15,34
50,Fail,54,23,5,12,42
50,Fail,48,24,6,15,33
50,Fail,46,24,8,13,33
50,Fail,47,29,0,16,31
50,Fail,43,28,4,14,29
50,Fail,49,23,6,9,40
50,Fail,48,23,0,14,34
50,Fail,45,25,5,13,32
50,Fail,47,27,2,12,35
50,Fail,50,24,6,10,40
50,Fail,47,30,0,11,36
50,Fail,46,23,2,16,30
50,Fail,50,29,0,15,35
50,Fail,47,28,7,10,37
50,Fail,46,29,0,10,36
50,Fail,43,31,0,15,28
50,Fail,45,33,0,10,35
50,Fail,38,31,4,19,19
50,Fail,45,27,0,21,24
50,Fail,50,26,0,12,38
50,Fail,52,24,0,11,41
50,Fail,52,16,1,14,38
50,Fail,44,29,1,18,26
50,Fail,44,40,0,9,35
50,Fail,51,25,2,12,39
50,Fail,39,39,0,14,25
50,Fail,49,30,0,9,40
50,Fail,53,13,3,18,35
50,Fail,49,24,4,12,37
50,Fail,55,20,1,16,39
50,Fail,49,23,0,14,35
50,Fail,52,22,0,16,36
50,Fail,44,33,0,14,30
50,Fail,43,31,1,16,27
50,Fail,40,34,9,11,29
50,Fail,51,27,0,12,39
50,Fail,47,35,0,4,43
50,Fail,45,28,5,11,34
50,Fail,48,25,2,13,35
50,Fail,45,32,0,12,33
50,Fail,44,28,2,14,30
50,Fail,49,27,5,10,39
50,Fail,51,23,4,11,40
50,Fail,55,25,0,9,46
50,Fail,55,16,0,15,40
50,Fail,46,28,1,14,32
50,Fail,50,28,5,9,41
50,Fail,46,28,4,9,37
50,Fail,48,34,0,8,40
50,Fail,46,35,0,9,37
50,Fail,51,23,3,12,39
50,Fail,41,33,0,14,27
50,Fail,40,36,0,13,27
50,Fail,47,27,2,8,39
50,Fail,45,31,5,10,35
50,Fail,51,14,2,17,34
50,Fail,49,28,0,11,38
50,Fail,53,22,6,8,45
50,Fail,45,35,0,11,34
50,Fail,49,30,0,12,37
50,Fail,42,36,0,12,30
50,Fail,51,29,0,12,39
50,Fail,44,26,2,17,27
50,Fail,47,30,0,10,37
50,Fail,45,27,2,14,31
50,Fail,56,21,3,11,45
50,Fail,53,23,0,12,41
50,Fail,45,29,2,9,36
50,Fail,58,25,0,10,48
50,Fail,50,19,3,17,33
50,Fail,46,30,2,15,31
50,Fail,52,28,1,9,43
50,Fail,43,26,0,17,26
50,Fail,44,29,0,15,29
50,Success,60,17,0,10,50
50,Fail,49,22,4,13,36
50,Fail,47,29,1,13,34
50,Fail,43,36,0,12,31
50,Fail,54,26,0,10,44
50,Fail,56,16,5,13,43
50,Fail,53,20,0,12,41
50,Fail,50,18,5,15,35
50,Fail,56,21,4,12,44
50,Fail,43,34,0,12,31
50,Fail,56,24,0,9,47
50,Fail,50,23,5,12,38
50,Fail,53,25,8,6,47
50,Fail,48,22,8,12,36
50,Fail,42,24,2,19,23
50,Fail,53,25,1,12,41
50,Fail,53,29,0,10,43
50,Fail,44,29,9,9,35
50,Fail,54,16,2,17,37
50,Fail,47,28,2,13,34
50,Fail,44,31,0,12,32
50,Fail,52,25,0,13,39
50,Fail,44,35,0,11,33
50,Fail,47,31,0,11,36
50,Fail,43,34,0,12,31
50,Fail,43,35,0,14,29
50,Fail,51,24,0,8,43
50,Fail,41,34,0,10,31
50,Fail,49,19,0,16,33
50,Fail,46,35,1,12,34
50,Fail,43,22,0,21,22
50,Fail,49,27,2,12,37
50,Fail,55,26,0,11,44
50,Fail,50,21,0,13,37
50,Fail,51,16,8,17,34
50,Fail,50,29,0,9,41
50,Fail,51,18,0,20,31
50,Fail,37,35,2,16,21
50,Fail,46,29,0,13,33
50,Fail,45,26,4,15,30
50,Fail,47,30,0,10,37
50,Fail,49,23,4,15,34
50,Fail,47,25,7,14,33
50,Fail,54,27,0,11,43
50,Fail,53,23,4,8,45
50,Fail,55,28,4,7,48
50,Fail,48,33,0,13,35
50,Fail,49,26,0,16,33
50,Fail,38,41,0,12,26
50,Fail,45,35,0,12,33
50,Fail,39,35,0,17,22
50,Fail,56,24,0,11,45
60,Fail,45,32,0,16,29
60,Fail,53,26,0,11,42
60,Fail,52,26,4,9,43
60,Fail,47,27,6,11,36
60,Fail,43,27,8,15,28
60,Fail,48,26,2,11,37
60,Fail,54,23,0,13,41
60,Fail,53,28,0,12,41
60,Fail,51,27,0,12,39
60,Fail,55,23,0,9,46
60,Fail,47,38,0,9,38
60,Fail,43,39,0,13,30
60,Fail,43,19,13,19,24
60,Fail,49,19,7,12,37
60,Fail,54,25,1,9,45
60,Fail,42,34,0,15,27
60,Fail,37,36,6,13,24
60,Fail,53,29,0,9,44
60,Fail,52,22,0,16,36
60,Fail,56,21,1,10,46
60,Fail,39,22,8,18,21
60,Fail,60,24,4,5,55
60,Fail,47,22,0,19,28
60,Fail,49,36,0,9,40
60,Fail,41,24,7,17,24
60,Fail,46,26,0,20,26
60,Fail,51,26,6,10,41
60,Fail,50,29,0,12,38
60,Fail,51,20,5,15,36
60,Fail,52,26,0,8,44
60,Fail,49,26,0,9,40
60,Fail,52,26,0,14,38
60,Fail,47,25,0,14,33
60,Fail,45,27,10,12,33
60,Fail,55,21,2,9,46
60,Fail,55,15,6,10,45
60,Fail,40,36,0,14,26
60,Fail,51,22,0,12,39
60,Fail,36,41,0,16,20
60,Fail,51,24,0,12,39
60,Fail,59,12,2,14,45
60,Fail,47,24,1,18,29
60,Fail,50,28,0,11,39
60,Fail,50,28,0,11,39
60,Fail,37,31,7,14,23
60,Fail,47,33,0,11,36
60,Fail,49,24,3,14,35
60,Fail,53,27,0,10,43
60,Fail,50,23,2,13,37
60,Fail,48,29,0,12,36
60,Fail,46,26,0,10,36
60,Fail,52,29,0,9,43
60,Fail,51,31,0,10,41
60,Fail,46,22,3,14,32
60,Fail,47,27,2,10,37
60,Fail,55,17,0,16,39
60,Fail,52,24,0,10,42
60,Fail,47,26,0,15,32
60,Fail,54,33,0,5,49
60,Fail,41,30,0,14,27
60,Fail,44,23,0,17,27
60,Fail,55,21,0,11,44
60,Fail,48,29,0,14,34
60,Fail,53,20,1,15,38
60,Fail,45,30,1,16,29
60,Fail,51,29,0,11,40
60,Fail,48,26,0,14,34
60,Fail,52,25,1,11,41
60,Fail,54,20,2,14,40
60,Fail,52,23,0,13,39
60,Fail,48,27,5,11,37
60,Fail,50,24,0,13,37
60,Fail,50,26,2,11,39
60,Fail,51,25,6,8,43
60,Fail,49,23,1,17,32
60,Fail,42,37,0,9,33
60,Fail,51,26,1,12,39
60,Fail,44,26,8,16,28
60,Fail,50,21,1,18,32
60,Fail,48,23,6,10,38
60,Fail,47,34,0,8,39
60,Fail,39,39,0,14,25
60,Fail,49,30,1,6,43
60,Fail,40,31,2,18,22
60,Fail,53,25,0,9,44
60,Fail,50,24,0,15,35
60,Fail,53,19,4,13,40
60,Fail,50,19,0,17,33
60,Fail,49,25,0,17,32
60,Fail,46,31,0,12,34
60,Fail,48,27,0,12,36
60,Fail,52,28,0,11,41
60,Fail,52,20,1,12,40
60,Fail,41,31,0,15,26
60,Fail,58,15,9,11,47
60,Fail,52,22,1,14,38
60,Fail,49,23,4,14,35
60,Fail,59,26,0,7,52
60,Fail,51,31,0,9,42
60,Fail,43,29,0,18,25
60,Fail,50,22,5,11,39
60,Fail,42,29,0,15,27
60,Fail,52,21,8,11,41
60,Fail,49,28,0,11,38
60,Fail,52,25,0,10,42
60,Fail,47,25,0,17,30
60,Fail,48,29,0,8,40
60,Fail,53,21,0,11,42
60,Fail,48,23,6,14,34
60,Fail,43,29,0,11,32
60,Fail,42,24,14,15,27
60,Fail,56,28,1,7,49
60,Fail,40,33,0,18,22
60,Fail,43,38,0,12,31
60,Fail,45,31,0,16,29
60,Fail,54,24,2,11,43
60,Fail,48,17,6,18,30
60,Fail,39,23,4,22,17
60,Fail,54,25,5,9,45
60,Fail,46,26,0,14,32
60,Fail,43,36,0,13,30
60,Fail,47,33,1,7,40
60,Fail,47,29,0,15,32
60,Fail,48,32,0,10,38
60,Fail,48,24,4,13,35
60,Fail,48,21,2,17,31
60,Fail,52,22,1,16,36
60,Fail,46,27,1,17,29
60,Fail,54,29,0,6,48
60,Fail,43,37,0,11,32
60,Fail,45,34,0,13,32
60,Fail,50,26,5,7,43
60,Fail,49,24,5,13,36
60,Fail,45,27,7,11,34
60,Fail,49,23,6,14,35
60,Fail,43,22,0,19,24
60,Fail,47,28,0,14,33
60,Fail,58,20,3,11,47
60,Fail,49,27,2,11,38
60,Fail,39,19,15,18,21
60,Fail,50,24,0,14,36
60,Fail,53,25,0,13,40
60,Fail,43,25,0,18,25
60,Fail,52,22,0,14,38
60,Fail,46,29,4,9,37
60,Fail,42,24,9,17,25
60,Fail,50,22,7,11,39
60,Fail,55,23,2,12,43
60,Fail,38,30,3,18,20
60,Fail,52,25,0,13,39
60,Fail,44,36,0,12,32
60,Fail,46,24,4,16,30
60,Fail,41,34,0,15,26
60,Fail,48,29,0,15,33
60,Fail,54,20,3,14,40
60,Fail,47,28,0,16,31
60,Fail,44,27,3,13,31
60,Fail,47,22,11,10,37
60,Fail,52,21,1,11,41
60,Fail,47,21,0,16,31
60,Fail,52,25,0,14,38
60,Fail,40,25,7,18,22
60,Fail,54,21,0,13,41
60,Fail,46,31,5,10,36
60,Fail,37,35,8,12,25
60,Fail,51,33,0,9,42
60,Fail,48,21,7,12,36
60,Fail,47,24,3,12,35
60,Fail,52,21,2,10,42
60,Fail,46,26,0,13,33
60,Fail,46,31,0,11,35
60,Fail,48,31,0,11,37
60,Fail,39,37,0,15,24
60,Fail,52,23,0,14,38
60,Fail,48,32,0,12,36
60,Fail,51,27,0,12,39
60,Fail,54,24,0,11,43
60,Fail,51,28,0,11,40
60,Fail,54,25,0,11,43
60,Fail,49,22,6,10,39
60,Fail,57,22,0,9,48
60,Fail,46,23,0,14,32
60,Fail,51,26,1,10,41
60,Fail,37,45,0,12,25
60,Fail,44,31,0,13,31
60,Fail,43,25,3,20,23
60,Fail,49,32,0,8,41
60,Fail,48,28,0,19,29
60,Fail,43,31,4,8,35
60,Fail,47,28,0,13,34
60,Fail,55,27,0,11,44
60,Fail,54,21,0,9,45
60,Fail,55,17,2,12,43
60,Fail,47,24,6,13,34
60,Fail,59,20,0,6,53
60,Fail,47,31,2,9,38
60,Fail,50,27,0,11,39
60,Fail,47,24,5,12,35
60,Fail,53,32,0,5,48
60,Fail,51,21,2,13,38
60,Fail,44,30,0,18,26
60,Fail,44,29,0,13,31
60,Fail,44,25,2,18,26
60,Fail,49,35,4,7,42
60,Fail,52,18,3,18,34
60,Fail,47,25,12,11,36
60,Fail,47,26,3,14,33
60,Fail,48,23,7,10,38
60,Fail,41,22,13,16,25
60,Fail,51,21,0,16,35
60,Fail,46,27,2,11,35
60,Fail,45,29,0,15,30
60,Fail,42,32,1,14,28
60,Fail,54,23,3,7,47
60,Fail,46,27,9,8,38
60,Fail,42,21,5,20,22
60,Fail,52,26,1,11,41
60,Fail,50,26,0,11,39
60,Fail,47,33,0,13,34
60,Fail,48,27,0,15,33
60,Fail,48,33,0,7,41
60,Fail,47,35,0,7,40
60,Fail,46,28,0,16,30
60,Fail,46,30,0,14,32
60,Fail,46,25,8,13,33
60,Fail,52,25,0,14,38
60,Fail,45,31,2,14,31
60,Fail,48,28,12,8,40
60,Fail,46,24,4,12,34
60,Fail,51,25,0,11,40
60,Fail,50,30,1,10,40
60,Fail,48,28,2,12,36
60,Fail,49,31,0,9,40
60,Fail,52,23,2,11,41
60,Fail,41,31,0,15,26
60,Fail,47,35,0,7,40
60,Fail,51,29,0,10,41
60,Fail,46,27,3,14,32
60,Fail,54,22,3,11,43
60,Fail,35,49,0,11,24
60,Fail,51,22,0,12,39
60,Fail,53,19,10,10,43
60,Fail,45,28,8,9,36
60,Fail,52,24,4,10,42
60,Fail,49,31,0,7,42
60,Fail,47,40,0,8,39
60,Fail,51,20,4,13,38
60,Fail,52,27,0,13,39
60,Fail,39,27,5,18,21
60,Fail,50,29,0,12,38
60,Fail,56,15,5,16,40
60,Fail,48,22,0,15,33
60,Fail,44,31,5,13,31
60,Fail,47,29,0,15,32
60,Fail,54,29,5,7,47
60,Fail,47,29,0,11,36
60,Fail,52,29,0,7,45
60,Fail,49,31,0,10,39
60,Fail,47,26,4,12,35
60,Fail,52,27,0,7,45
60,Fail,52,20,5,12,40
60,Fail,48,25,5,12,36
60,Fail,43,28,0,18,25
60,Fail,50,32,0,9,41
60,Fail,47,25,0,15,32
60,Fail,48,27,2,14,34
60,Fail,39,41,0,13,26
60,Fail,42,29,0,16,26
60,Fail,46,35,0,12,34
60,Fail,59,18,1,10,49
60,Fail,50,22,5,9,41
60,Fail,56,22,2,10,46
60,Fail,50,27,4,9,41
60,Fail,46,27,7,10,36
60,Fail,51,32,0,9,42
60,Fail,52,20,2,13,39
60,Fail,44,27,8,11,33
60,Fail,49,27,0,10,39
60,Fail,53,24,3,10,43
60,Fail,47,23,3,14,33
60,Fail,55,25,3,9,46
60,Fail,59,23,3,5,54
60,Fail,58,20,1,9,49
60,Fail,31,44,0,16,15
60,Fail,48,28,0,13,35
60,Fail,60,15,0,11,49
60,Fail,43,26,12,15,28
60,Fail,48,23,6,11,37
60,Fail,48,20,5,17,31
60,Fail,42,33,2,15,27
60,Fail,51,26,0,15,36
60,Fail,44,30,0,15,29
60,Fail,48,23,6,12,36
60,Fail,47,29,0,11,36
60,Fail,49,24,10,8,41
60,Fail,48,30,0,12,36
60,Fail,54,18,1,12,42
60,Fail,42,27,9,12,30
60,Fail,46,27,0,17,29
60,Fail,47,28,6,7,40
60,Fail,44,35,0,13,31
60,Fail,51,24,0,13,38
60,Fail,51,27,1,10,41
60,Fail,52,23,1,13,39
60,Fail,52,23,0,14,38
60,Fail,48,23,3,16,32
60,Fail,50,23,0,16,34
60,Fail,50,26,0,12,38
60,Fail,37,34,5,11,26
60,Fail,52,29,0,10,42
60,Fail,52,29,0,9,43
60,Fail,46,31,0,11,35
60,Fail,40,28,3,20,20
60,Fail,43,33,0,15,28
60,Fail,44,26,12,12,32
60,Fail,56,22,2,9,47
60,Fail,49,30,0,10,39
60,Fail,42,31,0,14,28
60,Fail,45,20,2,26,19
60,Fail,54,25,0,9,45
60,Fail,50,27,0,14,36
60,Fail,43,36,0,10,33
60,Fail,51,18,5,13,38
60,Fail,47,29,0,15,32
60,Fail,42,23,10,15,27
60,Fail,44,27,4,17,27
60,Fail,44,24,6,17,27
60,Fail,45,27,1,17,28
60,Fail,47,29,9,9,38
60,Fail,43,33,0,15,28
60,Fail,52,26,6,7,45
60,Fail,47,25,0,13,34
60,Fail,45,34,0,14,31
60,Fail,53,21,6,10,43
60,Fail,54,23,0,13,41
60,Fail,53,26,0,11,42
60,Fail,41,32,0,16,25
60,Fail,51,20,3,11,40
60,Fail,41,17,7,24,17
60,Fail,48,29,0,13,35
60,Fail,51,24,0,14,37
60,Fail,46,28,2,11,35
60,Fail,47,26,3,11,36
60,Fail,36,37,10,12,24
60,Fail,53,24,4,10,43
60,Fail,47,35,0,9,38
60,Fail,53,25,1,9,44
60,Fail,54,21,4,11,43
60,Fail,50,27,0,13,37
60,Fail,44,27,0,19,25
60,Fail,48,27,3,10,38
60,Fail,42,38,0,14,28
60,Fail,53,21,0,11,42
60,Fail,50,29,0,12,38
60,Fail,47,30,5,8,39
60,Fail,47,26,0,16,31
60,Fail,47,27,0,11,36
60,Fail,47,29,0,12,35
60,Fail,48,21,4,16,32
60,Fail,55,25,0,9,46
60,Fail,41,33,0,16,25
60,Fail,44,28,6,13,31
60,Fail,44,27,7,10,34
60,Fail,49,21,0,15,34
60,Fail,53,25,1,11,42
60,Fail,46,30,0,16,30
60,Fail,43,26,3,19,24
60,Fail,47,32,2,9,38
60,Fail,56,25,0,9,47
60,Fail,51,22,0,10,41
60,Fail,47,30,0,11,36
60,Fail,45,40,0,9,36
60,Fail,42,29,8,13,29
60,Fail,52,24,5,11,41
60,Fail,51,24,0,11,40
60,Fail,47,25,0,18,29
60,Fail,48,25,4,10,38
60,Fail,55,24,0,12,43
60,Fail,53,24,2,9,44
60,Fail,41,36,0,14,27
60,Fail,49,33,0,10,39
60,Fail,44,30,10,10,34
60,Fail,38,30,14,13,25
60,Fail,40,29,10,15,25
60,Fail,43,34,10,11,32
60,Fail,49,26,6,9,40
60,Fail,40,28,6,15,25
60,Fail,39,31,0,17,22
60,Fail,59,13,0,18,41
60,Fail,44,28,1,18,26
60,Fail,53,20,4,14,39
60,Fail,48,26,2,12,36
60,Fail,51,33,0,7,44
60,Fail,49,23,3,14,35
60,Fail,46,24,4,16,30
60,Fail,47,27,2,14,33
60,Fail,54,18,1,16,38
60,Fail,60,20,0,10,50
60,Fail,48,28,6,5,43
60,Fail,45,35,0,8,37
60,Fail,44,27,2,16,28
60,Fail,46,21,1,18,28
60,Fail,47,27,0,15,32
60,Fail,51,30,0,10,41
60,Fail,47,26,0,17,30
60,Fail,48,24,4,12,36
60,Fail,52,21,0,14,38
60,Fail,46,24,0,17,29
60,Fail,49,24,5,15,34
60,Fail,52,24,2,11,41
60,Fail,52,18,9,11,41
60,Fail,48,33,0,9,39
60,Fail,47,28,2,13,34
60,Fail,43,28,0,20,23
60,Fail,43,33,3,10,33
60,Fail,48,32,0,11,37
60,Fail,46,27,11,13,33
60,Fail,51,15,3,16,35
60,Fail,49,32,0,8,41
60,Fail,49,26,7,10,39
60,Fail,53,20,0,18,35
60,Fail,55,16,0,12,43
60,Fail,54,21,0,13,41
60,Fail,51,25,1,10,41
60,Fail,36,35,10,9,27
60,Fail,47,22,0,19,28
60,Fail,45,25,1,16,29
60,Fail,56,21,1,12,44
60,Fail,56,21,3,9,47
60,Fail,51,25,1,13,38
60,Fail,45,36,0,12,33
60,Fail,46,30,0,14,32
60,Fail,52,29,4,10,42
60,Fail,40,37,0,12,28
60,Fail,46,27,0,16,30
60,Fail,49,21,0,15,34
60,Fail,43,33,4,14,29
60,Fail,46,25,6,10,36
60,Fail,50,27,0,12,38
60,Fail,53,27,0,11,42
60,Fail,50,22,1,13,37
60,Fail,41,29,9,16,25
60,Fail,48,30,0,15,33
60,Fail,51,28,4,8,43
60,Fail,46,27,0,15,31
60,Fail,47,35,0,11,36
60,Fail,44,35,0,10,34
60,Fail,47,32,0,11,36
60,Fail,47,31,0,9,38
60,Fail,54,18,7,12,42
60,Fail,43,25,10,14,29
60,Fail,46,26,0,15,31
60,Fail,46,30,7,10,36
60,Fail,50,32,0,8,42
60,Fail,53,23,1,9,44
60,Fail,45,27,5,13,32
60,Fail,44,34,0,13,31
60,Fail,47,21,9,11,36
60,Fail,44,32,0,16,28
60,Fail,48,23,5,15,33
60,Fail,56,18,1,11,45
60,Fail,50,26,0,16,34
60,Fail,54,24,0,11,43
60,Fail,46,25,2,15,31
60,Fail,47,24,0,14,33
60,Fail,47,24,7,8,39
60,Fail,47,26,0,9,38
60,Fail,47,32,0,11,36
60,Fail,46,26,0,16,30
60,Fail,55,19,3,8,47
60,Fail,49,15,10,14,35
60,Fail,50,29,0,10,40
60,Fail,49,20,3,15,34
60,Fail,52,29,1,9,43
60,Fail,49,27,0,12,37
60,Fail,45,28,1,16,29
60,Fail,57,21,1,13,44
60,Fail,43,23,13,15,28
60,Fail,53,20,0,14,39
60,Fail,48,31,1,10,38
60,Fail,52,20,8,11,41
60,Fail,40,30,8,11,29
60,Fail,40,27,7,17,23
60,Fail,47,25,0,21,26
60,Fail,50,22,0,16,34
60,Fail,47,28,0,10,37
60,Fail,54,29,0,6,48
60,Fail,51,27,0,12,39
60,Fail,39,27,7,18,21
60,Fail,45,26,4,16,29
60,Fail,38,45,0,8,30
60,Fail,49,20,9,12,37
60,Fail,45,31,0,12,33
60,Fail,54,21,0,9,45
60,Fail,51,19,0,17,34
60,Fail,51,24,0,13,38
60,Fail,54,20,0,13,41
60,Fail,53,28,0,8,45
60,Fail,41,22,7,23,18
60,Fail,45,32,5,10,35
60,Fail,43,27,5,16,27
60,Fail,44,30,3,14,30
60,Fail,49,25,6,9,40
60,Fail,46,27,5,14,32
60,Fail,49,24,4,9,40
60,Fail,51,18,4,18,33
60,Fail,49,23,1,16,33
60,Fail,51,24,0,13,38
60,Fail,50,29,0,9,41
60,Fail,46,25,0,18,28
60,Fail,50,23,0,13,37
60,Fail,48,24,7,11,37
60,Fail,47,32,0,13,34
60,Fail,39,34,5,10,29
60,Fail,42,25,12,14,28
60,Fail,48,23,4,18,30
60,Fail,57,19,0,15,42
60,Fail,46,30,2,12,34
60,Fail,46,24,2,15,31
60,Fail,53,25,0,12,41
60,Fail,46,24,0,16,30
60,Fail,48,29,0,13,35
60,Fail,53,25,3,6,47
60,Fail,55,24,1,8,47
60,Fail,53,20,12,9,44
60,Fail,52,25,3,8,44
60,Fail,51,27,0,11,40
60,Fail,49,27,0,11,38
60,Fail,45,29,0,14,31
60,Fail,47,27,1,12,35
60,Fail,43,31,0,15,28
60,Fail,42,31,2,13,29
60,Fail,44,28,2,13,31
60,Fail,43,23,4,15,28
60,Fail,49,27,0,14,35
60,Fail,47,31,0,14,33
60,Fail,54,23,1,10,44
60,Fail,47,35,0,12,35
60,Fail,46,28,2,14,32
60,Fail,53,24,1,11,42
60,Fail,46,32,0,10,36
60,Fail,53,18,5,15,38
60,Fail,48,21,2,17,31
60,Fail,47,34,0,12,35
60,Fail,43,34,0,15,28
60,Fail,43,32,1,13,30
60,Fail,52,18,8,13,39
60,Fail,49,25,4,11,38
60,Fail,41,36,0,12,29
60,Fail,51,28,4,11,40
60,Fail,51,31,0,6,45
60,Fail,48,35,0,8,40
60,Fail,39,35,0,14,25
60,Fail,44,27,0,18,26
60,Fail,44,32,5,10,34
60,Fail,41,30,12,8,33
60,Fail,42,26,8,11,31
60,Fail,51,30,0,9,42
60,Fail,51,29,0,13,38
60,Fail,54,16,3,16,38
60,Fail,44,25,3,16,28
60,Fail,42,35,0,14,28
60,Fail,47,24,0,16,31
60,Fail,37,42,0,14,23
60,Fail,53,20,3,12,41
60,Fail,52,20,3,14,38
60,Fail,49,29,0,14,35
60,Fail,46,24,3,14,32
60,Fail,49,25,0,13,36
60,Fail,42,31,0,12,30
60,Fail,51,24,2,9,42
60,Fail,46,30,0,14,32
60,Fail,40,30,7,14,26
60,Fail,51,30,0,12,39
60,Fail,51,23,3,11,40
60,Fail,42,24,7,16,26
60,Fail,44,24,11,14,30
60,Fail,54,21,6,8,46
60,Fail,40,30,8,14,26
60,Fail,49,28,5,9,40
60,Fail,56,19,0,12,44
60,Fail,50,26,0,13,37
60,Fail,47,27,3,12,35
60,Fail,48,27,0,13,35
60,Fail,49,16,4,16,33
60,Fail,49,28,0,12,37
60,Fail,47,21,2,16,31
60,Fail,49,21,0,16,33
60,Fail,55,21,0,12,43
60,Fail,47,32,0,12,35
60,Fail,46,32,0,9,37
60,Fail,44,32,0,15,29
60,Fail,40,38,0,11,29
60,Fail,52,28,0,9,43
60,Fail,45,28,0,15,30
60,Fail,49,28,0,13,36
60,Fail,50,19,2,12,38
60,Fail,53,16,3,18,35
60,Fail,44,30,0,14,30
60,Fail,49,26,0,15,34
60,Fail,51,22,1,14,37
60,Fail,54,21,0,15,39
60,Fail,54,23,0,11,43
60,Fail,51,23,0,15,36
60,Fail,44,33,0,11,33
60,Fail,44,31,0,13,31
60,Fail,52,23,5,10,42
60,Fail,47,30,0,15,32
60,Fail,42,36,0,13,29
60,Fail,51,25,0,15,36
60,Fail,48,24,2,18,30
60,Fail,43,36,0,10,33
60,Fail,33,43,0,16,17
60,Fail,44,32,0,15,29
60,Fail,41,29,4,15,26
60,Fail,48,20,4,15,33
60,Fail,39,27,6,19,20
60,Fail,52,25,3,9,43
60,Fail,50,28,0,10,40
60,Fail,54,25,0,11,43
60,Fail,52,27,0,8,44
60,Fail,53,20,7,10,43
60,Fail,54,19,5,9,45
60,Fail,42,28,11,14,28
60,Fail,49,26,6,9,40
60,Fail,42,35,11,5,37
60,Fail,47,21,6,14,33
60,Fail,48,23,4,14,34
60,Fail,47,23,1,14,33
60,Fail,53,27,0,10,43
60,Fail,57,23,0,9,48
60,Fail,48,25,11,6,42
60,Fail,42,28,0,17,25
60,Fail,53,19,3,16,37
60,Fail,47,17,9,19,28
60,Fail,44,32,0,10,34
60,Fail,44,24,0,19,25
60,Fail,43,27,1,12,31
60,Fail,44,35,0,8,36
60,Fail,39,38,0,11,28
60,Fail,45,25,4,15,30
60,Fail,36,37,0,21,15
60,Fail,45,29,0,14,31
60,Fail,52,23,0,12,40
60,Fail,53,28,1,9,44
60,Fail,49,26,0,17,32
60,Fail,51,24,4,8,43
60,Fail,47,28,5,12,35
60,Fail,52,30,0,11,41
60,Fail,45,28,0,15,30
60,Fail,43,38,0,12,31
60,Fail,49,31,3,6,43
60,Fail,53,34,0,8,45
60,Fail,50,29,0,9,41
60,Fail,53,24,0,8,45
60,Fail,46,35,0,10,36
60,Fail,53,24,0,8,45
60,Fail,42,24,7,17,25
60,Fail,49,29,0,9,40
60,Fail,55,27,0,9,46
60,Fail,50,26,6,10,40
60,Fail,50,23,0,17,33
60,Fail,44,30,0,18,26
60,Fail,49,23,0,18,31
60,Fail,53,19,5,13,40
60,Fail,57,16,1,18,39
60,Fail,43,30,4,13,30
60,Fail,48,25,2,15,33
60,Fail,45,36,0,12,33
60,Fail,51,22,0,12,39
60,Fail,47,26,0,17,30
60,Fail,59,17,2,11,48
60,Fail,51,29,1,9,42
60,Fail,45,37,0,9,36
60,Fail,49,22,1,15,34
60,Fail,47,31,2,12,35
60,Fail,47,26,0,13,34
60,Fail,40,46,0,8,32
60,Fail,48,25,6,10,38
60,Fail,43,39,0,9,34
60,Fail,54,24,0,9,45
60,Fail,48,20,0,18,30
60,Fail,41,33,0,13,28
60,Fail,39,31,6,16,23
60,Fail,49,22,7,13,36
60,Fail,48,26,4,12,36
60,Fail,47,28,0,14,33
60,Fail,48,34,0,10,38
60,Fail,45,27,0,14,31
60,Fail,52,23,4,10,42
60,Fail,45,32,0,13,32
60,Fail,47,28,0,11,36
60,Fail,51,26,0,11,40
60,Fail,49,29,2,9,40
60,Fail,55,19,0,15,40
60,Fail,46,22,4,14,32
60,Fail,54,19,8,11,43
60,Fail,50,23,9,8,42
60,Fail,47,20,3,17,30
60,Fail,51,30,0,8,43
60,Fail,46,23,4,13,33
60,Fail,52,25,0,9,43
60,Fail,47,31,2,10,37
60,Fail,52,27,2,7,45
60,Fail,47,39,0,8,39
60,Fail,42,27,8,15,27
60,Fail,41,34,0,13,28
60,Fail,53,20,0,15,38
60,Fail,46,30,0,15,31
60,Fail,41,39,0,15,26
60,Fail,44,27,6,19,25
60,Fail,45,31,0,11,34
60,Fail,50,24,0,16,34
60,Fail,54,20,4,13,41
60,Fail,45,29,0,15,30
60,Fail,45,30,0,15,30
60,Fail,46,25,0,14,32
60,Fail,47,27,1,10,37
60,Fail,46,32,5,8,38
60,Fail,52,25,2,11,41
60,Fail,43,31,6,11,32
60,Fail,49,20,8,13,36
60,Fail,57,25,0,13,44
60,Fail,51,30,0,8,43
60,Fail,52,23,2,13,39
60,Fail,46,36,0,13,33
60,Fail,46,29,6,12,34
60,Fail,46,35,0,10,36
60,Fail,40,36,0,11,29
60,Fail,42,35,0,12,30
60,Fail,42,27,8,16,26
60,Fail,49,28,0,16,33
60,Fail,45,20,12,15,30
60,Fail,48,20,7,12,36
60,Fail,49,25,0,15,34
60,Fail,48,29,0,10,38
60,Fail,59,19,1,8,51
60,Fail,45,32,0,16,29
60,Fail,35,43,0,13,22
60,Fail,45,31,3,12,33
60,Fail,53,29,1,8,45
60,Fail,51,26,0,10,41
60,Fail,46,30,0,9,37
60,Fail,55,21,0,8,47
60,Fail,45,27,1,15,30
60,Fail,57,26,1,3,54
60,Fail,49,26,0,13,36
60,Fail,53,24,0,16,37
60,Fail,43,27,6,12,31
60,Fail,54,19,1,17,37
60,Fail,43,35,0,13,30
60,Fail,44,34,0,12,32
60,Fail,44,28,0,16,28
60,Fail,46,25,5,13,33
60,Fail,49,23,0,17,32
60,Fail,49,29,0,6,43
60,Fail,50,24,1,12,38
60,Fail,49,34,0,12,37
60,Fail,52,21,3,12,40
60,Fail,47,22,9,14,33
60,Fail,50,30,0,10,40
60,Fail,45,38,0,7,38
60,Fail,43,25,2,15,28
60,Fail,49,33,0,11,38
60,Fail,42,30,1,14,28
60,Fail,47,29,2,12,35
60,Fail,38,31,0,20,18
60,Fail,50,25,1,14,36
60,Fail,52,26,0,15,37
60,Fail,51,24,3,13,38
60,Fail,46,30,0,12,34
60,Fail,47,31,0,10,37
60,Fail,47,19,7,20,27
60,Fail,49,25,4,15,34
60,Fail,59,19,0,9,50
60,Fail,48,29,0,15,33
60,Fail,45,35,0,11,34
60,Fail,41,33,0,15,26
60,Fail,47,21,7,14,33
60,Fail,49,22,4,12,37
60,Fail,44,40,0,10,34
60,Fail,45,25,3,16,29
60,Fail,45,26,7,14,31
60,Fail,44,35,0,13,31
60,Fail,47,26,0,17,30
60,Fail,53,25,0,9,44
60,Fail,48,24,6,14,34
60,Fail,50,24,3,14,36
60,Fail,50,26,0,10,40
60,Fail,47,27,0,13,34
60,Fail,44,20,7,19,25
60,Fail,43,24,2,19,24
60,Fail,44,30,1,13,31
60,Fail,40,31,0,17,23
60,Fail,45,32,0,12,33
60,Fail,48,21,3,15,33
60,Fail,42,32,3,15,27
60,Fail,43,31,0,13,30
60,Fail,46,27,0,13,33
60,Fail,51,31,0,7,44
60,Fail,50,27,5,10,40
60,Fail,51,23,0,12,39
60,Fail,37,31,3,18,19
60,Fail,42,33,0,14,28
60,Fail,47,15,7,19,28
60,Fail,47,26,0,14,33
60,Fail,55,22,2,10,45
60,Fail,53,16,4,14,39
60,Fail,48,29,0,16,32
60,Fail,47,24,7,15,32
60,Fail,50,23,1,12,38
60,Fail,47,26,5,12,35
60,Fail,50,30,0,10,40
60,Fail,48,29,2,10,38
60,Fail,45,30,5,12,33
60,Fail,49,31,0,6,43
60,Fail,50,21,1,15,35
60,Fail,49,23,2,14,35
60,Fail,46,24,5,19,27
60,Fail,49,23,3,14,35
60,Fail,50,27,2,11,39
60,Fail,60,14,0,14,46
60,Fail,54,22,0,12,42
60,Fail,46,27,0,18,28
60,Fail,50,26,4,12,38
60,Fail,54,23,0,12,42
60,Fail,51,22,9,8,43
60,Fail,52,30,0,8,44
60,Fail,45,31,9,7,38
60,Fail,51,26,0,15,36
60,Fail,50,23,0,13,37
60,Fail,51,28,0,12,39
60,Fail,51,33,0,6,45
60,Fail,56,23,1,8,48
60,Fail,49,20,8,13,36
60,Fail,45,31,3,16,29
60,Fail,53,17,3,14,39
60,Fail,48,30,2,7,41
60,Fail,49,29,0,16,33
60,Fail,51,29,0,7,44
60,Fail,46,39,0,7,39
60,Fail,49,21,5,14,35
60,Fail,47,33,0,8,39
60,Fail,49,28,4,10,39
60,Fail,48,29,2,9,39
60,Fail,48,21,5,17,31
60,Fail,56,27,0,7,49
60,Fail,55,20,0,13,42
60,Fail,54,25,0,8,46
60,Fail,46,26,0,14,32
60,Fail,42,23,9,15,27
60,Fail,46,25,2,14,32
60,Fail,55,18,0,13,42
60,Fail,46,36,1,10,36
60,Fail,55,17,0,15,40
60,Fail,43,25,7,13,30
60,Fail,48,32,0,10,38
60,Fail,42,32,0,14,28
60,Fail,43,22,11,12,31
60,Fail,46,36,0,15,31
60,Fail,43,27,5,17,26
60,Fail,54,24,7,5,49
60,Fail,53,23,0,12,41
60,Fail,44,27,8,13,31
60,Fail,48,29,1,13,35
60,Fail,43,27,0,17,26
60,Fail,49,30,0,12,37
60,Fail,48,28,0,13,35
60,Fail,37,38,0,18,19
60,Fail,55,23,0,12,43
60,Fail,51,28,0,10,41
60,Fail,40,29,4,17,23
60,Fail,48,31,0,12,36
60,Fail,47,24,2,13,34
60,Fail,45,30,0,14,31
60,Fail,41,23,8,17,24
60,Fail,48,24,0,20,28
60,Fail,56,24,0,11,45
60,Fail,49,23,0,14,35
60,Fail,50,36,0,7,43
60,Fail,47,26,8,13,34
60,Fail,54,23,1,10,44
60,Fail,48,20,1,15,33
60,Fail,51,34,0,6,45
60,Fail,60,21,1,7,53
60,Fail,42,34,0,15,27
60,Fail,56,22,4,8,48
60,Fail,56,24,0,8,48
60,Fail,50,25,2,12,38
60,Fail,47,27,9,8,39
60,Fail,48,33,2,6,42
60,Fail,45,24,5,17,28
60,Fail,48,24,0,16,32
60,Fail,58,19,1,10,48
60,Fail,48,23,5,11,37
60,Fail,46,33,6,6,40
60,Fail,49,24,1,12,37
60,Fail,49,25,0,14,35
60,Fail,45,27,3,13,32
60,Fail,54,24,1,10,44
60,Fail,46,27,9,7,39
60,Fail,44,33,0,15,29
60,Fail,51,26,0,9,42
60,Fail,52,29,4,7,45
60,Fail,52,27,0,10,42
60,Fail,51,24,0,13,38
60,Fail,43,36,0,11,32
60,Fail,46,26,3,9,37
60,Fail,53,21,3,9,44
60,Fail,42,32,3,12,30
60,Fail,46,32,0,14,32
60,Fail,49,27,2,9,40
60,Fail,44,34,0,8,36
60,Fail,48,19,3,14,34
60,Fail,50,28,0,9,41
60,Fail,59,21,1,8,51
60,Fail,45,19,8,20,25
60,Fail,52,20,3,13,39
60,Fail,48,22,1,18,30
60,Fail,55,26,2,8,47
60,Fail,48,28,0,13,35
60,Fail,50,28,0,13,37
60,Fail,49,28,4,9,40
60,Fail,44,30,8,12,32
60,Fail,51,30,3,7,44
60,Fail,42,27,6,18,24
60,Fail,42,32,0,12,30
60,Fail,44,33,0,12,32
60,Fail,61,22,0,6,55
60,Fail,49,25,0,14,35
60,Fail,43,39,0,8,35
60,Fail,45,28,1,14,31
60,Fail,55,17,5,12,43
60,Fail,49,25,0,13,36
60,Fail,48,26,7,10,38
60,Fail,42,25,8,16,26
60,Fail,47,27,2,13,34
60,Fail,40,29,6,16,24
60,Fail,50,19,5,13,37
60,Fail,53,19,0,16,37
60,Fail,50,30,0,10,40
60,Fail,47,30,3,9,38
60,Fail,46,34,0,11,35
60,Fail,48,31,0,12,36
60,Fail,55,21,0,13,42
60,Fail,48,26,0,18,30
60,Fail,54,23,5,8,46
60,Fail,47,20,3,14,33
60,Fail,49,31,9,5,44
60,Fail,46,34,0,12,34
60,Fail,40,31,10,14,26
60,Fail,51,21,0,14,37
60,Fail,44,28,6,11,33
60,Fail,48,25,2,14,34
60,Fail,50,30,0,8,42
60,Fail,50,24,3,13,37
60,Fail,43,29,6,13,30
60,Fail,46,30,2,11,35
60,Fail,51,21,7,10,41
60,Fail,44,29,0,15,29
60,Fail,43,28,5,14,29
60,Fail,41,22,6,21,20
60,Fail,45,29,0,14,31
60,Fail,48,28,0,12,36
60,Fail,58,20,1,11,47
60,Fail,49,21,8,12,37
60,Fail,49,23,0,16,33
60,Fail,42,27,5,14,28
60,Fail,52,22,0,19,33
60,Fail,43,32,0,14,29
60,Fail,52,27,0,10,42
60,Fail,49,25,0,11,38
60,Fail,48,19,10,14,34
60,Fail,49,24,7,8,41
60,Fail,45,24,8,15,30
60,Fail,47,25,2,16,31
60,Fail,54,20,0,14,40
60,Fail,57,23,0,9,48
60,Fail,47,31,1,11,36
60,Fail,51,25,0,15,36
60,Fail,51,24,0,10,41
60,Fail,40,35,0,13,27
60,Fail,43,28,0,18,25
60,Fail,46,29,0,15,31
60,Fail,39,31,6,17,22
60,Fail,47,23,4,16,31
60,Fail,48,26,0,13,35
60,Fail,50,24,0,15,35
60,Fail,57,21,2,12,45
60,Fail,50,21,4,12,38
60,Fail,49,27,2,9,40
60,Fail,49,30,4,7,42
60,Fail,46,28,2,13,33
60,Fail,48,27,0,13,35
60,Fail,44,25,4,14,30
60,Fail,40,32,6,13,27
60,Fail,51,22,10,11,40
60,Fail,53,28,0,8,45
60,Fail,44,33,0,10,34
60,Fail,48,27,8,9,39
60,Fail,46,31,0,17,29
60,Fail,55,27,0,7,48
60,Fail,46,25,1,15,31
60,Fail,47,26,7,11,36
60,Fail,46,30,0,13,33
60,Fail,49,22,0,15,34
60,Fail,48,20,1,15,33
60,Fail,45,23,2,17,28
60,Fail,51,28,0,13,38
60,Fail,51,22,7,12,39
60,Fail,50,25,1,15,35
60,Fail,45,27,0,14,31
60,Fail,43,34,0,15,28
60,Fail,51,21,6,10,41
60,Fail,50,30,0,8,42
60,Fail,55,19,1,9,46
60,Fail,52,26,0,10,42
60,Fail,53,23,1,10,43
60,Fail,43,27,0,19,24
60,Fail,49,32,0,10,39
60,Fail,45,24,6,13,32
60,Fail,46,29,6,9,37
60,Fail,42,29,1,18,24
60,Fail,43,33,2,12,31
60,Fail,50,28,1,8,42
60,Fail,55,28,0,6,49
60,Fail,42,28,3,14,28
60,Fail,43,26,2,17,26
60,Fail,49,29,0,10,39
60,Fail,45,28,1,15,30
60,Fail,48,31,0,10,38
60,Fail,51,30,3,7,44
60,Fail,50,21,8,14,36
60,Fail,51,26,0,12,39
60,Fail,50,28,0,11,39
60,Fail,47,28,6,9,38
60,Fail,49,24,0,17,32
60,Fail,49,21,0,19,30
60,Fail,40,29,0,22,18
60,Fail,35,37,0,18,17
60,Fail,50,31,0,12,38
60,Fail,42,32,0,16,26
60,Fail,47,32,2,9,38
60,Fail,56,27,0,9,47
60,Fail,53,26,2,9,44
60,Fail,44,29,0,16,28
60,Fail,48,22,0,16,32
60,Fail,44,34,0,12,32
60,Fail,45,32,0,10,35
60,Fail,44,35,0,11,33
60,Fail,51,28,0,13,38
60,Fail,47,29,4,10,37
60,Fail,48,29,5,10,38
60,Fail,51,23,0,16,35
60,Fail,54,20,4,11,43
60,Fail,54,22,0,12,42
60,Fail,41,25,10,14,27
60,Fail,45,22,6,15,30
60,Fail,51,22,3,12,39
60,Fail,55,28,1,7,48
60,Fail,50,29,0,9,41
60,Fail,37,29,10,18,19
60,Fail,46,30,0,11,35
60,Fail,54,18,1,14,40
60,Fail,52,29,0,11,41
60,Fail,44,27,3,8,36
60,Fail,45,27,9,11,34
60,Fail,51,29,0,12,39
60,Fail,52,25,1,10,42
60,Fail,42,18,10,17,25
60,Fail,48,24,3,16,32
60,Fail,51,26,0,13,38
60,Fail,47,19,4,16,31
60,Fail,53,27,0,10,43
60,Fail,41,35,0,14,27
60,Fail,46,28,4,8,38
60,Fail,50,23,2,11,39
60,Fail,43,17,10,19,24
60,Fail,48,26,5,10,38
60,Fail,45,27,1,15,30
60,Fail,44,36,0,13,31
60,Fail,48,23,4,11,37
60,Fail,43,29,6,13,30
60,Fail,38,30,2,17,21
60,Fail,56,27,2,6,50
60,Fail,51,29,0,11,40
60,Fail,43,28,0,14,29
60,Fail,37,38,3,12,25
60,Fail,46,30,2,10,36
60,Fail,49,32,0,10,39
60,Fail,35,37,0,17,18
60,Fail,57,23,0,12,45
60,Fail,57,21,4,10,47
60,Fail,46,23,0,18,28
60,Fail,50,29,0,13,37
60,Fail,51,26,0,13,38
60,Fail,47,33,0,9,38
60,Fail,39,36,0,12,27
60,Fail,50,27,0,11,39
60,Fail,52,24,2,9,43
60,Fail,45,37,0,11,34
60,Fail,50,24,4,17,33
60,Fail,50,31,0,8,42
60,Fail,47,28,2,13,34
60,Fail,55,21,1,13,42
60,Fail,42,23,7,16,26
60,Fail,49,20,5,16,33
60,Fail,45,31,0,12,33
60,Fail,43,36,2,9,34
60,Fail,52,22,2,12,40
60,Fail,49,22,1,14,35
60,Fail,37,41,0,11,26
60,Fail,47,27,0,12,35
60,Fail,37,35,0,20,17
60,Fail,55,23,0,11,44
60,Fail,43,34,0,17,26
60,Fail,42,32,5,9,33
60,Fail,40,38,0,11,29
60,Fail,51,25,7,9,42
60,Fail,54,23,0,14,40
60,Fail,50,27,0,14,36
60,Fail,47,31,0,10,37
60,Fail,44,25,7,13,31
60,Fail,47,26,3,13,34
60,Fail,50,35,0,6,44
60,Fail,45,21,5,17,28
60,Fail,47,25,6,10,37
60,Fail,52,24,6,8,44
60,Fail,55,20,1,8,47
60,Fail,51,22,0,14,37
60,Fail,51,25,0,11,40
60,Fail,49,25,0,17,32
60,Fail,44,34,0,8,36
60,Fail,48,32,0,13,35
60,Fail,49,26,0,12,37
60,Fail,43,26,4,15,28
60,Fail,50,25,3,12,38
60,Fail,42,32,0,16,26
60,Fail,50,25,0,12,38
60,Fail,41,42,0,9,32
60,Fail,47,29,3,13,34
60,Fail,47,29,0,10,37
60,Fail,52,25,9,7,45
60,Fail,46,23,2,16,30
60,Fail,51,23,0,15,36
60,Fail,52,24,0,11,41
60,Fail,51,25,0,11,40
60,Fail,50,24,0,16,34
60,Fail,45,32,0,12,33
60,Fail,51,23,5,8,43
60,Fail,63,20,0,6,57
60,Fail,46,27,0,13,33
60,Fail,51,27,0,10,41
60,Fail,42,38,0,10,32
60,Fail,45,27,3,13,32
60,Fail,54,15,9,12,42
60,Fail,50,25,2,14,36
60,Fail,50,29,0,9,41
60,Fail,45,27,0,15,30
60,Fail,52,26,1,8,44
60,Fail,50,23,0,16,34
60,Fail,51,34,0,5,46
60,Fail,50,33,0,12,38
60,Fail,50,20,3,13,37
60,Fail,49,30,0,11,38
60,Fail,50,23,5,13,37
60,Fail,47,24,0,16,31
60,Fail,45,33,0,9,36
60,Fail,47,31,1,13,34
60,Fail,50,20,3,15,35
60,Fail,41,32,0,16,25
60,Fail,54,23,0,11,43
60,Fail,50,24,0,11,39
60,Fail,49,26,0,16,33
60,Fail,49,27,2,12,37
60,Fail,54,15,3,13,41
60,Fail,42,27,0,16,26
60,Fail,47,27,8,10,37
60,Fail,56,25,2,10,46
60,Fail,45,23,5,15,30
60,Fail,52,24,1,11,41
60,Fail,44,36,0,12,32
60,Fail,49,27,3,11,38
60,Fail,50,18,2,16,34
60,Fail,46,26,4,11,35
60,Fail,54,30,0,9,45
60,Fail,51,19,4,16,35
60,Fail,44,30,4,9,35
60,Fail,46,27,0,11,35
60,Fail,49,26,0,12,37
60,Fail,45,22,8,13,32
60,Fail,51,27,0,8,43
60,Fail,56,24,0,11,45
60,Fail,48,31,0,12,36
60,Fail,51,27,0,12,39
60,Fail,43,33,0,12,31
60,Fail,50,23,0,10,40
60,Fail,50,28,0,10,40
60,Fail,51,23,0,14,37
60,Fail,46,34,2,4,42
60,Fail,44,29,2,14,30
60,Fail,48,25,0,11,37
60,Fail,48,27,0,12,36
60,Fail,49,23,1,19,30
60,Fail,53,26,0,11,42
60,Fail,60,19,0,10,50
60,Fail,45,36,0,12,33
60,Fail,60,20,0,8,52
60,Fail,39,21,9,20,19
60,Fail,52,23,0,11,41
60,Fail,47,35,0,7,40
60,Fail,46,32,0,13,33
60,Fail,47,26,0,12,35
60,Fail,45,19,1,17,28
60,Fail,44,28,7,11,33
60,Fail,47,30,0,10,37
60,Fail,51,23,2,13,38
60,Fail,47,25,2,13,34
60,Fail,51,23,0,12,39
60,Fail,44,23,1,19,25
60,Fail,50,28,0,12,38
60,Fail,44,28,2,19,25
60,Fail,52,22,8,10,42
60,Fail,51,20,8,9,42
60,Fail,49,16,12,18,31
60,Fail,42,26,4,13,29
60,Fail,52,29,0,10,42
60,Fail,41,26,10,11,30
60,Fail,53,25,0,12,41
60,Fail,50,25,1,10,40
60,Fail,52,30,0,11,41
60,Fail,48,20,5,19,29
60,Fail,44,30,1,15,29
60,Fail,47,31,0,9,38
60,Fail,44,27,0,15,29
60,Fail,44,31,0,16,28
60,Fail,49,23,0,18,31
60,Fail,36,40,0,16,20
60,Fail,50,30,0,10,40
60,Fail,53,20,0,15,38
60,Fail,48,32,0,9,39
60,Fail,55,27,0,8,47
60,Fail,45,25,8,14,31
60,Fail,41,23,8,18,23
60,Fail,43,30,0,17,26
60,Fail,46,27,0,13,33
60,Fail,50,31,0,7,43
60,Fail,49,24,3,15,34
60,Fail,46,34,0,12,34
60,Fail,52,21,1,12,40
60,Fail,50,20,5,16,34
60,Fail,58,18,0,14,44
60,Fail,33,35,6,19,14
60,Fail,45,26,4,16,29
60,Fail,46,28,0,16,30
60,Fail,56,22,0,10,46
60,Fail,43,29,5,16,27
60,Fail,48,37,0,8,40
60,Fail,53,22,0,11,42
60,Fail,46,27,4,10,36
60,Fail,48,27,0,13,35
60,Fail,45,25,9,16,29
60,Fail,48,22,5,14,34
60,Fail,44,31,0,13,31
60,Fail,48,25,7,12,36
60,Fail,48,32,0,11,37
60,Fail,49,29,2,13,36
60,Fail,48,29,0,12,36
60,Fail,55,20,0,13,42
60,Fail,43,29,0,17,26
60,Fail,54,22,3,12,42
60,Fail,46,24,1,19,27
60,Fail,43,24,0,18,25
60,Fail,55,26,0,8,47
60,Fail,50,21,3,14,36
60,Fail,55,21,2,12,43
60,Fail,49,30,0,12,37
60,Fail,48,24,0,14,34
60,Fail,44,22,3,20,24
60,Fail,47,23,0,12,35
60,Fail,42,27,2,22,20
60,Fail,46,28,0,12,34
60,Fail,42,35,0,13,29
60,Fail,51,24,0,13,38
60,Fail,50,21,9,11,39
60,Fail,50,26,0,13,37
60,Fail,50,27,1,13,37
60,Fail,44,28,0,16,28
60,Fail,47,29,0,7,40
60,Fail,55,18,0,9,46
60,Fail,44,26,5,14,30
60,Fail,46,27,8,11,35
60,Fail,56,27,0,7,49
60,Fail,39,41,0,11,28
60,Fail,47,26,0,18,29
60,Fail,51,18,3,17,34
60,Fail,53,18,2,16,37
60,Fail,50,21,2,15,35
60,Fail,47,28,0,12,35
60,Fail,46,31,1,11,35
60,Fail,47,30,4,9,38
60,Fail,42,40,0,10,32
60,Fail,46,27,4,13,33
60,Fail,49,22,4,13,36
60,Fail,46,22,8,14,32
60,Fail,49,32,0,11,38
60,Fail,41,31,3,13,28
60,Fail,44,27,8,14,30
60,Fail,46,25,1,12,34
60,Fail,41,34,0,14,27
60,Fail,46,24,6,17,29
60,Fail,47,23,4,13,34
60,Fail,54,21,6,9,45
60,Fail,51,26,0,15,36
60,Fail,50,27,0,12,38
60,Fail,45,36,0,12,33
60,Fail,43,36,0,10,33
60,Fail,40,30,6,15,25
60,Fail,50,25,0,14,36
60,Fail,39,29,2,16,23
60,Fail,44,32,8,7,37
60,Fail,38,37,0,16,22
60,Fail,45,31,1,13,32
60,Fail,47,26,4,14,33
60,Fail,50,27,0,13,37
60,Fail,39,26,9,16,23
60,Fail,43,34,0,15,28
60,Fail,49,33,0,13,36
60,Fail,51,22,0,13,38
60,Fail,47,26,0,18,29
60,Fail,53,21,0,12,41
60,Fail,43,36,0,8,35
60,Fail,48,31,7,8,40
60,Fail,41,34,0,17,24
60,Fail,47,32,0,14,33
60,Fail,47,33,3,7,40
60,Fail,51,26,0,12,39
60,Fail,55,19,0,13,42
60,Fail,44,24,7,15,29
60,Fail,47,30,0,12,35
60,Fail,47,24,8,11,36
60,Fail,41,25,4,21,20
60,Fail,51,29,0,11,40
60,Fail,55,25,0,6,49
60,Fail,48,27,4,11,37
60,Fail,52,21,1,15,37
60,Fail,47,30,0,13,34
60,Fail,51,32,0,7,44
60,Fail,44,24,6,15,29
60,Fail,40,34,0,18,22
60,Fail,45,25,6,18,27
60,Fail,54,26,0,11,43
60,Fail,51,25,0,13,38
60,Fail,43,29,5,11,32
60,Fail,43,33,0,12,31
60,Fail,42,26,4,16,26
60,Fail,47,29,0,12,35
60,Fail,46,33,0,12,34
60,Fail,57,20,0,7,50
60,Fail,46,29,5,10,36
60,Fail,52,21,7,9,43
60,Fail,50,24,0,15,35
60,Fail,41,29,0,20,21
60,Fail,53,22,5,9,44
60,Fail,51,30,0,11,40
60,Fail,46,15,11,17,29
60,Fail,47,35,0,13,34
60,Fail,47,33,0,10,37
60,Fail,50,30,0,12,38
60,Fail,48,20,7,16,32
60,Fail,50,26,0,13,37
60,Fail,51,21,3,17,34
60,Fail,44,26,5,16,28
60,Fail,47,28,6,12,35
60,Fail,48,26,0,11,37
60,Fail,51,25,5,8,43
60,Fail,45,37,3,9,36
60,Fail,48,25,3,15,33
60,Fail,59,19,2,5,54
60,Fail,47,21,0,18,29
60,Fail,50,26,0,10,40
60,Fail,43,23,1,23,20
60,Fail,53,22,1,9,44
60,Fail,42,31,2,14,28
60,Fail,42,30,4,12,30
60,Fail,58,16,6,10,48
60,Fail,52,27,0,9,43
60,Fail,45,24,2,20,25
60,Fail,55,22,3,10,45
60,Fail,46,30,0,15,31
60,Fail,45,36,0,11,34
60,Fail,49,33,0,10,39
60,Fail,52,30,1,7,45
60,Fail,35,33,0,24,11
60,Fail,48,18,4,16,32
60,Fail,40,32,0,15,25
60,Fail,47,25,0,19,28
60,Fail,51,28,0,9,42
60,Fail,49,22,0,19,30
60,Fail,49,25,1,16,33
60,Fail,49,26,0,14,35
60,Fail,42,34,0,14,28
60,Fail,51,22,4,10,41
60,Fail,54,26,0,9,45
60,Fail,49,31,0,12,37
60,Fail,51,19,2,18,33
60,Fail,44,31,6,10,34
60,Fail,51,26,0,13,38
60,Fail,58,17,2,10,48
60,Fail,57,20,0,13,44
60,Fail,51,19,0,17,34
60,Fail,41,37,1,13,28
60,Fail,46,34,0,10,36
60,Fail,46,28,0,13,33
60,Fail,41,29,4,16,25
60,Fail,48,31,7,5,43
60,Fail,50,28,3,9,41
60,Fail,40,36,1,14,26
60,Fail,49,29,0,13,36
60,Fail,43,28,9,6,37
60,Fail,46,30,0,9,37
60,Fail,45,26,3,17,28
60,Fail,48,28,0,14,34
60,Fail,48,29,1,12,36
60,Fail,58,23,3,9,49
60,Fail,50,27,0,14,36
60,Fail,55,19,2,6,49
60,Fail,52,23,3,15,37
60,Fail,52,27,10,5,47
60,Fail,45,33,0,7,38
60,Fail,50,19,3,16,34
60,Fail,44,30,2,17,27
60,Fail,50,24,0,14,36
60,Fail,46,35,0,13,33
60,Fail,48,27,0,15,33
60,Fail,50,25,0,13,37
60,Fail,42,27,2,14,28
60,Fail,48,20,6,14,34
60,Fail,48,32,0,12,36
60,Fail,45,34,0,12,33
60,Fail,53,17,2,16,37
60,Fail,51,20,6,13,38
60,Fail,49,23,3,11,38
60,Fail,52,25,1,11,41
60,Fail,48,30,0,10,38
60,Fail,48,31,0,10,38
60,Fail,50,30,0,11,39
60,Fail,42,31,6,17,25
60,Fail,44,28,0,16,28
60,Fail,51,19,3,17,34
60,Fail,49,21,4,17,32
60,Fail,51,29,0,10,41
60,Fail,50,22,5,14,36
60,Fail,42,24,5,19,23
60,Fail,53,23,0,11,42
60,Fail,50,34,0,4,46
60,Fail,38,31,11,10,28
60,Fail,55,24,2,9,46
60,Fail,59,21,0,10,49
60,Fail,49,29,0,11,38
60,Fail,44,33,0,13,31
60,Fail,40,40,0,13,27
60,Fail,50,23,4,11,39
60,Fail,47,25,7,14,33
60,Fail,56,30,0,5,51
60,Fail,42,27,2,16,26
60,Fail,54,27,0,11,43
60,Fail,46,33,0,14,32
60,Fail,40,39,0,11,29
60,Fail,45,35,0,12,33
60,Fail,51,28,1,7,44
60,Fail,51,29,0,10,41
60,Fail,41,35,0,14,27
60,Fail,47,32,0,9,38
60,Fail,41,27,8,15,26
60,Fail,52,24,0,11,41
60,Fail,39,35,0,20,19
60,Fail,47,35,0,12,35
60,Fail,50,22,8,12,38
60,Fail,51,28,0,6,45
60,Fail,40,31,0,17,23
60,Fail,48,27,0,12,36
60,Fail,40,31,4,16,24
60,Fail,43,39,2,6,37
60,Fail,43,29,5,14,29
60,Fail,46,31,2,12,34
60,Fail,51,23,0,12,39
60,Fail,45,22,5,14,31
60,Fail,49,24,1,13,36
60,Fail,43,31,0,14,29
60,Fail,42,32,0,18,24
60,Fail,42,38,0,13,29
60,Fail,44,34,0,13,31
60,Fail,49,23,7,14,35
60,Fail,49,27,0,15,34
60,Fail,42,32,0,15,27
60,Fail,40,26,5,16,24
60,Fail,49,24,0,18,31
60,Fail,50,26,2,10,40
60,Fail,51,24,0,13,38
60,Fail,52,35,0,6,46
60,Fail,47,28,0,15,32
60,Fail,52,24,0,16,36
60,Fail,47,25,0,18,29
60,Fail,49,24,2,16,33
60,Fail,44,24,5,16,28
60,Fail,41,39,0,13,28
60,Fail,45,34,0,15,30
60,Fail,37,42,0,14,23
60,Fail,45,29,5,11,34
60,Fail,50,27,0,16,34
60,Fail,44,30,0,18,26
60,Fail,45,30,5,8,37
60,Fail,50,28,0,14,36
60,Fail,50,20,3,15,35
60,Fail,40,27,11,13,27
60,Fail,49,28,0,14,35
60,Fail,47,28,2,12,35
60,Fail,55,24,0,9,46
60,Fail,56,23,0,11,45
60,Fail,49,26,0,12,37
60,Fail,55,18,0,12,43
60,Fail,45,25,2,16,29
60,Fail,50,28,6,8,42
60,Fail,51,24,0,16,35
60,Fail,41,39,0,13,28
60,Fail,42,19,7,21,21
60,Fail,49,26,7,7,42
60,Fail,50,26,4,9,41
60,Fail,49,30,0,8,41
60,Fail,45,29,8,8,37
60,Fail,51,30,0,11,40
60,Fail,44,32,4,8,36
60,Fail,44,33,0,9,35
60,Fail,44,29,8,9,35
60,Fail,48,22,0,16,32
60,Fail,46,28,0,14,32
60,Fail,47,31,0,11,36
60,Fail,47,28,9,9,38
60,Fail,45,30,9,12,33
60,Fail,48,30,0,16,32
60,Fail,48,33,0,12,36
60,Fail,42,29,0,17,25
60,Fail,42,38,0,13,29
60,Fail,50,29,2,10,40
60,Fail,40,37,0,13,27
60,Fail,40,31,5,15,25
60,Fail,51,24,4,10,41
60,Fail,52,26,5,8,44
60,Fail,43,33,0,18,25
60,Fail,45,32,0,16,29
60,Fail,53,22,5,10,43
60,Fail,44,34,0,14,30
60,Fail,49,23,6,12,37
60,Fail,41,35,0,15,26
60,Fail,46,29,0,9,37
60,Fail,55,23,1,8,47
60,Fail,41,35,0,16,25
60,Fail,43,27,5,13,30
60,Fail,50,27,2,9,41
60,Fail,44,26,8,11,33
60,Fail,44,24,4,18,26
60,Fail,52,25,0,14,38
60,Fail,50,23,6,10,40
60,Fail,46,33,3,8,38
60,Fail,43,27,0,14,29
60,Fail,50,29,0,13,37
60,Fail,42,29,6,16,26
60,Fail,47,24,11,11,36
60,Fail,50,23,0,12,38
60,Fail,44,29,1,16,28
60,Fail,57,22,0,11,46
60,Fail,51,24,1,12,39
60,Fail,52,27,0,11,41
60,Fail,48,22,3,12,36
60,Fail,50,29,0,13,37
60,Fail,50,26,0,10,40
60,Fail,54,22,0,12,42
60,Fail,46,22,3,18,28
60,Fail,49,18,5,14,35
60,Fail,53,30,0,7,46
60,Fail,40,31,5,13,27
60,Fail,51,32,0,9,42
60,Fail,50,28,0,12,38
60,Fail,51,22,6,13,38
60,Fail,43,34,0,13,30
60,Fail,53,22,0,11,42
60,Fail,54,25,2,9,45
60,Fail,49,29,0,10,39
60,Fail,42,38,0,11,31
60,Fail,42,36,1,13,29
60,Fail,50,23,0,15,35
60,Fail,44,31,3,12,32
60,Fail,49,26,4,7,42
60,Fail,57,24,0,8,49
60,Fail,39,33,0,19,20
60,Fail,48,26,1,13,35
60,Fail,54,21,1,8,46
60,Fail,51,25,0,15,36
60,Fail,56,25,3,4,52
60,Fail,40,30,0,16,24
60,Fail,51,28,0,10,41
60,Fail,38,37,0,20,18
60,Fail,51,28,0,14,37
60,Fail,50,21,0,15,35
60,Fail,47,32,1,9,38
60,Fail,44,23,13,14,30
60,Fail,47,25,1,13,34
60,Fail,40,38,0,12,28
60,Fail,55,20,8,11,44
60,Fail,46,33,0,16,30
60,Fail,45,28,5,15,30
60,Fail,48,24,2,13,35
60,Fail,53,20,3,10,43
60,Fail,48,30,3,12,36
60,Fail,41,30,0,14,27
60,Fail,42,26,9,12,30
60,Fail,50,24,4,11,39
60,Fail,46,31,0,16,30
60,Fail,54,20,0,13,41
60,Fail,46,24,1,14,32
60,Fail,50,23,0,14,36
60,Fail,54,24,0,10,44
60,Fail,53,24,3,10,43
60,Fail,50,27,0,10,40
60,Fail,47,27,5,9,38
60,Fail,61,21,0,7,54
60,Fail,45,32,0,15,30
60,Fail,45,25,0,20,25
60,Fail,40,31,4,14,26
60,Fail,45,21,6,17,28
60,Fail,52,18,4,14,38
60,Fail,53,25,0,15,38
60,Fail,46,30,0,18,28
60,Fail,49,28,6,9,40
60,Fail,46,26,6,15,31
60,Fail,51,26,4,9,42
60,Fail,42,31,3,14,28
60,Fail,50,27,2,9,41
60,Fail,48,20,2,17,31
60,Fail,47,37,0,7,40
60,Fail,43,25,6,14,29
60,Fail,50,20,9,11,39
60,Fail,50,20,0,17,33
60,Fail,53,25,2,8,45
60,Fail,49,24,0,15,34
60,Fail,48,33,0,13,35
60,Fail,58,19,1,9,49
60,Fail,53,22,3,10,43
60,Fail,52,22,0,15,37
60,Fail,43,32,0,17,26
60,Fail,52,29,0,9,43
60,Fail,53,22,3,15,38
60,Fail,42,26,10,11,31
60,Fail,52,24,4,7,45
60,Fail,39,26,11,13,26
60,Fail,50,26,0,13,37
60,Fail,54,20,0,16,38
60,Fail,48,24,0,19,29
60,Fail,43,33,0,15,28
60,Fail,52,21,0,14,38
60,Fail,43,37,0,14,29
60,Fail,55,19,4,9,46
60,Fail,46,30,2,10,36
60,Fail,46,27,2,12,34
60,Fail,42,34,0,16,26
60,Fail,49,27,1,11,38
60,Fail,43,38,0,9,34
60,Fail,45,26,8,12,33
60,Fail,46,28,0,16,30
60,Fail,45,25,4,13,32
60,Fail,45,32,0,13,32
60,Fail,49,30,2,12,37
60,Fail,47,25,1,16,31
60,Fail,46,31,3,10,36
60,Fail,46,23,2,21,25
60,Fail,48,33,0,11,37
60,Fail,46,26,8,8,38
60,Fail,47,25,0,14,33
60,Fail,56,21,3,6,50
60,Fail,47,23,0,19,28
60,Fail,52,32,0,7,45
60,Fail,49,30,0,9,40
60,Fail,48,28,0,14,34
60,Fail,49,35,0,9,40
60,Fail,52,26,0,10,42
60,Fail,63,15,0,11,52
60,Fail,55,24,0,11,44
60,Fail,47,27,8,12,35
60,Fail,49,28,0,11,38
60,Fail,49,29,5,9,40
60,Fail,49,33,0,8,41
60,Fail,52,28,0,11,41
60,Fail,56,24,0,8,48
60,Fail,48,21,0,15,33
60,Fail,52,21,1,15,37
60,Fail,49,22,0,15,34
60,Fail,51,26,1,9,42
60,Fail,49,28,0,14,35
60,Fail,55,27,0,6,49
60,Fail,48,29,0,14,34
60,Fail,53,22,0,11,42
60,Fail,47,26,5,9,38
60,Fail,46,25,3,13,33
60,Fail,49,31,0,10,39
60,Fail,54,28,0,10,44
60,Fail,50,22,6,13,37
60,Fail,42,36,0,10,32
60,Fail,52,25,0,11,41
60,Fail,49,26,2,12,37
60,Fail,56,15,0,17,39
60,Fail,48,26,0,15,33
60,Fail,55,24,2,12,43
60,Fail,52,30,0,9,43
60,Fail,49,28,3,9,40
60,Fail,50,19,4,13,37
60,Fail,50,27,0,11,39
60,Fail,48,27,1,10,38
60,Fail,49,23,0,15,34
60,Fail,44,31,0,13,31
60,Fail,47,29,0,15,32
60,Fail,49,25,0,13,36
60,Fail,51,26,1,11,40
60,Fail,46,30,0,13,33
60,Fail,47,22,0,18,29
60,Fail,50,27,0,13,37
60,Fail,45,25,0,13,32
60,Fail,52,23,0,14,38
60,Fail,54,18,0,14,40
60,Fail,55,25,0,8,47
60,Fail,41,25,3,24,17
60,Fail,45,25,7,14,31
60,Fail,54,24,0,11,43
60,Fail,45,32,0,17,28
60,Fail,43,27,0,16,27
60,Fail,47,29,0,16,31
60,Fail,49,25,4,10,39
60,Fail,47,21,0,21,26
60,Fail,47,32,0,13,34
60,Fail,45,36,0,8,37
60,Fail,47,26,1,15,32
60,Fail,53,21,0,14,39
60,Fail,53,21,8,9,44
60,Fail,48,30,0,12,36
60,Fail,54,17,0,14,40
60,Fail,44,34,0,12,32
60,Fail,46,28,0,17,29
60,Fail,52,29,0,11,41
60,Fail,52,23,0,12,40
60,Fail,45,29,0,14,31
60,Fail,50,22,3,15,35
60,Fail,42,37,0,16,26
60,Fail,50,30,0,11,39
60,Fail,43,23,9,19,24
60,Fail,48,30,0,13,35
60,Fail,45,31,0,10,35
60,Fail,56,21,0,11,45
60,Fail,40,34,0,18,22
60,Fail,44,23,8,15,29
60,Fail,50,24,0,14,36
60,Fail,57,16,7,11,46
60,Fail,48,31,0,13,35
60,Fail,51,25,0,14,37
60,Fail,48,30,6,10,38
60,Fail,56,18,3,12,44
60,Fail,41,39,0,15,26
60,Fail,52,24,4,13,39
60,Fail,43,30,6,14,29
60,Fail,58,21,0,9,49
60,Fail,47,32,0,10,37
60,Fail,46,26,3,13,33
60,Fail,46,29,8,8,38
60,Fail,42,25,0,25,17
60,Fail,49,29,2,8,41
60,Fail,50,25,4,15,35
60,Fail,49,26,0,12,37
60,Fail,36,36,6,10,26
60,Fail,42,33,0,17,25
60,Fail,54,21,5,9,45
60,Fail,52,27,0,7,45
60,Fail,48,32,0,14,34
60,Fail,48,32,0,9,39
60,Fail,42,35,0,12,30
60,Fail,51,25,3,14,37
60,Fail,48,31,1,12,36
60,Fail,47,31,3,10,37
60,Fail,55,20,3,12,43
60,Fail,52,24,5,9,43
60,Fail,52,25,0,12,40
60,Fail,50,27,0,12,38
60,Fail,44,29,0,19,25
60,Fail,52,30,1,10,42
60,Fail,43,33,0,15,28
60,Fail,48,20,2,15,33
60,Fail,52,23,3,11,41
60,Fail,50,26,0,10,40
60,Fail,47,25,7,10,37
60,Fail,39,32,0,16,23
60,Fail,48,21,0,19,29
60,Fail,50,25,4,11,39
60,Fail,50,21,2,14,36
60,Fail,48,28,3,12,36
60,Fail,57,29,0,7,50
60,Fail,46,29,0,14,32
60,Fail,46,36,0,8,38
60,Fail,52,19,0,16,36
60,Fail,48,38,0,9,39
60,Fail,46,27,0,16,30
60,Fail,52,25,0,12,40
60,Fail,47,23,0,15,32
60,Fail,49,20,0,19,30
60,Fail,55,25,0,10,45
60,Fail,47,20,2,19,28
60,Fail,46,23,3,14,32
60,Fail,45,21,0,21,24
60,Fail,46,24,0,14,32
60,Fail,56,19,2,6,50
60,Fail,57,16,0,12,45
60,Fail,44,31,7,7,37
60,Fail,43,31,0,12,31
60,Fail,47,27,0,15,32
60,Fail,45,28,0,13,32
60,Fail,43,21,11,14,29
60,Fail,47,33,0,12,35
60,Fail,53,24,0,9,44
60,Fail,43,23,10,15,28
60,Fail,43,30,0,16,27
60,Fail,43,33,0,15,28
60,Fail,55,22,2,12,43
60,Fail,47,33,0,14,33
60,Fail,50,22,1,15,35
60,Fail,54,26,0,11,43
60,Fail,49,18,2,15,34
60,Fail,49,18,4,17,32
60,Fail,47,31,3,8,39
60,Fail,45,32,2,12,33
60,Fail,48,31,0,9,39
60,Fail,51,25,0,14,37
60,Fail,52,26,0,9,43
60,Fail,47,29,5,7,40
60,Fail,50,28,0,6,44
60,Fail,50,25,0,15,35
60,Fail,48,26,0,15,33
60,Fail,40,39,0,7,33
60,Fail,47,27,7,11,36
60,Fail,53,24,4,11,42
60,Fail,51,23,0,14,37
60,Fail,41,28,2,15,26
60,Fail,48,25,6,12,36
60,Fail,46,34,0,11,35
60,Fail,42,25,8,17,25
60,Fail,52,24,0,15,37
60,Fail,47,32,0,13,34
60,Fail,49,29,1,10,39
60,Fail,49,30,0,11,38
60,Fail,45,28,0,13,32
60,Fail,50,30,0,9,41
60,Fail,42,30,0,17,25
60,Fail,48,31,2,7,41
60,Fail,43,27,4,15,28
60,Fail,53,21,2,9,44
60,Fail,46,34,0,8,38
60,Fail,51,29,0,7,44
60,Fail,53,22,0,15,38
60,Fail,37,41,0,14,23
60,Fail,50,23,0,15,35
60,Fail,42,32,2,15,27
60,Fail,47,27,3,12,35
60,Fail,50,29,0,8,42
60,Fail,39,29,6,18,21
60,Fail,45,35,0,11,34
60,Fail,52,22,4,13,39
60,Fail,52,18,9,14,38
60,Fail,47,28,0,15,32
60,Fail,47,35,0,8,39
60,Fail,48,23,7,10,38
60,Fail,51,28,0,11,40
60,Fail,47,27,2,11,36
60,Fail,37,33,0,22,15
60,Fail,42,40,5,5,37
60,Fail,43,23,8,15,28
60,Fail,48,26,1,16,32
60,Fail,51,28,1,7,44
60,Fail,47,23,5,16,31
60,Fail,48,29,1,8,40
60,Fail,40,36,0,12,28
60,Fail,41,27,3,20,21
60,Fail,51,23,2,14,37
60,Fail,49,22,8,12,37
60,Fail,40,41,0,11,29
60,Fail,47,34,0,10,37
60,Fail,46,29,8,10,36
60,Fail,49,24,8,10,39
60,Fail,44,24,3,18,26
60,Fail,51,28,0,11,40
60,Fail,35,29,11,20,15
60,Fail,54,27,0,6,48
60,Fail,49,22,8,9,40
60,Fail,51,26,0,11,40
60,Fail,53,32,0,7,46
60,Fail,51,32,0,6,45
60,Fail,45,25,2,15,30
60,Fail,46,38,0,10,36
60,Fail,45,31,0,12,33
60,Fail,55,28,0,9,46
60,Fail,48,25,0,15,33
60,Fail,46,32,0,12,34
60,Fail,45,25,1,18,27
60,Fail,48,37,0,7,41
60,Fail,46,28,2,14,32
60,Fail,55,29,0,6,49
60,Fail,46,28,5,10,36
60,Fail,52,26,0,10,42
60,Fail,45,33,0,15,30
60,Fail,60,19,2,9,51
60,Fail,50,30,0,10,40
60,Fail,55,19,1,13,42
60,Fail,51,28,0,14,37
60,Fail,54,18,1,13,41
60,Fail,44,28,2,13,31
60,Fail,43,34,0,12,31
60,Fail,52,26,0,14,38
60,Fail,45,29,0,16,29
60,Fail,58,24,0,5,53
60,Fail,44,29,0,14,30
60,Fail,51,20,0,17,34
60,Fail,44,36,0,11,33
60,Fail,50,24,3,15,35
60,Fail,53,22,9,11,42
60,Fail,48,28,0,15,33
60,Fail,44,31,5,11,33
60,Fail,47,34,0,9,38
60,Fail,38,34,11,10,28
60,Fail,43,29,4,13,30
60,Fail,43,32,0,17,26
60,Fail,48,23,8,13,35
60,Fail,37,36,5,15,22
60,Fail,46,28,0,14,32
60,Fail,51,27,0,11,40
60,Fail,43,32,0,14,29
60,Fail,56,17,1,14,42
60,Fail,44,31,0,15,29
60,Fail,45,25,0,19,26
60,Fail,47,27,0,15,32
60,Fail,47,27,1,13,34
60,Fail,39,42,2,8,31
60,Fail,49,23,4,14,35
60,Fail,39,38,0,13,26
60,Fail,51,25,4,9,42
60,Fail,47,23,1,18,29
60,Fail,43,31,0,16,27
60,Fail,51,26,6,7,44
60,Fail,42,31,0,14,28
60,Fail,45,34,0,13,32
60,Fail,57,24,0,6,51
60,Fail,40,26,0,21,19
60,Fail,56,19,0,15,41
60,Fail,45,33,0,9,36
60,Fail,46,33,0,11,35
60,Fail,51,24,0,14,37
60,Fail,53,21,3,9,44
60,Fail,44,33,1,11,33
60,Fail,44,26,0,17,27
60,Fail,52,23,0,13,39
60,Fail,52,22,1,15,37
60,Fail,48,32,0,11,37
60,Fail,52,21,2,13,39
60,Fail,50,27,3,5,45
60,Fail,50,27,0,8,42
60,Fail,45,20,2,21,24
60,Fail,57,22,0,9,48
60,Fail,44,29,2,14,30
60,Fail,52,21,1,14,38
60,Fail,53,25,3,7,46
60,Fail,46,25,7,10,36
60,Fail,48,22,6,10,38
60,Fail,43,32,0,14,29
60,Fail,51,25,2,11,40
60,Fail,43,32,1,14,29
60,Fail,41,33,0,15,26
60,Fail,44,25,8,14,30
60,Fail,50,24,0,14,36
60,Fail,52,29,1,5,47
60,Fail,50,33,0,9,41
60,Fail,53,25,0,13,40
60,Fail,48,22,1,15,33
60,Fail,38,35,4,13,25
60,Fail,49,28,0,16,33
60,Fail,51,27,1,10,41
60,Fail,40,29,11,9,31
60,Fail,42,27,4,15,27
60,Fail,48,21,11,12,36
60,Fail,51,24,0,16,35
60,Fail,54,19,1,14,40
60,Fail,42,29,7,14,28
60,Fail,41,27,2,16,25
60,Fail,51,36,0,6,45
60,Fail,44,32,0,15,29
60,Fail,47,30,0,12,35
60,Fail,49,29,0,10,39
60,Fail,44,29,0,12,32
60,Fail,43,37,0,13,30
60,Fail,56,24,1,8,48
60,Fail,43,27,6,15,28
60,Fail,44,32,0,11,33
60,Fail,40,29,8,14,26
60,Fail,54,26,1,11,43
60,Fail,50,21,0,15,35
60,Fail,52,29,4,7,45
60,Fail,42,34,0,10,32
60,Fail,58,19,2,11,47
60,Fail,43,32,0,18,25
60,Fail,50,23,2,15,35
60,Fail,44,27,2,13,31
60,Fail,50,26,0,11,39
60,Fail,48,22,0,18,30
60,Fail,45,32,3,9,36
60,Fail,48,38,0,10,38
60,Fail,52,15,1,17,35
60,Fail,48,26,0,12,36
60,Fail,50,26,0,11,39
60,Fail,44,33,0,15,29
60,Fail,48,27,0,13,35
60,Fail,43,20,4,22,21
60,Fail,49,26,1,13,36
60,Fail,49,19,2,15,34
60,Fail,44,35,0,13,31
60,Fail,46,25,0,15,31
60,Fail,55,25,3,8,47
60,Fail,50,29,0,12,38
60,Fail,42,27,4,16,26
60,Fail,45,26,0,13,32
60,Fail,50,27,0,13,37
60,Fail,47,22,0,18,29
60,Fail,50,22,2,13,37
60,Fail,45,29,5,15,30
60,Fail,47,33,0,9,38
60,Fail,47,25,7,14,33
60,Fail,43,39,0,7,36
60,Fail,50,22,0,15,35
60,Fail,43,25,4,17,26
60,Fail,49,23,0,20,29
60,Fail,53,21,0,18,35
60,Fail,46,26,0,19,27
60,Fail,52,23,0,10,42
60,Fail,46,29,4,13,33
60,Fail,52,26,5,10,42
60,Fail,46,28,4,12,34
60,Fail,52,27,0,11,41
60,Fail,44,28,2,14,30
60,Fail,57,24,0,9,48
60,Fail,43,32,0,17,26
60,Fail,53,18,11,9,44
60,Fail,45,29,0,16,29
60,Fail,50,32,0,8,42
60,Fail,55,17,0,15,40
60,Fail,49,27,0,15,34
60,Fail,50,27,3,9,41
60,Fail,48,28,0,11,37
60,Fail,48,33,0,9,39
60,Fail,52,24,4,8,44
60,Fail,56,21,0,11,45
60,Fail,47,26,1,8,39
60,Fail,50,25,0,11,39
60,Fail,51,17,3,17,34
60,Fail,48,25,5,11,37
60,Fail,49,26,0,15,34
60,Fail,47,28,0,11,36
60,Fail,47,27,0,12,35
60,Fail,49,25,9,12,37
60,Fail,47,27,0,16,31
60,Fail,42,37,0,14,28
60,Fail,48,22,3,15,33
60,Fail,52,21,3,13,39
60,Fail,54,22,0,14,40
60,Fail,45,31,0,16,29
60,Fail,47,34,0,11,36
60,Fail,55,19,0,14,41
60,Fail,44,41,0,7,37
60,Fail,43,30,0,13,30
60,Fail,51,20,2,14,37
60,Fail,53,29,0,10,43
60,Fail,42,28,0,21,21
60,Fail,45,32,0,15,30
60,Fail,41,27,1,20,21
60,Fail,43,32,0,17,26
60,Fail,47,38,0,7,40
60,Fail,46,31,0,10,36
60,Fail,57,22,0,13,44
60,Fail,50,28,0,10,40
60,Fail,44,28,0,16,28
60,Fail,43,28,6,14,29
60,Fail,43,27,0,16,27
60,Fail,53,16,5,17,36
60,Fail,46,29,0,13,33
60,Fail,59,23,0,7,52
60,Fail,51,24,0,12,39
60,Fail,50,27,0,7,43
60,Fail,37,36,0,17,20
60,Fail,53,22,1,12,41
60,Fail,52,29,0,10,42
60,Fail,55,19,6,9,46
60,Fail,52,26,0,8,44
60,Fail,51,25,0,11,40
60,Fail,46,31,2,10,36
60,Fail,54,22,0,15,39
60,Fail,52,23,0,11,41
60,Fail,54,22,1,8,46
60,Fail,52,26,5,6,46
60,Fail,43,30,2,11,32
60,Fail,47,27,0,19,28
60,Fail,49,32,0,10,39
60,Fail,46,21,1,16,30
60,Fail,55,17,1,10,45
60,Fail,45,34,0,10,35
60,Fail,47,26,0,12,35
60,Fail,48,23,4,16,32
60,Fail,52,31,0,10,42
60,Fail,47,25,0,16,31
60,Fail,51,27,0,12,39
60,Fail,47,31,0,10,37
60,Fail,42,27,8,14,28
60,Fail,50,37,0,9,41
60,Fail,51,23,1,13,38
60,Fail,52,23,0,16,36
60,Fail,55,25,0,10,45
60,Fail,52,24,7,7,45
60,Fail,55,24,0,14,41
60,Fail,51,25,1,6,45
60,Fail,49,20,0,17,32
60,Fail,38,32,5,17,21
60,Fail,47,28,5,12,35
60,Fail,56,19,0,12,44
60,Fail,48,33,0,14,34
60,Fail,47,26,6,11,36
60,Fail,46,27,4,13,33
60,Fail,37,34,11,10,27
60,Fail,53,19,7,8,45
60,Fail,50,35,0,8,42
60,Fail,52,29,0,6,46
60,Fail,45,30,0,13,32
60,Fail,48,25,0,16,32
60,Fail,52,26,0,8,44
60,Fail,48,42,0,5,43
60,Fail,60,21,2,6,54
60,Fail,56,30,0,6,50
60,Fail,48,23,0,13,35
60,Fail,48,26,0,11,37
60,Fail,56,19,3,9,47
60,Fail,44,32,2,10,34
60,Fail,48,26,3,12,36
60,Fail,51,27,1,11,40
60,Fail,44,23,6,16,28
60,Fail,48,33,0,12,36
60,Fail,49,32,0,14,35
60,Fail,49,27,0,15,34
60,Fail,53,22,0,14,39
60,Fail,44,40,0,8,36
60,Fail,51,21,0,18,33
60,Fail,52,26,0,12,40
60,Fail,47,23,7,12,35
60,Fail,45,27,4,14,31
60,Fail,49,33,0,9,40
60,Fail,46,35,0,14,32
60,Fail,40,36,0,13,27
60,Fail,52,31,0,9,43
60,Fail,51,22,5,11,40
60,Fail,60,21,0,8,52
60,Fail,46,31,0,12,34
60,Fail,40,39,0,14,26
60,Fail,45,23,0,22,23
60,Fail,47,34,0,9,38
60,Fail,44,27,7,14,30
60,Fail,44,31,0,14,30
60,Fail,48,29,0,13,35
60,Fail,53,15,5,18,35
60,Fail,45,29,2,15,30
60,Fail,54,24,0,9,45
60,Fail,51,29,0,12,39
60,Fail,51,25,0,10,41
60,Fail,42,36,0,12,30
60,Fail,48,28,0,15,33
60,Fail,58,21,0,9,49
60,Fail,51,25,0,13,38
60,Fail,50,14,3,20,30
60,Fail,45,32,0,14,31
60,Fail,47,28,3,11,36
60,Fail,52,21,5,14,38
60,Fail,61,19,2,8,53
60,Fail,51,27,5,9,42
60,Fail,45,24,0,19,26
60,Fail,56,18,0,13,43
60,Fail,46,31,0,13,33
60,Fail,48,20,4,17,31
60,Fail,45,32,0,16,29
60,Fail,41,34,0,15,26
60,Fail,51,23,4,13,38
60,Fail,37,33,2,18,19
60,Fail,45,23,7,15,30
60,Fail,40,37,0,12,28
60,Fail,57,19,0,13,44
60,Fail,48,28,4,9,39
60,Fail,47,23,3,15,32
60,Fail,40,25,7,21,19
60,Fail,50,27,0,12,38
60,Fail,50,25,5,10,40
60,Fail,46,26,0,16,30
60,Fail,46,30,0,11,35
60,Fail,43,34,0,12,31
60,Fail,55,21,0,9,46
60,Fail,54,26,0,9,45
60,Fail,49,25,0,16,33
60,Fail,46,32,0,10,36
60,Fail,48,25,0,14,34
60,Fail,42,26,4,18,24
60,Fail,45,35,0,12,33
60,Fail,44,25,4,15,29
60,Fail,43,31,1,14,29
60,Fail,44,24,6,16,28
60,Fail,53,25,0,8,45
60,Fail,44,22,5,21,23
60,Fail,46,26,0,20,26
60,Fail,50,29,0,11,39
60,Fail,59,15,3,7,52
60,Fail,49,20,2,13,36
60,Fail,49,32,0,9,40
60,Fail,52,24,0,11,41
60,Fail,36,30,6,17,19
60,Fail,49,28,0,10,39
60,Fail,43,24,2,17,26
60,Fail,52,24,0,14,38
60,Fail,46,29,0,14,32
60,Fail,44,25,3,15,29
60,Fail,53,24,0,8,45
60,Fail,51,23,8,5,46
60,Fail,58,22,5,6,52
60,Fail,53,26,0,11,42
60,Fail,52,18,7,10,42
60,Fail,51,22,0,16,35
60,Fail,50,19,0,16,34
60,Fail,42,22,2,22,20
60,Fail,48,22,0,18,30
60,Fail,47,27,7,11,36
60,Fail,48,24,3,13,35
60,Fail,46,24,8,16,30
60,Fail,41,29,0,21,20
60,Fail,46,31,0,13,33
60,Fail,44,31,2,12,32
60,Fail,42,33,0,13,29
60,Fail,55,16,0,16,39
60,Fail,47,25,7,10,37
60,Fail,56,21,0,12,44
60,Fail,45,29,3,14,31
60,Fail,49,33,0,8,41
60,Fail,51,29,0,12,39
60,Fail,57,21,0,13,44
60,Fail,51,20,1,15,36
60,Fail,37,34,0,17,20
60,Fail,51,22,2,12,39
60,Fail,50,31,2,5,45
60,Fail,48,24,6,13,35
60,Fail,42,37,0,10,32
60,Fail,41,44,0,10,31
60,Fail,42,40,0,10,32
60,Fail,46,28,2,12,34
60,Fail,46,24,8,13,33
60,Fail,51,27,0,11,40
60,Fail,49,25,4,8,41
60,Fail,47,26,4,15,32
60,Fail,51,20,3,18,33
60,Fail,39,37,0,17,22
60,Fail,40,43,0,9,31
60,Fail,48,29,0,15,33
60,Fail,39,33,0,21,18
60,Fail,48,34,0,7,41
60,Fail,47,22,5,14,33
60,Fail,52,23,0,10,42
60,Fail,57,22,1,11,46
60,Fail,53,24,0,14,39
60,Fail,47,29,0,13,34
60,Fail,54,21,0,12,42
60,Fail,47,29,0,14,33
60,Fail,50,28,0,12,38
60,Fail,46,30,4,11,35
60,Fail,43,36,0,13,30
60,Fail,49,24,1,18,31
60,Fail,46,28,0,14,32
60,Fail,44,31,3,14,30
60,Fail,46,33,0,10,36
60,Fail,47,28,0,14,33
60,Fail,43,33,0,15,28
60,Fail,56,14,3,14,42
60,Fail,54,19,0,12,42
60,Fail,61,15,1,14,47
60,Fail,50,23,2,14,36
60,Fail,53,17,7,15,38
60,Fail,42,36,3,9,33
60,Fail,54,27,0,10,44
60,Fail,46,30,0,9,37
60,Fail,41,36,0,12,29
60,Fail,51,30,0,7,44
60,Fail,49,28,0,12,37
60,Fail,46,24,4,14,32
60,Fail,50,25,1,13,37
60,Fail,40,32,0,15,25
60,Fail,37,36,2,17,20
60,Fail,47,35,0,8,39
60,Fail,53,14,7,16,37
60,Fail,43,34,0,16,27
60,Fail,54,25,0,9,45
60,Fail,51,26,0,9,42
60,Fail,51,18,4,14,37
60,Fail,49,26,2,10,39
60,Fail,49,26,6,10,39
60,Fail,51,21,6,12,39
60,Fail,51,19,14,9,42
60,Fail,51,22,0,15,36
60,Fail,44,39,0,12,32
60,Fail,58,15,3,10,48
60,Fail,50,29,0,9,41
60,Fail,51,19,3,15,36
60,Fail,50,28,2,8,42
60,Fail,43,32,1,11,32
60,Fail,47,29,0,14,33
60,Fail,45,22,7,15,30
60,Fail,46,28,0,18,28
60,Fail,53,26,0,12,41
60,Fail,43,31,0,17,26
60,Fail,51,24,1,12,39
60,Fail,51,25,0,11,40
60,Fail,50,19,5,17,33
60,Fail,53,31,0,8,45
60,Fail,54,17,0,14,40
60,Fail,47,32,0,12,35
60,Fail,52,24,0,13,39
60,Fail,48,25,2,17,31
60,Fail,56,25,0,7,49
60,Fail,47,30,0,10,37
60,Fail,40,34,0,15,25
60,Fail,48,32,0,13,35
60,Fail,44,31,7,8,36
60,Fail,49,24,3,10,39
60,Fail,50,25,4,12,38
60,Fail,52,22,1,12,40
60,Fail,49,32,0,9,40
60,Fail,50,22,3,12,38
60,Fail,44,25,10,15,29
60,Fail,43,34,0,14,29
60,Fail,45,32,0,17,28
60,Fail,56,20,0,12,44
60,Fail,45,28,1,20,25
60,Fail,52,29,0,9,43
60,Fail,49,22,2,18,31
60,Fail,47,28,0,11,36
60,Fail,43,24,14,10,33
60,Fail,48,35,0,8,40
60,Fail,53,27,0,7,46
60,Fail,49,27,0,15,34
60,Fail,48,27,5,12,36
60,Fail,49,27,0,13,36
60,Fail,43,20,7,17,26
60,Fail,53,26,0,11,42
60,Fail,50,30,0,12,38
60,Fail,46,27,0,13,33
60,Fail,49,25,0,12,37
60,Fail,54,20,0,13,41
60,Fail,48,28,0,12,36
60,Fail,59,15,0,8,51
60,Fail,51,28,0,11,40
60,Fail,50,25,4,10,40
60,Fail,54,30,0,6,48
60,Fail,48,29,0,13,35
60,Fail,38,36,0,16,22
60,Fail,51,25,2,8,43
60,Fail,52,29,0,7,45
60,Fail,44,31,0,11,33
60,Fail,48,30,0,14,34
60,Fail,52,24,5,9,43
60,Fail,51,24,0,14,37
60,Fail,43,36,0,12,31
60,Fail,48,22,8,10,38
60,Fail,46,27,3,11,35
60,Fail,49,28,0,10,39
60,Fail,43,33,0,16,27
60,Fail,50,24,9,8,42
60,Fail,48,26,0,15,33
60,Fail,54,19,5,11,43
60,Fail,39,36,0,14,25
60,Fail,44,29,3,15,29
60,Fail,50,20,8,14,36
60,Fail,44,28,1,15,29
60,Fail,45,26,3,17,28
60,Fail,50,27,3,13,37
60,Fail,51,23,6,11,40
60,Fail,44,26,0,19,25
60,Fail,46,26,5,13,33
60,Fail,55,19,0,15,40
60,Fail,53,26,1,11,42
60,Fail,51,29,0,13,38
60,Fail,49,24,0,13,36
60,Fail,42,34,0,18,24
60,Fail,47,32,0,13,34
60,Fail,44,34,0,15,29
60,Fail,53,24,1,12,41
60,Fail,48,26,1,13,35
60,Fail,49,22,0,8,41
60,Fail,39,34,2,11,28
60,Fail,51,24,1,13,38
60,Fail,47,28,0,14,33
60,Fail,50,20,2,13,37
60,Fail,40,29,0,18,22
60,Fail,39,24,1,21,18
60,Fail,50,21,7,13,37
60,Fail,55,17,0,15,40
60,Fail,45,25,3,16,29
60,Fail,50,26,0,11,39
60,Fail,54,25,0,10,44
60,Fail,51,27,0,11,40
60,Fail,47,29,0,11,36
60,Fail,42,32,0,17,25
60,Fail,46,29,0,14,32
60,Fail,41,30,2,16,25
60,Fail,52,23,0,8,44
60,Fail,41,25,8,18,23
60,Fail,51,21,1,17,34
60,Fail,61,15,2,12,49
60,Fail,43,32,0,13,30
60,Fail,47,33,0,9,38
60,Fail,46,27,0,14,32
60,Fail,41,41,0,12,29
60,Fail,52,25,0,13,39
60,Fail,46,20,5,18,28
60,Fail,50,26,0,12,38
60,Fail,50,26,3,14,36
60,Fail,49,24,5,13,36
60,Fail,45,24,3,19,26
60,Fail,49,28,0,12,37
60,Fail,52,25,0,15,37
60,Fail,44,25,12,13,31
60,Fail,47,29,0,12,35
60,Fail,47,27,0,12,35
60,Fail,46,18,7,16,30
60,Fail,49,23,0,17,32
60,Fail,46,23,4,15,31
60,Fail,50,24,0,10,40
60,Fail,50,26,0,13,37
60,Fail,45,32,0,10,35
60,Fail,53,28,0,10,43
60,Fail,40,27,6,18,22
60,Fail,42,38,0,10,32
60,Fail,43,24,9,11,32
60,Fail,52,25,1,9,43
60,Fail,58,20,0,14,44
60,Fail,60,18,2,7,53
60,Fail,63,14,0,10,53
60,Fail,46,37,0,8,38
60,Fail,47,32,0,14,33
60,Fail,47,31,0,16,31
60,Fail,55,26,0,8,47
60,Fail,41,35,5,10,31
60,Fail,48,22,5,14,34
60,Fail,54,25,9,6,48
60,Fail,53,26,0,10,43
60,Fail,49,25,0,11,38
60,Fail,49,30,0,11,38
60,Fail,42,35,0,11,31
60,Fail,54,29,0,9,45
60,Fail,47,28,0,18,29
60,Fail,49,26,0,10,39
60,Fail,46,21,5,16,30
60,Fail,56,21,0,10,46
60,Fail,49,28,0,13,36
60,Fail,51,24,3,11,40
60,Fail,45,31,0,14,31
60,Fail,50,34,0,9,41
60,Fail,57,19,2,9,48
60,Fail,50,26,0,12,38
60,Fail,42,40,0,10,32
60,Fail,52,34,0,8,44
60,Fail,51,25,0,12,39
60,Fail,47,30,4,9,38
60,Fail,44,28,7,11,33
60,Fail,44,31,0,14,30
60,Fail,49,31,0,11,38
60,Fail,47,23,2,14,33
60,Fail,49,29,0,12,37
60,Fail,51,33,0,6,45
60,Fail,52,28,1,7,45
60,Fail,55,16,0,17,38
60,Fail,48,26,6,9,39
60,Fail,45,25,0,18,27
60,Fail,42,25,3,18,24
60,Fail,51,23,0,15,36
60,Fail,47,30,2,10,37
60,Fail,45,28,1,16,29
60,Fail,47,31,0,12,35
60,Fail,48,33,0,11,37
60,Fail,44,33,0,12,32
60,Fail,47,29,0,15,32
60,Fail,52,24,0,11,41
60,Fail,46,29,4,12,34
60,Fail,48,35,0,12,36
60,Fail,50,25,0,15,35
60,Fail,53,29,0,8,45
60,Fail,42,32,0,15,27
60,Fail,47,23,2,20,27
60,Fail,46,32,0,10,36
60,Fail,42,32,7,9,33
60,Fail,38,36,0,12,26
60,Fail,52,24,3,8,44
60,Fail,57,20,0,12,45
60,Fail,45,37,0,9,36
60,Fail,37,30,6,13,24
60,Fail,52,26,0,9,43
60,Fail,51,24,6,8,43
60,Fail,50,29,0,11,39
60,Fail,45,26,0,15,30
60,Fail,44,26,4,14,30
60,Fail,57,19,8,11,46
60,Fail,43,31,3,14,29
60,Fail,45,28,3,14,31
60,Fail,41,34,6,11,30
60,Fail,49,25,0,18,31
60,Fail,56,16,4,8,48
60,Fail,45,27,0,17,28
60,Fail,49,33,1,4,45
60,Fail,46,36,0,13,33
60,Fail,49,23,1,15,34
60,Fail,53,25,2,6,47
60,Fail,51,22,3,10,41
60,Fail,41,32,0,16,25
60,Fail,38,46,0,10,28
60,Fail,48,25,0,14,34
60,Fail,49,17,3,17,32
60,Fail,45,30,0,12,33
60,Fail,48,26,1,12,36
60,Fail,40,32,2,17,23
60,Fail,45,28,3,14,31
60,Fail,51,22,0,14,37
60,Fail,43,31,0,15,28
60,Fail,48,35,0,8,40
60,Fail,47,33,0,11,36
60,Fail,47,28,5,12,35
60,Fail,49,23,4,15,34
60,Fail,42,28,2,17,25
60,Fail,47,28,2,15,32
60,Fail,54,19,1,14,40
60,Fail,46,26,6,14,32
60,Fail,50,32,3,7,43
60,Fail,44,24,0,21,23
60,Fail,53,24,0,13,40
60,Fail,48,27,0,15,33
60,Fail,40,25,6,18,22
60,Fail,38,45,0,11,27
60,Fail,50,28,2,11,39
60,Fail,47,29,3,9,38
60,Fail,52,22,2,11,41
60,Fail,41,29,8,10,31
60,Fail,40,30,11,10,30
60,Fail,42,30,2,13,29
60,Fail,39,29,0,19,20
60,Fail,56,20,0,10,46
60,Fail,48,36,0,9,39
60,Fail,44,33,0,11,33
60,Fail,42,40,0,7,35
60,Fail,45,27,0,14,31
60,Fail,50,22,2,11,39
60,Fail,47,28,3,13,34
60,Fail,52,20,0,15,37
60,Fail,55,23,0,9,46
60,Fail,59,19,0,11,48
60,Fail,47,28,1,12,35
60,Fail,50,22,0,11,39
60,Fail,51,20,2,14,37
60,Fail,50,27,0,10,40
60,Fail,47,30,0,14,33
60,Fail,50,26,0,9,41
60,Fail,43,30,0,15,28
60,Fail,48,27,0,17,31
60,Fail,50,32,0,11,39
60,Fail,47,17,6,17,30
60,Fail,45,38,0,10,35
60,Fail,52,16,1,17,35
60,Fail,48,27,2,11,37
60,Fail,46,28,0,11,35
60,Fail,49,28,2,10,39
60,Fail,51,27,2,7,44
60,Fail,51,24,3,10,41
60,Fail,51,22,0,13,38
60,Fail,55,18,1,12,43
60,Fail,43,29,0,10,33
60,Fail,52,19,3,12,40
60,Fail,48,39,0,3,45
60,Fail,51,23,0,14,37
60,Fail,56,21,0,12,44
60,Fail,45,36,0,10,35
60,Fail,50,26,3,14,36
60,Fail,50,22,6,13,37
60,Fail,57,22,0,7,50
60,Fail,52,29,0,10,42
60,Fail,52,29,1,8,44
60,Fail,52,25,0,9,43
60,Fail,48,23,0,15,33
60,Fail,47,32,1,10,37
60,Fail,45,34,0,9,36
60,Fail,54,24,5,8,46
60,Fail,48,26,0,15,33
60,Fail,47,24,0,16,31
60,Fail,49,27,0,11,38
60,Fail,50,27,0,11,39
60,Fail,45,30,8,10,35
60,Fail,49,22,3,13,36
60,Fail,39,33,0,14,25
60,Fail,45,30,2,13,32
60,Fail,43,27,10,10,33
60,Fail,54,21,4,10,44
60,Fail,45,32,6,9,36
60,Fail,51,23,2,13,38
60,Fail,41,32,0,16,25
60,Fail,54,27,0,7,47
60,Fail,45,33,0,11,34
60,Fail,55,12,6,17,38
60,Fail,44,32,0,14,30
60,Fail,47,19,3,16,31
60,Fail,44,36,0,14,30
60,Fail,43,31,0,13,30
60,Fail,48,33,0,8,40
60,Fail,40,29,9,14,26
60,Fail,56,23,0,10,46
60,Fail,49,18,11,11,38
60,Fail,52,17,3,18,34
60,Fail,50,23,7,10,40
60,Fail,53,22,0,18,35
60,Fail,45,28,1,12,33
60,Fail,43,27,7,13,30
60,Fail,44,24,10,13,31
60,Fail,50,29,0,9,41
60,Fail,42,29,0,13,29
60,Fail,54,24,1,8,46
60,Fail,50,30,0,7,43
60,Fail,43,32,3,14,29
60,Fail,55,14,0,15,40
60,Fail,54,16,8,9,45
60,Fail,51,30,0,8,43
60,Fail,46,25,4,15,31
60,Fail,46,21,0,22,24
60,Fail,46,28,7,11,35
60,Fail,52,23,1,13,39
60,Fail,41,33,0,16,25
60,Fail,54,19,0,15,39
60,Fail,49,37,0,6,43
60,Fail,44,32,0,17,27
60,Fail,42,32,0,13,29
60,Fail,50,27,3,9,41
60,Fail,44,33,0,11,33
60,Fail,43,34,0,17,26
60,Fail,56,20,0,14,42
60,Fail,36,49,0,10,26
60,Fail,57,23,0,9,48
60,Fail,51,21,0,13,38
60,Fail,44,29,4,9,35
60,Fail,45,26,8,16,29
60,Fail,45,22,13,11,34
60,Fail,42,30,0,18,24
60,Fail,44,30,1,17,27
60,Fail,47,33,2,7,40
60,Fail,46,28,0,16,30
60,Fail,59,24,2,4,55
60,Fail,46,25,9,11,35
60,Fail,52,25,6,7,45
60,Fail,51,26,2,8,43
60,Fail,47,28,1,11,36
60,Fail,52,20,0,17,35
60,Fail,48,34,0,11,37
60,Fail,44,20,14,13,31
60,Fail,42,37,0,12,30
60,Fail,54,28,0,11,43
60,Fail,55,20,0,11,44
60,Fail,39,34,0,21,18
60,Fail,50,19,0,18,32
60,Fail,44,30,4,14,30
60,Fail,40,36,0,13,27
60,Fail,47,18,5,18,29
60,Fail,47,28,0,17,30
60,Fail,45,30,6,14,31
60,Fail,51,23,0,14,37
60,Fail,43,34,0,14,29
60,Fail,55,20,0,15,40
60,Fail,46,24,2,14,32
60,Fail,55,21,3,12,43
60,Fail,48,25,1,12,36
60,Fail,46,31,0,12,34
60,Fail,46,22,6,20,26
60,Fail,58,22,1,8,50
60,Fail,48,24,0,16,32
60,Fail,47,20,0,20,27
60,Fail,45,25,7,12,33
60,Fail,45,20,4,20,25
60,Fail,40,36,0,10,30
60,Fail,43,38,0,10,33
60,Fail,50,26,0,14,36
60,Fail,53,25,0,9,44
60,Fail,46,26,0,17,29
60,Fail,44,23,4,18,26
60,Fail,54,21,2,13,41
60,Fail,56,21,0,13,43
60,Fail,49,27,0,15,34
60,Fail,53,32,0,7,46
60,Fail,56,21,2,11,45
60,Fail,50,21,2,15,35
60,Fail,55,21,2,12,43
60,Fail,46,26,10,7,39
60,Fail,43,32,4,11,32
60,Fail,46,30,5,10,36
60,Fail,45,38,0,12,33
60,Fail,47,27,0,17,30
60,Fail,43,34,0,10,33
60,Fail,46,26,0,18,28
60,Fail,47,28,1,15,32
60,Fail,49,25,0,17,32
60,Fail,41,36,0,13,28
60,Fail,50,25,3,13,37
60,Fail,47,30,0,14,33
60,Fail,47,31,0,13,34
60,Fail,52,22,0,15,37
60,Fail,46,27,6,10,36
60,Fail,47,29,3,12,35
60,Fail,51,28,1,12,39
60,Fail,50,24,0,15,35
60,Fail,46,32,0,12,34
60,Fail,50,23,0,15,35
60,Fail,48,26,0,11,37
60,Fail,47,33,4,5,42
60,Fail,55,24,0,9,46
60,Fail,48,30,0,10,38
60,Fail,49,30,0,11,38
60,Fail,40,35,0,13,27
60,Fail,45,32,0,13,32
60,Fail,45,28,6,10,35
60,Fail,50,25,2,13,37
60,Fail,48,24,9,10,38
60,Fail,46,24,3,16,30
60,Fail,50,25,2,12,38
60,Fail,46,27,9,7,39
60,Fail,44,34,0,8,36
60,Fail,47,33,0,12,35
60,Fail,41,21,12,17,24
60,Fail,51,21,0,10,41
60,Fail,57,19,1,11,46
60,Fail,45,29,3,12,33
60,Fail,51,31,0,7,44
60,Fail,52,23,0,13,39
60,Fail,39,34,0,19,20
60,Fail,41,32,3,16,25
60,Fail,42,25,4,17,25
60,Fail,50,24,4,11,39
60,Fail,44,31,0,11,33
60,Fail,50,30,0,13,37
60,Fail,46,23,3,14,32
60,Fail,56,22,0,11,45
60,Fail,50,31,0,13,37
60,Fail,47,24,0,17,30
60,Fail,50,29,0,14,36
60,Fail,43,35,0,12,31
60,Fail,51,27,1,15,36
60,Fail,54,24,4,6,48
60,Fail,46,20,5,12,34
60,Fail,44,36,0,10,34
60,Fail,42,29,4,18,24
60,Fail,47,24,4,13,34
60,Fail,47,22,6,14,33
60,Fail,48,22,6,10,38
60,Fail,52,23,2,14,38
60,Fail,48,22,8,16,32
60,Fail,55,28,0,10,45
60,Fail,53,24,1,13,40
60,Fail,61,19,0,10,51
60,Fail,44,30,0,13,31
60,Fail,56,18,0,13,43
60,Fail,44,33,0,15,29
60,Fail,50,27,2,10,40
60,Fail,44,27,4,16,28
60,Fail,46,27,3,16,30
60,Fail,43,28,0,16,27
60,Fail,46,22,7,15,31
60,Fail,51,23,4,12,39
60,Fail,47,18,0,23,24
60,Fail,49,24,2,13,36
60,Fail,52,25,2,10,42
60,Fail,45,22,5,19,26
60,Fail,48,22,7,11,37
60,Fail,48,22,6,14,34
60,Fail,50,22,0,15,35
60,Fail,45,33,0,12,33
60,Fail,46,37,0,9,37
60,Fail,45,33,0,13,32
60,Fail,40,30,7,9,31
60,Fail,50,21,0,18,32
60,Fail,42,29,7,15,27
60,Fail,48,25,0,16,32
60,Fail,42,32,3,13,29
60,Fail,51,28,0,9,42
60,Fail,53,29,0,8,45
60,Fail,45,25,4,15,30
60,Fail,48,31,0,8,40
60,Fail,53,25,0,15,38
60,Fail,44,25,0,18,26
60,Fail,48,27,0,16,32
60,Fail,36,30,2,21,15
60,Fail,46,32,0,12,34
60,Fail,43,38,0,11,32
60,Fail,51,31,0,9,42
60,Fail,51,31,0,10,41
60,Fail,55,23,1,10,45
60,Fail,45,32,0,13,32
60,Fail,46,35,0,9,37
60,Fail,47,28,0,19,28
60,Fail,47,33,0,11,36
60,Fail,56,18,6,10,46
60,Fail,45,29,5,11,34
60,Fail,52,30,0,7,45
60,Fail,50,21,8,14,36
60,Fail,40,30,0,17,23
60,Fail,46,23,6,15,31
60,Fail,44,39,0,9,35
60,Fail,48,22,9,13,35
60,Fail,51,23,0,14,37
60,Fail,46,33,0,12,34
60,Fail,45,30,2,9,36
60,Fail,36,41,0,13,23
60,Fail,48,26,0,14,34
60,Fail,49,30,0,9,40
60,Fail,56,24,6,5,51
60,Fail,51,23,0,14,37
60,Fail,51,22,0,16,35
60,Fail,49,32,0,9,40
60,Fail,47,23,0,19,28
60,Fail,51,21,0,14,37
60,Fail,49,26,3,11,38
60,Fail,43,35,0,14,29
60,Fail,51,19,2,13,38
60,Fail,48,22,3,16,32
60,Fail,57,19,2,9,48
60,Fail,46,26,2,12,34
60,Fail,39,33,7,11,28
60,Fail,42,23,5,20,22
60,Fail,47,32,0,12,35
60,Fail,52,23,7,7,45
60,Fail,52,23,0,10,42
60,Fail,44,30,0,19,25
60,Fail,49,22,2,14,35
60,Fail,53,25,0,10,43
60,Fail,50,26,4,9,41
60,Fail,45,26,8,17,28
60,Fail,46,24,9,13,33
60,Fail,58,21,0,5,53
60,Fail,50,28,1,7,43
60,Fail,51,23,8,10,41
60,Fail,51,24,2,14,37
60,Fail,48,29,2,12,36
60,Fail,42,25,3,17,25
60,Fail,52,28,2,8,44
60,Fail,49,26,4,14,35
60,Fail,48,28,0,13,35
60,Fail,53,25,0,6,47
60,Fail,43,31,0,16,27
60,Fail,48,19,11,16,32
60,Fail,46,32,0,9,37
60,Fail,49,27,0,10,39
60,Fail,46,30,0,12,34
60,Fail,46,31,3,11,35
60,Fail,49,28,1,14,35
60,Fail,48,29,6,11,37
60,Fail,48,21,8,15,33
60,Fail,48,20,2,17,31
60,Fail,58,21,1,10,48
60,Fail,42,41,0,13,29
60,Fail,50,22,1,17,33
60,Fail,50,28,1,10,40
60,Fail,50,22,8,11,39
60,Fail,54,23,5,8,46
60,Fail,43,22,7,21,22
60,Fail,43,23,9,17,26
60,Fail,54,27,0,10,44
60,Fail,51,29,0,10,41
60,Fail,48,26,7,8,40
60,Fail,42,35,0,15,27
60,Fail,47,32,0,15,32
60,Fail,43,30,0,18,25
60,Fail,41,36,0,15,26
60,Fail,37,41,0,16,21
60,Fail,46,37,0,6,40
60,Fail,49,22,6,8,41
60,Fail,48,25,3,17,31
60,Fail,37,39,5,12,25
60,Fail,43,26,0,23,20
60,Fail,44,26,1,15,29
60,Fail,49,24,7,11,38
60,Fail,46,24,3,14,32
60,Fail,50,23,1,16,34
60,Fail,49,19,5,15,34
60,Fail,50,26,1,11,39
60,Fail,47,25,3,15,32
60,Fail,50,27,0,9,41
60,Fail,51,28,0,13,38
60,Fail,48,23,2,15,33
60,Fail,60,21,0,4,56
60,Fail,48,28,2,12,36
60,Fail,50,29,0,11,39
60,Fail,59,21,0,11,48
60,Fail,51,24,1,8,43
60,Fail,48,25,7,12,36
60,Fail,53,25,0,9,44
60,Fail,50,26,0,12,38
60,Fail,47,27,4,13,34
60,Fail,50,25,3,12,38
60,Fail,39,26,5,18,21
60,Fail,53,27,0,11,42
60,Fail,42,30,1,11,31
60,Fail,44,28,0,12,32
60,Fail,51,30,0,9,42
60,Fail,49,27,1,10,39
60,Fail,45,26,5,15,30
60,Fail,54,22,0,11,43
60,Fail,55,23,0,4,51
60,Fail,50,30,0,11,39
60,Fail,47,28,0,15,32
60,Fail,47,30,1,13,34
60,Fail,50,23,6,11,39
60,Fail,48,26,4,9,39
60,Fail,42,40,0,11,31
60,Fail,48,21,5,14,34
60,Fail,46,29,0,18,28
60,Fail,46,21,4,16,30
60,Fail,57,21,5,11,46
60,Fail,46,33,0,8,38
60,Fail,49,25,4,10,39
60,Fail,58,26,0,7,51
60,Fail,54,21,2,11,43
60,Fail,47,34,0,8,39
60,Fail,50,30,0,14,36
60,Fail,44,37,0,12,32
60,Fail,51,24,2,13,38
60,Fail,49,35,0,6,43
60,Fail,48,24,9,11,37
60,Fail,49,20,3,17,32
60,Fail,45,34,6,5,40
60,Fail,47,26,0,13,34
60,Fail,47,30,0,9,38
60,Fail,59,18,6,7,52
60,Fail,38,27,19,13,25
60,Fail,52,24,3,11,41
60,Fail,50,31,0,10,40
60,Fail,47,25,0,15,32
60,Fail,41,37,0,15,26
60,Fail,45,27,1,13,32
60,Fail,47,33,6,9,38
60,Fail,55,18,0,14,41
60,Fail,51,25,3,13,38
60,Fail,48,30,4,8,40
60,Fail,45,29,0,16,29
60,Fail,54,24,0,6,48
60,Fail,50,26,1,15,35
60,Fail,54,22,0,14,40
60,Fail,45,31,1,11,34
60,Fail,53,18,1,14,39
60,Fail,47,22,4,14,33
60,Fail,42,34,0,16,26
60,Fail,46,31,2,13,33
60,Fail,50,25,3,14,36
60,Fail,41,19,9,20,21
60,Fail,50,24,0,14,36
60,Fail,39,34,3,14,25
60,Fail,43,26,6,16,27
60,Fail,46,35,0,9,37
60,Fail,48,28,0,13,35
60,Fail,49,25,0,11,38
60,Fail,47,30,0,11,36
60,Fail,54,29,0,12,42
60,Fail,46,32,0,14,32
60,Fail,50,22,0,17,33
60,Fail,46,32,0,12,34
60,Fail,48,20,4,14,34
60,Fail,35,33,8,15,20
60,Fail,45,34,0,15,30
60,Fail,55,20,0,13,42
60,Fail,48,24,4,13,35
60,Fail,52,22,3,12,40
60,Fail,46,29,0,12,34
60,Fail,47,26,0,15,32
60,Fail,51,24,3,10,41
60,Fail,51,23,3,15,36
60,Fail,46,29,10,11,35
60,Fail,52,20,3,13,39
60,Fail,42,32,0,19,23
60,Fail,42,28,0,19,23
60,Fail,54,27,0,6,48
60,Fail,53,21,1,11,42
60,Fail,58,21,0,5,53
60,Fail,43,29,0,20,23
60,Fail,48,23,2,13,35
60,Fail,45,37,0,11,34
60,Fail,56,27,0,8,48
60,Fail,44,24,10,13,31
60,Fail,55,18,2,14,41
60,Fail,50,27,0,12,38
60,Fail,42,28,3,18,24
60,Fail,48,22,5,15,33
60,Fail,48,29,0,12,36
60,Fail,52,26,0,12,40
60,Fail,50,23,4,15,35
60,Fail,49,35,0,9,40
60,Fail,54,27,0,6,48
60,Fail,42,38,0,12,30
60,Fail,47,26,2,14,33
60,Fail,41,33,0,17,24
60,Fail,48,26,0,13,35
60,Fail,53,27,3,6,47
60,Fail,52,21,4,12,40
60,Fail,51,24,0,18,33
60,Fail,52,26,0,11,41
60,Fail,45,25,12,14,31
60,Fail,42,31,0,16,26
60,Fail,49,22,2,15,34
60,Fail,56,20,0,16,40
60,Fail,46,27,0,14,32
60,Fail,53,23,3,9,44
60,Fail,38,33,0,21,17
60,Fail,53,24,3,13,40
60,Fail,50,26,0,14,36
60,Fail,48,33,0,10,38
60,Fail,42,31,0,17,25
60,Fail,45,25,0,20,25
60,Fail,46,29,0,18,28
60,Fail,52,19,10,12,40
60,Fail,47,30,0,8,39
60,Fail,42,35,0,12,30
60,Fail,42,29,0,18,24
60,Fail,46,32,0,14,32
60,Fail,50,26,3,9,41
60,Fail,46,36,0,13,33
60,Fail,44,33,0,13,31
60,Fail,51,23,4,11,40
60,Fail,43,37,0,12,31
60,Fail,48,21,4,16,32
60,Fail,52,28,0,12,40
60,Fail,45,20,3,18,27
60,Fail,46,32,0,11,35
60,Fail,39,30,8,14,25
60,Fail,57,21,0,17,40
60,Fail,50,23,5,12,38
60,Fail,44,31,0,12,32
60,Fail,48,25,1,17,31
60,Fail,53,23,0,12,41
60,Fail,47,24,9,12,35
60,Fail,51,22,0,16,35
60,Fail,55,27,0,7,48
60,Fail,53,23,4,10,43
60,Fail,55,21,1,13,42
60,Fail,55,18,5,14,41
60,Fail,49,30,0,15,34
60,Fail,47,28,0,14,33
60,Fail,52,24,1,13,39
60,Fail,45,39,0,10,35
60,Fail,55,19,5,9,46
60,Fail,43,37,0,10,33
60,Fail,49,24,2,10,39
60,Fail,44,28,2,9,35
60,Fail,45,28,9,9,36
60,Fail,48,20,6,14,34
60,Fail,45,27,5,13,32
60,Fail,43,27,5,15,28
60,Fail,51,28,0,10,41
60,Fail,50,13,0,19,31
60,Fail,53,23,0,10,43
60,Fail,36,35,0,19,17
60,Fail,48,22,0,16,32
60,Fail,53,22,0,15,38
60,Fail,62,22,0,4,58
60,Fail,46,28,4,14,32
60,Fail,48,25,3,16,32
60,Fail,46,21,7,18,28
60,Fail,48,32,0,10,38
60,Fail,49,24,0,15,34
60,Fail,52,26,1,12,40
60,Fail,44,29,4,15,29
60,Fail,39,29,2,21,18
60,Fail,54,20,0,12,42
60,Fail,56,17,3,14,42
60,Fail,41,31,0,18,23
60,Fail,47,33,0,14,33
60,Fail,34,44,0,11,23
60,Fail,44,32,0,12,32
60,Fail,50,29,0,12,38
60,Fail,47,31,0,9,38
60,Fail,49,33,0,9,40
60,Fail,42,37,0,14,28
60,Fail,41,40,0,13,28
60,Fail,47,23,8,15,32
60,Fail,48,20,3,19,29
60,Fail,60,23,0,6,54
60,Fail,48,30,3,11,37
60,Fail,48,28,0,13,35
60,Fail,49,25,0,12,37
60,Fail,45,31,3,13,32
60,Fail,49,33,0,9,40
60,Fail,56,18,0,18,38
60,Fail,48,28,0,16,32
60,Fail,50,23,0,11,39
60,Fail,49,29,0,11,38
60,Fail,48,20,9,16,32
60,Fail,46,26,0,17,29
60,Fail,52,17,4,17,35
60,Fail,35,28,17,15,20
60,Fail,50,31,0,11,39
60,Fail,45,26,7,16,29
60,Fail,47,26,3,15,32
60,Fail,50,28,3,11,39
60,Fail,52,27,1,10,42
60,Fail,56,20,3,11,45
60,Fail,53,21,2,13,40
60,Fail,45,32,3,10,35
60,Fail,47,21,0,20,27
60,Fail,49,25,0,14,35
60,Fail,52,20,7,8,44
60,Fail,45,29,1,14,31
60,Fail,50,31,4,6,44
60,Fail,45,25,7,15,30
60,Fail,52,28,0,7,45
60,Fail,48,32,0,10,38
60,Fail,51,19,6,15,36
60,Fail,40,38,0,16,24
60,Fail,47,26,1,15,32
60,Fail,38,41,0,13,25
60,Fail,44,35,0,13,31
60,Fail,42,27,3,15,27
60,Fail,56,20,0,14,42
60,Fail,47,23,4,19,28
60,Fail,55,23,0,13,42
60,Fail,43,29,4,14,29
60,Fail,44,25,3,15,29
60,Fail,40,32,0,15,25
60,Fail,58,22,4,6,52
60,Fail,56,30,0,6,50
60,Fail,46,32,0,11,35
60,Fail,47,27,3,16,31
60,Fail,44,25,2,17,27
60,Fail,52,21,0,16,36
60,Fail,57,17,3,13,44
60,Fail,46,25,5,12,34
60,Fail,51,33,0,10,41
60,Fail,54,22,0,11,43
60,Fail,51,30,0,6,45
60,Fail,50,26,1,11,39
60,Fail,48,33,0,10,38
60,Fail,52,25,1,11,41
60,Fail,46,27,1,15,31
60,Fail,45,29,1,13,32
60,Fail,53,30,0,6,47
60,Fail,48,28,0,15,33
60,Fail,50,25,0,13,37
60,Fail,48,30,0,13,35
60,Fail,48,27,1,15,33
60,Fail,51,27,0,10,41
60,Fail,45,35,0,13,32
60,Fail,43,33,0,16,27
60,Fail,54,29,0,6,48
60,Fail,49,26,0,10,39
60,Fail,46,30,0,13,33
60,Fail,55,24,0,10,45
60,Fail,39,39,0,12,27
60,Fail,49,24,2,12,37
60,Fail,49,24,0,12,37
60,Fail,51,21,4,12,39
60,Fail,40,29,14,11,29
60,Fail,47,28,0,15,32
60,Fail,54,22,2,10,44
60,Fail,45,29,4,13,32
60,Fail,54,19,0,14,40
60,Fail,50,21,1,12,38
60,Fail,57,21,5,7,50
60,Fail,49,30,0,9,40
60,Fail,48,19,3,18,30
60,Fail,49,28,0,15,34
60,Fail,51,27,0,13,38
60,Fail,43,30,0,17,26
60,Fail,54,23,0,13,41
60,Fail,57,20,0,12,45
60,Fail,54,21,2,13,41
60,Fail,39,26,12,13,26
60,Fail,55,25,0,8,47
60,Fail,49,23,6,11,38
60,Fail,44,34,0,12,32
60,Fail,52,19,3,15,37
60,Fail,52,28,0,11,41
60,Fail,39,32,2,16,23
60,Fail,52,21,7,8,44
60,Fail,53,20,0,14,39
60,Fail,46,25,3,7,39
60,Fail,57,17,5,13,44
60,Fail,45,29,2,14,31
60,Fail,45,31,0,16,29
60,Fail,48,35,0,9,39
60,Fail,43,27,3,15,28
60,Fail,60,18,2,8,52
60,Fail,48,24,8,11,37
60,Fail,60,19,1,8,52
60,Fail,56,20,0,13,43
60,Fail,44,27,4,13,31
60,Fail,43,25,3,16,27
60,Fail,51,23,6,11,40
60,Fail,49,20,5,10,39
60,Fail,51,22,2,11,40
60,Fail,51,31,2,7,44
60,Fail,48,26,3,9,39
60,Fail,43,36,0,9,34
60,Fail,49,27,0,11,38
60,Fail,52,23,0,13,39
60,Fail,43,31,8,11,32
60,Fail,50,31,0,11,39
60,Fail,49,21,4,13,36
60,Fail,44,28,6,14,30
60,Fail,54,28,0,9,45
60,Fail,50,29,0,7,43
60,Fail,53,25,0,8,45
60,Fail,49,24,5,13,36
60,Fail,56,16,5,13,43
60,Fail,51,32,2,10,41
60,Fail,44,29,0,18,26
60,Fail,46,23,5,17,29
60,Fail,59,28,0,8,51
60,Fail,40,26,7,17,23
60,Fail,51,30,2,10,41
60,Fail,52,23,3,14,38
60,Fail,50,28,0,15,35
60,Fail,49,32,0,8,41
60,Fail,45,26,6,12,33
60,Fail,55,22,0,12,43
60,Fail,42,39,0,9,33
60,Fail,47,20,0,20,27
60,Fail,46,28,1,10,36
60,Fail,48,19,8,18,30
60,Fail,53,23,5,12,41
60,Fail,52,28,0,8,44
60,Fail,54,20,0,18,36
60,Fail,58,20,0,8,50
60,Fail,45,28,0,16,29
60,Fail,50,25,2,11,39
60,Fail,42,33,5,11,31
60,Fail,50,30,0,12,38
60,Fail,50,27,0,12,38
60,Fail,43,25,5,16,27
60,Fail,50,26,3,9,41
60,Fail,47,22,0,16,31
60,Fail,54,24,0,8,46
60,Fail,47,37,0,9,38
60,Fail,46,22,0,15,31
60,Fail,50,30,0,11,39
60,Fail,44,37,0,9,35
60,Fail,52,31,0,10,42
60,Fail,41,33,7,10,31
60,Fail,48,30,5,10,38
60,Fail,43,31,0,16,27
60,Fail,52,23,4,14,38
60,Fail,40,38,0,12,28
60,Fail,46,28,6,10,36
60,Fail,53,22,4,10,43
60,Fail,51,20,2,11,40
60,Fail,47,24,0,14,33
60,Fail,42,33,0,14,28
60,Fail,53,23,0,12,41
60,Fail,42,25,11,15,27
60,Fail,47,33,0,12,35
60,Fail,40,30,0,16,24
60,Fail,44,31,0,11,33
60,Fail,48,24,7,14,34
60,Fail,52,20,1,19,33
60,Fail,48,31,0,15,33
60,Fail,53,24,3,13,40
60,Fail,49,21,0,18,31
60,Fail,50,28,0,15,35
60,Fail,49,29,0,9,40
60,Fail,52,31,1,6,46
60,Fail,40,32,0,18,22
60,Fail,45,26,0,17,28
60,Fail,50,21,5,13,37
60,Fail,44,26,10,8,36
60,Fail,45,31,2,11,34
60,Fail,44,32,7,11,33
60,Fail,45,26,1,18,27
60,Fail,56,25,0,10,46
60,Fail,43,37,0,11,32
60,Fail,55,25,4,8,47
60,Fail,50,19,0,13,37
60,Fail,46,23,5,14,32
60,Fail,50,23,7,9,41
60,Fail,50,17,2,14,36
60,Fail,53,19,1,18,35
60,Fail,55,25,0,11,44
60,Fail,44,34,0,13,31
60,Fail,41,37,0,13,28
60,Fail,45,40,0,3,42
60,Fail,46,25,0,14,32
60,Fail,46,29,0,16,30
60,Fail,48,24,3,14,34
60,Fail,52,17,0,24,28
60,Fail,41,26,7,17,24
60,Fail,47,29,0,11,36
60,Fail,37,29,12,15,22
60,Fail,42,28,5,13,29
60,Fail,43,32,0,13,30
60,Fail,38,34,8,14,24
60,Fail,49,26,6,9,40
60,Fail,48,26,0,11,37
60,Fail,49,24,0,17,32
60,Fail,43,30,3,12,31
60,Fail,40,39,1,12,28
60,Fail,45,23,11,13,32
60,Fail,55,29,0,8,47
60,Fail,53,31,0,8,45
60,Fail,40,27,6,15,25
60,Fail,49,24,1,11,38
60,Fail,46,26,0,16,30
60,Fail,49,24,3,13,36
60,Fail,46,32,0,14,32
60,Fail,48,29,1,11,37
60,Fail,48,30,0,13,35
60,Fail,49,25,0,14,35
60,Fail,50,27,1,10,40
60,Fail,44,28,14,5,39
60,Fail,46,33,0,13,33
60,Fail,41,36,0,18,23
60,Fail,46,26,0,16,30
60,Fail,52,23,2,11,41
60,Fail,49,23,6,13,36
60,Fail,44,32,0,17,27
60,Fail,50,28,2,10,40
60,Fail,53,29,0,7,46
60,Fail,58,21,1,10,48
60,Fail,56,22,0,12,44
60,Fail,48,33,0,12,36
60,Fail,46,28,8,10,36
60,Fail,54,21,0,16,38
60,Fail,41,28,5,17,24
60,Fail,45,28,0,16,29
60,Fail,42,32,0,16,26
60,Fail,50,20,3,13,37
60,Fail,48,24,0,16,32
60,Fail,54,22,2,10,44
60,Fail,46,32,0,12,34
60,Fail,46,34,0,8,38
60,Fail,43,30,0,16,27
60,Fail,49,29,0,15,34
60,Fail,50,26,0,16,34
60,Fail,53,27,0,7,46
60,Fail,52,26,0,14,38
60,Fail,44,22,4,18,26
60,Fail,47,31,0,11,36
60,Fail,43,25,3,15,28
60,Fail,52,17,3,16,36
60,Fail,49,31,0,13,36
60,Fail,49,28,3,8,41
60,Fail,38,40,0,17,21
60,Fail,48,27,4,14,34
60,Fail,42,38,0,12,30
60,Fail,40,36,0,12,28
60,Fail,44,24,2,17,27
60,Fail,49,25,4,13,36
60,Fail,49,35,0,7,42
60,Fail,53,25,0,6,47
60,Fail,47,29,0,11,36
60,Fail,48,28,0,13,35
60,Fail,47,23,5,13,34
60,Fail,38,37,0,17,21
60,Fail,46,28,0,16,30
60,Fail,50,30,0,12,38
60,Fail,45,29,0,19,26
60,Fail,52,22,3,12,40
60,Fail,44,27,11,10,34
60,Fail,50,25,4,10,40
60,Fail,49,29,0,15,34
60,Fail,51,23,4,11,40
60,Fail,39,28,8,16,23
60,Fail,55,23,0,11,44
60,Fail,45,37,0,11,34
60,Fail,38,33,11,11,27
60,Fail,50,29,2,9,41
60,Fail,50,32,0,8,42
60,Fail,40,36,0,14,26
60,Fail,61,21,0,9,52
60,Fail,47,36,0,7,40
60,Fail,50,18,1,18,32
60,Fail,48,29,4,7,41
60,Fail,49,28,0,12,37
60,Fail,53,25,3,8,45
60,Fail,50,28,0,14,36
60,Fail,42,29,0,17,25
60,Fail,44,24,0,22,22
60,Fail,49,28,1,10,39
60,Fail,46,32,0,11,35
60,Fail,51,25,5,9,42
60,Fail,46,27,0,14,32
60,Fail,53,25,0,11,42
60,Fail,46,27,4,13,33
60,Fail,45,32,3,10,35
60,Fail,49,23,0,15,34
60,Fail,51,24,0,14,37
60,Fail,39,35,0,16,23
60,Fail,44,37,0,10,34
60,Fail,47,24,3,17,30
60,Fail,52,21,2,14,38
60,Fail,47,32,0,11,36
60,Fail,38,40,0,15,23
60,Fail,47,27,6,14,33
60,Fail,46,30,3,11,35
60,Fail,46,29,1,12,34
60,Fail,55,25,3,9,46
60,Fail,48,29,2,10,38
60,Fail,48,28,0,12,36
60,Fail,50,18,0,18,32
60,Fail,48,25,0,15,33
60,Fail,45,27,0,16,29
60,Fail,51,23,0,9,42
60,Fail,49,29,8,7,42
60,Fail,45,34,1,9,36
60,Fail,46,26,1,17,29
60,Fail,46,34,0,9,37
60,Fail,46,32,0,11,35
60,Fail,53,21,2,11,42
60,Fail,51,26,0,12,39
60,Fail,52,25,3,9,43
60,Fail,59,13,4,11,48
60,Fail,51,22,2,12,39
60,Fail,43,29,3,14,29
60,Fail,44,27,0,17,27
60,Fail,47,26,3,11,36
60,Fail,41,33,7,10,31
60,Fail,47,25,3,13,34
60,Fail,50,26,3,6,44
60,Fail,57,18,0,13,44
60,Fail,45,23,8,12,33
60,Fail,45,29,0,12,33
60,Fail,47,29,0,13,34
60,Fail,50,27,0,15,35
60,Fail,46,26,0,12,34
60,Fail,40,30,1,20,20
60,Fail,47,26,0,16,31
60,Fail,44,27,4,12,32
60,Fail,47,19,10,12,35
60,Fail,44,24,7,17,27
60,Fail,51,28,0,11,40
60,Fail,50,25,0,9,41
60,Fail,49,23,4,15,34
60,Fail,51,34,2,5,46
60,Fail,49,32,0,11,38
60,Fail,50,30,0,12,38
60,Fail,53,25,0,13,40
60,Fail,49,28,5,11,38
60,Fail,50,16,13,15,35
60,Fail,45,26,9,11,34
60,Fail,50,29,0,14,36
60,Fail,46,29,0,15,31
60,Fail,52,28,0,7,45
60,Fail,43,40,0,9,34
60,Fail,39,32,11,9,30
60,Fail,44,35,0,9,35
60,Fail,54,23,2,12,42
60,Fail,54,30,0,6,48
60,Fail,49,28,2,11,38
60,Fail,35,38,0,17,18
60,Fail,48,30,0,13,35
60,Fail,52,22,0,10,42
60,Fail,49,24,10,7,42
60,Fail,51,23,4,12,39
60,Fail,50,23,0,15,35
60,Fail,45,31,10,8,37
60,Fail,51,29,0,11,40
60,Fail,49,33,0,7,42
60,Fail,47,32,0,14,33
60,Fail,42,32,9,10,32
60,Fail,48,23,0,17,31
60,Fail,53,20,0,13,40
60,Fail,54,25,0,13,41
60,Fail,57,20,0,10,47
60,Fail,48,26,0,16,32
60,Fail,44,24,5,18,26
60,Fail,54,27,0,11,43
60,Fail,39,34,0,18,21
60,Fail,50,16,13,15,35
60,Fail,48,31,0,14,34
60,Fail,50,28,0,11,39
60,Fail,44,25,3,17,27
60,Fail,50,22,5,13,37
60,Fail,53,25,0,14,39
60,Fail,49,30,0,10,39
60,Fail,56,21,0,11,45
60,Fail,48,33,0,7,41
60,Fail,43,27,10,12,31
60,Fail,47,33,0,10,37
60,Fail,59,17,0,10,49
60,Fail,44,37,3,9,35
60,Fail,46,23,4,20,26
60,Fail,42,32,0,17,25
60,Fail,42,28,9,13,29
60,Fail,49,32,0,12,37
60,Fail,52,24,7,11,41
60,Fail,58,25,0,6,52
60,Fail,51,24,0,12,39
60,Fail,41,40,0,10,31
60,Fail,45,24,1,20,25
60,Fail,47,26,3,11,36
60,Fail,38,32,7,15,23
60,Fail,51,19,3,16,35
60,Fail,47,35,0,12,35
60,Fail,50,21,6,15,35
60,Fail,49,24,1,14,35
60,Fail,48,27,0,18,30
60,Fail,41,31,5,10,31
60,Fail,48,26,0,16,32
60,Fail,53,20,4,10,43
60,Fail,48,29,0,14,34
60,Fail,44,30,1,16,28
60,Fail,42,24,6,20,22
60,Fail,46,30,0,13,33
60,Fail,34,39,0,18,16
60,Fail,48,35,0,9,39
60,Fail,48,23,0,15,33
60,Fail,55,20,0,12,43
60,Fail,51,31,0,9,42
60,Fail,48,28,0,16,32
60,Fail,46,26,1,15,31
60,Fail,47,19,6,17,30
60,Fail,54,28,0,8,46
60,Fail,45,30,2,13,32
60,Fail,53,32,0,5,48
60,Fail,53,22,6,8,45
60,Fail,46,28,0,10,36
60,Fail,48,32,0,12,36
60,Fail,50,24,0,10,40
60,Fail,50,17,0,10,40
60,Fail,51,21,5,14,37
60,Fail,55,20,5,7,48
60,Fail,46,25,0,15,31
60,Fail,46,34,0,11,35
60,Fail,45,32,0,16,29
60,Fail,49,29,1,8,41
60,Fail,54,19,5,10,44
60,Fail,53,23,9,9,44
60,Fail,44,33,7,10,34
60,Fail,49,22,7,13,36
60,Fail,49,36,0,8,41
60,Fail,47,26,0,15,32
60,Fail,38,37,0,15,23
60,Fail,47,19,6,17,30
60,Fail,53,24,2,3,50
60,Fail,39,39,0,15,24
60,Fail,43,35,0,12,31
60,Fail,47,32,0,12,35
60,Fail,52,16,9,13,39
60,Fail,48,29,0,13,35
60,Fail,42,27,4,14,28
60,Fail,43,26,0,22,21
60,Fail,46,19,2,18,28
60,Fail,51,28,3,9,42
60,Fail,49,31,0,11,38
60,Fail,47,32,0,10,37
60,Fail,45,37,0,12,33
60,Fail,48,33,0,8,40
60,Fail,49,26,5,12,37
60,Fail,47,28,0,12,35
60,Fail,57,18,8,13,44
60,Fail,49,27,0,14,35
60,Fail,45,35,0,12,33
60,Fail,48,30,0,10,38
60,Fail,51,19,1,18,33
60,Fail,49,20,0,18,31
60,Fail,46,23,3,16,30
60,Fail,43,29,0,17,26
60,Fail,51,28,3,10,41
60,Fail,47,29,0,11,36
60,Fail,55,19,0,10,45
60,Fail,39,33,0,17,22
60,Fail,43,35,0,13,30
60,Fail,49,25,4,11,38
60,Fail,45,30,1,12,33
60,Fail,48,28,0,11,37
60,Fail,48,24,2,12,36
60,Fail,43,30,7,11,32
60,Fail,52,24,0,12,40
60,Fail,50,30,2,7,43
60,Fail,54,20,0,16,38
60,Fail,50,26,0,12,38
60,Fail,47,28,3,10,37
60,Fail,54,21,0,14,40
60,Fail,51,22,8,11,40
60,Fail,49,22,5,14,35
60,Fail,49,29,0,16,33
60,Fail,39,36,0,13,26
60,Fail,46,26,2,12,34
60,Fail,50,27,0,12,38
60,Fail,54,26,2,11,43
60,Fail,44,23,0,18,26
60,Fail,47,34,0,11,36
60,Fail,42,36,0,13,29
60,Fail,48,30,0,11,37
60,Fail,41,35,0,13,28
60,Fail,40,33,0,19,21
60,Fail,50,27,0,13,37
60,Fail,50,33,0,7,43
60,Fail,48,30,0,8,40
60,Fail,48,25,0,14,34
60,Fail,45,38,0,10,35
60,Fail,53,23,0,10,43
60,Fail,44,26,0,17,27
60,Fail,52,29,0,8,44
60,Fail,48,18,7,17,31
60,Fail,40,42,0,9,31
60,Fail,42,32,0,13,29
60,Fail,47,21,3,15,32
60,Fail,41,33,0,12,29
60,Fail,46,19,0,18,28
60,Fail,53,22,0,15,38
60,Fail,44,35,0,10,34
60,Fail,51,24,2,11,40
60,Fail,50,24,0,17,33
60,Fail,44,24,11,11,33
60,Fail,45,34,0,15,30
60,Fail,47,28,4,9,38
60,Fail,49,31,0,11,38
60,Fail,48,32,0,7,41
60,Fail,40,34,0,17,23
60,Fail,48,31,0,8,40
60,Fail,43,31,5,9,34
60,Fail,43,31,0,12,31
60,Fail,48,28,0,14,34
60,Fail,47,23,13,9,38
60,Fail,48,32,2,6,42
60,Fail,53,25,0,10,43
60,Fail,44,26,2,19,25
60,Fail,45,29,2,15,30
60,Fail,50,23,0,12,38
60,Fail,52,28,0,10,42
60,Fail,46,24,8,16,30
60,Fail,52,26,3,7,45
60,Fail,37,29,3,19,18
60,Fail,51,18,3,14,37
60,Fail,50,23,5,10,40
60,Fail,44,25,15,10,34
60,Fail,46,34,0,10,36
60,Fail,47,22,6,19,28
60,Fail,49,23,0,14,35
60,Fail,44,21,8,17,27
60,Fail,45,31,0,14,31
60,Fail,49,30,0,11,38
60,Fail,49,26,0,16,33
60,Fail,49,26,0,15,34
60,Fail,54,31,0,4,50
60,Fail,48,23,7,9,39
60,Fail,40,38,0,12,28
60,Fail,43,27,3,16,27
60,Fail,47,32,0,13,34
60,Fail,47,31,2,12,35
60,Fail,52,22,0,13,39
60,Fail,50,29,0,11,39
60,Fail,44,25,7,14,30
60,Fail,45,30,3,10,35
60,Fail,56,19,3,10,46
60,Fail,52,23,7,11,41
60,Fail,41,31,0,15,26
60,Fail,52,25,2,13,39
60,Fail,51,21,2,17,34
60,Fail,45,29,0,15,30
60,Fail,53,28,0,9,44
60,Fail,47,34,0,13,34
60,Fail,55,25,0,7,48
60,Fail,46,28,0,15,31
60,Fail,39,30,0,17,22
60,Fail,44,30,0,11,33
60,Fail,49,25,5,9,40
60,Fail,40,22,13,11,29
60,Fail,55,19,2,11,44
60,Fail,51,21,5,11,40
60,Fail,52,27,0,10,42
60,Fail,48,32,0,12,36
60,Fail,54,26,3,7,47
60,Fail,51,31,0,9,42
60,Fail,50,28,0,13,37
60,Fail,47,30,0,12,35
60,Fail,37,35,0,13,24
60,Fail,45,29,0,12,33
60,Fail,53,21,0,8,45
60,Fail,45,36,0,9,36
60,Fail,52,29,1,8,44
60,Fail,44,31,5,9,35
60,Fail,47,22,2,17,30
60,Fail,47,28,0,12,35
60,Fail,50,28,0,9,41
60,Fail,52,29,0,10,42
60,Fail,45,29,0,16,29
60,Fail,43,29,1,17,26
60,Fail,41,36,3,11,30
60,Fail,53,28,0,9,44
60,Fail,56,18,3,11,45
60,Fail,50,30,0,9,41
60,Fail,41,29,3,16,25
60,Fail,52,23,0,14,38
60,Fail,44,26,6,13,31
60,Fail,49,22,3,16,33
60,Fail,43,25,0,19,24
60,Fail,49,25,6,10,39
60,Fail,53,24,4,11,42
60,Fail,53,28,0,9,44
60,Fail,49,28,0,8,41
60,Fail,54,30,0,7,47
60,Fail,52,27,0,12,40
60,Fail,38,44,0,10,28
60,Fail,41,31,0,16,25
60,Fail,53,20,0,11,42
60,Fail,58,19,0,9,49
60,Fail,51,23,5,13,38
60,Fail,47,27,0,15,32
60,Fail,42,31,3,14,28
60,Fail,48,35,0,8,40
60,Fail,44,29,6,14,30
60,Fail,44,31,1,12,32
60,Fail,43,25,0,18,25
60,Fail,47,31,0,12,35
60,Fail,54,30,0,8,46
60,Fail,46,32,1,10,36
60,Fail,47,29,0,15,32
60,Fail,41,37,0,14,27
60,Fail,48,30,0,15,33
60,Fail,40,29,9,13,27
60,Fail,52,23,2,11,41
60,Fail,43,30,1,13,30
60,Fail,47,32,0,10,37
60,Fail,46,34,0,14,32
60,Fail,47,26,3,14,33
60,Fail,45,29,5,11,34
60,Fail,50,25,2,12,38
60,Fail,51,20,0,18,33
60,Fail,45,27,0,15,30
60,Fail,43,35,0,14,29
60,Fail,50,24,4,16,34
60,Fail,46,34,0,11,35
60,Fail,49,22,10,9,40
60,Fail,48,22,3,17,31
60,Fail,49,31,5,6,43
60,Fail,52,23,0,17,35
60,Fail,50,29,0,12,38
60,Fail,47,28,2,11,36
60,Fail,45,26,3,18,27
60,Fail,44,24,5,15,29
60,Fail,44,31,2,15,29
60,Fail,43,36,0,15,28
60,Fail,42,38,0,10,32
60,Fail,47,32,0,11,36
60,Fail,45,22,9,18,27
60,Fail,47,42,0,4,43
60,Fail,47,29,0,11,36
60,Fail,44,33,0,16,28
60,Fail,48,27,0,11,37
60,Fail,50,20,1,21,29
60,Fail,52,26,2,11,41
60,Fail,46,31,1,11,35
60,Fail,46,32,0,12,34
60,Fail,51,26,1,10,41
60,Fail,53,26,0,10,43
60,Fail,45,26,4,12,33
60,Fail,53,22,0,12,41
60,Fail,44,35,0,11,33
60,Fail,47,30,0,10,37
60,Fail,43,34,0,12,31
60,Fail,45,21,8,16,29
60,Fail,53,23,1,14,39
60,Fail,47,22,3,15,32
60,Fail,50,26,0,13,37
60,Fail,46,31,0,12,34
60,Fail,46,29,2,14,32
60,Fail,44,26,2,15,29
60,Fail,50,25,0,12,38
60,Fail,39,30,6,16,23
60,Fail,45,28,4,11,34
60,Fail,50,19,5,15,35
60,Fail,43,27,5,13,30
60,Fail,59,18,0,13,46
60,Fail,54,17,0,16,38
60,Fail,47,32,0,11,36
60,Fail,54,19,6,11,43
60,Fail,45,30,1,15,30
60,Fail,44,31,0,13,31
60,Fail,45,27,0,14,31
60,Fail,50,20,0,20,30
60,Fail,41,33,6,8,33
60,Fail,51,24,7,9,42
60,Fail,49,32,0,11,38
60,Fail,48,21,0,16,32
60,Fail,48,32,0,10,38
60,Fail,48,28,6,10,38
60,Fail,50,32,0,10,40
60,Fail,49,22,1,16,33
60,Fail,50,21,3,14,36
60,Fail,54,28,5,4,50
60,Fail,48,32,0,9,39
60,Fail,46,29,0,17,29
60,Fail,51,24,2,13,38
60,Fail,49,30,2,10,39
60,Fail,51,21,0,9,42
60,Fail,42,33,5,10,32
60,Fail,48,19,4,20,28
60,Fail,46,22,3,17,29
60,Fail,51,20,6,12,39
60,Fail,45,22,0,17,28
60,Fail,44,26,9,13,31
60,Fail,41,31,2,18,23
60,Fail,45,29,0,16,29
60,Fail,42,41,0,12,30
60,Fail,38,33,5,16,22
60,Fail,42,35,0,13,29
60,Fail,50,26,0,15,35
60,Fail,58,18,1,11,47
60,Fail,45,29,4,10,35
60,Fail,56,18,0,13,43
60,Fail,43,24,6,14,29
60,Fail,38,39,0,16,22
60,Fail,45,22,6,19,26
60,Fail,43,38,0,14,29
60,Fail,51,23,6,8,43
60,Fail,53,27,0,9,44
60,Fail,52,28,0,12,40
60,Fail,44,26,0,15,29
60,Fail,41,38,0,15,26
60,Fail,42,30,0,19,23
60,Fail,48,23,2,11,37
60,Fail,42,29,4,15,27
60,Fail,56,19,0,11,45
60,Fail,47,29,1,10,37
60,Fail,49,29,0,13,36
60,Fail,39,34,7,13,26
60,Fail,46,34,0,14,32
60,Fail,42,34,2,10,32
60,Fail,52,24,0,14,38
60,Fail,39,40,0,15,24
60,Fail,41,28,5,13,28
60,Fail,45,30,0,13,32
60,Fail,55,24,0,10,45
60,Fail,46,29,0,16,30
60,Fail,58,16,0,13,45
60,Fail,54,23,0,8,46
60,Fail,52,21,0,16,36
60,Fail,52,26,3,7,45
60,Fail,48,18,3,18,30
60,Fail,49,34,0,7,42
60,Fail,49,29,1,12,37
60,Fail,55,25,4,5,50
60,Fail,51,28,0,16,35
60,Fail,50,28,0,12,38
60,Fail,41,35,0,12,29
60,Fail,50,29,7,6,44
60,Fail,45,18,7,17,28
60,Fail,48,32,0,9,39
60,Fail,49,34,0,7,42
60,Fail,44,32,7,11,33
60,Fail,48,31,0,12,36
60,Fail,43,32,0,14,29
60,Fail,48,32,0,8,40
60,Fail,42,25,5,21,21
60,Fail,45,31,0,11,34
60,Fail,47,17,1,22,25
60,Fail,45,34,0,11,34
60,Fail,41,27,0,21,20
60,Fail,45,29,2,12,33
60,Fail,50,27,1,8,42
60,Fail,48,28,0,13,35
60,Fail,50,26,0,15,35
60,Fail,49,36,0,5,44
60,Fail,47,23,4,12,35
60,Fail,47,27,3,19,28
60,Fail,51,23,1,11,40
60,Fail,56,20,0,11,45
60,Fail,48,29,0,13,35
60,Fail,55,23,0,9,46
60,Fail,46,33,0,8,38
60,Fail,57,22,0,9,48
60,Fail,56,18,2,8,48
60,Fail,41,39,0,11,30
60,Fail,49,29,1,13,36
60,Fail,45,28,0,14,31
60,Fail,50,30,0,13,37
60,Fail,49,28,2,14,35
60,Fail,45,28,3,14,31
60,Fail,52,25,0,14,38
60,Fail,44,39,0,9,35
60,Fail,48,26,6,11,37
60,Fail,50,28,0,11,39
60,Fail,48,24,1,17,31
60,Fail,45,27,0,17,28
60,Fail,49,27,4,8,41
60,Fail,52,26,0,9,43
60,Fail,44,35,0,14,30
60,Fail,44,33,0,14,30
60,Fail,48,24,0,15,33
60,Fail,43,26,2,15,28
60,Fail,42,30,7,13,29
60,Fail,47,28,1,15,32
60,Fail,49,29,7,5,44
60,Fail,54,25,0,14,40
60,Fail,51,20,5,9,42
60,Fail,50,25,3,14,36
60,Fail,46,32,0,12,34
60,Fail,53,28,0,11,42
60,Fail,56,22,0,7,49
60,Fail,49,27,2,9,40
60,Fail,55,19,4,14,41
60,Fail,42,25,2,18,24
60,Fail,48,21,2,19,29
60,Fail,54,18,4,12,42
60,Fail,40,33,0,12,28
60,Fail,51,23,4,10,41
60,Fail,44,32,0,13,31
60,Fail,46,24,0,17,29
60,Fail,55,23,2,10,45
60,Fail,45,33,0,12,33
60,Fail,50,20,0,18,32
60,Fail,43,37,0,8,35
60,Fail,50,27,0,12,38
60,Fail,59,19,3,8,51
60,Fail,48,28,0,12,36
60,Fail,46,31,0,10,36
60,Fail,47,30,1,12,35
60,Fail,43,31,5,12,31
60,Fail,48,30,0,9,39
60,Fail,54,19,3,11,43
60,Fail,45,30,0,15,30
60,Fail,54,25,0,9,45
60,Fail,48,27,0,12,36
60,Fail,48,24,0,18,30
60,Fail,48,23,0,18,30
60,Fail,46,25,9,12,34
60,Fail,51,24,0,14,37
60,Fail,52,30,0,12,40
60,Fail,53,24,6,8,45
60,Fail,42,32,0,13,29
60,Fail,53,21,1,11,42
60,Fail,51,22,2,15,36
60,Fail,46,27,2,14,32
60,Fail,42,30,7,11,31
60,Fail,52,24,2,12,40
60,Fail,47,32,0,11,36
60,Fail,44,25,4,17,27
60,Fail,46,28,0,18,28
60,Fail,47,26,0,16,31
60,Fail,49,31,0,11,38
60,Fail,46,32,0,11,35
60,Fail,42,28,5,18,24
60,Fail,48,31,0,13,35
60,Fail,40,35,0,16,24
60,Fail,44,29,0,16,28
60,Fail,49,27,0,13,36
60,Fail,51,26,0,16,35
60,Fail,52,27,0,9,43
60,Fail,52,29,0,9,43
60,Fail,53,22,2,10,43
60,Fail,48,25,7,10,38
60,Fail,55,25,2,11,44
60,Fail,48,35,0,13,35
60,Fail,42,35,0,10,32
60,Fail,42,38,0,12,30
60,Fail,42,36,0,12,30
60,Fail,45,26,3,14,31
60,Fail,44,30,6,8,36
60,Fail,43,32,5,12,31
60,Fail,46,29,1,13,33
60,Fail,50,27,0,12,38
60,Fail,53,22,0,13,40
60,Fail,49,22,0,18,31
60,Fail,46,28,0,16,30
60,Fail,45,32,0,10,35
60,Fail,47,19,10,15,32
60,Fail,43,40,0,12,31
60,Fail,49,26,7,10,39
60,Fail,51,24,7,4,47
60,Fail,43,34,0,17,26
60,Fail,53,25,3,6,47
60,Fail,45,35,0,9,36
60,Fail,50,25,0,9,41
60,Fail,43,30,4,14,29
60,Fail,53,28,0,10,43
60,Fail,53,25,0,12,41
60,Fail,48,26,4,12,36
60,Fail,47,31,0,15,32
60,Fail,52,25,2,9,43
60,Fail,47,24,3,15,32
60,Fail,51,28,0,13,38
60,Fail,49,18,4,14,35
60,Fail,51,27,0,16,35
60,Fail,52,23,3,12,40
60,Fail,51,25,0,13,38
60,Fail,48,36,0,9,39
60,Fail,48,19,8,15,33
60,Fail,50,21,1,13,37
60,Fail,45,32,0,16,29
60,Fail,43,30,6,11,32
60,Fail,49,34,0,9,40
60,Fail,51,23,0,14,37
60,Fail,56,28,0,8,48
60,Fail,53,29,0,6,47
60,Fail,48,26,4,10,38
60,Fail,55,21,3,11,44
60,Fail,42,36,0,11,31
60,Fail,52,23,3,8,44
60,Fail,43,27,9,16,27
60,Fail,46,31,0,13,33
60,Fail,55,19,1,18,37
60,Fail,44,33,0,14,30
60,Fail,48,25,3,10,38
60,Fail,45,30,5,10,35
60,Fail,41,26,6,16,25
60,Fail,44,24,10,12,32
60,Fail,48,20,7,13,35
60,Fail,55,23,0,11,44
60,Fail,47,30,6,13,34
60,Fail,46,31,0,13,33
60,Fail,48,30,0,13,35
60,Fail,57,17,0,13,44
60,Fail,46,30,0,15,31
60,Fail,44,26,6,13,31
60,Fail,52,25,2,10,42
60,Fail,45,27,6,13,32
60,Fail,45,31,2,9,36
60,Fail,46,27,3,11,35
60,Fail,45,30,2,11,34
60,Fail,48,24,1,14,34
60,Fail,53,19,3,16,37
60,Fail,46,23,6,13,33
60,Fail,43,25,9,16,27
60,Fail,45,28,2,13,32
60,Fail,56,20,4,13,43
60,Fail,55,20,2,11,44
60,Fail,58,21,0,12,46
60,Fail,49,27,4,11,38
60,Fail,51,25,4,10,41
60,Fail,46,34,0,12,34
60,Fail,41,33,4,15,26
60,Fail,42,36,0,8,34
60,Fail,45,28,0,16,29
60,Fail,43,34,0,9,34
60,Fail,52,31,0,10,42
60,Fail,52,23,7,11,41
60,Fail,46,27,0,12,34
60,Fail,52,26,0,12,40
60,Fail,53,21,0,10,43
60,Fail,42,29,11,13,29
60,Fail,50,31,0,11,39
60,Fail,44,34,0,11,33
60,Fail,51,26,0,16,35
60,Fail,46,32,0,12,34
60,Fail,52,32,0,9,43
60,Fail,43,32,4,13,30
60,Fail,43,31,0,13,30
60,Fail,47,17,13,16,31
60,Fail,39,32,0,19,20
60,Fail,42,31,3,15,27
60,Fail,58,14,5,13,45
60,Fail,47,26,5,17,30
60,Fail,42,35,1,10,32
60,Fail,42,36,0,13,29
60,Fail,53,26,0,12,41
60,Fail,59,23,0,14,45
60,Fail,52,26,0,5,47
60,Fail,48,25,4,13,35
60,Fail,46,28,1,12,34
60,Fail,42,27,7,17,25
60,Fail,51,18,4,14,37
60,Fail,55,25,0,13,42
60,Fail,52,26,7,10,42
60,Fail,53,28,0,12,41
60,Fail,55,17,5,10,45
60,Fail,51,26,0,14,37
60,Fail,52,27,3,12,40
60,Fail,39,26,7,19,20
60,Fail,53,26,1,9,44
60,Fail,53,18,2,16,37
60,Fail,49,19,0,25,24
60,Fail,47,27,1,14,33
60,Fail,54,27,0,8,46
60,Fail,46,26,6,9,37
60,Fail,45,22,7,15,30
60,Fail,54,23,0,8,46
60,Fail,50,34,0,9,41
60,Fail,48,24,0,13,35
60,Fail,54,28,0,11,43
60,Fail,50,24,4,15,35
60,Fail,45,25,8,13,32
60,Fail,54,25,0,9,45
60,Fail,45,25,10,13,32
60,Fail,55,21,9,6,49
60,Fail,52,24,1,9,43
60,Fail,54,21,0,12,42
60,Fail,52,17,5,16,36
60,Fail,60,24,0,6,54
60,Fail,47,27,0,16,31
60,Fail,52,28,3,8,44
60,Fail,50,25,0,15,35
60,Fail,41,38,0,13,28
60,Fail,49,28,0,16,33
60,Fail,58,19,0,9,49
60,Fail,48,28,0,14,34
60,Fail,55,20,0,13,42
60,Fail,57,23,0,9,48
60,Fail,47,33,0,9,38
60,Fail,46,30,0,15,31
60,Fail,49,17,8,17,32
60,Fail,37,32,3,19,18
60,Fail,45,23,5,18,27
60,Fail,52,23,0,13,39
60,Fail,45,27,0,16,29
60,Fail,49,27,0,11,38
60,Fail,41,22,15,16,25
60,Fail,45,28,4,12,33
60,Fail,41,23,2,21,20
60,Fail,52,26,0,10,42
60,Fail,46,30,1,10,36
60,Fail,44,18,1,25,19
60,Fail,43,27,5,15,28
60,Fail,47,25,9,12,35
60,Fail,47,29,4,7,40
60,Fail,53,24,0,12,41
60,Fail,51,27,0,10,41
60,Fail,46,25,4,17,29
60,Fail,59,19,0,11,48
60,Fail,42,37,1,8,34
60,Fail,50,31,0,7,43
60,Fail,54,26,0,9,45
60,Fail,49,27,3,14,35
60,Fail,36,38,0,18,18
60,Fail,44,30,4,12,32
60,Fail,47,25,0,15,32
60,Fail,49,36,0,4,45
60,Fail,54,22,0,13,41
60,Fail,50,25,2,10,40
60,Fail,51,26,1,13,38
60,Fail,45,33,0,14,31
60,Fail,44,39,0,9,35
60,Fail,53,26,4,9,44
60,Fail,48,23,0,20,28
60,Fail,54,22,1,11,43
60,Fail,44,24,10,12,32
60,Fail,45,25,4,15,30
60,Fail,48,26,3,9,39
60,Fail,48,23,4,17,31
60,Fail,50,25,7,10,40
60,Fail,47,30,0,13,34
60,Fail,45,30,0,11,34
60,Fail,45,30,1,12,33
60,Fail,44,21,1,18,26
60,Fail,53,23,0,12,41
60,Fail,37,30,6,17,20
60,Fail,53,24,5,6,47
60,Fail,47,30,0,15,32
60,Fail,43,30,0,14,29
60,Fail,48,29,0,11,37
60,Fail,48,26,3,11,37
60,Fail,40,34,0,16,24
60,Fail,44,24,0,20,24
60,Fail,39,29,8,17,22
60,Fail,50,23,0,16,34
60,Fail,56,23,0,10,46
60,Fail,52,26,0,11,41
60,Fail,56,18,4,10,46
60,Fail,56,19,0,12,44
60,Fail,45,30,6,10,35
60,Fail,40,26,6,16,24
60,Fail,44,30,0,14,30
60,Fail,54,19,3,12,42
60,Fail,41,42,0,9,32
60,Fail,40,33,0,16,24
60,Fail,51,29,0,8,43
60,Fail,45,35,0,10,35
60,Fail,51,27,0,12,39
60,Fail,51,22,0,13,38
60,Fail,46,33,0,13,33
60,Fail,49,22,1,18,31
60,Fail,53,20,3,14,39
60,Fail,45,28,6,12,33
60,Fail,45,30,3,12,33
60,Fail,50,26,0,15,35
60,Fail,53,22,3,10,43
60,Fail,49,29,2,8,41
60,Fail,43,31,1,13,30
60,Fail,42,33,4,10,32
60,Fail,46,31,0,11,35
60,Fail,50,30,0,11,39
60,Fail,40,37,0,16,24
60,Fail,46,21,3,18,28
60,Fail,47,29,2,16,31
60,Fail,53,23,0,10,43
60,Fail,54,25,4,7,47
60,Fail,44,22,7,20,24
60,Fail,49,24,0,12,37
60,Fail,44,29,1,11,33
60,Fail,43,34,0,14,29
60,Fail,53,27,0,11,42
60,Fail,51,26,2,9,42
60,Fail,47,22,9,13,34
60,Fail,46,32,0,12,34
60,Fail,48,30,0,13,35
60,Fail,44,23,6,17,27
60,Fail,36,34,5,17,19
60,Fail,47,21,15,10,37
60,Fail,50,17,11,15,35
60,Fail,40,38,0,17,23
60,Fail,53,30,0,5,48
60,Fail,50,35,0,5,45
60,Fail,51,25,0,13,38
60,Fail,40,29,6,14,26
60,Fail,46,21,6,15,31
60,Fail,53,24,3,10,43
60,Fail,44,35,0,15,29
60,Fail,50,24,1,14,36
60,Fail,43,36,0,12,31
60,Fail,43,32,5,11,32
60,Fail,50,20,5,14,36
60,Fail,48,24,2,14,34
60,Fail,47,27,0,13,34
60,Fail,56,22,1,7,49
60,Fail,46,31,0,12,34
60,Fail,43,33,0,13,30
60,Fail,48,26,7,15,33
60,Fail,51,23,1,14,37
60,Fail,46,26,5,12,34
60,Fail,53,24,2,11,42
60,Fail,49,27,0,13,36
60,Fail,50,22,3,14,36
60,Fail,51,26,0,13,38
60,Fail,48,34,0,10,38
60,Fail,45,26,3,16,29
60,Fail,43,30,0,15,28
60,Fail,48,22,1,15,33
60,Fail,52,25,0,13,39
60,Fail,49,19,2,17,32
60,Fail,39,37,0,15,24
60,Fail,45,27,0,17,28
60,Fail,41,41,0,12,29
60,Fail,46,24,14,9,37
60,Fail,48,25,1,13,35
60,Fail,46,31,0,13,33
60,Fail,51,30,0,8,43
60,Fail,57,23,1,10,47
60,Fail,41,33,0,12,29
60,Fail,60,20,0,7,53
60,Fail,43,40,0,11,32
60,Fail,50,23,4,9,41
60,Fail,51,31,0,11,40
60,Fail,45,33,0,14,31
60,Fail,54,21,2,13,41
60,Fail,48,23,3,17,31
60,Fail,44,34,0,12,32
60,Fail,46,31,3,9,37
60,Fail,53,22,0,13,40
60,Fail,43,29,0,15,28
60,Fail,49,29,1,10,39
60,Fail,51,23,0,16,35
60,Fail,49,23,5,15,34
60,Fail,51,27,0,10,41
60,Fail,42,40,0,12,30
60,Fail,42,27,10,13,29
60,Fail,50,18,11,12,38
60,Fail,49,28,0,12,37
60,Fail,60,17,5,10,50
60,Fail,46,21,1,18,28
60,Fail,51,25,4,9,42
60,Fail,40,32,3,17,23
60,Fail,46,32,0,14,32
60,Fail,44,30,0,16,28
60,Fail,50,22,2,16,34
60,Fail,46,24,0,17,29
60,Fail,51,25,0,15,36
60,Fail,50,26,0,12,38
60,Fail,40,25,8,16,24
60,Fail,54,21,0,13,41
60,Fail,50,21,7,13,37
60,Fail,55,19,5,11,44
60,Fail,46,34,0,8,38
60,Fail,50,25,3,11,39
60,Fail,47,23,1,19,28
60,Fail,44,31,0,14,30
60,Fail,39,28,9,18,21
60,Fail,42,39,0,11,31
60,Fail,52,25,0,8,44
60,Fail,46,33,0,15,31
60,Fail,49,27,0,17,32
60,Fail,47,27,0,13,34
60,Fail,50,31,0,8,42
60,Fail,52,25,1,9,43
60,Fail,43,23,2,19,24
60,Fail,55,22,0,10,45
60,Fail,52,18,6,15,37
60,Fail,40,38,0,13,27
60,Fail,49,27,0,13,36
60,Fail,38,33,2,16,22
60,Fail,47,20,2,16,31
60,Fail,46,30,0,16,30
60,Fail,44,30,1,13,31
60,Fail,42,30,1,13,29
60,Fail,52,29,0,10,42
60,Fail,53,22,1,14,39
60,Fail,44,30,4,12,32
60,Fail,46,25,0,17,29
60,Fail,46,21,0,20,26
60,Fail,40,38,0,12,28
60,Fail,45,32,0,13,32
60,Fail,45,35,0,10,35
60,Fail,41,33,10,11,30
60,Fail,41,31,1,15,26
60,Fail,45,24,5,18,27
60,Fail,49,23,7,11,38
60,Fail,49,21,3,13,36
60,Fail,55,25,7,6,49
60,Fail,43,29,8,15,28
60,Fail,45,34,0,11,34
60,Fail,50,26,0,15,35
60,Fail,51,18,1,18,33
60,Fail,53,21,1,11,42
60,Fail,51,23,0,11,40
60,Fail,44,25,7,18,26
60,Fail,47,31,2,8,39
60,Fail,56,23,0,11,45
60,Fail,48,32,0,10,38
60,Fail,36,31,3,14,22
60,Fail,42,35,3,10,32
60,Fail,45,25,6,9,36
60,Fail,45,25,8,15,30
60,Fail,51,23,10,11,40
60,Fail,51,24,0,13,38
60,Fail,50,29,3,10,40
60,Fail,44,33,0,15,29
60,Fail,49,30,4,6,43
60,Fail,48,26,5,14,34
60,Fail,42,25,16,9,33
60,Fail,40,28,9,15,25
60,Fail,51,21,4,15,36
60,Fail,50,31,3,8,42
60,Fail,48,28,0,12,36
60,Fail,47,26,6,11,36
60,Fail,52,29,0,10,42
60,Fail,51,26,1,7,44
60,Fail,51,25,0,11,40
60,Fail,52,22,0,10,42
60,Fail,43,30,0,12,31
60,Fail,44,25,1,17,27
60,Fail,52,22,0,10,42
60,Fail,49,28,0,15,34
60,Fail,52,19,4,13,39
60,Fail,45,28,0,15,30
60,Fail,42,28,4,14,28
60,Fail,54,21,6,12,42
60,Fail,51,20,0,12,39
60,Fail,50,24,4,12,38
60,Fail,47,35,0,8,39
60,Fail,52,19,7,13,39
60,Fail,54,20,5,13,41
60,Fail,49,21,2,17,32
60,Fail,50,25,3,10,40
60,Fail,44,33,0,14,30
60,Fail,45,30,0,11,34
60,Fail,48,21,4,16,32
60,Fail,42,25,1,18,24
60,Fail,45,33,6,9,36
60,Fail,44,27,8,12,32
60,Fail,57,19,1,13,44
60,Fail,51,31,0,8,43
60,Fail,52,23,5,6,46
60,Fail,48,22,0,14,34
60,Fail,45,21,0,16,29
60,Fail,46,30,0,12,34
60,Fail,54,22,3,8,46
60,Fail,48,31,4,7,41
60,Fail,48,26,1,12,36
60,Fail,45,33,0,9,36
60,Fail,45,25,0,19,26
60,Fail,45,29,1,15,30
60,Fail,47,26,0,16,31
60,Fail,47,30,0,13,34
60,Fail,40,36,0,13,27
60,Fail,51,22,2,13,38
60,Fail,52,24,0,14,38
60,Fail,46,25,5,14,32
60,Fail,43,28,6,15,28
60,Fail,48,24,10,10,38
60,Fail,47,23,0,19,28
60,Fail,45,34,0,14,31
60,Fail,52,24,0,13,39
60,Fail,55,23,0,8,47
60,Fail,49,21,5,13,36
60,Fail,53,25,1,6,47
60,Fail,48,26,0,13,35
60,Fail,43,24,5,18,25
60,Fail,48,28,0,9,39
60,Fail,43,27,5,17,26
60,Fail,54,21,0,15,39
60,Fail,46,35,0,10,36
60,Fail,54,23,1,8,46
60,Fail,42,19,17,13,29
60,Fail,55,23,0,10,45
60,Fail,45,30,2,13,32
60,Fail,57,23,0,8,49
60,Fail,51,25,1,14,37
60,Fail,45,33,7,7,38
60,Fail,54,20,0,14,40
60,Fail,49,29,0,9,40
60,Fail,46,25,8,13,33
60,Fail,46,29,0,11,35
60,Fail,49,25,0,11,38
60,Fail,46,29,0,13,33
60,Fail,58,26,0,8,50
60,Fail,42,37,1,7,35
60,Fail,50,28,0,13,37
60,Fail,43,33,4,6,37
60,Fail,49,22,12,8,41
60,Fail,51,23,6,12,39
60,Fail,46,26,0,16,30
60,Fail,53,22,0,12,41
60,Fail,46,35,0,11,35
60,Fail,39,42,0,8,31
60,Fail,51,28,0,11,40
60,Fail,50,25,0,14,36
60,Fail,52,29,1,9,43
60,Fail,51,28,4,9,42
60,Fail,52,26,0,12,40
60,Fail,35,32,10,17,18
60,Fail,47,27,3,13,34
60,Fail,44,33,0,11,33
60,Fail,42,28,4,15,27
60,Fail,48,27,0,16,32
60,Fail,52,20,6,12,40
60,Fail,48,24,0,20,28
60,Fail,49,21,0,17,32
60,Fail,54,23,0,11,43
60,Fail,52,29,0,9,43
60,Fail,51,17,11,12,39
60,Fail,39,27,11,16,23
60,Fail,48,25,0,16,32
60,Fail,51,28,0,10,41
60,Fail,47,23,7,14,33
60,Fail,49,27,0,14,35
60,Fail,45,31,0,11,34
60,Fail,54,20,0,16,38
60,Fail,47,29,5,13,34
60,Fail,47,23,2,16,31
60,Fail,52,29,0,10,42
60,Fail,41,38,1,13,28
60,Fail,38,35,3,13,25
60,Fail,44,24,0,20,24
60,Fail,42,35,4,10,32
60,Fail,50,25,7,12,38
60,Fail,54,23,0,13,41
60,Fail,54,32,0,4,50
60,Fail,42,28,10,15,27
60,Fail,48,25,0,17,31
60,Fail,46,32,0,12,34
60,Fail,43,30,0,17,26
60,Fail,47,22,3,16,31
60,Fail,45,31,0,14,31
60,Fail,44,25,2,16,28
60,Fail,44,38,0,12,32
60,Fail,46,34,0,10,36
60,Fail,39,39,0,12,27
60,Fail,59,15,0,13,46
60,Fail,54,23,0,11,43
60,Fail,49,27,0,13,36
60,Fail,47,25,0,15,32
60,Fail,51,25,0,11,40
60,Fail,48,24,7,15,33
60,Fail,52,21,4,14,38
60,Fail,44,29,1,13,31
60,Fail,44,41,0,7,37
60,Fail,48,26,0,15,33
60,Fail,59,21,0,8,51
60,Fail,44,31,0,12,32
60,Fail,48,28,2,11,37
60,Fail,48,24,3,13,35
60,Fail,47,26,0,17,30
60,Fail,47,28,0,13,34
60,Fail,47,27,3,11,36
60,Fail,53,24,0,10,43
60,Fail,54,19,5,9,45
60,Fail,44,19,4,16,28
60,Fail,55,28,0,5,50
60,Fail,56,20,0,12,44
60,Fail,48,26,10,7,41
60,Fail,41,20,8,20,21
60,Fail,47,20,0,17,30
60,Fail,46,24,9,11,35
60,Fail,49,29,8,8,41
60,Fail,41,35,5,12,29
60,Fail,51,24,0,14,37
60,Fail,52,22,4,15,37
60,Fail,50,20,1,13,37
60,Fail,50,26,0,11,39
60,Fail,54,22,2,7,47
60,Fail,49,20,2,21,28
60,Fail,50,35,1,4,46
60,Fail,47,31,0,14,33
60,Fail,49,25,6,9,40
60,Fail,46,32,0,10,36
60,Fail,48,24,6,11,37
60,Fail,53,19,3,13,40
60,Fail,42,30,8,11,31
60,Fail,48,30,0,13,35
60,Fail,48,27,5,12,36
60,Fail,54,21,0,12,42
60,Fail,46,30,1,12,34
60,Fail,50,16,2,23,27
60,Fail,47,34,0,10,37
60,Fail,42,29,1,16,26
60,Fail,50,23,1,12,38
60,Fail,44,34,0,12,32
60,Fail,51,25,3,10,41
60,Fail,46,32,0,12,34
60,Fail,41,32,0,18,23
60,Fail,46,30,8,7,39
60,Fail,48,23,0,15,33
60,Fail,42,29,4,15,27
60,Fail,49,32,0,11,38
60,Fail,50,25,0,13,37
60,Fail,51,25,2,13,38
60,Fail,50,30,0,10,40
60,Fail,52,23,0,12,40
60,Fail,48,21,0,16,32
60,Fail,48,28,0,13,35
60,Fail,51,21,0,13,38
60,Fail,45,30,0,15,30
60,Fail,43,26,6,16,27
60,Fail,44,33,0,14,30
60,Fail,51,24,0,8,43
60,Fail,45,29,8,11,34
60,Fail,43,30,6,14,29
60,Fail,45,30,0,11,34
60,Fail,48,26,5,11,37
60,Fail,46,24,0,23,23
60,Fail,48,28,3,11,37
60,Fail,51,23,1,14,37
60,Fail,49,31,0,11,38
60,Fail,52,25,1,12,40
60,Fail,43,29,10,13,30
60,Fail,50,21,4,15,35
60,Fail,45,26,6,14,31
60,Fail,52,17,6,15,37
60,Fail,48,28,1,12,36
60,Fail,46,28,3,13,33
60,Fail,46,31,7,8,38
60,Fail,57,21,1,8,49
60,Fail,46,26,5,17,29
60,Fail,47,31,0,11,36
60,Fail,48,25,4,15,33
60,Fail,52,27,0,7,45
60,Fail,41,32,4,14,27
60,Fail,41,35,0,17,24
60,Fail,48,27,2,13,35
60,Fail,50,24,5,7,43
60,Fail,51,24,1,13,38
60,Fail,53,19,3,13,40
60,Fail,56,20,3,8,48
60,Fail,47,38,0,6,41
60,Fail,49,24,5,12,37
60,Fail,35,32,19,12,23
60,Fail,51,20,6,14,37
60,Fail,46,24,4,16,30
60,Fail,42,29,6,13,29
60,Fail,50,21,1,14,36
60,Fail,47,25,2,17,30
60,Fail,49,27,0,13,36
60,Fail,50,25,0,12,38
60,Fail,46,23,0,20,26
60,Fail,46,26,3,15,31
60,Fail,45,30,0,13,32
60,Fail,53,24,0,10,43
60,Fail,43,35,0,9,34
60,Fail,50,25,1,14,36
60,Fail,47,30,0,15,32
60,Fail,50,27,0,12,38
60,Fail,44,28,0,17,27
60,Fail,44,28,0,15,29
60,Fail,47,32,0,10,37
60,Fail,48,19,5,18,30
60,Fail,47,25,0,18,29
60,Fail,48,32,0,12,36
60,Fail,48,27,0,17,31
60,Fail,47,28,0,15,32
60,Fail,52,26,0,12,40
60,Fail,42,27,9,12,30
60,Fail,50,23,0,11,39
60,Fail,55,29,0,6,49
60,Fail,51,26,1,12,39
60,Fail,51,26,0,7,44
60,Fail,55,24,0,6,49
60,Fail,45,21,7,19,26
60,Fail,52,21,0,14,38
60,Fail,49,27,0,13,36
60,Fail,57,23,0,10,47
60,Fail,53,30,0,7,46
60,Fail,45,26,0,18,27
60,Fail,47,25,0,17,30
60,Fail,38,30,8,14,24
60,Fail,44,28,0,16,28
60,Fail,41,24,2,15,26
60,Fail,44,30,0,13,31
60,Fail,49,29,0,13,36
60,Fail,48,25,5,14,34
60,Fail,54,24,0,10,44
60,Fail,34,43,0,17,17
60,Fail,49,27,0,11,38
60,Fail,53,24,4,9,44
60,Fail,49,23,6,14,35
60,Fail,49,16,1,16,33
60,Fail,50,30,0,8,42
60,Fail,51,25,10,8,43
60,Fail,52,27,0,12,40
60,Fail,49,21,11,13,36
60,Fail,48,27,10,5,43
60,Fail,49,26,0,14,35
60,Fail,49,19,11,14,35
60,Fail,43,32,0,11,32
60,Fail,52,24,2,11,41
60,Fail,47,32,0,13,34
60,Fail,51,20,3,14,37
60,Fail,49,28,0,11,38
60,Fail,44,37,0,9,35
60,Fail,43,37,0,10,33
60,Fail,49,24,1,11,38
60,Fail,54,18,2,14,40
60,Fail,41,29,0,18,23
60,Fail,43,33,0,14,29
60,Fail,48,36,0,4,44
60,Fail,49,26,3,11,38
60,Fail,44,39,0,13,31
60,Fail,56,22,0,12,44
60,Fail,47,31,4,8,39
60,Fail,44,26,8,15,29
60,Fail,44,21,10,15,29
60,Fail,52,22,4,11,41
60,Fail,47,37,0,8,39
60,Fail,49,23,1,18,31
60,Fail,55,21,0,10,45
60,Fail,45,28,0,14,31
60,Fail,55,15,0,16,39
60,Fail,39,42,0,11,28
60,Fail,48,23,4,15,33
60,Fail,43,28,1,17,26
60,Fail,51,31,0,10,41
60,Fail,50,25,5,11,39
60,Fail,50,20,7,12,38
60,Fail,49,23,0,18,31
60,Fail,52,27,0,8,44
60,Fail,45,30,1,11,34
60,Fail,54,22,0,14,40
60,Fail,53,21,1,15,38
60,Fail,51,29,0,10,41
60,Fail,48,33,0,14,34
60,Fail,48,26,4,11,37
60,Fail,49,28,0,10,39
60,Fail,58,15,0,14,44
60,Fail,45,27,7,16,29
60,Fail,44,33,0,15,29
60,Fail,48,22,3,14,34
60,Fail,47,31,0,9,38
60,Fail,39,35,8,12,27
60,Fail,43,30,0,17,26
60,Fail,47,29,1,13,34
60,Fail,49,25,0,16,33
60,Fail,44,33,0,13,31
60,Fail,52,27,0,8,44
60,Fail,42,39,0,10,32
60,Fail,43,28,7,15,28
60,Fail,47,33,0,12,35
60,Fail,56,17,0,12,44
60,Fail,50,21,4,13,37
60,Fail,42,37,0,14,28
60,Fail,46,32,0,14,32
60,Fail,48,25,3,15,33
60,Fail,47,27,5,11,36
60,Fail,54,19,2,11,43
60,Fail,56,23,0,15,41
60,Fail,54,20,1,11,43
60,Fail,52,18,0,17,35
60,Fail,50,26,0,9,41
60,Fail,46,26,0,14,32
60,Fail,45,25,0,16,29
60,Fail,50,24,0,13,37
60,Fail,47,24,7,12,35
60,Fail,50,21,5,14,36
60,Fail,52,23,0,13,39
60,Fail,39,44,0,12,27
60,Fail,43,31,3,14,29
60,Fail,50,24,0,15,35
60,Fail,52,28,0,7,45
60,Fail,54,26,3,9,45
60,Fail,48,27,1,15,33
60,Fail,51,30,1,8,43
60,Fail,43,36,0,14,29
60,Fail,41,25,6,17,24
60,Fail,47,19,9,15,32
60,Fail,49,19,9,12,37
60,Fail,48,27,4,12,36
60,Fail,44,32,0,13,31
60,Fail,45,31,0,14,31
60,Fail,47,23,0,14,33
60,Fail,49,22,5,16,33
60,Fail,48,16,10,18,30
60,Fail,51,20,3,15,36
60,Fail,59,21,3,7,52
60,Fail,41,24,9,17,24
60,Fail,48,21,6,14,34
60,Fail,59,17,0,11,48
60,Fail,50,24,0,13,37
60,Fail,52,28,3,7,45
60,Fail,47,33,0,11,36
60,Fail,39,30,10,17,22
60,Fail,45,29,0,14,31
60,Fail,40,26,4,17,23
60,Fail,54,26,0,7,47
60,Fail,46,29,0,13,33
60,Fail,45,22,6,19,26
60,Fail,46,26,1,17,29
60,Fail,47,21,0,21,26
60,Fail,51,27,0,9,42
60,Fail,51,21,4,12,39
60,Fail,44,34,5,9,35
60,Fail,46,20,4,19,27
60,Fail,43,29,9,8,35
60,Fail,52,23,0,12,40
60,Fail,44,29,3,12,32
60,Fail,51,23,0,12,39
60,Fail,48,23,6,16,32
60,Fail,45,31,0,11,34
60,Fail,46,27,2,13,33
60,Fail,50,33,0,11,39
60,Fail,49,25,0,17,32
60,Fail,50,25,6,6,44
60,Fail,43,23,6,22,21
60,Fail,49,34,0,11,38
60,Fail,61,15,0,12,49
60,Fail,49,21,4,13,36
60,Fail,44,33,0,16,28
60,Fail,52,23,6,11,41
60,Fail,49,26,0,14,35
60,Fail,48,26,0,12,36
60,Fail,52,21,0,17,35
60,Fail,47,25,2,13,34
60,Fail,48,36,0,11,37
60,Fail,54,21,0,12,42
60,Fail,51,19,9,12,39
60,Fail,41,30,0,17,24
60,Fail,53,24,4,8,45
60,Fail,51,19,2,17,34
60,Fail,50,25,0,15,35
60,Fail,46,28,8,6,40
60,Fail,53,21,0,13,40
60,Fail,45,34,0,11,34
60,Fail,55,16,2,15,40
60,Fail,40,32,8,14,26
60,Fail,48,25,8,10,38
60,Fail,54,24,0,12,42
60,Fail,51,25,0,11,40
60,Fail,48,35,0,10,38
60,Fail,49,32,0,10,39
60,Fail,50,24,0,13,37
60,Fail,60,21,0,7,53
60,Fail,47,24,0,16,31
60,Fail,51,24,4,9,42
60,Fail,41,34,0,14,27
60,Fail,47,24,1,15,32
60,Fail,38,31,5,18,20
60,Fail,49,21,1,17,32
60,Fail,47,30,6,6,41
60,Fail,51,21,3,15,36
60,Fail,53,29,0,11,42
60,Fail,49,29,0,12,37
60,Fail,42,31,4,15,27
60,Fail,42,31,1,13,29
60,Fail,52,25,1,10,42
60,Fail,51,26,1,11,40
60,Fail,45,33,0,10,35
60,Fail,48,26,5,12,36
60,Fail,44,31,0,16,28
60,Fail,49,31,0,9,40
60,Fail,44,35,0,14,30
60,Fail,49,26,0,12,37
60,Fail,50,32,0,6,44
60,Fail,51,25,4,7,44
60,Fail,47,26,0,14,33
60,Fail,45,20,4,18,27
60,Fail,50,21,8,11,39
60,Fail,55,17,6,9,46
60,Fail,45,33,0,12,33
60,Fail,52,31,0,7,45
60,Fail,50,25,0,16,34
60,Fail,48,20,0,20,28
60,Fail,46,35,0,14,32
60,Fail,47,26,0,10,37
60,Fail,38,32,0,18,20
60,Fail,47,25,2,17,30
60,Fail,47,26,0,16,31
60,Fail,48,28,0,14,34
60,Fail,48,24,5,13,35
60,Fail,48,21,0,21,27
60,Fail,46,27,2,17,29
60,Fail,49,25,0,13,36
60,Fail,46,34,0,14,32
60,Fail,52,27,0,12,40
60,Fail,51,24,5,13,38
60,Fail,49,25,2,13,36
60,Fail,52,25,0,10,42
60,Fail,47,27,3,14,33
60,Fail,45,33,0,11,34
60,Fail,48,30,0,12,36
60,Fail,49,20,1,13,36
60,Fail,45,30,5,9,36
60,Fail,45,33,2,13,32
60,Fail,50,26,0,15,35
60,Fail,42,20,8,20,22
60,Fail,44,31,0,13,31
60,Fail,51,21,2,17,34
60,Fail,45,31,2,9,36
60,Fail,53,22,4,11,42
60,Fail,47,30,2,10,37
60,Fail,45,27,0,15,30
60,Fail,36,40,0,13,23
60,Fail,47,35,0,9,38
60,Fail,56,24,0,9,47
60,Fail,41,28,0,19,22
60,Fail,51,22,0,16,35
60,Fail,51,25,0,12,39
60,Fail,51,24,0,14,37
60,Fail,49,22,3,14,35
60,Fail,56,30,0,5,51
60,Fail,46,25,0,16,30
60,Fail,43,32,5,10,33
60,Fail,59,18,3,8,51
60,Fail,57,15,2,11,46
60,Fail,47,29,0,11,36
60,Fail,45,24,1,19,26
60,Fail,57,21,3,7,50
60,Fail,42,24,8,16,26
60,Fail,48,23,2,14,34
60,Fail,48,25,0,15,33
60,Fail,48,24,0,15,33
60,Fail,48,20,4,16,32
60,Fail,44,31,3,11,33
60,Fail,52,27,0,7,45
60,Fail,41,37,0,11,30
60,Fail,45,29,0,12,33
60,Fail,54,16,7,13,41
60,Fail,42,34,0,13,29
60,Fail,44,24,1,19,25
60,Fail,44,27,0,17,27
60,Fail,53,17,5,13,40
60,Fail,42,31,0,14,28
60,Fail,55,24,0,9,46
60,Fail,57,21,0,12,45
60,Fail,48,26,1,13,35
60,Fail,43,34,0,13,30
60,Fail,42,26,5,15,27
60,Fail,50,29,0,11,39
60,Fail,49,22,3,15,34
60,Fail,52,26,1,9,43
60,Fail,47,29,0,15,32
60,Fail,45,32,0,10,35
60,Fail,48,31,0,12,36
60,Fail,49,25,0,14,35
60,Fail,50,16,2,16,34
60,Fail,47,24,4,16,31
60,Fail,50,24,5,11,39
60,Fail,52,25,4,11,41
60,Fail,46,28,5,13,33
60,Fail,46,36,0,8,38
60,Fail,50,27,0,11,39
60,Fail,54,27,0,9,45
60,Fail,43,31,0,16,27
60,Fail,52,23,8,8,44
60,Fail,51,18,1,17,34
60,Fail,51,18,3,17,34
60,Fail,42,28,10,15,27
60,Fail,42,29,0,16,26
60,Fail,45,29,4,14,31
60,Fail,49,20,9,14,35
60,Fail,49,26,4,13,36
60,Fail,49,28,5,10,39
60,Fail,49,21,4,18,31
60,Fail,50,28,0,12,38
60,Fail,50,28,1,9,41
60,Fail,50,20,5,17,33
60,Fail,46,27,3,15,31
60,Fail,46,21,0,20,26
60,Fail,49,25,8,9,40
60,Fail,50,23,0,18,32
60,Fail,54,23,3,9,45
60,Fail,45,25,6,13,32
60,Fail,50,25,0,10,40
60,Fail,43,29,0,13,30
60,Fail,47,39,0,7,40
60,Fail,51,25,2,10,41
60,Fail,41,28,0,20,21
60,Fail,43,24,10,11,32
60,Fail,48,32,0,14,34
60,Fail,55,26,0,9,46
60,Fail,48,31,0,10,38
60,Fail,48,19,6,16,32
60,Fail,47,30,10,7,40
60,Fail,50,33,0,8,42
60,Fail,51,28,5,6,45
60,Fail,49,25,0,14,35
60,Fail,50,25,0,13,37
60,Fail,45,35,0,8,37
60,Fail,49,22,0,14,35
60,Fail,40,32,5,14,26
60,Fail,52,20,1,14,38
60,Fail,50,28,0,13,37
60,Fail,50,23,2,14,36
60,Fail,53,26,0,7,46
60,Fail,44,29,4,11,33
60,Fail,52,23,2,11,41
60,Fail,45,27,4,13,32
60,Fail,43,36,0,12,31
60,Fail,55,27,0,10,45
60,Fail,43,35,0,11,32
60,Fail,48,33,0,10,38
60,Fail,47,27,4,14,33
60,Fail,50,21,4,16,34
60,Fail,49,24,7,12,37
60,Fail,47,22,1,17,30
60,Fail,51,25,0,14,37
60,Fail,42,23,3,20,22
60,Fail,48,31,0,9,39
60,Fail,52,25,1,12,40
60,Fail,54,25,2,7,47
60,Fail,43,33,0,12,31
60,Fail,46,29,0,14,32
60,Fail,43,27,3,18,25
60,Fail,49,26,0,14,35
60,Fail,49,26,0,13,36
60,Fail,44,23,3,21,23
60,Fail,50,21,5,16,34
60,Fail,41,33,0,11,30
60,Fail,49,23,8,10,39
60,Fail,51,23,0,16,35
60,Fail,43,35,0,9,34
60,Fail,45,29,0,16,29
60,Fail,47,28,0,13,34
60,Fail,49,32,0,5,44
60,Fail,56,18,0,19,37
60,Fail,59,17,7,10,49
60,Fail,43,31,0,15,28
60,Fail,48,22,5,12,36
60,Fail,51,21,0,16,35
60,Fail,55,23,0,9,46
60,Fail,49,27,11,7,42
60,Fail,41,35,3,10,31
60,Fail,40,33,0,15,25
60,Fail,49,25,5,10,39
60,Fail,53,23,1,12,41
60,Fail,50,25,0,17,33
60,Fail,40,27,9,15,25
60,Fail,45,30,0,13,32
60,Fail,49,25,1,16,33
60,Fail,43,38,0,14,29
60,Fail,45,30,0,13,32
60,Fail,55,18,0,12,43
60,Fail,51,23,0,14,37
60,Fail,48,22,0,21,27
60,Fail,51,30,0,14,37
60,Fail,54,25,0,11,43
60,Fail,41,35,0,11,30
60,Fail,48,22,8,11,37
60,Fail,44,31,1,14,30
60,Fail,53,24,0,13,40
60,Fail,43,38,0,14,29
60,Fail,45,29,0,15,30
60,Fail,47,21,0,20,27
60,Fail,39,30,0,19,20
60,Fail,51,27,2,12,39
60,Fail,44,39,0,10,34
60,Fail,51,28,0,13,38
60,Fail,48,25,0,16,32
60,Fail,49,32,0,8,41
60,Fail,45,30,1,13,32
60,Fail,47,29,0,14,33
60,Fail,39,27,12,14,25
60,Fail,49,28,0,11,38
60,Fail,50,22,2,16,34
60,Fail,55,25,2,7,48
60,Fail,50,22,1,14,36
60,Fail,49,34,1,7,42
60,Fail,45,32,0,13,32
60,Fail,46,29,0,11,35
60,Fail,56,25,0,11,45
60,Fail,49,31,0,10,39
60,Fail,53,18,3,15,38
60,Fail,58,18,1,9,49
60,Fail,45,33,0,11,34
60,Fail,46,23,6,14,32
60,Fail,45,30,0,17,28
60,Fail,51,33,0,7,44
60,Fail,50,27,0,12,38
60,Fail,44,31,0,16,28
60,Fail,46,30,4,9,37
60,Fail,49,26,0,11,38
60,Fail,50,37,0,6,44
60,Fail,42,37,0,10,32
60,Fail,42,35,0,14,28
60,Fail,44,30,0,13,31
60,Fail,49,30,0,12,37
60,Fail,45,28,3,14,31
60,Fail,42,34,3,13,29
60,Fail,53,25,0,14,39
60,Fail,41,44,0,7,34
60,Fail,44,34,0,11,33
60,Fail,45,36,0,10,35
60,Fail,58,21,2,9,49
60,Fail,45,36,0,10,35
60,Fail,55,21,0,14,41
60,Fail,45,29,0,14,31
60,Fail,46,33,0,15,31
60,Fail,50,21,3,16,34
60,Fail,53,22,7,10,43
60,Fail,51,20,7,14,37
60,Fail,52,22,0,12,40
60,Fail,43,28,5,11,32
60,Fail,59,17,0,12,47
60,Fail,50,25,0,14,36
60,Fail,51,21,8,13,38
60,Fail,46,30,6,9,37
60,Fail,46,27,0,14,32
60,Fail,50,26,5,9,41
60,Fail,45,32,0,13,32
60,Fail,51,21,2,14,37
60,Fail,51,21,3,16,35
60,Fail,56,23,2,8,48
60,Fail,47,27,0,17,30
60,Fail,47,29,0,12,35
60,Fail,51,23,0,16,35
60,Fail,47,31,1,8,39
60,Fail,51,30,0,10,41
60,Fail,51,25,0,11,40
60,Fail,57,23,0,8,49
60,Fail,50,27,0,13,37
60,Fail,51,22,4,14,37
60,Fail,47,23,11,10,37
60,Fail,49,21,4,11,38
60,Fail,49,27,0,13,36
60,Fail,51,21,1,15,36
60,Fail,49,34,0,10,39
60,Fail,44,27,0,18,26
60,Fail,37,30,1,19,18
60,Fail,49,21,6,15,34
60,Fail,53,30,0,10,43
60,Fail,48,32,0,7,41
60,Fail,46,27,0,16,30
60,Fail,45,26,0,13,32
60,Fail,44,25,2,17,27
60,Fail,47,29,2,13,34
60,Fail,54,23,0,10,44
60,Fail,45,35,0,10,35
60,Fail,41,31,9,12,29
60,Fail,54,19,8,10,44
60,Fail,50,27,0,11,39
60,Fail,52,20,1,16,36
60,Fail,43,30,7,12,31
60,Fail,51,22,4,13,38
60,Fail,46,28,0,12,34
60,Fail,46,36,0,10,36
60,Fail,43,30,6,14,29
60,Fail,43,34,0,14,29
60,Fail,42,22,1,21,21
60,Fail,47,31,0,9,38
60,Fail,41,35,0,17,24
60,Fail,45,30,0,13,32
60,Fail,51,25,0,11,40
60,Fail,42,27,3,18,24
60,Fail,52,23,0,14,38
60,Fail,41,33,0,15,26
60,Fail,44,37,0,11,33
60,Fail,46,26,0,16,30
60,Fail,40,34,0,16,24
60,Fail,39,31,5,15,24
60,Fail,47,32,0,11,36
60,Fail,52,28,1,9,43
60,Fail,44,28,0,15,29
60,Fail,45,26,7,11,34
60,Fail,38,29,0,20,18
60,Fail,45,31,0,14,31
60,Fail,50,33,0,11,39
60,Fail,53,28,0,9,44
60,Fail,49,23,7,14,35
60,Fail,53,27,0,7,46
60,Fail,53,22,4,12,41
60,Fail,38,31,0,20,18
60,Fail,42,36,0,12,30
60,Fail,52,22,3,11,41
60,Fail,46,26,0,12,34
60,Fail,46,21,2,16,30
60,Fail,49,27,0,13,36
60,Fail,46,27,0,14,32
60,Fail,51,30,0,9,42
60,Fail,50,25,0,13,37
60,Fail,48,25,0,11,37
60,Fail,59,15,3,12,47
60,Fail,46,24,6,12,34
60,Fail,51,25,0,14,37
60,Fail,52,21,3,16,36
60,Fail,48,25,0,19,29
60,Fail,57,17,1,11,46
60,Fail,50,22,0,14,36
60,Fail,46,36,0,10,36
60,Fail,47,30,0,13,34
60,Fail,48,28,0,12,36
60,Fail,45,29,0,14,31
60,Fail,41,31,4,14,27
60,Fail,45,27,5,15,30
60,Fail,52,29,0,10,42
60,Fail,44,27,2,15,29
60,Fail,45,26,1,17,28
60,Fail,52,29,0,9,43
60,Fail,53,25,0,8,45
60,Fail,50,27,1,7,43
60,Fail,46,24,2,19,27
60,Fail,52,28,0,11,41
60,Fail,48,28,0,14,34
60,Fail,46,31,2,12,34
60,Fail,48,30,5,8,40
60,Fail,54,20,0,10,44
60,Fail,52,16,3,16,36
60,Fail,48,28,0,14,34
60,Fail,43,32,1,14,29
60,Fail,57,19,0,15,42
60,Fail,44,24,8,13,31
60,Fail,39,30,10,14,25
60,Fail,45,25,7,14,31
60,Fail,50,26,0,12,38
60,Fail,47,35,0,9,38
60,Fail,46,26,0,11,35
60,Fail,47,32,1,9,38
60,Fail,49,21,0,19,30
60,Fail,38,37,0,17,21
60,Fail,43,28,2,16,27
60,Fail,48,27,3,10,38
60,Fail,58,19,0,12,46
60,Fail,50,26,0,15,35
60,Fail,48,33,0,12,36
60,Fail,49,34,0,11,38
60,Fail,45,31,0,13,32
60,Fail,49,23,6,10,39
60,Fail,48,24,0,17,31
60,Fail,55,27,0,9,46
60,Fail,55,22,1,8,47
60,Fail,45,27,5,10,35
60,Fail,45,29,0,18,27
60,Fail,38,26,7,16,22
60,Fail,46,29,0,14,32
60,Fail,47,31,1,11,36
60,Fail,51,21,0,15,36
60,Fail,55,26,0,10,45
60,Fail,52,27,3,5,47
60,Fail,56,29,0,7,49
60,Fail,41,37,0,10,31
60,Fail,53,26,0,9,44
60,Fail,42,25,11,13,29
60,Fail,45,26,6,11,34
60,Fail,57,18,6,10,47
60,Fail,45,20,7,17,28
60,Fail,54,19,0,12,42
60,Fail,59,12,5,12,47
60,Fail,42,24,10,11,31
60,Fail,50,27,0,12,38
60,Fail,44,33,0,15,29
60,Fail,50,28,1,8,42
60,Fail,46,29,0,15,31
60,Fail,54,18,1,13,41
60,Fail,47,19,10,15,32
60,Fail,47,20,1,18,29
60,Fail,54,23,2,8,46
60,Fail,48,30,0,10,38
60,Fail,48,27,0,12,36
60,Fail,43,28,1,17,26
60,Fail,39,45,0,11,28
60,Fail,42,36,0,11,31
60,Fail,52,25,2,10,42
60,Fail,47,24,10,9,38
60,Fail,49,32,0,10,39
60,Fail,40,34,0,15,25
60,Fail,46,25,0,19,27
60,Fail,52,25,0,13,39
60,Fail,45,23,3,16,29
60,Fail,48,27,3,14,34
60,Fail,47,30,0,11,36
60,Fail,52,21,0,12,40
60,Fail,48,30,0,14,34
60,Fail,47,28,0,12,35
60,Fail,55,18,0,15,40
60,Fail,54,24,0,12,42
60,Fail,45,37,0,11,34
60,Fail,48,19,6,20,28
60,Fail,53,26,0,7,46
60,Fail,43,31,5,14,29
60,Fail,50,19,8,13,37
60,Fail,52,22,0,14,38
60,Fail,56,21,0,13,43
60,Fail,46,31,1,10,36
60,Fail,45,30,8,8,37
60,Fail,39,30,11,12,27
60,Fail,44,28,0,15,29
60,Fail,51,27,3,10,41
60,Fail,50,27,0,11,39
60,Fail,48,31,4,9,39
60,Fail,48,32,0,13,35
60,Fail,43,33,3,11,32
60,Fail,44,32,4,10,34
60,Fail,47,31,3,10,37
60,Fail,43,25,3,20,23
60,Fail,55,25,0,7,48
60,Fail,39,32,0,18,21
60,Fail,45,30,2,9,36
60,Fail,50,25,9,9,41
60,Fail,50,28,2,12,38
60,Fail,48,22,0,15,33
60,Fail,41,23,7,19,22
60,Fail,50,27,0,13,37
60,Fail,49,34,0,11,38
60,Fail,47,27,7,12,35
60,Fail,47,29,0,14,33
60,Fail,43,41,0,8,35
60,Fail,49,27,1,11,38
60,Fail,46,37,0,9,37
60,Fail,50,20,3,15,35
60,Fail,47,26,0,14,33
60,Fail,53,20,0,14,39
60,Fail,46,30,6,9,37
60,Fail,49,28,0,10,39
60,Fail,50,22,5,10,40
60,Fail,46,36,0,13,33
60,Fail,48,32,8,7,41
60,Fail,47,27,4,11,36
60,Fail,46,32,0,12,34
60,Fail,50,26,1,8,42
60,Fail,41,26,7,16,25
60,Fail,52,17,3,14,38
60,Fail,50,24,5,10,40
60,Fail,41,25,9,17,24
60,Fail,49,21,4,11,38
60,Fail,49,26,0,16,33
60,Fail,44,27,0,18,26
60,Fail,45,23,10,10,35
60,Fail,51,19,6,13,38
60,Fail,52,20,2,13,39
60,Fail,52,19,11,8,44
60,Fail,52,20,4,17,35
60,Fail,54,21,0,15,39
60,Fail,46,20,10,11,35
60,Fail,42,21,8,22,20
60,Fail,42,27,0,18,24
60,Fail,45,27,3,12,33
60,Fail,60,22,2,7,53
60,Fail,46,22,5,17,29
60,Fail,45,37,0,10,35
60,Fail,52,20,1,13,39
60,Fail,47,31,0,16,31
60,Fail,50,22,5,11,39
60,Fail,49,25,0,18,31
60,Fail,47,22,0,18,29
60,Fail,57,20,2,10,47
60,Fail,48,34,0,11,37
60,Fail,52,25,0,12,40
60,Fail,48,17,5,16,32
60,Fail,52,25,0,14,38
60,Fail,51,31,0,8,43
60,Fail,47,33,0,12,35
60,Fail,42,34,0,11,31
60,Fail,47,23,3,15,32
60,Fail,48,23,0,17,31
60,Fail,55,27,0,8,47
60,Fail,43,23,12,17,26
60,Fail,50,24,4,9,41
60,Fail,42,26,4,17,25
60,Fail,51,25,3,13,38
60,Fail,52,24,1,8,44
60,Fail,50,19,5,16,34
60,Fail,45,27,0,13,32
60,Fail,53,26,1,9,44
60,Fail,39,38,0,13,26
60,Fail,45,29,0,16,29
60,Fail,50,26,2,13,37
60,Fail,52,19,5,14,38
60,Fail,54,18,3,14,40
60,Fail,45,31,0,14,31
60,Fail,51,23,2,15,36
60,Fail,50,28,0,7,43
60,Fail,51,26,0,12,39
60,Fail,51,16,10,9,42
60,Fail,52,17,4,16,36
60,Fail,46,23,3,17,29
60,Fail,48,30,0,13,35
60,Fail,45,36,0,15,30
60,Fail,52,23,0,14,38
60,Fail,51,19,2,12,39
60,Fail,50,25,0,15,35
60,Fail,49,30,3,7,42
60,Fail,42,35,0,15,27
60,Fail,46,20,7,20,26
60,Fail,52,28,2,9,43
60,Fail,37,34,3,19,18
60,Fail,53,24,3,11,42
60,Fail,47,31,0,16,31
60,Fail,47,24,0,15,32
60,Fail,56,20,0,12,44
60,Fail,57,17,2,10,47
60,Fail,51,30,0,8,43
60,Fail,57,24,0,9,48
60,Fail,54,31,0,7,47
60,Fail,55,22,0,9,46
60,Fail,51,29,0,11,40
60,Fail,38,35,0,18,20
60,Fail,56,17,1,12,44
60,Fail,53,20,3,15,38
60,Fail,47,29,1,14,33
60,Fail,53,27,1,5,48
60,Fail,44,30,0,14,30
60,Fail,50,31,0,7,43
60,Fail,44,18,2,19,25
60,Fail,46,32,3,9,37
60,Fail,49,31,0,11,38
60,Fail,49,27,8,9,40
60,Fail,42,26,0,18,24
60,Fail,46,32,0,14,32
60,Fail,44,32,5,9,35
60,Fail,47,25,0,17,30
60,Fail,46,30,9,8,38
60,Fail,40,34,2,14,26
60,Fail,45,26,5,10,35
60,Fail,57,17,0,11,46
60,Fail,49,31,0,9,40
60,Fail,44,29,1,19,25
60,Fail,50,24,0,15,35
60,Fail,45,28,0,14,31
60,Fail,52,24,0,14,38
60,Fail,47,31,0,15,32
60,Fail,49,20,2,14,35
60,Fail,58,16,2,13,45
60,Fail,46,23,4,22,24
60,Fail,47,21,3,15,32
60,Fail,45,31,0,14,31
60,Fail,48,28,2,8,40
60,Fail,56,18,0,16,40
60,Fail,52,28,0,11,41
60,Fail,50,24,9,7,43
60,Fail,49,26,0,13,36
60,Fail,46,29,0,15,31
60,Fail,49,24,0,14,35
60,Fail,48,25,2,10,38
60,Fail,47,28,10,7,40
60,Fail,55,21,4,11,44
60,Fail,52,17,8,13,39
60,Fail,49,23,0,12,37
60,Fail,50,25,4,12,38
60,Fail,46,23,4,16,30
60,Fail,42,28,7,14,28
60,Fail,48,24,6,13,35
60,Fail,44,34,2,10,34
60,Fail,51,18,6,15,36
60,Fail,48,22,10,11,37
60,Fail,43,33,4,12,31
60,Fail,50,25,3,11,39
60,Fail,52,25,0,10,42
60,Fail,50,20,10,11,39
60,Fail,49,32,0,10,39
60,Fail,53,21,0,14,39
60,Fail,54,22,0,12,42
60,Fail,52,23,1,13,39
60,Fail,52,25,0,13,39
60,Fail,51,20,0,16,35
60,Fail,47,26,0,14,33
60,Fail,48,27,0,15,33
60,Fail,54,19,6,13,41
60,Fail,40,23,9,18,22
60,Fail,46,30,0,14,32
60,Fail,51,23,1,13,38
60,Fail,49,22,0,16,33
60,Fail,45,25,7,17,28
60,Fail,40,30,0,17,23
60,Fail,50,24,3,12,38
60,Fail,40,25,4,18,22
60,Fail,57,18,0,16,41
60,Fail,51,21,0,17,34
60,Fail,47,30,0,11,36
60,Fail,44,36,0,12,32
60,Fail,49,24,0,16,33
60,Fail,52,26,0,6,46
60,Fail,45,23,8,16,29
60,Fail,46,34,0,12,34
60,Fail,48,27,0,16,32
60,Fail,51,26,4,8,43
60,Fail,48,27,0,13,35
60,Fail,45,30,0,13,32
60,Fail,54,22,0,16,38
60,Fail,41,34,9,10,31
60,Fail,47,30,0,13,34
60,Fail,48,32,0,13,35
60,Fail,48,25,1,15,33
60,Fail,53,24,0,12,41
60,Fail,54,19,0,11,43
60,Fail,46,33,4,9,37
60,Fail,47,31,0,12,35
60,Fail,53,28,0,13,40
60,Fail,48,38,0,4,44
60,Fail,55,23,3,9,46
60,Fail,46,31,0,14,32
60,Fail,46,33,0,11,35
60,Fail,51,28,0,11,40
60,Fail,51,27,0,10,41
60,Fail,55,24,4,9,46
60,Fail,51,21,4,11,40
60,Fail,57,22,6,8,49
60,Fail,52,20,0,16,36
60,Fail,40,40,0,13,27
60,Fail,50,24,0,14,36
60,Fail,51,30,0,8,43
60,Fail,42,29,0,18,24
60,Fail,40,35,0,17,23
60,Fail,49,28,0,15,34
60,Fail,50,30,0,15,35
60,Fail,49,30,2,10,39
60,Fail,52,23,1,13,39
60,Fail,50,24,7,8,42
60,Fail,48,20,8,17,31
60,Fail,46,27,3,11,35
60,Fail,48,28,5,9,39
60,Fail,44,32,1,14,30
60,Fail,43,29,0,17,26
60,Fail,47,26,9,13,34
60,Fail,56,16,6,11,45
60,Fail,41,27,0,20,21
60,Fail,43,22,19,14,29
60,Fail,40,31,0,17,23
60,Fail,43,35,10,9,34
60,Fail,56,28,0,10,46
60,Fail,53,27,0,9,44
60,Fail,51,29,0,15,36
60,Fail,44,23,18,10,34
60,Fail,45,32,0,12,33
60,Fail,51,23,1,16,35
60,Fail,46,32,0,11,35
60,Fail,50,25,1,12,38
60,Fail,51,22,0,16,35
60,Fail,44,25,11,10,34
60,Fail,57,21,0,13,44
60,Fail,51,29,0,9,42
60,Fail,53,25,0,12,41
60,Fail,56,21,4,9,47
60,Fail,42,31,5,13,29
60,Fail,57,20,0,16,41
60,Fail,51,25,2,11,40
60,Fail,48,29,1,10,38
60,Fail,47,28,4,11,36
60,Fail,48,30,0,13,35
60,Fail,50,29,0,11,39
60,Fail,57,21,1,8,49
60,Fail,47,22,10,11,36
60,Fail,55,25,0,9,46
60,Fail,52,24,3,14,38
60,Fail,48,24,0,15,33
60,Fail,47,23,5,13,34
60,Fail,37,40,0,13,24
60,Fail,42,25,1,19,23
60,Fail,45,27,0,16,29
60,Fail,53,21,0,13,40
60,Fail,48,26,5,8,40
60,Fail,59,18,0,11,48
60,Fail,46,26,0,15,31
60,Fail,46,26,0,16,30
60,Fail,52,24,2,10,42
60,Fail,48,31,0,10,38
60,Fail,45,42,0,8,37
60,Fail,48,24,3,13,35
60,Fail,45,33,0,14,31
60,Fail,43,34,0,15,28
60,Fail,51,24,3,11,40
60,Fail,48,27,0,15,33
60,Fail,53,24,0,10,43
60,Fail,49,25,1,12,37
60,Fail,56,18,4,13,43
60,Fail,53,28,0,5,48
60,Fail,47,28,0,14,33
60,Fail,45,34,0,12,33
60,Fail,49,27,0,13,36
60,Fail,40,31,0,20,20
60,Fail,43,32,0,14,29
60,Fail,50,16,6,19,31
60,Fail,47,19,6,15,32
60,Fail,54,22,0,10,44
60,Fail,49,16,8,15,34
60,Fail,49,21,9,12,37
60,Fail,52,15,7,15,37
60,Fail,45,29,0,15,30
60,Fail,39,26,10,17,22
60,Fail,48,31,0,14,34
60,Fail,46,23,2,15,31
60,Fail,46,23,0,21,25
60,Fail,37,33,0,19,18
60,Fail,43,24,7,15,28
60,Fail,48,25,0,13,35
60,Fail,50,29,0,9,41
60,Fail,53,23,0,10,43
60,Fail,53,21,0,11,42
60,Fail,50,21,0,17,33
60,Fail,46,29,0,16,30
60,Fail,56,25,0,9,47
60,Fail,47,37,0,9,38
60,Fail,49,31,0,9,40
60,Fail,41,41,0,11,30
60,Fail,43,40,0,7,36
60,Fail,42,40,0,9,33
60,Fail,49,24,0,16,33
60,Fail,46,27,3,15,31
60,Fail,45,31,9,11,34
60,Fail,42,32,0,16,26
60,Fail,47,27,0,12,35
60,Fail,50,31,0,7,43
60,Fail,50,21,5,12,38
60,Fail,48,24,1,17,31
60,Fail,43,25,4,14,29
60,Fail,43,32,3,12,31
60,Fail,49,28,8,7,42
60,Fail,56,20,0,10,46
60,Fail,50,30,0,8,42
60,Fail,46,23,8,12,34
60,Fail,45,26,0,15,30
60,Fail,51,23,3,16,35
60,Fail,44,30,8,13,31
60,Fail,50,27,0,13,37
60,Fail,52,21,3,16,36
60,Fail,49,27,5,11,38
60,Fail,48,30,0,14,34
60,Fail,46,28,0,13,33
60,Fail,39,42,0,12,27
60,Fail,47,34,0,10,37
60,Fail,54,16,0,16,38
60,Fail,48,28,0,11,37
60,Fail,50,29,2,10,40
60,Fail,45,22,6,14,31
60,Fail,56,26,0,8,48
60,Fail,48,27,4,12,36
60,Fail,38,29,2,18,20
60,Fail,56,22,0,8,48
60,Fail,44,23,4,23,21
60,Fail,44,29,0,12,32
60,Fail,44,33,0,11,33
60,Fail,43,30,5,14,29
60,Fail,47,24,3,16,31
60,Fail,52,21,0,12,40
60,Fail,39,27,2,18,21
60,Fail,41,36,0,12,29
60,Fail,50,29,0,13,37
60,Fail,50,24,7,7,43
60,Fail,45,35,0,11,34
60,Fail,38,29,6,19,19
60,Fail,46,32,0,13,33
60,Fail,36,42,0,16,20
60,Fail,44,33,0,8,36
60,Fail,55,29,0,6,49
60,Fail,49,20,10,17,32
60,Fail,47,20,9,13,34
60,Fail,47,27,5,12,35
60,Fail,55,15,0,15,40
60,Fail,46,24,2,14,32
60,Fail,45,32,0,11,34
60,Fail,48,26,0,14,34
60,Fail,45,34,0,12,33
60,Fail,49,25,4,11,38
60,Fail,48,27,0,12,36
60,Fail,50,25,2,12,38
60,Fail,52,23,0,13,39
60,Fail,47,25,3,14,33
60,Fail,48,35,0,9,39
60,Fail,39,35,5,9,30
60,Fail,53,30,0,11,42
60,Fail,55,24,3,9,46
60,Fail,47,22,16,7,40
60,Fail,44,25,8,13,31
60,Fail,48,29,0,13,35
60,Fail,48,32,0,9,39
60,Fail,53,21,9,10,43
60,Fail,54,24,3,11,43
60,Fail,41,28,0,17,24
60,Fail,34,31,6,15,19
60,Fail,53,28,0,9,44
60,Fail,53,28,0,6,47
60,Fail,39,28,6,14,25
60,Fail,54,23,3,8,46
60,Fail,46,28,0,13,33
60,Fail,49,24,5,11,38
60,Fail,49,29,4,10,39
60,Fail,46,28,9,10,36
60,Fail,50,24,1,15,35
60,Fail,50,21,6,14,36
60,Fail,51,23,0,12,39
60,Fail,45,31,0,17,28
60,Fail,43,28,1,15,28
60,Fail,42,32,0,17,25
60,Fail,51,16,8,12,39
60,Fail,43,35,0,11,32
60,Fail,49,29,0,11,38
60,Fail,51,21,1,18,33
60,Fail,57,17,0,14,43
60,Fail,42,26,0,18,24
60,Fail,43,35,0,14,29
60,Fail,53,25,0,13,40
60,Fail,55,26,5,6,49
60,Fail,44,32,2,10,34
60,Fail,43,37,0,10,33
60,Fail,50,23,6,11,39
60,Fail,52,31,0,9,43
60,Fail,46,38,0,9,37
60,Fail,45,21,7,17,28
60,Fail,49,25,0,12,37
60,Fail,55,21,7,12,43
60,Fail,51,21,4,13,38
60,Fail,57,16,1,13,44
60,Fail,42,24,5,18,24
60,Fail,48,33,0,12,36
60,Fail,49,30,0,9,40
60,Fail,44,28,0,18,26
60,Fail,52,22,4,9,43
60,Fail,50,33,0,10,40
60,Fail,46,32,0,10,36
60,Fail,36,28,9,20,16
60,Fail,43,29,0,16,27
60,Fail,55,27,0,8,47
60,Fail,48,21,8,12,36
60,Fail,46,36,0,6,40
60,Fail,52,25,0,11,41
60,Fail,45,26,13,8,37
60,Fail,46,19,7,14,32
60,Fail,49,28,5,10,39
60,Fail,56,19,2,12,44
60,Fail,47,34,0,10,37
60,Fail,52,24,1,7,45
60,Fail,56,27,0,8,48
60,Fail,37,39,0,19,18
60,Fail,47,26,0,16,31
60,Fail,50,28,2,8,42
60,Fail,44,29,0,18,26
60,Fail,52,18,2,15,37
60,Fail,50,20,0,16,34
60,Fail,40,33,0,17,23
60,Fail,50,29,0,11,39
60,Fail,39,29,9,10,29
60,Fail,43,35,0,12,31
60,Fail,42,35,3,9,33
60,Fail,53,20,0,15,38
60,Fail,47,39,0,8,39
60,Fail,48,27,0,12,36
60,Fail,49,25,0,14,35
60,Fail,49,22,0,15,34
60,Fail,50,23,4,11,39
60,Fail,55,25,0,8,47
60,Fail,50,23,0,14,36
60,Fail,38,36,5,12,26
60,Fail,48,18,8,15,33
60,Fail,53,23,0,13,40
60,Fail,49,25,3,14,35
60,Fail,46,36,0,7,39
60,Fail,50,20,4,11,39
60,Fail,43,34,0,16,27
60,Fail,57,22,3,5,52
60,Fail,44,28,0,13,31
60,Fail,46,33,0,8,38
60,Fail,50,26,7,9,41
60,Fail,45,29,1,14,31
60,Fail,48,25,6,12,36
60,Fail,51,24,1,9,42
60,Fail,50,30,0,13,37
60,Fail,43,22,7,16,27
60,Fail,45,30,0,15,30
60,Fail,48,28,0,13,35
60,Fail,52,28,2,8,44
60,Fail,46,37,0,11,35
60,Fail,48,28,0,11,37
60,Fail,48,30,0,8,40
60,Fail,48,28,1,9,39
60,Fail,49,27,0,12,37
60,Fail,55,25,4,7,48
60,Fail,52,27,8,8,44
60,Fail,49,29,0,12,37
60,Fail,58,19,0,8,50
60,Fail,55,27,0,7,48
60,Fail,46,27,0,15,31
60,Fail,49,26,0,11,38
60,Fail,39,32,0,19,20
60,Fail,44,24,0,14,30
60,Fail,50,25,2,13,37
60,Fail,51,23,4,16,35
60,Fail,41,33,5,10,31
60,Fail,46,38,0,6,40
60,Fail,38,38,0,16,22
60,Fail,57,23,3,7,50
60,Fail,51,22,2,18,33
60,Fail,48,31,0,9,39
60,Fail,48,25,3,12,36
60,Fail,48,25,1,13,35
60,Fail,53,19,2,13,40
60,Fail,50,29,0,11,39
60,Fail,60,19,0,8,52
60,Fail,42,21,9,17,25
60,Fail,53,29,0,7,46
60,Fail,49,24,1,13,36
60,Fail,45,33,2,11,34
60,Fail,53,28,0,8,45
60,Fail,49,34,0,9,40
60,Fail,45,29,0,14,31
60,Fail,51,25,1,9,42
60,Fail,46,36,0,7,39
60,Fail,49,30,0,13,36
60,Fail,43,39,0,9,34
60,Fail,47,33,0,9,38
60,Fail,50,25,9,10,40
60,Fail,50,30,0,13,37
60,Fail,54,24,6,4,50
60,Fail,49,31,0,10,39
60,Fail,40,31,9,16,24
60,Fail,51,22,3,8,43
60,Fail,51,28,2,11,40
60,Fail,47,22,2,20,27
60,Fail,46,22,9,17,29
60,Fail,43,37,0,11,32
60,Fail,53,23,4,10,43
60,Fail,48,31,0,12,36
60,Fail,49,20,0,18,31
60,Fail,38,37,0,14,24
60,Fail,43,29,1,14,29
60,Fail,52,27,0,8,44
60,Fail,48,31,0,9,39
60,Fail,46,19,8,13,33
60,Fail,54,19,6,9,45
60,Fail,49,28,0,10,39
60,Fail,46,30,0,16,30
60,Fail,48,23,8,8,40
60,Fail,53,15,9,12,41
60,Fail,51,27,0,11,40
60,Fail,46,35,0,11,35
60,Fail,45,32,2,11,34
60,Fail,42,29,2,14,28
60,Fail,42,32,7,10,32
60,Fail,53,23,0,13,40
60,Fail,45,26,0,20,25
60,Fail,55,22,0,13,42
60,Fail,52,25,0,14,38
60,Fail,49,29,2,9,40
60,Fail,52,28,5,8,44
60,Fail,46,23,9,11,35
60,Fail,53,25,0,11,42
60,Fail,44,28,0,14,30
60,Fail,41,40,0,12,29
60,Fail,46,34,0,10,36
60,Fail,50,29,5,6,44
60,Fail,56,21,0,11,45
60,Fail,58,24,0,7,51
60,Fail,40,35,0,14,26
60,Fail,48,27,0,8,40
60,Fail,45,30,0,14,31
60,Fail,54,25,0,8,46
60,Fail,43,21,11,15,28
60,Fail,54,15,3,11,43
60,Fail,53,26,0,10,43
60,Fail,42,32,8,8,34
60,Fail,45,31,0,13,32
60,Fail,48,24,2,12,36
60,Fail,54,24,6,7,47
60,Fail,38,33,0,20,18
60,Fail,44,35,0,12,32
60,Fail,50,20,3,18,32
60,Fail,46,20,6,18,28
60,Fail,46,28,5,14,32
60,Fail,53,23,0,12,41
60,Fail,51,25,1,10,41
60,Fail,46,29,3,11,35
60,Fail,50,21,3,10,40
60,Fail,58,13,4,16,42
60,Fail,47,26,2,17,30
60,Fail,56,18,4,12,44
60,Fail,46,30,0,13,33
60,Fail,53,21,0,15,38
60,Fail,42,30,0,18,24
60,Fail,50,23,1,14,36
60,Fail,45,26,1,19,26
60,Fail,45,33,0,14,31
60,Fail,44,27,1,16,28
60,Fail,50,23,6,11,39
60,Fail,55,21,1,13,42
60,Fail,49,24,0,19,30
60,Fail,53,16,0,17,36
60,Fail,49,30,0,10,39
60,Fail,43,30,1,14,29
60,Fail,52,26,0,10,42
60,Fail,51,23,5,12,39
60,Fail,61,17,6,9,52
60,Fail,41,31,7,12,29
60,Fail,51,25,3,8,43
60,Fail,47,32,0,10,37
60,Fail,52,23,3,11,41
60,Fail,49,22,10,11,38
60,Fail,49,23,0,17,32
60,Fail,48,24,12,7,41
60,Fail,46,23,0,18,28
60,Fail,50,23,3,14,36
60,Fail,50,22,0,16,34
60,Fail,48,26,6,9,39
60,Fail,49,26,0,14,35
60,Fail,50,22,1,14,36
60,Fail,45,32,0,13,32
60,Fail,48,26,0,15,33
60,Fail,41,27,3,20,21
60,Fail,51,24,5,9,42
60,Fail,45,31,0,11,34
60,Fail,48,22,0,15,33
60,Fail,46,26,6,12,34
60,Fail,54,23,0,11,43
60,Fail,47,22,4,13,34
60,Fail,51,27,1,10,41
60,Fail,53,22,2,11,42
60,Fail,47,33,0,13,34
60,Fail,50,26,3,13,37
60,Fail,48,17,8,18,30
60,Fail,38,40,0,11,27
60,Fail,47,30,0,12,35
60,Fail,46,28,0,15,31
60,Fail,50,19,0,17,33
60,Fail,43,30,0,11,32
60,Fail,48,28,2,9,39
60,Fail,51,25,4,10,41
60,Fail,48,26,1,15,33
60,Fail,55,15,0,17,38
60,Fail,47,30,0,14,33
60,Fail,53,24,0,12,41
60,Fail,52,22,0,10,42
60,Fail,50,21,7,15,35
60,Fail,46,30,2,11,35
60,Fail,44,38,0,9,35
60,Fail,48,26,3,12,36
60,Fail,51,29,0,12,39
60,Fail,54,28,0,8,46
60,Fail,52,31,0,8,44
60,Fail,49,25,4,12,37
60,Fail,44,24,3,18,26
60,Fail,49,24,5,11,38
60,Fail,43,27,2,15,28
60,Fail,53,22,5,13,40
60,Fail,57,16,0,11,46
60,Fail,57,19,0,10,47
60,Fail,45,35,0,7,38
60,Fail,44,27,5,13,31
60,Fail,47,31,2,9,38
60,Fail,52,25,2,11,41
60,Fail,51,19,0,16,35
60,Fail,46,33,0,11,35
60,Fail,50,19,0,18,32
60,Fail,54,25,0,10,44
60,Fail,50,21,4,14,36
60,Fail,47,27,0,16,31
60,Fail,51,28,2,7,44
60,Fail,49,27,0,11,38
60,Fail,44,40,0,6,38
60,Fail,40,32,0,16,24
60,Fail,40,37,0,17,23
60,Fail,43,35,0,14,29
60,Fail,48,27,0,12,36
60,Fail,52,32,0,9,43
60,Fail,51,28,0,11,40
60,Fail,52,24,0,9,43
60,Fail,52,26,0,10,42
60,Fail,48,23,3,14,34
60,Fail,43,29,4,15,28
60,Fail,46,22,0,21,25
60,Fail,50,32,0,11,39
60,Fail,50,28,0,9,41
60,Fail,52,19,0,16,36
60,Fail,43,32,0,16,27
60,Fail,51,24,4,8,43
60,Fail,40,41,0,12,28
60,Fail,51,23,5,14,37
60,Fail,48,29,0,14,34
60,Fail,42,34,0,12,30
60,Fail,48,24,1,15,33
60,Fail,46,31,0,12,34
60,Fail,43,37,0,13,30
60,Fail,42,41,0,8,34
60,Fail,49,27,0,13,36
60,Fail,46,29,6,11,35
60,Fail,51,19,7,17,34
60,Fail,56,17,0,13,43
60,Fail,50,26,2,8,42
60,Fail,44,29,8,13,31
60,Fail,49,23,11,12,37
60,Fail,55,30,0,9,46
60,Fail,53,27,0,13,40
60,Fail,52,22,0,14,38
60,Fail,57,27,0,5,52
60,Fail,55,24,2,8,47
60,Fail,50,27,0,12,38
60,Fail,52,23,0,11,41
60,Fail,44,25,8,15,29
60,Fail,46,20,5,21,25
60,Fail,50,26,0,11,39
60,Fail,46,23,0,20,26
60,Fail,48,25,6,12,36
60,Fail,44,33,0,13,31
60,Fail,50,23,5,12,38
60,Fail,45,26,9,11,34
60,Fail,49,32,0,12,37
60,Fail,44,33,0,14,30
60,Fail,43,38,0,14,29
60,Fail,56,21,0,9,47
60,Fail,50,24,0,14,36
60,Fail,53,26,1,10,43
60,Fail,52,24,3,8,44
60,Fail,52,20,2,15,37
60,Fail,48,23,0,19,29
60,Fail,57,16,3,14,43
60,Fail,40,28,0,17,23
60,Fail,49,25,1,10,39
60,Fail,39,37,12,6,33
60,Fail,50,24,4,14,36
60,Fail,50,25,3,12,38
60,Fail,40,33,4,11,29
60,Fail,48,23,4,18,30
60,Fail,54,19,2,14,40
60,Fail,50,21,0,19,31
60,Fail,48,27,4,13,35
60,Fail,52,23,2,13,39
60,Fail,39,31,3,15,24
60,Fail,46,20,0,20,26
60,Fail,50,30,0,10,40
60,Fail,54,25,0,9,45
60,Fail,49,29,0,9,40
60,Fail,49,31,0,13,36
60,Fail,52,26,0,8,44
60,Fail,59,21,0,7,52
60,Fail,43,39,0,13,30
60,Fail,45,27,2,17,28
60,Fail,50,30,1,8,42
60,Fail,52,24,2,10,42
60,Fail,40,30,0,21,19
60,Fail,41,21,20,10,31
60,Fail,53,22,0,15,38
60,Fail,49,26,0,13,36
60,Fail,46,27,7,10,36
60,Fail,45,31,0,12,33
60,Fail,51,26,0,13,38
60,Fail,39,32,0,18,21
60,Fail,44,29,0,17,27
60,Fail,47,26,5,11,36
60,Fail,51,24,5,9,42
60,Fail,52,24,1,11,41
60,Fail,37,34,5,13,24
60,Fail,48,21,10,12,36
60,Fail,53,25,3,8,45
60,Fail,45,30,0,14,31
60,Fail,48,29,0,9,39
60,Fail,54,25,0,11,43
60,Fail,48,22,3,13,35
60,Fail,47,27,5,12,35
60,Fail,42,35,3,10,32
60,Fail,50,27,0,15,35
60,Fail,53,29,1,7,46
60,Fail,45,29,7,11,34
60,Fail,43,24,12,16,27
60,Fail,60,18,0,10,50
60,Fail,53,19,0,18,35
60,Fail,51,27,0,13,38
60,Fail,48,23,1,16,32
60,Fail,54,27,0,9,45
60,Fail,50,18,4,18,32
60,Fail,51,24,0,12,39
60,Fail,40,31,7,13,27
60,Fail,54,21,1,14,40
60,Fail,51,24,1,15,36
60,Fail,49,28,5,11,38
60,Fail,58,20,0,7,51
60,Fail,52,24,0,13,39
60,Fail,45,21,0,22,23
60,Fail,48,28,3,11,37
60,Fail,45,33,2,13,32
60,Fail,48,25,2,13,35
60,Fail,56,20,0,12,44
60,Fail,52,29,0,11,41
60,Fail,43,26,6,10,33
60,Fail,46,31,1,12,34
60,Fail,49,22,1,14,35
60,Fail,43,26,7,15,28
60,Fail,49,28,1,11,38
60,Fail,48,30,0,14,34
60,Fail,52,30,0,8,44
60,Fail,41,29,5,16,25
60,Fail,43,25,6,17,26
60,Fail,50,20,4,14,36
60,Fail,46,32,0,12,34
60,Fail,49,25,0,15,34
60,Fail,38,32,6,13,25
60,Fail,50,26,0,14,36
60,Fail,45,20,7,15,30
60,Fail,46,23,11,16,30
60,Fail,48,33,2,7,41
60,Fail,47,37,0,10,37
60,Fail,43,28,8,13,30
60,Fail,51,24,1,11,40
60,Fail,54,24,0,12,42
60,Fail,44,22,1,19,25
60,Fail,56,19,4,11,45
60,Fail,52,28,4,11,41
60,Fail,39,38,2,10,29
60,Fail,46,30,0,12,34
60,Fail,52,20,0,15,37
60,Fail,41,33,0,14,27
60,Fail,51,29,0,10,41
60,Fail,51,26,0,13,38
60,Fail,45,30,8,8,37
60,Fail,48,30,6,6,42
60,Fail,47,30,0,11,36
60,Fail,42,26,5,15,27
60,Fail,51,24,0,12,39
60,Fail,48,29,0,15,33
60,Fail,50,32,0,10,40
60,Fail,46,31,0,15,31
60,Fail,41,34,0,13,28
60,Fail,45,25,0,20,25
60,Fail,46,26,0,19,27
60,Fail,54,21,0,14,40
60,Fail,43,32,0,12,31
60,Fail,49,22,0,15,34
60,Fail,42,37,0,14,28
60,Fail,46,27,5,11,35
60,Fail,44,30,4,9,35
60,Fail,48,28,0,14,34
60,Fail,49,26,8,9,40
60,Fail,44,35,0,14,30
60,Fail,47,28,0,13,34
60,Fail,46,28,7,11,35
60,Fail,48,25,0,13,35
60,Fail,45,31,13,7,38
60,Fail,50,27,0,14,36
60,Fail,48,27,0,13,35
60,Fail,55,26,3,7,48
60,Fail,50,23,2,12,38
60,Fail,48,25,6,12,36
60,Fail,52,25,0,10,42
60,Fail,52,28,0,9,43
60,Fail,45,26,1,15,30
60,Fail,47,23,0,18,29
60,Fail,49,28,2,13,36
60,Fail,50,22,5,12,38
60,Fail,51,23,2,13,38
60,Fail,47,27,6,9,38
60,Fail,50,25,1,15,35
60,Fail,51,22,6,10,41
60,Fail,49,29,5,10,39
60,Fail,41,32,0,12,29
60,Fail,40,34,0,18,22
60,Fail,43,31,7,14,29
60,Fail,50,24,0,12,38
60,Fail,45,31,0,17,28
60,Fail,46,29,6,10,36
60,Fail,47,26,4,6,41
60,Fail,38,41,0,13,25
60,Fail,53,21,8,11,42
60,Fail,44,25,6,15,29
60,Fail,47,23,2,14,33
60,Fail,47,35,1,6,41
60,Fail,47,26,10,10,37
60,Fail,41,32,0,14,27
60,Fail,48,25,0,17,31
60,Fail,47,21,10,17,30
60,Fail,45,34,0,8,37
60,Fail,52,19,0,15,37
60,Fail,46,23,6,11,35
60,Fail,49,29,0,12,37
60,Fail,42,32,0,20,22
60,Fail,49,19,3,14,35
60,Fail,47,32,0,14,33
60,Fail,45,28,4,13,32
60,Fail,42,32,2,15,27
60,Fail,47,32,0,9,38
60,Fail,45,38,0,8,37
60,Fail,51,26,0,11,40
60,Fail,52,26,4,6,46
60,Fail,45,32,0,15,30
60,Fail,40,42,0,13,27
60,Fail,49,31,0,10,39
60,Fail,46,27,3,18,28
60,Fail,54,22,12,7,47
60,Fail,51,22,0,13,38
60,Fail,52,23,0,12,40
60,Fail,41,27,11,16,25
60,Fail,46,31,0,15,31
60,Fail,47,32,2,8,39
60,Fail,46,34,0,12,34
60,Fail,49,35,0,12,37
60,Fail,48,27,0,11,37
60,Fail,47,20,14,12,35
60,Fail,52,29,1,8,44
60,Fail,48,33,0,8,40
60,Fail,54,25,1,9,45
60,Fail,47,23,3,15,32
60,Fail,46,25,0,16,30
60,Fail,48,26,4,8,40
60,Fail,40,39,0,10,30
60,Fail,51,33,0,10,41
60,Fail,51,28,0,12,39
60,Fail,44,26,2,16,28
60,Fail,38,39,0,19,19
60,Fail,48,35,0,10,38
60,Fail,49,28,0,12,37
60,Fail,46,28,0,12,34
60,Fail,46,22,4,16,30
60,Fail,54,20,0,10,44
60,Fail,48,27,3,11,37
60,Fail,57,14,0,12,45
60,Fail,48,19,0,19,29
60,Fail,52,25,2,11,41
60,Fail,46,28,0,10,36
60,Fail,50,28,0,10,40
60,Fail,46,33,0,10,36
60,Fail,47,21,14,8,39
60,Fail,43,35,0,15,28
60,Fail,47,29,0,15,32
60,Fail,43,40,0,10,33
60,Fail,41,41,0,12,29
60,Fail,59,21,5,5,54
60,Fail,44,25,0,18,26
60,Fail,51,22,0,17,34
60,Fail,44,32,2,11,33
60,Fail,52,24,3,10,42
60,Fail,52,23,6,8,44
60,Fail,50,25,0,16,34
60,Fail,48,32,0,10,38
60,Fail,46,25,0,20,26
60,Fail,46,38,0,9,37
60,Fail,47,19,5,14,33
60,Fail,44,27,6,13,31
60,Fail,41,36,0,19,22
60,Fail,54,27,3,5,49
60,Fail,49,26,5,11,38
60,Fail,51,30,0,13,38
60,Fail,41,26,9,14,27
60,Fail,39,28,7,17,22
60,Fail,54,31,0,9,45
60,Fail,48,24,7,10,38
60,Fail,41,32,1,16,25
60,Fail,49,28,2,9,40
60,Fail,55,22,0,16,39
60,Fail,47,20,2,22,25
60,Fail,52,29,0,10,42
60,Fail,51,27,3,12,39
60,Fail,50,27,5,11,39
60,Fail,53,23,4,9,44
60,Fail,51,33,0,7,44
60,Fail,44,32,0,11,33
60,Fail,46,25,3,14,32
60,Fail,50,31,0,13,37
60,Fail,61,16,3,7,54
60,Fail,50,24,0,17,33
60,Fail,50,23,7,9,41
60,Fail,48,28,0,12,36
60,Fail,48,21,7,13,35
60,Fail,43,31,2,13,30
60,Fail,49,21,2,17,32
60,Fail,47,30,0,15,32
60,Fail,46,25,9,8,38
60,Fail,54,19,0,12,42
60,Fail,53,24,0,12,41
60,Fail,44,29,0,19,25
60,Fail,57,20,5,8,49
60,Fail,55,22,3,8,47
60,Fail,39,34,4,13,26
60,Fail,49,27,0,14,35
60,Fail,40,36,0,14,26
60,Fail,50,24,0,15,35
60,Fail,46,30,0,11,35
60,Fail,45,21,0,23,22
60,Fail,50,25,1,11,39
60,Fail,49,31,0,10,39
60,Fail,44,35,1,11,33
60,Fail,50,21,13,9,41
60,Fail,60,22,0,8,52
60,Fail,46,22,6,14,32
60,Fail,51,33,0,7,44
60,Fail,50,25,0,12,38
60,Fail,53,16,0,15,38
60,Fail,49,19,3,19,30
60,Fail,51,28,3,9,42
60,Fail,52,21,3,12,40
60,Fail,43,31,2,11,32
60,Fail,43,20,8,16,27
60,Fail,49,31,0,13,36
60,Fail,52,26,0,9,43
60,Fail,43,26,2,20,23
60,Fail,42,33,2,12,30
60,Fail,49,24,0,17,32
60,Fail,44,26,4,14,30
60,Fail,46,26,2,16,30
60,Fail,46,26,2,13,33
60,Fail,47,26,1,14,33
60,Fail,48,24,9,14,34
60,Fail,51,26,7,7,44
60,Fail,48,16,12,9,39
60,Fail,47,29,2,14,33
60,Fail,54,20,5,9,45
60,Fail,58,16,2,11,47
60,Fail,49,30,3,13,36
60,Fail,51,21,0,14,37
60,Fail,48,30,0,11,37
60,Fail,50,29,0,12,38
60,Fail,46,32,4,10,36
60,Fail,40,37,0,15,25
60,Fail,40,32,0,14,26
60,Fail,47,30,0,11,36
60,Fail,54,22,5,9,45
60,Fail,46,24,4,14,32
60,Fail,49,30,0,11,38
60,Fail,44,28,4,15,29
60,Fail,45,26,0,18,27
60,Fail,46,33,0,11,35
60,Fail,45,27,1,14,31
60,Fail,49,39,0,10,39
60,Fail,53,22,1,10,43
60,Fail,53,26,2,9,44
60,Fail,51,27,0,14,37
60,Fail,47,25,1,13,34
60,Fail,46,26,6,11,35
60,Fail,48,28,0,12,36
60,Fail,53,29,0,8,45
60,Fail,50,27,0,12,38
60,Fail,43,39,0,9,34
60,Fail,45,26,9,11,34
60,Fail,41,26,5,19,22
60,Fail,50,25,0,14,36
60,Fail,42,35,0,12,30
60,Fail,42,36,0,13,29
60,Fail,55,25,0,5,50
60,Fail,45,36,0,13,32
60,Fail,41,29,3,14,27
60,Fail,55,27,0,4,51
60,Fail,45,25,0,19,26
60,Fail,43,39,0,10,33
60,Fail,54,26,0,9,45
60,Fail,43,25,7,16,27
60,Fail,51,20,0,16,35
60,Fail,52,16,6,16,36
60,Fail,48,29,0,13,35
60,Fail,44,32,3,11,33
60,Fail,44,22,0,20,24
60,Fail,53,22,0,16,37
60,Fail,45,34,0,12,33
60,Fail,40,33,0,16,24
60,Fail,44,32,0,14,30
60,Fail,47,33,0,12,35
60,Fail,48,33,0,11,37
60,Fail,46,32,0,13,33
60,Fail,49,27,0,10,39
60,Fail,50,22,0,18,32
60,Fail,47,31,0,16,31
60,Fail,50,30,0,11,39
60,Fail,47,24,2,17,30
60,Fail,52,26,0,14,38
60,Fail,51,20,3,12,39
60,Fail,48,36,0,10,38
60,Fail,56,17,0,15,41
60,Fail,59,18,4,8,51
60,Fail,41,31,9,10,31
60,Fail,54,20,0,12,42
60,Fail,52,31,1,5,47
60,Fail,40,34,7,9,31
60,Fail,55,23,1,7,48
60,Fail,46,26,0,16,30
60,Fail,50,22,1,17,33
60,Fail,48,29,0,13,35
60,Fail,50,26,1,13,37
60,Fail,46,27,8,11,35
60,Fail,51,26,8,9,42
60,Fail,42,33,0,14,28
60,Fail,47,30,3,9,38
60,Fail,50,24,2,9,41
60,Fail,38,39,0,13,25
60,Fail,53,24,4,12,41
60,Fail,50,24,4,11,39
60,Fail,44,29,0,16,28
60,Fail,47,32,0,11,36
60,Fail,53,21,4,9,44
60,Fail,51,23,0,13,38
60,Fail,51,16,3,18,33
60,Fail,44,27,8,10,34
60,Fail,44,23,2,19,25
60,Fail,42,37,0,12,30
60,Fail,54,25,0,9,45
60,Fail,40,36,0,14,26
60,Fail,51,24,2,11,40
60,Fail,43,35,0,13,30
60,Fail,49,27,3,11,38
60,Fail,52,23,8,8,44
60,Fail,44,31,3,10,34
60,Fail,51,28,0,11,40
60,Fail,36,24,7,22,14
60,Fail,41,32,5,13,28
60,Fail,50,26,0,10,40
60,Fail,43,24,9,12,31
60,Fail,44,20,10,16,28
60,Fail,51,27,0,10,41
60,Fail,49,31,0,10,39
60,Fail,55,22,1,8,47
60,Fail,40,36,0,17,23
60,Fail,50,26,0,11,39
60,Fail,42,27,6,11,31
60,Fail,46,26,5,13,33
60,Fail,53,19,2,13,40
60,Fail,58,24,0,9,49
60,Fail,44,25,0,25,19
60,Fail,44,39,2,6,38
60,Fail,46,26,1,14,32
60,Fail,52,28,0,9,43
60,Fail,54,19,4,15,39
60,Fail,42,30,0,17,25
60,Fail,41,34,1,15,26
60,Fail,48,25,0,18,30
60,Fail,58,22,3,6,52
60,Fail,49,32,0,11,38
60,Fail,47,30,0,14,33
60,Fail,43,28,6,12,31
60,Fail,47,31,3,10,37
60,Fail,58,22,0,8,50
60,Fail,37,38,0,18,19
60,Fail,51,27,0,11,40
60,Fail,45,33,2,14,31
60,Fail,49,32,0,12,37
60,Fail,49,23,6,11,38
60,Fail,45,31,4,11,34
60,Fail,46,21,12,14,32
60,Fail,53,22,7,9,44
60,Fail,51,23,5,8,43
60,Fail,44,32,0,15,29
60,Fail,58,16,1,12,46
60,Fail,39,26,1,19,20
60,Fail,39,31,1,17,22
60,Fail,48,31,0,9,39
60,Fail,46,26,3,17,29
60,Fail,52,23,0,15,37
60,Fail,46,20,5,15,31
60,Fail,32,43,0,16,16
60,Fail,45,30,0,18,27
60,Fail,51,25,4,9,42
60,Fail,57,22,0,8,49
60,Fail,53,25,0,10,43
60,Fail,55,25,0,9,46
60,Fail,47,28,0,13,34
60,Fail,43,37,0,14,29
60,Fail,50,24,0,13,37
60,Fail,42,35,0,14,28
60,Fail,46,34,0,9,37
60,Fail,53,24,0,14,39
60,Fail,43,28,4,12,31
60,Fail,52,22,0,11,41
60,Fail,49,26,0,13,36
60,Fail,47,28,0,13,34
60,Fail,54,23,1,10,44
60,Fail,42,36,0,12,30
60,Fail,53,20,0,13,40
60,Fail,55,21,0,12,43
60,Fail,43,30,0,16,27
60,Fail,49,32,0,10,39
60,Fail,50,23,0,13,37
60,Fail,45,32,0,15,30
60,Fail,52,24,0,9,43
60,Fail,45,21,4,21,24
60,Fail,47,24,2,12,35
60,Fail,51,22,3,12,39
60,Fail,50,32,0,9,41
60,Fail,49,19,3,15,34
60,Fail,49,25,0,15,34
60,Fail,48,27,4,12,36
60,Fail,48,28,0,14,34
60,Fail,40,33,0,20,20
60,Fail,48,30,0,10,38
60,Fail,51,33,0,8,43
60,Fail,46,28,0,14,32
60,Fail,47,31,0,15,32
60,Fail,50,21,0,18,32
60,Fail,45,20,6,15,30
60,Fail,52,23,0,13,39
60,Fail,47,37,0,8,39
60,Fail,44,27,1,15,29
60,Fail,43,31,2,12,31
60,Fail,47,34,0,13,34
60,Fail,49,29,0,11,38
60,Fail,47,27,0,14,33
60,Fail,44,32,0,16,28
60,Fail,59,20,0,11,48
60,Fail,42,38,0,16,26
60,Fail,49,25,4,13,36
60,Fail,42,37,0,15,27
60,Fail,48,30,0,13,35
60,Fail,46,30,2,12,34
60,Fail,51,18,2,17,34
60,Fail,52,22,7,9,43
60,Fail,57,18,2,7,50
60,Fail,43,31,0,12,31
60,Fail,47,30,0,12,35
60,Fail,50,23,1,16,34
60,Fail,38,28,8,15,23
60,Fail,41,33,4,9,32
60,Fail,45,28,0,16,29
60,Fail,45,29,0,17,28
60,Fail,47,25,5,14,33
60,Fail,46,29,0,13,33
60,Fail,59,20,0,12,47
60,Fail,50,24,0,18,32
60,Fail,45,30,2,14,31
60,Fail,54,17,4,12,42
60,Fail,46,26,11,10,36
60,Fail,48,35,0,9,39
60,Fail,46,31,0,12,34
60,Fail,57,25,0,6,51
60,Fail,47,25,0,15,32
60,Fail,46,28,0,13,33
60,Fail,44,31,0,16,28
60,Fail,56,19,1,12,44
60,Fail,47,33,0,9,38
60,Fail,42,33,0,14,28
60,Fail,46,24,2,15,31
60,Fail,45,31,0,8,37
60,Fail,48,25,1,18,30
60,Fail,48,23,0,19,29
60,Fail,49,23,0,13,36
60,Fail,47,30,4,6,41
60,Fail,47,26,1,13,34
60,Fail,54,21,0,12,42
60,Fail,45,32,0,14,31
60,Fail,54,18,5,14,40
60,Fail,50,26,7,10,40
60,Fail,49,27,5,9,40
60,Fail,57,22,0,10,47
60,Fail,51,28,0,13,38
60,Fail,53,20,1,12,41
60,Fail,44,27,5,12,32
60,Fail,50,29,0,6,44
60,Fail,57,24,0,6,51
60,Fail,41,35,0,15,26
60,Fail,56,20,2,12,44
60,Fail,45,27,0,14,31
60,Fail,51,22,0,13,38
60,Fail,41,34,1,13,28
60,Fail,44,33,13,3,41
60,Fail,47,23,5,18,29
60,Fail,52,23,0,18,34
60,Fail,42,30,0,17,25
60,Fail,47,36,0,11,36
60,Fail,44,26,2,12,32
60,Fail,46,28,0,15,31
60,Fail,44,25,4,17,27
60,Fail,47,24,0,18,29
60,Fail,45,31,0,12,33
60,Fail,45,30,0,10,35
60,Fail,44,27,7,13,31
60,Fail,45,30,0,13,32
60,Fail,48,25,5,8,40
60,Fail,48,37,0,7,41
60,Fail,47,27,0,13,34
60,Fail,44,35,0,12,32
60,Fail,52,27,4,11,41
60,Fail,44,27,5,14,30
60,Fail,47,21,0,22,25
60,Fail,48,35,0,8,40
60,Fail,44,31,0,18,26
60,Fail,50,25,0,14,36
60,Fail,49,32,0,8,41
60,Fail,50,25,4,11,39
60,Fail,50,23,0,15,35
60,Fail,46,32,0,13,33
60,Fail,46,35,0,9,37
60,Fail,41,27,0,17,24
60,Fail,47,18,8,15,32
60,Fail,46,28,0,14,32
60,Fail,51,25,0,12,39
60,Fail,43,29,2,15,28
60,Fail,58,23,1,6,52
60,Fail,51,23,0,15,36
60,Fail,52,25,2,11,41
60,Fail,49,30,1,10,39
60,Fail,56,25,0,9,47
60,Fail,59,14,11,9,50
60,Fail,44,32,0,15,29
60,Fail,34,30,9,19,15
60,Fail,39,31,0,20,19
60,Fail,54,26,4,7,47
60,Fail,52,22,2,15,37
60,Fail,45,34,0,12,33
60,Fail,49,30,5,8,41
60,Fail,49,35,0,12,37
60,Fail,52,31,0,9,43
60,Fail,49,22,4,16,33
60,Fail,42,23,3,21,21
60,Fail,55,18,0,13,42
60,Fail,54,21,1,13,41
60,Fail,55,24,1,12,43
60,Fail,47,23,0,14,33
60,Fail,55,24,0,10,45
60,Fail,47,33,0,14,33
60,Fail,58,18,1,10,48
60,Fail,55,20,0,13,42
60,Fail,51,23,0,12,39
60,Fail,44,23,9,17,27
60,Fail,47,24,0,16,31
60,Fail,56,21,0,9,47
60,Fail,54,27,0,8,46
60,Fail,51,24,0,12,39
60,Fail,40,30,0,21,19
60,Fail,42,31,0,13,29
60,Fail,50,26,1,13,37
60,Fail,49,26,2,14,35
60,Fail,43,26,4,14,29
60,Fail,43,31,0,16,27
60,Fail,54,30,0,5,49
60,Fail,38,25,15,15,23
60,Fail,49,23,6,14,35
60,Fail,44,25,2,12,32
60,Fail,51,27,0,14,37
60,Fail,43,33,0,9,34
60,Fail,48,31,0,15,33
60,Fail,57,27,0,8,49
60,Fail,54,21,1,13,41
60,Fail,44,34,0,13,31
60,Fail,51,28,0,12,39
60,Fail,45,27,5,13,32
60,Fail,47,25,10,10,37
60,Fail,47,34,0,13,34
60,Fail,44,32,0,15,29
60,Fail,48,13,11,20,28
60,Fail,48,31,0,11,37
60,Fail,42,24,5,20,22
60,Fail,46,29,0,13,33
60,Fail,45,31,0,11,34
60,Fail,47,31,0,14,33
60,Fail,53,24,0,10,43
60,Fail,49,26,5,11,38
60,Fail,50,28,5,6,44
60,Fail,45,27,0,18,27
60,Fail,45,33,0,11,34
60,Fail,51,20,7,11,40
60,Fail,48,26,0,12,36
60,Fail,49,26,0,15,34
60,Fail,51,31,0,11,40
60,Fail,48,29,0,13,35
60,Fail,51,23,7,9,42
60,Fail,47,27,7,8,39
60,Fail,44,29,0,17,27
60,Fail,53,22,4,9,44
60,Fail,48,22,0,20,28
60,Fail,45,33,2,11,34
60,Fail,48,30,1,12,36
60,Fail,52,25,2,6,46
60,Fail,54,26,1,10,44
60,Fail,47,37,0,6,41
60,Fail,55,22,1,8,47
60,Fail,51,27,0,12,39
60,Fail,54,20,0,14,40
60,Fail,44,33,0,12,32
60,Fail,40,46,0,7,33
60,Fail,52,23,1,11,41
60,Fail,42,31,5,10,32
60,Fail,45,27,3,11,34
60,Fail,41,29,5,15,26
60,Fail,49,23,2,13,36
60,Fail,52,20,0,17,35
60,Fail,46,28,6,14,32
60,Fail,48,30,0,15,33
60,Fail,47,26,2,13,34
60,Fail,47,31,0,13,34
60,Fail,56,17,2,13,43
60,Fail,48,33,0,11,37
60,Fail,51,24,0,12,39
60,Fail,56,19,1,13,43
60,Fail,43,31,0,13,30
60,Fail,46,27,3,14,32
60,Fail,51,21,0,15,36
60,Fail,47,19,5,18,29
60,Fail,48,34,0,13,35
60,Fail,56,22,0,8,48
60,Fail,42,30,7,11,31
60,Fail,49,26,3,11,38
60,Fail,50,31,0,11,39
60,Fail,43,27,0,16,27
60,Fail,45,24,4,13,32
60,Fail,48,23,0,14,34
60,Fail,44,24,2,19,25
60,Fail,44,27,10,9,35
60,Fail,44,29,4,12,32
60,Fail,46,29,4,14,32
60,Fail,45,33,0,10,35
60,Fail,50,25,8,11,39
60,Fail,54,32,0,6,48
60,Fail,54,24,0,12,42
60,Fail,53,29,1,5,48
60,Fail,46,36,0,10,36
60,Fail,50,20,9,10,40
60,Fail,44,24,7,17,27
60,Fail,45,24,6,13,32
60,Fail,45,32,0,11,34
60,Fail,52,25,1,14,38
60,Fail,49,29,3,13,36
60,Fail,40,36,0,12,28
60,Fail,46,22,4,15,31
60,Fail,47,24,6,12,35
60,Fail,45,32,0,13,32
60,Fail,40,24,11,14,26
60,Fail,47,38,0,6,41
60,Fail,48,21,8,13,35
60,Fail,46,23,5,15,31
60,Fail,49,27,0,15,34
60,Fail,45,27,2,14,31
60,Fail,41,41,0,13,28
60,Fail,51,28,0,14,37
60,Fail,40,30,0,20,20
60,Fail,51,25,4,11,40
60,Fail,55,27,0,9,46
60,Fail,53,20,2,12,41
60,Fail,52,26,1,10,42
60,Fail,50,24,0,15,35
60,Fail,54,23,2,10,44
60,Fail,54,20,0,12,42
60,Fail,52,25,0,12,40
60,Fail,50,20,7,15,35
60,Fail,45,36,4,9,36
60,Fail,51,32,0,10,41
60,Fail,39,36,0,18,21
60,Fail,57,23,0,10,47
60,Fail,46,29,8,10,36
60,Fail,50,23,9,10,40
60,Fail,48,23,7,15,33
60,Fail,49,26,0,12,37
60,Fail,52,25,0,11,41
60,Fail,49,25,4,8,41
60,Fail,46,23,1,19,27
60,Fail,47,24,0,14,33
60,Fail,42,37,0,12,30
60,Fail,51,28,0,14,37
60,Fail,48,26,2,12,36
60,Fail,45,26,7,14,31
60,Fail,46,24,6,15,31
60,Fail,49,25,5,12,37
60,Fail,52,29,0,7,45
60,Fail,38,31,1,14,24
60,Fail,56,26,0,10,46
60,Fail,54,17,0,17,37
60,Fail,47,22,3,18,29
60,Fail,51,35,0,9,42
60,Fail,38,29,5,21,17
60,Fail,43,36,0,13,30
60,Fail,44,30,0,13,31
60,Fail,48,27,4,9,39
60,Fail,47,29,2,11,36
60,Fail,50,27,4,8,42
60,Fail,49,25,3,11,38
60,Fail,46,28,0,14,32
60,Fail,43,38,0,13,30
60,Fail,49,21,2,18,31
60,Fail,47,26,0,14,33
60,Fail,50,30,0,12,38
60,Fail,42,29,9,12,30
60,Fail,44,34,6,8,36
60,Fail,50,24,0,13,37
60,Fail,48,25,3,15,33
60,Fail,50,31,0,8,42
60,Fail,39,28,6,17,22
60,Fail,49,29,0,14,35
60,Fail,47,30,0,14,33
60,Fail,54,18,7,9,45
60,Fail,44,33,0,15,29
60,Fail,50,23,3,12,38
60,Fail,51,25,1,12,39
60,Fail,49,31,7,8,41
60,Fail,53,27,2,8,45
60,Fail,53,25,3,6,47
60,Fail,51,23,11,6,45
60,Fail,48,25,5,11,37
60,Fail,38,32,0,18,20
60,Fail,54,21,1,7,47
60,Fail,54,31,0,7,47
60,Fail,54,23,0,13,41
60,Fail,48,26,0,17,31
60,Fail,47,25,3,13,34
60,Fail,41,33,0,15,26
60,Fail,32,33,12,16,16
60,Fail,51,24,4,11,40
60,Fail,55,25,1,8,47
60,Fail,49,30,0,11,38
60,Fail,42,34,0,16,26
60,Fail,47,32,0,14,33
60,Fail,39,29,0,19,20
60,Fail,42,33,0,14,28
60,Fail,47,22,0,18,29
60,Fail,51,22,0,11,40
60,Fail,45,30,2,12,33
60,Fail,49,26,0,12,37
60,Fail,42,26,10,13,29
60,Fail,55,24,0,8,47
60,Fail,42,20,10,19,23
60,Fail,40,25,10,11,29
60,Fail,49,28,0,12,37
60,Fail,51,25,0,10,41
60,Fail,50,22,0,15,35
60,Fail,36,31,8,17,19
60,Fail,51,22,1,12,39
60,Fail,45,32,0,11,34
60,Fail,39,39,0,14,25
60,Fail,51,29,0,11,40
60,Fail,46,26,6,11,35
60,Fail,44,26,2,16,28
60,Fail,44,24,13,14,30
60,Fail,54,23,7,8,46
60,Fail,49,21,6,17,32
60,Fail,53,23,0,13,40
60,Fail,48,31,4,9,39
60,Fail,50,22,10,13,37
60,Fail,46,29,0,13,33
60,Fail,50,24,6,8,42
60,Fail,43,28,0,18,25
60,Fail,46,35,0,10,36
60,Fail,45,23,9,19,26
60,Fail,46,29,1,12,34
60,Fail,53,27,0,12,41
60,Fail,60,20,0,12,48
60,Fail,46,19,0,20,26
60,Fail,49,24,3,14,35
60,Fail,53,27,0,9,44
60,Fail,42,30,9,14,28
60,Fail,51,32,0,4,47
60,Fail,40,32,0,17,23
60,Fail,53,17,0,16,37
60,Fail,53,21,2,12,41
60,Fail,55,24,0,10,45
60,Fail,45,30,5,11,34
60,Fail,50,19,0,17,33
60,Fail,49,29,0,11,38
60,Fail,47,27,2,9,38
60,Fail,56,26,0,9,47
60,Fail,54,22,0,12,42
60,Fail,45,32,0,13,32
60,Fail,49,22,0,16,33
60,Fail,51,23,8,9,42
60,Fail,47,27,6,9,38
60,Fail,47,24,4,15,32
60,Fail,41,35,2,12,29
60,Fail,41,35,0,15,26
60,Fail,55,21,4,6,49
60,Fail,48,28,0,15,33
60,Fail,45,33,0,13,32
60,Fail,47,25,4,10,37
60,Fail,43,32,3,14,29
60,Fail,48,32,0,10,38
60,Fail,51,16,4,18,33
60,Fail,47,25,7,13,34
60,Fail,55,22,3,10,45
60,Fail,58,19,0,11,47
60,Fail,47,32,0,9,38
60,Fail,45,30,11,7,38
60,Fail,49,23,0,16,33
60,Fail,51,30,0,6,45
60,Fail,48,27,7,10,38
60,Fail,42,30,0,14,28
60,Fail,53,25,0,10,43
60,Fail,45,33,1,10,35
60,Fail,58,20,0,12,46
60,Fail,47,24,0,17,30
60,Fail,56,23,0,11,45
60,Fail,48,26,0,17,31
60,Fail,44,32,0,12,32
60,Fail,49,27,1,14,35
60,Fail,48,33,0,9,39
60,Fail,49,25,0,13,36
60,Fail,43,22,10,16,27
60,Fail,53,21,4,12,41
60,Fail,49,25,6,14,35
60,Fail,49,26,0,13,36
60,Fail,44,31,0,12,32
60,Fail,50,24,0,16,34
60,Fail,50,18,9,11,39
60,Fail,46,23,0,20,26
60,Fail,48,28,0,11,37
60,Fail,47,27,8,12,35
60,Fail,52,25,8,8,44
60,Fail,45,31,0,11,34
60,Fail,51,23,0,13,38
60,Fail,44,26,1,16,28
60,Fail,49,26,0,13,36
60,Fail,49,21,3,20,29
60,Fail,48,22,0,17,31
60,Fail,48,22,2,15,33
60,Fail,46,28,0,16,30
60,Fail,48,28,2,12,36
60,Fail,41,27,7,15,26
60,Fail,46,28,6,10,36
60,Fail,54,23,3,7,47
60,Fail,44,26,0,16,28
60,Fail,49,21,7,13,36
60,Fail,45,26,1,16,29
60,Fail,46,27,1,11,35
60,Fail,53,23,2,12,41
60,Fail,51,26,0,11,40
60,Fail,47,22,0,18,29
60,Fail,48,23,7,12,36
60,Fail,50,26,6,9,41
60,Fail,48,21,0,18,30
60,Fail,47,24,0,15,32
60,Fail,49,22,6,16,33
60,Fail,52,27,0,11,41
60,Fail,51,29,0,11,40
60,Fail,48,23,4,11,37
60,Fail,48,27,3,12,36
60,Fail,48,29,0,12,36
60,Fail,49,29,2,10,39
60,Fail,50,22,7,11,39
60,Fail,48,25,0,16,32
60,Fail,55,22,4,8,47
60,Fail,46,39,0,7,39
60,Fail,47,26,6,12,35
60,Fail,47,19,17,12,35
60,Fail,51,31,0,12,39
60,Fail,56,17,0,14,42
60,Fail,49,28,1,11,38
60,Fail,45,34,0,14,31
60,Fail,57,12,10,12,45
60,Fail,54,28,0,10,44
60,Fail,48,32,0,11,37
60,Fail,53,20,0,14,39
60,Fail,43,29,4,17,26
60,Fail,51,23,1,14,37
60,Fail,49,29,0,10,39
60,Fail,49,21,7,12,37
60,Fail,55,21,0,12,43
60,Fail,50,23,5,10,40
60,Fail,50,28,1,12,38
60,Fail,48,27,3,12,36
60,Fail,42,27,6,12,30
60,Fail,41,38,0,11,30
60,Fail,44,26,6,13,31
60,Fail,42,38,0,13,29
60,Fail,48,35,0,11,37
60,Fail,48,22,3,17,31
60,Fail,40,38,0,13,27
60,Fail,53,21,0,12,41
60,Fail,46,33,0,12,34
60,Fail,52,20,1,10,42
60,Fail,48,23,6,11,37
60,Fail,43,33,0,15,28
60,Fail,39,27,3,16,23
60,Fail,50,24,4,12,38
60,Fail,51,28,0,10,41
60,Fail,51,24,0,10,41
60,Fail,45,28,1,14,31
60,Fail,44,39,0,10,34
60,Fail,55,24,0,12,43
60,Fail,52,27,0,14,38
60,Fail,48,23,6,14,34
60,Fail,44,25,2,19,25
60,Fail,43,30,0,16,27
60,Fail,55,22,1,10,45
60,Fail,48,28,0,11,37
60,Fail,52,20,1,19,33
60,Fail,49,23,2,15,34
60,Fail,43,33,0,14,29
60,Fail,47,25,0,17,30
60,Fail,50,21,5,12,38
60,Fail,42,30,0,13,29
60,Fail,51,26,0,10,41
60,Fail,54,26,0,9,45
60,Fail,49,24,0,15,34
60,Fail,48,30,0,11,37
60,Fail,46,28,0,13,33
60,Fail,42,33,0,15,27
60,Fail,40,20,11,18,22
60,Fail,45,33,0,14,31
60,Fail,47,34,0,8,39
60,Fail,45,38,0,8,37
60,Fail,48,26,3,9,39
60,Fail,46,29,0,15,31
60,Fail,41,36,0,11,30
60,Fail,56,22,1,10,46
60,Fail,42,32,3,10,32
60,Fail,43,31,0,16,27
60,Fail,46,30,0,14,32
60,Fail,36,39,0,16,20
60,Fail,47,31,0,11,36
60,Fail,49,25,2,17,32
60,Fail,54,29,0,6,48
60,Fail,51,24,0,13,38
60,Fail,45,25,7,13,32
60,Fail,44,32,0,16,28
60,Fail,49,33,0,8,41
60,Fail,54,18,1,18,36
60,Fail,55,19,1,14,41
60,Fail,45,28,4,12,33
60,Fail,46,24,1,18,28
60,Fail,52,22,4,14,38
60,Fail,55,17,3,17,38
60,Fail,42,24,2,20,22
60,Fail,44,36,0,8,36
60,Fail,46,26,6,16,30
60,Fail,55,27,0,10,45
60,Fail,62,10,1,11,51
60,Fail,48,19,2,21,27
60,Fail,43,40,0,8,35
60,Fail,52,21,4,11,41
60,Fail,56,21,2,7,49
60,Fail,46,31,4,8,38
60,Fail,53,24,3,10,43
60,Fail,48,26,0,16,32
60,Fail,53,25,0,11,42
60,Fail,40,26,6,21,19
60,Fail,47,28,0,14,33
60,Fail,37,40,0,14,23
60,Fail,44,28,0,19,25
60,Fail,46,24,8,13,33
60,Fail,56,21,0,8,48
60,Fail,53,22,2,13,40
60,Fail,45,26,1,18,27
60,Fail,52,20,3,12,40
60,Fail,43,37,0,12,31
60,Fail,51,21,0,15,36
60,Fail,49,24,5,14,35
60,Fail,44,32,0,17,27
60,Fail,47,30,0,14,33
60,Fail,46,24,4,12,34
60,Fail,47,25,2,14,33
60,Fail,55,30,0,10,45
60,Fail,46,26,5,12,34
60,Fail,50,32,0,12,38
60,Fail,52,26,0,10,42
60,Fail,48,23,2,17,31
60,Fail,48,21,12,11,37
60,Fail,47,33,0,13,34
60,Fail,43,22,8,17,26
60,Fail,46,33,0,11,35
60,Fail,52,25,0,15,37
60,Fail,51,27,0,11,40
60,Fail,51,28,0,10,41
60,Fail,46,24,3,11,35
60,Fail,50,29,0,10,40
60,Fail,46,39,0,9,37
60,Fail,53,24,0,10,43
60,Fail,46,25,6,15,31
60,Fail,53,29,0,9,44
60,Fail,53,28,0,6,47
60,Fail,41,35,0,13,28
60,Fail,47,32,0,9,38
60,Fail,45,31,0,16,29
60,Fail,43,33,2,11,32
60,Fail,47,29,4,11,36
60,Fail,55,23,0,9,46
60,Fail,46,30,2,12,34
60,Fail,49,31,0,11,38
60,Fail,48,25,4,13,35
60,Fail,57,27,0,8,49
60,Fail,48,30,0,9,39
60,Fail,47,22,8,14,33
60,Fail,47,28,0,11,36
60,Fail,46,23,2,14,32
60,Fail,48,27,0,8,40
60,Fail,57,20,0,9,48
60,Fail,51,30,0,9,42
60,Fail,48,26,0,14,34
60,Fail,46,26,2,18,28
60,Fail,43,23,6,18,25
60,Fail,49,28,2,11,38
60,Fail,52,19,0,15,37
60,Fail,42,36,0,13,29
60,Fail,44,25,4,17,27
60,Fail,52,29,0,8,44
60,Fail,42,36,0,11,31
60,Fail,41,45,0,9,32
60,Fail,46,30,0,14,32
60,Fail,51,21,3,13,38
60,Fail,52,18,2,14,38
60,Fail,48,36,0,8,40
60,Fail,41,30,3,19,22
60,Fail,46,27,4,16,30
60,Fail,45,30,0,12,33
60,Fail,52,19,1,16,36
60,Fail,46,34,0,13,33
60,Fail,47,24,3,16,31
60,Fail,39,25,18,12,27
60,Fail,51,16,7,17,34
60,Fail,54,26,0,9,45
60,Fail,54,26,3,9,45
60,Fail,51,24,0,13,38
60,Fail,45,34,0,11,34
60,Fail,50,27,6,9,41
60,Fail,50,31,0,11,39
60,Fail,45,33,0,10,35
60,Fail,54,19,2,9,45
60,Fail,50,24,3,15,35
60,Fail,50,28,0,11,39
60,Fail,51,31,0,10,41
60,Fail,45,32,0,14,31
60,Fail,44,26,1,16,28
60,Fail,46,30,0,13,33
60,Fail,53,24,0,13,40
60,Fail,45,29,0,17,28
60,Fail,51,31,0,8,43
60,Fail,43,30,0,14,29
60,Fail,52,28,0,8,44
60,Fail,48,27,4,13,35
60,Fail,48,24,0,16,32
60,Fail,50,23,2,11,39
60,Fail,51,24,0,14,37
60,Fail,52,28,0,10,42
60,Fail,42,24,3,18,24
60,Fail,44,25,4,14,30
60,Fail,50,23,3,11,39
60,Fail,45,26,6,16,29
60,Fail,46,26,0,18,28
60,Fail,50,29,0,9,41
60,Fail,46,31,0,17,29
60,Fail,48,26,0,14,34
60,Fail,51,29,0,10,41
60,Fail,41,29,0,14,27
60,Fail,43,25,5,18,25
60,Fail,42,25,7,14,28
60,Fail,52,22,1,15,37
60,Fail,37,39,0,14,23
60,Fail,46,29,1,8,38
60,Fail,51,31,2,9,42
60,Fail,49,29,0,11,38
60,Fail,49,33,0,11,38
60,Fail,42,36,7,10,32
60,Fail,47,31,0,12,35
60,Fail,48,27,0,13,35
60,Fail,53,23,0,11,42
60,Fail,48,20,18,8,40
60,Fail,50,28,0,9,41
60,Fail,43,34,0,13,30
60,Fail,49,29,2,11,38
60,Fail,49,32,0,8,41
60,Fail,51,26,0,10,41
60,Fail,49,24,3,14,35
60,Fail,52,26,4,9,43
60,Fail,55,22,0,16,39
60,Fail,46,35,0,6,40
60,Fail,56,23,0,8,48
60,Fail,44,21,10,14,30
60,Fail,51,23,0,16,35
60,Fail,53,27,0,13,40
60,Fail,41,38,0,13,28
60,Fail,45,35,0,12,33
60,Fail,50,29,0,14,36
60,Fail,49,35,0,10,39
60,Fail,52,26,0,13,39
60,Fail,47,30,0,10,37
60,Fail,41,23,3,19,22
60,Fail,43,31,0,12,31
60,Fail,56,20,4,9,47
60,Fail,49,20,4,18,31
60,Fail,44,22,12,12,32
60,Fail,49,31,2,8,41
60,Fail,51,22,9,8,43
60,Fail,42,23,11,15,27
60,Fail,48,28,4,9,39
60,Fail,51,19,0,17,34
60,Fail,48,35,0,10,38
60,Fail,51,27,2,8,43
60,Fail,45,26,0,14,31
60,Fail,42,31,5,14,28
60,Fail,50,23,5,13,37
60,Fail,50,23,0,14,36
60,Fail,43,33,0,15,28
60,Fail,44,34,0,11,33
60,Fail,41,26,11,10,31
60,Fail,42,35,0,14,28
60,Fail,49,26,3,13,36
60,Fail,47,30,1,10,37
60,Fail,49,28,6,10,39
60,Fail,46,32,0,16,30
60,Fail,50,27,7,9,41
60,Fail,48,32,0,10,38
60,Fail,46,33,0,11,35
60,Fail,46,22,2,19,27
60,Fail,52,23,3,12,40
60,Fail,49,27,0,9,40
60,Fail,43,35,1,11,32
60,Fail,40,32,0,15,25
60,Fail,49,26,0,14,35
60,Fail,37,33,0,20,17
60,Fail,49,28,0,15,34
60,Fail,44,27,3,14,30
60,Fail,48,30,0,10,38
60,Fail,50,30,0,13,37
60,Fail,45,24,2,18,27
60,Fail,44,35,0,11,33
60,Fail,49,26,1,13,36
60,Fail,56,22,0,7,49
60,Fail,54,22,5,10,44
60,Fail,52,30,0,8,44
60,Fail,51,27,0,11,40
60,Fail,53,25,0,11,42
60,Fail,41,34,0,18,23
60,Fail,54,25,0,10,44
60,Fail,50,17,3,17,33
60,Fail,55,16,3,13,42
60,Fail,60,20,0,9,51
60,Fail,49,29,0,8,41
60,Fail,39,35,0,19,20
60,Fail,44,30,0,15,29
60,Fail,47,33,0,8,39
60,Fail,55,21,3,10,45
60,Fail,52,23,0,12,40
60,Fail,45,22,2,21,24
60,Fail,46,30,0,15,31
60,Fail,45,35,0,9,36
60,Fail,53,29,0,9,44
60,Fail,49,33,0,6,43
60,Fail,47,30,2,9,38
60,Fail,50,35,0,6,44
60,Fail,57,20,0,11,46
60,Fail,45,22,0,23,22
60,Fail,41,27,3,15,26
60,Fail,40,34,0,12,28
60,Fail,40,27,12,13,27
60,Fail,40,28,2,19,21
60,Fail,51,24,0,14,37
60,Fail,49,28,0,11,38
60,Fail,53,32,0,7,46
60,Fail,50,28,0,11,39
60,Fail,45,30,4,16,29
60,Fail,52,23,0,11,41
60,Fail,41,36,0,14,27
60,Fail,52,22,0,12,40
60,Fail,47,32,0,11,36
60,Fail,50,30,0,7,43
60,Fail,41,32,5,13,28
60,Fail,48,31,2,8,40
60,Fail,41,26,1,19,22
60,Fail,53,22,2,10,43
60,Fail,57,21,0,8,49
60,Fail,50,29,0,11,39
60,Fail,40,27,7,19,21
60,Fail,49,20,12,16,33
60,Fail,41,32,6,12,29
60,Fail,41,45,0,12,29
60,Fail,44,32,0,13,31
60,Fail,43,26,6,17,26
60,Fail,58,24,0,8,50
60,Fail,49,26,0,18,31
60,Fail,47,29,2,11,36
60,Fail,41,40,0,12,29
60,Fail,51,24,4,11,40
60,Fail,54,26,0,11,43
60,Fail,44,22,4,18,26
60,Fail,51,19,6,14,37
60,Fail,47,34,0,10,37
60,Fail,53,21,1,11,42
60,Fail,52,21,2,14,38
60,Fail,43,27,7,12,31
60,Fail,48,35,0,12,36
60,Fail,50,31,0,12,38
60,Fail,44,31,0,13,31
60,Fail,41,33,0,15,26
60,Fail,52,15,3,16,36
60,Fail,43,28,12,11,32
60,Fail,44,24,5,12,32
60,Fail,41,27,6,18,23
60,Fail,44,25,3,17,27
60,Fail,51,28,0,11,40
60,Fail,48,27,4,10,38
60,Fail,51,26,0,12,39
60,Fail,49,27,0,16,33
60,Fail,49,32,0,15,34
60,Fail,50,27,10,8,42
60,Fail,42,29,2,17,25
60,Fail,47,24,3,14,33
60,Fail,42,27,0,20,22
60,Fail,47,26,4,9,38
60,Fail,45,29,5,12,33
60,Fail,49,22,2,13,36
60,Fail,45,40,0,8,37
60,Fail,45,38,0,10,35
60,Fail,42,29,0,15,27
60,Fail,50,27,0,13,37
60,Fail,46,33,0,14,32
60,Fail,47,21,0,20,27
60,Fail,49,28,0,12,37
60,Fail,56,20,1,8,48
60,Fail,47,23,8,16,31
60,Fail,44,37,0,11,33
60,Fail,44,32,0,14,30
60,Fail,53,22,0,8,45
60,Fail,46,28,0,15,31
60,Fail,60,23,2,7,53
60,Fail,52,23,0,13,39
60,Fail,51,26,0,11,40
60,Fail,51,28,0,7,44
60,Fail,55,25,0,7,48
60,Fail,44,26,5,12,32
60,Fail,50,30,0,10,40
60,Fail,50,17,0,19,31
60,Fail,46,22,4,15,31
60,Fail,51,30,0,11,40
60,Fail,39,29,10,14,25
60,Fail,53,21,2,11,42
60,Fail,51,25,4,12,39
60,Fail,49,28,0,9,40
60,Fail,35,44,0,10,25
60,Fail,54,16,0,19,35
60,Fail,48,26,0,16,32
60,Fail,41,26,2,19,22
60,Fail,46,25,5,14,32
60,Fail,47,27,3,14,33
60,Fail,53,23,3,12,41
60,Fail,44,28,5,10,34
60,Fail,53,15,2,13,40
60,Fail,46,38,0,11,35
60,Fail,40,37,0,11,29
60,Fail,45,25,3,18,27
60,Fail,55,26,2,8,47
60,Fail,46,20,11,14,32
60,Fail,54,21,1,9,45
60,Fail,51,29,0,10,41
60,Fail,42,32,6,11,31
60,Fail,57,17,3,14,43
60,Fail,52,29,1,10,42
60,Fail,47,25,2,13,34
60,Fail,42,26,4,16,26
60,Fail,39,29,0,21,18
60,Fail,48,28,0,15,33
60,Fail,46,29,1,14,32
60,Fail,47,21,4,16,31
60,Fail,46,26,5,13,33
60,Fail,44,33,0,14,30
60,Fail,47,21,0,15,32
60,Fail,58,24,0,7,51
60,Fail,41,32,0,19,22
60,Fail,47,28,0,18,29
60,Fail,46,27,0,13,33
60,Fail,45,31,2,12,33
60,Fail,50,28,0,10,40
60,Fail,45,24,6,13,32
60,Fail,40,31,0,19,21
60,Fail,58,26,0,8,50
60,Fail,47,32,0,13,34
60,Fail,41,27,8,12,29
60,Fail,51,34,0,6,45
60,Fail,54,18,0,15,39
60,Fail,52,25,7,10,42
60,Fail,49,30,0,12,37
60,Fail,44,37,0,12,32
60,Fail,48,24,9,8,40
60,Fail,42,27,4,16,26
60,Fail,49,23,11,11,38
60,Fail,54,23,0,9,45
60,Fail,55,19,2,13,42
60,Fail,53,20,3,13,40
60,Fail,48,26,1,14,34
60,Fail,40,31,0,20,20
60,Fail,50,33,0,10,40
60,Fail,46,31,1,12,34
60,Fail,48,33,0,9,39
60,Fail,48,25,0,15,33
60,Fail,49,25,1,18,31
60,Fail,50,17,6,19,31
60,Fail,49,23,4,9,40
60,Fail,55,21,0,12,43
60,Fail,45,21,1,21,24
60,Fail,54,24,1,8,46
60,Fail,47,32,1,8,39
60,Fail,43,28,0,15,28
60,Fail,47,28,4,10,37
60,Fail,54,21,0,12,42
60,Fail,49,31,0,8,41
60,Fail,46,28,0,17,29
60,Fail,46,29,2,11,35
60,Fail,51,21,0,13,38
60,Fail,46,25,0,17,29
60,Fail,48,27,4,12,36
60,Fail,45,35,0,12,33
60,Fail,55,17,2,13,42
60,Fail,50,22,3,12,38
60,Fail,47,20,7,17,30
60,Fail,41,31,0,18,23
60,Fail,44,33,0,13,31
60,Fail,45,26,5,16,29
60,Fail,47,21,0,18,29
60,Fail,49,24,7,15,34
60,Fail,43,31,0,17,26
60,Fail,49,24,1,15,34
60,Fail,44,31,0,18,26
60,Fail,44,32,1,9,35
60,Fail,50,31,0,8,42
60,Fail,45,33,0,10,35
60,Fail,48,24,2,14,34
60,Fail,51,24,0,13,38
60,Fail,48,23,0,16,32
60,Fail,47,31,2,8,39
60,Fail,45,27,2,16,29
60,Fail,49,26,0,13,36
60,Fail,53,28,0,7,46
60,Fail,47,29,4,10,37
60,Fail,49,24,4,13,36
60,Fail,48,20,7,14,34
60,Fail,48,31,0,10,38
60,Fail,46,21,9,12,34
60,Fail,50,32,0,9,41
60,Fail,46,33,0,16,30
60,Fail,51,23,0,16,35
60,Fail,48,32,1,8,40
60,Fail,50,29,0,9,41
60,Fail,52,26,0,11,41
60,Fail,43,28,4,15,28
60,Fail,46,26,1,13,33
60,Fail,48,30,0,14,34
60,Fail,46,30,3,12,34
60,Fail,43,33,0,13,30
60,Fail,44,35,0,12,32
60,Fail,51,34,0,5,46
60,Fail,58,19,1,12,46
60,Fail,44,35,1,6,38
60,Fail,45,21,11,18,27
60,Fail,46,23,2,17,29
60,Fail,54,23,3,9,45
60,Fail,54,21,9,11,43
60,Fail,58,18,3,8,50
60,Fail,41,34,0,18,23
60,Fail,53,22,1,12,41
60,Fail,57,25,3,10,47
60,Fail,49,24,0,13,36
60,Fail,52,21,2,11,41
60,Fail,54,27,0,9,45
60,Fail,42,24,4,18,24
60,Fail,44,36,0,10,34
60,Fail,44,31,5,10,34
60,Fail,45,29,2,13,32
60,Fail,53,26,0,9,44
60,Fail,48,24,3,12,36
60,Fail,51,28,0,10,41
60,Fail,40,26,14,15,25
60,Fail,48,29,0,14,34
60,Fail,47,25,11,10,37
60,Fail,43,31,0,17,26
60,Fail,50,22,3,16,34
60,Fail,46,25,7,10,36
60,Fail,55,21,0,14,41
60,Fail,52,26,0,9,43
60,Fail,48,22,1,18,30
60,Fail,50,28,2,9,41
60,Fail,43,35,0,11,32
60,Fail,49,24,5,13,36
60,Fail,54,18,1,12,42
60,Fail,49,25,0,15,34
60,Fail,46,29,0,15,31
60,Fail,49,28,0,9,40
60,Fail,43,26,4,16,27
60,Fail,58,17,1,11,47
60,Fail,49,29,0,13,36
60,Fail,42,31,6,13,29
60,Fail,44,30,0,14,30
60,Fail,42,26,0,22,20
60,Fail,50,18,10,14,36
60,Fail,49,21,8,11,38
60,Fail,50,23,0,13,37
60,Fail,48,29,2,8,40
60,Fail,47,33,0,11,36
60,Fail,47,26,1,11,36
60,Fail,52,28,0,8,44
60,Fail,41,21,12,18,23
60,Fail,47,28,0,13,34
60,Fail,52,23,0,16,36
60,Fail,53,23,2,7,46
60,Fail,47,28,0,13,34
60,Fail,55,16,11,6,49
60,Fail,46,27,8,12,34
60,Fail,48,30,0,13,35
60,Fail,41,33,3,15,26
60,Fail,51,26,2,11,40
60,Fail,43,37,0,12,31
60,Fail,55,22,4,12,43
60,Fail,49,18,4,14,35
60,Fail,55,24,0,4,51
60,Fail,40,37,0,16,24
60,Fail,45,29,0,15,30
60,Fail,52,25,7,7,45
60,Fail,41,33,0,16,25
60,Fail,50,27,0,13,37
60,Fail,48,39,0,5,43
60,Fail,58,18,2,13,45
60,Fail,51,15,3,17,34
60,Fail,46,28,9,11,35
60,Fail,55,26,0,9,46
60,Fail,51,30,0,8,43
60,Fail,48,27,0,14,34
60,Fail,45,27,5,13,32
60,Fail,49,26,1,12,37
60,Fail,47,32,0,12,35
60,Fail,53,19,6,13,40
60,Fail,58,13,0,15,43
60,Fail,39,32,4,12,27
60,Fail,50,29,5,7,43
60,Fail,47,32,0,11,36
60,Fail,49,34,0,9,40
60,Fail,48,27,0,13,35
60,Fail,46,29,3,10,36
60,Fail,49,27,0,10,39
60,Fail,49,24,8,6,43
60,Fail,46,23,6,13,33
60,Fail,55,20,0,11,44
60,Fail,50,34,0,8,42
60,Fail,51,32,0,4,47
60,Fail,54,21,0,14,40
60,Fail,50,29,0,14,36
60,Fail,53,21,0,16,37
60,Fail,47,29,0,16,31
60,Fail,46,24,0,18,28
60,Fail,41,30,9,10,31
60,Fail,54,26,0,11,43
60,Fail,39,42,0,12,27
60,Fail,49,30,0,13,36
60,Fail,42,34,0,10,32
60,Fail,39,35,0,13,26
60,Fail,49,24,0,15,34
60,Fail,44,26,0,17,27
60,Fail,45,29,0,15,30
60,Fail,43,30,0,14,29
60,Fail,39,39,0,15,24
60,Fail,42,26,7,16,26
60,Fail,47,25,1,15,32
60,Fail,47,32,0,13,34
60,Fail,49,30,0,11,38
60,Fail,57,17,1,10,47
60,Fail,51,25,2,10,41
60,Fail,42,23,10,14,28
60,Fail,53,26,0,10,43
60,Fail,47,27,5,8,39
60,Fail,45,39,0,8,37
60,Fail,40,29,13,16,24
60,Fail,47,28,0,14,33
60,Fail,48,25,2,16,32
60,Fail,44,34,0,16,28
60,Fail,45,33,0,15,30
60,Fail,43,31,5,11,32
60,Fail,48,33,0,12,36
60,Fail,39,36,0,17,22
60,Fail,42,33,0,15,27
60,Fail,46,28,0,13,33
60,Fail,52,22,2,14,38
60,Fail,42,35,0,17,25
60,Fail,43,40,0,11,32
60,Fail,49,21,2,16,33
60,Fail,49,27,0,10,39
60,Fail,47,28,5,10,37
60,Fail,45,27,3,14,31
60,Fail,54,21,0,11,43
60,Fail,55,23,3,9,46
60,Fail,50,24,0,9,41
60,Fail,41,41,0,8,33
60,Fail,48,27,0,14,34
60,Fail,44,32,0,15,29
60,Fail,52,24,0,15,37
60,Fail,34,40,0,17,17
60,Fail,59,19,0,13,46
60,Fail,48,23,1,16,32
60,Fail,54,28,0,8,46
60,Fail,36,40,0,18,18
60,Fail,48,23,9,11,37
60,Fail,53,26,0,9,44
60,Fail,52,24,0,13,39
60,Fail,53,23,0,10,43
60,Fail,47,26,10,9,38
60,Fail,45,32,0,15,30
60,Fail,41,38,0,12,29
60,Fail,50,22,3,15,35
60,Fail,39,33,3,15,24
60,Fail,46,34,0,10,36
60,Fail,49,26,3,13,36
60,Fail,45,35,0,13,32
60,Fail,49,34,0,8,41
60,Fail,54,26,0,10,44
60,Fail,48,29,0,14,34
60,Fail,49,30,0,10,39
60,Fail,48,23,4,14,34
60,Fail,55,22,0,12,43
60,Fail,56,33,0,6,50
60,Fail,44,39,0,8,36
60,Fail,45,28,5,11,34
60,Fail,42,35,0,16,26
60,Fail,49,28,0,11,38
60,Fail,45,22,0,20,25
60,Fail,51,18,4,16,35
60,Fail,51,35,0,8,43
60,Fail,45,22,6,16,29
60,Fail,53,17,0,13,40
60,Fail,41,43,0,10,31
60,Fail,38,33,3,15,23
60,Fail,58,24,0,8,50
60,Fail,42,40,0,12,30
60,Fail,55,26,4,8,47
60,Fail,50,23,2,9,41
60,Fail,48,26,2,10,38
60,Fail,44,32,0,13,31
60,Fail,51,21,1,13,38
60,Fail,43,34,0,16,27
60,Fail,44,23,11,12,32
60,Fail,45,28,0,15,30
60,Fail,43,29,10,10,33
60,Fail,51,24,4,10,41
60,Fail,43,36,0,11,32
60,Fail,45,35,0,7,38
60,Fail,48,32,0,10,38
60,Fail,49,25,2,14,35
60,Fail,51,30,0,10,41
60,Fail,43,24,12,15,28
60,Fail,49,20,11,8,41
60,Fail,51,31,0,12,39
60,Fail,43,26,5,16,27
60,Fail,56,26,4,6,50
60,Fail,54,29,0,7,47
60,Fail,48,30,0,12,36
60,Fail,47,25,0,15,32
60,Fail,54,27,0,11,43
60,Fail,55,20,7,10,45
60,Fail,49,31,0,12,37
60,Fail,55,19,1,13,42
60,Fail,49,29,0,13,36
60,Fail,54,15,1,15,39
60,Fail,46,26,0,14,32
60,Fail,54,22,0,12,42
60,Fail,46,28,0,16,30
60,Fail,43,25,6,13,30
60,Fail,50,20,4,13,37
60,Fail,45,31,0,13,32
60,Fail,45,25,1,16,29
60,Fail,49,29,0,12,37
60,Fail,38,33,0,16,22
60,Fail,47,27,3,17,30
60,Fail,41,31,10,13,28
60,Fail,49,33,0,10,39
60,Fail,44,27,10,12,32
60,Fail,46,39,0,10,36
60,Fail,49,31,0,12,37
60,Fail,52,27,2,9,43
60,Fail,42,34,0,12,30
60,Fail,48,29,0,13,35
60,Fail,55,21,2,8,47
60,Fail,47,25,10,11,36
60,Fail,48,29,1,10,38
60,Fail,50,27,3,12,38
60,Fail,51,24,8,10,41
60,Fail,44,34,0,11,33
60,Fail,52,29,0,7,45
60,Fail,52,28,0,10,42
60,Fail,50,28,0,12,38
60,Fail,48,25,0,18,30
60,Fail,50,36,0,5,45
60,Fail,48,27,0,10,38
60,Fail,49,22,8,11,38
60,Fail,47,32,0,10,37
60,Fail,40,30,12,9,31
60,Fail,48,22,4,16,32
60,Fail,47,26,0,13,34
60,Fail,45,32,0,13,32
60,Fail,55,27,0,7,48
60,Fail,52,32,0,9,43
60,Fail,43,35,0,10,33
60,Fail,40,38,0,12,28
60,Fail,43,28,1,17,26
60,Fail,47,29,0,14,33
60,Fail,48,24,3,13,35
60,Fail,48,24,3,14,34
60,Fail,50,22,7,13,37
60,Fail,51,20,2,10,41
60,Fail,51,23,1,16,35
60,Fail,43,26,3,16,27
60,Fail,45,29,0,15,30
60,Fail,46,29,2,9,37
60,Fail,54,31,0,6,48
60,Fail,46,28,0,16,30
60,Fail,51,24,2,13,38
60,Fail,49,22,0,16,33
60,Fail,44,27,5,17,27
60,Fail,50,25,2,12,38
60,Fail,56,25,0,8,48
60,Fail,47,26,1,16,31
60,Fail,54,27,0,11,43
60,Fail,55,24,0,8,47
60,Fail,58,22,0,10,48
60,Fail,44,28,0,15,29
60,Fail,44,27,4,14,30
60,Fail,48,25,6,14,34
60,Fail,45,23,0,17,28
60,Fail,50,30,3,5,45
60,Fail,41,32,0,15,26
60,Fail,45,35,0,13,32
60,Fail,53,25,3,8,45
60,Fail,37,33,0,22,15
60,Fail,44,32,0,15,29
60,Fail,51,24,7,10,41
60,Fail,49,22,0,12,37
60,Fail,48,26,2,12,36
60,Fail,47,24,10,13,34
60,Fail,41,31,0,15,26
60,Fail,50,27,0,13,37
60,Fail,51,28,0,11,40
60,Fail,47,22,4,17,30
60,Fail,42,27,0,21,21
60,Fail,54,15,0,17,37
60,Fail,48,22,4,15,33
60,Fail,52,31,1,8,44
60,Fail,47,24,3,17,30
60,Fail,42,34,0,10,32
60,Fail,49,28,0,14,35
60,Fail,48,23,0,17,31
60,Fail,44,33,1,10,34
60,Fail,44,29,0,19,25
60,Fail,43,27,0,16,27
60,Fail,53,24,0,10,43
60,Fail,56,28,0,7,49
60,Fail,39,42,0,12,27
60,Fail,57,23,0,9,48
60,Fail,49,32,0,11,38
60,Fail,53,26,0,11,42
60,Fail,46,22,0,16,30
60,Fail,52,21,11,7,45
60,Fail,53,24,0,11,42
60,Fail,43,29,2,14,29
60,Fail,46,29,4,12,34
60,Fail,50,23,0,14,36
60,Fail,38,32,7,14,24
60,Fail,47,32,0,14,33
60,Fail,47,20,4,12,35
60,Fail,44,26,6,11,33
60,Fail,46,29,6,9,37
60,Fail,43,33,0,12,31
60,Fail,50,31,0,11,39
60,Fail,42,26,3,20,22
60,Fail,46,34,0,12,34
60,Fail,51,26,1,10,41
60,Fail,49,35,0,11,38
60,Fail,48,31,0,16,32
60,Fail,47,33,3,10,37
60,Fail,48,28,0,9,39
60,Fail,42,34,0,15,27
60,Fail,47,32,0,11,36
60,Fail,52,22,6,10,42
60,Fail,50,24,0,12,38
60,Fail,47,29,0,12,35
60,Fail,52,21,1,15,37
60,Fail,45,25,10,11,34
60,Fail,43,25,2,16,27
60,Fail,44,28,0,15,29
60,Fail,44,36,0,9,35
60,Fail,47,30,0,14,33
60,Fail,49,23,1,14,35
60,Fail,42,32,0,14,28
60,Fail,52,20,7,8,44
60,Fail,46,20,6,18,28
60,Fail,46,27,6,13,33
60,Fail,51,28,0,9,42
60,Fail,51,22,1,11,40
60,Fail,46,25,5,15,31
60,Fail,46,25,0,15,31
60,Fail,50,26,0,12,38
60,Fail,48,21,0,18,30
60,Fail,44,30,0,15,29
60,Fail,45,34,0,12,33
60,Fail,48,32,0,11,37
60,Fail,50,26,0,10,40
60,Fail,49,23,2,14,35
60,Fail,48,33,0,9,39
60,Fail,52,23,0,13,39
60,Fail,51,19,3,17,34
60,Fail,43,29,3,13,30
60,Fail,46,38,0,11,35
60,Fail,52,25,0,15,37
60,Fail,44,31,0,15,29
60,Fail,54,16,0,14,40
60,Fail,50,26,1,9,41
60,Fail,52,29,0,11,41
60,Fail,40,30,0,17,23
60,Fail,48,25,0,17,31
60,Fail,51,35,0,5,46
60,Fail,50,30,0,11,39
60,Fail,46,29,0,13,33
60,Fail,48,26,0,11,37
60,Fail,50,32,0,7,43
60,Fail,50,30,0,14,36
60,Fail,50,29,0,13,37
60,Fail,51,31,1,10,41
60,Fail,45,31,10,7,38
60,Fail,42,34,0,14,28
60,Fail,52,24,0,11,41
60,Fail,45,23,0,20,25
60,Fail,50,31,0,11,39
60,Fail,50,31,0,11,39
60,Fail,44,32,0,11,33
60,Fail,50,28,1,12,38
60,Fail,52,20,3,12,40
60,Fail,45,29,0,17,28
60,Fail,49,25,0,11,38
60,Fail,46,29,3,13,33
60,Fail,50,26,2,13,37
60,Fail,49,23,8,10,39
60,Fail,53,22,1,11,42
60,Fail,48,27,0,11,37
60,Fail,56,24,0,11,45
60,Fail,53,22,0,13,40
60,Fail,52,23,0,10,42
60,Fail,46,37,0,10,36
60,Fail,43,30,0,18,25
60,Fail,44,35,0,11,33
60,Fail,50,26,0,13,37
60,Fail,50,23,0,16,34
60,Fail,48,29,0,15,33
60,Fail,55,22,0,16,39
60,Fail,46,27,1,16,30
60,Fail,54,25,3,7,47
60,Fail,43,24,8,15,28
60,Fail,46,24,2,15,31
60,Fail,53,26,0,8,45
60,Fail,43,28,0,19,24
60,Fail,50,24,0,14,36
60,Fail,48,26,0,14,34
60,Fail,48,24,0,18,30
60,Fail,48,27,5,16,32
60,Fail,52,29,0,10,42
60,Fail,44,28,7,11,33
60,Fail,53,23,2,10,43
60,Fail,58,22,2,6,52
60,Fail,49,27,0,12,37
60,Fail,55,21,1,14,41
60,Fail,52,25,0,17,35
60,Fail,50,31,0,13,37
60,Fail,51,25,1,8,43
60,Fail,46,27,4,16,30
60,Fail,40,35,0,13,27
60,Fail,46,27,0,18,28
60,Fail,44,31,4,16,28
60,Fail,46,22,0,18,28
60,Fail,51,27,0,13,38
60,Fail,41,29,3,15,26
60,Fail,42,31,0,18,24
60,Fail,55,19,4,12,43
60,Fail,47,24,4,17,30
60,Fail,48,29,4,9,39
60,Fail,46,32,0,10,36
60,Fail,46,26,0,17,29
60,Fail,49,33,0,9,40
60,Fail,49,24,6,13,36
60,Fail,43,27,0,20,23
60,Fail,46,27,2,12,34
60,Fail,48,34,1,8,40
60,Fail,51,26,0,11,40
60,Fail,53,29,0,7,46
60,Fail,47,39,0,7,40
60,Fail,52,23,5,13,39
60,Fail,52,26,2,6,46
60,Fail,52,26,0,10,42
60,Fail,54,28,0,10,44
60,Fail,54,24,1,12,42
60,Fail,44,30,6,14,30
60,Fail,47,33,0,11,36
60,Fail,41,42,0,10,31
60,Fail,53,21,7,7,46
60,Fail,48,30,0,14,34
60,Fail,45,31,0,18,27
60,Fail,52,27,3,8,44
60,Fail,46,33,4,8,38
60,Fail,46,29,0,14,32
60,Fail,44,38,0,6,38
60,Fail,43,27,10,13,30
60,Fail,38,43,0,8,30
60,Fail,49,26,0,13,36
60,Fail,51,27,3,9,42
60,Fail,57,23,2,10,47
60,Fail,49,28,7,8,41
60,Fail,44,23,9,15,29
60,Fail,40,31,7,14,26
60,Fail,50,27,0,11,39
60,Fail,54,26,0,7,47
60,Fail,39,35,0,17,22
60,Fail,49,28,0,15,34
60,Fail,47,26,5,14,33
60,Fail,54,25,2,10,44
60,Fail,51,24,0,10,41
60,Fail,50,26,0,10,40
60,Fail,48,31,2,12,36
60,Fail,49,26,0,15,34
60,Fail,53,23,1,10,43
60,Fail,46,22,2,15,31
60,Fail,45,38,0,13,32
60,Fail,50,25,0,18,32
60,Fail,48,30,0,11,37
60,Fail,44,22,10,19,25
60,Fail,42,29,11,11,31
60,Fail,43,30,0,18,25
60,Fail,54,25,0,10,44
60,Fail,47,29,3,10,37
60,Fail,45,26,0,19,26
60,Fail,50,25,3,9,41
60,Fail,47,30,0,13,34
60,Fail,54,19,5,13,41
60,Fail,43,26,5,17,26
60,Fail,40,35,9,11,29
60,Fail,51,21,2,16,35
60,Fail,48,21,11,9,39
60,Fail,48,23,6,16,32
60,Fail,53,23,0,15,38
60,Fail,47,22,7,14,33
60,Fail,50,22,3,12,38
60,Fail,46,30,6,10,36
60,Fail,50,34,0,8,42
60,Fail,50,24,0,14,36
60,Fail,54,21,9,11,43
60,Fail,50,19,0,15,35
60,Fail,44,21,5,18,26
60,Fail,39,28,6,17,22
60,Fail,40,29,1,16,24
60,Fail,49,27,0,10,39
60,Fail,52,26,3,11,41
60,Fail,39,34,0,19,20
60,Fail,41,30,7,12,29
60,Fail,41,29,4,16,25
60,Fail,43,31,3,10,33
60,Fail,50,21,1,13,37
60,Fail,56,21,0,11,45
60,Fail,45,24,7,15,30
60,Fail,41,26,5,14,27
60,Fail,49,27,6,7,42
60,Fail,51,30,0,9,42
60,Fail,47,24,6,15,32
60,Fail,47,28,2,13,34
60,Fail,60,16,1,8,52
60,Fail,53,30,0,10,43
60,Fail,51,23,4,13,38
60,Fail,48,19,8,17,31
60,Fail,48,24,7,9,39
60,Fail,42,25,0,19,23
60,Fail,46,21,7,15,31
60,Fail,47,26,0,16,31
60,Fail,44,38,0,6,38
60,Fail,49,25,0,16,33
60,Fail,50,27,3,9,41
60,Fail,45,21,3,17,28
60,Fail,38,34,0,19,19
60,Fail,45,28,2,11,34
60,Fail,39,26,5,21,18
60,Fail,46,24,2,17,29
60,Fail,42,35,0,13,29
60,Fail,37,25,4,22,15
60,Fail,47,21,0,17,30
60,Fail,42,32,0,15,27
60,Fail,42,26,8,15,27
60,Fail,48,28,2,7,41
60,Fail,52,25,0,9,43
60,Fail,53,26,0,12,41
60,Fail,53,19,3,12,41
60,Fail,50,32,0,6,44
60,Fail,49,24,1,10,39
60,Fail,51,32,0,8,43
60,Fail,51,23,0,14,37
60,Fail,46,35,4,10,36
60,Fail,49,24,0,12,37
60,Fail,43,29,4,10,33
60,Fail,50,21,5,12,38
60,Fail,51,28,2,7,44
60,Fail,40,27,7,18,22
60,Fail,49,21,2,13,36
60,Fail,52,23,0,14,38
60,Fail,47,29,0,12,35
60,Fail,52,28,0,13,39
60,Fail,55,25,2,9,46
60,Fail,51,25,0,8,43
60,Fail,48,29,4,8,40
60,Fail,52,23,0,14,38
60,Fail,47,27,0,14,33
60,Fail,50,27,1,12,38
60,Fail,51,24,1,14,37
60,Fail,40,32,0,16,24
60,Fail,51,20,2,19,32
60,Fail,51,30,0,11,40
60,Fail,53,20,1,14,39
60,Fail,48,24,1,12,36
60,Fail,54,18,4,11,43
60,Fail,47,28,0,15,32
60,Fail,45,37,0,10,35
60,Fail,46,26,0,13,33
60,Fail,52,19,5,16,36
60,Fail,46,24,7,17,29
60,Fail,49,34,0,8,41
60,Fail,54,22,0,9,45
60,Fail,45,31,3,12,33
60,Fail,42,38,0,11,31
60,Fail,41,23,0,22,19
60,Fail,46,30,2,10,36
60,Fail,56,19,0,14,42
60,Fail,46,29,9,10,36
60,Fail,51,28,0,13,38
60,Fail,48,25,0,16,32
60,Fail,49,27,1,14,35
60,Fail,48,15,8,17,31
60,Fail,47,26,1,9,38
60,Fail,50,23,2,16,34
60,Fail,43,24,6,17,26
60,Fail,46,17,9,17,29
60,Fail,46,27,2,14,32
60,Fail,50,26,1,11,39
60,Fail,46,26,5,11,35
60,Fail,48,32,0,7,41
60,Fail,50,20,4,16,34
60,Fail,51,23,2,11,40
60,Fail,49,23,0,18,31
60,Fail,48,30,0,11,37
60,Fail,44,23,7,17,27
60,Fail,55,20,0,12,43
60,Fail,46,35,2,8,38
60,Fail,53,23,4,9,44
60,Fail,40,35,0,15,25
60,Fail,49,19,6,16,33
60,Fail,52,26,0,11,41
60,Fail,41,35,0,13,28
60,Fail,43,26,12,14,29
60,Fail,42,32,0,16,26
60,Fail,45,24,0,16,29
60,Fail,47,28,0,14,33
60,Fail,46,29,0,15,31
60,Fail,49,29,1,10,39
60,Fail,41,36,0,16,25
60,Fail,48,31,0,15,33
60,Fail,39,36,0,17,22
60,Fail,46,33,0,13,33
60,Fail,41,31,10,12,29
60,Fail,50,28,4,10,40
60,Fail,48,29,0,11,37
60,Fail,49,24,2,14,35
60,Fail,49,27,1,15,34
60,Fail,49,26,1,14,35
60,Fail,56,19,3,12,44
60,Fail,43,23,11,13,30
60,Fail,49,20,6,13,36
60,Fail,49,23,3,11,38
60,Fail,56,17,3,12,44
60,Fail,43,25,3,18,25
60,Fail,41,36,1,15,26
60,Fail,45,27,5,14,31
60,Fail,40,35,0,16,24
60,Fail,46,25,0,12,34
60,Fail,52,24,0,14,38
60,Fail,55,28,1,7,48
60,Fail,48,24,3,14,34
60,Fail,49,27,0,12,37
60,Fail,56,21,1,10,46
60,Fail,49,24,11,6,43
60,Fail,49,24,6,13,36
60,Fail,49,25,0,16,33
60,Fail,55,22,0,12,43
60,Fail,47,30,2,9,38
60,Fail,49,30,0,12,37
60,Fail,49,26,0,12,37
60,Fail,49,26,0,16,33
60,Fail,41,30,0,17,24
60,Fail,48,24,0,16,32
60,Fail,45,30,5,10,35
60,Fail,47,26,0,13,34
60,Fail,37,41,0,15,22
60,Fail,45,30,4,15,30
60,Fail,53,27,2,9,44
60,Fail,48,24,0,17,31
60,Fail,50,25,0,13,37
60,Fail,45,27,0,12,33
60,Fail,52,27,0,11,41
60,Fail,49,30,0,11,38
60,Fail,45,33,0,13,32
60,Fail,56,21,0,11,45
60,Fail,43,26,5,13,30
60,Fail,36,39,0,18,18
60,Fail,50,22,2,14,36
60,Fail,49,29,0,13,36
60,Fail,49,28,0,14,35
60,Fail,56,22,3,9,47
60,Fail,54,24,0,10,44
60,Fail,48,32,0,12,36
60,Fail,50,27,0,12,38
60,Fail,49,27,0,13,36
60,Fail,47,26,3,12,35
60,Fail,48,23,4,16,32
60,Fail,46,25,0,20,26
60,Fail,42,28,10,9,33
60,Fail,50,22,1,14,36
60,Fail,56,22,2,8,48
60,Fail,52,20,0,15,37
60,Fail,47,34,0,11,36
60,Fail,42,34,5,10,32
60,Fail,47,20,9,13,34
60,Fail,53,24,4,9,44
60,Fail,42,21,10,15,27
60,Fail,48,25,0,16,32
60,Fail,39,32,10,10,29
60,Fail,46,19,9,18,28
60,Fail,52,22,0,16,36
60,Fail,53,27,0,12,41
60,Fail,57,23,3,7,50
60,Fail,45,34,0,12,33
60,Fail,48,28,3,8,40
60,Fail,48,25,0,12,36
60,Fail,40,24,7,19,21
60,Fail,47,23,3,15,32
60,Fail,49,18,6,17,32
60,Fail,50,20,6,14,36
60,Fail,46,28,9,12,34
60,Fail,52,18,0,17,35
60,Fail,52,27,1,9,43
60,Fail,47,31,3,8,39
60,Fail,46,28,0,12,34
60,Fail,46,22,8,12,34
60,Fail,45,33,0,13,32
60,Fail,54,29,0,7,47
60,Fail,45,22,10,18,27
60,Fail,55,20,0,11,44
60,Fail,49,27,0,13,36
60,Fail,50,23,0,15,35
60,Fail,61,19,2,8,53
60,Fail,53,18,0,13,40
60,Fail,45,24,15,9,36
60,Fail,51,33,0,7,44
60,Fail,39,38,0,15,24
60,Fail,48,24,4,13,35
60,Fail,49,23,8,9,40
60,Fail,56,15,1,13,43
60,Fail,58,12,0,14,44
60,Fail,55,21,2,10,45
60,Fail,40,31,0,19,21
60,Fail,43,30,0,18,25
60,Fail,43,32,0,15,28
60,Fail,58,15,0,17,41
60,Fail,49,31,0,10,39
60,Fail,52,21,7,12,40
60,Fail,53,20,4,13,40
60,Fail,46,37,0,10,36
60,Fail,54,30,0,7,47
60,Fail,52,19,0,20,32
60,Fail,46,25,7,11,35
60,Fail,44,29,0,18,26
60,Fail,52,21,5,10,42
60,Fail,44,34,0,10,34
60,Fail,43,21,4,22,21
60,Fail,52,18,6,10,42
60,Fail,53,20,1,14,39
60,Fail,53,26,0,12,41
60,Fail,54,24,0,11,43
60,Fail,50,34,0,9,41
60,Fail,40,27,8,16,24
60,Fail,48,29,0,14,34
60,Fail,47,31,0,12,35
60,Fail,53,26,4,9,44
60,Fail,48,20,7,13,35
60,Fail,52,22,2,13,39
60,Fail,46,29,3,10,36
60,Fail,41,31,0,16,25
60,Fail,56,16,3,11,45
60,Fail,51,29,0,9,42
60,Fail,44,33,0,11,33
60,Fail,57,22,3,9,48
60,Fail,43,27,11,13,30
60,Fail,43,29,3,15,28
60,Fail,42,29,0,17,25
60,Fail,37,42,0,11,26
60,Fail,46,29,1,15,31
60,Fail,40,26,8,13,27
60,Fail,49,22,0,16,33
60,Fail,45,32,0,14,31
60,Fail,45,37,0,9,36
60,Fail,56,21,3,9,47
60,Fail,49,20,10,13,36
60,Fail,46,20,4,19,27
60,Fail,55,29,0,6,49
60,Fail,45,28,4,8,37
60,Fail,50,25,3,10,40
60,Fail,47,25,0,15,32
60,Fail,40,28,2,17,23
60,Fail,51,17,5,16,35
60,Fail,48,26,0,13,35
60,Fail,45,31,4,8,37
60,Fail,49,27,2,10,39
60,Fail,47,20,6,19,28
60,Fail,52,15,6,18,34
60,Fail,50,20,4,12,38
60,Fail,54,23,0,11,43
60,Fail,52,23,0,11,41
60,Fail,43,29,6,16,27
60,Fail,49,28,0,16,33
60,Fail,53,23,0,10,43
60,Fail,54,24,0,14,40
60,Fail,52,32,0,7,45
60,Fail,47,32,0,9,38
60,Fail,46,30,4,13,33
60,Fail,53,23,7,8,45
60,Fail,49,30,0,11,38
60,Fail,43,29,0,14,29
60,Fail,52,28,0,10,42
60,Fail,48,33,0,8,40
60,Fail,48,34,0,9,39
60,Fail,49,28,2,9,40
60,Fail,50,31,1,7,43
60,Fail,44,30,4,13,31
60,Fail,47,32,0,12,35
60,Fail,46,24,10,9,37
60,Fail,51,24,0,13,38
60,Fail,50,22,0,16,34
60,Fail,48,34,0,11,37
60,Fail,41,36,0,15,26
60,Fail,46,34,0,10,36
60,Fail,49,25,5,10,39
60,Fail,48,26,0,15,33
60,Fail,44,33,0,12,32
60,Fail,54,21,1,8,46
60,Fail,44,28,2,14,30
60,Fail,43,36,0,13,30
60,Fail,48,29,0,12,36
60,Fail,48,27,0,13,35
60,Fail,46,27,0,14,32
60,Fail,49,30,0,11,38
60,Fail,49,24,0,13,36
60,Fail,51,28,0,11,40
60,Fail,46,21,9,17,29
60,Fail,51,26,1,10,41
60,Fail,53,23,0,11,42
60,Fail,47,26,7,12,35
60,Fail,47,23,0,16,31
60,Fail,48,20,2,15,33
60,Fail,43,28,0,19,24
60,Fail,57,20,2,11,46
60,Fail,50,26,8,6,44
60,Fail,44,24,3,17,27
60,Fail,44,26,0,19,25
60,Fail,57,25,0,7,50
60,Fail,51,25,0,11,40
60,Fail,46,25,13,7,39
60,Fail,47,22,0,15,32
60,Fail,50,24,1,14,36
60,Fail,42,38,0,12,30
60,Fail,44,33,0,13,31
60,Fail,52,29,0,8,44
60,Fail,40,35,4,16,24
60,Fail,45,25,0,19,26
60,Fail,39,33,0,16,23
60,Fail,44,34,2,13,31
60,Fail,42,28,0,17,25
60,Fail,49,21,3,14,35
60,Fail,48,21,7,13,35
60,Fail,43,27,4,18,25
60,Fail,44,30,5,13,31
60,Fail,46,30,1,12,34
60,Fail,44,33,0,14,30
60,Fail,55,15,5,11,44
60,Fail,53,24,0,11,42
60,Fail,48,22,4,17,31
60,Fail,46,26,2,17,29
60,Fail,47,24,0,16,31
60,Fail,46,21,2,18,28
60,Fail,41,30,0,17,24
60,Fail,49,25,2,11,38
60,Fail,49,30,0,12,37
60,Fail,40,41,0,15,25
60,Fail,55,21,3,11,44
60,Fail,47,32,0,12,35
60,Fail,45,31,0,15,30
60,Fail,40,39,0,13,27
60,Fail,45,28,0,14,31
60,Fail,45,29,1,12,33
60,Fail,50,26,0,11,39
60,Fail,49,31,0,8,41
60,Fail,43,32,4,11,32
60,Fail,43,33,0,13,30
60,Fail,43,29,0,15,28
60,Fail,49,31,0,8,41
60,Fail,53,21,6,8,45
60,Fail,52,22,7,9,43
60,Fail,45,31,0,14,31
60,Fail,40,35,0,17,23
60,Fail,51,35,0,9,42
60,Fail,46,32,0,14,32
60,Fail,45,32,3,7,38
60,Fail,51,26,1,9,42
60,Fail,55,17,2,15,40
60,Fail,40,37,0,10,30
60,Fail,53,25,0,8,45
60,Fail,48,29,0,13,35
60,Fail,47,29,6,11,36
60,Fail,52,23,1,12,40
60,Fail,39,43,0,12,27
60,Fail,39,30,1,18,21
60,Fail,43,28,0,12,31
60,Fail,43,34,0,14,29
60,Fail,46,30,5,13,33
60,Fail,50,29,0,9,41
60,Fail,51,28,2,12,39
60,Fail,48,26,0,17,31
60,Fail,48,29,0,12,36
60,Fail,50,26,0,10,40
60,Fail,53,22,0,12,41
60,Fail,51,20,5,14,37
60,Fail,54,22,2,9,45
60,Fail,46,27,0,16,30
60,Fail,50,25,8,11,39
60,Fail,43,31,0,18,25
60,Fail,51,26,0,13,38
60,Fail,52,25,3,10,42
60,Fail,52,22,2,10,42
60,Fail,46,32,0,13,33
60,Fail,50,27,0,11,39
60,Fail,44,29,1,11,33
60,Fail,54,24,0,9,45
60,Fail,54,22,0,11,43
60,Fail,46,26,0,19,27
60,Fail,47,22,0,16,31
60,Fail,52,19,1,15,37
60,Fail,41,24,6,16,25
60,Fail,48,33,0,12,36
60,Fail,49,24,7,8,41
60,Fail,49,26,0,15,34
60,Fail,54,17,0,15,39
60,Fail,53,30,0,7,46
60,Fail,44,28,1,17,27
60,Fail,53,20,0,15,38
60,Fail,45,26,3,15,30
60,Fail,48,26,6,11,37
60,Fail,48,26,0,15,33
60,Fail,50,19,10,9,41
60,Fail,44,27,0,15,29
60,Fail,53,20,4,12,41
60,Fail,49,22,6,14,35
60,Fail,46,25,3,15,31
60,Fail,49,24,11,10,39
60,Fail,51,24,0,14,37
60,Fail,45,32,0,12,33
60,Fail,40,33,0,16,24
60,Fail,46,26,6,13,33
60,Fail,42,20,9,20,22
60,Fail,45,26,2,10,35
60,Fail,48,29,0,12,36
60,Fail,42,35,0,10,32
60,Fail,48,28,0,15,33
60,Fail,46,19,7,18,28
60,Fail,54,25,0,6,48
60,Fail,42,33,5,13,29
60,Fail,43,28,10,8,35
60,Fail,50,25,5,9,41
60,Fail,55,24,0,10,45
60,Fail,45,35,5,6,39
60,Fail,46,30,7,7,39
60,Fail,43,30,10,6,37
60,Fail,45,26,0,18,27
60,Fail,50,28,1,10,40
60,Fail,50,28,0,11,39
60,Fail,53,18,0,14,39
60,Fail,52,22,7,7,45
60,Fail,50,33,0,8,42
60,Fail,46,28,0,16,30
60,Fail,52,22,0,13,39
60,Fail,43,32,0,17,26
60,Fail,48,24,0,17,31
60,Fail,45,38,0,10,35
60,Fail,48,26,0,13,35
60,Fail,48,27,0,11,37
60,Fail,40,29,0,18,22
60,Fail,53,23,1,12,41
60,Fail,47,29,0,16,31
60,Fail,51,24,6,10,41
60,Fail,40,33,0,19,21
60,Fail,35,39,5,13,22
60,Fail,53,22,0,16,37
60,Fail,36,43,0,15,21
60,Fail,35,43,0,12,23
60,Fail,41,28,0,19,22
60,Fail,43,34,0,15,28
60,Fail,46,25,6,12,34
60,Fail,53,19,5,13,40
60,Fail,44,24,6,17,27
60,Fail,55,18,3,12,43
60,Fail,40,33,11,11,29
60,Fail,47,29,0,12,35
60,Fail,44,25,5,15,29
60,Fail,44,28,7,15,29
60,Fail,43,39,0,10,33
60,Fail,42,35,0,14,28
60,Fail,52,23,1,15,37
60,Fail,50,16,0,16,34
60,Fail,43,35,5,12,31
60,Fail,46,27,0,11,35
60,Fail,46,22,3,18,28
60,Fail,50,16,6,18,32
60,Fail,50,26,0,11,39
60,Fail,46,27,1,13,33
60,Fail,56,23,0,10,46
60,Fail,43,26,9,12,31
60,Fail,49,22,0,14,35
60,Fail,45,30,1,14,31
60,Fail,62,20,1,5,57
60,Fail,51,29,0,8,43
60,Fail,47,29,0,11,36
60,Fail,50,26,3,8,42
60,Fail,48,30,6,9,39
60,Fail,50,26,5,12,38
60,Fail,45,29,8,12,33
60,Fail,43,21,7,18,25
60,Fail,55,21,0,15,40
60,Fail,48,28,0,14,34
60,Fail,38,30,0,17,21
60,Fail,49,23,1,17,32
60,Fail,45,31,0,14,31
60,Fail,51,29,0,11,40
60,Fail,44,22,5,15,29
60,Fail,47,26,0,15,32
60,Fail,54,22,1,13,41
60,Fail,52,25,0,12,40
60,Fail,48,26,4,12,36
60,Fail,49,28,0,11,38
60,Fail,50,26,0,13,37
60,Fail,47,25,0,15,32
60,Fail,44,31,0,13,31
60,Fail,45,31,0,16,29
60,Fail,46,30,2,14,32
60,Fail,50,29,0,13,37
60,Fail,45,34,0,13,32
60,Fail,51,31,0,9,42
60,Fail,40,32,7,11,29
60,Fail,43,28,0,21,22
60,Fail,46,21,9,14,32
60,Fail,51,17,2,18,33
60,Fail,46,24,0,19,27
60,Fail,54,21,0,8,46
60,Fail,51,23,1,10,41
60,Fail,37,32,7,19,18
60,Fail,53,23,1,11,42
60,Fail,47,33,0,10,37
60,Fail,46,30,0,16,30
60,Fail,40,32,5,14,26
60,Fail,48,26,8,8,40
60,Fail,58,21,1,9,49
60,Fail,48,26,0,16,32
60,Fail,42,37,0,12,30
60,Fail,50,21,2,14,36
60,Fail,55,28,0,9,46
60,Fail,52,22,0,13,39
60,Fail,40,37,0,12,28
60,Fail,48,33,0,14,34
60,Fail,53,19,6,15,38
60,Fail,51,22,7,11,40
60,Fail,52,25,0,15,37
60,Fail,44,28,4,12,32
60,Fail,48,33,0,8,40
60,Fail,41,34,0,17,24
60,Fail,47,26,2,13,34
60,Fail,42,34,1,12,30
60,Fail,44,24,7,15,29
60,Fail,43,25,4,22,21
60,Fail,49,26,3,12,37
60,Fail,46,37,0,10,36
60,Fail,49,32,0,10,39
60,Fail,53,22,0,9,44
60,Fail,48,27,5,12,36
60,Fail,49,32,0,13,36
60,Fail,45,28,0,12,33
60,Fail,50,28,0,11,39
60,Fail,48,27,6,11,37
60,Fail,48,24,4,12,36
60,Fail,45,28,0,16,29
60,Fail,49,27,0,16,33
60,Fail,47,26,2,15,32
60,Fail,52,23,0,12,40
60,Fail,46,26,1,18,28
60,Fail,54,24,0,14,40
60,Fail,49,28,2,10,39
60,Fail,48,25,4,11,37
60,Fail,50,16,0,21,29
60,Fail,50,32,0,11,39
60,Fail,55,28,0,3,52
60,Fail,48,24,0,17,31
60,Fail,52,22,1,13,39
60,Fail,46,27,9,11,35
60,Fail,52,22,0,14,38
60,Fail,49,27,0,12,37
60,Fail,43,30,6,12,31
60,Fail,49,26,3,14,35
60,Fail,45,36,0,14,31
60,Fail,49,28,4,9,40
60,Fail,52,24,0,13,39
60,Fail,45,34,8,6,39
60,Fail,51,25,2,15,36
60,Fail,43,28,4,12,31
60,Fail,44,32,0,16,28
60,Fail,47,25,2,16,31
60,Fail,54,24,0,11,43
60,Fail,48,33,0,14,34
60,Fail,50,25,1,13,37
60,Fail,39,30,1,17,22
60,Fail,47,29,0,10,37
60,Fail,44,26,0,20,24
60,Fail,54,19,0,13,41
60,Fail,44,36,0,11,33
60,Fail,51,28,0,7,44
60,Fail,51,24,4,15,36
60,Fail,57,18,4,10,47
60,Fail,42,31,5,12,30
60,Fail,55,21,0,15,40
60,Fail,49,29,5,8,41
60,Fail,47,30,1,12,35
60,Fail,49,24,6,12,37
60,Fail,46,27,3,10,36
60,Fail,46,34,0,11,35
60,Fail,55,24,0,8,47
60,Fail,52,27,0,11,41
60,Fail,46,25,13,10,36
60,Fail,52,21,1,14,38
60,Fail,46,27,4,12,34
60,Fail,42,36,0,9,33
60,Fail,48,25,4,14,34
60,Fail,52,23,2,13,39
60,Fail,42,38,0,11,31
60,Fail,49,25,3,11,38
60,Fail,48,27,0,11,37
60,Fail,46,33,0,14,32
60,Fail,49,22,8,12,37
60,Fail,51,22,1,13,38
60,Fail,47,26,1,13,34
60,Fail,42,26,6,14,28
60,Fail,41,37,0,11,30
60,Fail,42,27,7,12,30
60,Fail,56,23,0,6,50
60,Fail,48,29,0,10,38
60,Fail,52,26,0,11,41
60,Fail,46,26,0,14,32
60,Fail,49,26,0,12,37
60,Fail,48,24,6,14,34
60,Fail,44,30,1,16,28
60,Fail,40,40,0,15,25
60,Fail,46,33,1,13,33
60,Fail,52,23,3,9,43
60,Fail,54,23,0,12,42
60,Fail,51,23,0,11,40
60,Fail,50,25,1,11,39
60,Fail,41,40,0,12,29
60,Fail,43,40,0,9,34
60,Fail,50,20,1,15,35
60,Fail,47,23,7,17,30
60,Fail,55,26,2,9,46
60,Fail,42,25,0,19,23
60,Fail,41,31,1,15,26
60,Fail,56,12,10,10,46
60,Fail,47,30,0,15,32
60,Fail,45,24,7,11,34
60,Fail,42,30,4,15,27
60,Fail,46,26,0,15,31
60,Fail,50,27,3,10,40
60,Fail,50,31,0,9,41
60,Fail,53,22,10,4,49
60,Fail,43,28,3,15,28
60,Fail,43,28,0,15,28
60,Fail,45,34,4,7,38
60,Fail,43,36,0,10,33
60,Fail,46,27,1,15,31
60,Fail,49,31,0,8,41
60,Fail,50,25,2,12,38
60,Fail,47,28,0,16,31
60,Fail,47,26,0,15,32
60,Fail,52,23,6,9,43
60,Fail,45,27,6,15,30
60,Fail,49,24,3,11,38
60,Fail,44,24,1,18,26
60,Fail,54,27,0,9,45
60,Fail,52,27,0,13,39
60,Fail,40,30,5,13,27
60,Fail,44,31,0,16,28
60,Fail,43,23,2,19,24
60,Fail,47,43,0,3,44
60,Fail,41,29,9,10,31
60,Fail,56,26,0,8,48
60,Fail,51,22,3,13,38
60,Fail,49,24,2,10,39
60,Fail,53,29,0,12,41
60,Fail,49,23,6,10,39
60,Fail,58,16,2,8,50
60,Fail,50,22,0,15,35
60,Fail,48,28,5,10,38
60,Fail,42,37,0,12,30
60,Fail,47,29,9,7,40
60,Fail,55,24,4,8,47
60,Fail,47,32,0,10,37
60,Fail,47,19,4,19,28
60,Fail,44,32,0,12,32
60,Fail,40,34,16,8,32
60,Fail,49,28,0,12,37
60,Fail,48,32,0,11,37
60,Fail,47,29,0,11,36
60,Fail,51,21,2,10,41
60,Fail,45,35,0,10,35
60,Fail,47,25,6,11,36
60,Fail,46,26,0,15,31
60,Fail,49,26,1,14,35
60,Fail,38,39,0,14,24
60,Fail,44,27,2,16,28
60,Fail,51,19,8,12,39
60,Fail,53,27,0,9,44
60,Fail,48,28,9,9,39
60,Fail,45,21,8,15,30
60,Fail,52,24,9,10,42
60,Fail,47,29,0,11,36
60,Fail,52,19,0,19,33
60,Fail,37,33,0,21,16
60,Fail,49,28,4,7,42
60,Fail,43,33,0,15,28
60,Fail,45,31,0,10,35
60,Fail,54,27,0,4,50
60,Fail,52,29,0,9,43
60,Fail,49,26,1,13,36
60,Fail,52,21,0,13,39
60,Fail,49,18,7,14,35
60,Fail,56,18,3,13,43
60,Fail,50,28,0,13,37
60,Fail,55,18,0,11,44
60,Fail,49,31,0,11,38
60,Fail,46,30,0,13,33
60,Fail,52,21,2,12,40
60,Fail,57,19,0,14,43
60,Fail,50,21,5,13,37
60,Fail,55,27,0,7,48
60,Fail,38,28,9,18,20
60,Fail,51,28,0,9,42
60,Fail,41,38,0,11,30
60,Fail,43,26,7,19,24
60,Fail,46,38,0,9,37
60,Fail,43,38,0,13,30
60,Fail,55,24,0,11,44
60,Fail,54,24,0,7,47
60,Fail,45,31,7,8,37
60,Fail,52,19,2,15,37
60,Fail,49,24,4,7,42
60,Fail,42,22,8,19,23
60,Fail,49,37,0,6,43
60,Fail,50,24,1,11,39
60,Fail,53,22,0,14,39
60,Fail,56,22,1,14,42
60,Fail,44,34,0,11,33
60,Fail,45,33,2,7,38
60,Fail,47,30,0,13,34
60,Fail,41,39,0,13,28
60,Fail,53,25,0,9,44
60,Fail,42,32,4,15,27
60,Fail,49,26,3,11,38
60,Fail,46,23,7,13,33
60,Fail,46,28,7,10,36
60,Fail,52,30,0,7,45
60,Fail,51,25,1,7,44
60,Fail,45,25,6,13,32
60,Fail,42,35,1,11,31
60,Fail,47,36,0,10,37
60,Fail,42,36,0,15,27
60,Fail,45,25,0,21,24
60,Fail,51,25,1,10,41
60,Fail,43,29,6,11,32
60,Fail,51,17,7,11,40
60,Fail,55,22,2,10,45
60,Fail,55,23,0,10,45
60,Fail,44,23,6,16,28
60,Fail,44,34,0,12,32
60,Fail,57,23,3,10,47
60,Fail,45,31,1,12,33
60,Fail,51,32,0,6,45
60,Fail,53,20,0,16,37
60,Fail,53,24,0,10,43
60,Fail,53,28,0,10,43
60,Fail,51,18,7,10,41
60,Fail,46,29,0,13,33
60,Fail,47,25,1,17,30
60,Fail,42,35,0,14,28
60,Fail,41,31,8,13,28
60,Fail,48,28,0,11,37
60,Fail,52,29,0,11,41
60,Fail,46,25,0,15,31
60,Fail,48,23,3,15,33
60,Fail,52,25,1,10,42
60,Fail,46,26,1,10,36
60,Fail,46,26,4,12,34
60,Fail,41,28,1,17,24
60,Fail,48,20,0,22,26
60,Fail,48,22,3,16,32
60,Fail,55,20,5,14,41
60,Fail,55,22,3,12,43
60,Fail,52,23,0,13,39
60,Fail,46,31,0,15,31
60,Fail,47,22,0,18,29
60,Fail,49,28,4,9,40
60,Fail,44,39,0,7,37
60,Fail,46,33,1,10,36
60,Fail,44,32,0,12,32
60,Fail,46,29,6,9,37
60,Fail,48,28,8,10,38
60,Fail,54,31,0,7,47
60,Fail,40,26,7,16,24
60,Fail,42,38,0,12,30
60,Fail,60,17,2,10,50
60,Fail,56,20,0,10,46
60,Fail,44,40,0,10,34
60,Fail,47,25,0,17,30
60,Fail,46,23,7,14,32
60,Fail,42,34,5,8,34
60,Fail,47,30,0,10,37
60,Fail,41,33,4,13,28
60,Fail,55,21,2,10,45
60,Fail,53,19,2,12,41
60,Fail,40,34,0,13,27
60,Fail,48,27,0,16,32
60,Fail,48,26,0,14,34
60,Fail,41,25,6,16,25
60,Fail,41,31,0,16,25
60,Fail,45,23,0,18,27
60,Fail,44,23,8,14,30
60,Fail,54,25,0,8,46
60,Fail,49,21,4,11,38
60,Fail,46,30,0,13,33
60,Fail,42,34,0,16,26
60,Fail,43,32,2,13,30
60,Fail,45,35,0,10,35
60,Fail,61,19,0,8,53
60,Fail,54,28,0,8,46
60,Fail,45,30,0,13,32
60,Fail,50,31,0,9,41
60,Fail,52,24,0,12,40
60,Fail,42,33,7,7,35
60,Fail,50,24,0,14,36
60,Fail,46,21,6,19,27
60,Fail,48,31,0,10,38
60,Fail,46,22,10,11,35
60,Fail,51,23,2,13,38
60,Fail,57,23,0,9,48
60,Fail,50,26,0,14,36
60,Fail,56,19,3,10,46
60,Fail,48,23,5,13,35
60,Fail,50,30,0,10,40
60,Fail,49,29,0,8,41
60,Fail,47,23,10,11,36
60,Fail,53,20,2,14,39
60,Fail,44,21,14,16,28
60,Fail,39,29,12,12,27
60,Fail,52,26,0,12,40
60,Fail,52,25,3,10,42
60,Fail,52,23,5,11,41
60,Fail,46,27,1,14,32
60,Fail,45,35,0,13,32
60,Fail,45,26,4,14,31
60,Fail,51,26,0,10,41
60,Fail,43,32,0,17,26
60,Fail,45,28,0,15,30
60,Fail,46,23,1,18,28
60,Fail,42,28,4,13,29
60,Fail,48,22,6,11,37
60,Fail,42,33,2,10,32
60,Fail,45,27,3,13,32
60,Fail,53,25,0,10,43
60,Fail,49,32,0,6,43
60,Fail,48,30,0,13,35
60,Fail,52,23,6,8,44
60,Fail,47,21,0,21,26
60,Fail,51,31,0,11,40
60,Fail,58,24,3,4,54
60,Fail,43,35,0,10,33
60,Fail,41,34,0,13,28
60,Fail,54,25,0,13,41
60,Fail,47,27,3,14,33
60,Fail,51,24,1,9,42
60,Fail,40,37,4,11,29
60,Fail,51,24,8,10,41
60,Fail,46,34,0,13,33
60,Fail,37,33,2,12,25
60,Fail,55,14,6,10,45
60,Fail,54,22,0,13,41
60,Fail,45,35,3,10,35
60,Fail,46,32,0,12,34
60,Fail,57,19,1,10,47
60,Fail,45,40,0,4,41
60,Fail,47,34,0,9,38
60,Fail,50,26,0,10,40
60,Fail,46,25,5,11,35
60,Fail,49,24,0,16,33
60,Fail,51,23,0,12,39
60,Fail,56,25,0,6,50
60,Fail,45,37,0,7,38
60,Fail,50,28,0,7,43
60,Fail,47,22,6,16,31
60,Fail,40,23,6,21,19
60,Fail,44,30,2,11,33
60,Fail,39,33,4,16,23
60,Fail,50,28,0,10,40
60,Fail,45,32,0,12,33
60,Fail,48,22,0,15,33
60,Fail,41,32,0,16,25
60,Fail,48,26,2,12,36
60,Fail,43,39,0,14,29
60,Fail,52,21,0,18,34
60,Fail,53,25,0,14,39
60,Fail,47,23,0,18,29
60,Fail,46,33,0,12,34
60,Fail,43,28,11,14,29
60,Fail,49,29,1,9,40
60,Fail,42,38,0,15,27
60,Fail,53,18,4,15,38
60,Fail,50,23,0,17,33
60,Fail,47,26,4,13,34
60,Fail,45,34,0,12,33
60,Fail,49,31,0,14,35
60,Fail,47,24,4,15,32
60,Fail,52,30,0,5,47
60,Fail,48,23,1,17,31
60,Fail,45,31,2,11,34
60,Fail,48,29,1,9,39
60,Fail,56,20,0,12,44
60,Fail,50,26,0,13,37
60,Fail,56,20,0,12,44
60,Fail,51,25,0,13,38
60,Fail,50,18,0,19,31
60,Fail,52,23,1,13,39
60,Fail,54,27,0,8,46
60,Fail,53,21,6,13,40
60,Fail,49,23,5,14,35
60,Fail,56,26,0,6,50
60,Fail,46,26,0,13,33
60,Fail,47,28,0,14,33
60,Fail,43,32,1,13,30
60,Fail,41,34,0,16,25
60,Fail,52,27,0,8,44
60,Fail,38,36,0,13,25
60,Fail,39,32,5,15,24
60,Fail,48,24,3,11,37
60,Fail,41,32,0,17,24
60,Fail,46,25,4,17,29
60,Fail,53,18,6,12,41
60,Fail,44,26,0,19,25
60,Fail,49,20,2,20,29
60,Fail,43,30,3,11,32
60,Fail,44,42,0,8,36
60,Fail,51,28,0,13,38
60,Fail,50,19,4,16,34
60,Fail,51,31,0,6,45
60,Fail,45,32,0,11,34
60,Fail,43,36,0,15,28
60,Fail,43,35,0,14,29
60,Fail,40,33,3,15,25
60,Fail,46,24,0,19,27
60,Fail,45,27,0,15,30
60,Fail,42,34,0,13,29
60,Fail,45,26,2,15,30
60,Fail,50,32,0,13,37
60,Fail,46,26,3,10,36
60,Fail,49,35,0,10,39
60,Fail,41,33,2,12,29
60,Fail,52,19,5,14,38
60,Fail,48,30,0,11,37
60,Fail,54,26,0,9,45
60,Fail,47,30,5,9,38
60,Fail,47,29,0,12,35
60,Fail,49,33,0,7,42
60,Fail,55,24,2,8,47
60,Fail,54,19,3,13,41
60,Fail,39,29,7,19,20
60,Fail,45,21,11,13,32
60,Fail,53,24,1,11,42
60,Fail,50,28,0,13,37
60,Fail,45,25,6,15,30
60,Fail,53,17,3,15,38
60,Fail,52,22,0,15,37
60,Fail,47,31,0,10,37
60,Fail,49,25,7,12,37
60,Fail,54,28,0,9,45
60,Fail,45,26,0,16,29
60,Fail,48,26,0,20,28
60,Fail,43,37,0,10,33
60,Fail,48,27,0,14,34
60,Fail,51,30,0,8,43
60,Fail,56,24,0,4,52
60,Fail,47,26,3,15,32
60,Fail,50,23,6,13,37
60,Fail,53,23,8,5,48
60,Fail,51,26,0,12,39
60,Fail,45,31,0,18,27
60,Fail,43,31,0,12,31
60,Fail,45,36,0,13,32
60,Fail,49,36,0,8,41
60,Fail,48,27,1,12,36
60,Fail,51,25,0,16,35
60,Fail,49,24,0,16,33
60,Fail,48,21,0,17,31
60,Fail,51,24,1,10,41
60,Fail,41,38,0,12,29
60,Fail,49,23,5,10,39
60,Fail,55,14,0,19,36
60,Fail,47,33,0,15,32
60,Fail,50,25,0,15,35
60,Fail,50,30,0,8,42
60,Fail,57,20,0,9,48
60,Fail,42,32,2,10,32
60,Fail,46,29,1,9,37
60,Fail,51,27,0,9,42
60,Fail,49,30,0,8,41
60,Fail,49,22,5,13,36
60,Fail,46,29,0,11,35
60,Fail,43,33,2,11,32
60,Fail,50,23,2,15,35
60,Fail,36,33,10,11,25
60,Fail,56,14,4,14,42
60,Fail,47,23,5,11,36
60,Fail,50,31,0,10,40
60,Fail,48,29,1,10,38
60,Fail,50,25,0,12,38
60,Fail,52,28,1,7,45
60,Fail,49,22,1,17,32
60,Fail,46,35,0,6,40
60,Fail,43,31,0,16,27
60,Fail,49,20,4,11,38
60,Fail,45,32,0,13,32
60,Fail,59,15,3,14,45
60,Fail,46,28,0,14,32
60,Fail,44,28,3,11,33
60,Fail,42,34,0,16,26
60,Fail,51,30,0,10,41
60,Fail,52,20,7,14,38
60,Fail,42,35,0,13,29
60,Fail,44,23,7,13,31
60,Fail,49,28,0,11,38
60,Fail,44,23,4,19,25
60,Fail,55,30,0,5,50
60,Fail,45,31,0,14,31
60,Fail,49,28,0,15,34
60,Fail,50,22,0,13,37
60,Fail,42,24,4,20,22
60,Fail,42,31,0,15,27
60,Fail,54,26,1,10,44
60,Fail,48,20,10,11,37
60,Fail,39,28,4,19,20
60,Fail,52,28,0,12,40
60,Fail,55,20,0,12,43
60,Fail,50,29,0,12,38
60,Fail,44,28,4,14,30
60,Fail,45,24,4,15,30
60,Fail,48,24,7,9,39
60,Fail,54,19,0,16,38
60,Fail,49,27,0,14,35
60,Fail,42,23,6,17,25
60,Fail,49,20,1,21,28
60,Fail,50,26,0,12,38
60,Fail,42,24,11,15,27
60,Fail,49,19,7,12,37
60,Fail,54,21,1,13,41
60,Fail,43,36,0,10,33
60,Fail,51,30,0,8,43
60,Fail,46,25,8,15,31
60,Fail,50,31,0,11,39
60,Fail,49,26,0,14,35
60,Fail,53,22,4,10,43
60,Fail,56,21,2,11,45
60,Fail,50,28,0,10,40
60,Fail,41,28,1,15,26
60,Fail,43,32,5,12,31
60,Fail,48,31,0,9,39
60,Fail,46,32,0,9,37
60,Fail,47,30,0,9,38
60,Fail,45,23,0,18,27
60,Fail,46,34,0,15,31
60,Fail,41,28,0,19,22
60,Fail,49,27,4,9,40
60,Fail,44,27,7,14,30
60,Fail,51,26,6,9,42
60,Fail,49,29,0,10,39
60,Fail,55,21,3,8,47
60,Fail,52,31,0,8,44
60,Fail,51,32,0,9,42
60,Fail,43,31,0,15,28
60,Fail,45,29,7,6,39
60,Fail,42,24,6,18,24
60,Fail,47,26,7,14,33
60,Fail,44,33,0,13,31
60,Fail,41,29,2,13,28
60,Fail,46,26,2,16,30
60,Fail,53,24,0,12,41
60,Fail,44,27,5,12,32
60,Fail,48,27,0,10,38
60,Fail,50,22,0,16,34
60,Fail,55,24,0,10,45
60,Fail,49,25,1,14,35
60,Fail,51,26,0,9,42
60,Fail,47,25,0,20,27
60,Fail,50,24,0,15,35
60,Fail,45,32,0,14,31
60,Fail,47,32,5,11,36
60,Fail,59,19,0,10,49
60,Fail,48,25,3,14,34
60,Fail,56,22,3,10,46
60,Fail,55,19,2,12,43
60,Fail,50,22,9,11,39
60,Fail,49,21,0,15,34
60,Fail,51,25,3,12,39
60,Fail,57,19,0,12,45
60,Fail,48,24,0,14,34
60,Fail,44,21,7,20,24
60,Fail,55,24,0,10,45
60,Fail,54,21,0,15,39
60,Fail,50,32,0,8,42
60,Fail,54,23,3,13,41
60,Fail,44,32,0,14,30
60,Fail,43,26,0,15,28
60,Fail,44,26,6,15,29
60,Fail,50,24,0,15,35
60,Fail,49,25,0,14,35
60,Fail,49,30,0,13,36
60,Fail,48,30,0,12,36
60,Fail,54,27,1,7,47
60,Fail,46,22,8,16,30
60,Fail,45,26,0,16,29
60,Fail,46,31,0,11,35
60,Fail,43,30,5,15,28
60,Fail,41,33,0,16,25
60,Fail,42,28,0,16,26
60,Fail,49,16,6,16,33
60,Fail,49,27,1,10,39
60,Fail,47,28,0,14,33
60,Fail,48,29,0,11,37
60,Fail,50,27,0,13,37
60,Fail,54,19,2,12,42
60,Fail,51,28,0,10,41
60,Fail,43,39,0,10,33
60,Fail,41,35,5,9,32
60,Fail,47,30,0,12,35
60,Fail,52,29,0,12,40
60,Fail,44,34,3,11,33
60,Fail,45,25,0,18,27
60,Fail,44,35,0,9,35
60,Fail,44,35,0,13,31
60,Fail,54,31,0,8,46
60,Fail,53,24,6,6,47
60,Fail,43,38,0,11,32
60,Fail,45,24,0,19,26
60,Fail,44,34,0,11,33
60,Fail,47,31,0,9,38
60,Fail,49,25,2,16,33
60,Fail,54,33,0,6,48
60,Fail,50,27,0,12,38
60,Fail,53,24,0,14,39
60,Fail,43,34,0,14,29
60,Fail,53,22,3,10,43
60,Fail,44,29,0,21,23
60,Fail,48,31,0,10,38
60,Fail,45,25,6,10,35
60,Fail,45,27,2,14,31
60,Fail,46,28,0,14,32
60,Fail,52,26,0,10,42
60,Fail,46,33,0,10,36
60,Fail,46,28,0,12,34
60,Fail,58,27,0,8,50
60,Fail,58,21,1,10,48
60,Fail,56,20,1,8,48
60,Fail,53,27,0,7,46
60,Fail,49,27,5,6,43
60,Fail,50,26,0,14,36
60,Fail,58,16,0,9,49
60,Fail,56,19,0,12,44
60,Fail,49,22,0,18,31
60,Fail,50,17,6,16,34
60,Fail,43,28,7,11,32
60,Fail,49,29,0,9,40
60,Fail,44,31,4,8,36
60,Fail,45,25,3,18,27
60,Fail,53,22,7,10,43
60,Fail,40,27,7,19,21
60,Fail,45,38,0,9,36
60,Fail,49,21,5,16,33
60,Fail,48,33,0,10,38
60,Fail,52,26,0,14,38
60,Fail,39,29,11,10,29
60,Fail,55,30,0,6,49
60,Fail,52,20,6,9,43
60,Fail,46,27,6,12,34
60,Fail,47,23,5,14,33
60,Fail,45,32,0,14,31
60,Fail,48,27,0,16,32
60,Fail,44,36,0,13,31
60,Fail,46,22,0,18,28
60,Fail,53,22,5,11,42
60,Fail,47,25,2,15,32
60,Fail,50,26,0,14,36
60,Fail,48,24,7,11,37
60,Fail,46,32,0,11,35
60,Fail,49,27,1,12,37
60,Fail,49,33,0,11,38
60,Fail,49,26,0,13,36
60,Fail,49,24,0,15,34
60,Fail,50,19,2,16,34
60,Fail,45,27,0,16,29
60,Fail,51,26,3,11,40
60,Fail,39,27,8,16,23
60,Fail,50,28,0,12,38
60,Fail,45,31,5,12,33
60,Fail,54,29,0,7,47
60,Fail,55,21,0,10,45
60,Fail,45,21,0,24,21
60,Fail,46,27,0,15,31
60,Fail,56,22,0,8,48
60,Fail,50,27,3,10,40
60,Fail,48,22,1,16,32
60,Fail,50,18,1,16,34
60,Fail,47,34,1,8,39
60,Fail,45,30,1,13,32
60,Fail,55,20,7,9,46
60,Fail,41,31,6,18,23
60,Fail,45,32,0,11,34
60,Fail,49,22,6,11,38
60,Fail,47,29,0,17,30
60,Fail,51,25,3,9,42
60,Fail,53,24,1,13,40
60,Fail,49,26,3,10,39
60,Fail,46,25,3,13,33
60,Fail,42,33,0,16,26
60,Fail,50,28,0,12,38
60,Fail,50,22,0,11,39
60,Fail,44,28,4,16,28
60,Fail,51,21,3,15,36
60,Fail,49,33,0,7,42
60,Fail,46,23,0,15,31
60,Fail,49,25,0,12,37
60,Fail,42,32,0,13,29
60,Fail,38,27,7,19,19
60,Fail,47,25,0,18,29
60,Fail,45,28,1,12,33
60,Fail,55,21,0,15,40
60,Fail,50,25,0,10,40
60,Fail,48,27,2,11,37
60,Fail,49,27,0,11,38
60,Fail,47,29,0,13,34
60,Fail,43,36,0,10,33
60,Fail,48,30,2,7,41
60,Fail,40,34,11,8,32
60,Fail,59,15,6,11,48
60,Fail,49,35,4,6,43
60,Fail,56,23,3,9,47
60,Fail,45,23,3,21,24
60,Fail,40,37,0,11,29
60,Fail,51,27,9,6,45
60,Fail,53,18,4,11,42
60,Fail,44,32,0,15,29
60,Fail,54,27,5,3,51
60,Fail,56,24,0,8,48
60,Fail,46,27,4,13,33
60,Fail,54,22,0,9,45
60,Fail,47,32,0,10,37
60,Fail,44,26,0,15,29
60,Fail,47,32,5,7,40
60,Fail,43,28,4,13,30
60,Fail,48,20,3,15,33
60,Fail,44,35,0,15,29
60,Fail,49,19,7,13,36
60,Fail,47,32,3,11,36
60,Fail,47,31,0,13,34
60,Fail,57,22,0,10,47
60,Fail,48,29,0,9,39
60,Fail,43,35,0,13,30
60,Fail,45,39,0,7,38
60,Fail,48,27,3,12,36
60,Fail,47,27,4,10,37
60,Fail,47,30,4,12,35
60,Fail,51,27,0,10,41
60,Fail,49,32,0,10,39
60,Fail,56,20,1,10,46
60,Fail,49,33,0,7,42
60,Fail,47,27,0,15,32
60,Fail,55,29,2,7,48
60,Fail,49,29,1,10,39
60,Fail,41,35,3,11,30
60,Fail,48,24,4,12,36
60,Fail,56,21,4,11,45
60,Fail,48,25,6,10,38
60,Fail,44,20,6,18,26
60,Fail,46,27,6,13,33
60,Fail,48,24,4,10,38
60,Fail,56,21,0,11,45
60,Fail,55,18,2,14,41
60,Fail,44,27,2,15,29
60,Fail,40,41,0,12,28
60,Fail,50,21,7,13,37
60,Fail,44,27,0,20,24
60,Fail,52,28,5,8,44
60,Fail,49,24,5,15,34
60,Fail,45,28,5,12,33
60,Fail,42,31,9,12,30
60,Fail,44,28,0,15,29
60,Fail,51,35,0,2,49
60,Fail,41,30,5,16,25
60,Fail,44,28,5,13,31
60,Fail,45,33,8,9,36
60,Fail,48,19,4,15,33
60,Fail,42,28,7,15,27
60,Fail,51,27,0,9,42
60,Fail,42,27,12,14,28
60,Fail,52,25,2,11,41
60,Fail,57,25,0,9,48
60,Fail,55,22,0,12,43
60,Fail,41,31,5,11,30
60,Fail,51,32,0,9,42
60,Fail,48,29,4,11,37
60,Fail,44,29,0,18,26
60,Fail,52,23,2,10,42
60,Fail,52,19,3,14,38
60,Fail,49,27,0,16,33
60,Fail,48,39,0,6,42
60,Fail,48,30,0,12,36
60,Fail,52,22,1,10,42
60,Fail,48,29,4,12,36
60,Fail,40,23,8,18,22
60,Fail,44,33,0,13,31
60,Fail,51,27,0,11,40
60,Fail,51,16,10,12,39
60,Fail,53,17,2,17,36
60,Fail,48,21,5,17,31
60,Fail,56,22,0,10,46
60,Fail,55,25,0,10,45
60,Fail,54,22,1,11,43
60,Fail,52,25,0,10,42
60,Fail,48,27,0,14,34
60,Fail,46,22,8,11,35
60,Fail,49,27,0,15,34
60,Fail,56,21,0,10,46
60,Fail,52,25,5,10,42
60,Fail,49,31,0,14,35
60,Fail,41,40,0,11,30
60,Fail,46,28,0,17,29
60,Fail,53,19,2,15,38
60,Fail,45,34,0,12,33
60,Fail,43,26,3,18,25
60,Fail,52,27,1,11,41
60,Fail,45,22,0,18,27
60,Fail,49,22,0,16,33
60,Fail,51,23,6,10,41
60,Fail,41,37,0,12,29
60,Fail,43,36,0,13,30
60,Fail,49,23,3,15,34
60,Fail,42,35,2,10,32
60,Fail,44,30,0,20,24
60,Fail,46,28,0,14,32
60,Fail,49,21,10,9,40
60,Fail,42,33,0,15,27
60,Fail,53,29,0,5,48
60,Fail,42,31,0,19,23
60,Fail,52,23,2,15,37
60,Fail,50,24,5,11,39
60,Fail,45,31,5,8,37
60,Fail,46,25,8,13,33
60,Fail,44,28,6,15,29
60,Fail,50,21,0,13,37
60,Fail,49,30,0,15,34
60,Fail,48,24,3,13,35
60,Fail,50,25,4,10,40
60,Fail,51,22,0,12,39
60,Fail,50,22,0,14,36
60,Fail,44,35,0,13,31
60,Fail,48,28,5,11,37
60,Fail,43,34,0,13,30
60,Fail,48,26,0,12,36
60,Fail,47,22,6,14,33
60,Fail,54,26,0,11,43
60,Fail,52,29,0,8,44
60,Fail,44,29,0,17,27
60,Fail,47,26,0,14,33
60,Fail,41,35,1,12,29
60,Fail,45,23,9,16,29
60,Fail,48,24,2,17,31
60,Fail,51,21,5,11,40
60,Fail,48,26,0,16,32
60,Fail,45,33,4,10,35
60,Fail,44,26,7,12,32
60,Fail,42,40,0,12,30
60,Fail,51,26,0,13,38
60,Fail,44,25,6,13,31
60,Fail,52,24,3,9,43
60,Fail,53,21,4,10,43
60,Fail,44,23,9,16,28
60,Fail,40,37,0,16,24
60,Fail,48,27,1,14,34
60,Fail,45,26,11,12,33
60,Fail,56,22,3,9,47
60,Fail,53,20,4,14,39
60,Fail,52,27,0,10,42
60,Fail,48,24,0,16,32
60,Fail,40,29,7,15,25
60,Fail,46,30,0,11,35
60,Fail,63,16,1,12,51
60,Fail,42,30,0,16,26
60,Fail,54,18,8,13,41
60,Fail,51,30,0,9,42
60,Fail,48,28,3,11,37
60,Fail,44,34,0,14,30
60,Fail,49,35,0,5,44
60,Fail,53,28,0,9,44
60,Fail,50,22,3,13,37
60,Fail,49,21,2,13,36
60,Fail,50,32,0,10,40
60,Fail,47,36,0,12,35
60,Fail,49,25,0,19,30
60,Fail,49,19,3,15,34
60,Fail,40,35,0,16,24
60,Fail,53,21,4,12,41
60,Fail,43,25,4,15,28
60,Fail,51,24,0,11,40
60,Fail,48,19,9,11,37
60,Fail,48,30,0,10,38
60,Fail,55,21,0,13,42
60,Fail,45,29,0,15,30
60,Fail,51,20,4,16,35
60,Fail,50,24,1,17,33
60,Fail,51,20,10,11,40
60,Fail,50,23,0,13,37
60,Fail,50,28,1,11,39
60,Fail,47,34,0,8,39
60,Fail,54,25,0,8,46
60,Fail,57,15,8,9,48
60,Fail,56,26,1,8,48
60,Fail,44,29,7,10,34
60,Fail,46,21,4,16,30
60,Fail,39,46,0,11,28
60,Fail,50,24,0,15,35
60,Fail,44,29,0,17,27
60,Fail,48,28,0,12,36
60,Fail,44,28,0,16,28
60,Fail,43,23,8,16,27
60,Fail,52,24,1,13,39
60,Fail,55,20,3,12,43
60,Fail,54,23,1,14,40
60,Fail,44,30,0,16,28
60,Fail,49,25,1,14,35
60,Fail,46,30,0,13,33
60,Fail,49,23,0,16,33
60,Fail,54,26,0,11,43
60,Fail,48,30,6,9,39
60,Fail,52,29,0,5,47
60,Fail,50,27,0,15,35
60,Fail,43,38,0,7,36
60,Fail,48,24,0,15,33
60,Fail,49,32,0,10,39
60,Fail,53,28,0,13,40
60,Fail,47,27,0,13,34
60,Fail,52,29,0,11,41
60,Fail,50,28,0,16,34
60,Fail,51,28,0,9,42
60,Fail,53,23,0,11,42
60,Fail,40,25,7,17,23
60,Fail,46,36,0,10,36
60,Fail,48,26,5,11,37
60,Fail,44,30,0,14,30
60,Fail,45,30,0,17,28
60,Fail,45,21,6,18,27
60,Fail,51,28,0,8,43
60,Fail,44,27,5,10,34
60,Fail,55,20,0,11,44
60,Fail,52,31,0,9,43
60,Fail,47,25,0,16,31
60,Fail,56,18,5,11,45
60,Fail,52,25,5,8,44
60,Fail,43,30,7,9,34
60,Fail,53,23,0,11,42
60,Fail,45,32,7,6,39
60,Fail,45,29,6,9,36
60,Fail,41,29,9,14,27
60,Fail,45,37,0,11,34
60,Fail,40,31,6,13,27
60,Fail,46,32,0,13,33
60,Fail,51,31,0,11,40
60,Fail,51,34,0,6,45
60,Fail,48,22,2,18,30
60,Fail,48,21,8,13,35
60,Fail,40,28,14,11,29
60,Fail,47,23,0,20,27
60,Fail,49,30,2,13,36
60,Fail,48,28,3,11,37
60,Fail,48,26,0,13,35
60,Fail,39,29,10,13,26
60,Fail,43,22,10,21,22
60,Fail,48,31,0,14,34
60,Fail,49,20,0,17,32
60,Fail,46,30,0,16,30
60,Fail,52,25,3,12,40
60,Fail,55,20,0,11,44
60,Fail,46,25,5,13,33
60,Fail,39,25,7,21,18
60,Fail,51,23,6,9,42
60,Fail,40,29,0,19,21
60,Fail,51,21,5,11,40
60,Fail,42,30,0,15,27
60,Fail,55,24,0,9,46
60,Fail,44,32,0,12,32
60,Fail,52,23,0,16,36
60,Fail,46,24,1,21,25
60,Fail,46,20,8,15,31
60,Fail,51,25,0,11,40
60,Fail,42,29,12,9,33
60,Fail,40,42,0,12,28
60,Fail,53,24,0,9,44
60,Fail,50,26,1,10,40
60,Fail,48,28,0,15,33
60,Fail,41,33,3,11,30
60,Fail,47,23,6,15,32
60,Fail,42,29,10,11,31
60,Fail,48,24,0,12,36
60,Fail,52,28,0,9,43
60,Fail,55,23,3,10,45
60,Fail,57,24,0,9,48
60,Fail,52,27,0,8,44
60,Fail,51,20,4,14,37
60,Fail,48,29,2,11,37
60,Fail,46,29,0,11,35
60,Fail,46,25,5,10,36
60,Fail,54,25,1,11,43
60,Fail,47,27,2,13,34
60,Fail,53,23,0,13,40
60,Fail,40,33,5,12,28
60,Fail,56,23,0,13,43
60,Fail,39,29,7,16,23
60,Fail,42,41,0,10,32
60,Fail,37,34,6,15,22
60,Fail,50,26,0,12,38
60,Fail,44,36,0,10,34
60,Fail,57,19,0,14,43
60,Fail,54,24,0,11,43
60,Fail,46,30,0,13,33
60,Fail,50,23,1,12,38
60,Fail,51,25,1,11,40
60,Fail,48,27,0,13,35
60,Fail,59,24,0,8,51
60,Fail,49,21,2,20,29
60,Fail,53,26,0,10,43
60,Fail,49,24,1,13,36
60,Fail,51,23,0,14,37
60,Fail,43,31,0,13,30
60,Fail,37,33,0,21,16
60,Fail,45,20,11,14,31
60,Fail,47,28,0,13,34
60,Fail,48,29,0,10,38
60,Fail,52,29,0,10,42
60,Fail,53,24,0,10,43
60,Fail,51,29,0,9,42
60,Fail,46,25,0,17,29
60,Fail,58,21,0,13,45
60,Fail,51,26,0,14,37
60,Fail,46,28,0,17,29
60,Fail,51,17,4,15,36
60,Fail,44,29,5,12,32
60,Fail,44,33,0,12,32
60,Fail,47,30,0,10,37
60,Fail,50,32,0,7,43
60,Fail,47,34,0,11,36
60,Fail,53,21,0,16,37
60,Fail,52,29,0,7,45
60,Fail,50,27,0,11,39
60,Fail,52,20,4,15,37
60,Fail,42,33,0,13,29
60,Fail,49,23,3,13,36
60,Fail,50,26,2,13,37
60,Fail,45,33,0,12,33
60,Fail,40,30,9,12,28
60,Fail,52,24,0,14,38
60,Fail,50,26,5,9,41
60,Fail,51,25,0,15,36
60,Fail,50,30,0,8,42
60,Fail,48,22,4,17,31
60,Fail,54,18,6,10,44
60,Fail,55,19,1,12,43
60,Fail,50,19,2,14,36
60,Fail,48,30,0,16,32
60,Fail,45,32,0,13,32
60,Fail,51,23,5,9,42
60,Fail,46,29,4,11,35
60,Fail,50,24,0,14,36
60,Fail,37,28,9,16,21
60,Fail,56,26,0,8,48
60,Fail,44,29,8,12,32
60,Fail,41,31,2,15,26
60,Fail,44,30,0,17,27
60,Fail,47,33,0,11,36
60,Fail,45,31,0,12,33
60,Fail,51,27,0,7,44
60,Fail,44,30,4,12,32
60,Fail,45,25,12,12,33
60,Fail,46,23,0,14,32
60,Fail,47,26,0,16,31
60,Fail,52,17,3,15,37
60,Fail,46,28,2,16,30
60,Fail,42,27,9,10,32
60,Fail,45,31,2,11,34
60,Fail,45,25,4,16,29
60,Fail,47,25,3,12,35
60,Fail,43,34,0,11,32
60,Fail,50,20,0,15,35
60,Fail,46,32,8,6,40
60,Fail,51,28,0,12,39
60,Fail,46,29,3,12,34
60,Fail,50,23,2,14,36
60,Fail,45,30,0,13,32
60,Fail,50,22,10,7,43
60,Fail,42,36,0,16,26
60,Fail,45,23,12,13,32
60,Fail,48,21,5,13,35
60,Fail,47,27,0,16,31
60,Fail,49,22,0,17,32
60,Fail,51,33,0,9,42
60,Fail,40,34,0,14,26
60,Fail,43,23,6,20,23
60,Fail,44,35,0,12,32
60,Fail,51,23,0,12,39
60,Fail,53,29,0,10,43
60,Fail,47,28,0,14,33
60,Fail,54,24,0,12,42
60,Fail,42,25,11,14,28
60,Fail,52,22,5,6,46
60,Fail,42,34,0,13,29
60,Fail,46,24,11,8,38
60,Fail,51,23,1,11,40
60,Fail,51,20,17,7,44
60,Fail,43,32,9,9,34
60,Fail,42,33,0,14,28
60,Fail,51,22,6,11,40
60,Fail,42,28,6,16,26
60,Fail,47,32,0,11,36
60,Fail,52,29,2,8,44
60,Fail,49,25,7,11,38
60,Fail,49,30,0,15,34
60,Fail,52,24,0,12,40
60,Fail,48,28,4,13,35
60,Fail,52,28,0,8,44
60,Fail,48,26,5,10,38
60,Fail,47,22,7,16,31
60,Fail,45,25,6,13,32
60,Fail,57,20,2,12,45
60,Fail,45,26,0,18,27
60,Fail,56,17,8,10,46
60,Fail,47,22,0,18,29
60,Fail,45,40,0,10,35
60,Fail,45,26,4,15,30
60,Fail,47,23,4,13,34
60,Fail,45,29,1,14,31
60,Fail,54,21,0,9,45
60,Fail,48,27,1,16,32
60,Fail,42,36,0,16,26
60,Fail,50,27,1,11,39
60,Fail,53,27,3,4,49
60,Fail,56,19,1,13,43
60,Fail,54,15,6,11,43
60,Fail,50,21,1,16,34
60,Fail,44,31,0,17,27
60,Fail,39,38,7,9,30
60,Fail,50,20,0,16,34
60,Fail,43,32,0,16,27
60,Fail,47,24,8,12,35
60,Fail,37,34,1,18,19
60,Fail,41,27,0,16,25
60,Fail,46,29,2,12,34
60,Fail,49,25,6,11,38
60,Fail,47,25,0,18,29
60,Fail,52,28,0,8,44
60,Fail,45,28,2,13,32
60,Fail,50,28,0,10,40
60,Fail,48,29,0,17,31
60,Fail,45,30,0,15,30
60,Fail,57,22,2,7,50
60,Fail,52,19,0,15,37
60,Fail,47,23,3,15,32
60,Fail,53,23,4,10,43
60,Fail,51,24,0,14,37
60,Fail,48,25,6,13,35
60,Fail,49,21,0,16,33
60,Fail,54,29,0,7,47
60,Fail,38,21,16,16,22
60,Fail,45,29,0,16,29
60,Fail,43,29,0,17,26
60,Fail,45,22,4,18,27
60,Fail,52,28,0,7,45
60,Fail,54,23,1,9,45
60,Fail,50,25,0,16,34
60,Fail,46,18,7,15,31
60,Fail,56,22,5,6,50
60,Fail,52,24,0,12,40
60,Fail,55,24,0,8,47
60,Fail,45,29,6,11,34
60,Fail,47,27,8,11,36
60,Fail,50,19,2,17,33
60,Fail,47,28,0,12,35
60,Fail,46,31,0,13,33
60,Fail,48,25,0,13,35
60,Fail,40,34,0,15,25
60,Fail,39,22,9,20,19
60,Fail,55,16,0,13,42
60,Fail,50,27,0,12,38
60,Fail,53,23,0,12,41
60,Fail,48,25,0,15,33
60,Fail,41,31,0,21,20
60,Fail,49,29,0,12,37
60,Fail,59,20,3,8,51
60,Fail,48,29,2,13,35
60,Fail,46,22,0,15,31
60,Fail,52,30,0,8,44
60,Fail,48,28,0,14,34
60,Fail,43,32,5,14,29
60,Fail,50,25,3,10,40
60,Fail,48,26,3,12,36
60,Fail,47,22,6,13,34
60,Fail,41,36,0,11,30
60,Fail,49,25,3,12,37
60,Fail,46,22,2,15,31
60,Fail,46,26,4,13,33
60,Fail,53,21,1,13,40
60,Fail,41,32,0,14,27
60,Fail,37,32,12,14,23
60,Fail,46,31,0,11,35
60,Fail,58,16,0,12,46
60,Fail,42,34,0,15,27
60,Fail,48,23,5,16,32
60,Fail,58,19,1,12,46
60,Fail,43,27,6,14,29
60,Fail,59,17,0,10,49
60,Fail,54,24,4,9,45
60,Fail,54,18,1,15,39
60,Fail,41,24,1,24,17
60,Fail,54,25,0,11,43
60,Fail,50,33,0,6,44
60,Fail,54,28,0,9,45
60,Fail,49,29,0,14,35
60,Fail,45,34,0,12,33
60,Fail,46,31,0,11,35
60,Fail,48,32,0,12,36
60,Fail,47,31,0,10,37
60,Fail,55,23,2,11,44
60,Fail,43,32,0,12,31
60,Fail,53,18,0,16,37
60,Fail,44,34,2,12,32
60,Fail,41,40,0,8,33
60,Fail,50,27,0,13,37
60,Fail,43,28,7,14,29
60,Fail,43,28,13,11,32
60,Fail,43,23,10,14,29
60,Fail,51,25,0,14,37
60,Fail,41,44,0,10,31
60,Fail,47,31,5,9,38
60,Fail,42,27,2,16,26
60,Fail,46,35,0,12,34
60,Fail,60,24,0,9,51
60,Fail,50,34,0,10,40
60,Fail,47,29,6,11,36
60,Fail,39,29,0,22,17
60,Fail,45,28,0,14,31
60,Fail,41,34,0,15,26
60,Fail,48,26,0,16,32
60,Fail,47,36,0,10,37
60,Fail,47,26,0,18,29
60,Fail,57,20,0,16,41
60,Fail,45,29,0,14,31
60,Fail,41,34,0,14,27
60,Fail,50,23,0,19,31
60,Fail,45,34,0,13,32
60,Fail,49,28,0,16,33
60,Fail,47,30,0,11,36
60,Fail,47,25,5,13,34
60,Fail,48,29,0,17,31
60,Fail,51,31,0,12,39
60,Fail,44,34,0,10,34
60,Fail,46,26,3,10,36
60,Fail,53,17,1,17,36
60,Fail,44,32,3,13,31
60,Fail,56,20,6,8,48
60,Fail,48,28,0,15,33
60,Fail,50,29,2,9,41
60,Fail,56,24,0,13,43
60,Fail,57,25,0,8,49
60,Fail,53,20,6,11,42
60,Fail,41,27,1,14,27
60,Fail,50,27,2,10,40
60,Fail,50,24,2,9,41
60,Fail,47,30,0,12,35
60,Fail,50,26,0,15,35
60,Fail,51,28,3,9,42
60,Fail,47,28,0,11,36
60,Fail,42,36,0,14,28
60,Fail,54,26,0,9,45
60,Fail,43,29,9,10,33
60,Fail,43,33,0,13,30
60,Fail,48,29,0,9,39
60,Fail,47,25,0,17,30
60,Fail,46,29,0,17,29
60,Fail,49,35,0,7,42
60,Fail,50,25,0,16,34
60,Fail,49,33,0,11,38
60,Fail,51,22,1,12,39
60,Fail,48,32,0,7,41
60,Fail,57,24,0,9,48
60,Fail,54,27,0,11,43
60,Fail,49,23,4,12,37
60,Fail,48,31,0,11,37
60,Fail,50,23,1,14,36
60,Fail,48,25,0,13,35
60,Fail,45,23,6,17,28
60,Fail,43,34,0,11,32
60,Fail,46,25,4,14,32
60,Fail,48,24,2,15,33
60,Fail,49,27,4,10,39
60,Fail,51,29,0,10,41
60,Fail,45,23,3,16,29
60,Fail,51,28,0,10,41
60,Fail,43,22,12,15,28
60,Fail,44,34,0,14,30
60,Fail,51,29,0,9,42
60,Fail,50,30,0,14,36
60,Fail,51,24,3,10,41
60,Fail,51,23,6,9,42
60,Fail,51,26,0,13,38
60,Fail,48,25,5,9,39
60,Fail,56,19,0,12,44
60,Fail,48,25,9,8,40
60,Fail,52,20,6,13,39
60,Fail,52,18,0,19,33
60,Fail,36,34,4,15,21
60,Fail,47,28,1,12,35
60,Fail,54,22,0,11,43
60,Fail,50,27,0,15,35
60,Fail,48,22,0,18,30
60,Fail,52,24,0,15,37
60,Fail,54,20,0,12,42
60,Fail,51,21,3,11,40
60,Fail,48,24,0,14,34
60,Fail,41,33,0,20,21
60,Fail,49,30,0,13,36
60,Fail,55,29,0,7,48
60,Fail,52,22,0,9,43
60,Fail,48,24,0,12,36
60,Fail,45,27,0,17,28
60,Fail,52,21,0,16,36
60,Fail,46,26,0,19,27
60,Fail,52,23,0,11,41
60,Fail,54,18,0,12,42
60,Fail,43,32,0,14,29
60,Fail,44,34,3,10,34
60,Fail,58,21,1,9,49
60,Fail,43,36,0,12,31
60,Fail,44,30,0,16,28
60,Fail,49,24,6,11,38
60,Fail,46,30,0,12,34
60,Fail,50,28,0,12,38
60,Fail,48,24,5,14,34
60,Fail,45,34,1,9,36
60,Fail,51,24,0,12,39
60,Fail,50,28,0,9,41
60,Fail,55,21,0,9,46
60,Fail,48,25,0,13,35
60,Fail,53,23,0,14,39
60,Fail,46,30,0,12,34
60,Fail,41,28,8,13,28
60,Fail,56,15,0,14,42
60,Fail,55,26,0,10,45
60,Fail,41,27,0,20,21
60,Fail,48,31,0,11,37
60,Fail,51,31,0,9,42
60,Fail,43,36,0,10,33
60,Fail,48,23,2,16,32
60,Fail,53,18,0,19,34
60,Fail,44,37,0,11,33
60,Fail,55,31,0,8,47
60,Fail,49,26,0,11,38
60,Fail,47,30,2,10,37
60,Fail,45,32,0,13,32
60,Fail,45,26,5,13,32
60,Fail,52,28,0,10,42
60,Fail,48,24,0,11,37
60,Fail,48,29,5,10,38
60,Fail,55,22,0,9,46
60,Fail,43,25,8,14,29
60,Fail,52,24,3,10,42
60,Fail,43,22,3,17,26
60,Fail,46,22,5,14,32
60,Fail,47,31,0,9,38
60,Fail,47,31,0,6,41
60,Fail,54,26,0,8,46
60,Fail,44,29,10,12,32
60,Fail,53,22,0,14,39
60,Fail,44,35,0,11,33
60,Fail,48,35,0,9,39
60,Fail,44,32,4,11,33
60,Fail,49,22,0,18,31
60,Fail,49,24,1,15,34
60,Fail,47,29,0,13,34
60,Fail,49,25,0,13,36
60,Fail,47,25,4,13,34
60,Fail,48,29,0,17,31
60,Fail,47,27,1,11,36
60,Fail,45,26,1,16,29
60,Fail,44,42,1,5,39
60,Fail,46,33,0,10,36
60,Fail,38,38,0,17,21
60,Fail,50,29,2,13,37
60,Fail,50,22,3,11,39
60,Fail,50,28,0,10,40
60,Fail,48,17,4,21,27
60,Fail,51,31,0,9,42
60,Fail,57,20,1,11,46
60,Fail,52,18,4,15,37
60,Fail,46,39,0,9,37
60,Fail,47,28,1,9,38
60,Fail,46,27,0,13,33
60,Fail,49,25,5,13,36
60,Fail,43,31,0,12,31
60,Fail,44,32,0,12,32
60,Fail,42,25,6,16,26
60,Fail,44,29,0,19,25
60,Fail,47,29,9,7,40
60,Fail,46,35,0,14,32
60,Fail,54,18,2,14,40
60,Fail,52,24,0,11,41
60,Fail,46,27,0,13,33
60,Fail,42,32,8,11,31
60,Fail,42,27,2,19,23
60,Fail,47,27,0,14,33
60,Fail,45,30,0,14,31
60,Fail,49,29,0,9,40
60,Fail,48,29,0,15,33
60,Fail,50,25,0,13,37
60,Fail,49,23,4,13,36
60,Fail,49,20,2,17,32
60,Fail,47,23,1,10,37
60,Fail,46,23,0,17,29
60,Fail,48,28,0,16,32
60,Fail,50,25,2,13,37
60,Fail,55,19,0,13,42
60,Fail,46,20,0,19,27
60,Fail,41,36,0,12,29
60,Fail,48,30,0,10,38
60,Fail,49,22,11,14,35
60,Fail,49,24,0,17,32
60,Fail,50,25,2,10,40
60,Fail,48,37,0,7,41
60,Fail,36,39,0,16,20
60,Fail,51,20,7,14,37
60,Fail,46,30,3,10,36
60,Fail,51,19,0,18,33
60,Fail,55,26,0,10,45
60,Fail,47,23,1,16,31
60,Fail,52,20,0,17,35
60,Fail,47,20,1,16,31
60,Fail,47,22,7,15,32
60,Fail,49,20,7,14,35
60,Fail,44,30,0,13,31
60,Fail,48,26,2,11,37
60,Fail,47,28,5,13,34
60,Fail,52,23,0,11,41
60,Fail,53,24,0,11,42
60,Fail,52,23,2,11,41
60,Fail,55,25,0,13,42
60,Fail,46,31,2,13,33
60,Fail,50,25,0,12,38
60,Fail,52,27,0,12,40
60,Fail,51,20,3,12,39
60,Fail,49,26,6,12,37
60,Fail,48,26,2,10,38
60,Fail,52,18,3,12,40
60,Fail,46,17,11,16,30
60,Fail,49,17,3,15,34
60,Fail,45,30,0,19,26
60,Fail,51,23,0,15,36
60,Fail,51,19,2,14,37
60,Fail,51,21,0,18,33
60,Fail,48,26,4,11,37
60,Fail,56,17,1,11,45
60,Fail,48,26,0,15,33
60,Fail,48,28,0,12,36
60,Fail,44,26,0,21,23
60,Fail,54,20,0,17,37
60,Fail,48,27,0,16,32
60,Fail,49,25,8,7,42
60,Fail,46,27,2,14,32
60,Fail,44,32,4,9,35
60,Fail,49,25,0,13,36
60,Fail,48,25,3,15,33
60,Fail,46,32,0,11,35
60,Fail,55,19,0,11,44
60,Fail,51,21,5,16,35
60,Fail,49,32,0,9,40
60,Fail,47,30,0,11,36
60,Fail,40,38,0,13,27
60,Fail,46,28,4,13,33
60,Fail,43,37,0,11,32
60,Fail,44,29,3,12,32
60,Fail,42,27,5,15,27
60,Fail,44,28,2,16,28
60,Fail,47,27,0,14,33
60,Fail,51,25,1,13,38
60,Fail,42,35,4,9,33
60,Fail,55,21,5,9,46
60,Fail,48,27,3,11,37
60,Fail,38,35,2,15,23
60,Fail,49,23,5,14,35
60,Fail,51,28,1,9,42
60,Fail,47,26,1,14,33
60,Fail,46,24,0,16,30
60,Fail,51,30,0,10,41
60,Fail,46,21,4,21,25
60,Fail,50,21,9,10,40
60,Fail,52,23,8,8,44
60,Fail,47,25,5,12,35
60,Fail,47,37,0,10,37
60,Fail,42,29,3,14,28
60,Fail,48,29,0,13,35
60,Fail,53,29,0,7,46
60,Fail,53,24,0,16,37
60,Fail,50,24,3,13,37
60,Fail,44,34,0,12,32
60,Fail,53,28,0,10,43
60,Fail,48,22,2,13,35
60,Fail,47,30,4,13,34
60,Fail,45,25,12,11,34
60,Fail,55,21,7,7,48
60,Fail,51,25,2,13,38
60,Fail,46,26,4,13,33
60,Fail,46,30,0,14,32
60,Fail,50,23,0,17,33
60,Fail,38,35,7,11,27
60,Fail,44,34,0,15,29
60,Fail,43,35,0,15,28
60,Fail,44,31,0,17,27
60,Fail,48,29,0,6,42
60,Fail,43,22,10,19,24
60,Fail,54,25,6,6,48
60,Fail,48,24,0,14,34
60,Fail,42,31,3,13,29
60,Fail,49,32,0,7,42
60,Fail,49,24,2,12,37
60,Fail,54,22,0,10,44
60,Fail,53,18,5,11,42
60,Fail,48,32,3,10,38
60,Fail,51,24,6,10,41
60,Fail,46,32,0,9,37
60,Fail,49,25,3,15,34
60,Fail,48,24,6,9,39
60,Fail,45,31,0,15,30
60,Fail,42,33,0,14,28
60,Fail,46,33,0,12,34
60,Fail,48,28,0,14,34
60,Fail,50,31,0,11,39
60,Fail,45,27,6,14,31
60,Fail,57,21,1,11,46
60,Fail,39,42,0,12,27
60,Fail,49,18,0,19,30
60,Fail,49,26,0,12,37
60,Fail,44,32,0,14,30
60,Fail,53,23,0,9,44
60,Fail,47,29,0,13,34
60,Fail,44,25,6,12,32
60,Fail,52,23,1,15,37
60,Fail,43,42,0,10,33
60,Fail,48,28,0,13,35
60,Fail,49,27,2,10,39
60,Fail,48,32,0,12,36
60,Fail,43,28,5,13,30
60,Fail,59,23,0,8,51
60,Fail,52,24,1,12,40
60,Fail,58,22,0,8,50
60,Fail,47,26,0,18,29
60,Fail,43,38,0,12,31
60,Fail,49,28,0,11,38
60,Fail,51,18,6,13,38
60,Fail,41,39,0,12,29
60,Fail,42,23,6,19,23
60,Fail,44,30,0,14,30
60,Fail,48,25,0,16,32
60,Fail,48,22,4,14,34
60,Fail,38,38,0,15,23
60,Fail,48,33,0,14,34
60,Fail,52,28,0,12,40
60,Fail,41,28,8,12,29
60,Fail,46,18,0,19,27
60,Fail,47,27,5,11,36
60,Fail,46,20,12,9,37
60,Fail,46,34,0,11,35
60,Fail,50,29,0,10,40
60,Fail,48,25,0,14,34
60,Fail,48,28,0,14,34
60,Fail,47,27,1,9,38
60,Fail,41,38,0,10,31
60,Fail,52,22,7,11,41
60,Fail,46,25,3,12,34
60,Fail,49,25,5,10,39
60,Fail,46,25,0,16,30
60,Fail,41,22,4,21,20
60,Fail,51,20,0,15,36
60,Fail,41,26,0,17,24
60,Fail,47,24,3,13,34
60,Fail,47,28,0,12,35
60,Fail,43,37,0,13,30
60,Fail,52,26,0,11,41
60,Fail,45,33,0,11,34
60,Fail,49,33,0,10,39
60,Fail,52,26,1,9,43
60,Fail,44,25,6,15,29
60,Fail,52,27,3,9,43
60,Fail,45,28,8,12,33
60,Fail,41,25,5,19,22
60,Fail,56,27,0,7,49
60,Fail,47,30,7,11,36
60,Fail,40,26,10,14,26
60,Fail,45,39,0,12,33
60,Fail,50,31,0,11,39
60,Fail,57,15,2,12,45
60,Fail,46,30,0,16,30
60,Fail,50,25,0,16,34
60,Fail,55,22,0,13,42
60,Fail,46,31,0,15,31
60,Fail,53,23,0,13,40
60,Fail,54,20,3,11,43
60,Fail,51,26,0,13,38
60,Fail,54,20,3,11,43
60,Fail,47,27,3,13,34
60,Fail,49,22,3,16,33
60,Fail,53,22,1,11,42
60,Fail,44,33,2,12,32
60,Fail,42,31,0,13,29
60,Fail,46,18,5,20,26
60,Fail,54,20,0,13,41
60,Fail,55,24,0,7,48
60,Fail,54,29,0,10,44
60,Fail,49,27,1,13,36
60,Fail,49,30,0,11,38
60,Fail,56,21,0,11,45
60,Fail,40,31,9,12,28
60,Fail,46,28,1,14,32
60,Fail,49,26,6,9,40
60,Fail,41,26,3,15,26
60,Fail,55,20,0,11,44
60,Fail,53,23,2,11,42
60,Fail,46,26,7,13,33
60,Fail,51,15,6,16,35
60,Fail,53,17,2,15,38
60,Fail,64,17,1,7,57
60,Fail,43,28,0,16,27
60,Fail,46,37,0,11,35
60,Fail,46,23,8,13,33
60,Fail,50,29,0,15,35
60,Fail,46,24,2,16,30
60,Fail,56,27,0,8,48
60,Fail,44,29,0,12,32
60,Fail,47,35,0,11,36
60,Fail,50,30,0,10,40
60,Fail,53,26,0,9,44
60,Fail,41,32,0,12,29
60,Fail,52,25,5,8,44
60,Fail,45,27,3,12,33
60,Fail,41,31,0,21,20
60,Fail,41,35,0,17,24
60,Fail,39,30,0,18,21
60,Fail,49,23,6,13,36
60,Fail,44,33,0,15,29
60,Fail,48,20,3,16,32
60,Fail,43,39,0,13,30
60,Fail,54,20,0,14,40
60,Fail,43,36,0,12,31
60,Fail,52,20,0,17,35
60,Fail,46,34,0,13,33
60,Fail,47,29,1,15,32
60,Fail,34,40,0,21,13
60,Fail,46,36,0,14,32
60,Fail,42,37,0,15,27
60,Fail,45,26,8,12,33
60,Fail,42,32,0,16,26
60,Fail,48,34,0,10,38
60,Fail,52,30,0,7,45
60,Fail,51,28,0,13,38
60,Fail,53,22,0,13,40
60,Fail,52,31,0,11,41
60,Fail,52,27,0,10,42
60,Fail,51,24,0,11,40
60,Fail,49,28,0,10,39
60,Fail,49,25,6,11,38
60,Fail,46,26,0,17,29
60,Fail,50,33,0,8,42
60,Fail,54,24,1,9,45
60,Fail,45,22,3,17,28
60,Fail,48,28,2,15,33
60,Fail,56,20,0,12,44
60,Fail,47,25,4,12,35
60,Fail,51,31,0,9,42
60,Fail,33,38,0,16,17
60,Fail,45,32,0,13,32
70,Fail,47,24,7,13,34
70,Fail,49,28,0,14,35
70,Fail,48,31,4,10,38
70,Fail,54,21,0,8,46
70,Fail,50,29,0,11,39
70,Fail,54,18,4,8,46
70,Fail,48,26,0,12,36
70,Fail,50,27,0,17,33
70,Fail,45,21,3,17,28
70,Fail,44,25,0,19,25
70,Fail,49,27,3,11,38
70,Fail,49,31,2,9,40
70,Fail,53,24,0,8,45
70,Fail,43,29,0,13,30
70,Fail,51,28,0,11,40
70,Fail,52,26,0,9,43
70,Fail,52,24,0,14,38
70,Fail,44,27,4,16,28
70,Fail,46,34,2,10,36
70,Fail,42,31,3,13,29
70,Fail,55,23,0,8,47
70,Fail,52,26,0,12,40
70,Fail,51,25,0,11,40
70,Fail,44,19,2,23,21
70,Fail,54,22,0,11,43
70,Fail,51,29,0,11,40
70,Fail,50,29,0,12,38
70,Fail,52,27,0,11,41
70,Fail,52,18,0,18,34
70,Fail,44,29,2,13,31
70,Fail,52,19,7,12,40
70,Fail,44,29,0,18,26
70,Fail,45,23,6,16,29
70,Fail,44,26,10,15,29
70,Fail,42,38,0,12,30
70,Fail,43,25,10,11,32
70,Fail,46,24,0,17,29
70,Fail,49,22,4,13,36
70,Fail,49,25,4,12,37
70,Fail,47,31,5,7,40
70,Fail,38,29,6,16,22
70,Fail,51,21,5,12,39
70,Fail,50,26,0,12,38
70,Fail,53,25,2,11,42
70,Fail,49,27,6,11,38
70,Fail,57,21,5,7,50
70,Fail,50,24,0,14,36
70,Fail,42,31,8,10,32
70,Fail,51,22,3,9,42
70,Fail,51,23,0,13,38
70,Fail,48,25,9,14,34
70,Fail,43,32,0,13,30
70,Fail,38,43,0,11,27
70,Fail,45,25,4,11,34
70,Fail,51,30,0,9,42
70,Fail,44,26,8,14,30
70,Fail,53,26,6,8,45
70,Fail,56,24,0,8,48
70,Fail,56,18,2,11,45
70,Fail,55,22,6,6,49
70,Fail,49,27,0,12,37
70,Fail,51,29,0,9,42
70,Fail,47,22,3,16,31
70,Fail,47,24,3,12,35
70,Fail,46,26,1,18,28
70,Fail,43,27,2,17,26
70,Fail,43,25,4,16,27
70,Fail,50,26,0,12,38
70,Fail,32,46,0,15,17
70,Fail,48,30,0,13,35
70,Fail,50,21,8,12,38
70,Fail,45,23,6,15,30
70,Fail,47,24,0,18,29
70,Fail,42,26,8,14,28
70,Fail,48,29,0,9,39
70,Fail,43,27,3,16,27
70,Fail,50,21,4,14,36
70,Fail,48,30,0,12,36
70,Fail,44,37,0,11,33
70,Fail,51,30,0,9,42
70,Fail,49,22,4,14,35
70,Fail,54,24,3,8,46
70,Fail,39,37,5,10,29
70,Fail,48,28,1,12,36
70,Fail,49,19,8,14,35
70,Fail,54,25,0,11,43
70,Fail,50,27,0,14,36
70,Fail,45,27,1,15,30
70,Fail,52,23,2,12,40
70,Fail,54,20,1,12,42
70,Fail,43,30,1,12,31
70,Fail,50,28,0,11,39
70,Fail,42,35,0,14,28
70,Fail,49,29,0,9,40
70,Fail,47,27,0,18,29
70,Fail,44,33,0,14,30
70,Fail,49,29,2,8,41
70,Fail,45,35,0,8,37
70,Fail,52,25,3,11,41
70,Fail,44,26,0,15,29
70,Fail,52,23,0,15,37
70,Fail,52,26,0,13,39
70,Fail,54,21,0,12,42
70,Fail,54,20,7,11,43
70,Fail,40,38,0,15,25
70,Fail,46,31,0,14,32
70,Fail,41,30,2,15,26
70,Fail,50,29,0,8,42
70,Fail,48,34,0,9,39
70,Fail,52,24,0,10,42
70,Fail,44,40,0,7,37
70,Fail,39,39,0,14,25
70,Fail,54,24,4,10,44
70,Fail,52,27,0,8,44
70,Fail,46,30,0,13,33
70,Fail,42,39,0,9,33
70,Fail,45,35,0,8,37
70,Fail,50,29,6,10,40
70,Fail,57,24,0,9,48
70,Fail,50,25,0,12,38
70,Fail,50,31,0,9,41
70,Fail,52,21,2,15,37
70,Fail,47,31,0,11,36
70,Fail,55,24,0,10,45
70,Fail,46,28,4,9,37
70,Fail,43,34,0,14,29
70,Fail,46,29,0,15,31
70,Fail,48,31,0,11,37
70,Fail,41,33,0,17,24
70,Fail,50,24,2,14,36
70,Fail,52,18,3,13,39
70,Fail,45,26,7,13,32
70,Fail,51,26,0,14,37
70,Fail,47,24,7,10,37
70,Fail,52,25,1,10,42
70,Fail,52,20,4,15,37
70,Fail,47,28,0,12,35
70,Fail,53,25,7,7,46
70,Fail,47,30,0,13,34
70,Fail,51,19,7,12,39
70,Fail,46,30,0,14,32
70,Fail,51,24,0,13,38
70,Fail,47,30,1,11,36
70,Fail,42,31,6,10,32
70,Fail,49,25,0,18,31
70,Fail,58,20,3,8,50
70,Fail,48,20,13,11,37
70,Fail,57,24,0,9,48
70,Fail,46,27,4,12,34
70,Fail,48,26,0,13,35
70,Fail,47,23,1,18,29
70,Fail,53,19,0,19,34
70,Fail,53,16,2,18,35
70,Fail,45,21,2,18,27
70,Fail,43,27,6,17,26
70,Fail,50,25,0,14,36
70,Fail,47,24,0,17,30
70,Fail,50,30,0,8,42
70,Fail,49,22,0,14,35
70,Fail,49,30,0,9,40
70,Fail,57,17,0,15,42
70,Fail,47,27,2,12,35
70,Fail,45,19,11,11,34
70,Fail,48,32,1,11,37
70,Fail,51,24,0,17,34
70,Fail,37,37,0,17,20
70,Fail,48,17,5,16,32
70,Fail,46,25,1,14,32
70,Fail,52,27,0,13,39
70,Fail,44,41,0,9,35
70,Fail,47,23,5,16,31
70,Fail,52,28,0,10,42
70,Fail,53,22,0,11,42
70,Fail,49,21,3,14,35
70,Fail,50,26,1,14,36
70,Fail,56,23,0,10,46
70,Fail,42,39,0,17,25
70,Fail,46,37,0,7,39
70,Fail,43,32,0,14,29
70,Fail,43,28,6,12,31
70,Fail,49,27,0,12,37
70,Fail,44,30,4,12,32
70,Fail,45,30,0,15,30
70,Fail,44,31,2,12,32
70,Fail,51,35,0,7,44
70,Fail,45,32,0,12,33
70,Fail,41,35,0,18,23
70,Fail,49,23,3,14,35
70,Fail,50,20,3,16,34
70,Fail,47,30,8,10,37
70,Fail,48,27,4,14,34
70,Fail,45,27,4,16,29
70,Fail,50,27,0,12,38
70,Fail,49,20,5,17,32
70,Fail,48,25,7,13,35
70,Fail,42,27,12,13,29
70,Fail,44,26,6,15,29
70,Fail,43,27,2,15,28
70,Fail,47,25,2,14,33
70,Fail,44,27,0,17,27
70,Fail,44,23,0,22,22
70,Fail,56,22,0,8,48
70,Fail,46,23,7,11,35
70,Fail,45,32,0,14,31
70,Fail,48,34,0,11,37
70,Fail,43,30,6,8,35
70,Fail,48,34,0,11,37
70,Fail,44,29,0,16,28
70,Fail,34,37,9,12,22
70,Fail,44,38,0,7,37
70,Fail,46,21,10,12,34
70,Fail,43,27,0,19,24
70,Fail,49,26,1,15,34
70,Fail,45,31,1,14,31
70,Fail,48,29,2,9,39
70,Fail,54,27,0,10,44
70,Fail,50,31,0,7,43
70,Fail,49,22,0,17,32
70,Fail,53,21,0,16,37
70,Fail,51,32,0,8,43
70,Fail,46,27,0,14,32
70,Fail,47,25,4,12,35
70,Fail,51,25,0,14,37
70,Fail,50,22,0,15,35
70,Fail,49,27,0,14,35
70,Fail,53,26,0,8,45
70,Fail,50,27,2,11,39
70,Fail,52,24,1,13,39
70,Fail,52,21,0,21,31
70,Fail,55,25,0,10,45
70,Fail,43,35,0,13,30
70,Fail,42,25,7,20,22
70,Fail,47,31,1,8,39
70,Fail,47,28,0,16,31
70,Fail,45,31,5,11,34
70,Fail,42,35,0,14,28
70,Fail,43,32,5,10,33
70,Fail,54,19,4,12,42
70,Fail,51,25,3,13,38
70,Fail,46,28,0,16,30
70,Fail,41,36,0,17,24
70,Fail,52,19,4,11,41
70,Fail,46,36,0,11,35
70,Fail,55,27,2,7,48
70,Fail,57,20,1,7,50
70,Fail,52,31,0,8,44
70,Fail,44,33,0,9,35
70,Fail,45,30,0,13,32
70,Fail,47,26,4,11,36
70,Fail,40,21,6,22,18
70,Fail,50,25,6,10,40
70,Fail,49,26,1,10,39
70,Fail,53,26,0,8,45
70,Fail,44,28,0,20,24
70,Fail,46,31,0,12,34
70,Fail,55,22,1,12,43
70,Fail,45,28,0,12,33
70,Fail,48,19,7,15,33
70,Fail,51,22,1,15,36
70,Fail,53,23,3,16,37
70,Fail,43,25,0,20,23
70,Fail,52,20,1,16,36
70,Fail,55,24,0,12,43
70,Fail,40,37,0,12,28
70,Fail,47,26,1,14,33
70,Fail,54,26,5,8,46
70,Fail,50,31,0,9,41
70,Fail,44,27,0,18,26
70,Fail,50,21,7,14,36
70,Fail,49,22,9,16,33
70,Fail,46,27,0,17,29
70,Fail,47,28,3,14,33
70,Fail,44,28,0,19,25
70,Fail,42,25,9,16,26
70,Fail,43,35,0,14,29
70,Fail,40,38,4,8,32
70,Fail,44,30,0,12,32
70,Fail,44,26,2,13,31
70,Fail,42,30,0,16,26
70,Fail,52,25,0,11,41
70,Fail,51,30,0,11,40
70,Fail,45,25,0,20,25
70,Fail,51,24,5,9,42
70,Fail,45,27,6,13,32
70,Fail,54,21,1,12,42
70,Fail,49,33,0,11,38
70,Fail,51,27,0,10,41
70,Fail,48,23,1,20,28
70,Fail,42,31,9,12,30
70,Fail,45,32,0,14,31
70,Fail,45,33,0,11,34
70,Fail,43,24,3,18,25
70,Fail,49,22,5,16,33
70,Fail,51,25,4,12,39
70,Fail,44,40,0,7,37
70,Fail,49,25,0,12,37
70,Fail,52,25,2,12,40
70,Fail,53,26,0,8,45
70,Fail,47,25,0,16,31
70,Fail,44,29,0,16,28
70,Fail,52,25,0,11,41
70,Fail,48,35,0,9,39
70,Fail,45,35,0,8,37
70,Fail,49,21,0,16,33
70,Fail,49,32,0,9,40
70,Fail,55,24,0,9,46
70,Fail,53,26,2,9,44
70,Fail,47,29,0,14,33
70,Fail,50,29,2,12,38
70,Fail,43,31,0,13,30
70,Fail,45,27,1,12,33
70,Fail,45,29,0,14,31
70,Fail,53,23,1,13,40
70,Fail,60,15,6,8,52
70,Fail,48,26,0,11,37
70,Fail,50,24,3,13,37
70,Fail,51,30,0,11,40
70,Fail,59,24,0,8,51
70,Fail,51,29,7,8,43
70,Fail,44,24,5,13,31
70,Fail,48,37,0,9,39
70,Fail,46,33,0,10,36
70,Fail,46,31,0,13,33
70,Fail,50,20,4,14,36
70,Fail,42,29,1,16,26
70,Fail,47,22,4,13,34
70,Fail,50,27,0,17,33
70,Fail,50,20,0,15,35
70,Fail,40,35,4,11,29
70,Fail,56,18,0,12,44
70,Fail,45,36,0,7,38
70,Fail,51,25,3,12,39
70,Fail,48,29,0,10,38
70,Fail,50,29,0,14,36
70,Fail,48,27,0,12,36
70,Fail,47,24,6,12,35
70,Fail,49,19,9,14,35
70,Fail,49,30,0,7,42
70,Fail,43,29,0,20,23
70,Fail,46,27,2,15,31
70,Fail,52,24,0,10,42
70,Fail,45,34,0,14,31
70,Fail,49,24,2,14,35
70,Fail,42,33,0,16,26
70,Fail,55,20,1,10,45
70,Fail,48,26,8,10,38
70,Fail,44,32,0,14,30
70,Fail,47,38,0,6,41
70,Fail,46,31,0,14,32
70,Fail,35,43,0,15,20
70,Fail,46,32,7,11,35
70,Fail,40,39,0,11,29
70,Fail,40,37,0,13,27
70,Fail,52,24,2,9,43
70,Fail,45,21,7,18,27
70,Fail,49,21,0,18,31
70,Fail,51,27,0,10,41
70,Fail,49,27,5,11,38
70,Fail,51,21,0,14,37
70,Fail,49,17,4,18,31
70,Fail,50,37,0,4,46
70,Fail,44,34,0,13,31
70,Fail,43,29,0,17,26
70,Fail,56,19,0,11,45
70,Fail,47,22,0,17,30
70,Fail,48,33,0,12,36
70,Fail,46,28,0,16,30
70,Fail,43,27,0,18,25
70,Fail,45,34,0,12,33
70,Fail,46,33,0,13,33
70,Fail,49,27,0,11,38
70,Fail,47,28,3,9,38
70,Fail,45,35,0,12,33
70,Fail,48,27,9,11,37
70,Fail,48,27,0,18,30
70,Fail,48,30,0,12,36
70,Fail,48,29,0,13,35
70,Fail,45,29,3,17,28
70,Fail,48,37,0,8,40
70,Fail,53,21,0,10,43
70,Fail,45,31,1,9,36
70,Fail,52,20,1,16,36
70,Fail,45,31,5,12,33
70,Fail,57,21,4,8,49
70,Fail,43,36,0,10,33
70,Fail,53,24,0,10,43
70,Fail,41,28,5,22,19
70,Fail,45,24,1,16,29
70,Fail,43,25,5,15,28
70,Fail,56,22,0,10,46
70,Fail,45,25,0,17,28
70,Fail,54,20,2,11,43
70,Fail,53,26,5,6,47
70,Fail,49,27,0,15,34
70,Fail,47,28,0,13,34
70,Fail,39,30,7,15,24
70,Fail,40,33,0,19,21
70,Fail,43,33,0,15,28
70,Fail,44,29,5,14,30
70,Fail,51,25,0,16,35
70,Fail,50,26,0,9,41
70,Fail,50,25,2,10,40
70,Fail,46,36,0,8,38
70,Fail,44,24,6,15,29
70,Fail,51,22,1,13,38
70,Fail,55,20,0,15,40
70,Fail,51,22,0,12,39
70,Fail,46,33,0,10,36
70,Fail,51,21,0,20,31
70,Fail,40,37,5,10,30
70,Fail,57,21,0,9,48
70,Fail,49,23,0,14,35
70,Fail,47,20,2,16,31
70,Fail,49,27,4,9,40
70,Fail,49,29,4,10,39
70,Fail,48,32,9,8,40
70,Fail,50,27,0,16,34
70,Fail,45,36,0,11,34
70,Fail,41,32,0,12,29
70,Fail,55,25,0,7,48
70,Fail,51,27,1,9,42
70,Fail,48,25,0,16,32
70,Fail,48,31,0,15,33
70,Fail,41,37,0,13,28
70,Fail,51,21,1,13,38
70,Fail,49,27,0,14,35
70,Fail,46,28,0,13,33
70,Fail,42,32,7,11,31
70,Fail,50,29,0,11,39
70,Fail,50,24,1,11,39
70,Fail,47,33,5,7,40
70,Fail,47,27,0,15,32
70,Fail,44,34,0,16,28
70,Fail,50,23,1,15,35
70,Fail,50,29,0,11,39
70,Fail,62,14,2,12,50
70,Fail,43,23,3,19,24
70,Fail,54,24,1,6,48
70,Fail,50,24,2,13,37
70,Fail,59,17,3,11,48
70,Fail,46,31,0,9,37
70,Fail,47,25,0,14,33
70,Fail,50,25,3,8,42
70,Fail,53,23,0,10,43
70,Fail,43,28,0,18,25
70,Fail,55,20,7,9,46
70,Fail,53,24,1,12,41
70,Fail,48,28,5,10,38
70,Fail,52,20,0,14,38
70,Fail,50,21,2,13,37
70,Fail,50,29,0,12,38
70,Fail,45,28,0,18,27
70,Fail,48,28,0,13,35
70,Fail,40,40,0,13,27
70,Fail,48,27,0,14,34
70,Fail,44,23,5,18,26
70,Fail,46,31,1,13,33
70,Fail,50,21,2,16,34
70,Fail,59,20,0,11,48
70,Fail,48,23,4,12,36
70,Fail,48,31,0,11,37
70,Fail,44,26,7,16,28
70,Fail,55,23,0,10,45
70,Fail,43,41,0,11,32
70,Fail,41,26,7,16,25
70,Fail,53,26,0,10,43
70,Fail,48,24,2,14,34
70,Fail,31,39,4,19,12
70,Fail,45,30,0,14,31
70,Fail,50,30,0,11,39
70,Fail,49,23,6,11,38
70,Fail,49,27,0,14,35
70,Fail,49,26,0,13,36
70,Fail,55,20,0,11,44
70,Fail,43,32,0,12,31
70,Fail,53,25,4,11,42
70,Fail,53,21,5,10,43
70,Fail,39,34,0,17,22
70,Fail,47,27,2,12,35
70,Fail,47,25,3,12,35
70,Fail,44,24,12,8,36
70,Fail,51,20,1,13,38
70,Fail,46,23,9,15,31
70,Fail,49,29,1,10,39
70,Fail,46,28,3,10,36
70,Fail,49,27,0,11,38
70,Fail,46,30,0,8,38
70,Fail,56,21,2,10,46
70,Fail,41,29,5,11,30
70,Fail,49,33,0,11,38
70,Fail,51,22,0,15,36
70,Fail,43,25,3,16,27
70,Fail,48,30,1,9,39
70,Fail,49,22,3,15,34
70,Fail,42,26,3,16,26
70,Fail,43,27,1,20,23
70,Fail,44,36,0,10,34
70,Fail,56,20,0,14,42
70,Fail,44,32,8,8,36
70,Fail,39,34,0,18,21
70,Fail,52,24,0,12,40
70,Fail,50,27,1,8,42
70,Fail,46,32,0,13,33
70,Fail,44,29,0,17,27
70,Fail,50,17,7,14,36
70,Fail,43,30,4,11,32
70,Fail,47,26,0,16,31
70,Fail,47,29,0,12,35
70,Fail,45,30,0,12,33
70,Fail,50,35,0,8,42
70,Fail,42,36,0,10,32
70,Fail,41,30,6,14,27
70,Fail,47,32,0,13,34
70,Fail,51,25,0,12,39
70,Fail,51,25,0,13,38
70,Fail,46,26,5,12,34
70,Fail,53,22,0,9,44
70,Fail,49,22,5,13,36
70,Fail,51,25,0,15,36
70,Fail,48,28,5,10,38
70,Fail,50,30,0,14,36
70,Fail,48,36,0,9,39
70,Fail,57,16,2,14,43
70,Fail,50,31,0,10,40
70,Fail,57,22,0,11,46
70,Fail,58,24,1,6,52
70,Fail,39,35,0,14,25
70,Fail,44,29,0,15,29
70,Fail,51,13,4,20,31
70,Fail,41,25,9,18,23
70,Fail,49,32,1,7,42
70,Fail,48,27,0,10,38
70,Fail,58,22,2,7,51
70,Fail,43,24,4,20,23
70,Fail,51,24,1,13,38
70,Fail,49,21,2,19,30
70,Fail,48,24,0,14,34
70,Fail,57,26,0,6,51
70,Fail,41,30,9,12,29
70,Fail,49,25,4,8,41
70,Fail,51,18,5,13,38
70,Fail,47,40,0,9,38
70,Fail,52,24,1,13,39
70,Fail,47,28,5,12,35
70,Fail,47,25,1,15,32
70,Fail,50,23,0,18,32
70,Fail,43,28,4,15,28
70,Fail,39,34,0,18,21
70,Fail,41,33,8,12,29
70,Fail,48,32,0,12,36
70,Fail,43,30,0,15,28
70,Fail,40,33,0,17,23
70,Fail,46,22,5,17,29
70,Fail,46,31,0,13,33
70,Fail,47,27,1,15,32
70,Fail,49,28,0,13,36
70,Fail,55,20,0,11,44
70,Fail,49,27,0,11,38
70,Fail,47,29,0,10,37
70,Fail,52,23,0,14,38
70,Fail,44,27,8,14,30
70,Fail,42,27,0,21,21
70,Fail,53,23,0,14,39
70,Fail,52,30,0,11,41
70,Fail,46,29,4,10,36
70,Fail,43,29,0,17,26
70,Fail,49,31,0,11,38
70,Fail,43,32,0,14,29
70,Fail,42,30,5,15,27
70,Fail,61,16,0,7,54
70,Fail,46,28,11,9,37
70,Fail,41,36,0,14,27
70,Fail,51,24,0,12,39
70,Fail,45,34,0,14,31
70,Fail,51,27,0,12,39
70,Fail,43,30,2,13,30
70,Fail,52,20,1,16,36
70,Fail,46,27,0,14,32
70,Fail,50,21,0,17,33
70,Fail,48,27,0,9,39
70,Fail,47,26,1,10,37
70,Fail,54,23,4,11,43
70,Fail,44,27,2,17,27
70,Fail,54,21,0,11,43
70,Fail,49,24,6,15,34
70,Fail,48,31,1,10,38
70,Fail,53,22,0,15,38
70,Fail,44,38,0,11,33
70,Fail,48,24,0,16,32
70,Fail,49,25,1,12,37
70,Fail,52,25,0,12,40
70,Fail,49,26,0,10,39
70,Fail,47,32,2,6,41
70,Fail,43,31,6,10,33
70,Fail,54,19,2,16,38
70,Fail,48,27,0,12,36
70,Fail,52,25,2,8,44
70,Fail,44,34,0,17,27
70,Fail,45,35,0,11,34
70,Fail,47,32,1,12,35
70,Fail,45,30,0,15,30
70,Fail,51,19,7,13,38
70,Fail,49,23,5,14,35
70,Fail,50,29,4,8,42
70,Fail,46,30,0,13,33
70,Fail,48,22,2,17,31
70,Fail,50,27,4,7,43
70,Fail,53,26,0,6,47
70,Fail,54,27,0,6,48
70,Fail,51,24,0,15,36
70,Fail,55,23,4,8,47
70,Fail,41,33,6,10,31
70,Fail,47,21,8,11,36
70,Fail,47,25,4,13,34
70,Fail,47,30,0,12,35
70,Fail,41,35,0,13,28
70,Fail,46,27,0,12,34
70,Fail,42,35,0,11,31
70,Fail,50,24,4,11,39
70,Fail,48,29,0,13,35
70,Fail,50,28,0,11,39
70,Fail,55,18,3,11,44
70,Fail,45,32,0,16,29
70,Fail,47,20,2,18,29
70,Fail,46,26,0,14,32
70,Fail,51,20,4,14,37
70,Fail,50,25,3,11,39
70,Fail,47,31,0,11,36
70,Fail,48,26,0,12,36
70,Fail,54,26,0,11,43
70,Fail,47,32,0,11,36
70,Fail,49,27,4,8,41
70,Fail,49,32,0,9,40
70,Fail,55,30,0,8,47
70,Fail,51,24,0,15,36
70,Fail,53,22,0,11,42
70,Fail,48,20,8,12,36
70,Fail,52,20,8,14,38
70,Fail,49,32,1,7,42
70,Fail,50,25,0,14,36
70,Fail,55,22,3,11,44
70,Fail,47,31,0,11,36
70,Fail,42,33,0,13,29
70,Fail,49,24,7,10,39
70,Fail,52,22,0,15,37
70,Fail,50,25,0,9,41
70,Fail,50,21,7,16,34
70,Fail,50,23,0,13,37
70,Fail,48,29,0,14,34
70,Fail,43,35,0,12,31
70,Fail,53,26,0,10,43
70,Fail,53,23,1,14,39
70,Fail,48,31,0,10,38
70,Fail,49,31,0,11,38
70,Fail,45,29,7,12,33
70,Fail,46,34,0,11,35
70,Fail,48,27,0,12,36
70,Fail,49,22,8,14,35
70,Fail,57,24,1,7,50
70,Fail,44,24,7,11,33
70,Fail,48,31,4,14,34
70,Fail,52,21,0,16,36
70,Fail,53,23,0,15,38
70,Fail,44,25,9,15,29
70,Fail,41,23,7,19,22
70,Fail,47,27,0,14,33
70,Fail,55,27,0,6,49
70,Fail,49,27,3,10,39
70,Fail,52,22,3,16,36
70,Fail,44,29,3,10,34
70,Fail,48,26,0,16,32
70,Fail,40,29,4,16,24
70,Fail,49,27,0,15,34
70,Fail,51,23,2,15,36
70,Fail,52,21,0,15,37
70,Fail,50,23,0,16,34
70,Fail,47,28,0,12,35
70,Fail,50,31,0,8,42
70,Fail,50,20,5,9,41
70,Fail,49,29,0,13,36
70,Fail,49,32,0,12,37
70,Fail,40,36,0,11,29
70,Fail,44,29,2,13,31
70,Fail,57,17,2,13,44
70,Fail,48,30,0,11,37
70,Fail,47,26,0,14,33
70,Fail,40,29,7,16,24
70,Fail,47,24,5,15,32
70,Fail,44,26,6,12,32
70,Fail,48,21,8,12,36
70,Fail,49,26,0,14,35
70,Fail,50,26,0,11,39
70,Fail,46,26,10,11,35
70,Fail,48,29,0,16,32
70,Fail,44,24,9,14,30
70,Fail,46,37,0,11,35
70,Fail,53,21,0,13,40
70,Fail,52,31,0,5,47
70,Fail,42,25,5,22,20
70,Fail,42,31,0,16,26
70,Fail,46,26,8,11,35
70,Fail,45,22,7,16,29
70,Fail,44,38,0,11,33
70,Fail,53,23,0,10,43
70,Fail,53,21,4,7,46
70,Fail,36,28,8,20,16
70,Fail,49,24,1,11,38
70,Fail,55,26,0,11,44
70,Fail,48,26,0,13,35
70,Fail,43,24,3,20,23
70,Fail,50,21,5,9,41
70,Fail,44,32,3,7,37
70,Fail,53,26,0,5,48
70,Fail,45,28,0,19,26
70,Fail,45,32,0,10,35
70,Fail,49,22,4,16,33
70,Fail,39,44,0,10,29
70,Fail,50,21,7,11,39
70,Fail,42,32,1,16,26
70,Fail,50,26,1,13,37
70,Fail,52,27,2,10,42
70,Fail,52,23,5,9,43
70,Fail,51,24,0,11,40
70,Fail,48,30,4,9,39
70,Fail,46,29,7,8,38
70,Fail,45,28,0,19,26
70,Fail,52,23,0,16,36
70,Fail,52,18,5,15,37
70,Fail,47,38,0,8,39
70,Fail,53,29,0,13,40
70,Fail,51,22,0,14,37
70,Fail,47,35,0,9,38
70,Fail,51,27,0,10,41
70,Fail,51,22,0,19,32
70,Fail,47,26,6,11,36
70,Fail,56,22,0,7,49
70,Fail,53,18,0,11,42
70,Fail,46,29,0,16,30
70,Fail,48,32,2,7,41
70,Fail,47,24,1,18,29
70,Fail,49,23,0,14,35
70,Fail,60,20,3,9,51
70,Fail,57,23,0,9,48
70,Fail,55,20,0,15,40
70,Fail,50,23,0,18,32
70,Fail,52,25,0,12,40
70,Fail,40,38,0,16,24
70,Fail,52,22,4,12,40
70,Fail,49,32,0,11,38
70,Fail,43,28,1,17,26
70,Fail,54,27,0,9,45
70,Fail,50,23,7,11,39
70,Fail,49,21,10,12,37
70,Fail,49,26,5,13,36
70,Fail,53,20,1,11,42
70,Fail,53,19,4,11,42
70,Fail,45,28,0,15,30
70,Fail,54,23,1,7,47
70,Fail,54,30,0,8,46
70,Fail,47,30,4,8,39
70,Fail,49,23,5,14,35
70,Fail,43,27,10,10,33
70,Fail,46,34,2,6,40
70,Fail,52,26,2,7,45
70,Fail,44,30,2,13,31
70,Fail,56,23,1,9,47
70,Fail,47,30,0,14,33
70,Fail,52,23,0,13,39
70,Fail,54,20,1,8,46
70,Fail,52,28,0,9,43
70,Fail,52,25,0,12,40
70,Fail,51,25,0,13,38
70,Fail,51,21,0,18,33
70,Fail,56,19,4,11,45
70,Fail,41,28,0,19,22
70,Fail,50,26,0,18,32
70,Fail,45,26,8,12,33
70,Fail,46,28,0,14,32
70,Fail,48,25,2,13,35
70,Fail,50,22,3,13,37
70,Fail,49,31,5,5,44
70,Fail,45,35,0,10,35
70,Fail,44,24,12,13,31
70,Fail,46,28,0,13,33
70,Fail,47,19,2,17,30
70,Fail,51,24,0,13,38
70,Fail,47,31,0,13,34
70,Fail,52,27,0,7,45
70,Fail,50,25,3,11,39
70,Fail,59,21,2,7,52
70,Fail,52,25,0,13,39
70,Fail,48,22,1,17,31
70,Fail,43,27,4,12,31
70,Fail,46,29,0,14,32
70,Fail,47,28,0,16,31
70,Fail,44,24,6,17,27
70,Fail,44,29,1,15,29
70,Fail,50,23,0,14,36
70,Fail,53,28,0,10,43
70,Fail,53,19,0,10,43
70,Fail,43,30,0,14,29
70,Fail,50,30,0,8,42
70,Fail,46,22,10,15,31
70,Fail,51,27,0,13,38
70,Fail,54,29,0,10,44
70,Fail,47,24,0,17,30
70,Fail,48,23,1,13,35
70,Fail,47,28,0,16,31
70,Fail,56,24,0,11,45
70,Fail,51,26,0,11,40
70,Fail,49,29,0,14,35
70,Fail,56,23,1,11,45
70,Fail,49,19,5,14,35
70,Fail,51,25,3,12,39
70,Fail,56,21,4,10,46
70,Fail,48,27,5,12,36
70,Fail,49,25,0,16,33
70,Fail,51,26,5,11,40
70,Fail,42,38,0,9,33
70,Fail,50,30,0,9,41
70,Fail,48,33,0,11,37
70,Fail,46,27,0,14,32
70,Fail,48,31,0,11,37
70,Fail,48,31,0,10,38
70,Fail,46,32,4,8,38
70,Fail,56,13,12,5,51
70,Fail,51,31,0,4,47
70,Fail,47,30,8,6,41
70,Fail,43,28,3,16,27
70,Fail,46,29,0,17,29
70,Fail,51,36,0,6,45
70,Fail,51,32,0,9,42
70,Fail,47,28,0,15,32
70,Fail,45,22,3,21,24
70,Fail,50,24,0,12,38
70,Fail,51,28,0,12,39
70,Fail,45,36,2,9,36
70,Fail,52,14,3,17,35
70,Fail,54,24,0,12,42
70,Fail,38,24,9,18,20
70,Fail,49,30,0,9,40
70,Fail,44,26,2,15,29
70,Fail,52,21,4,15,37
70,Fail,53,23,0,11,42
70,Fail,49,28,0,15,34
70,Fail,51,30,0,9,42
70,Fail,51,23,0,16,35
70,Fail,49,32,0,8,41
70,Fail,40,43,0,6,34
70,Fail,35,45,0,12,23
70,Fail,50,21,7,10,40
70,Fail,56,24,0,6,50
70,Fail,57,20,0,8,49
70,Fail,49,16,0,17,32
70,Fail,52,18,4,18,34
70,Fail,46,30,3,13,33
70,Fail,46,24,2,18,28
70,Fail,49,21,3,16,33
70,Fail,48,28,0,16,32
70,Fail,56,22,0,11,45
70,Fail,50,27,0,11,39
70,Fail,45,34,0,11,34
70,Fail,52,23,0,10,42
70,Fail,47,29,0,13,34
70,Fail,48,26,0,13,35
70,Fail,51,30,0,10,41
70,Fail,44,26,0,17,27
70,Fail,46,21,10,13,33
70,Fail,45,36,0,12,33
70,Fail,50,23,0,16,34
70,Fail,40,24,8,20,20
70,Fail,51,23,4,10,41
70,Fail,48,25,1,16,32
70,Fail,41,34,0,11,30
70,Fail,50,18,8,14,36
70,Fail,41,27,8,12,29
70,Fail,46,24,6,15,31
70,Fail,51,20,0,16,35
70,Fail,42,36,0,13,29
70,Fail,43,21,12,16,27
70,Fail,48,28,0,10,38
70,Fail,43,26,4,15,28
70,Fail,47,17,2,21,26
70,Fail,50,25,0,14,36
70,Fail,52,22,4,9,43
70,Fail,45,22,6,17,28
70,Fail,49,29,3,10,39
70,Fail,45,37,0,9,36
70,Fail,52,26,1,11,41
70,Fail,43,33,2,8,35
70,Fail,51,30,0,7,44
70,Fail,52,20,4,10,42
70,Fail,48,24,6,11,37
70,Fail,46,28,4,12,34
70,Fail,46,29,8,11,35
70,Fail,55,21,0,14,41
70,Fail,48,29,7,9,39
70,Fail,49,26,1,13,36
70,Fail,48,19,2,17,31
70,Fail,58,22,0,9,49
70,Fail,47,25,4,13,34
70,Fail,51,25,1,11,40
70,Fail,55,23,0,7,48
70,Fail,46,30,12,7,39
70,Fail,43,41,0,12,31
70,Fail,47,26,2,12,35
70,Fail,47,27,4,10,37
70,Fail,44,32,0,13,31
70,Fail,46,36,0,10,36
70,Fail,49,27,0,12,37
70,Fail,47,28,0,11,36
70,Fail,57,22,0,15,42
70,Fail,43,27,0,17,26
70,Fail,45,32,0,13,32
70,Fail,53,23,0,13,40
70,Fail,50,28,0,13,37
70,Fail,50,24,0,8,42
70,Fail,49,20,10,16,33
70,Fail,54,29,0,7,47
70,Fail,55,24,0,11,44
70,Fail,40,34,5,12,28
70,Fail,55,19,0,18,37
70,Fail,51,24,0,15,36
70,Fail,45,27,0,15,30
70,Fail,50,25,6,10,40
70,Fail,47,17,1,23,24
70,Fail,40,33,7,12,28
70,Fail,47,24,8,10,37
70,Fail,52,26,0,11,41
70,Fail,50,27,0,12,38
70,Fail,50,27,2,11,39
70,Fail,43,33,0,15,28
70,Fail,45,22,12,13,32
70,Fail,45,28,3,17,28
70,Fail,50,23,1,15,35
70,Fail,50,29,0,10,40
70,Fail,46,30,2,10,36
70,Fail,50,16,10,14,36
70,Fail,46,30,0,13,33
70,Fail,54,20,0,12,42
70,Fail,53,27,1,11,42
70,Fail,50,21,8,11,39
70,Fail,53,23,0,11,42
70,Fail,55,21,0,12,43
70,Fail,52,19,0,15,37
70,Fail,44,37,0,14,30
70,Fail,46,25,9,12,34
70,Fail,48,17,4,17,31
70,Fail,46,23,1,16,30
70,Fail,50,22,2,15,35
70,Fail,47,30,0,13,34
70,Fail,41,32,0,19,22
70,Fail,49,26,2,14,35
70,Fail,52,22,3,14,38
70,Fail,46,27,6,12,34
70,Fail,50,28,0,11,39
70,Fail,45,22,6,14,31
70,Fail,45,20,11,15,30
70,Fail,54,25,0,10,44
70,Fail,43,45,0,7,36
70,Fail,45,29,2,13,32
70,Fail,45,33,0,12,33
70,Fail,47,31,0,12,35
70,Fail,49,25,0,9,40
70,Fail,48,28,0,15,33
70,Fail,49,22,7,9,40
70,Fail,47,28,2,14,33
70,Fail,51,21,0,16,35
70,Fail,45,25,5,14,31
70,Fail,44,35,0,14,30
70,Fail,48,21,5,12,36
70,Fail,51,37,0,6,45
70,Fail,45,24,0,19,26
70,Fail,45,35,0,12,33
70,Fail,51,25,0,12,39
70,Fail,53,20,0,16,37
70,Fail,43,23,0,20,23
70,Fail,47,27,0,9,38
70,Fail,48,36,0,9,39
70,Fail,49,27,0,13,36
70,Fail,47,30,0,14,33
70,Fail,47,28,0,14,33
70,Fail,49,28,0,13,36
70,Fail,46,31,0,12,34
70,Fail,53,22,1,12,41
70,Fail,47,27,5,12,35
70,Fail,45,22,12,15,30
70,Fail,55,30,0,8,47
70,Fail,52,21,0,16,36
70,Fail,45,30,3,13,32
70,Fail,52,23,0,12,40
70,Fail,56,19,1,14,42
70,Fail,50,24,0,14,36
70,Fail,51,29,0,9,42
70,Fail,45,34,3,8,37
70,Fail,49,31,0,8,41
70,Fail,46,27,0,15,31
70,Fail,56,22,3,9,47
70,Fail,48,34,0,10,38
70,Fail,44,28,5,14,30
70,Fail,54,24,0,10,44
70,Fail,47,28,6,11,36
70,Fail,54,31,0,8,46
70,Fail,41,30,5,13,28
70,Fail,49,23,4,14,35
70,Fail,50,26,0,13,37
70,Fail,50,23,5,13,37
70,Fail,43,34,0,13,30
70,Fail,42,30,3,12,30
70,Fail,49,32,0,12,37
70,Fail,50,26,0,11,39
70,Fail,47,29,4,10,37
70,Fail,50,29,0,8,42
70,Fail,38,33,2,13,25
70,Fail,52,25,1,12,40
70,Fail,50,17,9,15,35
70,Fail,45,27,2,14,31
70,Fail,51,27,2,10,41
70,Fail,43,24,4,20,23
70,Fail,50,30,2,8,42
70,Fail,45,23,8,14,31
70,Fail,55,22,0,11,44
70,Fail,54,25,0,8,46
70,Fail,50,24,0,13,37
70,Fail,51,26,2,9,42
70,Fail,41,33,1,12,29
70,Fail,53,27,0,10,43
70,Fail,53,18,3,14,39
70,Fail,49,26,0,11,38
70,Fail,48,26,0,14,34
70,Fail,42,27,10,11,31
70,Fail,52,27,1,8,44
70,Fail,51,30,0,15,36
70,Fail,38,31,11,13,25
70,Fail,47,28,0,15,32
70,Fail,47,29,0,10,37
70,Fail,54,22,4,10,44
70,Fail,47,34,0,15,32
70,Fail,47,28,4,9,38
70,Fail,49,25,4,13,36
70,Fail,43,38,0,12,31
70,Fail,56,19,4,10,46
70,Fail,43,26,3,18,25
70,Fail,51,18,8,12,39
70,Fail,51,22,3,13,38
70,Fail,45,27,5,13,32
70,Fail,49,23,0,17,32
70,Fail,53,25,0,10,43
70,Fail,51,24,0,13,38
70,Fail,41,32,7,10,31
70,Fail,44,31,0,16,28
70,Fail,49,26,7,6,43
70,Fail,44,35,0,9,35
70,Fail,44,28,0,16,28
70,Fail,56,21,0,7,49
70,Fail,51,21,3,12,39
70,Fail,52,25,6,9,43
70,Fail,47,28,6,10,37
70,Fail,48,33,0,9,39
70,Fail,42,29,9,13,29
70,Fail,45,29,0,13,32
70,Fail,45,30,0,12,33
70,Fail,44,32,0,12,32
70,Fail,52,28,0,7,45
70,Fail,42,22,14,15,27
70,Fail,47,26,0,13,34
70,Fail,50,28,0,13,37
70,Fail,45,24,7,14,31
70,Fail,51,25,0,13,38
70,Fail,49,28,0,14,35
70,Fail,55,26,0,12,43
70,Fail,44,29,5,11,33
70,Fail,53,22,0,8,45
70,Fail,49,36,0,5,44
70,Fail,39,45,0,10,29
70,Fail,52,25,0,13,39
70,Fail,44,33,0,11,33
70,Fail,48,24,0,11,37
70,Fail,43,27,8,13,30
70,Fail,52,28,0,11,41
70,Fail,42,29,5,14,28
70,Fail,51,23,1,10,41
70,Fail,41,29,5,13,28
70,Fail,55,25,0,7,48
70,Fail,47,24,0,17,30
70,Fail,55,23,2,10,45
70,Fail,44,31,0,12,32
70,Fail,42,32,0,16,26
70,Fail,54,19,6,15,39
70,Fail,45,33,0,13,32
70,Fail,49,24,5,11,38
70,Fail,54,18,5,13,41
70,Fail,44,34,0,15,29
70,Fail,51,27,1,11,40
70,Fail,52,31,0,10,42
70,Fail,46,21,3,15,31
70,Fail,45,23,6,14,31
70,Fail,47,25,0,15,32
70,Fail,44,31,0,15,29
70,Fail,48,27,0,16,32
70,Fail,46,30,6,8,38
70,Fail,48,33,0,8,40
70,Fail,51,16,4,16,35
70,Fail,48,23,0,17,31
70,Fail,50,25,0,15,35
70,Fail,37,45,0,13,24
70,Fail,44,32,0,15,29
70,Fail,51,27,0,11,40
70,Fail,52,22,2,13,39
70,Fail,49,29,0,11,38
70,Fail,52,23,3,13,39
70,Fail,39,31,5,17,22
70,Fail,46,24,5,15,31
70,Fail,43,30,5,15,28
70,Fail,50,21,6,15,35
70,Fail,54,25,0,11,43
70,Fail,50,26,2,10,40
70,Fail,49,27,0,11,38
70,Fail,58,17,4,11,47
70,Fail,51,23,0,15,36
70,Fail,57,23,1,6,51
70,Fail,42,41,0,10,32
70,Fail,47,25,1,18,29
70,Fail,46,21,5,15,31
70,Fail,45,30,6,12,33
70,Fail,47,38,0,10,37
70,Fail,50,27,1,13,37
70,Fail,46,28,2,14,32
70,Fail,48,30,0,12,36
70,Fail,42,35,0,16,26
70,Fail,50,32,0,11,39
70,Fail,50,24,5,14,36
70,Fail,59,20,3,7,52
70,Fail,51,20,8,11,40
70,Fail,40,32,5,14,26
70,Fail,50,20,1,13,37
70,Fail,47,24,1,15,32
70,Fail,42,28,1,15,27
70,Fail,50,25,0,12,38
70,Fail,36,35,8,14,22
70,Fail,51,21,8,13,38
70,Fail,48,29,0,12,36
70,Fail,48,26,0,15,33
70,Fail,50,19,4,13,37
70,Fail,38,31,0,21,17
70,Fail,42,22,12,15,27
70,Fail,50,22,8,11,39
70,Fail,49,26,0,13,36
70,Fail,48,24,1,18,30
70,Fail,45,26,6,14,31
70,Fail,50,33,0,7,43
70,Fail,40,28,11,14,26
70,Fail,48,35,0,11,37
70,Fail,50,27,0,14,36
70,Fail,52,25,0,10,42
70,Fail,52,25,0,8,44
70,Fail,48,24,0,17,31
70,Fail,48,21,1,19,29
70,Fail,46,20,1,19,27
70,Fail,50,27,2,10,40
70,Fail,48,32,4,10,38
70,Fail,44,35,0,12,32
70,Fail,52,22,0,11,41
70,Fail,48,32,0,9,39
70,Fail,43,30,0,17,26
70,Fail,47,27,3,13,34
70,Fail,47,26,0,17,30
70,Fail,52,29,0,9,43
70,Fail,38,32,0,15,23
70,Fail,52,19,2,15,37
70,Fail,54,15,6,14,40
70,Fail,44,26,1,20,24
70,Fail,55,17,0,16,39
70,Fail,52,28,0,12,40
70,Fail,50,20,0,17,33
70,Fail,44,32,0,15,29
70,Fail,43,30,10,13,30
70,Fail,57,14,0,15,42
70,Fail,45,33,2,10,35
70,Fail,53,22,0,13,40
70,Fail,38,33,11,13,25
70,Fail,44,36,0,11,33
70,Fail,43,33,0,13,30
70,Fail,58,22,0,10,48
70,Fail,46,27,9,9,37
70,Fail,48,28,2,13,35
70,Fail,49,24,2,12,37
70,Fail,45,31,1,14,31
70,Fail,46,31,0,10,36
70,Fail,51,19,0,17,34
70,Fail,49,22,0,18,31
70,Fail,49,24,1,17,32
70,Fail,48,30,0,11,37
70,Fail,45,26,7,17,28
70,Fail,48,27,1,12,36
70,Fail,45,26,5,16,29
70,Fail,41,33,0,15,26
70,Fail,49,23,5,13,36
70,Fail,43,32,2,11,32
70,Fail,45,30,0,13,32
70,Fail,49,24,3,10,39
70,Fail,47,25,2,11,36
70,Fail,52,27,0,8,44
70,Fail,49,24,7,12,37
70,Fail,45,26,11,14,31
70,Fail,50,28,0,13,37
70,Fail,47,33,0,10,37
70,Fail,48,30,0,11,37
70,Fail,41,33,1,14,27
70,Fail,46,21,2,16,30
70,Fail,48,30,0,9,39
70,Fail,55,21,2,11,44
70,Fail,44,28,4,11,33
70,Fail,44,27,0,18,26
70,Fail,44,30,0,15,29
70,Fail,56,20,0,11,45
70,Fail,48,29,2,10,38
70,Fail,43,29,1,16,27
70,Fail,53,18,7,13,40
70,Fail,48,22,1,14,34
70,Fail,43,30,0,17,26
70,Fail,51,24,9,13,38
70,Fail,47,31,2,11,36
70,Fail,37,32,4,18,19
70,Fail,52,26,0,10,42
70,Fail,39,30,0,17,22
70,Fail,44,29,3,12,32
70,Fail,52,26,0,12,40
70,Fail,52,24,2,12,40
70,Fail,48,25,0,16,32
70,Fail,52,24,0,14,38
70,Fail,46,28,6,11,35
70,Fail,48,29,0,11,37
70,Fail,47,28,0,12,35
70,Fail,51,22,0,11,40
70,Fail,42,33,0,11,31
70,Fail,43,24,1,23,20
70,Fail,43,27,15,9,34
70,Fail,53,24,1,13,40
70,Fail,45,33,0,11,34
70,Fail,42,35,4,11,31
70,Fail,38,33,9,11,27
70,Fail,51,22,6,10,41
70,Fail,43,22,11,16,27
70,Fail,49,27,0,15,34
70,Fail,50,27,2,10,40
70,Fail,44,30,0,17,27
70,Fail,49,24,0,12,37
70,Fail,50,25,6,12,38
70,Fail,47,35,0,8,39
70,Fail,52,26,0,6,46
70,Fail,44,29,6,11,33
70,Fail,56,18,2,17,39
70,Fail,50,23,0,16,34
70,Fail,52,23,9,10,42
70,Fail,44,29,5,11,33
70,Fail,51,27,0,11,40
70,Fail,48,26,5,13,35
70,Fail,37,30,10,16,21
70,Fail,49,14,14,16,33
70,Fail,46,30,4,9,37
70,Fail,51,29,0,10,41
70,Fail,41,31,0,17,24
70,Fail,47,25,2,15,32
70,Fail,45,35,0,12,33
70,Fail,50,23,0,15,35
70,Fail,49,36,0,6,43
70,Fail,50,26,0,12,38
70,Fail,50,30,0,11,39
70,Fail,47,19,6,17,30
70,Fail,48,23,6,15,33
70,Fail,55,25,1,6,49
70,Fail,49,24,1,13,36
70,Fail,50,23,0,15,35
70,Fail,41,31,5,16,25
70,Fail,45,29,3,13,32
70,Fail,52,21,0,17,35
70,Fail,48,26,1,14,34
70,Fail,47,20,9,13,34
70,Fail,47,34,0,11,36
70,Fail,42,24,8,15,27
70,Fail,43,38,0,7,36
70,Fail,63,18,4,8,55
70,Fail,50,33,0,10,40
70,Fail,48,28,4,8,40
70,Fail,46,30,3,11,35
70,Fail,51,28,0,11,40
70,Fail,48,24,0,16,32
70,Fail,51,21,3,13,38
70,Fail,56,19,1,14,42
70,Fail,46,24,0,16,30
70,Fail,48,22,0,14,34
70,Fail,52,23,4,8,44
70,Fail,49,23,0,14,35
70,Fail,36,42,0,17,19
70,Fail,43,33,4,15,28
70,Fail,53,26,2,9,44
70,Fail,51,28,0,8,43
70,Fail,44,23,11,13,31
70,Fail,47,31,1,12,35
70,Fail,45,31,4,10,35
70,Fail,47,31,0,13,34
70,Fail,47,22,0,20,27
70,Fail,54,15,1,18,36
70,Fail,43,29,0,16,27
70,Fail,41,36,0,20,21
70,Fail,40,26,4,22,18
70,Fail,41,34,0,14,27
70,Fail,50,23,4,13,37
70,Fail,47,24,4,14,33
70,Fail,42,24,8,18,24
70,Fail,51,28,0,12,39
70,Fail,49,26,2,9,40
70,Fail,41,32,4,16,25
70,Fail,44,32,4,9,35
70,Fail,42,25,8,17,25
70,Fail,42,31,2,13,29
70,Fail,49,26,5,12,37
70,Fail,43,25,7,15,28
70,Fail,45,24,1,14,31
70,Fail,47,29,0,15,32
70,Fail,45,26,8,11,34
70,Fail,46,32,7,9,37
70,Fail,42,28,0,14,28
70,Fail,49,23,0,14,35
70,Fail,43,27,0,17,26
70,Fail,49,27,6,8,41
70,Fail,49,18,0,20,29
70,Fail,41,38,3,8,33
70,Fail,50,25,1,7,43
70,Fail,52,21,0,14,38
70,Fail,44,28,6,13,31
70,Fail,45,29,0,14,31
70,Fail,50,22,12,9,41
70,Fail,47,25,10,11,36
70,Fail,39,35,0,19,20
70,Fail,50,23,0,12,38
70,Fail,40,45,0,10,30
70,Fail,47,23,8,13,34
70,Fail,41,32,3,15,26
70,Fail,41,37,0,10,31
70,Fail,44,36,0,14,30
70,Fail,48,24,0,15,33
70,Fail,45,33,0,15,30
70,Fail,51,20,5,13,38
70,Fail,44,35,0,12,32
70,Fail,50,30,3,12,38
70,Fail,43,29,3,12,31
70,Fail,49,27,0,14,35
70,Fail,45,33,0,13,32
70,Fail,46,31,0,11,35
70,Fail,55,26,1,8,47
70,Fail,48,30,0,9,39
70,Fail,49,20,8,12,37
70,Fail,46,25,5,15,31
70,Fail,51,23,0,15,36
70,Fail,44,28,6,14,30
70,Fail,53,18,0,13,40
70,Fail,54,17,4,11,43
70,Fail,50,25,0,10,40
70,Fail,40,39,0,11,29
70,Fail,41,26,3,20,21
70,Fail,44,30,0,12,32
70,Fail,49,32,0,10,39
70,Fail,46,26,3,12,34
70,Fail,42,27,7,16,26
70,Fail,52,32,0,10,42
70,Fail,46,33,0,11,35
70,Fail,47,34,0,9,38
70,Fail,54,22,0,16,38
70,Fail,48,28,0,12,36
70,Fail,56,28,0,8,48
70,Fail,42,25,7,15,27
70,Fail,50,23,2,14,36
70,Fail,48,29,0,12,36
70,Fail,43,33,0,15,28
70,Fail,50,26,0,13,37
70,Fail,45,26,0,16,29
70,Fail,52,22,0,11,41
70,Fail,54,25,0,10,44
70,Fail,47,26,6,15,32
70,Fail,39,43,0,11,28
70,Fail,50,29,2,9,41
70,Fail,48,23,0,19,29
70,Fail,47,27,5,13,34
70,Fail,45,30,5,7,38
70,Fail,51,27,1,8,43
70,Fail,50,24,1,16,34
70,Fail,53,26,0,13,40
70,Fail,47,27,2,13,34
70,Fail,53,24,0,12,41
70,Fail,42,23,10,20,22
70,Fail,45,29,0,13,32
70,Fail,57,24,2,4,53
70,Fail,45,32,8,8,37
70,Fail,45,23,7,15,30
70,Fail,43,31,0,17,26
70,Fail,46,34,5,9,37
70,Fail,56,26,0,9,47
70,Fail,46,28,1,12,34
70,Fail,49,25,2,13,36
70,Fail,46,25,0,14,32
70,Fail,47,25,0,13,34
70,Fail,53,27,0,6,47
70,Fail,49,24,0,15,34
70,Fail,37,29,13,14,23
70,Fail,44,36,0,11,33
70,Fail,52,22,0,12,40
70,Fail,54,22,0,7,47
70,Fail,50,27,0,13,37
70,Fail,50,30,3,10,40
70,Fail,42,25,7,14,28
70,Fail,41,25,7,16,25
70,Fail,41,35,0,14,27
70,Fail,46,28,0,13,33
70,Fail,48,30,0,11,37
70,Fail,51,29,0,7,44
70,Fail,46,32,0,13,33
70,Fail,45,31,0,14,31
70,Fail,40,33,0,18,22
70,Fail,46,30,2,10,36
70,Fail,56,28,0,6,50
70,Fail,44,36,0,11,33
70,Fail,50,29,0,11,39
70,Fail,59,22,0,9,50
70,Fail,49,22,1,15,34
70,Fail,45,26,8,16,29
70,Fail,47,28,1,12,35
70,Fail,54,17,0,16,38
70,Fail,54,16,8,12,42
70,Fail,51,28,0,10,41
70,Fail,48,28,5,8,40
70,Fail,40,39,0,14,26
70,Fail,44,39,0,12,32
70,Fail,50,20,0,17,33
70,Fail,50,19,3,18,32
70,Fail,53,18,1,11,42
70,Fail,53,24,0,10,43
70,Fail,54,27,0,6,48
70,Fail,43,27,4,17,26
70,Fail,44,32,0,16,28
70,Fail,48,30,9,8,40
70,Fail,49,26,3,10,39
70,Fail,41,30,0,18,23
70,Fail,51,31,0,8,43
70,Fail,46,34,0,11,35
70,Fail,51,18,6,14,37
70,Fail,56,19,0,10,46
70,Fail,52,23,4,12,40
70,Fail,45,33,0,13,32
70,Fail,53,24,0,9,44
70,Fail,40,38,0,12,28
70,Fail,43,32,0,15,28
70,Fail,46,23,3,14,32
70,Fail,45,29,0,16,29
70,Fail,51,27,0,11,40
70,Fail,47,30,0,12,35
70,Fail,44,32,0,12,32
70,Fail,44,27,7,13,31
70,Fail,45,31,0,9,36
70,Fail,47,30,0,14,33
70,Fail,59,18,0,10,49
70,Fail,54,22,4,7,47
70,Fail,49,29,0,11,38
70,Fail,50,26,3,10,40
70,Fail,41,27,4,21,20
70,Fail,47,26,0,13,34
70,Fail,47,28,0,12,35
70,Fail,53,21,6,10,43
70,Fail,48,26,4,14,34
70,Fail,49,24,1,14,35
70,Fail,47,27,0,15,32
70,Fail,50,29,0,12,38
70,Fail,53,25,0,11,42
70,Fail,47,28,0,11,36
70,Fail,52,23,0,15,37
70,Fail,41,35,0,15,26
70,Fail,46,28,0,13,33
70,Fail,47,25,3,14,33
70,Fail,41,30,0,18,23
70,Fail,54,21,6,10,44
70,Fail,50,34,0,8,42
70,Fail,43,25,10,14,29
70,Fail,57,20,0,13,44
70,Fail,55,22,3,10,45
70,Fail,45,32,0,15,30
70,Fail,47,31,0,9,38
70,Fail,41,36,0,11,30
70,Fail,50,27,0,11,39
70,Fail,55,21,0,10,45
70,Fail,45,30,1,11,34
70,Fail,52,14,2,17,35
70,Fail,52,28,0,8,44
70,Fail,47,30,3,10,37
70,Fail,55,23,0,15,40
70,Fail,53,24,0,12,41
70,Fail,53,20,5,9,44
70,Fail,58,18,2,12,46
70,Fail,44,34,0,12,32
70,Fail,41,39,0,12,29
70,Fail,57,21,0,10,47
70,Fail,57,26,2,6,51
70,Fail,42,36,2,13,29
70,Fail,46,27,4,9,37
70,Fail,50,30,0,10,40
70,Fail,49,23,3,14,35
70,Fail,47,27,0,13,34
70,Fail,45,32,0,9,36
70,Fail,41,38,0,12,29
70,Fail,48,29,2,9,39
70,Fail,42,35,0,15,27
70,Fail,47,27,6,9,38
70,Fail,43,37,0,11,32
70,Fail,52,23,2,10,42
70,Fail,52,26,0,12,40
70,Fail,44,28,0,15,29
70,Fail,45,25,8,15,30
70,Fail,48,31,0,11,37
70,Fail,49,28,0,12,37
70,Fail,47,23,4,14,33
70,Fail,43,35,0,13,30
70,Fail,38,42,0,14,24
70,Fail,48,32,3,8,40
70,Fail,45,32,0,14,31
70,Fail,38,47,0,10,28
70,Fail,50,28,1,9,41
70,Fail,56,18,3,10,46
70,Fail,53,23,0,13,40
70,Fail,48,30,0,13,35
70,Fail,54,26,0,9,45
70,Fail,47,23,4,15,32
70,Fail,47,23,9,13,34
70,Fail,51,27,0,12,39
70,Fail,47,27,0,16,31
70,Fail,49,29,0,11,38
70,Fail,46,31,0,11,35
70,Fail,54,30,0,7,47
70,Fail,45,29,0,14,31
70,Fail,44,30,0,16,28
70,Fail,50,22,4,13,37
70,Fail,38,38,0,14,24
70,Fail,46,25,7,13,33
70,Fail,52,23,3,13,39
70,Fail,42,30,4,14,28
70,Fail,43,29,7,12,31
70,Fail,47,25,2,14,33
70,Fail,42,31,0,14,28
70,Fail,51,21,2,14,37
70,Fail,49,28,4,11,38
70,Fail,50,30,0,12,38
70,Fail,39,42,0,9,30
70,Fail,49,26,0,16,33
70,Fail,51,24,0,17,34
70,Fail,44,32,0,8,36
70,Fail,54,17,1,12,42
70,Fail,46,23,8,12,34
70,Fail,52,23,5,11,41
70,Fail,45,32,0,15,30
70,Fail,45,28,2,15,30
70,Fail,47,29,0,11,36
70,Fail,44,26,12,12,32
70,Fail,51,27,0,14,37
70,Fail,51,26,0,11,40
70,Fail,50,24,1,12,38
70,Fail,48,27,2,11,37
70,Fail,43,23,0,21,22
70,Fail,50,24,2,10,40
70,Fail,49,26,0,13,36
70,Fail,41,40,2,7,34
70,Fail,54,18,0,14,40
70,Fail,45,36,0,10,35
70,Fail,47,24,0,17,30
70,Fail,48,26,4,11,37
70,Fail,43,33,0,15,28
70,Fail,52,29,0,5,47
70,Fail,44,25,10,12,32
70,Fail,60,19,2,6,54
70,Fail,45,27,8,11,34
70,Fail,58,18,0,13,45
70,Fail,36,24,8,21,15
70,Fail,55,31,0,11,44
70,Fail,45,27,4,12,33
70,Fail,50,26,1,10,40
70,Fail,45,26,2,17,28
70,Fail,50,22,6,10,40
70,Fail,39,25,1,19,20
70,Fail,47,26,2,14,33
70,Fail,45,25,0,17,28
70,Fail,50,26,3,9,41
70,Fail,46,25,0,15,31
70,Fail,42,27,5,17,25
70,Fail,51,24,0,13,38
70,Fail,46,30,0,13,33
70,Fail,53,21,0,15,38
70,Fail,49,32,0,6,43
70,Fail,51,20,3,14,37
70,Fail,49,29,0,8,41
70,Fail,52,32,0,8,44
70,Fail,45,28,8,7,38
70,Fail,49,26,0,16,33
70,Fail,56,21,2,12,44
70,Fail,53,25,1,11,42
70,Fail,51,30,0,10,41
70,Fail,38,35,0,17,21
70,Fail,50,26,0,9,41
70,Fail,55,23,3,12,43
70,Fail,51,23,0,18,33
70,Fail,53,28,0,7,46
70,Fail,49,16,2,17,32
70,Fail,58,18,1,14,44
70,Fail,50,16,5,17,33
70,Fail,49,32,4,6,43
70,Fail,51,26,0,14,37
70,Fail,42,30,10,10,32
70,Fail,52,21,2,13,39
70,Fail,45,30,0,8,37
70,Fail,43,22,5,20,23
70,Fail,45,30,0,14,31
70,Fail,53,29,0,9,44
70,Fail,50,27,0,14,36
70,Fail,46,27,0,19,27
70,Fail,56,22,0,9,47
70,Fail,53,23,0,13,40
70,Fail,49,32,5,7,42
70,Fail,49,28,0,13,36
70,Fail,39,33,0,16,23
70,Fail,52,21,7,13,39
70,Fail,51,27,0,11,40
70,Fail,42,32,0,12,30
70,Fail,45,33,0,11,34
70,Fail,47,27,9,9,38
70,Fail,47,30,0,9,38
70,Fail,54,21,2,13,41
70,Fail,50,25,1,11,39
70,Fail,50,25,2,12,38
70,Fail,41,28,0,14,27
70,Fail,48,27,0,14,34
70,Fail,53,18,7,15,38
70,Fail,42,25,5,13,29
70,Fail,45,25,1,13,32
70,Fail,42,26,0,16,26
70,Fail,52,13,5,19,33
70,Fail,47,23,4,12,35
70,Fail,46,26,0,15,31
70,Fail,42,24,6,15,27
70,Fail,54,20,5,14,40
70,Fail,50,25,3,15,35
70,Fail,55,22,0,15,40
70,Fail,43,35,4,8,35
70,Fail,47,31,0,16,31
70,Fail,48,26,0,12,36
70,Fail,52,15,6,17,35
70,Fail,48,23,2,20,28
70,Fail,45,32,0,15,30
70,Fail,48,26,1,11,37
70,Fail,55,24,3,10,45
70,Fail,49,30,0,9,40
70,Fail,50,25,0,7,43
70,Fail,43,28,6,12,31
70,Fail,50,19,0,17,33
70,Fail,50,26,0,12,38
70,Fail,47,22,8,14,33
70,Fail,46,28,0,15,31
70,Fail,51,26,1,14,37
70,Fail,56,22,0,8,48
70,Fail,47,30,0,12,35
70,Fail,48,27,1,14,34
70,Fail,49,33,0,7,42
70,Fail,52,27,0,12,40
70,Fail,44,31,0,15,29
70,Fail,49,23,5,16,33
70,Fail,54,23,0,10,44
70,Fail,51,36,0,9,42
70,Fail,49,29,0,11,38
70,Fail,50,21,3,14,36
70,Fail,51,20,3,11,40
70,Fail,51,31,1,9,42
70,Fail,47,30,0,11,36
70,Fail,55,22,0,12,43
70,Fail,44,33,7,11,33
70,Fail,47,26,0,18,29
70,Fail,53,24,0,12,41
70,Fail,50,18,0,20,30
70,Fail,49,31,0,10,39
70,Fail,43,24,5,18,25
70,Fail,49,32,0,10,39
70,Fail,51,22,0,15,36
70,Fail,51,27,0,11,40
70,Fail,47,27,3,13,34
70,Fail,48,29,1,10,38
70,Fail,51,27,2,9,42
70,Fail,52,22,4,13,39
70,Fail,48,40,0,4,44
70,Fail,48,28,2,14,34
70,Fail,52,29,0,12,40
70,Fail,49,26,0,14,35
70,Fail,50,25,0,9,41
70,Fail,44,27,0,16,28
70,Fail,53,18,3,16,37
70,Fail,47,20,6,15,32
70,Fail,47,26,0,13,34
70,Fail,53,21,0,13,40
70,Fail,48,21,1,18,30
70,Fail,56,21,0,10,46
70,Fail,46,28,9,10,36
70,Fail,48,26,3,7,41
70,Fail,50,26,0,14,36
70,Fail,42,40,0,8,34
70,Fail,53,28,0,11,42
70,Fail,52,22,0,14,38
70,Fail,50,28,0,13,37
70,Fail,49,28,0,14,35
70,Fail,47,21,0,16,31
70,Fail,43,27,2,16,27
70,Fail,43,34,6,9,34
70,Fail,45,27,1,15,30
70,Fail,47,31,0,13,34
70,Fail,43,35,0,12,31
70,Fail,49,31,0,11,38
70,Fail,51,22,2,12,39
70,Fail,51,23,1,11,40
70,Fail,48,24,2,13,35
70,Fail,59,18,2,10,49
70,Fail,52,21,4,11,41
70,Fail,42,27,3,20,22
70,Fail,43,20,6,20,23
70,Fail,53,30,0,8,45
70,Fail,54,26,0,9,45
70,Fail,44,28,0,19,25
70,Fail,59,20,2,11,48
70,Fail,44,34,0,13,31
70,Fail,50,29,0,13,37
70,Fail,46,30,2,11,35
70,Fail,52,24,1,13,39
70,Fail,49,28,1,12,37
70,Fail,51,21,0,17,34
70,Fail,51,27,0,10,41
70,Fail,49,30,0,10,39
70,Fail,47,31,0,12,35
70,Fail,46,25,4,16,30
70,Fail,45,21,2,15,30
70,Fail,42,24,7,21,21
70,Fail,44,36,0,10,34
70,Fail,49,25,0,16,33
70,Fail,53,22,0,15,38
70,Fail,49,22,0,16,33
70,Fail,49,30,0,10,39
70,Fail,56,27,0,10,46
70,Fail,47,26,3,9,38
70,Fail,52,22,4,12,40
70,Fail,51,26,0,15,36
70,Fail,50,28,6,5,45
70,Fail,55,26,0,9,46
70,Fail,41,38,0,11,30
70,Fail,49,24,1,15,34
70,Fail,45,25,8,12,33
70,Fail,44,22,7,16,28
70,Fail,50,23,0,15,35
70,Fail,45,20,11,15,30
70,Fail,50,29,0,12,38
70,Fail,43,29,0,19,24
70,Fail,55,26,0,8,47
70,Fail,52,25,2,12,40
70,Fail,49,29,0,15,34
70,Fail,45,25,12,9,36
70,Fail,49,31,0,10,39
70,Fail,43,30,4,12,31
70,Fail,51,26,0,9,42
70,Fail,47,29,1,10,37
70,Fail,45,25,3,14,31
70,Fail,42,39,1,11,31
70,Fail,49,33,1,6,43
70,Fail,49,23,1,16,33
70,Fail,47,27,0,17,30
70,Fail,45,23,8,14,31
70,Fail,44,29,2,10,34
70,Fail,57,24,0,9,48
70,Fail,44,22,10,15,29
70,Fail,56,24,0,9,47
70,Fail,47,24,1,19,28
70,Fail,50,29,0,11,39
70,Fail,48,27,1,15,33
70,Fail,51,25,2,8,43
70,Fail,46,29,0,15,31
70,Fail,47,20,8,15,32
70,Fail,52,22,0,16,36
70,Fail,50,21,4,11,39
70,Fail,45,32,0,12,33
70,Fail,41,20,5,24,17
70,Fail,49,23,0,13,36
70,Fail,37,36,6,15,22
70,Fail,53,21,0,11,42
70,Fail,48,23,0,15,33
70,Fail,49,26,0,12,37
70,Fail,51,22,2,14,37
70,Fail,48,35,0,10,38
70,Fail,45,35,0,11,34
70,Fail,47,30,0,11,36
70,Fail,50,27,0,11,39
70,Fail,49,33,0,8,41
70,Fail,49,24,5,12,37
70,Fail,44,31,0,17,27
70,Fail,49,27,5,10,39
70,Fail,53,21,0,13,40
70,Fail,43,32,0,14,29
70,Fail,50,22,1,17,33
70,Fail,45,26,0,19,26
70,Fail,53,29,0,6,47
70,Fail,44,23,8,17,27
70,Fail,38,35,0,12,26
70,Fail,51,28,9,8,43
70,Fail,50,27,4,11,39
70,Fail,52,24,0,15,37
70,Fail,48,19,8,14,34
70,Fail,54,27,0,6,48
70,Fail,43,27,0,17,26
70,Fail,51,25,5,8,43
70,Fail,49,28,0,12,37
70,Fail,46,26,2,16,30
70,Fail,53,25,2,11,42
70,Fail,48,24,2,15,33
70,Fail,42,39,0,9,33
70,Fail,53,22,0,15,38
70,Fail,44,28,3,9,35
70,Fail,47,30,1,9,38
70,Fail,45,32,0,16,29
70,Fail,46,32,0,9,37
70,Fail,50,29,3,8,42
70,Fail,46,29,0,11,35
70,Fail,48,24,1,14,34
70,Fail,46,31,0,12,34
70,Fail,49,31,0,12,37
70,Fail,39,45,0,12,27
70,Fail,47,23,4,13,34
70,Fail,48,29,3,9,39
70,Fail,43,25,2,19,24
70,Fail,48,29,0,12,36
70,Fail,42,32,1,15,27
70,Fail,49,23,0,17,32
70,Fail,55,22,0,15,40
70,Fail,52,22,0,16,36
70,Fail,57,17,0,14,43
70,Fail,51,23,0,9,42
70,Fail,49,31,0,6,43
70,Fail,50,22,4,13,37
70,Fail,50,28,0,11,39
70,Fail,48,25,0,10,38
70,Fail,39,33,8,11,28
70,Fail,51,30,0,11,40
70,Fail,52,26,1,12,40
70,Fail,40,30,0,17,23
70,Fail,56,24,0,7,49
70,Fail,45,29,2,13,32
70,Fail,52,23,0,11,41
70,Fail,48,29,0,11,37
70,Fail,55,21,3,10,45
70,Fail,43,29,0,16,27
70,Fail,39,30,8,13,26
70,Fail,51,28,3,9,42
70,Fail,48,29,4,9,39
70,Fail,50,31,0,7,43
70,Fail,47,21,13,13,34
70,Fail,49,29,0,11,38
70,Fail,41,36,0,16,25
70,Fail,50,25,5,10,40
70,Fail,46,37,0,8,38
70,Fail,55,24,0,10,45
70,Fail,53,22,0,16,37
70,Fail,44,35,0,13,31
70,Fail,48,27,5,14,34
70,Fail,54,23,2,10,44
70,Fail,42,29,10,11,31
70,Fail,54,18,1,17,37
70,Fail,50,23,1,11,39
70,Fail,53,23,0,10,43
70,Fail,45,33,0,15,30
70,Fail,55,20,2,9,46
70,Fail,52,25,0,10,42
70,Fail,44,31,0,14,30
70,Fail,44,37,0,11,33
70,Fail,49,32,0,14,35
70,Fail,51,20,12,12,39
70,Fail,48,22,0,13,35
70,Fail,43,30,2,15,28
70,Fail,50,28,0,13,37
70,Fail,47,33,0,12,35
70,Fail,58,24,0,5,53
70,Fail,48,26,3,12,36
70,Fail,49,26,6,11,38
70,Fail,53,27,0,9,44
70,Fail,50,25,3,12,38
70,Fail,45,35,0,9,36
70,Fail,51,24,4,12,39
70,Fail,55,29,0,5,50
70,Fail,49,28,0,17,32
70,Fail,50,23,6,11,39
70,Fail,51,25,0,15,36
70,Fail,46,23,0,16,30
70,Fail,45,31,3,13,32
70,Fail,46,22,3,16,30
70,Fail,50,30,0,12,38
70,Fail,56,20,1,14,42
70,Fail,51,26,0,10,41
70,Fail,52,24,0,14,38
70,Fail,50,29,0,6,44
70,Fail,55,23,0,9,46
70,Fail,48,27,0,14,34
70,Fail,53,26,0,9,44
70,Fail,49,22,6,12,37
70,Fail,44,28,0,15,29
70,Fail,55,15,0,15,40
70,Fail,40,21,9,17,23
70,Fail,46,31,0,15,31
70,Fail,49,29,0,8,41
70,Fail,47,18,6,17,30
70,Fail,48,26,0,13,35
70,Fail,48,21,5,20,28
70,Fail,43,31,5,10,33
70,Fail,47,39,0,7,40
70,Fail,54,17,5,16,38
70,Fail,59,17,0,10,49
70,Fail,48,22,4,16,32
70,Fail,55,25,0,11,44
70,Fail,45,28,0,15,30
70,Fail,40,30,7,17,23
70,Fail,51,30,0,14,37
70,Fail,47,29,0,13,34
70,Fail,53,22,1,10,43
70,Fail,59,15,0,13,46
70,Fail,49,28,1,10,39
70,Fail,49,20,4,11,38
70,Fail,48,27,0,11,37
70,Fail,55,19,0,14,41
70,Fail,54,18,9,9,45
70,Fail,57,24,0,8,49
70,Fail,53,25,0,11,42
70,Fail,51,23,1,13,38
70,Fail,44,28,2,13,31
70,Fail,49,23,3,13,36
70,Fail,40,41,0,12,28
70,Fail,55,20,0,16,39
70,Fail,45,23,3,15,30
70,Fail,45,23,7,15,30
70,Fail,40,40,0,12,28
70,Fail,43,35,0,16,27
70,Fail,48,31,0,13,35
70,Fail,47,24,0,17,30
70,Fail,42,29,0,14,28
70,Fail,54,24,0,12,42
70,Fail,47,34,0,9,38
70,Fail,49,26,0,17,32
70,Fail,44,34,0,13,31
70,Fail,50,23,2,13,37
70,Fail,51,24,2,13,38
70,Fail,48,23,0,13,35
70,Fail,45,27,0,18,27
70,Fail,48,24,1,14,34
70,Fail,47,26,0,14,33
70,Fail,45,27,3,17,28
70,Fail,56,21,0,12,44
70,Fail,41,33,0,15,26
70,Fail,51,23,0,16,35
70,Fail,45,30,6,12,33
70,Fail,40,43,0,12,28
70,Fail,45,29,0,12,33
70,Fail,49,26,0,12,37
70,Fail,51,20,11,13,38
70,Fail,50,25,0,12,38
70,Fail,40,32,0,15,25
70,Fail,49,26,3,10,39
70,Fail,41,28,0,21,20
70,Fail,41,39,0,15,26
70,Fail,43,22,3,15,28
70,Fail,47,26,0,15,32
70,Fail,39,28,6,18,21
70,Fail,54,21,4,10,44
70,Fail,52,21,1,10,42
70,Fail,59,23,0,7,52
70,Fail,48,30,0,14,34
70,Fail,50,29,0,11,39
70,Fail,40,31,6,11,29
70,Fail,49,21,4,14,35
70,Fail,50,29,0,11,39
70,Fail,53,24,0,16,37
70,Fail,48,30,0,12,36
70,Fail,47,28,0,14,33
70,Fail,46,32,10,6,40
70,Fail,48,24,1,14,34
70,Fail,53,24,0,12,41
70,Fail,42,36,0,16,26
70,Fail,49,28,0,9,40
70,Fail,53,27,1,7,46
70,Fail,44,24,7,16,28
70,Fail,60,22,0,7,53
70,Fail,55,22,0,16,39
70,Fail,54,25,0,6,48
70,Fail,43,35,0,12,31
70,Fail,46,22,4,17,29
70,Fail,47,22,10,9,38
70,Fail,43,33,0,17,26
70,Fail,54,25,0,9,45
70,Fail,49,25,2,8,41
70,Fail,50,25,3,8,42
70,Fail,48,28,0,14,34
70,Fail,45,31,4,8,37
70,Fail,55,23,0,9,46
70,Fail,59,17,6,6,53
70,Fail,49,26,0,13,36
70,Fail,47,26,0,17,30
70,Fail,45,32,0,12,33
70,Fail,50,21,5,13,37
70,Fail,44,24,12,14,30
70,Fail,58,16,0,11,47
70,Fail,42,29,5,13,29
70,Fail,38,26,0,21,17
70,Fail,47,26,1,15,32
70,Fail,50,27,0,13,37
70,Fail,44,31,0,13,31
70,Fail,54,20,0,16,38
70,Fail,53,25,2,11,42
70,Fail,42,38,0,9,33
70,Fail,53,17,7,12,41
70,Fail,39,32,3,15,24
70,Fail,40,34,0,15,25
70,Fail,51,22,2,14,37
70,Fail,48,23,6,15,33
70,Fail,52,29,0,9,43
70,Fail,49,36,0,7,42
70,Fail,47,30,0,11,36
70,Fail,43,33,0,13,30
70,Fail,46,32,0,12,34
70,Fail,44,29,5,12,32
70,Fail,56,21,0,10,46
70,Fail,42,27,4,15,27
70,Fail,48,24,0,14,34
70,Fail,54,23,0,9,45
70,Fail,57,19,0,10,47
70,Fail,45,29,0,18,27
70,Fail,48,27,4,7,41
70,Fail,53,24,0,13,40
70,Fail,48,26,1,14,34
70,Fail,54,22,0,12,42
70,Fail,46,25,1,18,28
70,Fail,34,23,15,19,15
70,Fail,46,29,3,12,34
70,Fail,46,25,6,13,33
70,Fail,47,31,0,10,37
70,Fail,44,26,0,19,25
70,Fail,45,34,0,7,38
70,Fail,43,29,0,15,28
70,Fail,56,22,0,12,44
70,Fail,54,20,3,14,40
70,Fail,52,25,0,13,39
70,Fail,49,23,0,12,37
70,Fail,48,24,0,15,33
70,Fail,43,28,0,16,27
70,Fail,51,21,1,11,40
70,Fail,47,26,5,11,36
70,Fail,48,28,3,9,39
70,Fail,49,23,9,10,39
70,Fail,53,22,0,11,42
70,Fail,58,23,0,10,48
70,Fail,46,32,0,12,34
70,Fail,47,40,0,6,41
70,Fail,47,25,2,19,28
70,Fail,47,29,0,12,35
70,Fail,34,32,16,9,25
70,Fail,45,26,0,15,30
70,Fail,50,30,0,10,40
70,Fail,48,24,4,14,34
70,Fail,47,23,7,13,34
70,Fail,45,24,2,19,26
70,Fail,52,23,6,9,43
70,Fail,48,33,0,9,39
70,Fail,51,25,3,8,43
70,Fail,45,28,7,13,32
70,Fail,47,32,0,9,38
70,Fail,45,33,0,9,36
70,Fail,50,22,0,19,31
70,Fail,44,30,13,10,34
70,Fail,43,34,8,9,34
70,Fail,56,19,0,11,45
70,Fail,47,33,0,10,37
70,Fail,49,25,0,13,36
70,Fail,56,22,7,7,49
70,Fail,53,29,0,11,42
70,Fail,53,25,2,7,46
70,Fail,49,32,0,10,39
70,Fail,51,32,0,8,43
70,Fail,40,36,0,16,24
70,Fail,49,20,8,12,37
70,Fail,41,29,0,19,22
70,Fail,49,23,5,12,37
70,Fail,47,31,0,15,32
70,Fail,48,23,0,15,33
70,Fail,44,24,4,16,28
70,Fail,48,33,0,11,37
70,Fail,46,25,2,16,30
70,Fail,47,24,3,16,31
70,Fail,54,27,0,11,43
70,Fail,43,32,0,14,29
70,Fail,53,23,0,11,42
70,Fail,51,25,0,10,41
70,Fail,52,27,2,12,40
70,Fail,54,15,0,22,32
70,Fail,46,31,0,15,31
70,Fail,48,30,1,8,40
70,Fail,47,25,10,12,35
70,Fail,57,22,0,9,48
70,Fail,44,26,0,20,24
70,Fail,47,26,2,14,33
70,Fail,44,34,0,12,32
70,Fail,46,31,2,11,35
70,Fail,52,23,0,13,39
70,Fail,45,23,4,16,29
70,Fail,44,34,0,13,31
70,Fail,54,20,0,16,38
70,Fail,47,24,4,16,31
70,Fail,41,35,4,11,30
70,Fail,46,27,0,14,32
70,Fail,40,35,0,17,23
70,Fail,52,19,5,15,37
70,Fail,52,22,0,13,39
70,Fail,52,24,0,9,43
70,Fail,53,23,0,15,38
70,Fail,34,41,0,16,18
70,Fail,43,26,10,14,29
70,Fail,50,24,3,9,41
70,Fail,44,30,4,15,29
70,Fail,49,25,6,11,38
70,Fail,48,31,0,9,39
70,Fail,51,24,1,14,37
70,Fail,48,28,0,15,33
70,Fail,58,24,2,5,53
70,Fail,52,29,0,7,45
70,Fail,55,23,0,12,43
70,Fail,49,29,0,11,38
70,Fail,52,28,0,12,40
70,Fail,51,21,2,12,39
70,Fail,55,28,0,6,49
70,Fail,50,27,0,14,36
70,Fail,43,26,0,17,26
70,Fail,52,27,0,6,46
70,Fail,49,28,0,11,38
70,Fail,39,28,12,13,26
70,Fail,41,30,10,14,27
70,Fail,38,35,0,14,24
70,Fail,44,25,7,15,29
70,Fail,51,24,0,15,36
70,Fail,51,29,0,9,42
70,Fail,53,24,0,9,44
70,Fail,44,31,0,16,28
70,Fail,50,21,8,13,37
70,Fail,45,34,0,13,32
70,Fail,39,45,0,9,30
70,Fail,50,30,0,14,36
70,Fail,48,33,0,6,42
70,Fail,42,39,0,9,33
70,Fail,56,19,0,14,42
70,Fail,45,31,0,14,31
70,Fail,45,27,11,10,35
70,Fail,44,36,0,13,31
70,Fail,41,34,7,13,28
70,Fail,44,25,0,18,26
70,Fail,45,32,4,9,36
70,Fail,40,32,8,13,27
70,Fail,49,22,8,12,37
70,Fail,50,27,0,12,38
70,Fail,48,29,0,13,35
70,Fail,49,22,3,10,39
70,Fail,48,28,9,9,39
70,Fail,60,20,0,9,51
70,Fail,46,26,7,10,36
70,Fail,48,26,3,9,39
70,Fail,49,25,6,12,37
70,Fail,42,34,0,16,26
70,Fail,48,23,5,12,36
70,Fail,44,34,0,12,32
70,Fail,37,30,9,15,22
70,Fail,50,38,0,9,41
70,Fail,44,31,0,13,31
70,Fail,47,23,2,20,27
70,Fail,43,45,0,8,35
70,Fail,41,30,1,18,23
70,Fail,53,19,3,11,42
70,Fail,47,28,0,11,36
70,Fail,48,27,0,11,37
70,Fail,49,35,0,8,41
70,Fail,52,18,5,14,38
70,Fail,48,25,0,17,31
70,Fail,48,27,0,12,36
70,Fail,47,31,0,12,35
70,Fail,48,22,2,14,34
70,Fail,48,23,3,15,33
70,Fail,51,28,0,12,39
70,Fail,53,26,1,9,44
70,Fail,47,29,1,10,37
70,Fail,54,20,0,12,42
70,Fail,51,28,0,12,39
70,Fail,45,23,8,14,31
70,Fail,55,20,2,12,43
70,Fail,53,19,17,6,47
70,Fail,52,28,0,11,41
70,Fail,54,23,2,10,44
70,Fail,50,27,3,8,42
70,Fail,55,23,0,8,47
70,Fail,42,36,0,12,30
70,Fail,46,35,0,9,37
70,Fail,55,26,0,9,46
70,Fail,45,28,1,12,33
70,Fail,45,36,0,8,37
70,Fail,42,26,3,17,25
70,Fail,41,32,0,16,25
70,Fail,48,33,0,12,36
70,Fail,52,22,2,11,41
70,Fail,45,26,0,15,30
70,Fail,41,35,0,16,25
70,Fail,44,33,0,11,33
70,Fail,47,28,0,16,31
70,Fail,57,25,1,7,50
70,Fail,38,41,0,12,26
70,Fail,48,32,0,8,40
70,Fail,52,21,0,16,36
70,Fail,42,34,0,15,27
70,Fail,53,28,0,9,44
70,Fail,46,25,8,14,32
70,Fail,40,26,1,19,21
70,Fail,47,24,1,14,33
70,Fail,52,27,0,11,41
70,Fail,46,29,8,6,40
70,Fail,51,25,0,10,41
70,Fail,37,28,0,25,12
70,Fail,56,24,2,8,48
70,Fail,49,28,0,15,34
70,Fail,47,30,4,12,35
70,Fail,54,16,0,14,40
70,Fail,46,23,4,13,33
70,Fail,50,21,7,11,39
70,Fail,43,35,1,12,31
70,Fail,44,26,7,11,33
70,Fail,46,24,10,14,32
70,Fail,44,30,8,10,34
70,Fail,45,30,6,9,36
70,Fail,51,29,5,6,45
70,Fail,43,34,0,17,26
70,Fail,49,22,0,15,34
70,Fail,50,26,0,13,37
70,Fail,47,33,0,10,37
70,Fail,46,38,0,9,37
70,Fail,48,26,1,12,36
70,Fail,46,30,0,13,33
70,Fail,58,21,2,8,50
70,Fail,48,22,8,12,36
70,Fail,50,25,0,16,34
70,Fail,51,24,4,9,42
70,Fail,46,29,0,15,31
70,Fail,51,25,1,10,41
70,Fail,51,25,3,11,40
70,Fail,40,43,0,7,33
70,Fail,55,25,0,9,46
70,Fail,47,24,10,12,35
70,Fail,46,30,0,14,32
70,Fail,45,21,0,23,22
70,Fail,46,28,0,12,34
70,Fail,50,29,0,9,41
70,Fail,51,23,8,12,39
70,Fail,46,27,6,10,36
70,Fail,51,24,1,12,39
70,Fail,54,29,0,5,49
70,Fail,44,32,0,11,33
70,Fail,42,30,0,20,22
70,Fail,47,26,0,14,33
70,Fail,53,28,0,10,43
70,Fail,50,22,3,14,36
70,Fail,53,23,2,8,45
70,Fail,50,21,1,16,34
70,Fail,50,26,0,10,40
70,Fail,50,27,0,11,39
70,Fail,53,20,0,13,40
70,Fail,46,30,0,14,32
70,Fail,49,24,6,10,39
70,Fail,51,26,0,14,37
70,Fail,54,20,0,13,41
70,Fail,54,23,1,12,42
70,Fail,40,33,1,17,23
70,Fail,50,27,0,14,36
70,Fail,53,24,3,9,44
70,Fail,47,24,0,15,32
70,Fail,49,25,6,12,37
70,Fail,50,17,0,21,29
70,Fail,52,23,1,13,39
70,Fail,48,30,0,15,33
70,Fail,49,21,6,9,40
70,Fail,46,33,2,13,33
70,Fail,49,25,0,15,34
70,Fail,44,28,8,12,32
70,Fail,47,30,0,13,34
70,Fail,57,23,0,7,50
70,Fail,52,26,6,9,43
70,Fail,55,18,3,14,41
70,Fail,42,28,0,17,25
70,Fail,56,21,1,12,44
70,Fail,52,26,2,13,39
70,Fail,50,26,0,14,36
70,Fail,42,34,0,18,24
70,Fail,49,30,0,14,35
70,Fail,46,32,0,11,35
70,Fail,52,23,0,12,40
70,Fail,52,23,0,12,40
70,Fail,46,24,5,19,27
70,Fail,45,32,0,11,34
70,Fail,53,28,2,10,43
70,Fail,40,34,0,18,22
70,Fail,49,29,4,10,39
70,Fail,46,31,0,11,35
70,Fail,49,27,3,10,39
70,Fail,49,26,0,12,37
70,Fail,48,21,2,18,30
70,Fail,43,31,3,12,31
70,Fail,47,24,2,14,33
70,Fail,38,38,0,16,22
70,Fail,43,38,0,13,30
70,Fail,53,25,1,12,41
70,Fail,48,34,0,9,39
70,Fail,48,34,0,9,39
70,Fail,36,38,0,16,20
70,Fail,49,27,0,13,36
70,Fail,53,25,0,11,42
70,Fail,46,31,0,13,33
70,Fail,49,28,1,13,36
70,Fail,47,27,0,15,32
70,Fail,55,20,6,7,48
70,Fail,47,33,0,10,37
70,Fail,49,23,2,16,33
70,Fail,46,30,0,14,32
70,Fail,45,33,0,14,31
70,Fail,48,29,0,14,34
70,Fail,52,23,5,10,42
70,Fail,43,31,8,10,33
70,Fail,54,14,4,16,38
70,Fail,49,23,0,14,35
70,Fail,36,40,0,14,22
70,Fail,47,33,0,8,39
70,Fail,53,22,0,12,41
70,Fail,52,23,7,10,42
70,Fail,35,39,7,12,23
70,Fail,46,23,8,14,32
70,Fail,42,27,8,10,32
70,Fail,51,25,0,16,35
70,Fail,45,26,5,17,28
70,Fail,48,26,10,11,37
70,Fail,46,37,0,11,35
70,Fail,49,21,2,15,34
70,Fail,48,31,0,9,39
70,Fail,57,20,0,10,47
70,Fail,55,18,0,13,42
70,Fail,50,19,3,12,38
70,Fail,55,23,3,7,48
70,Fail,44,23,3,15,29
70,Fail,41,25,10,13,28
70,Fail,47,25,0,17,30
70,Fail,51,26,0,11,40
70,Fail,50,21,5,10,40
70,Fail,46,38,0,9,37
70,Fail,46,28,0,17,29
70,Fail,51,23,2,15,36
70,Fail,45,28,5,11,34
70,Fail,53,22,0,11,42
70,Fail,41,38,0,12,29
70,Fail,45,35,0,11,34
70,Fail,54,25,4,7,47
70,Fail,46,34,2,11,35
70,Fail,50,27,4,11,39
70,Fail,45,27,9,16,29
70,Fail,49,32,0,8,41
70,Fail,51,21,6,11,40
70,Fail,54,27,0,11,43
70,Fail,54,18,4,14,40
70,Fail,55,22,0,15,40
70,Fail,47,25,9,12,35
70,Fail,59,24,0,11,48
70,Fail,58,18,0,12,46
70,Fail,40,26,3,17,23
70,Fail,47,27,1,12,35
70,Fail,41,36,7,9,32
70,Fail,47,23,0,15,32
70,Fail,46,25,1,15,31
70,Fail,54,21,0,13,41
70,Fail,53,20,1,12,41
70,Fail,52,29,0,11,41
70,Fail,44,24,6,17,27
70,Fail,49,22,1,16,33
70,Fail,53,19,3,12,41
70,Fail,58,19,7,8,50
70,Fail,50,20,0,20,30
70,Fail,54,21,1,12,42
70,Fail,36,28,6,21,15
70,Fail,50,31,6,5,45
70,Fail,48,25,7,9,39
70,Fail,46,34,0,10,36
70,Fail,51,26,3,11,40
70,Fail,48,31,0,13,35
70,Fail,55,24,1,10,45
70,Fail,45,32,2,14,31
70,Fail,56,21,1,10,46
70,Fail,38,35,0,18,20
70,Fail,50,26,0,16,34
70,Fail,40,36,0,16,24
70,Fail,47,28,0,16,31
70,Fail,49,29,0,11,38
70,Fail,49,30,0,13,36
70,Fail,43,29,9,8,35
70,Fail,51,28,0,11,40
70,Fail,46,25,4,15,31
70,Fail,51,22,2,14,37
70,Fail,57,20,0,10,47
70,Fail,43,27,10,13,30
70,Fail,43,26,0,17,26
70,Fail,45,25,2,19,26
70,Fail,49,27,8,10,39
70,Fail,46,26,0,15,31
70,Fail,40,41,0,10,30
70,Fail,55,25,0,11,44
70,Fail,57,22,0,8,49
70,Fail,50,24,2,12,38
70,Fail,42,28,2,13,29
70,Fail,42,31,0,17,25
70,Fail,47,32,0,11,36
70,Fail,44,31,0,12,32
70,Fail,47,18,2,18,29
70,Fail,45,27,1,12,33
70,Fail,50,23,4,10,40
70,Fail,43,37,0,9,34
70,Fail,50,22,1,16,34
70,Fail,50,27,0,10,40
70,Fail,53,19,3,16,37
70,Fail,48,25,0,14,34
70,Fail,41,41,0,11,30
70,Fail,47,26,12,7,40
70,Fail,46,27,0,15,31
70,Fail,46,25,0,18,28
70,Fail,43,25,4,13,30
70,Fail,54,20,2,14,40
70,Fail,48,25,4,10,38
70,Fail,46,33,0,10,36
70,Fail,51,22,1,12,39
70,Fail,48,30,3,12,36
70,Fail,51,26,0,12,39
70,Fail,48,30,0,14,34
70,Fail,55,22,1,14,41
70,Fail,49,33,0,6,43
70,Fail,52,28,0,13,39
70,Fail,46,31,0,11,35
70,Fail,53,26,0,12,41
70,Fail,42,34,0,13,29
70,Fail,52,28,0,8,44
70,Fail,44,36,0,10,34
70,Fail,45,25,1,15,30
70,Fail,49,24,0,17,32
70,Fail,51,20,3,13,38
70,Fail,45,32,0,12,33
70,Fail,50,22,3,12,38
70,Fail,44,29,3,14,30
70,Fail,39,38,0,13,26
70,Fail,48,35,0,9,39
70,Fail,49,26,1,13,36
70,Fail,54,25,0,12,42
70,Fail,44,29,0,14,30
70,Fail,49,30,3,10,39
70,Fail,46,22,0,20,26
70,Fail,46,21,8,13,33
70,Fail,51,23,0,13,38
70,Fail,44,30,2,8,36
70,Fail,49,20,0,16,33
70,Fail,53,27,0,8,45
70,Fail,48,25,1,15,33
70,Fail,46,27,6,9,37
70,Fail,43,33,2,14,29
70,Fail,51,31,0,13,38
70,Fail,55,23,0,7,48
70,Fail,51,28,4,8,43
70,Fail,48,25,0,14,34
70,Fail,45,28,0,14,31
70,Fail,53,28,0,8,45
70,Fail,44,31,0,15,29
70,Fail,54,15,3,15,39
70,Fail,51,29,0,10,41
70,Fail,40,29,0,19,21
70,Fail,39,31,4,13,26
70,Fail,43,24,14,11,32
70,Fail,53,20,1,14,39
70,Fail,45,27,4,16,29
70,Fail,40,25,12,13,27
70,Fail,45,26,4,18,27
70,Fail,53,24,0,10,43
70,Fail,50,28,2,7,43
70,Fail,42,29,2,16,26
70,Fail,40,31,2,15,25
70,Fail,47,28,0,12,35
70,Fail,50,17,0,20,30
70,Fail,52,18,5,14,38
70,Fail,56,19,0,12,44
70,Fail,48,28,0,17,31
70,Fail,50,34,0,6,44
70,Fail,50,22,0,16,34
70,Fail,42,33,4,12,30
70,Fail,42,22,8,15,27
70,Fail,43,29,5,12,31
70,Fail,52,30,0,9,43
70,Fail,47,21,4,19,28
70,Fail,48,23,2,13,35
70,Fail,44,28,0,16,28
70,Fail,50,30,0,9,41
70,Fail,51,26,0,11,40
70,Fail,50,33,0,10,40
70,Fail,63,19,0,7,56
70,Fail,51,18,1,17,34
70,Fail,50,26,0,12,38
70,Fail,49,20,2,16,33
70,Fail,46,29,0,12,34
70,Fail,49,22,0,17,32
70,Fail,50,29,1,8,42
70,Fail,51,29,0,15,36
70,Fail,50,24,2,14,36
70,Fail,51,25,0,14,37
70,Fail,43,33,0,11,32
70,Fail,52,26,2,8,44
70,Fail,51,26,0,12,39
70,Fail,50,29,0,10,40
70,Fail,57,21,0,12,45
70,Fail,44,29,6,14,30
70,Fail,49,29,0,10,39
70,Fail,46,16,3,26,20
70,Fail,46,30,0,14,32
70,Fail,57,22,0,11,46
70,Fail,42,20,6,17,25
70,Fail,54,20,2,9,45
70,Fail,51,19,0,17,34
70,Fail,50,27,0,12,38
70,Fail,52,33,0,8,44
70,Fail,47,32,0,8,39
70,Fail,51,22,2,10,41
70,Fail,48,27,0,11,37
70,Fail,47,29,2,11,36
70,Fail,41,36,0,15,26
70,Fail,48,26,0,12,36
70,Fail,41,38,0,13,28
70,Fail,38,41,0,13,25
70,Fail,52,28,1,11,41
70,Fail,46,27,4,12,34
70,Fail,49,24,1,11,38
70,Fail,50,23,3,15,35
70,Fail,46,28,0,16,30
70,Fail,41,31,6,12,29
70,Fail,43,32,0,15,28
70,Fail,51,26,1,12,39
70,Fail,50,21,0,17,33
70,Fail,43,27,0,17,26
70,Fail,45,26,4,15,30
70,Fail,51,31,0,11,40
70,Fail,37,32,0,20,17
70,Fail,45,35,0,11,34
70,Fail,52,22,3,8,44
70,Fail,43,28,1,17,26
70,Fail,60,19,0,9,51
70,Fail,58,22,0,8,50
70,Fail,43,28,5,13,30
70,Fail,53,24,0,13,40
70,Fail,44,24,4,16,28
70,Fail,45,30,0,17,28
70,Fail,45,23,6,14,31
70,Fail,57,16,5,10,47
70,Fail,58,19,0,15,43
70,Fail,43,35,0,13,30
70,Fail,53,24,0,15,38
70,Fail,46,31,3,15,31
70,Fail,45,24,5,20,25
70,Fail,55,22,6,7,48
70,Fail,43,30,2,12,31
70,Fail,43,25,1,18,25
70,Fail,49,30,0,11,38
70,Fail,46,35,0,8,38
70,Fail,52,24,0,16,36
70,Fail,54,20,0,13,41
70,Fail,50,20,6,16,34
70,Fail,48,33,0,11,37
70,Fail,40,38,0,15,25
70,Fail,50,26,1,13,37
70,Fail,44,29,0,16,28
70,Fail,54,24,3,6,48
70,Fail,43,38,0,8,35
70,Fail,40,30,11,13,27
70,Fail,52,20,5,12,40
70,Fail,48,27,0,12,36
70,Fail,50,25,0,16,34
70,Fail,43,33,0,11,32
70,Fail,47,26,8,8,39
70,Fail,53,23,3,9,44
70,Fail,48,26,0,14,34
70,Fail,50,25,2,14,36
70,Fail,57,15,6,8,49
70,Fail,51,26,0,11,40
70,Fail,46,26,0,16,30
70,Fail,51,21,5,12,39
70,Fail,43,30,0,15,28
70,Fail,51,22,0,15,36
70,Fail,45,27,3,15,30
70,Fail,44,35,0,9,35
70,Fail,56,22,0,8,48
70,Fail,50,23,5,10,40
70,Fail,47,24,4,12,35
70,Fail,46,29,0,17,29
70,Fail,47,26,7,14,33
70,Fail,39,31,5,16,23
70,Fail,49,31,0,14,35
70,Fail,54,19,0,14,40
70,Fail,47,22,7,15,32
70,Fail,47,26,9,10,37
70,Fail,46,35,0,8,38
70,Fail,51,29,0,7,44
70,Fail,55,24,0,7,48
70,Fail,61,16,6,9,52
70,Fail,43,35,1,13,30
70,Fail,48,24,0,18,30
70,Fail,45,25,4,14,31
70,Fail,48,23,0,17,31
70,Fail,49,30,0,8,41
70,Fail,48,29,0,12,36
70,Fail,55,22,3,12,43
70,Fail,52,25,3,11,41
70,Fail,56,22,0,12,44
70,Fail,50,21,0,20,30
70,Fail,49,25,0,13,36
70,Fail,47,23,1,18,29
70,Fail,47,19,11,14,33
70,Fail,51,30,0,13,38
70,Fail,49,33,0,14,35
70,Fail,51,21,1,14,37
70,Fail,51,22,7,12,39
70,Fail,42,32,0,15,27
70,Fail,54,22,0,11,43
70,Fail,42,39,0,12,30
70,Fail,51,24,0,12,39
70,Fail,46,25,3,15,31
70,Fail,41,33,0,18,23
70,Fail,55,27,0,5,50
70,Fail,48,24,0,16,32
70,Fail,47,24,0,17,30
70,Fail,56,21,0,10,46
70,Fail,51,29,4,7,44
70,Fail,58,30,0,5,53
70,Fail,45,29,0,15,30
70,Fail,48,32,0,12,36
70,Fail,48,33,0,9,39
70,Fail,50,22,3,15,35
70,Fail,58,23,0,8,50
70,Fail,53,18,2,12,41
70,Fail,51,21,3,14,37
70,Fail,46,34,0,12,34
70,Fail,48,31,0,11,37
70,Fail,44,29,0,11,33
70,Fail,47,25,3,16,31
70,Fail,46,19,4,20,26
70,Fail,44,34,0,12,32
70,Fail,48,26,3,12,36
70,Fail,41,27,1,16,25
70,Fail,49,29,0,11,38
70,Fail,46,24,0,18,28
70,Fail,43,29,0,19,24
70,Fail,46,24,5,17,29
70,Fail,40,38,0,13,27
70,Fail,50,26,1,11,39
70,Fail,47,26,0,13,34
70,Fail,46,36,0,10,36
70,Fail,49,26,0,13,36
70,Fail,57,19,0,10,47
70,Fail,42,34,0,12,30
70,Fail,47,29,3,13,34
70,Fail,53,28,0,8,45
70,Fail,41,34,9,8,33
70,Fail,58,18,0,13,45
70,Fail,48,26,0,17,31
70,Fail,50,25,0,13,37
70,Fail,44,39,0,10,34
70,Fail,43,35,0,14,29
70,Fail,49,26,0,13,36
70,Fail,38,28,19,10,28
70,Fail,40,37,0,10,30
70,Fail,50,19,4,15,35
70,Fail,37,35,0,18,19
70,Fail,44,27,0,17,27
70,Fail,47,23,5,18,29
70,Fail,52,25,4,5,47
70,Fail,50,23,1,16,34
70,Fail,48,33,0,12,36
70,Fail,44,35,0,12,32
70,Fail,45,24,7,14,31
70,Fail,44,24,7,15,29
70,Fail,48,26,2,13,35
70,Fail,53,27,0,10,43
70,Fail,52,25,0,12,40
70,Fail,58,28,0,6,52
70,Fail,43,30,6,10,33
70,Fail,51,35,0,8,43
70,Fail,46,33,0,13,33
70,Fail,50,25,1,11,39
70,Fail,41,35,0,14,27
70,Fail,40,32,0,16,24
70,Fail,45,27,8,8,37
70,Fail,52,26,5,6,46
70,Fail,46,21,0,22,24
70,Fail,51,22,5,10,41
70,Fail,45,36,0,11,34
70,Fail,52,22,0,12,40
70,Fail,55,21,0,16,39
70,Fail,55,19,0,11,44
70,Fail,46,30,4,10,36
70,Fail,52,33,0,8,44
70,Fail,45,28,6,14,31
70,Fail,49,32,0,10,39
70,Fail,48,31,0,12,36
70,Fail,46,25,5,12,34
70,Fail,50,29,0,12,38
70,Fail,49,20,7,17,32
70,Fail,52,26,1,9,43
70,Fail,49,24,6,11,38
70,Fail,45,29,8,9,36
70,Fail,51,29,0,8,43
70,Fail,47,28,0,14,33
70,Fail,46,30,0,10,36
70,Fail,47,29,0,10,37
70,Fail,44,33,2,10,34
70,Fail,53,24,1,10,43
70,Fail,43,35,0,11,32
70,Fail,51,25,0,16,35
70,Fail,45,34,9,6,39
70,Fail,46,32,0,8,38
70,Fail,51,34,0,6,45
70,Fail,49,28,1,11,38
70,Fail,39,29,1,17,22
70,Fail,50,19,1,16,34
70,Fail,44,31,0,13,31
70,Fail,49,29,0,12,37
70,Fail,45,23,7,17,28
70,Fail,46,22,2,14,32
70,Fail,46,23,0,18,28
70,Fail,38,44,0,11,27
70,Fail,43,34,0,10,33
70,Fail,51,20,0,16,35
70,Fail,41,34,0,16,25
70,Fail,53,22,6,9,44
70,Fail,53,19,3,14,39
70,Fail,53,24,0,14,39
70,Fail,46,27,10,9,37
70,Fail,52,15,3,14,38
70,Fail,49,34,0,11,38
70,Fail,51,22,2,17,34
70,Fail,48,27,5,11,37
70,Fail,46,29,6,9,37
70,Fail,45,36,0,10,35
70,Fail,47,26,10,6,41
70,Fail,48,32,3,9,39
70,Fail,49,25,8,12,37
70,Fail,48,26,0,14,34
70,Fail,43,35,0,13,30
70,Fail,51,23,2,11,40
70,Fail,52,22,1,12,40
70,Fail,50,27,0,11,39
70,Fail,45,35,0,9,36
70,Fail,43,29,4,15,28
70,Fail,45,35,0,10,35
70,Fail,52,23,0,12,40
70,Fail,46,26,3,10,36
70,Fail,53,24,4,13,40
70,Fail,42,32,0,14,28
70,Fail,54,19,3,12,42
70,Fail,48,29,0,14,34
70,Fail,47,25,0,17,30
70,Fail,52,25,2,10,42
70,Fail,41,37,0,14,27
70,Fail,46,28,0,14,32
70,Fail,51,28,0,12,39
70,Fail,58,25,0,4,54
70,Fail,35,29,11,19,16
70,Fail,45,36,0,11,34
70,Fail,42,25,9,16,26
70,Fail,49,31,0,11,38
70,Fail,53,21,8,10,43
70,Fail,46,22,6,16,30
70,Fail,50,26,1,7,43
70,Fail,45,27,7,13,32
70,Fail,45,26,1,15,30
70,Fail,47,25,4,13,34
70,Fail,53,25,0,9,44
70,Fail,49,33,0,11,38
70,Fail,36,35,5,18,18
70,Fail,41,31,4,12,29
70,Fail,51,23,0,11,40
70,Fail,46,26,0,17,29
70,Fail,56,24,1,10,46
70,Fail,42,30,4,12,30
70,Fail,43,38,0,12,31
70,Fail,51,26,0,9,42
70,Fail,45,26,0,17,28
70,Fail,43,31,7,11,32
70,Fail,47,34,0,11,36
70,Fail,55,23,1,9,46
70,Fail,45,32,0,12,33
70,Fail,45,37,0,12,33
70,Fail,45,26,5,13,32
70,Fail,47,31,0,12,35
70,Fail,52,29,0,12,40
70,Fail,54,26,0,13,41
70,Fail,50,31,0,12,38
70,Fail,50,23,7,11,39
70,Fail,52,20,0,18,34
70,Fail,46,31,0,12,34
70,Fail,50,28,0,12,38
70,Fail,52,26,2,10,42
70,Fail,48,29,0,11,37
70,Fail,55,22,0,12,43
70,Fail,45,21,8,17,28
70,Fail,52,24,0,14,38
70,Fail,59,21,0,9,50
70,Fail,47,28,2,13,34
70,Fail,55,25,0,7,48
70,Fail,43,33,0,16,27
70,Fail,51,25,4,10,41
70,Fail,44,28,3,15,29
70,Fail,47,21,6,15,32
70,Fail,50,23,0,14,36
70,Fail,48,28,0,12,36
70,Fail,51,25,2,12,39
70,Fail,56,24,0,11,45
70,Fail,49,31,0,11,38
70,Fail,46,27,6,9,37
70,Fail,50,21,0,15,35
70,Fail,56,20,3,9,47
70,Fail,47,28,0,13,34
70,Fail,53,26,0,7,46
70,Fail,48,29,3,12,36
70,Fail,45,28,0,15,30
70,Fail,46,32,0,11,35
70,Fail,38,40,0,10,28
70,Fail,45,31,0,12,33
70,Fail,47,30,3,10,37
70,Fail,49,32,0,10,39
70,Fail,52,28,0,8,44
70,Fail,52,29,1,7,45
70,Fail,54,22,0,12,42
70,Fail,50,19,7,11,39
70,Fail,47,31,0,11,36
70,Fail,47,29,0,14,33
70,Fail,39,33,0,17,22
70,Fail,42,34,0,17,25
70,Fail,51,26,0,13,38
70,Fail,52,24,1,12,40
70,Fail,49,23,0,11,38
70,Fail,50,25,1,9,41
70,Fail,52,28,2,9,43
70,Fail,43,34,1,12,31
70,Fail,44,30,0,17,27
70,Fail,54,23,6,9,45
70,Fail,39,30,0,24,15
70,Fail,47,23,4,11,36
70,Fail,45,32,0,13,32
70,Fail,50,27,3,9,41
70,Fail,48,31,0,13,35
70,Fail,47,31,0,13,34
70,Fail,44,31,0,12,32
70,Fail,46,24,4,12,34
70,Fail,46,30,0,13,33
70,Fail,56,24,0,4,52
70,Fail,57,22,0,7,50
70,Fail,44,20,6,19,25
70,Fail,56,21,0,10,46
70,Fail,42,28,4,14,28
70,Fail,50,25,0,15,35
70,Fail,50,31,0,10,40
70,Fail,55,27,0,4,51
70,Fail,42,38,0,10,32
70,Fail,51,24,0,10,41
70,Fail,49,31,0,11,38
70,Fail,46,27,0,18,28
70,Fail,49,22,2,15,34
70,Fail,37,36,6,12,25
70,Fail,45,31,0,13,32
70,Fail,55,19,1,8,47
70,Fail,45,35,0,10,35
70,Fail,45,28,0,19,26
70,Fail,51,21,2,18,33
70,Fail,51,34,0,6,45
70,Fail,48,29,0,15,33
70,Fail,42,27,2,19,23
70,Fail,49,27,2,12,37
70,Fail,55,26,0,8,47
70,Fail,53,23,0,12,41
70,Fail,54,27,0,9,45
70,Fail,52,24,0,14,38
70,Fail,55,26,0,8,47
70,Fail,52,22,0,15,37
70,Fail,54,21,1,13,41
70,Fail,47,29,0,18,29
70,Fail,48,27,0,16,32
70,Fail,40,33,1,12,28
70,Fail,53,29,0,8,45
70,Fail,40,40,0,14,26
70,Fail,51,25,0,14,37
70,Fail,51,24,2,9,42
70,Fail,49,27,0,12,37
70,Fail,44,32,0,16,28
70,Fail,47,31,0,9,38
70,Fail,54,26,0,8,46
70,Fail,51,23,0,15,36
70,Fail,42,27,11,12,30
70,Fail,42,28,0,15,27
70,Fail,56,24,0,8,48
70,Fail,38,36,0,16,22
70,Fail,50,23,8,10,40
70,Fail,47,23,3,17,30
70,Fail,48,31,0,14,34
70,Fail,47,37,0,11,36
70,Fail,45,26,2,16,29
70,Fail,41,28,2,18,23
70,Fail,50,27,8,10,40
70,Fail,42,24,7,17,25
70,Fail,52,24,0,10,42
70,Fail,48,21,0,20,28
70,Fail,57,20,4,6,51
70,Fail,39,29,11,16,23
70,Fail,48,23,2,16,32
70,Fail,51,20,1,15,36
70,Fail,46,24,0,19,27
70,Fail,50,29,3,5,45
70,Fail,41,35,0,13,28
70,Fail,45,43,0,3,42
70,Fail,47,27,3,10,37
70,Fail,57,20,1,10,47
70,Fail,52,17,3,18,34
70,Fail,44,41,0,7,37
70,Fail,43,25,1,19,24
70,Fail,43,27,2,13,30
70,Fail,51,24,2,8,43
70,Fail,55,24,0,9,46
70,Fail,46,29,0,12,34
70,Fail,41,33,0,15,26
70,Fail,46,22,0,18,28
70,Fail,54,28,0,10,44
70,Fail,42,37,0,13,29
70,Fail,44,33,1,13,31
70,Fail,46,25,2,14,32
70,Fail,51,22,7,11,40
70,Fail,52,27,0,13,39
70,Fail,51,25,0,16,35
70,Fail,46,25,8,12,34
70,Fail,51,20,3,15,36
70,Fail,53,23,0,12,41
70,Fail,42,24,13,14,28
70,Fail,52,23,0,15,37
70,Fail,48,31,0,10,38
70,Fail,59,13,0,14,45
70,Fail,46,24,0,20,26
70,Fail,47,24,0,17,30
70,Fail,43,27,6,16,27
70,Fail,52,30,0,9,43
70,Fail,42,42,0,10,32
70,Fail,52,21,2,17,35
70,Fail,38,29,7,17,21
70,Fail,47,23,0,17,30
70,Fail,49,26,0,16,33
70,Fail,43,27,9,16,27
70,Fail,47,36,0,7,40
70,Fail,41,31,0,18,23
70,Fail,40,30,5,15,25
70,Fail,48,30,0,12,36
70,Fail,50,23,0,10,40
70,Fail,39,38,2,10,29
70,Fail,52,23,4,10,42
70,Fail,53,25,0,12,41
70,Fail,50,29,0,13,37
70,Fail,54,21,0,14,40
70,Fail,42,32,0,17,25
70,Fail,46,32,0,16,30
70,Fail,52,21,5,12,40
70,Fail,45,36,0,8,37
70,Fail,48,21,2,16,32
70,Fail,49,24,3,15,34
70,Fail,51,28,0,9,42
70,Fail,47,26,1,16,31
70,Fail,48,20,3,18,30
70,Fail,49,27,1,13,36
70,Fail,46,33,0,13,33
70,Fail,49,30,0,10,39
70,Fail,45,25,0,14,31
70,Fail,49,32,0,12,37
70,Fail,42,34,0,11,31
70,Fail,41,40,0,11,30
70,Fail,54,25,0,10,44
70,Fail,45,32,0,13,32
70,Fail,44,26,0,19,25
70,Fail,50,24,10,6,44
70,Fail,50,24,0,17,33
70,Fail,51,30,0,10,41
70,Fail,44,21,9,14,30
70,Fail,44,33,0,14,30
70,Fail,38,35,0,15,23
70,Fail,52,22,0,16,36
70,Fail,37,39,0,15,22
70,Fail,52,18,4,11,41
70,Fail,52,23,2,13,39
70,Fail,47,28,0,11,36
70,Fail,32,37,0,17,15
70,Fail,51,26,5,7,44
70,Fail,43,32,0,17,26
70,Fail,50,25,0,11,39
70,Fail,47,30,0,13,34
70,Fail,49,31,0,11,38
70,Fail,45,31,0,13,32
70,Fail,45,23,6,17,28
70,Fail,56,22,0,12,44
70,Fail,53,20,2,12,41
70,Fail,50,23,0,14,36
70,Fail,54,20,0,12,42
70,Fail,49,29,0,10,39
70,Fail,50,25,0,13,37
70,Fail,45,25,4,11,34
70,Fail,39,34,0,15,24
70,Fail,53,20,1,16,37
70,Fail,52,23,0,11,41
70,Fail,42,37,0,15,27
70,Fail,56,22,0,11,45
70,Fail,50,28,0,11,39
70,Fail,48,23,3,16,32
70,Fail,57,26,0,6,51
70,Fail,44,32,0,13,31
70,Fail,49,28,3,10,39
70,Fail,57,25,1,9,48
70,Fail,53,23,0,8,45
70,Fail,51,24,0,14,37
70,Fail,36,28,0,21,15
70,Fail,44,41,0,8,36
70,Fail,45,26,1,16,29
70,Fail,50,25,6,11,39
70,Fail,48,29,0,16,32
70,Fail,50,27,2,9,41
70,Fail,45,21,6,17,28
70,Fail,54,24,0,11,43
70,Fail,54,18,0,13,41
70,Fail,43,31,0,13,30
70,Fail,46,37,0,7,39
70,Fail,44,29,0,18,26
70,Fail,42,28,8,14,28
70,Fail,46,27,8,9,37
70,Fail,40,28,4,18,22
70,Fail,50,25,7,11,39
70,Fail,46,27,9,9,37
70,Fail,48,26,7,13,35
70,Fail,42,39,0,10,32
70,Fail,57,16,0,16,41
70,Fail,43,35,0,12,31
70,Fail,55,27,1,8,47
70,Fail,39,39,0,16,23
70,Fail,52,26,0,9,43
70,Fail,52,22,7,10,42
70,Fail,47,27,0,15,32
70,Fail,53,26,0,14,39
70,Fail,43,30,0,11,32
70,Fail,41,34,7,8,33
70,Fail,51,23,2,12,39
70,Fail,53,26,0,9,44
70,Fail,39,36,0,17,22
70,Fail,42,35,0,10,32
70,Fail,52,25,0,11,41
70,Fail,49,25,7,10,39
70,Fail,49,26,1,12,37
70,Fail,45,30,0,14,31
70,Fail,51,24,4,7,44
70,Fail,55,22,0,10,45
70,Fail,49,29,1,12,37
70,Fail,40,38,0,15,25
70,Fail,35,38,0,18,17
70,Fail,47,28,0,16,31
70,Fail,41,31,10,11,30
70,Fail,43,27,5,14,29
70,Fail,52,22,3,12,40
70,Fail,46,25,0,17,29
70,Fail,44,31,0,18,26
70,Fail,50,16,1,17,33
70,Fail,40,36,0,18,22
70,Fail,55,21,0,8,47
70,Fail,52,27,1,8,44
70,Fail,53,24,0,14,39
70,Fail,52,18,6,12,40
70,Fail,50,25,0,12,38
70,Fail,50,27,0,13,37
70,Fail,43,32,0,11,32
70,Fail,52,18,6,17,35
70,Fail,57,25,0,8,49
70,Fail,44,25,14,11,33
70,Fail,54,22,0,13,41
70,Fail,42,23,11,17,25
70,Fail,51,23,0,10,41
70,Fail,44,39,0,11,33
70,Fail,47,31,0,12,35
70,Fail,47,26,0,15,32
70,Fail,43,29,0,16,27
70,Fail,56,23,0,11,45
70,Fail,45,27,12,10,35
70,Fail,45,29,1,15,30
70,Fail,42,28,6,16,26
70,Fail,45,25,0,20,25
70,Fail,48,24,6,10,38
70,Fail,40,24,7,17,23
70,Fail,57,21,0,11,46
70,Fail,50,22,0,19,31
70,Fail,56,21,1,14,42
70,Fail,55,19,0,11,44
70,Fail,54,18,8,11,43
70,Fail,51,18,1,18,33
70,Fail,40,26,9,14,26
70,Fail,54,24,0,11,43
70,Fail,46,31,1,10,36
70,Fail,39,38,0,12,27
70,Fail,47,33,0,10,37
70,Fail,44,29,0,16,28
70,Fail,40,39,0,9,31
70,Fail,51,24,5,11,40
70,Fail,53,25,0,11,42
70,Fail,53,24,6,10,43
70,Fail,53,29,0,7,46
70,Fail,45,36,0,9,36
70,Fail,45,29,2,14,31
70,Fail,50,26,2,12,38
70,Fail,52,20,3,11,41
70,Fail,48,23,6,12,36
70,Fail,50,22,3,10,40
70,Fail,50,29,2,6,44
70,Fail,49,22,3,13,36
70,Fail,50,27,0,14,36
70,Fail,55,17,0,14,41
70,Fail,47,23,3,17,30
70,Fail,49,27,0,14,35
70,Fail,44,23,2,22,22
70,Fail,50,24,1,15,35
70,Fail,47,22,3,16,31
70,Fail,45,22,8,11,34
70,Fail,48,30,0,12,36
70,Fail,59,23,0,10,49
70,Fail,52,18,5,11,41
70,Fail,49,29,0,11,38
70,Fail,48,21,5,14,34
70,Fail,51,20,2,17,34
70,Fail,52,19,3,13,39
70,Fail,45,28,0,17,28
70,Fail,51,28,0,8,43
70,Fail,51,18,12,11,40
70,Fail,49,30,0,11,38
70,Fail,44,25,5,14,30
70,Fail,55,23,2,11,44
70,Fail,49,27,0,12,37
70,Fail,47,30,0,13,34
70,Fail,44,30,2,11,33
70,Fail,49,22,4,14,35
70,Fail,45,28,4,13,32
70,Fail,42,30,13,8,34
70,Fail,44,25,3,17,27
70,Fail,50,23,0,17,33
70,Fail,40,27,18,12,28
70,Fail,58,23,0,11,47
70,Fail,45,26,1,17,28
70,Fail,43,22,7,14,29
70,Fail,51,24,0,10,41
70,Fail,49,38,0,5,44
70,Fail,49,25,0,15,34
70,Fail,52,28,4,4,48
70,Fail,38,28,10,17,21
70,Fail,41,39,0,8,33
70,Fail,43,33,3,12,31
70,Fail,55,24,0,11,44
70,Fail,45,33,0,13,32
70,Fail,43,32,10,10,33
70,Fail,53,25,0,10,43
70,Fail,48,19,7,15,33
70,Fail,47,20,1,17,30
70,Fail,49,20,8,14,35
70,Fail,53,28,3,6,47
70,Fail,40,40,0,9,31
70,Fail,47,31,0,10,37
70,Fail,42,29,10,14,28
70,Fail,48,23,0,13,35
70,Fail,49,26,2,13,36
70,Fail,46,30,3,11,35
70,Fail,56,14,5,15,41
70,Fail,47,28,0,14,33
70,Fail,44,36,0,8,36
70,Fail,50,24,0,13,37
70,Fail,51,25,1,7,44
70,Fail,57,28,0,6,51
70,Fail,52,26,5,9,43
70,Fail,55,27,0,12,43
70,Fail,48,20,8,14,34
70,Fail,51,24,1,15,36
70,Fail,51,27,0,9,42
70,Fail,47,30,4,7,40
70,Fail,45,26,2,15,30
70,Fail,46,30,4,10,36
70,Fail,51,22,4,12,39
70,Fail,48,23,7,13,35
70,Fail,52,24,0,16,36
70,Fail,51,24,3,14,37
70,Fail,52,24,0,13,39
70,Fail,56,21,0,16,40
70,Fail,48,31,0,17,31
70,Fail,51,32,0,10,41
70,Fail,48,34,0,10,38
70,Fail,43,26,4,19,24
70,Fail,47,30,0,11,36
70,Fail,50,29,0,12,38
70,Fail,54,25,0,8,46
70,Fail,53,23,0,11,42
70,Fail,50,33,0,8,42
70,Fail,50,19,7,16,34
70,Fail,52,27,0,11,41
70,Fail,50,23,7,10,40
70,Fail,52,26,0,14,38
70,Fail,42,29,8,12,30
70,Fail,42,30,3,19,23
70,Fail,52,24,2,11,41
70,Fail,45,37,0,11,34
70,Fail,60,16,0,12,48
70,Fail,52,20,0,15,37
70,Fail,48,24,0,17,31
70,Fail,48,28,0,8,40
70,Fail,38,37,0,18,20
70,Fail,51,30,0,11,40
70,Fail,56,22,1,11,45
70,Fail,45,27,0,18,27
70,Fail,55,19,5,11,44
70,Fail,43,30,0,10,33
70,Fail,53,25,0,8,45
70,Fail,44,25,5,13,31
70,Fail,48,25,1,16,32
70,Fail,48,28,0,12,36
70,Fail,58,25,1,6,52
70,Fail,38,29,8,19,19
70,Fail,46,27,10,10,36
70,Fail,46,31,0,9,37
70,Fail,48,28,0,15,33
70,Fail,47,29,0,15,32
70,Fail,51,30,2,4,47
70,Fail,47,30,5,9,38
70,Fail,52,25,0,10,42
70,Fail,49,26,1,13,36
70,Fail,43,28,1,20,23
70,Fail,45,34,0,14,31
70,Fail,48,25,4,9,39
70,Fail,52,23,0,12,40
70,Fail,48,26,4,12,36
70,Fail,47,35,0,11,36
70,Fail,41,32,4,16,25
70,Fail,43,25,5,13,30
70,Fail,47,31,0,12,35
70,Fail,41,32,0,17,24
70,Fail,45,29,8,10,35
70,Fail,45,27,7,10,35
70,Fail,38,40,0,17,21
70,Fail,44,34,2,10,34
70,Fail,43,27,6,16,27
70,Fail,46,24,4,17,29
70,Fail,49,24,1,13,36
70,Fail,49,19,0,17,32
70,Fail,49,31,0,8,41
70,Fail,43,26,5,18,25
70,Fail,50,21,3,13,37
70,Fail,40,41,0,14,26
70,Fail,45,35,0,9,36
70,Fail,53,24,2,12,41
70,Fail,46,24,3,15,31
70,Fail,43,34,0,13,30
70,Fail,41,41,0,10,31
70,Fail,42,34,6,8,34
70,Fail,49,22,2,17,32
70,Fail,40,33,4,17,23
70,Fail,41,33,10,9,32
70,Fail,51,22,0,17,34
70,Fail,40,40,0,12,28
70,Fail,42,28,5,15,27
70,Fail,42,29,0,14,28
70,Fail,43,25,9,14,29
70,Fail,51,24,0,11,40
70,Fail,49,18,5,19,30
70,Fail,48,24,0,13,35
70,Fail,47,25,4,12,35
70,Fail,42,31,0,20,22
70,Fail,36,32,5,18,18
70,Fail,41,37,0,12,29
70,Fail,45,32,3,8,37
70,Fail,48,30,0,7,41
70,Fail,47,27,1,16,31
70,Fail,50,25,0,11,39
70,Fail,50,31,0,10,40
70,Fail,57,19,1,10,47
70,Fail,52,23,2,10,42
70,Fail,42,29,1,18,24
70,Fail,56,19,3,10,46
70,Fail,43,28,9,14,29
70,Fail,44,27,6,16,28
70,Fail,46,29,0,16,30
70,Fail,43,40,0,11,32
70,Fail,53,22,0,14,39
70,Fail,47,26,0,15,32
70,Fail,46,31,0,15,31
70,Fail,48,34,0,12,36
70,Fail,47,26,5,13,34
70,Fail,47,23,0,18,29
70,Fail,54,30,0,7,47
70,Fail,50,22,0,17,33
70,Fail,41,33,2,12,29
70,Fail,54,20,2,13,41
70,Fail,48,22,3,13,35
70,Fail,51,32,0,10,41
70,Fail,45,39,0,7,38
70,Fail,38,35,6,11,27
70,Fail,46,26,0,15,31
70,Fail,49,18,0,20,29
70,Fail,44,33,0,14,30
70,Fail,54,19,1,12,42
70,Fail,43,27,6,15,28
70,Fail,38,26,8,18,20
70,Fail,48,19,2,18,30
70,Fail,52,30,3,8,44
70,Fail,45,33,0,12,33
70,Fail,49,30,0,12,37
70,Fail,45,39,0,6,39
70,Fail,48,21,3,14,34
70,Fail,56,20,0,10,46
70,Fail,44,29,0,12,32
70,Fail,46,29,0,12,34
70,Fail,50,30,0,10,40
70,Fail,45,27,2,15,30
70,Fail,54,22,0,13,41
70,Fail,50,22,8,12,38
70,Fail,50,26,0,13,37
70,Fail,51,10,7,18,33
70,Fail,56,18,0,12,44
70,Fail,42,32,0,14,28
70,Fail,41,34,0,16,25
70,Fail,45,31,0,16,29
70,Fail,47,37,0,7,40
70,Fail,47,30,0,11,36
70,Fail,56,14,0,16,40
70,Fail,46,29,0,14,32
70,Fail,53,27,0,7,46
70,Fail,50,22,8,12,38
70,Fail,49,26,0,13,36
70,Fail,51,28,0,11,40
70,Fail,42,26,3,19,23
70,Fail,47,33,0,11,36
70,Fail,49,29,0,14,35
70,Fail,38,28,8,19,19
70,Fail,44,34,0,12,32
70,Fail,41,45,0,12,29
70,Fail,49,21,1,19,30
70,Fail,50,22,0,15,35
70,Fail,47,23,2,16,31
70,Fail,46,34,0,11,35
70,Fail,48,29,0,14,34
70,Fail,51,27,0,9,42
70,Fail,47,29,0,7,40
70,Fail,46,29,1,15,31
70,Fail,54,20,0,10,44
70,Fail,52,21,0,12,40
70,Fail,49,22,0,20,29
70,Fail,47,23,6,14,33
70,Fail,53,21,2,13,40
70,Fail,48,23,8,13,35
70,Fail,55,20,0,14,41
70,Fail,52,25,1,10,42
70,Fail,44,28,5,13,31
70,Fail,37,38,0,13,24
70,Fail,52,27,0,11,41
70,Fail,39,27,2,21,18
70,Fail,54,24,1,10,44
70,Fail,47,23,6,14,33
70,Fail,42,34,1,8,34
70,Fail,48,19,11,16,32
70,Fail,58,18,1,14,44
70,Fail,50,28,3,9,41
70,Fail,49,28,0,9,40
70,Fail,47,26,7,13,34
70,Fail,51,27,1,9,42
70,Fail,46,32,0,10,36
70,Fail,48,30,0,16,32
70,Fail,49,34,0,9,40
70,Fail,48,27,4,12,36
70,Fail,61,16,0,14,47
70,Fail,46,31,6,9,37
70,Fail,37,28,10,14,23
70,Fail,51,22,3,11,40
70,Fail,54,25,3,12,42
70,Fail,45,29,0,13,32
70,Fail,49,29,0,8,41
70,Fail,49,28,2,12,37
70,Fail,45,26,0,18,27
70,Fail,46,27,0,12,34
70,Fail,49,29,2,8,41
70,Fail,46,41,0,9,37
70,Fail,42,31,0,18,24
70,Fail,47,29,4,12,35
70,Fail,45,32,8,8,37
70,Fail,44,33,0,14,30
70,Fail,44,25,7,15,29
70,Fail,45,16,7,20,25
70,Fail,50,22,0,15,35
70,Fail,51,25,8,8,43
70,Fail,39,40,0,11,28
70,Fail,46,29,0,16,30
70,Fail,45,26,0,17,28
70,Fail,58,21,0,7,51
70,Fail,47,31,0,10,37
70,Fail,52,21,2,16,36
70,Fail,49,23,0,13,36
70,Fail,40,35,0,17,23
70,Fail,46,29,2,12,34
70,Fail,55,19,1,14,41
70,Fail,45,34,0,12,33
70,Fail,45,30,0,12,33
70,Fail,44,30,0,14,30
70,Fail,46,21,8,11,35
70,Fail,45,37,0,10,35
70,Fail,56,27,0,7,49
70,Fail,44,26,6,18,26
70,Fail,54,22,2,12,42
70,Fail,43,37,0,12,31
70,Fail,52,24,1,11,41
70,Fail,52,28,0,11,41
70,Fail,46,26,1,13,33
70,Fail,53,24,3,13,40
70,Fail,55,19,1,13,42
70,Fail,45,36,0,7,38
70,Fail,46,29,0,14,32
70,Fail,42,31,0,16,26
70,Fail,49,25,10,6,43
70,Fail,49,24,6,13,36
70,Fail,49,24,5,16,33
70,Fail,55,24,0,8,47
70,Fail,50,25,0,14,36
70,Fail,46,31,0,12,34
70,Fail,51,25,0,15,36
70,Fail,51,29,0,11,40
70,Fail,43,36,0,11,32
70,Fail,52,27,0,11,41
70,Fail,51,27,1,7,44
70,Fail,48,29,0,12,36
70,Fail,47,27,2,15,32
70,Fail,53,29,0,8,45
70,Fail,44,23,9,15,29
70,Fail,41,35,0,13,28
70,Fail,49,24,0,11,38
70,Fail,44,28,3,17,27
70,Fail,51,26,2,11,40
70,Fail,44,27,0,17,27
70,Fail,52,29,1,6,46
70,Fail,50,21,1,15,35
70,Fail,37,34,0,18,19
70,Fail,46,30,0,13,33
70,Fail,43,37,0,16,27
70,Fail,52,22,0,18,34
70,Fail,52,23,0,13,39
70,Fail,46,23,9,10,36
70,Fail,48,24,8,10,38
70,Fail,48,23,2,10,38
70,Fail,50,32,0,8,42
70,Fail,51,22,0,14,37
70,Fail,53,23,0,11,42
70,Fail,52,20,2,16,36
70,Fail,55,19,12,9,46
70,Fail,48,32,0,12,36
70,Fail,53,17,0,15,38
70,Fail,50,23,3,14,36
70,Fail,52,22,4,12,40
70,Fail,45,23,8,16,29
70,Fail,51,23,0,14,37
70,Fail,56,21,2,9,47
70,Fail,45,27,1,19,26
70,Fail,48,30,0,12,36
70,Fail,43,19,8,22,21
70,Fail,51,27,0,13,38
70,Fail,48,27,0,17,31
70,Fail,48,28,6,8,40
70,Fail,46,31,4,10,36
70,Fail,46,32,3,10,36
70,Fail,47,28,0,12,35
70,Fail,45,27,5,12,33
70,Fail,48,29,0,14,34
70,Fail,48,34,0,12,36
70,Fail,49,17,6,15,34
70,Fail,45,37,0,10,35
70,Fail,56,23,6,7,49
70,Fail,43,38,0,11,32
70,Fail,54,23,1,14,40
70,Fail,44,30,4,11,33
70,Fail,49,27,5,14,35
70,Fail,47,24,2,13,34
70,Fail,51,21,0,16,35
70,Fail,52,23,7,9,43
70,Fail,52,25,0,15,37
70,Fail,50,29,5,6,44
70,Fail,50,25,0,13,37
70,Fail,50,23,0,16,34
70,Fail,53,19,3,11,42
70,Fail,49,25,0,12,37
70,Fail,47,20,8,17,30
70,Fail,46,24,2,13,33
70,Fail,47,29,0,12,35
70,Fail,53,26,6,5,48
70,Fail,51,24,0,13,38
70,Fail,52,26,0,14,38
70,Fail,46,34,0,9,37
70,Fail,46,34,0,13,33
70,Fail,47,31,6,11,36
70,Fail,52,19,0,19,33
70,Fail,44,35,0,15,29
70,Fail,49,22,9,11,38
70,Fail,54,26,0,8,46
70,Fail,49,21,11,9,40
70,Fail,40,30,0,16,24
70,Fail,47,27,0,15,32
70,Fail,46,25,4,14,32
70,Fail,48,23,7,12,36
70,Fail,46,28,0,17,29
70,Fail,37,41,0,12,25
70,Fail,49,27,0,13,36
70,Fail,38,31,0,22,16
70,Fail,46,26,0,16,30
70,Fail,49,31,0,10,39
70,Fail,49,28,0,8,41
70,Fail,43,25,9,14,29
70,Fail,48,34,0,13,35
70,Fail,44,28,5,9,35
70,Fail,48,29,0,14,34
70,Fail,45,31,0,14,31
70,Fail,44,30,4,11,33
70,Fail,41,34,0,14,27
70,Fail,50,25,0,13,37
70,Fail,49,28,2,11,38
70,Fail,47,27,0,15,32
70,Fail,50,29,0,9,41
70,Fail,50,20,6,14,36
70,Fail,50,28,0,10,40
70,Fail,61,20,0,10,51
70,Fail,52,19,2,17,35
70,Fail,45,32,4,7,38
70,Fail,48,25,4,12,36
70,Fail,44,23,3,19,25
70,Fail,52,27,4,6,46
70,Fail,49,22,11,13,36
70,Fail,50,26,0,13,37
70,Fail,55,20,6,9,46
70,Fail,43,31,0,15,28
70,Fail,51,18,3,16,35
70,Fail,52,21,4,12,40
70,Fail,42,29,0,16,26
70,Fail,41,28,6,15,26
70,Fail,41,31,0,12,29
70,Fail,41,26,10,16,25
70,Fail,50,24,0,15,35
70,Fail,44,30,0,18,26
70,Fail,51,22,0,16,35
70,Fail,50,23,0,11,39
70,Fail,56,17,1,15,41
70,Fail,49,26,1,10,39
70,Fail,45,29,5,13,32
70,Fail,52,22,3,13,39
70,Fail,48,30,5,9,39
70,Fail,40,27,1,14,26
70,Fail,54,22,0,12,42
70,Fail,56,17,2,15,41
70,Fail,48,24,0,17,31
70,Fail,43,38,0,11,32
70,Fail,48,26,0,16,32
70,Fail,44,28,12,11,33
70,Fail,43,27,8,14,29
70,Fail,51,31,0,11,40
70,Fail,59,27,0,7,52
70,Fail,51,22,6,16,35
70,Fail,49,22,0,16,33
70,Fail,49,34,0,10,39
70,Fail,51,27,0,10,41
70,Fail,48,29,0,15,33
70,Fail,52,19,6,14,38
70,Fail,45,36,0,12,33
70,Fail,40,33,0,16,24
70,Fail,48,29,0,13,35
70,Fail,51,28,0,9,42
70,Fail,51,16,3,14,37
70,Fail,47,23,0,17,30
70,Fail,51,24,0,12,39
70,Fail,43,31,9,9,34
70,Fail,46,29,0,13,33
70,Fail,44,24,2,19,25
70,Fail,46,24,4,17,29
70,Fail,55,26,1,7,48
70,Fail,45,34,0,12,33
70,Fail,54,19,4,15,39
70,Fail,52,19,4,14,38
70,Fail,52,19,4,13,39
70,Fail,45,31,0,15,30
70,Fail,46,24,5,15,31
70,Fail,51,24,3,10,41
70,Fail,51,25,0,14,37
70,Fail,52,27,0,13,39
70,Fail,52,25,2,10,42
70,Fail,41,32,6,16,25
70,Fail,55,22,0,11,44
70,Fail,46,38,0,8,38
70,Fail,56,20,3,11,45
70,Fail,47,23,0,20,27
70,Fail,52,30,2,5,47
70,Fail,54,24,0,9,45
70,Fail,46,29,4,13,33
70,Fail,52,20,4,11,41
70,Fail,39,38,6,8,31
70,Fail,51,20,0,16,35
70,Fail,50,24,0,12,38
70,Fail,46,32,1,14,32
70,Fail,46,22,7,13,33
70,Fail,43,38,0,11,32
70,Fail,55,19,0,13,42
70,Fail,44,24,0,19,25
70,Fail,43,35,0,10,33
70,Fail,45,32,0,15,30
70,Fail,48,27,0,15,33
70,Fail,50,25,2,12,38
70,Fail,46,29,0,14,32
70,Fail,44,32,0,11,33
70,Fail,37,31,6,19,18
70,Fail,40,27,5,15,25
70,Fail,51,18,8,12,39
70,Fail,45,26,5,14,31
70,Fail,41,30,0,16,25
70,Fail,55,18,0,11,44
70,Fail,48,34,0,8,40
70,Fail,47,22,0,20,27
70,Fail,49,31,0,9,40
70,Fail,51,25,0,14,37
70,Fail,47,25,3,16,31
70,Fail,54,17,2,13,41
70,Fail,40,27,8,16,24
70,Fail,45,28,0,15,30
70,Fail,50,33,0,10,40
70,Fail,54,18,3,16,38
70,Fail,46,31,0,11,35
70,Fail,46,32,0,11,35
70,Fail,47,26,2,14,33
70,Fail,48,20,0,17,31
70,Fail,49,29,0,13,36
70,Fail,44,28,0,14,30
70,Fail,49,24,5,12,37
70,Fail,47,30,4,9,38
70,Fail,52,26,4,9,43
70,Fail,53,25,0,10,43
70,Fail,42,31,0,14,28
70,Fail,43,36,3,11,32
70,Fail,43,32,0,18,25
70,Fail,43,29,0,19,24
70,Fail,52,20,2,13,39
70,Fail,52,20,0,13,39
70,Fail,43,41,0,10,33
70,Fail,58,24,0,8,50
70,Fail,47,28,2,16,31
70,Fail,46,26,0,18,28
70,Fail,48,26,3,13,35
70,Fail,47,30,0,13,34
70,Fail,48,25,0,16,32
70,Fail,46,29,0,16,30
70,Fail,51,22,3,12,39
70,Fail,49,29,2,9,40
70,Fail,46,21,0,18,28
70,Fail,47,27,0,14,33
70,Fail,41,39,0,10,31
70,Fail,47,31,0,13,34
70,Fail,46,26,3,10,36
70,Fail,50,21,0,13,37
70,Fail,56,30,0,7,49
70,Fail,51,20,4,11,40
70,Fail,55,27,0,7,48
70,Fail,53,23,3,10,43
70,Fail,54,25,0,10,44
70,Fail,48,28,5,8,40
70,Fail,53,28,0,9,44
70,Fail,49,33,0,10,39
70,Fail,43,31,3,12,31
70,Fail,50,22,3,12,38
70,Fail,50,24,6,9,41
70,Fail,51,21,0,10,41
70,Fail,49,24,3,9,40
70,Fail,50,35,0,7,43
70,Fail,43,33,0,13,30
70,Fail,51,21,2,15,36
70,Fail,47,30,0,10,37
70,Fail,52,23,0,10,42
70,Fail,57,25,0,8,49
70,Fail,43,28,1,16,27
70,Fail,43,30,0,16,27
70,Fail,54,20,0,10,44
70,Fail,45,22,5,16,29
70,Fail,54,17,4,13,41
70,Fail,46,35,0,11,35
70,Fail,56,20,0,12,44
70,Fail,44,32,0,16,28
70,Fail,46,24,7,15,31
70,Fail,52,25,4,6,46
70,Fail,52,19,3,16,36
70,Fail,44,28,2,16,28
70,Fail,45,29,0,15,30
70,Fail,43,19,4,25,18
70,Fail,53,22,0,11,42
70,Fail,40,35,0,14,26
70,Fail,49,22,2,16,33
70,Fail,55,27,0,10,45
70,Fail,59,24,0,9,50
70,Fail,41,25,4,20,21
70,Fail,52,22,4,11,41
70,Fail,49,29,0,15,34
70,Fail,53,24,6,11,42
70,Fail,51,29,0,8,43
70,Fail,50,21,3,14,36
70,Fail,46,25,2,14,32
70,Fail,46,24,6,15,31
70,Fail,45,26,1,19,26
70,Fail,43,27,0,17,26
70,Fail,41,34,0,14,27
70,Fail,55,24,0,11,44
70,Fail,51,22,1,13,38
70,Fail,52,30,0,7,45
70,Fail,43,38,0,11,32
70,Fail,45,30,1,13,32
70,Fail,51,17,3,19,32
70,Fail,43,29,4,14,29
70,Fail,42,34,0,14,28
70,Fail,53,33,0,7,46
70,Fail,44,32,3,12,32
70,Fail,51,28,5,9,42
70,Fail,50,28,0,12,38
70,Fail,51,26,4,9,42
70,Fail,47,32,0,16,31
70,Fail,49,28,3,11,38
70,Fail,51,28,2,9,42
70,Fail,43,27,0,19,24
70,Fail,48,29,0,11,37
70,Fail,53,30,2,9,44
70,Fail,48,29,0,11,37
70,Fail,47,25,4,13,34
70,Fail,49,24,2,15,34
70,Fail,52,20,2,14,38
70,Fail,53,22,0,11,42
70,Fail,45,23,0,20,25
70,Fail,54,23,0,11,43
70,Fail,51,22,1,13,38
70,Fail,61,19,0,9,52
70,Fail,42,34,0,13,29
70,Fail,44,32,0,16,28
70,Fail,53,22,0,9,44
70,Fail,45,34,0,8,37
70,Fail,52,16,3,18,34
70,Fail,47,30,8,8,39
70,Fail,45,32,0,12,33
70,Fail,49,24,0,15,34
70,Fail,42,29,0,19,23
70,Fail,44,30,0,15,29
70,Fail,45,32,0,12,33
70,Fail,48,27,0,16,32
70,Fail,50,20,2,17,33
70,Fail,50,23,4,12,38
70,Fail,44,34,0,11,33
70,Fail,50,22,0,14,36
70,Fail,47,30,0,15,32
70,Fail,57,14,6,12,45
70,Fail,52,13,10,14,38
70,Fail,47,27,8,8,39
70,Fail,49,23,2,18,31
70,Fail,53,20,0,14,39
70,Fail,52,29,1,10,42
70,Fail,51,25,0,11,40
70,Fail,47,28,0,12,35
70,Fail,46,30,0,14,32
70,Fail,39,28,5,13,26
70,Fail,50,26,0,9,41
70,Fail,45,30,2,11,34
70,Fail,50,29,0,12,38
70,Fail,52,29,0,10,42
70,Fail,40,28,4,17,23
70,Fail,51,24,0,11,40
70,Fail,49,34,0,8,41
70,Fail,52,24,0,11,41
70,Fail,47,34,0,11,36
70,Fail,47,28,0,10,37
70,Fail,49,26,2,12,37
70,Fail,49,30,0,7,42
70,Fail,47,24,9,10,37
70,Fail,49,26,0,14,35
70,Fail,46,29,0,16,30
70,Fail,46,33,0,11,35
70,Fail,40,29,9,13,27
70,Fail,54,24,0,10,44
70,Fail,52,23,6,10,42
70,Fail,49,26,0,14,35
70,Fail,53,28,0,11,42
70,Fail,44,31,0,13,31
70,Fail,55,22,0,14,41
70,Fail,50,25,0,9,41
70,Fail,41,24,9,17,24
70,Fail,45,27,10,13,32
70,Fail,54,28,0,9,45
70,Fail,48,21,3,14,34
70,Fail,52,27,0,10,42
70,Fail,52,24,1,9,43
70,Fail,41,32,0,20,21
70,Fail,46,40,0,6,40
70,Fail,52,27,4,7,45
70,Fail,48,30,0,16,32
70,Fail,46,32,0,11,35
70,Fail,49,23,0,13,36
70,Fail,48,24,4,13,35
70,Fail,46,23,5,13,33
70,Fail,46,24,0,19,27
70,Fail,51,26,0,8,43
70,Fail,52,29,1,7,45
70,Fail,49,22,1,18,31
70,Fail,51,23,3,14,37
70,Fail,51,28,0,14,37
70,Fail,46,31,0,16,30
70,Fail,40,33,0,17,23
70,Fail,53,22,0,16,37
70,Fail,42,28,12,9,33
70,Fail,45,35,0,11,34
70,Fail,57,17,0,15,42
70,Fail,42,28,6,14,28
70,Fail,48,22,8,9,39
70,Fail,43,30,2,13,30
70,Fail,49,25,0,16,33
70,Fail,48,37,2,4,44
70,Fail,46,33,0,10,36
70,Fail,46,20,3,16,30
70,Fail,50,25,0,11,39
70,Fail,45,24,4,14,31
70,Fail,48,22,7,11,37
70,Fail,52,24,0,10,42
70,Fail,53,26,0,5,48
70,Fail,46,32,4,9,37
70,Fail,44,21,1,21,23
70,Fail,53,22,0,13,40
70,Fail,48,28,2,8,40
70,Fail,50,18,6,12,38
70,Fail,41,34,0,13,28
70,Fail,45,27,9,12,33
70,Fail,49,24,3,13,36
70,Fail,50,31,0,8,42
70,Fail,42,27,4,14,28
70,Fail,50,28,0,10,40
70,Fail,49,28,6,8,41
70,Fail,50,22,0,15,35
70,Fail,47,24,3,16,31
70,Fail,53,21,2,13,40
70,Fail,45,21,10,18,27
70,Fail,49,25,0,13,36
70,Fail,45,33,0,16,29
70,Fail,47,26,1,14,33
70,Fail,50,28,0,13,37
70,Fail,46,21,2,16,30
70,Fail,53,18,0,16,37
70,Fail,57,20,0,11,46
70,Fail,51,24,4,10,41
70,Fail,47,30,0,12,35
70,Fail,47,30,0,10,37
70,Fail,47,30,0,11,36
70,Fail,52,20,2,12,40
70,Fail,51,23,0,15,36
70,Fail,45,29,0,15,30
70,Fail,48,30,0,10,38
70,Fail,54,29,0,14,40
70,Fail,56,20,3,10,46
70,Fail,45,34,0,12,33
70,Fail,45,30,1,13,32
70,Fail,37,34,0,19,18
70,Fail,55,33,0,7,48
70,Fail,56,21,1,9,47
70,Fail,37,34,6,19,18
70,Fail,50,21,5,12,38
70,Fail,50,20,11,10,40
70,Fail,44,27,5,16,28
70,Fail,43,34,0,14,29
70,Fail,47,34,0,9,38
70,Fail,52,27,0,12,40
70,Fail,42,39,0,11,31
70,Fail,48,27,2,8,40
70,Fail,50,20,0,18,32
70,Fail,49,23,3,12,37
70,Fail,48,26,3,12,36
70,Fail,47,20,12,11,36
70,Fail,43,25,0,21,22
70,Fail,52,25,0,13,39
70,Fail,51,26,2,11,40
70,Fail,53,23,1,12,41
70,Fail,56,26,0,8,48
70,Fail,48,25,2,15,33
70,Fail,44,33,0,11,33
70,Fail,53,24,9,9,44
70,Fail,44,28,6,10,34
70,Fail,48,33,0,11,37
70,Fail,53,23,0,11,42
70,Fail,52,19,10,11,41
70,Fail,39,37,0,13,26
70,Fail,47,27,2,14,33
70,Fail,49,24,0,15,34
70,Fail,46,22,0,20,26
70,Fail,46,33,0,12,34
70,Fail,55,26,0,8,47
70,Fail,54,22,0,14,40
70,Fail,51,27,0,10,41
70,Fail,48,21,2,18,30
70,Fail,53,28,0,9,44
70,Fail,57,21,1,9,48
70,Fail,48,24,0,12,36
70,Fail,53,19,2,14,39
70,Fail,44,25,1,16,28
70,Fail,51,33,0,7,44
70,Fail,47,25,8,11,36
70,Fail,42,25,1,17,25
70,Fail,51,22,0,11,40
70,Fail,48,30,0,12,36
70,Fail,45,33,0,12,33
70,Fail,46,20,9,15,31
70,Fail,51,24,6,8,43
70,Fail,44,26,4,19,25
70,Fail,53,27,2,8,45
70,Fail,55,26,0,10,45
70,Fail,55,20,0,13,42
70,Fail,47,25,9,8,39
70,Fail,48,24,6,14,34
70,Fail,47,27,0,12,35
70,Fail,46,31,0,13,33
70,Fail,49,28,0,12,37
70,Fail,36,42,0,12,24
70,Fail,49,29,0,10,39
70,Fail,52,20,2,14,38
70,Fail,40,30,8,13,27
70,Fail,49,29,1,13,36
70,Fail,55,24,0,10,45
70,Fail,50,20,6,14,36
70,Fail,50,22,10,9,41
70,Fail,51,21,1,14,37
70,Fail,50,25,0,12,38
70,Fail,38,31,8,15,23
70,Fail,51,23,0,15,36
70,Fail,42,23,2,21,21
70,Fail,47,35,0,10,37
70,Fail,46,24,7,11,35
70,Fail,53,25,0,12,41
70,Fail,43,26,6,16,27
70,Fail,48,21,3,15,33
70,Fail,51,25,0,14,37
70,Fail,40,22,14,18,22
70,Fail,49,26,1,15,34
70,Fail,46,26,0,19,27
70,Fail,45,38,0,11,34
70,Fail,46,20,3,15,31
70,Fail,39,28,10,14,25
70,Fail,45,30,0,16,29
70,Fail,48,32,0,11,37
70,Fail,51,27,0,9,42
70,Fail,45,34,0,12,33
70,Fail,49,34,0,7,42
70,Fail,37,28,7,18,19
70,Fail,49,36,0,5,44
70,Fail,49,24,0,15,34
70,Fail,43,31,1,12,31
70,Fail,45,25,10,8,37
70,Fail,46,34,5,6,40
70,Fail,47,25,0,15,32
70,Fail,50,26,8,9,41
70,Fail,54,23,0,10,44
70,Fail,48,25,7,11,37
70,Fail,50,25,0,15,35
70,Fail,48,22,6,16,32
70,Fail,50,29,0,11,39
70,Fail,48,22,2,17,31
70,Fail,50,25,5,8,42
70,Fail,50,28,0,11,39
70,Fail,46,29,0,15,31
70,Fail,55,25,0,10,45
70,Fail,47,28,1,11,36
70,Fail,45,25,4,14,31
70,Fail,49,25,0,13,36
70,Fail,47,32,8,6,41
70,Fail,53,26,0,10,43
70,Fail,49,28,0,11,38
70,Fail,56,24,0,9,47
70,Fail,48,30,0,15,33
70,Fail,56,28,2,5,51
70,Fail,48,36,0,9,39
70,Fail,49,27,0,11,38
70,Fail,43,30,0,16,27
70,Fail,46,27,2,13,33
70,Fail,59,22,0,5,54
70,Fail,42,38,0,12,30
70,Fail,53,22,7,7,46
70,Fail,41,40,0,14,27
70,Fail,49,23,4,13,36
70,Fail,47,29,5,14,33
70,Fail,56,19,1,14,42
70,Fail,55,21,3,15,40
70,Fail,43,36,0,15,28
70,Fail,52,30,0,10,42
70,Fail,47,23,1,18,29
70,Fail,48,20,2,18,30
70,Fail,42,33,0,11,31
70,Fail,48,30,0,13,35
70,Fail,50,23,1,16,34
70,Fail,45,31,0,9,36
70,Fail,43,30,4,11,32
70,Fail,48,33,0,11,37
70,Fail,44,29,9,13,31
70,Fail,52,22,0,17,35
70,Fail,51,20,5,12,39
70,Fail,53,23,1,10,43
70,Fail,41,34,9,9,32
70,Fail,53,18,2,17,36
70,Fail,49,20,9,14,35
70,Fail,50,31,0,8,42
70,Fail,48,26,5,14,34
70,Fail,50,25,2,13,37
70,Fail,53,24,1,12,41
70,Fail,48,28,0,14,34
70,Fail,39,27,5,20,19
70,Fail,50,32,0,9,41
70,Fail,48,26,0,16,32
70,Fail,43,29,0,11,32
70,Fail,43,23,9,16,27
70,Fail,46,33,0,8,38
70,Fail,50,27,1,8,42
70,Fail,38,31,0,22,16
70,Fail,52,31,0,5,47
70,Fail,47,30,4,10,37
70,Fail,50,26,0,13,37
70,Fail,48,21,0,20,28
70,Fail,50,30,0,10,40
70,Fail,52,22,3,15,37
70,Fail,51,29,0,11,40
70,Fail,46,28,0,14,32
70,Fail,45,29,0,17,28
70,Fail,49,27,0,10,39
70,Fail,50,26,3,8,42
70,Fail,47,27,4,11,36
70,Fail,48,27,0,13,35
70,Fail,47,30,0,12,35
70,Fail,57,21,1,8,49
70,Fail,47,29,0,8,39
70,Fail,49,25,0,14,35
70,Fail,41,33,0,16,25
70,Fail,49,23,6,14,35
70,Fail,48,31,1,8,40
70,Fail,50,25,0,13,37
70,Fail,46,28,0,19,27
70,Fail,49,22,6,14,35
70,Fail,47,24,3,14,33
70,Fail,45,33,0,12,33
70,Fail,42,26,9,16,26
70,Fail,49,24,5,11,38
70,Fail,55,16,9,12,43
70,Fail,47,28,0,14,33
70,Fail,48,40,0,7,41
70,Fail,47,22,8,15,32
70,Fail,54,28,1,9,45
70,Fail,51,25,6,6,45
70,Fail,45,32,0,13,32
70,Fail,46,35,0,11,35
70,Fail,47,25,2,15,32
70,Fail,52,22,5,11,41
70,Fail,49,23,5,13,36
70,Fail,39,28,6,20,19
70,Fail,47,31,5,9,38
70,Fail,42,30,10,12,30
70,Fail,50,24,8,9,41
70,Fail,43,28,13,11,32
70,Fail,37,36,2,14,23
70,Fail,43,29,1,17,26
70,Fail,52,30,2,9,43
70,Fail,47,27,7,11,36
70,Fail,53,23,2,10,43
70,Fail,46,32,0,14,32
70,Fail,49,28,0,13,36
70,Fail,47,33,1,10,37
70,Fail,54,29,0,10,44
70,Fail,54,22,1,10,44
70,Fail,46,29,0,15,31
70,Fail,50,31,0,6,44
70,Fail,49,27,0,11,38
70,Fail,43,31,4,13,30
70,Fail,51,26,2,9,42
70,Fail,49,28,0,10,39
70,Fail,48,28,7,10,38
70,Fail,49,25,5,12,37
70,Fail,43,30,5,11,32
70,Fail,54,25,0,12,42
70,Fail,50,21,0,18,32
70,Fail,47,32,0,13,34
70,Fail,46,29,4,14,32
70,Fail,48,29,2,9,39
70,Fail,52,23,2,13,39
70,Fail,39,33,0,18,21
70,Fail,57,19,0,10,47
70,Fail,42,34,0,16,26
70,Fail,51,34,0,6,45
70,Fail,44,32,2,12,32
70,Fail,43,33,0,16,27
70,Fail,47,26,4,11,36
70,Fail,56,19,4,13,43
70,Fail,45,37,0,9,36
70,Fail,51,29,0,9,42
70,Fail,43,35,0,16,27
70,Fail,45,35,0,11,34
70,Fail,49,20,4,14,35
70,Fail,49,22,5,16,33
70,Fail,61,20,0,8,53
70,Fail,47,31,0,13,34
70,Fail,45,30,0,18,27
70,Fail,51,27,0,11,40
70,Fail,50,27,1,10,40
70,Fail,50,26,0,13,37
70,Fail,47,21,0,20,27
70,Fail,48,25,0,15,33
70,Fail,45,35,0,11,34
70,Fail,52,27,0,6,46
70,Fail,53,18,4,12,41
70,Fail,55,21,1,10,45
70,Fail,47,23,1,16,31
70,Fail,47,26,0,16,31
70,Fail,49,26,0,15,34
70,Fail,49,28,0,12,37
70,Fail,51,30,2,10,41
70,Fail,49,25,2,14,35
70,Fail,50,25,0,13,37
70,Fail,47,26,1,13,34
70,Fail,50,24,6,7,43
70,Fail,49,20,2,11,38
70,Fail,46,29,1,16,30
70,Fail,47,22,1,14,33
70,Fail,56,31,0,7,49
70,Fail,45,26,3,16,29
70,Fail,50,23,6,15,35
70,Fail,54,22,1,13,41
70,Fail,51,23,0,12,39
70,Fail,49,23,4,12,37
70,Fail,51,30,0,9,42
70,Fail,48,30,0,12,36
70,Fail,47,26,2,11,36
70,Fail,59,20,1,11,48
70,Fail,53,26,3,10,43
70,Fail,50,28,0,11,39
70,Fail,53,25,0,12,41
70,Fail,49,26,0,10,39
70,Fail,38,30,0,18,20
70,Fail,46,27,5,14,32
70,Fail,47,34,0,9,38
70,Fail,50,31,4,7,43
70,Fail,56,21,0,8,48
70,Fail,53,22,0,12,41
70,Fail,52,26,0,14,38
70,Fail,52,21,6,12,40
70,Fail,51,31,0,7,44
70,Fail,56,24,4,6,50
70,Fail,45,28,0,14,31
70,Fail,43,22,9,20,23
70,Fail,45,26,8,14,31
70,Fail,53,22,0,10,43
70,Fail,55,22,1,10,45
70,Fail,48,29,0,10,38
70,Fail,54,20,5,12,42
70,Fail,51,29,0,10,41
70,Fail,46,24,3,14,32
70,Fail,52,22,0,10,42
70,Fail,44,29,0,17,27
70,Fail,50,21,0,15,35
70,Fail,47,30,0,14,33
70,Fail,50,26,0,14,36
70,Fail,45,24,8,13,32
70,Fail,54,23,0,11,43
70,Fail,52,26,0,13,39
70,Fail,46,29,10,10,36
70,Fail,44,31,0,11,33
70,Fail,49,26,2,13,36
70,Fail,58,20,0,12,46
70,Fail,45,28,0,14,31
70,Fail,46,23,7,14,32
70,Fail,51,20,4,14,37
70,Fail,54,26,0,8,46
70,Fail,49,32,0,9,40
70,Fail,46,29,8,10,36
70,Fail,48,24,0,13,35
70,Fail,50,18,5,14,36
70,Fail,35,29,8,19,16
70,Fail,45,33,0,14,31
70,Fail,49,36,0,9,40
70,Fail,44,34,0,15,29
70,Fail,47,30,0,12,35
70,Fail,40,25,8,18,22
70,Fail,45,37,0,8,37
70,Fail,49,30,0,13,36
70,Fail,44,29,4,15,29
70,Fail,48,28,5,10,38
70,Fail,46,28,2,12,34
70,Fail,56,23,1,11,45
70,Fail,44,35,0,10,34
70,Fail,42,30,6,11,31
70,Fail,46,22,10,14,32
70,Fail,43,31,0,16,27
70,Fail,44,30,0,12,32
70,Fail,43,40,0,12,31
70,Fail,50,25,6,10,40
70,Fail,46,24,3,14,32
70,Fail,47,26,0,15,32
70,Fail,45,30,3,8,37
70,Fail,52,28,0,11,41
70,Fail,47,31,2,16,31
70,Fail,50,24,0,11,39
70,Fail,57,22,0,12,45
70,Fail,50,25,0,15,35
70,Fail,49,32,0,8,41
70,Fail,52,28,0,13,39
70,Fail,56,17,6,11,45
70,Fail,41,27,6,14,27
70,Fail,48,28,2,10,38
70,Fail,45,29,0,12,33
70,Fail,54,21,4,11,43
70,Fail,46,27,8,7,39
70,Fail,40,32,0,20,20
70,Fail,46,33,0,13,33
70,Fail,48,31,0,10,38
70,Fail,50,29,0,11,39
70,Fail,45,31,0,15,30
70,Fail,43,25,7,15,28
70,Fail,48,28,5,11,37
70,Fail,49,27,6,6,43
70,Fail,45,14,16,17,28
70,Fail,46,24,7,13,33
70,Fail,58,18,0,12,46
70,Fail,48,23,8,14,34
70,Fail,44,39,0,13,31
70,Fail,52,32,3,6,46
70,Fail,47,22,0,17,30
70,Fail,42,31,0,16,26
70,Fail,51,28,2,9,42
70,Fail,53,19,4,14,39
70,Fail,53,26,1,6,47
70,Fail,46,26,6,16,30
70,Fail,40,38,0,12,28
70,Fail,52,19,7,16,36
70,Fail,48,24,8,9,39
70,Fail,42,24,7,17,25
70,Fail,52,24,4,10,42
70,Fail,52,29,0,10,42
70,Fail,48,29,0,12,36
70,Fail,53,27,0,9,44
70,Fail,49,28,3,12,37
70,Fail,50,22,0,13,37
70,Fail,46,33,2,11,35
70,Fail,51,23,0,15,36
70,Fail,45,27,10,11,34
70,Fail,52,32,0,8,44
70,Fail,49,31,0,11,38
70,Fail,43,37,0,11,32
70,Fail,53,18,10,9,44
70,Fail,46,27,7,12,34
70,Fail,53,22,0,15,38
70,Fail,50,28,0,12,38
70,Fail,49,29,0,11,38
70,Fail,48,25,2,14,34
70,Fail,44,25,3,12,32
70,Fail,46,35,0,9,37
70,Fail,43,30,1,10,33
70,Fail,48,32,2,9,39
70,Fail,50,33,0,10,40
70,Fail,50,27,0,16,34
70,Fail,45,35,0,11,34
70,Fail,50,28,4,5,45
70,Fail,45,28,2,13,32
70,Fail,44,31,5,12,32
70,Fail,42,26,3,18,24
70,Fail,44,35,0,13,31
70,Fail,49,22,3,12,37
70,Fail,48,30,0,11,37
70,Fail,35,33,12,15,20
70,Fail,46,28,0,12,34
70,Fail,49,18,4,14,35
70,Fail,42,37,0,16,26
70,Fail,47,30,0,15,32
70,Fail,44,27,0,20,24
70,Fail,47,26,0,14,33
70,Fail,47,22,0,18,29
70,Fail,54,24,4,10,44
70,Fail,53,17,0,17,36
70,Fail,57,24,0,7,50
70,Fail,49,30,0,9,40
70,Fail,48,22,5,12,36
70,Fail,54,31,2,7,47
70,Fail,50,27,0,12,38
70,Fail,51,22,4,11,40
70,Fail,48,28,5,8,40
70,Fail,46,21,0,18,28
70,Fail,53,26,0,12,41
70,Fail,53,24,0,11,42
70,Fail,50,29,0,11,39
70,Fail,49,26,0,14,35
70,Fail,48,27,0,10,38
70,Fail,42,35,0,12,30
70,Fail,45,33,0,14,31
70,Fail,47,19,12,15,32
70,Fail,45,27,5,13,32
70,Fail,49,17,0,20,29
70,Fail,58,20,0,9,49
70,Fail,45,30,9,7,38
70,Fail,51,23,8,9,42
70,Fail,44,25,3,17,27
70,Fail,46,39,0,6,40
70,Fail,45,27,5,12,33
70,Fail,46,32,0,14,32
70,Fail,53,17,8,10,43
70,Fail,49,30,0,12,37
70,Fail,56,22,0,11,45
70,Fail,46,28,4,11,35
70,Fail,53,22,0,14,39
70,Fail,44,27,8,11,33
70,Fail,42,39,0,10,32
70,Fail,60,16,5,8,52
70,Fail,46,32,0,12,34
70,Fail,44,22,11,14,30
70,Fail,59,18,0,10,49
70,Fail,44,29,0,15,29
70,Fail,54,20,2,11,43
70,Fail,38,38,0,18,20
70,Fail,45,30,3,11,34
70,Fail,47,23,2,17,30
70,Fail,46,29,3,12,34
70,Fail,58,25,0,7,51
70,Fail,57,12,3,15,42
70,Fail,49,21,5,13,36
70,Fail,37,37,0,18,19
70,Fail,57,23,0,9,48
70,Fail,54,28,0,6,48
70,Fail,49,22,0,15,34
70,Fail,46,27,11,10,36
70,Fail,50,30,0,10,40
70,Fail,49,32,0,7,42
70,Fail,52,28,1,10,42
70,Fail,47,34,0,10,37
70,Fail,45,36,0,10,35
70,Fail,49,23,1,14,35
70,Fail,48,30,3,10,38
70,Fail,44,29,2,13,31
70,Fail,49,26,1,14,35
70,Fail,62,20,0,11,51
70,Fail,50,24,0,16,34
70,Fail,54,22,0,10,44
70,Fail,46,23,1,15,31
70,Fail,47,26,2,13,34
70,Fail,47,32,2,7,40
70,Fail,48,31,0,14,34
70,Fail,43,29,3,15,28
70,Fail,49,29,2,9,40
70,Fail,44,31,0,16,28
70,Fail,51,24,5,14,37
70,Fail,60,23,0,8,52
70,Fail,49,24,2,14,35
70,Fail,46,29,1,12,34
70,Fail,47,29,0,13,34
70,Fail,50,28,0,14,36
70,Fail,53,22,0,10,43
70,Fail,56,24,0,10,46
70,Fail,49,21,13,8,41
70,Fail,48,35,0,10,38
70,Fail,46,29,2,14,32
70,Fail,56,19,0,9,47
70,Fail,56,24,0,11,45
70,Fail,49,25,5,9,40
70,Fail,42,30,0,23,19
70,Fail,50,25,3,8,42
70,Fail,51,27,0,12,39
70,Fail,40,23,7,15,25
70,Fail,54,25,1,10,44
70,Fail,51,22,5,11,40
70,Fail,50,21,4,13,37
70,Fail,50,19,1,16,34
70,Fail,48,26,0,17,31
70,Fail,52,23,4,11,41
70,Fail,39,31,9,13,26
70,Fail,51,33,0,8,43
70,Fail,47,24,1,16,31
70,Fail,51,23,6,14,37
70,Fail,45,25,0,21,24
70,Fail,46,29,0,10,36
70,Fail,56,21,0,12,44
70,Fail,46,27,0,13,33
70,Fail,46,33,0,13,33
70,Fail,41,30,4,18,23
70,Fail,41,32,0,17,24
70,Fail,41,27,6,18,23
70,Fail,44,31,0,13,31
70,Fail,42,37,0,13,29
70,Fail,48,28,0,12,36
70,Fail,44,27,0,15,29
70,Fail,58,22,0,11,47
70,Fail,45,28,0,17,28
70,Fail,42,37,0,13,29
70,Fail,51,28,0,11,40
70,Fail,51,22,0,13,38
70,Fail,52,26,0,11,41
70,Fail,43,31,0,16,27
70,Fail,52,28,1,12,40
70,Fail,41,30,0,22,19
70,Fail,50,31,0,12,38
70,Fail,48,26,5,11,37
70,Fail,43,31,1,15,28
70,Fail,47,27,0,15,32
70,Fail,45,30,0,14,31
70,Fail,52,24,0,13,39
70,Fail,49,17,8,17,32
70,Fail,47,30,0,10,37
70,Fail,48,30,0,13,35
70,Fail,41,35,10,9,32
70,Fail,44,27,2,13,31
70,Fail,51,29,0,9,42
70,Fail,41,36,0,11,30
70,Fail,47,27,3,11,36
70,Fail,51,23,3,13,38
70,Fail,48,26,0,13,35
70,Fail,47,31,0,16,31
70,Fail,50,27,0,12,38
70,Fail,37,32,7,16,21
70,Fail,49,24,0,9,40
70,Fail,43,33,1,12,31
70,Fail,43,20,11,18,25
70,Fail,47,29,0,14,33
70,Fail,53,20,1,16,37
70,Fail,51,29,0,12,39
70,Fail,53,26,0,9,44
70,Fail,43,27,7,12,31
70,Fail,49,24,0,13,36
70,Fail,46,27,9,14,32
70,Fail,51,27,4,7,44
70,Fail,54,23,0,12,42
70,Fail,44,27,4,14,30
70,Fail,50,27,2,10,40
70,Fail,52,22,3,13,39
70,Fail,51,25,1,12,39
70,Fail,46,28,5,10,36
70,Fail,58,19,1,12,46
70,Fail,42,30,2,15,27
70,Fail,50,25,0,14,36
70,Fail,45,35,0,11,34
70,Fail,54,22,1,13,41
70,Fail,44,27,4,14,30
70,Fail,52,26,3,13,39
70,Fail,38,36,3,13,25
70,Fail,50,31,0,12,38
70,Fail,54,21,0,16,38
70,Fail,47,27,0,14,33
70,Fail,48,28,0,8,40
70,Fail,45,22,14,9,36
70,Fail,53,21,0,14,39
70,Fail,48,22,5,14,34
70,Fail,53,20,5,12,41
70,Fail,46,31,3,8,38
70,Fail,42,30,5,13,29
70,Fail,45,28,3,15,30
70,Fail,52,26,4,9,43
70,Fail,48,30,0,11,37
70,Fail,42,26,7,16,26
70,Fail,47,22,9,14,33
70,Fail,47,21,5,17,30
70,Fail,49,28,0,13,36
70,Fail,52,24,0,14,38
70,Fail,52,28,0,8,44
70,Fail,49,28,2,9,40
70,Fail,46,34,0,11,35
70,Fail,48,23,0,15,33
70,Fail,52,20,0,15,37
70,Fail,51,24,0,12,39
70,Fail,59,19,0,8,51
70,Fail,48,31,0,12,36
70,Fail,49,30,0,13,36
70,Fail,46,24,6,16,30
70,Fail,50,22,1,18,32
70,Fail,48,36,0,4,44
70,Fail,48,33,0,9,39
70,Fail,47,25,4,14,33
70,Fail,43,27,0,13,30
70,Fail,50,21,3,16,34
70,Fail,50,32,0,6,44
70,Fail,45,30,2,14,31
70,Fail,46,39,0,8,38
70,Fail,46,36,0,9,37
70,Fail,50,29,0,14,36
70,Fail,55,17,5,11,44
70,Fail,52,32,0,8,44
70,Fail,51,28,0,9,42
70,Fail,55,19,0,14,41
70,Fail,52,23,2,11,41
70,Fail,47,24,11,11,36
70,Fail,46,31,1,11,35
70,Fail,46,23,9,13,33
70,Fail,54,27,1,6,48
70,Fail,56,24,0,12,44
70,Fail,50,24,1,13,37
70,Fail,46,22,5,17,29
70,Fail,38,28,6,21,17
70,Fail,52,27,3,9,43
70,Fail,49,25,10,11,38
70,Fail,42,34,0,11,31
70,Fail,54,26,0,9,45
70,Fail,45,33,1,10,35
70,Fail,49,23,2,15,34
70,Fail,43,29,2,14,29
70,Fail,50,28,0,8,42
70,Fail,56,26,0,8,48
70,Fail,44,24,9,16,28
70,Fail,52,30,0,6,46
70,Fail,52,22,4,11,41
70,Fail,49,32,0,9,40
70,Fail,46,33,8,8,38
70,Fail,44,29,9,10,34
70,Fail,48,34,0,8,40
70,Fail,49,28,0,14,35
70,Fail,46,31,5,11,35
70,Fail,49,31,0,10,39
70,Fail,42,35,0,13,29
70,Fail,44,31,0,13,31
70,Fail,44,30,0,18,26
70,Fail,54,17,0,17,37
70,Fail,49,22,6,13,36
70,Fail,51,26,0,12,39
70,Fail,42,35,0,11,31
70,Fail,46,25,1,12,34
70,Fail,49,27,3,12,37
70,Fail,51,26,0,13,38
70,Fail,52,23,0,14,38
70,Fail,44,37,0,8,36
70,Fail,46,34,0,6,40
70,Fail,45,26,2,17,28
70,Fail,57,18,0,13,44
70,Fail,55,24,0,9,46
70,Fail,45,26,7,12,33
70,Fail,46,27,0,14,32
70,Fail,45,31,1,12,33
70,Fail,51,32,0,6,45
70,Fail,45,30,0,18,27
70,Fail,54,28,0,5,49
70,Fail,51,25,0,13,38
70,Fail,58,20,0,12,46
70,Fail,51,27,0,11,40
70,Fail,56,24,0,9,47
70,Fail,46,21,0,20,26
70,Fail,42,33,0,12,30
70,Fail,47,26,4,14,33
70,Fail,50,23,10,7,43
70,Fail,44,28,0,17,27
70,Fail,51,28,0,10,41
70,Fail,48,24,1,12,36
70,Fail,43,26,10,17,26
70,Fail,46,34,0,13,33
70,Fail,50,23,0,18,32
70,Fail,50,27,4,7,43
70,Fail,46,22,5,15,31
70,Fail,42,27,6,15,27
70,Fail,46,34,0,11,35
70,Fail,49,31,9,6,43
70,Fail,45,25,4,13,32
70,Fail,49,34,0,12,37
70,Fail,56,14,2,16,40
70,Fail,49,25,2,16,33
70,Fail,48,29,0,13,35
70,Fail,53,28,0,13,40
70,Fail,47,29,0,16,31
70,Fail,46,33,0,11,35
70,Fail,50,22,0,13,37
70,Fail,49,30,0,11,38
70,Fail,56,19,0,17,39
70,Fail,47,27,2,13,34
70,Fail,48,27,9,11,37
70,Fail,44,28,6,11,33
70,Fail,51,22,2,13,38
70,Fail,50,26,0,12,38
70,Fail,49,21,7,11,38
70,Fail,44,29,7,12,32
70,Fail,54,18,2,14,40
70,Fail,51,24,0,15,36
70,Fail,46,24,0,17,29
70,Fail,43,29,0,17,26
70,Fail,44,34,0,13,31
70,Fail,43,24,3,16,27
70,Fail,48,35,0,11,37
70,Fail,51,20,0,16,35
70,Fail,45,29,0,16,29
70,Fail,41,35,0,19,22
70,Fail,45,28,5,12,33
70,Fail,40,35,0,13,27
70,Fail,56,21,5,8,48
70,Fail,43,28,2,13,30
70,Fail,49,24,0,19,30
70,Fail,48,35,0,7,41
70,Fail,48,29,0,11,37
70,Fail,46,30,0,13,33
70,Fail,51,19,1,14,37
70,Fail,48,28,0,16,32
70,Fail,47,27,2,15,32
70,Fail,55,24,7,6,49
70,Fail,57,21,0,8,49
70,Fail,50,24,2,15,35
70,Fail,53,29,0,11,42
70,Fail,44,26,0,17,27
70,Fail,50,26,3,12,38
70,Fail,49,20,2,15,34
70,Fail,51,23,0,9,42
70,Fail,46,31,0,11,35
70,Fail,47,30,0,14,33
70,Fail,50,26,0,9,41
70,Fail,45,23,8,13,32
70,Fail,55,17,0,14,41
70,Fail,52,22,4,9,43
70,Fail,48,29,0,14,34
70,Fail,49,31,0,14,35
70,Fail,51,25,2,12,39
70,Fail,56,21,1,8,48
70,Fail,45,25,4,16,29
70,Fail,61,15,0,12,49
70,Fail,49,24,2,14,35
70,Fail,50,24,1,12,38
70,Fail,48,24,0,19,29
70,Fail,48,31,0,13,35
70,Fail,49,31,0,8,41
70,Fail,41,28,10,14,27
70,Fail,57,24,0,12,45
70,Fail,48,25,4,15,33
70,Fail,49,23,6,13,36
70,Fail,42,39,0,11,31
70,Fail,51,22,0,17,34
70,Fail,46,26,1,15,31
70,Fail,51,31,0,8,43
70,Fail,52,17,4,13,39
70,Fail,52,22,6,12,40
70,Fail,48,30,0,14,34
70,Fail,56,27,0,8,48
70,Fail,45,26,1,15,30
70,Fail,49,20,8,12,37
70,Fail,55,20,0,12,43
70,Fail,49,33,0,10,39
70,Fail,52,26,2,10,42
70,Fail,53,24,3,8,45
70,Fail,48,25,0,16,32
70,Fail,44,28,6,11,33
70,Fail,52,37,0,6,46
70,Fail,47,29,0,12,35
70,Fail,52,19,0,16,36
70,Fail,47,35,0,10,37
70,Fail,48,22,3,15,33
70,Fail,41,30,0,15,26
70,Fail,44,32,0,12,32
70,Fail,50,23,9,8,42
70,Fail,53,23,2,11,42
70,Fail,39,47,0,9,30
70,Fail,51,21,2,12,39
70,Fail,40,28,6,17,23
70,Fail,59,17,0,12,47
70,Fail,50,27,5,10,40
70,Fail,52,26,0,11,41
70,Fail,43,20,12,12,31
70,Fail,51,26,0,10,41
70,Fail,51,23,0,16,35
70,Fail,49,28,0,14,35
70,Fail,46,34,2,7,39
70,Fail,47,27,1,16,31
70,Fail,48,22,1,14,34
70,Fail,48,29,0,14,34
70,Fail,56,25,0,10,46
70,Fail,43,27,3,11,32
70,Fail,47,34,0,6,41
70,Fail,53,30,0,9,44
70,Fail,49,22,5,15,34
70,Fail,60,21,0,9,51
70,Fail,47,27,5,11,36
70,Fail,53,24,0,13,40
70,Fail,54,16,4,11,43
70,Fail,43,30,0,11,32
70,Fail,51,28,0,11,40
70,Fail,43,28,0,18,25
70,Fail,46,29,0,15,31
70,Fail,48,29,0,13,35
70,Fail,44,32,7,8,36
70,Fail,53,22,1,15,38
70,Fail,44,35,5,9,35
70,Fail,49,22,4,15,34
70,Fail,50,23,0,17,33
70,Fail,46,27,8,12,34
70,Fail,47,28,0,12,35
70,Fail,53,26,0,9,44
70,Fail,51,25,0,16,35
70,Fail,46,30,1,12,34
70,Fail,51,33,0,7,44
70,Fail,42,32,1,12,30
70,Fail,47,29,0,15,32
70,Fail,55,23,0,11,44
70,Fail,49,32,0,7,42
70,Fail,46,36,0,9,37
70,Fail,43,30,4,15,28
70,Fail,43,28,0,15,28
70,Fail,56,25,0,7,49
70,Fail,46,36,0,8,38
70,Fail,49,36,0,9,40
70,Fail,45,29,2,10,35
70,Fail,43,36,0,17,26
70,Fail,47,24,1,20,27
70,Fail,48,28,0,14,34
70,Fail,48,25,5,11,37
70,Fail,46,24,9,8,38
70,Fail,48,25,0,15,33
70,Fail,52,25,2,11,41
70,Fail,45,34,0,13,32
70,Fail,50,27,0,10,40
70,Fail,46,37,0,7,39
70,Fail,38,26,7,18,20
70,Fail,50,29,0,12,38
70,Fail,49,23,3,17,32
70,Fail,46,36,0,9,37
70,Fail,45,34,0,15,30
70,Fail,43,30,3,15,28
70,Fail,50,22,6,15,35
70,Fail,43,28,10,12,31
70,Fail,49,24,0,14,35
70,Fail,42,32,1,16,26
70,Fail,46,34,0,9,37
70,Fail,41,38,0,12,29
70,Fail,49,30,4,8,41
70,Fail,48,24,5,12,36
70,Fail,50,26,0,14,36
70,Fail,47,29,0,6,41
70,Fail,42,33,5,11,31
70,Fail,55,20,0,11,44
70,Fail,53,22,2,12,41
70,Fail,51,30,0,12,39
70,Fail,51,25,2,14,37
70,Fail,39,39,0,14,25
70,Fail,48,33,0,8,40
70,Fail,45,27,1,15,30
70,Fail,47,31,0,9,38
70,Fail,53,31,0,11,42
70,Fail,52,23,1,12,40
70,Fail,55,24,0,8,47
70,Fail,40,35,3,11,29
70,Fail,36,48,0,12,24
70,Fail,44,29,4,10,34
70,Fail,50,36,0,7,43
70,Fail,59,22,0,9,50
70,Fail,51,20,2,14,37
70,Fail,47,26,1,16,31
70,Fail,42,26,0,18,24
70,Fail,55,14,8,11,44
70,Fail,48,24,2,16,32
70,Fail,44,32,0,15,29
70,Fail,42,26,6,12,30
70,Fail,46,28,0,12,34
70,Fail,56,16,3,14,42
70,Fail,43,30,1,18,25
70,Fail,47,20,9,14,33
70,Fail,47,25,0,18,29
70,Fail,44,29,0,16,28
70,Fail,50,27,0,11,39
70,Fail,54,22,6,8,46
70,Fail,45,23,5,16,29
70,Fail,48,26,0,18,30
70,Fail,46,27,0,14,32
70,Fail,48,27,0,10,38
70,Fail,35,43,2,11,24
70,Fail,42,28,0,22,20
70,Fail,52,25,0,9,43
70,Fail,47,25,10,10,37
70,Fail,45,25,0,16,29
70,Fail,52,24,0,12,40
70,Fail,48,23,0,17,31
70,Fail,49,30,0,7,42
70,Fail,47,28,3,13,34
70,Fail,53,24,3,7,46
70,Fail,53,29,0,10,43
70,Fail,52,22,2,9,43
70,Fail,40,27,11,12,28
70,Fail,47,29,5,11,36
70,Fail,59,15,0,12,47
70,Fail,45,28,0,16,29
70,Fail,47,19,9,16,31
70,Fail,39,29,0,19,20
70,Fail,53,24,11,6,47
70,Fail,45,25,6,15,30
70,Fail,51,26,3,8,43
70,Fail,48,29,0,14,34
70,Fail,44,28,2,18,26
70,Fail,48,29,0,12,36
70,Fail,47,34,0,9,38
70,Fail,46,26,0,15,31
70,Fail,49,24,0,16,33
70,Fail,47,24,0,20,27
70,Fail,47,25,0,15,32
70,Fail,44,25,3,16,28
70,Fail,45,24,3,17,28
70,Fail,51,30,1,9,42
70,Fail,47,24,5,15,32
70,Fail,51,26,2,7,44
70,Fail,47,26,8,8,39
70,Fail,53,21,2,14,39
70,Fail,46,29,0,14,32
70,Fail,47,29,5,12,35
70,Fail,44,31,0,15,29
70,Fail,45,26,6,15,30
70,Fail,54,21,2,12,42
70,Fail,44,30,5,14,30
70,Fail,50,23,0,17,33
70,Fail,44,29,2,11,33
70,Fail,45,27,0,18,27
70,Fail,48,26,1,14,34
70,Fail,37,31,10,14,23
70,Fail,52,29,0,10,42
70,Fail,49,34,0,6,43
70,Fail,44,30,0,16,28
70,Fail,51,15,13,12,39
70,Fail,48,24,0,17,31
70,Fail,58,21,0,11,47
70,Fail,45,35,0,12,33
70,Fail,52,27,0,13,39
70,Fail,56,25,0,9,47
70,Fail,47,32,0,14,33
70,Fail,45,29,4,10,35
70,Fail,47,32,0,12,35
70,Fail,40,31,0,18,22
70,Fail,54,17,6,13,41
70,Fail,54,22,2,11,43
70,Fail,43,34,0,12,31
70,Fail,48,27,0,14,34
70,Fail,47,22,5,15,32
70,Fail,54,25,1,8,46
70,Fail,50,23,0,18,32
70,Fail,49,23,0,13,36
70,Fail,53,27,0,9,44
70,Fail,45,22,9,13,32
70,Fail,48,22,7,9,39
70,Fail,54,23,0,12,42
70,Fail,47,27,0,17,30
70,Fail,51,26,1,10,41
70,Fail,53,23,0,15,38
70,Fail,42,29,6,12,30
70,Fail,48,22,3,12,36
70,Fail,45,36,0,9,36
70,Fail,51,20,11,8,43
70,Fail,46,30,0,12,34
70,Fail,52,23,1,12,40
70,Fail,47,27,0,20,27
70,Fail,55,17,3,12,43
70,Fail,46,36,0,11,35
70,Fail,50,27,0,11,39
70,Fail,43,34,4,6,37
70,Fail,54,22,0,16,38
70,Fail,44,26,4,12,32
70,Fail,48,23,4,13,35
70,Fail,45,33,0,9,36
70,Fail,50,27,2,10,40
70,Fail,49,25,5,7,42
70,Fail,42,38,0,16,26
70,Fail,43,37,0,11,32
70,Fail,54,22,2,8,46
70,Fail,52,22,4,9,43
70,Fail,51,24,0,17,34
70,Fail,48,27,0,9,39
70,Fail,44,34,0,10,34
70,Fail,42,34,3,12,30
70,Fail,45,32,0,14,31
70,Fail,46,30,2,13,33
70,Fail,43,31,0,12,31
70,Fail,51,23,0,15,36
70,Fail,47,35,0,13,34
70,Fail,55,21,0,12,43
70,Fail,48,23,2,18,30
70,Fail,45,36,0,11,34
70,Fail,55,26,0,8,47
70,Fail,50,18,4,19,31
70,Fail,44,30,0,16,28
70,Fail,51,24,0,13,38
70,Fail,52,21,1,17,35
70,Fail,53,20,3,10,43
70,Fail,43,23,14,12,31
70,Fail,52,29,0,8,44
70,Fail,52,21,0,11,41
70,Fail,41,34,0,13,28
70,Fail,51,20,3,13,38
70,Fail,45,26,1,16,29
70,Fail,47,21,1,13,34
70,Fail,47,24,0,18,29
70,Fail,45,30,0,14,31
70,Fail,51,22,0,15,36
70,Fail,45,32,7,8,37
70,Fail,50,23,0,12,38
70,Fail,48,28,0,14,34
70,Fail,48,30,0,12,36
70,Fail,57,16,3,15,42
70,Fail,51,22,0,16,35
70,Fail,52,28,0,9,43
70,Fail,53,25,0,11,42
70,Fail,47,24,0,18,29
70,Fail,49,23,3,12,37
70,Fail,55,17,4,12,43
70,Fail,50,25,1,10,40
70,Fail,54,22,0,10,44
70,Fail,40,31,5,13,27
70,Fail,51,24,0,15,36
70,Fail,45,34,1,11,34
70,Fail,50,22,0,16,34
70,Fail,51,22,0,13,38
70,Fail,46,25,0,17,29
70,Fail,48,28,0,15,33
70,Fail,48,30,3,10,38
70,Fail,48,31,0,12,36
70,Fail,49,20,12,10,39
70,Fail,52,24,0,12,40
70,Fail,59,16,0,11,48
70,Fail,45,28,3,14,31
70,Fail,58,22,2,7,51
70,Fail,49,20,1,18,31
70,Fail,51,23,1,12,39
70,Fail,49,30,0,12,37
70,Fail,48,30,0,9,39
70,Fail,50,24,5,9,41
70,Fail,54,24,0,7,47
70,Fail,44,31,4,11,33
70,Fail,51,24,7,12,39
70,Fail,38,36,0,17,21
70,Fail,53,23,5,10,43
70,Fail,50,31,0,9,41
70,Fail,48,30,0,10,38
70,Fail,50,26,0,13,37
70,Fail,43,29,0,14,29
70,Fail,43,32,2,10,33
70,Fail,50,29,0,11,39
70,Fail,47,21,7,13,34
70,Fail,41,39,0,10,31
70,Fail,47,31,0,8,39
70,Fail,53,25,0,12,41
70,Fail,52,22,0,13,39
70,Fail,46,27,1,10,36
70,Fail,51,30,0,11,40
70,Fail,46,35,0,10,36
70,Fail,51,24,0,10,41
70,Fail,48,29,2,13,35
70,Fail,58,18,5,7,51
70,Fail,51,27,0,12,39
70,Fail,52,26,0,10,42
70,Fail,44,28,0,19,25
70,Fail,48,29,6,8,40
70,Fail,50,29,0,14,36
70,Fail,52,23,0,13,39
70,Fail,50,21,2,14,36
70,Fail,48,30,0,15,33
70,Fail,48,32,0,13,35
70,Fail,42,31,4,14,28
70,Fail,55,22,0,12,43
70,Fail,50,20,9,13,37
70,Fail,47,23,10,14,33
70,Fail,59,22,3,8,51
70,Fail,43,28,6,10,33
70,Fail,52,19,0,18,34
70,Fail,41,29,1,16,25
70,Fail,49,28,1,10,39
70,Fail,49,24,0,12,37
70,Fail,37,32,1,15,22
70,Fail,50,26,0,10,40
70,Fail,57,24,3,9,48
70,Fail,44,37,0,10,34
70,Fail,46,30,0,11,35
70,Fail,47,27,3,20,27
70,Fail,49,34,0,7,42
70,Fail,45,33,0,13,32
70,Fail,49,28,0,16,33
70,Fail,49,25,1,16,33
70,Fail,46,29,7,11,35
70,Fail,46,23,0,17,29
70,Fail,55,21,1,11,44
70,Fail,45,26,0,18,27
70,Fail,50,18,7,17,33
70,Fail,40,37,0,17,23
70,Fail,42,31,7,15,27
70,Fail,46,32,0,11,35
70,Fail,49,31,0,12,37
70,Fail,51,21,4,11,40
70,Fail,52,25,3,14,38
70,Fail,55,23,2,12,43
70,Fail,52,21,0,14,38
70,Fail,47,24,0,20,27
70,Fail,48,30,0,12,36
70,Fail,49,25,3,12,37
70,Fail,50,24,0,14,36
70,Fail,54,19,8,10,44
70,Fail,45,28,0,13,32
70,Fail,48,27,0,13,35
70,Fail,46,24,3,12,34
70,Fail,49,29,3,10,39
70,Fail,47,29,0,14,33
70,Fail,50,33,0,8,42
70,Fail,47,31,0,12,35
70,Fail,52,20,0,14,38
70,Fail,43,29,5,14,29
70,Fail,42,25,3,16,26
70,Fail,50,23,4,12,38
70,Fail,43,33,4,8,35
70,Fail,47,33,0,12,35
70,Fail,49,25,0,11,38
70,Fail,43,34,0,9,34
70,Fail,47,33,0,9,38
70,Fail,52,24,0,9,43
70,Fail,50,26,0,14,36
70,Fail,48,26,3,17,31
70,Fail,51,22,6,13,38
70,Fail,57,23,0,11,46
70,Fail,50,27,4,12,38
70,Fail,43,37,0,10,33
70,Fail,44,30,0,21,23
70,Fail,44,29,0,16,28
70,Fail,46,31,4,7,39
70,Fail,46,30,0,13,33
70,Fail,44,34,0,12,32
70,Fail,53,26,0,10,43
70,Fail,47,24,0,16,31
70,Fail,44,34,0,10,34
70,Fail,46,28,0,12,34
70,Fail,47,32,0,13,34
70,Fail,45,33,0,12,33
70,Fail,45,25,9,11,34
70,Fail,50,26,3,13,37
70,Fail,43,27,0,19,24
70,Fail,50,25,0,13,37
70,Fail,51,26,0,10,41
70,Fail,51,25,0,11,40
70,Fail,51,25,3,13,38
70,Fail,46,25,2,16,30
70,Fail,44,39,0,10,34
70,Fail,47,26,2,13,34
70,Fail,50,24,0,12,38
70,Fail,52,28,0,10,42
70,Fail,48,26,3,8,40
70,Fail,52,21,2,11,41
70,Fail,44,31,4,11,33
70,Fail,45,25,2,13,32
70,Fail,42,27,7,15,27
70,Fail,42,29,4,14,28
70,Fail,45,24,4,12,33
70,Fail,52,24,0,11,41
70,Fail,51,20,7,15,36
70,Fail,43,29,0,12,31
70,Fail,40,35,7,12,28
70,Fail,46,27,0,13,33
70,Fail,50,29,0,10,40
70,Fail,40,30,0,18,22
70,Fail,42,32,0,10,32
70,Fail,43,34,0,15,28
70,Fail,44,28,0,18,26
70,Fail,44,30,0,15,29
70,Fail,45,25,3,13,32
70,Fail,36,37,0,17,19
70,Fail,50,32,2,8,42
70,Fail,49,24,2,15,34
70,Fail,48,28,8,8,40
70,Fail,41,27,6,18,23
70,Fail,43,23,5,19,24
70,Fail,52,15,1,19,33
70,Fail,49,31,0,9,40
70,Fail,49,28,0,15,34
70,Fail,44,32,0,12,32
70,Fail,48,22,6,13,35
70,Fail,47,25,5,12,35
70,Fail,49,22,5,9,40
70,Fail,49,25,0,13,36
70,Fail,50,23,4,14,36
70,Fail,54,19,9,11,43
70,Fail,57,23,0,10,47
70,Fail,50,22,0,15,35
70,Fail,52,19,1,13,39
70,Fail,49,23,0,18,31
70,Fail,38,33,0,19,19
70,Fail,46,28,0,12,34
70,Fail,44,24,0,18,26
70,Fail,50,23,6,9,41
70,Fail,49,24,1,14,35
70,Fail,35,39,0,13,22
70,Fail,44,25,0,19,25
70,Fail,54,25,0,11,43
70,Fail,48,26,9,9,39
70,Fail,36,34,3,15,21
70,Fail,44,26,0,19,25
70,Fail,41,30,4,14,27
70,Fail,41,31,7,14,27
70,Fail,48,28,1,14,34
70,Fail,52,22,1,14,38
70,Fail,44,26,0,17,27
70,Fail,42,29,4,13,29
70,Fail,52,24,7,10,42
70,Fail,45,30,2,11,34
70,Fail,55,21,10,11,44
70,Fail,48,31,0,9,39
70,Fail,49,31,1,7,42
70,Fail,49,30,0,11,38
70,Fail,49,30,3,10,39
70,Fail,48,27,0,14,34
70,Fail,45,22,9,13,32
70,Fail,55,22,0,12,43
70,Fail,43,27,2,16,27
70,Fail,45,39,0,5,40
70,Fail,36,39,0,19,17
70,Fail,48,25,2,17,31
70,Fail,43,33,0,18,25
70,Fail,48,35,0,8,40
70,Fail,45,33,0,13,32
70,Fail,49,28,3,11,38
70,Fail,41,27,7,19,22
70,Fail,50,23,7,13,37
70,Fail,45,28,3,15,30
70,Fail,46,21,0,22,24
70,Fail,47,37,0,7,40
70,Fail,50,26,2,14,36
70,Fail,50,35,0,8,42
70,Fail,43,37,0,10,33
70,Fail,42,35,0,14,28
70,Fail,58,18,1,11,47
70,Fail,39,41,0,13,26
70,Fail,53,23,0,14,39
70,Fail,44,31,0,14,30
70,Fail,43,23,11,11,32
70,Fail,48,31,0,14,34
70,Fail,50,23,2,15,35
70,Fail,51,16,0,18,33
70,Fail,49,24,0,13,36
70,Fail,46,35,0,12,34
70,Fail,45,34,0,11,34
70,Fail,53,20,7,13,40
70,Fail,46,22,5,14,32
70,Fail,47,29,2,14,33
70,Fail,56,14,0,17,39
70,Fail,56,21,4,8,48
70,Fail,51,23,2,13,38
70,Fail,50,26,1,11,39
70,Fail,50,24,7,12,38
70,Fail,46,22,2,17,29
70,Fail,45,22,11,10,35
70,Fail,54,26,3,9,45
70,Fail,54,23,1,12,42
70,Fail,48,29,2,9,39
70,Fail,39,37,0,16,23
70,Fail,47,27,2,14,33
70,Fail,53,26,0,11,42
70,Fail,47,33,0,9,38
70,Fail,41,33,0,13,28
70,Fail,53,17,2,15,38
70,Fail,48,22,0,16,32
70,Fail,51,36,2,4,47
70,Fail,56,24,0,10,46
70,Fail,51,24,1,14,37
70,Fail,45,27,4,10,35
70,Fail,44,26,10,11,33
70,Fail,44,23,8,16,28
70,Fail,43,31,1,15,28
70,Fail,44,26,9,13,31
70,Fail,51,24,5,12,39
70,Fail,44,28,2,13,31
70,Fail,48,23,5,16,32
70,Fail,50,32,0,11,39
70,Fail,48,26,1,11,37
70,Fail,52,22,2,14,38
70,Fail,51,27,4,9,42
70,Fail,55,23,3,9,46
70,Fail,51,27,0,11,40
70,Fail,51,22,2,14,37
70,Fail,41,37,0,13,28
70,Fail,49,19,5,17,32
70,Fail,48,27,2,12,36
70,Fail,53,23,1,11,42
70,Fail,41,30,4,17,24
70,Fail,49,27,0,12,37
70,Fail,53,20,0,13,40
70,Fail,49,22,0,16,33
70,Fail,38,35,5,14,24
70,Fail,49,22,0,11,38
70,Fail,47,32,0,10,37
70,Fail,49,23,4,12,37
70,Fail,47,21,4,14,33
70,Fail,41,32,3,13,28
70,Fail,59,24,0,7,52
70,Fail,41,34,0,17,24
70,Fail,44,35,2,10,34
70,Fail,49,27,3,10,39
70,Fail,42,26,10,11,31
70,Fail,52,29,0,11,41
70,Fail,42,35,0,11,31
70,Fail,51,33,0,10,41
70,Fail,45,27,3,14,31
70,Fail,47,27,0,13,34
70,Fail,53,24,1,12,41
70,Fail,51,20,3,16,35
70,Fail,50,29,0,12,38
70,Fail,52,26,1,11,41
70,Fail,45,28,6,12,33
70,Fail,46,23,3,16,30
70,Fail,46,25,6,16,30
70,Fail,52,26,0,13,39
70,Fail,57,19,3,11,46
70,Fail,52,24,1,16,36
70,Fail,40,30,3,16,24
70,Fail,50,27,2,12,38
70,Fail,48,27,2,11,37
70,Fail,57,21,2,10,47
70,Fail,53,18,6,11,42
70,Fail,54,19,5,12,42
70,Fail,52,25,0,12,40
70,Fail,48,33,0,10,38
70,Fail,41,38,0,14,27
70,Fail,45,26,6,14,31
70,Fail,45,21,9,15,30
70,Fail,36,34,7,14,22
70,Fail,52,21,0,16,36
70,Fail,50,26,1,15,35
70,Fail,56,22,4,10,46
70,Fail,46,34,0,12,34
70,Fail,50,22,1,16,34
70,Fail,53,23,0,11,42
70,Fail,49,31,0,9,40
70,Fail,51,17,0,19,32
70,Fail,45,22,0,19,26
70,Fail,58,19,0,11,47
70,Fail,46,23,10,13,33
70,Fail,54,21,1,12,42
70,Fail,51,26,0,11,40
70,Fail,53,27,0,7,46
70,Fail,40,24,13,17,23
70,Fail,45,27,1,11,34
70,Fail,45,27,6,14,31
70,Fail,52,25,1,12,40
70,Fail,61,15,5,9,52
70,Fail,44,33,0,11,33
70,Fail,47,34,0,10,37
70,Fail,52,27,4,8,44
70,Fail,47,34,0,10,37
70,Fail,48,20,7,13,35
70,Fail,48,26,1,15,33
70,Fail,50,21,4,15,35
70,Fail,44,27,1,17,27
70,Fail,43,28,2,14,29
70,Fail,48,27,0,14,34
70,Fail,49,29,0,16,33
70,Fail,50,25,6,11,39
70,Fail,41,25,4,15,26
70,Fail,48,31,0,11,37
70,Fail,48,29,0,14,34
70,Fail,46,25,0,16,30
70,Fail,51,26,0,14,37
70,Fail,46,32,0,16,30
70,Fail,43,32,0,11,32
70,Fail,56,22,4,12,44
70,Fail,45,32,0,12,33
70,Fail,52,27,1,9,43
70,Fail,45,35,0,11,34
70,Fail,54,20,1,9,45
70,Fail,51,26,0,11,40
70,Fail,53,24,0,14,39
70,Fail,55,20,0,11,44
70,Fail,42,35,0,15,27
70,Fail,48,28,3,12,36
70,Fail,42,34,0,15,27
70,Fail,49,24,8,11,38
70,Fail,39,37,5,12,27
70,Fail,37,37,0,15,22
70,Fail,46,24,6,12,34
70,Fail,46,32,1,9,37
70,Fail,43,36,0,12,31
70,Fail,48,29,0,10,38
70,Fail,47,27,1,13,34
70,Fail,52,25,0,11,41
70,Fail,46,38,0,9,37
70,Fail,45,30,0,14,31
70,Fail,47,26,6,10,37
70,Fail,45,29,0,13,32
70,Fail,49,27,0,12,37
70,Fail,51,36,0,5,46
70,Fail,47,26,0,14,33
70,Fail,57,16,3,10,47
70,Fail,56,23,0,9,47
70,Fail,53,28,0,10,43
70,Fail,43,26,5,16,27
70,Fail,49,31,0,10,39
70,Fail,44,27,10,14,30
70,Fail,48,22,7,16,32
70,Fail,44,26,1,22,22
70,Fail,46,25,3,16,30
70,Fail,50,29,0,9,41
70,Fail,54,24,0,10,44
70,Fail,50,29,0,12,38
70,Fail,51,24,0,15,36
70,Fail,45,30,3,14,31
70,Fail,54,22,0,15,39
70,Fail,51,28,0,11,40
70,Fail,47,27,1,12,35
70,Fail,45,23,0,20,25
70,Fail,52,25,0,12,40
70,Fail,48,28,0,14,34
70,Fail,49,29,0,7,42
70,Fail,45,26,3,13,32
70,Fail,49,34,0,10,39
70,Fail,59,25,0,9,50
70,Fail,44,31,1,13,31
70,Fail,38,41,0,15,23
70,Fail,44,26,5,19,25
70,Fail,57,22,0,10,47
70,Fail,50,23,1,11,39
70,Fail,42,32,0,13,29
70,Fail,44,26,0,18,26
70,Fail,46,32,0,12,34
70,Fail,49,24,2,14,35
70,Fail,47,30,1,11,36
70,Fail,51,22,0,14,37
70,Fail,40,35,0,9,31
70,Fail,48,30,0,13,35
70,Fail,49,28,0,11,38
70,Fail,48,29,1,12,36
70,Fail,48,25,2,9,39
70,Fail,56,18,5,8,48
70,Fail,44,35,0,13,31
70,Fail,49,28,6,10,39
70,Fail,47,34,0,9,38
70,Fail,50,22,0,11,39
70,Fail,46,34,0,6,40
70,Fail,50,30,0,10,40
70,Fail,44,25,8,13,31
70,Fail,49,32,0,11,38
70,Fail,50,25,0,14,36
70,Fail,50,27,0,13,37
70,Fail,43,31,0,11,32
70,Fail,50,21,0,14,36
70,Fail,48,35,0,11,37
70,Fail,49,21,5,16,33
70,Fail,58,26,0,7,51
70,Fail,44,32,6,8,36
70,Fail,53,26,0,7,46
70,Fail,46,29,0,11,35
70,Fail,42,45,0,9,33
70,Fail,48,26,8,9,39
70,Fail,47,22,4,18,29
70,Fail,57,23,0,8,49
70,Fail,52,21,0,13,39
70,Fail,53,19,0,16,37
70,Fail,50,20,6,15,35
70,Fail,46,28,0,14,32
70,Fail,53,20,5,14,39
70,Fail,48,29,2,9,39
70,Fail,50,27,0,13,37
70,Fail,53,24,3,10,43
70,Fail,57,18,0,15,42
70,Fail,46,28,7,11,35
70,Fail,42,27,1,15,27
70,Fail,45,36,0,12,33
70,Fail,50,22,2,16,34
70,Fail,45,26,7,11,34
70,Fail,49,33,0,9,40
70,Fail,47,30,3,9,38
70,Fail,41,29,0,17,24
70,Fail,46,28,0,13,33
70,Fail,46,25,6,16,30
70,Fail,44,30,9,9,35
70,Fail,46,27,0,14,32
70,Fail,37,35,0,17,20
70,Fail,45,31,0,16,29
70,Fail,45,25,12,11,34
70,Fail,54,21,0,12,42
70,Fail,42,32,0,18,24
70,Fail,48,18,6,18,30
70,Fail,50,31,5,7,43
70,Fail,49,23,1,14,35
70,Fail,47,33,0,12,35
70,Fail,47,26,0,14,33
70,Fail,56,23,2,8,48
70,Fail,55,20,3,7,48
70,Fail,52,28,4,11,41
70,Fail,44,22,13,15,29
70,Fail,44,33,3,10,34
70,Fail,48,30,0,10,38
70,Fail,42,30,0,20,22
70,Fail,58,18,1,10,48
70,Fail,47,34,0,13,34
70,Fail,42,26,6,16,26
70,Fail,42,36,0,12,30
70,Fail,44,37,0,11,33
70,Fail,50,22,7,9,41
70,Fail,50,35,0,4,46
70,Fail,44,22,0,23,21
70,Fail,51,25,0,10,41
70,Fail,42,27,0,17,25
70,Fail,54,22,0,12,42
70,Fail,52,27,0,9,43
70,Fail,51,23,0,14,37
70,Fail,52,22,0,16,36
70,Fail,48,21,0,15,33
70,Fail,49,19,0,17,32
70,Fail,47,22,8,14,33
70,Fail,45,31,6,9,36
70,Fail,54,26,0,11,43
70,Fail,49,28,0,17,32
70,Fail,48,22,0,16,32
70,Fail,43,27,6,11,32
70,Fail,45,34,0,9,36
70,Fail,45,24,0,18,27
70,Fail,52,23,0,13,39
70,Fail,54,25,0,10,44
70,Fail,48,28,0,14,34
70,Fail,50,21,0,12,38
70,Fail,44,25,4,15,29
70,Fail,42,29,7,11,31
70,Fail,54,28,5,6,48
70,Fail,53,23,0,10,43
70,Fail,45,30,0,15,30
70,Fail,44,30,0,18,26
70,Fail,46,27,0,16,30
70,Fail,48,27,0,14,34
70,Fail,38,35,0,17,21
70,Fail,46,32,0,10,36
70,Fail,40,31,2,14,26
70,Fail,45,25,6,15,30
70,Fail,40,31,5,14,26
70,Fail,44,30,0,16,28
70,Fail,54,25,8,5,49
70,Fail,46,21,2,17,29
70,Fail,55,23,0,11,44
70,Fail,45,31,0,15,30
70,Fail,53,22,2,13,40
70,Fail,43,30,0,20,23
70,Fail,45,25,9,8,37
70,Fail,44,23,4,14,30
70,Fail,40,23,15,13,27
70,Fail,45,37,0,8,37
70,Fail,44,33,0,10,34
70,Fail,45,29,10,11,34
70,Fail,45,28,7,13,32
70,Fail,42,27,7,14,28
70,Fail,50,29,4,9,41
70,Fail,49,18,12,14,35
70,Fail,49,34,0,9,40
70,Fail,55,18,0,13,42
70,Fail,51,26,0,11,40
70,Fail,49,28,0,13,36
70,Fail,50,23,7,10,40
70,Fail,53,21,0,14,39
70,Fail,51,33,0,8,43
70,Fail,45,31,0,15,30
70,Fail,45,28,0,15,30
70,Fail,51,27,0,13,38
70,Fail,47,23,5,16,31
70,Fail,50,31,0,6,44
70,Fail,49,24,0,12,37
70,Fail,45,28,3,8,37
70,Fail,55,25,0,10,45
70,Fail,46,29,0,14,32
70,Fail,44,25,3,13,31
70,Fail,48,19,9,16,32
70,Fail,53,19,1,17,36
70,Fail,49,31,0,8,41
70,Fail,49,33,0,11,38
70,Fail,56,26,1,7,49
70,Fail,41,36,3,10,31
70,Fail,41,43,0,9,32
70,Fail,45,36,0,13,32
70,Fail,51,27,0,11,40
70,Fail,41,34,0,15,26
70,Fail,50,27,0,13,37
70,Fail,47,22,4,15,32
70,Fail,48,17,11,15,33
70,Fail,51,20,7,11,40
70,Fail,50,22,2,15,35
70,Fail,49,34,0,10,39
70,Fail,60,22,3,5,55
70,Fail,42,29,0,17,25
70,Fail,53,25,0,11,42
70,Fail,50,26,0,9,41
70,Fail,49,22,0,11,38
70,Fail,46,29,2,13,33
70,Fail,47,28,3,12,35
70,Fail,49,30,7,7,42
70,Fail,46,28,3,13,33
70,Fail,45,28,4,13,32
70,Fail,60,15,0,10,50
70,Fail,42,37,3,9,33
70,Fail,52,24,0,13,39
70,Fail,51,26,0,14,37
70,Fail,42,28,3,14,28
70,Fail,59,20,0,10,49
70,Fail,49,25,8,5,44
70,Fail,53,27,5,8,45
70,Fail,49,20,2,15,34
70,Fail,44,24,0,16,28
70,Fail,54,24,0,16,38
70,Fail,47,35,0,10,37
70,Fail,40,25,7,14,26
70,Fail,47,28,0,12,35
70,Fail,54,21,0,13,41
70,Fail,46,36,0,6,40
70,Fail,37,36,0,15,22
70,Fail,46,30,4,9,37
70,Fail,46,27,0,14,32
70,Fail,51,27,0,14,37
70,Fail,42,37,0,17,25
70,Fail,46,25,0,20,26
70,Fail,48,23,3,13,35
70,Fail,49,26,0,15,34
70,Fail,50,27,3,10,40
70,Fail,42,31,4,11,31
70,Fail,47,38,0,7,40
70,Fail,52,31,0,10,42
70,Fail,43,30,0,19,24
70,Fail,55,13,7,12,43
70,Fail,50,27,4,10,40
70,Fail,46,38,0,8,38
70,Fail,46,28,8,12,34
70,Fail,49,24,0,12,37
70,Fail,51,27,0,14,37
70,Fail,52,29,0,8,44
70,Fail,48,26,6,13,35
70,Fail,43,36,0,15,28
70,Fail,51,29,0,10,41
70,Fail,52,23,1,12,40
70,Fail,46,27,2,11,35
70,Fail,49,24,8,9,40
70,Fail,51,28,0,11,40
70,Fail,46,23,9,14,32
70,Fail,53,21,3,14,39
70,Fail,49,23,5,11,38
70,Fail,52,21,2,10,42
70,Fail,45,23,4,15,30
70,Fail,45,24,3,18,27
70,Fail,46,31,0,16,30
70,Fail,41,32,0,18,23
70,Fail,47,23,5,11,36
70,Fail,49,32,0,10,39
70,Fail,54,30,0,8,46
70,Fail,44,25,5,11,33
70,Fail,52,21,0,13,39
70,Fail,48,27,0,13,35
70,Fail,47,29,0,14,33
70,Fail,46,29,7,7,39
70,Fail,55,25,0,11,44
70,Fail,51,22,0,14,37
70,Fail,49,24,1,17,32
70,Fail,48,36,0,6,42
70,Fail,47,23,5,16,31
70,Fail,43,28,0,16,27
70,Fail,43,24,9,16,27
70,Fail,54,23,0,10,44
70,Fail,55,27,1,5,50
70,Fail,41,35,0,13,28
70,Fail,56,18,2,13,43
70,Fail,52,27,0,8,44
70,Fail,50,35,0,9,41
70,Fail,54,22,2,13,41
70,Fail,45,30,1,13,32
70,Fail,48,31,1,10,38
70,Fail,43,28,6,15,28
70,Fail,46,35,0,11,35
70,Fail,42,29,6,16,26
70,Fail,51,22,3,12,39
70,Fail,51,32,1,7,44
70,Fail,48,23,0,16,32
70,Fail,50,25,0,17,33
70,Fail,44,29,0,12,32
70,Fail,43,28,4,15,28
70,Fail,48,32,0,10,38
70,Fail,51,29,0,11,40
70,Fail,54,25,0,13,41
70,Fail,44,32,5,13,31
70,Fail,45,27,5,11,34
70,Fail,52,22,1,12,40
70,Fail,45,28,7,15,30
70,Fail,60,16,5,10,50
70,Fail,61,22,0,8,53
70,Fail,46,30,0,15,31
70,Fail,54,20,0,11,43
70,Fail,43,36,0,12,31
70,Fail,49,25,0,13,36
70,Fail,51,23,0,13,38
70,Fail,50,28,0,9,41
70,Fail,45,34,1,12,33
70,Fail,52,25,1,8,44
70,Fail,46,24,4,14,32
70,Fail,46,19,11,12,34
70,Fail,45,32,0,12,33
70,Fail,46,24,0,19,27
70,Fail,46,33,0,10,36
70,Fail,49,29,0,7,42
70,Fail,61,20,2,8,53
70,Fail,51,23,2,15,36
70,Fail,46,35,0,8,38
70,Fail,57,23,3,9,48
70,Fail,43,24,7,14,29
70,Fail,46,33,0,15,31
70,Fail,57,27,0,6,51
70,Fail,44,31,2,14,30
70,Fail,51,27,0,9,42
70,Fail,48,25,1,14,34
70,Fail,50,24,7,11,39
70,Fail,41,32,0,14,27
70,Fail,46,26,0,15,31
70,Fail,49,16,2,21,28
70,Fail,43,31,6,12,31
70,Fail,42,29,10,16,26
70,Fail,51,28,0,11,40
70,Fail,50,22,0,15,35
70,Fail,42,31,0,15,27
70,Fail,37,38,0,17,20
70,Fail,38,27,13,14,24
70,Fail,49,27,3,10,39
70,Fail,46,32,0,12,34
70,Fail,44,25,8,16,28
70,Fail,48,30,0,14,34
70,Fail,48,16,12,15,33
70,Fail,43,25,4,17,26
70,Fail,50,26,6,11,39
70,Fail,47,24,4,14,33
70,Fail,49,29,0,15,34
70,Fail,37,32,7,17,20
70,Fail,40,37,0,14,26
70,Fail,47,18,1,19,28
70,Fail,44,32,0,11,33
70,Fail,55,19,0,16,39
70,Fail,53,21,1,10,43
70,Fail,49,33,0,12,37
70,Fail,49,27,0,12,37
70,Fail,56,26,0,5,51
70,Fail,53,19,2,15,38
70,Fail,51,23,4,13,38
70,Fail,51,26,2,9,42
70,Fail,52,22,6,12,40
70,Fail,42,38,0,13,29
70,Fail,54,25,0,8,46
70,Fail,47,35,0,8,39
70,Fail,49,33,0,14,35
70,Fail,49,19,5,19,30
70,Fail,44,34,0,9,35
70,Fail,51,22,9,10,41
70,Fail,54,22,1,10,44
70,Fail,40,38,0,11,29
70,Fail,44,28,0,15,29
70,Fail,49,22,4,17,32
70,Fail,52,26,0,7,45
70,Fail,49,17,1,17,32
70,Fail,52,23,0,14,38
70,Fail,50,27,5,8,42
70,Fail,37,36,0,18,19
70,Fail,48,34,0,9,39
70,Fail,49,23,11,10,39
70,Fail,53,25,0,9,44
70,Fail,45,28,0,14,31
70,Fail,44,25,5,11,33
70,Fail,45,32,0,16,29
70,Fail,41,36,0,13,28
70,Fail,44,29,0,13,31
70,Fail,44,24,4,14,30
70,Fail,46,28,0,16,30
70,Fail,44,31,0,17,27
70,Fail,44,31,3,13,31
70,Fail,48,33,0,9,39
70,Fail,49,27,4,10,39
70,Fail,55,23,0,13,42
70,Fail,43,29,1,18,25
70,Fail,51,23,2,16,35
70,Fail,47,24,0,17,30
70,Fail,49,31,0,9,40
70,Fail,47,28,0,16,31
70,Fail,51,23,5,10,41
70,Fail,45,30,4,12,33
70,Fail,51,21,4,12,39
70,Fail,38,24,12,17,21
70,Fail,45,26,2,16,29
70,Fail,47,26,1,15,32
70,Fail,52,26,3,7,45
70,Fail,52,33,0,5,47
70,Fail,48,24,0,19,29
70,Fail,48,29,0,13,35
70,Fail,56,22,1,7,49
70,Fail,51,29,0,12,39
70,Fail,51,30,0,9,42
70,Fail,48,33,0,10,38
70,Fail,41,38,0,12,29
70,Fail,50,32,0,8,42
70,Fail,45,35,0,14,31
70,Fail,50,28,0,14,36
70,Fail,53,18,5,16,37
70,Fail,58,20,2,7,51
70,Fail,47,21,0,19,28
70,Fail,55,22,2,10,45
70,Fail,45,23,2,18,27
70,Fail,49,27,0,14,35
70,Fail,46,24,5,16,30
70,Fail,51,23,0,15,36
70,Fail,46,24,9,14,32
70,Fail,43,35,3,12,31
70,Fail,48,26,0,13,35
70,Fail,48,23,7,12,36
70,Fail,49,22,7,10,39
70,Fail,40,30,4,16,24
70,Fail,45,33,2,11,34
70,Fail,48,23,0,12,36
70,Fail,48,25,3,15,33
70,Fail,51,27,9,8,43
70,Fail,52,25,0,12,40
70,Fail,46,25,3,12,34
70,Fail,42,27,1,17,25
70,Fail,40,33,8,8,32
70,Fail,47,24,6,14,33
70,Fail,50,19,3,14,36
70,Fail,51,23,0,14,37
70,Fail,50,24,5,13,37
70,Fail,50,30,0,9,41
70,Fail,51,23,2,14,37
70,Fail,49,33,0,7,42
70,Fail,55,16,5,14,41
70,Fail,48,30,0,10,38
70,Fail,44,31,5,17,27
70,Fail,48,27,4,10,38
70,Fail,47,20,7,14,33
70,Fail,57,18,1,11,46
70,Fail,44,31,0,15,29
70,Fail,52,27,0,11,41
70,Fail,51,30,0,10,41
70,Fail,56,21,2,7,49
70,Fail,52,20,0,14,38
70,Fail,58,22,0,7,51
70,Fail,41,36,0,12,29
70,Fail,46,21,8,15,31
70,Fail,51,18,8,16,35
70,Fail,49,22,3,14,35
70,Fail,50,27,0,11,39
70,Fail,41,35,0,14,27
70,Fail,56,23,0,10,46
70,Fail,45,32,0,17,28
70,Fail,47,33,0,13,34
70,Fail,48,23,0,17,31
70,Fail,50,31,0,10,40
70,Fail,43,19,13,11,32
70,Fail,43,28,1,20,23
70,Fail,47,27,9,9,38
70,Fail,56,23,0,8,48
70,Fail,46,27,0,11,35
70,Fail,48,36,0,10,38
70,Fail,52,23,1,12,40
70,Fail,57,19,0,12,45
70,Fail,46,31,0,12,34
70,Fail,43,34,2,12,31
70,Fail,47,17,5,22,25
70,Fail,37,36,0,20,17
70,Fail,62,16,0,10,52
70,Fail,40,31,8,15,25
70,Fail,44,28,1,13,31
70,Fail,53,23,6,8,45
70,Fail,56,29,0,5,51
70,Fail,47,32,0,6,41
70,Fail,48,23,6,14,34
70,Fail,46,30,0,14,32
70,Fail,47,25,5,13,34
70,Fail,52,23,0,12,40
70,Fail,43,34,0,14,29
70,Fail,51,23,0,15,36
70,Fail,48,20,0,22,26
70,Fail,55,20,2,10,45
70,Fail,47,27,0,13,34
70,Fail,46,27,0,15,31
70,Fail,52,26,0,10,42
70,Fail,46,31,0,12,34
70,Fail,44,22,14,13,31
70,Fail,47,19,10,16,31
70,Fail,42,35,0,12,30
70,Fail,54,23,0,13,41
70,Fail,44,29,5,13,31
70,Fail,45,22,3,19,26
70,Fail,40,32,0,17,23
70,Fail,57,23,2,5,52
70,Fail,60,21,3,5,55
70,Fail,53,21,0,12,41
70,Fail,43,31,2,16,27
70,Fail,45,39,0,11,34
70,Fail,44,29,0,15,29
70,Fail,48,23,0,14,34
70,Fail,42,28,11,8,34
70,Fail,43,38,0,10,33
70,Fail,55,24,0,11,44
70,Fail,43,32,0,18,25
70,Fail,48,36,0,8,40
70,Fail,49,25,1,10,39
70,Fail,52,19,2,14,38
70,Fail,39,36,0,12,27
70,Fail,48,31,0,9,39
70,Fail,41,29,7,14,27
70,Fail,53,26,4,8,45
70,Fail,50,28,0,8,42
70,Fail,51,22,4,11,40
70,Fail,41,31,7,15,26
70,Fail,52,29,2,5,47
70,Fail,44,34,0,12,32
70,Fail,46,25,4,15,31
70,Fail,49,34,0,8,41
70,Fail,47,30,0,14,33
70,Fail,51,22,0,16,35
70,Fail,51,25,0,9,42
70,Fail,54,21,5,11,43
70,Fail,56,19,0,12,44
70,Fail,54,24,0,9,45
70,Fail,49,25,2,11,38
70,Fail,47,25,2,14,33
70,Fail,52,24,0,15,37
70,Fail,48,32,0,15,33
70,Fail,52,27,0,8,44
70,Fail,53,21,0,14,39
70,Fail,46,30,1,11,35
70,Fail,48,26,2,15,33
70,Fail,40,37,0,13,27
70,Fail,52,24,3,13,39
70,Fail,51,26,0,11,40
70,Fail,53,21,1,12,41
70,Fail,49,22,1,12,37
70,Fail,50,29,0,15,35
70,Fail,50,27,0,13,37
70,Fail,48,26,0,16,32
70,Fail,46,30,0,13,33
70,Fail,52,15,5,20,32
70,Fail,52,24,0,15,37
70,Fail,55,21,1,8,47
70,Fail,52,30,0,11,41
70,Fail,41,44,0,5,36
70,Fail,59,22,0,7,52
70,Fail,43,33,0,16,27
70,Fail,52,24,0,13,39
70,Fail,45,30,0,16,29
70,Fail,51,26,0,11,40
70,Fail,45,22,10,15,30
70,Fail,54,24,0,13,41
70,Fail,43,37,0,15,28
70,Fail,49,27,1,8,41
70,Fail,45,38,0,9,36
70,Fail,48,24,3,14,34
70,Fail,56,20,6,13,43
70,Fail,51,23,6,15,36
70,Fail,51,26,0,10,41
70,Fail,49,30,0,8,41
70,Fail,40,29,4,16,24
70,Fail,44,31,0,14,30
70,Fail,58,17,2,13,45
70,Fail,48,29,1,11,37
70,Fail,54,23,3,9,45
70,Fail,39,36,0,12,27
70,Fail,44,25,0,16,28
70,Fail,50,27,0,13,37
70,Fail,56,27,0,8,48
70,Fail,50,16,11,14,36
70,Fail,51,24,4,10,41
70,Fail,48,24,1,18,30
70,Fail,45,31,0,12,33
70,Fail,52,18,6,10,42
70,Fail,43,34,0,17,26
70,Fail,50,27,0,12,38
70,Fail,45,33,0,13,32
70,Fail,56,18,0,14,42
70,Fail,46,28,0,15,31
70,Fail,53,25,0,14,39
70,Fail,46,28,3,15,31
70,Fail,46,27,7,14,32
70,Fail,42,34,7,12,30
70,Fail,59,23,0,7,52
70,Fail,56,27,0,8,48
70,Fail,43,31,0,14,29
70,Fail,54,24,1,9,45
70,Fail,41,26,2,18,23
70,Fail,49,29,0,10,39
70,Fail,47,30,0,13,34
70,Fail,47,21,7,16,31
70,Fail,61,18,0,11,50
70,Fail,49,24,0,14,35
70,Fail,47,23,0,13,34
70,Fail,52,23,2,11,41
70,Fail,43,25,5,15,28
70,Fail,40,33,0,15,25
70,Fail,53,21,1,12,41
70,Fail,46,34,0,12,34
70,Fail,50,19,2,17,33
70,Fail,49,27,4,11,38
70,Fail,46,29,0,14,32
70,Fail,55,20,9,11,44
70,Fail,50,21,0,15,35
70,Fail,39,31,0,17,22
70,Fail,45,37,0,11,34
70,Fail,55,18,1,13,42
70,Fail,42,29,0,17,25
70,Fail,45,21,0,21,24
70,Fail,50,29,0,9,41
70,Fail,52,25,6,9,43
70,Fail,50,21,0,14,36
70,Fail,48,28,0,11,37
70,Fail,46,27,4,13,33
70,Fail,53,24,2,6,47
70,Fail,55,19,7,9,46
70,Fail,48,22,6,17,31
70,Fail,47,25,2,11,36
70,Fail,49,23,5,11,38
70,Fail,49,28,4,4,45
70,Fail,51,16,1,17,34
70,Fail,47,23,6,14,33
70,Fail,51,28,0,12,39
70,Fail,50,22,1,15,35
70,Fail,40,32,0,19,21
70,Fail,48,33,0,12,36
70,Fail,46,27,3,10,36
70,Fail,49,30,0,10,39
70,Fail,49,32,0,11,38
70,Fail,47,21,4,16,31
70,Fail,54,20,4,11,43
70,Fail,51,22,0,14,37
70,Fail,56,33,0,4,52
70,Fail,55,21,0,12,43
70,Fail,51,27,0,12,39
70,Fail,48,31,0,10,38
70,Fail,51,20,0,11,40
70,Fail,42,24,9,11,31
70,Fail,54,24,0,12,42
70,Fail,50,27,2,10,40
70,Fail,44,33,0,12,32
70,Fail,47,26,3,13,34
70,Fail,55,18,6,9,46
70,Fail,49,28,0,12,37
70,Fail,52,26,0,10,42
70,Fail,43,35,0,10,33
70,Fail,46,28,0,19,27
70,Fail,46,25,3,15,31
70,Fail,54,23,0,12,42
70,Fail,58,24,0,5,53
70,Fail,49,21,5,18,31
70,Fail,52,30,0,10,42
70,Fail,44,27,11,15,29
70,Fail,47,19,4,18,29
70,Fail,48,22,0,16,32
70,Fail,53,19,3,10,43
70,Fail,58,16,3,13,45
70,Fail,51,23,0,13,38
70,Fail,50,25,3,12,38
70,Fail,45,30,0,15,30
70,Fail,48,24,6,12,36
70,Fail,47,24,7,11,36
70,Fail,54,25,0,9,45
70,Fail,53,23,0,8,45
70,Fail,51,26,0,11,40
70,Fail,48,20,2,18,30
70,Fail,51,24,3,12,39
70,Fail,48,29,0,11,37
70,Fail,44,32,0,16,28
70,Fail,49,25,0,13,36
70,Fail,49,28,0,12,37
70,Fail,38,35,0,15,23
70,Fail,51,23,6,12,39
70,Fail,49,17,2,18,31
70,Fail,50,25,2,11,39
70,Fail,48,20,0,16,32
70,Fail,53,19,1,15,38
70,Fail,52,27,1,11,41
70,Fail,48,22,5,15,33
70,Fail,52,20,0,15,37
70,Fail,55,27,0,5,50
70,Fail,51,28,3,9,42
70,Fail,49,28,2,11,38
70,Fail,51,26,0,10,41
70,Fail,41,32,2,14,27
70,Fail,50,20,0,18,32
70,Fail,49,21,8,14,35
70,Fail,46,29,0,15,31
70,Fail,52,22,0,13,39
70,Fail,50,30,0,12,38
70,Fail,49,30,0,13,36
70,Fail,47,30,0,13,34
70,Fail,52,21,0,16,36
70,Fail,51,23,0,16,35
70,Fail,41,34,0,14,27
70,Fail,47,23,3,15,32
70,Fail,50,25,0,13,37
70,Fail,55,20,4,10,45
70,Fail,42,32,4,13,29
70,Fail,44,36,0,14,30
70,Fail,49,30,3,7,42
70,Fail,55,23,0,9,46
70,Fail,49,27,0,13,36
70,Fail,44,27,3,15,29
70,Fail,50,25,4,13,37
70,Fail,43,31,4,9,34
70,Fail,44,22,5,19,25
70,Fail,42,26,4,18,24
70,Fail,52,18,2,18,34
70,Fail,49,26,1,11,38
70,Fail,52,20,4,13,39
70,Fail,45,30,0,14,31
70,Fail,40,25,8,16,24
70,Fail,40,31,8,16,24
70,Fail,47,32,0,11,36
70,Fail,48,25,6,14,34
70,Fail,52,19,1,15,37
70,Fail,46,27,5,9,37
70,Fail,54,25,1,11,43
70,Fail,51,24,3,12,39
70,Fail,51,33,0,7,44
70,Fail,51,27,5,9,42
70,Fail,46,32,0,11,35
70,Fail,45,31,4,12,33
70,Fail,43,33,0,13,30
70,Fail,57,27,0,7,50
70,Fail,47,24,5,14,33
70,Fail,52,28,0,6,46
70,Fail,49,25,0,16,33
70,Fail,45,31,0,15,30
70,Fail,52,26,0,9,43
70,Fail,48,24,0,13,35
70,Fail,50,27,2,13,37
70,Fail,50,20,2,15,35
70,Fail,52,28,1,7,45
70,Fail,55,26,0,12,43
70,Fail,47,23,9,17,30
70,Fail,57,21,0,8,49
70,Fail,44,33,0,10,34
70,Fail,54,27,2,8,46
70,Fail,51,24,3,10,41
70,Fail,53,26,0,12,41
70,Fail,55,24,0,10,45
70,Fail,45,33,0,13,32
70,Fail,47,30,6,11,36
70,Fail,41,35,0,9,32
70,Fail,53,24,0,12,41
70,Fail,54,25,1,7,47
70,Fail,48,25,0,17,31
70,Fail,50,25,6,9,41
70,Fail,49,27,3,13,36
70,Fail,50,28,2,6,44
70,Fail,46,30,0,13,33
70,Fail,40,31,7,14,26
70,Fail,42,43,0,11,31
70,Fail,45,30,3,11,34
70,Fail,45,31,0,12,33
70,Fail,47,29,1,13,34
70,Fail,54,29,0,10,44
70,Fail,48,24,0,17,31
70,Fail,45,26,4,12,33
70,Fail,46,29,0,15,31
70,Fail,46,30,0,13,33
70,Fail,52,23,3,11,41
70,Fail,47,32,5,10,37
70,Fail,53,27,2,8,45
70,Fail,48,32,3,7,41
70,Fail,52,26,0,12,40
70,Fail,49,24,5,16,33
70,Fail,49,26,0,13,36
70,Fail,53,22,4,11,42
70,Fail,48,37,0,5,43
70,Fail,49,32,2,7,42
70,Fail,53,26,0,9,44
70,Fail,51,28,0,8,43
70,Fail,39,35,0,14,25
70,Fail,53,18,0,16,37
70,Fail,44,30,1,13,31
70,Fail,44,34,0,12,32
70,Fail,43,31,6,10,33
70,Fail,47,30,0,12,35
70,Fail,46,28,2,12,34
70,Fail,45,29,4,12,33
70,Fail,45,27,0,16,29
70,Fail,45,24,2,15,30
70,Fail,44,27,3,13,31
70,Fail,58,22,5,7,51
70,Fail,40,33,4,10,30
70,Fail,48,33,0,8,40
70,Fail,48,32,0,12,36
70,Fail,47,28,1,14,33
70,Fail,50,24,0,14,36
70,Fail,41,34,0,13,28
70,Fail,56,19,1,10,46
70,Fail,43,27,4,14,29
70,Fail,46,30,0,14,32
70,Fail,49,21,0,16,33
70,Fail,46,28,0,12,34
70,Fail,46,26,1,15,31
70,Fail,43,21,10,19,24
70,Fail,49,29,0,12,37
70,Fail,50,27,0,8,42
70,Fail,50,31,0,12,38
70,Fail,51,23,3,10,41
70,Fail,45,28,0,15,30
70,Fail,50,25,2,11,39
70,Fail,47,23,1,14,33
70,Fail,51,30,0,12,39
70,Fail,53,16,6,10,43
70,Fail,53,19,5,15,38
70,Fail,50,25,4,11,39
70,Fail,38,37,0,15,23
70,Fail,47,33,0,8,39
70,Fail,52,20,3,14,38
70,Fail,44,30,0,16,28
70,Fail,43,31,5,12,31
70,Fail,52,21,2,14,38
70,Fail,54,18,0,18,36
70,Fail,39,41,0,12,27
70,Fail,46,26,4,13,33
70,Fail,48,28,0,12,36
70,Fail,50,22,8,7,43
70,Fail,50,28,0,8,42
70,Fail,47,23,9,15,32
70,Fail,42,37,0,15,27
70,Fail,48,24,4,14,34
70,Fail,41,27,0,16,25
70,Fail,45,35,0,13,32
70,Fail,52,25,0,11,41
70,Fail,40,37,1,15,25
70,Fail,47,29,0,14,33
70,Fail,43,33,0,11,32
70,Fail,51,21,2,15,36
70,Fail,46,34,0,8,38
70,Fail,43,33,0,14,29
70,Fail,46,24,1,19,27
70,Fail,51,25,1,11,40
70,Fail,52,22,7,9,43
70,Fail,50,27,4,8,42
70,Fail,45,30,0,13,32
70,Fail,45,29,0,15,30
70,Fail,52,20,7,10,42
70,Fail,46,24,5,15,31
70,Fail,48,28,0,12,36
70,Fail,56,21,0,10,46
70,Fail,51,28,0,7,44
70,Fail,51,26,6,9,42
70,Fail,48,29,6,8,40
70,Fail,38,30,9,14,24
70,Fail,48,20,0,20,28
70,Fail,39,28,9,17,22
70,Fail,45,39,0,9,36
70,Fail,44,23,0,21,23
70,Fail,55,19,2,12,43
70,Fail,49,26,1,12,37
70,Fail,50,23,3,10,40
70,Fail,48,29,2,13,35
70,Fail,50,31,0,13,37
70,Fail,42,32,5,11,31
70,Fail,48,30,0,12,36
70,Fail,46,25,2,12,34
70,Fail,48,26,0,16,32
70,Fail,51,19,9,8,43
70,Fail,48,34,0,6,42
70,Fail,51,22,3,14,37
70,Fail,45,26,5,14,31
70,Fail,49,32,0,9,40
70,Fail,49,25,0,13,36
70,Fail,53,27,0,10,43
70,Fail,48,32,0,13,35
70,Fail,44,34,6,9,35
70,Fail,50,28,8,8,42
70,Fail,47,29,0,15,32
70,Fail,44,33,0,15,29
70,Fail,51,30,0,6,45
70,Fail,49,25,7,12,37
70,Fail,48,30,2,10,38
70,Fail,46,29,1,13,33
70,Fail,47,24,8,12,35
70,Fail,43,24,0,21,22
70,Fail,53,20,0,12,41
70,Fail,47,21,5,16,31
70,Fail,52,16,1,17,35
70,Fail,51,24,2,13,38
70,Fail,45,26,10,14,31
70,Fail,48,23,9,12,36
70,Fail,50,22,4,14,36
70,Fail,55,24,3,8,47
70,Fail,47,30,0,15,32
70,Fail,46,25,2,13,33
70,Fail,47,30,0,12,35
70,Fail,44,38,0,9,35
70,Fail,46,31,0,11,35
70,Fail,45,27,2,14,31
70,Fail,54,25,0,12,42
70,Fail,40,36,0,15,25
70,Fail,56,25,0,9,47
70,Fail,50,24,0,13,37
70,Fail,43,24,8,18,25
70,Fail,44,30,3,13,31
70,Fail,46,32,0,13,33
70,Fail,52,24,2,10,42
70,Fail,51,31,0,7,44
70,Fail,40,28,8,14,26
70,Fail,51,25,1,10,41
70,Fail,44,31,0,14,30
70,Fail,43,28,6,14,29
70,Fail,45,40,0,12,33
70,Fail,50,22,0,17,33
70,Fail,45,35,0,11,34
70,Fail,55,25,3,7,48
70,Fail,50,28,0,11,39
70,Fail,43,27,7,20,23
70,Fail,41,36,3,14,27
70,Fail,51,31,0,8,43
70,Fail,55,22,0,11,44
70,Fail,40,37,0,17,23
70,Fail,49,27,0,13,36
70,Fail,45,34,0,13,32
70,Fail,42,27,0,17,25
70,Fail,56,25,0,8,48
70,Fail,46,30,2,13,33
70,Fail,43,26,3,18,25
70,Fail,57,26,0,8,49
70,Fail,49,29,0,14,35
70,Fail,50,21,3,18,32
70,Fail,52,30,0,8,44
70,Fail,48,27,0,13,35
70,Fail,48,28,0,15,33
70,Fail,49,23,3,14,35
70,Fail,47,29,0,12,35
70,Fail,52,25,4,11,41
70,Fail,42,32,0,16,26
70,Fail,51,22,7,10,41
70,Fail,47,27,3,16,31
70,Fail,44,34,0,13,31
70,Fail,42,22,11,13,29
70,Fail,46,22,5,12,34
70,Fail,41,26,10,15,26
70,Fail,44,27,5,15,29
70,Fail,46,28,0,16,30
70,Fail,43,29,6,11,32
70,Fail,45,38,0,7,38
70,Fail,56,27,0,6,50
70,Fail,47,35,1,7,40
70,Fail,43,36,0,13,30
70,Fail,46,30,0,16,30
70,Fail,45,36,6,6,39
70,Fail,45,25,4,19,26
70,Fail,43,27,2,18,25
70,Fail,51,26,7,7,44
70,Fail,59,22,1,9,50
70,Fail,54,20,0,11,43
70,Fail,51,29,1,8,43
70,Fail,52,21,4,11,41
70,Fail,56,24,0,5,51
70,Fail,47,32,3,9,38
70,Fail,46,30,0,13,33
70,Fail,51,22,3,13,38
70,Fail,51,24,0,13,38
70,Fail,47,23,7,17,30
70,Fail,48,28,1,10,38
70,Fail,39,21,15,19,20
70,Fail,52,28,1,10,42
70,Fail,43,36,0,11,32
70,Fail,49,23,0,18,31
70,Fail,47,29,2,10,37
70,Fail,51,30,0,10,41
70,Fail,44,29,0,18,26
70,Fail,53,21,0,13,40
70,Fail,56,23,1,9,47
70,Fail,51,22,0,13,38
70,Fail,49,31,0,10,39
70,Fail,45,34,0,11,34
70,Fail,40,31,6,10,30
70,Fail,49,21,6,14,35
70,Fail,50,26,0,9,41
70,Fail,52,30,0,8,44
70,Fail,42,37,0,11,31
70,Fail,47,25,0,14,33
70,Fail,49,29,4,8,41
70,Fail,41,32,7,11,30
70,Fail,46,32,0,14,32
70,Fail,49,31,0,9,40
70,Fail,48,26,4,11,37
70,Fail,45,24,10,14,31
70,Fail,50,26,0,13,37
70,Fail,45,28,0,19,26
70,Fail,49,25,2,14,35
70,Fail,52,28,4,9,43
70,Fail,49,34,0,9,40
70,Fail,45,29,0,13,32
70,Fail,47,26,9,13,34
70,Fail,46,28,2,10,36
70,Fail,50,28,2,9,41
70,Fail,58,16,3,12,46
70,Fail,45,26,6,12,33
70,Fail,39,37,0,15,24
70,Fail,55,19,6,13,42
70,Fail,52,19,6,10,42
70,Fail,51,28,0,12,39
70,Fail,52,28,0,10,42
70,Fail,48,24,0,15,33
70,Fail,51,24,1,16,35
70,Fail,48,25,5,12,36
70,Fail,56,21,3,8,48
70,Fail,51,32,0,6,45
70,Fail,48,24,0,15,33
70,Fail,48,26,0,13,35
70,Fail,44,31,0,16,28
70,Fail,48,23,2,16,32
70,Fail,43,28,8,14,29
70,Fail,45,35,0,8,37
70,Fail,44,35,0,14,30
70,Fail,55,22,0,12,43
70,Fail,54,16,3,15,39
70,Fail,50,33,4,3,47
70,Fail,51,20,8,14,37
70,Fail,41,29,5,16,25
70,Fail,48,29,0,13,35
70,Fail,51,20,1,15,36
70,Fail,60,15,5,10,50
70,Fail,45,21,8,16,29
70,Fail,46,38,0,11,35
70,Fail,55,23,0,11,44
70,Fail,48,35,0,5,43
70,Fail,41,37,0,15,26
70,Fail,51,27,0,13,38
70,Fail,46,29,6,12,34
70,Fail,42,40,0,9,33
70,Fail,45,30,0,16,29
70,Fail,49,23,1,12,37
70,Fail,41,33,6,10,31
70,Fail,49,30,1,13,36
70,Fail,46,29,6,9,37
70,Fail,52,21,0,13,39
70,Fail,47,22,0,14,33
70,Fail,54,24,4,9,45
70,Fail,51,34,2,6,45
70,Fail,47,24,2,15,32
70,Fail,50,26,2,13,37
70,Fail,46,30,1,14,32
70,Fail,56,19,2,11,45
70,Fail,48,24,1,18,30
70,Fail,48,36,0,9,39
70,Fail,45,31,1,12,33
70,Fail,46,36,0,9,37
70,Fail,41,34,5,9,32
70,Fail,48,24,4,12,36
70,Fail,49,27,1,8,41
70,Fail,60,14,5,13,47
70,Fail,51,20,4,13,38
70,Fail,41,23,10,15,26
70,Fail,46,25,0,13,33
70,Fail,49,33,0,7,42
70,Fail,51,22,2,14,37
70,Fail,45,31,0,13,32
70,Fail,50,26,3,10,40
70,Fail,58,20,0,11,47
70,Fail,50,24,6,12,38
70,Fail,54,21,0,11,43
70,Fail,50,32,1,10,40
70,Fail,43,26,8,12,31
70,Fail,52,27,3,10,42
70,Fail,49,31,0,14,35
70,Fail,39,25,7,19,20
70,Fail,44,29,8,13,31
70,Fail,45,31,0,14,31
70,Fail,49,22,3,16,33
70,Fail,43,27,0,19,24
70,Fail,49,26,0,13,36
70,Fail,60,16,0,10,50
70,Fail,52,18,8,15,37
70,Fail,43,36,0,13,30
70,Fail,50,27,0,13,37
70,Fail,60,21,0,9,51
70,Fail,47,26,8,11,36
70,Fail,52,21,3,11,41
70,Fail,50,30,0,9,41
70,Fail,52,21,0,15,37
70,Fail,43,30,1,14,29
70,Fail,45,22,5,18,27
70,Fail,44,38,0,12,32
70,Fail,39,27,11,16,23
70,Fail,46,34,0,13,33
70,Fail,49,25,6,12,37
70,Fail,46,28,0,14,32
70,Fail,46,25,2,16,30
70,Fail,45,24,10,13,32
70,Fail,51,28,0,8,43
70,Fail,44,25,1,18,26
70,Fail,45,28,1,12,33
70,Fail,49,29,0,13,36
70,Fail,47,24,4,19,28
70,Fail,44,31,0,17,27
70,Fail,49,28,0,12,37
70,Fail,55,20,0,13,42
70,Fail,53,22,0,11,42
70,Fail,40,28,2,18,22
70,Fail,52,23,5,11,41
70,Fail,50,28,0,10,40
70,Fail,49,33,0,9,40
70,Fail,50,36,0,10,40
70,Fail,44,34,0,16,28
70,Fail,53,22,6,9,44
70,Fail,47,27,10,10,37
70,Fail,53,25,6,7,46
70,Fail,45,31,1,11,34
70,Fail,45,25,5,12,33
70,Fail,43,35,0,11,32
70,Fail,45,27,6,11,34
70,Fail,48,24,2,13,35
70,Fail,46,27,0,18,28
70,Fail,44,31,0,15,29
70,Fail,45,31,0,14,31
70,Fail,53,28,0,11,42
70,Fail,36,50,0,9,27
70,Fail,43,26,0,20,23
70,Fail,48,27,0,13,35
70,Fail,55,26,0,7,48
70,Fail,54,24,7,9,45
70,Fail,41,35,2,10,31
70,Fail,48,31,0,9,39
70,Fail,49,19,3,19,30
70,Fail,57,21,0,5,52
70,Fail,49,25,2,18,31
70,Fail,56,26,1,9,47
70,Fail,50,27,0,11,39
70,Fail,50,31,0,10,40
70,Fail,49,22,0,16,33
70,Fail,55,22,0,9,46
70,Fail,48,27,0,13,35
70,Fail,53,23,0,14,39
70,Fail,46,24,6,16,30
70,Fail,53,22,0,11,42
70,Fail,41,30,0,17,24
70,Fail,54,19,2,14,40
70,Fail,58,22,0,10,48
70,Fail,46,29,1,12,34
70,Fail,47,24,8,12,35
70,Fail,54,23,1,11,43
70,Fail,47,26,5,12,35
70,Fail,54,21,0,13,41
70,Fail,52,21,4,12,40
70,Fail,45,25,9,14,31
70,Fail,52,30,0,9,43
70,Fail,50,26,2,9,41
70,Fail,51,25,2,9,42
70,Fail,53,23,4,11,42
70,Fail,49,25,5,11,38
70,Fail,42,36,0,10,32
70,Fail,45,33,0,14,31
70,Fail,48,25,3,11,37
70,Fail,40,33,3,14,26
70,Fail,46,37,0,11,35
70,Fail,47,38,0,10,37
70,Fail,54,26,0,10,44
70,Fail,47,30,0,12,35
70,Fail,55,26,0,13,42
70,Fail,47,31,3,10,37
70,Fail,42,26,4,14,28
70,Fail,52,23,3,12,40
70,Fail,43,36,0,10,33
70,Fail,45,31,0,14,31
70,Fail,45,37,0,11,34
70,Fail,45,34,2,12,33
70,Fail,49,29,0,12,37
70,Fail,42,29,7,9,33
70,Fail,57,16,0,17,40
70,Fail,45,29,4,13,32
70,Fail,49,31,0,11,38
70,Fail,52,25,0,14,38
70,Fail,53,20,8,9,44
70,Fail,52,22,9,13,39
70,Fail,41,32,4,15,26
70,Fail,45,32,0,14,31
70,Fail,45,37,0,9,36
70,Fail,50,27,0,13,37
70,Fail,47,23,4,14,33
70,Fail,55,18,4,12,43
70,Fail,44,41,0,9,35
70,Fail,46,35,0,10,36
70,Fail,46,37,0,9,37
70,Fail,42,29,0,17,25
70,Fail,45,29,0,15,30
70,Fail,60,15,0,13,47
70,Fail,45,29,3,11,34
70,Fail,46,32,0,12,34
70,Fail,55,21,3,11,44
70,Fail,53,29,3,8,45
70,Fail,46,27,0,15,31
70,Fail,49,22,7,13,36
70,Fail,43,29,0,13,30
70,Fail,43,34,0,13,30
70,Fail,44,37,0,9,35
70,Fail,45,30,1,9,36
70,Fail,51,28,0,6,45
70,Fail,57,22,0,8,49
70,Fail,54,23,3,9,45
70,Fail,47,26,0,12,35
70,Fail,46,25,12,10,36
70,Fail,52,22,0,12,40
70,Fail,42,25,3,18,24
70,Fail,52,23,0,13,39
70,Fail,51,26,0,13,38
70,Fail,49,19,3,16,33
70,Fail,54,24,1,8,46
70,Fail,47,29,0,9,38
70,Fail,44,32,0,13,31
70,Fail,56,26,0,9,47
70,Fail,45,23,0,18,27
70,Fail,51,24,8,13,38
70,Fail,52,19,7,10,42
70,Fail,57,22,0,12,45
70,Fail,54,22,0,10,44
70,Fail,43,31,0,18,25
70,Fail,49,25,1,13,36
70,Fail,46,27,6,11,35
70,Fail,47,34,3,7,40
70,Fail,51,21,0,14,37
70,Fail,39,28,2,19,20
70,Fail,45,21,8,14,31
70,Fail,50,23,4,9,41
70,Fail,48,29,0,10,38
70,Fail,41,29,10,13,28
70,Fail,43,33,0,16,27
70,Fail,50,23,1,12,38
70,Fail,41,31,6,14,27
70,Fail,53,24,4,13,40
70,Fail,47,27,0,14,33
70,Fail,52,23,1,12,40
70,Fail,47,23,9,12,35
70,Fail,48,26,0,16,32
70,Fail,40,27,7,16,24
70,Fail,48,34,0,10,38
70,Fail,51,25,0,10,41
70,Fail,43,32,3,14,29
70,Fail,44,31,0,16,28
70,Fail,48,22,3,15,33
70,Fail,43,33,0,12,31
70,Fail,40,30,5,13,27
70,Fail,49,24,10,11,38
70,Fail,52,25,1,10,42
70,Fail,42,29,1,15,27
70,Fail,49,21,4,17,32
70,Fail,47,31,0,12,35
70,Fail,44,31,0,12,32
70,Fail,55,21,0,14,41
70,Fail,51,20,0,16,35
70,Fail,47,27,6,9,38
70,Fail,51,26,6,8,43
70,Fail,43,27,0,17,26
70,Fail,48,19,8,14,34
70,Fail,41,26,0,23,18
70,Fail,46,27,0,12,34
70,Fail,40,32,11,11,29
70,Fail,45,26,6,16,29
70,Fail,48,29,1,10,38
70,Fail,46,27,6,12,34
70,Fail,46,35,0,10,36
70,Fail,49,29,0,12,37
70,Fail,42,37,0,10,32
70,Fail,49,25,1,12,37
70,Fail,52,24,0,11,41
70,Fail,50,27,0,11,39
70,Fail,48,25,0,13,35
70,Fail,48,27,0,10,38
70,Fail,48,21,6,16,32
70,Fail,50,23,6,10,40
70,Fail,48,25,10,10,38
70,Fail,43,27,9,16,27
70,Fail,47,30,1,12,35
70,Fail,46,24,0,18,28
70,Fail,50,32,0,8,42
70,Fail,50,27,5,10,40
70,Fail,51,22,0,15,36
70,Fail,45,33,0,12,33
70,Fail,49,24,0,12,37
70,Fail,45,29,1,11,34
70,Fail,52,24,5,9,43
70,Fail,49,33,0,9,40
70,Fail,50,26,1,12,38
70,Fail,41,32,0,17,24
70,Fail,49,28,3,13,36
70,Fail,46,27,0,17,29
70,Fail,49,30,0,13,36
70,Fail,51,21,4,14,37
70,Fail,41,28,1,20,21
70,Fail,52,24,0,16,36
70,Fail,40,35,8,10,30
70,Fail,51,21,5,16,35
70,Fail,44,34,0,12,32
70,Fail,52,24,0,14,38
70,Fail,54,25,0,9,45
70,Fail,38,34,0,17,21
70,Fail,50,29,2,11,39
70,Fail,57,16,4,8,49
70,Fail,43,35,0,13,30
70,Fail,47,35,0,11,36
70,Fail,44,31,2,11,33
70,Fail,43,31,1,16,27
70,Fail,51,25,0,15,36
70,Fail,55,22,0,16,39
70,Fail,44,34,0,11,33
70,Fail,51,27,0,12,39
70,Fail,48,30,0,11,37
70,Fail,49,22,0,15,34
70,Fail,53,23,0,11,42
70,Fail,52,28,1,13,39
70,Fail,56,23,0,10,46
70,Fail,43,35,0,9,34
70,Fail,51,31,0,14,37
70,Fail,44,25,9,12,32
70,Fail,54,21,4,13,41
70,Fail,48,27,0,13,35
70,Fail,43,32,0,14,29
70,Fail,53,21,6,12,41
70,Fail,43,31,0,17,26
70,Fail,50,29,0,10,40
70,Fail,51,24,4,11,40
70,Fail,44,33,0,12,32
70,Fail,43,37,0,16,27
70,Fail,48,27,0,19,29
70,Fail,47,24,0,12,35
70,Fail,44,35,0,10,34
70,Fail,42,34,0,17,25
70,Fail,52,23,0,13,39
70,Fail,44,35,0,14,30
70,Fail,59,19,1,6,53
70,Fail,46,28,0,16,30
70,Fail,54,26,0,10,44
70,Fail,48,22,0,18,30
70,Fail,45,25,0,14,31
70,Fail,49,31,0,11,38
70,Fail,43,35,0,16,27
70,Fail,51,31,0,7,44
70,Fail,55,16,0,16,39
70,Fail,62,14,5,12,50
70,Fail,40,33,0,17,23
70,Fail,48,35,0,9,39
70,Fail,50,29,0,12,38
70,Fail,47,26,1,17,30
70,Fail,50,28,1,10,40
70,Fail,50,29,0,12,38
70,Fail,46,26,5,13,33
70,Fail,53,30,0,7,46
70,Fail,57,22,1,10,47
70,Fail,51,29,0,12,39
70,Fail,51,28,0,11,40
70,Fail,55,27,0,12,43
70,Fail,52,23,6,10,42
70,Fail,49,38,0,9,40
70,Fail,47,28,0,10,37
70,Fail,40,25,9,16,24
70,Fail,50,24,4,13,37
70,Fail,47,27,0,15,32
70,Fail,42,26,0,15,27
70,Fail,49,20,2,15,34
70,Fail,56,19,1,11,45
70,Fail,48,30,0,11,37
70,Fail,49,29,0,11,38
70,Fail,47,38,0,11,36
70,Fail,52,28,2,5,47
70,Fail,45,26,0,18,27
70,Fail,47,27,0,11,36
70,Fail,46,24,4,17,29
70,Fail,48,31,0,15,33
70,Fail,50,28,8,6,44
70,Fail,52,24,0,13,39
70,Fail,51,26,0,15,36
70,Fail,45,33,0,12,33
70,Fail,48,28,3,13,35
70,Fail,54,26,1,10,44
70,Fail,46,30,6,6,40
70,Fail,44,20,9,17,27
70,Fail,48,23,0,15,33
70,Fail,55,21,4,11,44
70,Fail,49,25,0,12,37
70,Fail,51,31,0,10,41
70,Fail,47,32,0,12,35
70,Fail,49,23,5,10,39
70,Fail,45,30,2,11,34
70,Fail,54,24,6,6,48
70,Fail,45,33,4,8,37
70,Fail,49,28,0,12,37
70,Fail,52,19,4,16,36
70,Fail,54,27,0,11,43
70,Fail,48,22,4,15,33
70,Fail,41,27,2,15,26
70,Fail,45,31,0,13,32
70,Fail,42,30,9,13,29
70,Fail,53,19,8,10,43
70,Fail,44,28,0,16,28
70,Fail,49,30,0,11,38
70,Fail,47,33,0,11,36
70,Fail,57,22,0,10,47
70,Fail,45,31,0,14,31
70,Fail,40,38,0,12,28
70,Fail,45,30,0,11,34
70,Fail,52,23,2,13,39
70,Fail,51,23,0,14,37
70,Fail,54,18,3,13,41
70,Fail,55,32,0,5,50
70,Fail,51,26,0,11,40
70,Fail,58,22,0,8,50
70,Fail,46,32,0,17,29
70,Fail,50,27,0,10,40
70,Fail,54,18,1,17,37
70,Fail,51,27,0,13,38
70,Fail,50,27,1,11,39
70,Fail,46,25,9,7,39
70,Fail,51,20,4,12,39
70,Fail,42,33,0,16,26
70,Fail,47,33,0,13,34
70,Fail,54,23,0,9,45
70,Fail,44,29,3,16,28
70,Fail,54,21,4,12,42
70,Fail,46,31,0,8,38
70,Fail,51,26,0,11,40
70,Fail,52,23,0,13,39
70,Fail,49,23,0,15,34
70,Fail,41,32,9,11,30
70,Fail,54,17,4,11,43
70,Fail,50,30,0,7,43
70,Fail,57,18,3,10,47
70,Fail,41,25,13,12,29
70,Fail,52,23,0,16,36
70,Fail,50,23,2,13,37
70,Fail,51,30,0,12,39
70,Fail,49,28,0,10,39
70,Fail,45,27,0,15,30
70,Fail,48,21,4,19,29
70,Fail,53,25,0,10,43
70,Fail,51,31,0,10,41
70,Fail,54,18,0,12,42
70,Fail,39,35,7,12,27
70,Fail,50,24,5,12,38
70,Fail,49,28,0,11,38
70,Fail,49,19,6,17,32
70,Fail,43,38,0,13,30
70,Fail,57,20,2,12,45
70,Fail,51,20,5,15,36
70,Fail,58,21,0,9,49
70,Fail,49,32,0,9,40
70,Fail,49,28,0,12,37
70,Fail,51,24,0,15,36
70,Fail,53,24,0,12,41
70,Fail,46,26,0,19,27
70,Fail,43,34,0,12,31
70,Fail,49,28,0,12,37
70,Fail,42,40,0,7,35
70,Fail,50,21,3,13,37
70,Fail,44,31,2,13,31
70,Fail,53,23,0,12,41
70,Fail,46,26,7,9,37
70,Fail,47,32,3,9,38
70,Fail,39,28,5,17,22
70,Fail,49,24,4,10,39
70,Fail,50,30,0,7,43
70,Fail,54,29,0,6,48
70,Fail,48,26,7,11,37
70,Fail,54,22,0,13,41
70,Fail,49,30,0,10,39
70,Fail,48,26,0,13,35
70,Fail,50,26,7,11,39
70,Fail,42,30,5,13,29
70,Fail,55,18,1,13,42
70,Fail,47,36,0,8,39
70,Fail,50,27,0,12,38
70,Fail,51,25,3,12,39
70,Fail,47,27,0,15,32
70,Fail,52,25,3,11,41
70,Fail,55,19,5,10,45
70,Fail,51,26,3,12,39
70,Fail,52,26,0,10,42
70,Fail,46,34,0,13,33
70,Fail,39,37,0,13,26
70,Fail,46,23,4,17,29
70,Fail,49,24,0,11,38
70,Fail,43,24,13,15,28
70,Fail,45,32,0,12,33
70,Fail,41,35,0,14,27
70,Fail,50,28,0,8,42
70,Fail,57,15,2,11,46
70,Fail,44,32,0,12,32
70,Fail,50,23,1,14,36
70,Fail,46,24,5,16,30
70,Fail,42,34,0,14,28
70,Fail,39,37,0,14,25
70,Fail,46,30,0,12,34
70,Fail,45,23,11,15,30
70,Fail,48,22,10,12,36
70,Fail,42,33,4,13,29
70,Fail,52,24,0,9,43
70,Fail,42,36,0,14,28
70,Fail,54,20,5,8,46
70,Fail,50,24,0,17,33
70,Fail,45,26,12,8,37
70,Fail,49,34,0,10,39
70,Fail,44,32,0,14,30
70,Fail,49,32,1,10,39
70,Fail,55,24,0,7,48
70,Fail,55,20,0,12,43
70,Fail,48,27,1,11,37
70,Fail,50,31,0,10,40
70,Fail,49,18,0,14,35
70,Fail,45,20,7,18,27
70,Fail,52,17,4,13,39
70,Fail,49,24,6,12,37
70,Fail,54,29,0,8,46
70,Fail,41,34,0,16,25
70,Fail,47,28,4,10,37
70,Fail,43,30,3,14,29
70,Fail,54,22,0,12,42
70,Fail,43,26,3,14,29
70,Fail,47,31,0,12,35
70,Fail,43,27,0,20,23
70,Fail,46,28,1,15,31
70,Fail,55,23,1,10,45
70,Fail,45,25,11,11,34
70,Fail,44,30,0,16,28
70,Fail,47,28,1,13,34
70,Fail,48,26,8,8,40
70,Fail,49,27,0,13,36
70,Fail,53,21,5,8,45
70,Fail,50,30,0,10,40
70,Fail,47,29,0,14,33
70,Fail,46,28,0,15,31
70,Fail,57,24,1,7,50
70,Fail,52,22,7,12,40
70,Fail,55,25,1,8,47
70,Fail,52,23,0,16,36
70,Fail,49,30,0,10,39
70,Fail,43,34,0,13,30
70,Fail,52,26,0,13,39
70,Fail,52,21,1,11,41
70,Fail,47,23,0,20,27
70,Fail,45,26,1,16,29
70,Fail,45,21,2,20,25
70,Fail,53,17,0,14,39
70,Fail,43,38,0,6,37
70,Fail,48,25,5,13,35
70,Fail,50,23,4,13,37
70,Fail,45,27,0,17,28
70,Fail,43,32,2,13,30
70,Fail,39,39,0,15,24
70,Fail,49,31,0,11,38
70,Fail,45,30,0,12,33
70,Fail,51,22,2,14,37
70,Fail,45,28,4,12,33
70,Fail,51,27,0,11,40
70,Fail,47,28,0,12,35
70,Fail,41,35,5,8,33
70,Fail,48,28,0,11,37
70,Fail,43,40,0,7,36
70,Fail,52,24,4,9,43
70,Fail,52,25,1,12,40
70,Fail,43,34,0,13,30
70,Fail,55,23,0,9,46
70,Fail,54,21,5,8,46
70,Fail,43,31,1,15,28
70,Fail,52,25,0,8,44
70,Fail,54,29,0,6,48
70,Fail,47,28,0,13,34
70,Fail,55,23,0,9,46
70,Fail,50,30,0,9,41
70,Fail,57,25,1,8,49
70,Fail,55,20,2,9,46
70,Fail,53,19,1,14,39
70,Fail,55,25,0,10,45
70,Fail,43,37,0,9,34
70,Fail,53,25,0,13,40
70,Fail,49,27,5,11,38
70,Fail,49,24,3,13,36
70,Fail,47,30,0,11,36
70,Fail,45,20,5,17,28
70,Fail,54,26,0,7,47
70,Fail,45,31,2,11,34
70,Fail,46,29,0,16,30
70,Fail,47,25,9,11,36
70,Fail,51,24,4,13,38
70,Fail,54,32,0,8,46
70,Fail,44,32,0,11,33
70,Fail,47,25,0,18,29
70,Fail,41,30,5,15,26
70,Fail,45,34,0,11,34
70,Fail,47,23,2,15,32
70,Fail,44,32,3,12,32
70,Fail,46,32,0,11,35
70,Fail,50,30,0,12,38
70,Fail,47,25,0,17,30
70,Fail,45,32,1,13,32
70,Fail,48,28,5,8,40
70,Fail,46,27,12,9,37
70,Fail,45,35,0,12,33
70,Fail,49,17,6,18,31
70,Fail,53,21,3,14,39
70,Fail,57,20,2,12,45
70,Fail,42,31,0,17,25
70,Fail,42,30,10,10,32
70,Fail,57,20,0,9,48
70,Fail,48,32,0,10,38
70,Fail,40,40,0,13,27
70,Fail,50,24,3,13,37
70,Fail,46,25,8,11,35
70,Fail,42,24,5,17,25
70,Fail,43,34,0,12,31
70,Fail,50,19,1,18,32
70,Fail,53,18,2,19,34
70,Fail,49,28,0,12,37
70,Fail,48,25,0,17,31
70,Fail,44,31,0,12,32
70,Fail,52,22,0,17,35
70,Fail,46,21,0,14,32
70,Fail,52,24,0,9,43
70,Fail,53,31,0,7,46
70,Fail,43,41,0,5,38
70,Fail,49,29,0,14,35
70,Fail,53,24,3,9,44
70,Fail,56,23,5,8,48
70,Fail,51,35,0,8,43
70,Fail,52,19,0,15,37
70,Fail,42,30,3,16,26
70,Fail,44,38,0,11,33
70,Fail,52,23,0,12,40
70,Fail,53,22,1,11,42
70,Fail,59,21,0,8,51
70,Fail,44,31,0,12,32
70,Fail,52,31,0,9,43
70,Fail,49,24,8,11,38
70,Fail,47,25,7,9,38
70,Fail,55,21,2,11,44
70,Fail,48,29,0,12,36
70,Fail,47,33,0,9,38
70,Fail,51,27,0,9,42
70,Fail,53,19,1,16,37
70,Fail,45,28,6,11,34
70,Fail,48,36,0,9,39
70,Fail,48,30,0,12,36
70,Fail,55,25,1,8,47
70,Fail,48,30,0,11,37
70,Fail,55,27,2,9,46
70,Fail,42,24,7,16,26
70,Fail,49,25,0,14,35
70,Fail,48,29,0,9,39
70,Fail,56,22,0,8,48
70,Fail,51,14,8,15,36
70,Fail,35,31,7,17,18
70,Fail,44,24,0,18,26
70,Fail,42,31,0,18,24
70,Fail,46,24,1,16,30
70,Fail,42,24,8,18,24
70,Fail,54,24,0,10,44
70,Fail,36,29,5,17,19
70,Fail,51,24,0,9,42
70,Fail,47,25,2,14,33
70,Fail,52,28,0,9,43
70,Fail,46,28,4,11,35
70,Fail,45,27,6,13,32
70,Fail,49,28,0,11,38
70,Fail,53,21,5,11,42
70,Fail,46,25,5,11,35
70,Fail,46,30,2,9,37
70,Fail,46,24,0,19,27
70,Fail,50,30,2,8,42
70,Fail,48,23,0,14,34
70,Fail,48,33,0,3,45
70,Fail,43,33,0,14,29
70,Fail,50,27,1,14,36
70,Fail,43,35,0,13,30
70,Fail,51,29,0,12,39
70,Fail,51,26,0,11,40
70,Fail,48,19,1,19,29
70,Fail,50,19,2,18,32
70,Fail,44,28,6,14,30
70,Fail,41,33,0,18,23
70,Fail,50,17,4,18,32
70,Fail,42,28,10,13,29
70,Fail,47,23,0,16,31
70,Fail,45,28,5,11,34
70,Fail,52,23,0,14,38
70,Fail,41,30,0,18,23
70,Fail,55,30,0,9,46
70,Fail,42,34,0,13,29
70,Fail,50,24,4,14,36
70,Fail,46,40,0,8,38
70,Fail,49,25,6,12,37
70,Fail,52,23,2,13,39
70,Fail,54,27,0,10,44
70,Fail,52,26,1,12,40
70,Fail,49,32,0,12,37
70,Fail,53,20,0,13,40
70,Fail,56,24,1,7,49
70,Fail,52,20,3,15,37
70,Fail,45,35,0,13,32
70,Fail,44,34,0,16,28
70,Fail,56,32,0,8,48
70,Fail,54,17,2,17,37
70,Fail,43,32,5,13,30
70,Fail,47,24,3,17,30
70,Fail,54,22,1,14,40
70,Fail,35,22,13,22,13
70,Fail,40,35,0,16,24
70,Fail,51,24,0,14,37
70,Fail,42,27,9,16,26
70,Fail,43,26,8,16,27
70,Fail,50,28,0,11,39
70,Fail,45,33,6,9,36
70,Fail,49,22,3,11,38
70,Fail,41,38,0,12,29
70,Fail,46,33,0,10,36
70,Fail,43,35,0,15,28
70,Fail,50,27,2,6,44
70,Fail,51,25,0,7,44
70,Fail,53,28,0,10,43
70,Fail,48,25,5,13,35
70,Fail,56,21,1,10,46
70,Fail,49,24,0,14,35
70,Fail,41,27,8,18,23
70,Fail,49,33,0,8,41
70,Fail,40,37,0,13,27
70,Fail,42,28,0,18,24
70,Fail,43,31,0,15,28
70,Fail,43,29,5,14,29
70,Fail,50,27,7,11,39
70,Fail,49,24,1,10,39
70,Fail,55,25,0,5,50
70,Fail,51,28,3,11,40
70,Fail,38,47,0,10,28
70,Fail,49,30,5,9,40
70,Fail,49,29,0,12,37
70,Fail,50,19,5,17,33
70,Fail,43,24,5,16,27
70,Fail,39,30,11,11,28
70,Fail,46,28,0,16,30
70,Fail,48,23,1,19,29
70,Fail,53,29,3,10,43
70,Fail,53,23,0,11,42
70,Fail,47,27,4,15,32
70,Fail,52,28,0,12,40
70,Fail,40,36,2,14,26
70,Fail,51,24,2,11,40
70,Fail,55,22,0,12,43
70,Fail,56,27,0,9,47
70,Fail,48,24,1,14,34
70,Fail,42,34,0,10,32
70,Fail,50,28,0,13,37
70,Fail,45,20,9,15,30
70,Fail,46,30,0,12,34
70,Fail,52,22,3,12,40
70,Fail,53,17,0,14,39
70,Fail,46,23,6,16,30
70,Fail,47,35,0,9,38
70,Fail,50,24,5,10,40
70,Fail,41,39,0,13,28
70,Fail,50,24,1,17,33
70,Fail,50,25,4,12,38
70,Fail,55,19,3,12,43
70,Fail,48,39,0,4,44
70,Fail,50,30,1,9,41
70,Fail,46,30,6,10,36
70,Fail,52,17,0,14,38
70,Fail,50,21,4,17,33
70,Fail,53,20,5,12,41
70,Fail,49,26,0,14,35
70,Fail,49,32,0,9,40
70,Fail,45,30,0,16,29
70,Fail,42,36,0,11,31
70,Fail,50,23,1,13,37
70,Fail,50,27,2,13,37
70,Fail,52,28,0,7,45
70,Fail,51,27,0,12,39
70,Fail,43,24,11,16,27
70,Fail,48,31,0,14,34
70,Fail,48,30,3,9,39
70,Fail,47,34,0,13,34
70,Fail,52,22,0,14,38
70,Fail,42,30,6,14,28
70,Fail,49,29,0,10,39
70,Fail,51,30,0,8,43
70,Fail,46,30,8,10,36
70,Fail,47,22,10,14,33
70,Fail,43,25,3,19,24
70,Fail,49,29,0,9,40
70,Fail,45,32,0,15,30
70,Fail,52,31,0,8,44
70,Fail,50,23,0,19,31
70,Fail,46,30,0,14,32
70,Fail,53,26,0,13,40
70,Fail,42,34,0,12,30
70,Fail,43,33,5,10,33
70,Fail,56,27,0,3,53
70,Fail,47,31,0,11,36
70,Fail,53,19,0,13,40
70,Fail,48,23,0,15,33
70,Fail,48,30,6,7,41
70,Fail,55,22,0,13,42
70,Fail,44,30,0,14,30
70,Fail,45,22,0,15,30
70,Fail,55,26,0,10,45
70,Fail,50,26,0,12,38
70,Fail,50,23,0,15,35
70,Fail,47,30,0,12,35
70,Fail,51,23,1,15,36
70,Fail,54,22,5,6,48
70,Fail,49,25,0,16,33
70,Fail,45,34,0,11,34
70,Fail,46,28,0,14,32
70,Fail,48,24,2,16,32
70,Fail,55,20,7,9,46
70,Fail,54,22,2,10,44
70,Fail,51,18,4,15,36
70,Fail,51,24,0,16,35
70,Fail,45,26,6,14,31
70,Fail,54,20,1,16,38
70,Fail,39,33,0,18,21
70,Fail,46,36,0,8,38
70,Fail,50,29,0,10,40
70,Fail,48,22,3,14,34
70,Fail,46,26,0,14,32
70,Fail,50,25,0,16,34
70,Fail,47,23,5,12,35
70,Fail,54,27,0,7,47
70,Fail,52,24,3,8,44
70,Fail,55,22,0,12,43
70,Fail,48,22,0,18,30
70,Fail,51,20,0,14,37
70,Fail,47,26,4,10,37
70,Fail,51,23,4,12,39
70,Fail,45,20,10,14,31
70,Fail,43,24,8,14,29
70,Fail,44,34,1,8,36
70,Fail,48,29,0,11,37
70,Fail,43,35,0,10,33
70,Fail,51,23,3,14,37
70,Fail,48,20,3,17,31
70,Fail,49,25,7,10,39
70,Fail,49,26,0,13,36
70,Fail,40,36,0,19,21
70,Fail,53,21,7,10,43
70,Fail,46,31,0,17,29
70,Fail,41,28,1,20,21
70,Fail,51,22,6,10,41
70,Fail,50,31,0,6,44
70,Fail,47,25,0,13,34
70,Fail,41,37,0,13,28
70,Fail,50,31,0,7,43
70,Fail,48,31,0,9,39
70,Fail,54,24,6,7,47
70,Fail,43,38,0,12,31
70,Fail,46,25,1,18,28
70,Fail,48,38,0,5,43
70,Fail,50,23,0,15,35
70,Fail,45,24,7,16,29
70,Fail,45,38,0,10,35
70,Fail,52,32,0,10,42
70,Fail,51,19,8,11,40
70,Fail,49,28,0,13,36
70,Fail,50,25,0,16,34
70,Fail,53,21,3,12,41
70,Fail,56,26,0,9,47
70,Fail,54,22,2,10,44
70,Fail,40,22,7,21,19
70,Fail,35,34,5,17,18
70,Fail,51,20,0,22,29
70,Fail,45,27,9,13,32
70,Fail,45,27,7,12,33
70,Fail,54,22,0,12,42
70,Fail,50,30,0,10,40
70,Fail,45,23,2,16,29
70,Fail,48,26,4,11,37
70,Fail,52,26,3,7,45
70,Fail,54,19,2,15,39
70,Fail,49,28,0,10,39
70,Fail,49,25,0,13,36
70,Fail,47,32,0,13,34
70,Fail,45,27,4,18,27
70,Fail,44,29,0,17,27
70,Fail,49,33,0,8,41
70,Fail,41,25,5,18,23
70,Fail,51,24,0,14,37
70,Fail,51,29,0,7,44
70,Fail,50,19,2,12,38
70,Fail,54,29,0,8,46
70,Fail,51,21,3,12,39
70,Fail,50,23,5,14,36
70,Fail,47,35,0,7,40
70,Fail,50,19,9,14,36
70,Fail,49,22,11,11,38
70,Fail,43,32,7,11,32
70,Fail,45,26,0,16,29
70,Fail,47,26,2,9,38
70,Fail,39,28,0,21,18
70,Fail,53,29,0,6,47
70,Fail,51,28,0,11,40
70,Fail,45,29,1,11,34
70,Fail,47,36,0,11,36
70,Fail,46,22,7,17,29
70,Fail,56,16,0,16,40
70,Fail,49,27,0,12,37
70,Fail,51,19,3,10,41
70,Fail,44,30,3,13,31
70,Fail,53,27,0,12,41
70,Fail,44,27,0,18,26
70,Fail,54,21,0,12,42
70,Fail,45,24,11,12,33
70,Fail,50,22,1,16,34
70,Fail,57,25,0,9,48
70,Fail,54,28,0,7,47
70,Fail,55,18,2,16,39
70,Fail,45,31,0,12,33
70,Fail,46,24,2,15,31
70,Fail,47,30,0,13,34
70,Fail,47,27,0,13,34
70,Fail,46,29,0,10,36
70,Fail,51,26,0,11,40
70,Fail,51,21,5,11,40
70,Fail,47,35,0,10,37
70,Fail,47,33,0,13,34
70,Fail,56,24,0,9,47
70,Fail,43,28,3,13,30
70,Fail,50,27,2,9,41
70,Fail,47,35,0,8,39
70,Fail,52,22,0,11,41
70,Fail,46,29,0,14,32
70,Fail,49,26,5,10,39
70,Fail,49,21,3,16,33
70,Fail,49,25,0,10,39
70,Fail,53,18,0,21,32
70,Fail,50,20,2,14,36
70,Fail,41,25,10,15,26
70,Fail,44,33,0,15,29
70,Fail,47,30,8,9,38
70,Fail,45,27,2,15,30
70,Fail,43,27,12,12,31
70,Fail,49,25,0,15,34
70,Fail,53,25,1,7,46
70,Fail,48,27,0,13,35
70,Fail,51,24,0,10,41
70,Fail,44,25,3,16,28
70,Fail,41,28,4,13,28
70,Fail,44,30,0,16,28
70,Fail,54,21,0,13,41
70,Fail,51,25,0,11,40
70,Fail,53,22,2,10,43
70,Fail,45,19,11,15,30
70,Fail,44,25,14,8,36
70,Fail,49,23,0,16,33
70,Fail,57,20,2,5,52
70,Fail,44,27,1,17,27
70,Fail,46,23,9,17,29
70,Fail,53,16,5,19,34
70,Fail,39,31,3,15,24
70,Fail,42,31,4,16,26
70,Fail,49,26,3,12,37
70,Fail,55,32,0,6,49
70,Fail,46,26,3,12,34
70,Fail,51,25,5,11,40
70,Fail,45,24,0,21,24
70,Fail,44,29,0,17,27
70,Fail,47,39,0,8,39
70,Fail,47,34,1,8,39
70,Fail,48,24,10,9,39
70,Fail,48,30,0,11,37
70,Fail,41,31,8,11,30
70,Fail,52,27,1,9,43
70,Fail,51,21,1,16,35
70,Fail,46,37,0,9,37
70,Fail,51,26,4,10,41
70,Fail,37,31,0,19,18
70,Fail,44,30,4,13,31
70,Fail,51,33,0,9,42
70,Fail,46,26,7,9,37
70,Fail,49,16,7,15,34
70,Fail,50,21,6,11,39
70,Fail,50,28,0,11,39
70,Fail,53,24,3,11,42
70,Fail,49,29,1,11,38
70,Fail,49,27,1,10,39
70,Fail,46,36,0,11,35
70,Fail,57,19,1,11,46
70,Fail,41,28,0,23,18
70,Fail,38,30,11,13,25
70,Fail,49,27,0,13,36
70,Fail,49,29,0,10,39
70,Fail,43,27,6,13,30
70,Fail,50,27,0,13,37
70,Fail,44,30,10,8,36
70,Fail,48,26,0,20,28
70,Fail,57,15,0,11,46
70,Fail,49,24,3,13,36
70,Fail,42,32,0,16,26
70,Fail,51,24,2,13,38
70,Fail,44,27,0,19,25
70,Fail,46,31,4,6,40
70,Fail,47,28,0,13,34
70,Fail,53,24,3,9,44
70,Fail,46,21,0,22,24
70,Fail,61,17,1,12,49
70,Fail,52,28,4,7,45
70,Fail,52,21,0,16,36
70,Fail,43,23,4,19,24
70,Fail,52,23,1,13,39
70,Fail,45,31,0,14,31
70,Fail,45,24,0,19,26
70,Fail,58,20,0,12,46
70,Fail,47,35,0,8,39
70,Fail,44,35,0,12,32
70,Fail,52,27,0,12,40
70,Fail,50,25,0,10,40
70,Fail,39,27,8,14,25
70,Fail,47,22,2,17,30
70,Fail,59,20,0,8,51
70,Fail,49,33,0,8,41
70,Fail,46,29,0,11,35
70,Fail,45,24,0,20,25
70,Fail,47,24,0,15,32
70,Fail,38,35,2,13,25
70,Fail,44,36,4,10,34
70,Fail,44,31,0,12,32
70,Fail,42,28,4,17,25
70,Fail,53,23,1,7,46
70,Fail,42,27,10,13,29
70,Fail,43,32,0,17,26
70,Fail,51,28,2,11,40
70,Fail,40,33,3,7,33
70,Fail,46,33,0,13,33
70,Fail,51,29,0,11,40
70,Fail,47,24,4,16,31
70,Fail,47,25,4,13,34
70,Fail,45,30,0,16,29
70,Fail,45,23,17,10,35
70,Fail,46,34,0,11,35
70,Fail,50,30,0,9,41
70,Fail,41,41,0,8,33
70,Fail,52,22,4,9,43
70,Fail,50,25,2,12,38
70,Fail,46,24,0,18,28
70,Fail,47,33,0,11,36
70,Fail,55,26,0,7,48
70,Fail,44,33,2,13,31
70,Fail,46,26,3,13,33
70,Fail,39,31,6,15,24
70,Fail,57,20,0,12,45
70,Fail,51,24,0,13,38
70,Fail,40,28,11,14,26
70,Fail,40,35,3,12,28
70,Fail,56,21,2,10,46
70,Fail,48,26,0,12,36
70,Fail,41,33,0,16,25
70,Fail,49,34,1,6,43
70,Fail,45,28,0,14,31
70,Fail,45,33,1,11,34
70,Fail,42,27,6,12,30
70,Fail,52,34,0,6,46
70,Fail,48,25,1,8,40
70,Fail,50,32,0,6,44
70,Fail,45,32,0,13,32
70,Fail,40,32,9,10,30
70,Fail,45,27,3,11,34
70,Fail,51,21,1,14,37
70,Fail,50,25,4,11,39
70,Fail,49,18,0,17,32
70,Fail,49,32,0,9,40
70,Fail,47,30,0,9,38
70,Fail,43,37,0,11,32
70,Fail,50,28,0,14,36
70,Fail,48,30,1,13,35
70,Fail,50,22,3,16,34
70,Fail,52,32,0,8,44
70,Fail,48,28,0,11,37
70,Fail,46,30,0,9,37
70,Fail,41,28,13,9,32
70,Fail,40,33,1,18,22
70,Fail,42,38,0,8,34
70,Fail,44,25,0,17,27
70,Fail,41,29,0,20,21
70,Fail,50,26,0,16,34
70,Fail,44,30,3,13,31
70,Fail,48,27,0,16,32
70,Fail,48,27,0,13,35
70,Fail,53,22,0,13,40
70,Fail,52,26,2,12,40
70,Fail,51,30,4,8,43
70,Fail,52,24,0,13,39
70,Fail,52,24,5,11,41
70,Fail,54,26,0,10,44
70,Fail,48,21,0,18,30
70,Fail,48,29,0,15,33
70,Fail,48,26,2,15,33
70,Fail,52,20,3,9,43
70,Fail,51,20,0,18,33
70,Fail,50,27,2,12,38
70,Fail,49,27,0,9,40
70,Fail,44,21,0,22,22
70,Fail,48,27,3,11,37
70,Fail,46,18,4,22,24
70,Fail,41,26,15,11,30
70,Fail,49,29,0,9,40
70,Fail,47,32,0,12,35
70,Fail,48,34,0,10,38
70,Fail,48,18,7,22,26
70,Fail,42,32,6,9,33
70,Fail,46,31,0,15,31
70,Fail,52,23,5,9,43
70,Fail,44,31,0,16,28
70,Fail,55,18,0,14,41
70,Fail,47,25,0,16,31
70,Fail,51,25,0,11,40
70,Fail,41,35,0,16,25
70,Fail,49,27,0,13,36
70,Fail,53,24,3,9,44
70,Fail,46,28,3,12,34
70,Fail,56,18,7,8,48
70,Fail,45,33,0,13,32
70,Fail,51,26,2,10,41
70,Fail,43,24,9,15,28
70,Fail,46,20,0,23,23
70,Fail,44,39,0,12,32
70,Fail,45,36,0,10,35
70,Fail,44,20,2,19,25
70,Fail,44,27,2,16,28
70,Fail,51,27,2,11,40
70,Fail,50,30,0,9,41
70,Fail,48,31,0,10,38
70,Fail,52,23,6,7,45
70,Fail,47,29,0,12,35
70,Fail,50,30,5,7,43
70,Fail,41,31,13,10,31
70,Fail,46,24,6,14,32
70,Fail,46,33,0,10,36
70,Fail,51,27,0,11,40
70,Fail,44,25,0,20,24
70,Fail,42,19,4,24,18
70,Fail,50,23,0,15,35
70,Fail,46,26,1,12,34
70,Fail,42,30,0,16,26
70,Fail,46,28,6,11,35
70,Fail,57,21,0,12,45
70,Fail,50,15,0,22,28
70,Fail,41,26,7,13,28
70,Fail,58,18,2,10,48
70,Fail,48,25,8,10,38
70,Fail,46,25,0,18,28
70,Fail,45,37,0,8,37
70,Fail,51,27,0,10,41
70,Fail,45,31,0,15,30
70,Fail,46,27,0,15,31
70,Fail,48,31,3,10,38
70,Fail,39,35,0,17,22
70,Fail,52,25,0,14,38
70,Fail,43,31,0,14,29
70,Fail,52,22,0,13,39
70,Fail,51,32,0,10,41
70,Fail,53,22,0,13,40
70,Fail,42,30,0,18,24
70,Fail,42,29,6,12,30
70,Fail,50,27,2,10,40
70,Fail,45,21,13,12,33
70,Fail,45,35,0,8,37
70,Fail,46,22,4,19,27
70,Fail,41,31,5,14,27
70,Fail,50,21,8,14,36
70,Fail,46,30,6,9,37
70,Fail,49,26,0,15,34
70,Fail,44,31,0,11,33
70,Fail,49,30,0,9,40
70,Fail,52,25,0,12,40
70,Fail,49,20,6,12,37
70,Fail,60,20,0,8,52
70,Fail,40,35,0,17,23
70,Fail,56,20,2,10,46
70,Fail,41,37,0,11,30
70,Fail,52,31,0,10,42
70,Fail,46,22,6,16,30
70,Fail,51,18,3,20,31
70,Fail,51,21,6,11,40
70,Fail,44,32,0,14,30
70,Fail,57,19,5,10,47
70,Fail,41,38,0,10,31
70,Fail,45,35,0,14,31
70,Fail,47,25,2,15,32
70,Fail,57,20,1,11,46
70,Fail,45,24,8,15,30
70,Fail,45,32,1,11,34
70,Fail,47,29,0,15,32
70,Fail,48,19,9,16,32
70,Fail,47,32,0,15,32
70,Fail,46,27,6,13,33
70,Fail,49,20,6,13,36
70,Fail,50,23,0,12,38
70,Fail,50,30,0,10,40
70,Fail,50,22,5,11,39
70,Fail,43,35,0,13,30
70,Fail,50,27,0,11,39
70,Fail,50,32,3,2,48
70,Fail,56,21,0,8,48
70,Fail,49,24,4,13,36
70,Fail,44,37,0,13,31
70,Fail,37,32,9,15,22
70,Fail,46,24,2,17,29
70,Fail,34,31,3,21,13
70,Fail,47,31,2,8,39
70,Fail,47,32,0,8,39
70,Fail,55,21,0,12,43
70,Fail,42,24,4,16,26
70,Fail,53,22,5,9,44
70,Fail,62,25,0,1,61
70,Fail,45,26,4,12,33
70,Fail,54,16,10,8,46
70,Fail,50,28,0,13,37
70,Fail,50,25,1,13,37
70,Fail,43,36,0,10,33
70,Fail,46,27,4,14,32
70,Fail,53,23,0,13,40
70,Fail,42,19,9,23,19
70,Fail,57,25,0,6,51
70,Fail,56,22,0,10,46
70,Fail,44,35,0,10,34
70,Fail,52,27,3,8,44
70,Fail,55,19,1,11,44
70,Fail,54,24,1,12,42
70,Fail,51,30,0,9,42
70,Fail,49,23,1,13,36
70,Fail,44,24,10,12,32
70,Fail,39,35,4,11,28
70,Fail,42,33,0,16,26
70,Fail,55,21,0,9,46
70,Fail,46,26,0,15,31
70,Fail,53,26,0,7,46
70,Fail,48,30,0,14,34
70,Fail,47,28,0,14,33
70,Fail,46,23,4,17,29
70,Fail,51,24,3,11,40
70,Fail,49,26,1,14,35
70,Fail,43,34,0,13,30
70,Fail,48,27,0,14,34
70,Fail,49,27,0,12,37
70,Fail,55,21,2,8,47
70,Fail,51,23,0,12,39
70,Fail,51,16,3,16,35
70,Fail,51,23,0,13,38
70,Fail,47,25,0,15,32
70,Fail,43,37,0,15,28
70,Fail,44,39,0,9,35
70,Fail,40,36,7,9,31
70,Fail,45,31,0,12,33
70,Fail,49,30,0,11,38
70,Fail,42,24,0,23,19
70,Fail,43,29,0,16,27
70,Fail,46,41,0,8,38
70,Fail,50,28,0,11,39
70,Fail,48,32,0,8,40
70,Fail,45,30,6,13,32
70,Fail,44,36,0,10,34
70,Fail,52,22,1,14,38
70,Fail,47,23,4,15,32
70,Fail,55,26,0,8,47
70,Fail,53,19,0,15,38
70,Fail,47,27,7,9,38
70,Fail,43,36,1,10,33
70,Fail,48,31,0,10,38
70,Fail,52,24,0,11,41
70,Fail,41,32,0,11,30
70,Fail,47,27,0,14,33
70,Fail,40,40,0,8,32
70,Fail,47,19,8,14,33
70,Fail,40,33,2,13,27
70,Fail,47,25,11,9,38
70,Fail,51,29,1,12,39
70,Fail,50,18,9,14,36
70,Fail,43,29,4,15,28
70,Fail,55,17,0,11,44
70,Fail,47,27,1,9,38
70,Fail,47,29,0,11,36
70,Fail,50,24,3,12,38
70,Fail,56,21,0,10,46
70,Fail,50,26,0,16,34
70,Fail,46,26,1,15,31
70,Fail,56,19,1,10,46
70,Fail,47,27,0,12,35
70,Fail,46,31,0,17,29
70,Fail,57,20,0,10,47
70,Fail,48,27,1,13,35
70,Fail,47,22,5,15,32
70,Fail,50,22,3,12,38
70,Fail,54,21,3,12,42
70,Fail,42,27,9,13,29
70,Fail,50,21,4,11,39
70,Fail,51,19,0,18,33
70,Fail,47,30,0,13,34
70,Fail,55,22,0,10,45
70,Fail,45,35,0,12,33
70,Fail,56,22,0,9,47
70,Fail,56,22,0,9,47
70,Fail,53,24,3,9,44
70,Fail,48,25,0,14,34
70,Fail,48,25,7,12,36
70,Fail,53,30,0,10,43
70,Fail,51,21,3,13,38
70,Fail,47,26,0,14,33
70,Fail,46,25,11,11,35
70,Fail,42,35,0,14,28
70,Fail,46,28,1,15,31
70,Fail,53,25,0,9,44
70,Fail,45,27,4,10,35
70,Fail,47,23,4,15,32
70,Fail,56,16,6,14,42
70,Fail,57,19,4,12,45
70,Fail,49,34,0,8,41
70,Fail,55,25,0,11,44
70,Fail,41,27,1,19,22
70,Fail,63,15,0,9,54
70,Fail,44,23,1,21,23
70,Fail,50,32,0,6,44
70,Fail,44,41,0,7,37
70,Fail,54,26,0,9,45
70,Fail,48,20,1,19,29
70,Fail,51,20,4,12,39
70,Fail,51,22,0,17,34
70,Fail,51,23,3,11,40
70,Fail,53,21,0,18,35
70,Fail,51,23,0,7,44
70,Fail,52,28,0,5,47
70,Fail,44,23,6,14,30
70,Fail,47,26,4,10,37
70,Fail,53,17,0,17,36
70,Fail,51,20,2,14,37
70,Fail,49,22,1,13,36
70,Fail,52,29,0,9,43
70,Fail,49,24,2,13,36
70,Fail,44,21,1,20,24
70,Fail,45,29,0,12,33
70,Fail,49,24,3,14,35
70,Fail,50,18,3,18,32
70,Fail,36,31,10,18,18
70,Fail,46,23,5,15,31
70,Fail,47,30,0,14,33
70,Fail,55,17,2,13,42
70,Fail,52,24,0,11,41
70,Fail,49,19,10,14,35
70,Fail,47,19,7,16,31
70,Fail,52,24,1,10,42
70,Fail,53,25,4,9,44
70,Fail,44,38,0,12,32
70,Fail,47,26,0,15,32
70,Fail,42,32,7,13,29
70,Fail,45,40,0,13,32
70,Fail,47,23,5,15,32
70,Fail,50,30,0,12,38
70,Fail,54,18,0,14,40
70,Fail,60,23,4,6,54
70,Fail,46,37,0,12,34
70,Fail,47,34,0,5,42
70,Fail,37,37,0,16,21
70,Fail,46,25,1,18,28
70,Fail,42,29,0,14,28
70,Fail,49,27,1,10,39
70,Fail,42,32,0,16,26
70,Fail,48,33,0,9,39
70,Fail,48,26,0,15,33
70,Fail,45,26,0,17,28
70,Fail,59,17,0,12,47
70,Fail,57,19,0,8,49
70,Fail,46,30,5,9,37
70,Fail,50,32,0,9,41
70,Fail,45,21,3,17,28
70,Fail,52,22,1,15,37
70,Fail,42,36,0,13,29
70,Fail,49,24,0,13,36
70,Fail,44,33,0,12,32
70,Fail,43,27,2,14,29
70,Fail,50,23,0,16,34
70,Fail,51,25,0,15,36
70,Fail,44,29,5,12,32
70,Fail,52,26,2,11,41
70,Fail,42,30,2,18,24
70,Fail,39,32,6,15,24
70,Fail,45,25,8,10,35
70,Fail,47,30,3,13,34
70,Fail,49,35,0,9,40
70,Fail,52,28,0,10,42
70,Fail,49,25,1,16,33
70,Fail,46,31,0,12,34
70,Fail,43,27,1,19,24
70,Fail,48,29,0,11,37
70,Fail,46,28,2,13,33
70,Fail,45,34,0,10,35
70,Fail,46,23,5,13,33
70,Fail,43,26,6,11,32
70,Fail,49,31,0,10,39
70,Fail,48,22,12,12,36
70,Fail,47,33,0,12,35
70,Fail,53,22,0,15,38
70,Fail,50,31,0,9,41
70,Fail,39,23,16,18,21
70,Fail,46,31,0,16,30
70,Fail,48,22,6,14,34
70,Fail,42,27,4,16,26
70,Fail,46,25,5,12,34
70,Fail,41,31,6,12,29
70,Fail,44,28,2,13,31
70,Fail,45,32,3,10,35
70,Fail,58,19,0,13,45
70,Fail,53,29,0,5,48
70,Fail,51,30,0,10,41
70,Fail,54,23,0,9,45
70,Fail,45,29,0,14,31
70,Fail,50,25,4,9,41
70,Fail,42,27,5,15,27
70,Fail,55,24,1,10,45
70,Fail,45,29,0,14,31
70,Fail,50,28,0,12,38
70,Fail,51,21,3,12,39
70,Fail,46,34,0,12,34
70,Fail,45,27,7,10,35
70,Fail,50,28,3,7,43
70,Fail,48,25,11,9,39
70,Fail,51,22,6,13,38
70,Fail,49,27,0,15,34
70,Fail,51,27,0,16,35
70,Fail,45,31,0,15,30
70,Fail,46,28,0,14,32
70,Fail,44,36,0,10,34
70,Fail,50,20,5,20,30
70,Fail,49,20,1,19,30
70,Fail,49,25,5,10,39
70,Fail,43,32,0,14,29
70,Fail,53,31,0,6,47
70,Fail,51,20,5,13,38
70,Fail,46,24,0,14,32
70,Fail,46,34,0,10,36
70,Fail,48,30,0,14,34
70,Fail,45,25,10,12,33
70,Fail,49,27,5,12,37
70,Fail,39,36,0,15,24
70,Fail,48,31,1,10,38
70,Fail,43,23,8,15,28
70,Fail,43,28,5,13,30
70,Fail,36,28,13,17,19
70,Fail,49,33,5,4,45
70,Fail,42,42,0,12,30
70,Fail,39,29,15,10,29
70,Fail,59,18,0,14,45
70,Fail,46,27,0,15,31
70,Fail,47,22,8,13,34
70,Fail,48,30,0,11,37
70,Fail,50,24,0,15,35
70,Fail,51,27,0,13,38
70,Fail,55,19,0,12,43
70,Fail,50,27,0,12,38
70,Fail,51,21,7,9,42
70,Fail,46,32,0,9,37
70,Fail,47,35,0,11,36
70,Fail,47,33,0,12,35
70,Fail,52,18,2,18,34
70,Fail,52,27,0,11,41
70,Fail,44,33,0,16,28
70,Fail,46,35,0,13,33
70,Fail,51,22,0,11,40
70,Fail,43,30,5,11,32
70,Fail,50,30,0,12,38
70,Fail,45,23,1,19,26
70,Fail,49,27,0,12,37
70,Fail,55,20,0,14,41
70,Fail,42,27,2,18,24
70,Fail,50,25,0,14,36
70,Fail,45,31,0,13,32
70,Fail,49,33,0,7,42
70,Fail,49,22,4,12,37
70,Fail,41,33,0,18,23
70,Fail,39,32,10,15,24
70,Fail,45,25,5,10,35
70,Fail,42,29,6,12,30
70,Fail,52,22,0,12,40
70,Fail,52,28,0,12,40
70,Fail,47,21,4,18,29
70,Fail,54,18,6,13,41
70,Fail,55,25,2,10,45
70,Fail,44,21,6,19,25
70,Fail,45,22,5,19,26
70,Fail,51,25,0,13,38
70,Fail,44,27,0,17,27
70,Fail,52,23,1,15,37
70,Fail,48,21,0,20,28
70,Fail,43,28,3,17,26
70,Fail,57,20,4,6,51
70,Fail,52,23,0,15,37
70,Fail,44,33,0,10,34
70,Fail,51,32,0,8,43
70,Fail,44,25,6,15,29
70,Fail,51,27,0,11,40
70,Fail,45,28,3,17,28
70,Fail,41,37,0,14,27
70,Fail,46,22,2,21,25
70,Fail,52,26,7,6,46
70,Fail,48,21,2,15,33
70,Fail,56,20,3,8,48
70,Fail,48,27,3,10,38
70,Fail,50,18,8,13,37
70,Fail,54,28,0,5,49
70,Fail,46,30,0,12,34
70,Fail,56,19,0,15,41
70,Fail,46,27,0,13,33
70,Fail,49,22,2,16,33
70,Fail,49,27,5,8,41
70,Fail,49,34,0,12,37
70,Fail,48,24,9,14,34
70,Fail,49,32,0,11,38
70,Fail,40,31,8,10,30
70,Fail,41,28,3,15,26
70,Fail,48,35,0,10,38
70,Fail,46,28,9,13,33
70,Fail,51,30,0,10,41
70,Fail,59,21,0,10,49
70,Fail,42,29,8,13,29
70,Fail,51,31,0,7,44
70,Fail,51,25,2,11,40
70,Fail,52,27,0,14,38
70,Fail,51,28,0,11,40
70,Fail,51,31,2,10,41
70,Fail,44,36,0,12,32
70,Fail,51,28,0,9,42
70,Fail,44,28,0,14,30
70,Fail,48,24,2,14,34
70,Fail,52,27,0,12,40
70,Fail,48,29,0,12,36
70,Fail,51,19,1,17,34
70,Fail,51,26,2,10,41
70,Fail,43,24,7,17,26
70,Fail,51,30,0,10,41
70,Fail,45,26,1,15,30
70,Fail,44,34,0,14,30
70,Fail,44,27,0,17,27
70,Fail,51,22,0,16,35
70,Fail,47,20,10,15,32
70,Fail,47,31,0,10,37
70,Fail,44,34,0,13,31
70,Fail,44,19,1,21,23
70,Fail,52,23,0,13,39
70,Fail,43,33,1,12,31
70,Fail,45,30,0,15,30
70,Fail,51,23,5,11,40
70,Fail,54,21,1,14,40
70,Fail,42,32,0,18,24
70,Fail,39,37,5,10,29
70,Fail,48,20,6,15,33
70,Fail,52,28,0,7,45
70,Fail,52,21,6,10,42
70,Fail,52,32,0,5,47
70,Fail,41,20,10,22,19
70,Fail,46,32,4,8,38
70,Fail,49,27,0,12,37
70,Fail,43,30,0,12,31
70,Fail,42,31,0,19,23
70,Fail,49,28,0,12,37
70,Fail,58,18,2,13,45
70,Fail,48,31,7,10,38
70,Fail,41,30,4,13,28
70,Fail,52,20,6,8,44
70,Fail,45,28,0,12,33
70,Fail,41,33,0,13,28
70,Fail,47,35,0,10,37
70,Fail,52,24,0,12,40
70,Fail,52,19,0,17,35
70,Fail,47,26,0,15,32
70,Fail,54,24,0,12,42
70,Fail,54,22,1,11,43
70,Fail,50,26,5,9,41
70,Fail,50,26,3,10,40
70,Fail,51,23,5,10,41
70,Fail,42,28,7,15,27
70,Fail,41,25,0,22,19
70,Fail,53,23,0,13,40
70,Fail,36,38,0,15,21
70,Fail,49,28,3,10,39
70,Fail,46,24,0,20,26
70,Fail,42,30,2,11,31
70,Fail,40,32,0,15,25
70,Fail,50,26,7,7,43
70,Fail,49,26,0,16,33
70,Fail,49,26,7,9,40
70,Fail,47,24,0,13,34
70,Fail,47,22,4,14,33
70,Fail,53,23,0,11,42
70,Fail,42,37,0,12,30
70,Fail,53,22,5,10,43
70,Fail,44,23,7,16,28
70,Fail,48,25,9,8,40
70,Fail,48,25,0,16,32
70,Fail,48,24,0,16,32
70,Fail,50,27,0,12,38
70,Fail,48,26,8,11,37
70,Fail,47,28,0,15,32
70,Fail,52,31,0,6,46
70,Fail,49,18,9,11,38
70,Fail,49,22,2,17,32
70,Fail,44,31,3,10,34
70,Fail,50,28,0,8,42
70,Fail,51,28,2,9,42
70,Fail,48,26,4,8,40
70,Fail,54,29,0,9,45
70,Fail,51,30,0,7,44
70,Fail,44,33,0,15,29
70,Fail,50,22,0,15,35
70,Fail,46,30,1,12,34
70,Fail,48,33,0,15,33
70,Fail,49,33,0,9,40
70,Fail,45,25,6,14,31
70,Fail,45,33,0,13,32
70,Fail,51,28,0,11,40
70,Fail,55,19,3,14,41
70,Fail,53,28,3,6,47
70,Fail,39,36,0,12,27
70,Fail,41,40,0,16,25
70,Fail,55,18,2,15,40
70,Fail,56,13,3,12,44
70,Fail,51,22,4,14,37
70,Fail,43,28,0,16,27
70,Fail,40,29,5,16,24
70,Fail,46,27,6,9,37
70,Fail,44,29,5,13,31
70,Fail,46,33,0,14,32
70,Fail,47,25,2,15,32
70,Fail,43,29,4,12,31
70,Fail,49,26,9,11,38
70,Fail,49,27,0,11,38
70,Fail,61,20,1,6,55
70,Fail,37,30,12,13,24
70,Fail,53,21,0,12,41
70,Fail,48,28,6,10,38
70,Fail,57,18,1,7,50
70,Fail,46,28,0,16,30
70,Fail,36,43,0,14,22
70,Fail,46,25,3,15,31
70,Fail,53,27,0,6,47
70,Fail,47,28,0,10,37
70,Fail,54,29,0,8,46
70,Fail,47,34,0,11,36
70,Fail,39,33,2,15,24
70,Fail,51,24,1,13,38
70,Fail,51,26,1,11,40
70,Fail,39,31,0,21,18
70,Fail,43,36,0,11,32
70,Fail,44,37,0,8,36
70,Fail,44,26,5,14,30
70,Fail,45,29,3,13,32
70,Fail,48,31,0,8,40
70,Fail,46,30,5,12,34
70,Fail,48,26,2,11,37
70,Fail,46,25,6,13,33
70,Fail,49,26,4,11,38
70,Fail,45,31,0,14,31
70,Fail,40,31,6,12,28
70,Fail,42,33,2,14,28
70,Fail,48,30,2,13,35
70,Fail,48,33,0,12,36
70,Fail,48,23,0,13,35
70,Fail,53,30,0,7,46
70,Fail,49,26,0,14,35
70,Fail,46,25,0,21,25
70,Fail,53,15,1,19,34
70,Fail,46,26,2,12,34
70,Fail,52,21,4,10,42
70,Fail,53,25,2,9,44
70,Fail,48,31,0,12,36
70,Fail,50,30,0,10,40
70,Fail,54,24,2,12,42
70,Fail,44,30,7,10,34
70,Fail,51,27,4,11,40
70,Fail,50,30,10,5,45
70,Fail,55,23,0,10,45
70,Fail,46,30,0,14,32
70,Fail,46,28,2,12,34
70,Fail,41,35,0,14,27
70,Fail,49,28,0,16,33
70,Fail,46,30,0,13,33
70,Fail,45,28,1,15,30
70,Fail,42,31,4,16,26
70,Fail,53,25,3,7,46
70,Fail,50,29,1,9,41
70,Fail,53,26,0,13,40
70,Fail,40,35,0,14,26
70,Fail,49,25,3,10,39
70,Fail,47,32,0,12,35
70,Fail,49,29,1,14,35
70,Fail,50,21,0,18,32
70,Fail,38,28,6,19,19
70,Fail,54,21,0,14,40
70,Fail,52,24,5,9,43
70,Fail,53,13,1,19,34
70,Fail,60,14,0,8,52
70,Fail,48,33,0,10,38
70,Fail,44,27,0,19,25
70,Fail,48,29,0,12,36
70,Fail,44,32,6,9,35
70,Fail,42,23,6,17,25
70,Fail,41,34,7,12,29
70,Fail,54,28,0,9,45
70,Fail,54,27,0,4,50
70,Fail,57,21,1,9,48
70,Fail,52,27,0,10,42
70,Fail,47,33,2,8,39
70,Fail,51,25,1,9,42
70,Fail,49,23,7,8,41
70,Fail,57,26,0,7,50
70,Fail,48,28,5,9,39
70,Fail,46,29,8,9,37
70,Fail,48,28,4,12,36
70,Fail,51,26,0,11,40
70,Fail,45,30,4,14,31
70,Fail,54,22,1,11,43
70,Fail,59,18,0,10,49
70,Fail,45,30,0,14,31
70,Fail,49,25,8,9,40
70,Fail,49,29,0,14,35
70,Fail,45,21,7,17,28
70,Fail,46,28,6,11,35
70,Fail,40,27,2,17,23
70,Fail,48,24,7,12,36
70,Fail,41,27,8,16,25
70,Fail,56,24,0,11,45
70,Fail,36,24,11,20,16
70,Fail,53,23,0,15,38
70,Fail,44,24,7,13,31
70,Fail,44,36,0,14,30
70,Fail,45,26,4,15,30
70,Fail,47,27,0,12,35
70,Fail,51,18,9,11,40
70,Fail,51,21,11,10,41
70,Fail,56,23,0,10,46
70,Fail,51,26,1,9,42
70,Fail,46,31,0,11,35
70,Fail,49,25,0,16,33
70,Fail,42,28,3,14,28
70,Fail,47,35,0,9,38
70,Fail,48,28,2,12,36
70,Fail,49,23,8,8,41
70,Fail,50,27,6,7,43
70,Fail,52,21,1,15,37
70,Fail,53,24,0,9,44
70,Fail,49,24,2,14,35
70,Fail,48,19,5,17,31
70,Fail,45,28,0,13,32
70,Fail,46,27,6,9,37
70,Fail,40,24,8,20,20
70,Fail,52,27,0,12,40
70,Fail,47,32,0,12,35
70,Fail,47,33,0,12,35
70,Fail,45,24,3,17,28
70,Fail,44,28,6,9,35
70,Fail,57,24,0,7,50
70,Fail,54,28,0,11,43
70,Fail,46,32,3,9,37
70,Fail,54,28,0,7,47
70,Fail,51,24,5,12,39
70,Fail,45,30,6,14,31
70,Fail,49,22,3,10,39
70,Fail,44,30,3,12,32
70,Fail,53,29,0,12,41
70,Fail,50,26,0,12,38
70,Fail,50,23,2,12,38
70,Fail,49,32,0,8,41
70,Fail,50,30,0,9,41
70,Fail,52,18,4,15,37
70,Fail,46,24,3,19,27
70,Fail,52,23,1,15,37
70,Fail,45,25,7,13,32
70,Fail,47,29,0,12,35
70,Fail,46,35,0,12,34
70,Fail,43,26,11,15,28
70,Fail,52,24,0,8,44
70,Fail,50,31,0,5,45
70,Fail,46,30,0,17,29
70,Fail,52,25,0,12,40
70,Fail,44,28,0,17,27
70,Fail,47,29,3,12,35
70,Fail,48,31,0,14,34
70,Fail,47,30,7,7,40
70,Fail,42,29,0,21,21
70,Fail,48,23,7,10,38
70,Fail,41,34,4,12,29
70,Fail,41,37,0,15,26
70,Fail,49,25,0,15,34
70,Fail,48,25,0,17,31
70,Fail,48,23,6,13,35
70,Fail,40,28,0,20,20
70,Fail,56,20,0,9,47
70,Fail,52,29,0,10,42
70,Fail,49,25,1,12,37
70,Fail,45,30,0,13,32
70,Fail,48,32,0,13,35
70,Fail,53,24,0,10,43
70,Fail,44,30,6,15,29
70,Fail,47,25,3,14,33
70,Fail,41,28,2,16,25
70,Fail,46,23,4,14,32
70,Fail,41,35,0,15,26
70,Fail,45,33,0,13,32
70,Fail,51,29,3,6,45
70,Fail,47,25,5,12,35
70,Fail,45,34,0,10,35
70,Fail,46,24,11,11,35
70,Fail,51,25,2,12,39
70,Fail,44,27,0,14,30
70,Fail,44,30,2,15,29
70,Fail,54,20,0,13,41
70,Fail,45,30,5,12,33
70,Fail,50,24,14,7,43
70,Fail,43,34,0,11,32
70,Fail,47,23,0,17,30
70,Fail,46,25,4,17,29
70,Fail,45,33,0,14,31
70,Fail,45,24,4,16,29
70,Fail,52,21,9,11,41
70,Fail,41,37,0,15,26
70,Fail,51,24,0,13,38
70,Fail,42,37,0,16,26
70,Fail,42,30,3,15,27
70,Fail,42,35,3,9,33
70,Fail,53,21,0,12,41
70,Fail,47,27,0,12,35
70,Fail,53,23,0,12,41
70,Fail,52,24,0,16,36
70,Fail,45,36,0,14,31
70,Fail,50,19,0,18,32
70,Fail,53,26,0,12,41
70,Fail,54,25,0,12,42
70,Fail,47,21,4,13,34
70,Fail,56,17,5,6,50
70,Fail,46,29,0,12,34
70,Fail,48,31,0,10,38
70,Fail,44,28,4,14,30
70,Fail,50,23,3,16,34
70,Fail,45,25,0,14,31
70,Fail,50,26,0,13,37
70,Fail,52,22,0,14,38
70,Fail,43,25,8,15,28
70,Fail,40,37,0,13,27
70,Fail,44,27,0,18,26
70,Fail,50,24,5,13,37
70,Fail,46,30,0,13,33
70,Fail,46,25,4,15,31
70,Fail,39,40,0,12,27
70,Fail,44,24,1,20,24
70,Fail,46,23,0,20,26
70,Fail,49,23,3,12,37
70,Fail,57,23,0,10,47
70,Fail,48,25,0,15,33
70,Fail,40,32,12,5,35
70,Fail,41,32,0,13,28
70,Fail,42,28,0,16,26
70,Fail,41,37,0,10,31
70,Fail,51,20,0,14,37
70,Fail,40,26,13,13,27
70,Fail,42,32,0,14,28
70,Fail,44,30,1,12,32
70,Fail,44,26,8,14,30
70,Fail,40,32,2,15,25
70,Fail,54,23,0,12,42
70,Fail,51,23,4,13,38
70,Fail,41,30,0,18,23
70,Fail,40,33,0,12,28
70,Fail,50,26,0,9,41
70,Fail,46,32,0,11,35
70,Fail,49,23,3,16,33
70,Fail,43,30,0,14,29
70,Fail,51,29,0,7,44
70,Fail,45,26,6,10,35
70,Fail,47,30,0,12,35
70,Fail,48,27,0,10,38
70,Fail,46,27,0,17,29
70,Fail,57,24,1,9,48
70,Fail,45,30,0,12,33
70,Fail,48,23,2,17,31
70,Fail,51,28,0,11,40
70,Fail,53,35,0,7,46
70,Fail,43,35,0,9,34
70,Fail,51,24,0,11,40
70,Fail,52,25,0,12,40
70,Fail,47,26,1,12,35
70,Fail,51,23,3,14,37
70,Fail,46,30,6,11,35
70,Fail,48,31,0,9,39
70,Fail,58,21,0,7,51
70,Fail,40,40,0,9,31
70,Fail,41,28,6,15,26
70,Fail,51,25,2,11,40
70,Fail,46,36,0,11,35
70,Fail,48,19,0,21,27
70,Fail,46,27,9,11,35
70,Fail,51,23,1,12,39
70,Fail,50,28,0,12,38
70,Fail,49,24,6,11,38
70,Fail,46,27,3,13,33
70,Fail,41,38,0,10,31
70,Fail,42,38,0,10,32
70,Fail,34,38,5,12,22
70,Fail,42,38,0,11,31
70,Fail,52,26,6,9,43
70,Fail,49,25,0,12,37
70,Fail,42,24,0,21,21
70,Fail,52,23,0,13,39
70,Fail,49,27,5,14,35
70,Fail,43,30,2,12,31
70,Fail,43,33,0,14,29
70,Fail,61,20,0,9,52
70,Fail,48,27,0,13,35
70,Fail,36,38,0,16,20
70,Fail,49,25,4,12,37
70,Fail,49,19,0,16,33
70,Fail,47,26,1,12,35
70,Fail,44,28,1,13,31
70,Fail,54,20,0,11,43
70,Fail,41,30,7,12,29
70,Fail,46,31,0,11,35
70,Fail,55,22,0,10,45
70,Fail,44,27,0,16,28
70,Fail,50,18,0,14,36
70,Fail,49,27,0,14,35
70,Fail,51,29,0,15,36
70,Fail,48,25,0,12,36
70,Fail,49,28,0,12,37
70,Fail,48,28,0,12,36
70,Fail,50,20,0,16,34
70,Fail,56,18,1,11,45
70,Fail,51,29,0,11,40
70,Fail,45,25,0,19,26
70,Fail,47,37,0,10,37
70,Fail,45,23,5,17,28
70,Fail,53,23,0,12,41
70,Fail,44,31,5,11,33
70,Fail,54,23,3,10,44
70,Fail,44,34,0,11,33
70,Fail,47,31,0,10,37
70,Fail,42,25,10,11,31
70,Fail,52,24,1,9,43
70,Fail,46,27,0,16,30
70,Fail,53,23,2,13,40
70,Fail,46,26,6,14,32
70,Fail,48,22,0,17,31
70,Fail,48,26,0,14,34
70,Fail,54,22,6,10,44
70,Fail,52,25,2,9,43
70,Fail,46,24,8,11,35
70,Fail,55,20,5,10,45
70,Fail,45,30,0,12,33
70,Fail,50,21,2,15,35
70,Fail,44,26,0,17,27
70,Fail,51,24,7,10,41
70,Fail,43,31,0,18,25
70,Fail,53,19,0,14,39
70,Fail,46,29,0,16,30
70,Fail,55,19,0,13,42
70,Fail,43,32,0,16,27
70,Fail,54,23,6,8,46
70,Fail,47,25,4,15,32
70,Fail,45,29,0,15,30
70,Fail,57,15,3,19,38
70,Fail,45,31,0,15,30
70,Fail,45,26,0,17,28
70,Fail,41,28,0,16,25
70,Fail,52,25,3,8,44
70,Fail,49,21,7,12,37
70,Fail,45,29,0,10,35
70,Fail,53,23,0,11,42
70,Fail,44,23,3,17,27
70,Fail,45,22,5,17,28
70,Fail,47,28,0,11,36
70,Fail,54,28,0,6,48
70,Fail,49,22,2,13,36
70,Fail,46,34,1,11,35
70,Fail,46,27,4,12,34
70,Fail,45,24,4,15,30
70,Fail,56,15,0,17,39
70,Fail,50,24,0,15,35
70,Fail,43,28,0,14,29
70,Fail,45,29,0,17,28
70,Fail,48,26,0,13,35
70,Fail,54,16,4,16,38
70,Fail,47,27,3,13,34
70,Fail,49,24,0,17,32
70,Fail,48,27,1,15,33
70,Fail,49,29,0,13,36
70,Fail,50,26,3,11,39
70,Fail,46,31,2,10,36
70,Fail,54,25,0,11,43
70,Fail,50,23,2,14,36
70,Fail,46,27,0,17,29
70,Fail,39,41,0,11,28
70,Fail,53,24,0,11,42
70,Fail,50,28,0,16,34
70,Fail,51,24,0,14,37
70,Fail,47,25,0,15,32
70,Fail,49,26,3,14,35
70,Fail,45,27,6,14,31
70,Fail,46,33,0,13,33
70,Fail,44,40,0,9,35
70,Fail,53,21,0,15,38
70,Fail,50,22,3,13,37
70,Fail,52,25,0,14,38
70,Fail,50,26,0,17,33
70,Fail,53,21,4,12,41
70,Fail,50,24,11,7,43
70,Fail,45,29,0,12,33
70,Fail,46,24,0,15,31
70,Fail,53,24,0,9,44
70,Fail,45,22,4,17,28
70,Fail,37,35,3,18,19
70,Fail,49,28,0,11,38
70,Fail,59,21,4,8,51
70,Fail,49,30,0,13,36
70,Fail,38,29,16,13,25
70,Fail,49,27,0,12,37
70,Fail,44,33,4,9,35
70,Fail,48,21,3,21,27
70,Fail,48,22,9,11,37
70,Fail,51,26,0,8,43
70,Fail,44,27,8,11,33
70,Fail,39,38,0,14,25
70,Fail,44,32,0,13,31
70,Fail,53,22,0,15,38
70,Fail,52,20,3,14,38
70,Fail,50,25,0,11,39
70,Fail,47,33,0,12,35
70,Fail,46,27,0,13,33
70,Fail,43,33,0,9,34
70,Fail,43,36,0,7,36
70,Fail,40,34,0,16,24
70,Fail,43,29,0,17,26
70,Fail,49,22,4,11,38
70,Fail,53,26,0,8,45
70,Fail,42,36,0,11,31
70,Fail,52,21,3,15,37
70,Fail,43,36,0,16,27
70,Fail,49,24,3,10,39
70,Fail,40,38,0,12,28
70,Fail,52,22,0,12,40
70,Fail,47,25,0,15,32
70,Fail,43,33,3,12,31
70,Fail,58,24,0,7,51
70,Fail,47,28,1,14,33
70,Fail,49,32,0,11,38
70,Fail,48,27,11,7,41
70,Fail,48,28,0,17,31
70,Fail,44,32,4,12,32
70,Fail,51,30,4,5,46
70,Fail,39,32,0,15,24
70,Fail,54,22,1,14,40
70,Fail,42,33,0,16,26
70,Fail,52,26,0,14,38
70,Fail,57,22,1,9,48
70,Fail,43,28,14,6,37
70,Fail,46,25,6,13,33
70,Fail,38,36,8,10,28
70,Fail,40,33,3,11,29
70,Fail,53,21,0,11,42
70,Fail,51,24,3,14,37
70,Fail,41,34,0,16,25
70,Fail,42,29,8,11,31
70,Fail,53,19,0,14,39
70,Fail,52,21,0,15,37
70,Fail,46,30,0,12,34
70,Fail,51,30,0,11,40
70,Fail,45,25,0,17,28
70,Fail,53,21,5,12,41
70,Fail,42,28,5,17,25
70,Fail,57,23,2,6,51
70,Fail,34,49,0,14,20
70,Fail,50,22,2,14,36
70,Fail,46,32,0,12,34
70,Fail,52,30,0,11,41
70,Fail,52,28,0,9,43
70,Fail,43,30,0,16,27
70,Fail,45,28,0,13,32
70,Fail,44,33,1,14,30
70,Fail,43,31,10,9,34
70,Fail,51,18,3,13,38
70,Fail,56,24,1,7,49
70,Fail,49,24,0,18,31
70,Fail,49,30,0,9,40
70,Fail,46,22,8,15,31
70,Fail,48,24,13,8,40
70,Fail,43,27,1,16,27
70,Fail,48,29,0,9,39
70,Fail,49,27,0,13,36
70,Fail,45,30,0,17,28
70,Fail,42,31,0,17,25
70,Fail,53,23,0,15,38
70,Fail,44,32,0,11,33
70,Fail,45,28,1,15,30
70,Fail,50,19,0,19,31
70,Fail,48,25,3,14,34
70,Fail,53,31,0,7,46
70,Fail,48,26,0,13,35
70,Fail,45,24,0,19,26
70,Fail,56,23,1,8,48
70,Fail,50,33,0,11,39
70,Fail,48,22,10,14,34
70,Fail,51,16,1,19,32
70,Fail,47,24,6,15,32
70,Fail,50,22,0,12,38
70,Fail,54,22,0,13,41
70,Fail,46,32,0,13,33
70,Fail,44,25,4,19,25
70,Fail,50,30,0,9,41
70,Fail,46,28,3,15,31
70,Fail,50,20,1,15,35
70,Fail,39,33,7,11,28
70,Fail,50,28,0,12,38
70,Fail,56,20,4,10,46
70,Fail,48,21,5,14,34
70,Fail,52,27,4,10,42
70,Fail,44,26,5,16,28
70,Fail,54,18,3,13,41
70,Fail,51,23,0,13,38
70,Fail,47,32,0,10,37
70,Fail,45,25,2,17,28
70,Fail,38,41,0,13,25
70,Fail,47,26,0,16,31
70,Fail,51,26,5,8,43
70,Fail,52,22,0,14,38
70,Fail,47,26,1,15,32
70,Fail,48,28,0,10,38
70,Fail,54,23,0,7,47
70,Fail,50,28,0,9,41
70,Fail,48,25,0,16,32
70,Fail,54,21,2,11,43
70,Fail,47,38,0,8,39
70,Fail,44,27,0,14,30
70,Fail,50,23,0,16,34
70,Fail,45,27,7,11,34
70,Fail,45,27,1,14,31
70,Fail,53,23,0,12,41
70,Fail,52,22,0,13,39
70,Fail,49,19,2,18,31
70,Fail,50,28,0,11,39
70,Fail,54,27,0,9,45
70,Fail,53,23,2,11,42
70,Fail,45,26,0,17,28
70,Fail,49,21,4,15,34
70,Fail,46,33,0,14,32
70,Fail,53,24,0,16,37
70,Fail,47,22,2,17,30
70,Fail,49,27,0,12,37
70,Fail,46,26,5,12,34
70,Fail,49,19,0,19,30
70,Fail,49,28,5,9,40
70,Fail,48,26,4,13,35
70,Fail,49,26,0,18,31
70,Fail,50,29,0,14,36
70,Fail,40,29,0,19,21
70,Fail,43,34,0,17,26
70,Fail,42,27,0,18,24
70,Fail,36,34,0,21,15
70,Fail,48,24,0,13,35
70,Fail,47,23,9,10,37
70,Fail,45,35,0,9,36
70,Fail,50,25,0,10,40
70,Fail,49,31,2,9,40
70,Fail,42,28,5,16,26
70,Fail,51,22,0,16,35
70,Fail,40,29,16,10,30
70,Fail,48,31,0,14,34
70,Fail,49,26,0,17,32
70,Fail,45,31,0,15,30
70,Fail,40,22,12,21,19
70,Fail,48,20,4,13,35
70,Fail,47,27,2,15,32
70,Fail,51,22,0,14,37
70,Fail,50,31,0,9,41
70,Fail,47,33,1,7,40
70,Fail,47,29,2,10,37
70,Fail,36,45,0,15,21
70,Fail,49,25,0,12,37
70,Fail,52,25,0,12,40
70,Fail,48,22,0,17,31
70,Fail,47,32,0,14,33
70,Fail,51,19,1,14,37
70,Fail,53,21,2,14,39
70,Fail,48,25,7,11,37
70,Fail,46,25,8,14,32
70,Fail,46,25,1,15,31
70,Fail,43,27,0,19,24
70,Fail,45,27,0,17,28
70,Fail,61,19,0,7,54
70,Fail,52,25,5,11,41
70,Fail,48,24,0,14,34
70,Fail,46,31,0,8,38
70,Fail,50,27,0,11,39
70,Fail,48,33,0,10,38
70,Fail,58,18,0,13,45
70,Fail,54,20,1,11,43
70,Fail,50,29,0,8,42
70,Fail,46,23,11,14,32
70,Fail,43,30,0,15,28
70,Fail,48,27,0,15,33
70,Fail,55,15,5,12,43
70,Fail,50,22,2,12,38
70,Fail,59,22,3,8,51
70,Fail,44,34,0,11,33
70,Fail,47,21,4,19,28
70,Fail,55,17,0,14,41
70,Fail,53,23,1,9,44
70,Fail,49,34,0,8,41
70,Fail,43,37,0,8,35
70,Fail,49,31,1,11,38
70,Fail,39,28,11,16,23
70,Fail,47,29,0,13,34
70,Fail,55,19,1,12,43
70,Fail,44,31,0,9,35
70,Fail,45,34,0,10,35
70,Fail,48,29,2,7,41
70,Fail,56,20,0,13,43
70,Fail,53,25,0,11,42
70,Fail,49,28,0,14,35
70,Fail,43,27,7,15,28
70,Fail,47,27,0,17,30
70,Fail,49,25,2,11,38
70,Fail,46,29,0,17,29
70,Fail,41,39,0,12,29
70,Fail,52,25,6,10,42
70,Fail,45,24,0,16,29
70,Fail,48,29,1,11,37
70,Fail,53,26,0,6,47
70,Fail,44,21,5,18,26
70,Fail,46,29,8,5,41
70,Fail,43,33,3,13,30
70,Fail,42,27,4,18,24
70,Fail,43,25,0,19,24
70,Fail,49,23,2,14,35
70,Fail,51,23,0,12,39
70,Fail,49,27,0,12,37
70,Fail,58,17,3,10,48
70,Fail,56,20,0,14,42
70,Fail,49,35,0,9,40
70,Fail,43,27,2,13,30
70,Fail,48,31,2,10,38
70,Fail,45,28,0,16,29
70,Fail,49,32,0,9,40
70,Fail,53,24,3,10,43
70,Fail,53,26,2,7,46
70,Fail,53,18,7,12,41
70,Fail,51,28,2,5,46
70,Fail,54,22,0,12,42
70,Fail,49,19,0,19,30
70,Fail,42,29,0,12,30
70,Fail,46,28,3,13,33
70,Fail,48,27,0,14,34
70,Fail,54,18,1,14,40
70,Fail,51,25,8,8,43
70,Fail,54,22,1,9,45
70,Fail,46,29,5,10,36
70,Fail,48,30,4,9,39
70,Fail,57,24,0,9,48
70,Fail,45,24,0,18,27
70,Fail,47,22,8,16,31
70,Fail,48,32,0,10,38
70,Fail,44,39,0,10,34
70,Fail,46,32,0,16,30
70,Fail,46,22,11,11,35
70,Fail,41,34,0,13,28
70,Fail,44,27,0,13,31
70,Fail,47,19,8,16,31
70,Fail,47,34,0,12,35
70,Fail,51,22,0,19,32
70,Fail,41,31,1,15,26
70,Fail,46,29,0,15,31
70,Fail,48,32,0,13,35
70,Fail,48,25,0,17,31
70,Fail,53,21,3,14,39
70,Fail,46,21,2,17,29
70,Fail,45,25,2,17,28
70,Fail,42,30,9,13,29
70,Fail,52,26,0,9,43
70,Fail,45,28,0,16,29
70,Fail,40,21,8,21,19
70,Fail,41,21,14,13,28
70,Fail,48,30,1,11,37
70,Fail,47,26,5,9,38
70,Fail,35,44,0,13,22
70,Fail,48,32,0,7,41
70,Fail,38,38,0,15,23
70,Fail,51,27,2,8,43
70,Fail,50,23,5,9,41
70,Fail,42,23,4,19,23
70,Fail,46,29,0,14,32
70,Fail,49,27,0,15,34
70,Fail,42,30,4,14,28
70,Fail,48,27,4,8,40
70,Fail,51,24,0,15,36
70,Fail,42,35,0,14,28
70,Fail,46,32,0,14,32
70,Fail,44,27,0,17,27
70,Fail,48,29,0,16,32
70,Fail,55,23,0,10,45
70,Fail,49,30,0,12,37
70,Fail,53,23,3,9,44
70,Fail,50,15,9,16,34
70,Fail,53,27,0,10,43
70,Fail,41,30,6,15,26
70,Fail,57,27,0,4,53
70,Fail,52,25,4,7,45
70,Fail,49,22,2,14,35
70,Fail,51,27,0,10,41
70,Fail,48,31,2,10,38
70,Fail,44,37,0,12,32
70,Fail,47,23,2,15,32
70,Fail,50,26,1,12,38
70,Fail,46,26,6,12,34
70,Fail,43,28,7,17,26
70,Fail,47,21,5,13,34
70,Fail,50,24,5,14,36
70,Fail,54,19,0,15,39
70,Fail,49,23,0,18,31
70,Fail,45,31,0,9,36
70,Fail,48,20,5,16,32
70,Fail,48,23,4,15,33
70,Fail,50,25,0,11,39
70,Fail,49,25,2,11,38
70,Fail,58,22,0,6,52
70,Fail,43,33,0,13,30
70,Fail,44,31,0,16,28
70,Fail,46,28,0,13,33
70,Fail,42,26,0,18,24
70,Fail,48,24,6,16,32
70,Fail,46,30,5,11,35
70,Fail,51,24,0,14,37
70,Fail,46,28,0,16,30
70,Fail,47,32,0,12,35
70,Fail,57,23,0,11,46
70,Fail,43,33,0,14,29
70,Fail,47,25,4,14,33
70,Fail,48,27,0,13,35
70,Fail,48,18,6,14,34
70,Fail,51,16,9,9,42
70,Fail,47,32,0,11,36
70,Fail,47,28,9,10,37
70,Fail,54,18,3,12,42
70,Fail,39,36,0,16,23
70,Fail,51,28,0,12,39
70,Fail,54,23,0,11,43
70,Fail,48,27,0,13,35
70,Fail,57,22,1,9,48
70,Fail,61,12,1,12,49
70,Fail,49,27,0,12,37
70,Fail,43,34,0,13,30
70,Fail,52,17,7,12,40
70,Fail,46,24,15,9,37
70,Fail,48,32,0,14,34
70,Fail,49,29,0,11,38
70,Fail,42,35,0,13,29
70,Fail,47,24,2,12,35
70,Fail,49,26,1,12,37
70,Fail,45,30,0,11,34
70,Fail,47,26,2,9,38
70,Fail,49,25,1,15,34
70,Fail,47,31,0,15,32
70,Fail,49,26,0,13,36
70,Fail,53,29,5,8,45
70,Fail,47,25,3,15,32
70,Fail,47,22,0,20,27
70,Fail,46,21,7,15,31
70,Fail,47,34,0,11,36
70,Fail,47,27,2,13,34
70,Fail,41,28,1,17,24
70,Fail,38,32,7,14,24
70,Fail,52,26,3,9,43
70,Fail,47,26,6,12,35
70,Fail,56,13,5,13,43
70,Fail,48,32,0,13,35
70,Fail,55,22,0,12,43
70,Fail,46,27,7,10,36
70,Fail,45,30,1,11,34
70,Fail,53,22,5,9,44
70,Fail,53,26,2,8,45
70,Fail,49,25,3,14,35
70,Fail,51,24,1,12,39
70,Fail,52,27,0,9,43
70,Fail,51,21,0,16,35
70,Fail,55,25,0,10,45
70,Fail,37,34,0,20,17
70,Fail,48,30,0,15,33
70,Fail,52,20,0,17,35
70,Fail,42,31,0,13,29
70,Fail,42,34,8,13,29
70,Fail,45,33,0,17,28
70,Fail,54,27,0,10,44
70,Fail,51,20,0,14,37
70,Fail,53,24,0,14,39
70,Fail,57,17,5,11,46
70,Fail,50,25,1,9,41
70,Fail,57,22,0,7,50
70,Fail,50,25,5,11,39
70,Fail,48,22,7,11,37
70,Fail,42,31,0,14,28
70,Fail,53,21,0,11,42
70,Fail,45,29,2,11,34
70,Fail,48,31,0,10,38
70,Fail,45,27,2,14,31
70,Fail,52,27,6,6,46
70,Fail,52,18,5,14,38
70,Fail,48,28,0,14,34
70,Fail,50,27,1,12,38
70,Fail,51,27,0,13,38
70,Fail,46,35,0,10,36
70,Fail,43,39,0,9,34
70,Fail,52,26,4,8,44
70,Fail,53,22,2,9,44
70,Fail,51,28,0,11,40
70,Fail,53,31,0,8,45
70,Fail,42,29,0,17,25
70,Fail,41,29,13,8,33
70,Fail,41,38,0,13,28
70,Fail,52,21,2,12,40
70,Fail,41,34,2,15,26
70,Fail,36,41,0,17,19
70,Fail,52,25,3,10,42
70,Fail,41,41,0,11,30
70,Fail,47,30,0,11,36
70,Fail,43,26,9,14,29
70,Fail,57,21,0,9,48
70,Fail,49,28,0,11,38
70,Fail,48,25,4,15,33
70,Fail,47,23,4,16,31
70,Fail,50,29,0,12,38
70,Fail,39,21,12,17,22
70,Fail,45,26,1,15,30
70,Fail,52,25,0,13,39
70,Fail,45,31,0,16,29
70,Fail,53,23,0,10,43
70,Fail,54,25,3,5,49
70,Fail,46,29,4,8,38
70,Fail,52,22,1,11,41
70,Fail,45,30,1,14,31
70,Fail,47,25,2,15,32
70,Fail,49,21,6,16,33
70,Fail,54,19,1,9,45
70,Fail,44,26,5,15,29
70,Fail,46,20,7,18,28
70,Fail,42,35,0,12,30
70,Fail,49,31,0,11,38
70,Fail,50,20,5,15,35
70,Fail,58,21,0,12,46
70,Fail,57,24,0,7,50
70,Fail,41,33,0,13,28
70,Fail,50,25,0,14,36
70,Fail,48,26,7,11,37
70,Fail,40,32,0,17,23
70,Fail,43,27,0,15,28
70,Fail,53,22,4,8,45
70,Fail,50,22,0,11,39
70,Fail,40,35,0,14,26
70,Fail,48,22,3,11,37
70,Fail,52,33,0,10,42
70,Fail,46,30,0,12,34
70,Fail,46,28,0,16,30
70,Fail,44,21,7,20,24
70,Fail,44,32,0,14,30
70,Fail,47,21,0,19,28
70,Fail,49,23,3,10,39
70,Fail,47,30,3,11,36
70,Fail,38,33,0,18,20
70,Fail,51,21,8,12,39
70,Fail,53,27,0,10,43
70,Fail,47,26,3,12,35
70,Fail,54,24,0,10,44
70,Fail,52,29,0,9,43
70,Fail,47,20,6,16,31
70,Fail,53,24,0,10,43
70,Fail,44,35,0,11,33
70,Fail,54,21,6,7,47
70,Fail,47,21,6,13,34
70,Fail,49,26,0,11,38
70,Fail,51,26,0,12,39
70,Fail,55,24,0,13,42
70,Fail,45,21,0,22,23
70,Fail,46,33,0,8,38
70,Fail,40,28,2,16,24
70,Fail,52,19,6,15,37
70,Fail,44,28,0,16,28
70,Fail,45,32,0,12,33
70,Fail,48,28,0,10,38
70,Fail,48,25,0,17,31
70,Fail,45,36,0,8,37
70,Fail,49,26,1,11,38
70,Fail,47,36,0,12,35
70,Fail,44,37,0,8,36
70,Fail,37,36,0,20,17
70,Fail,45,28,0,15,30
70,Fail,43,32,4,9,34
70,Fail,46,30,0,13,33
70,Fail,55,29,0,3,52
70,Fail,53,21,0,12,41
70,Fail,52,22,3,12,40
70,Fail,48,35,0,12,36
70,Fail,47,27,5,13,34
70,Fail,50,36,0,4,46
70,Fail,33,38,4,14,19
70,Fail,54,23,3,9,45
70,Fail,48,25,0,16,32
70,Fail,46,32,0,15,31
70,Fail,54,23,0,10,44
70,Fail,44,27,0,23,21
70,Fail,50,31,0,8,42
70,Fail,49,29,0,14,35
70,Fail,48,28,3,10,38
70,Fail,45,28,13,8,37
70,Fail,43,35,0,11,32
70,Fail,58,20,0,10,48
70,Fail,45,37,0,12,33
70,Fail,54,23,2,10,44
70,Fail,46,36,0,8,38
70,Fail,40,35,4,12,28
70,Fail,36,48,0,9,27
70,Fail,45,25,4,11,34
70,Fail,51,32,0,7,44
70,Fail,45,39,0,8,37
70,Fail,44,36,0,11,33
70,Fail,48,25,0,18,30
70,Fail,48,31,0,12,36
70,Fail,49,27,0,15,34
70,Fail,46,36,0,9,37
70,Fail,53,23,0,9,44
70,Fail,45,29,0,15,30
70,Fail,53,22,0,13,40
70,Fail,54,26,0,10,44
70,Fail,44,29,0,16,28
70,Fail,44,33,0,12,32
70,Fail,39,41,0,12,27
70,Fail,49,27,1,7,42
70,Fail,44,26,5,14,30
70,Fail,51,24,5,10,41
70,Fail,51,23,2,14,37
70,Fail,56,23,1,11,45
70,Fail,52,29,0,11,41
70,Fail,46,27,3,12,34
70,Fail,44,29,0,11,33
70,Fail,46,33,0,12,34
70,Fail,42,32,0,14,28
70,Fail,44,35,0,13,31
70,Fail,49,25,1,12,37
70,Fail,49,23,4,13,36
70,Fail,53,23,0,12,41
70,Fail,43,41,0,12,31
70,Fail,45,35,2,11,34
70,Fail,47,36,0,11,36
70,Fail,50,21,5,15,35
70,Fail,51,22,1,15,36
70,Fail,50,22,6,13,37
70,Fail,45,21,0,18,27
70,Fail,46,21,3,16,30
70,Fail,47,28,4,8,39
70,Fail,48,25,0,19,29
70,Fail,52,30,0,9,43
70,Fail,45,33,0,11,34
70,Fail,52,24,1,9,43
70,Fail,45,27,1,13,32
70,Fail,50,21,4,17,33
70,Fail,46,29,3,14,32
70,Fail,54,18,1,13,41
70,Fail,38,37,4,10,28
70,Fail,48,25,4,13,35
70,Fail,51,26,3,13,38
70,Fail,45,25,0,16,29
70,Fail,47,21,0,21,26
70,Fail,57,23,0,5,52
70,Fail,46,26,3,12,34
70,Fail,40,37,0,14,26
70,Fail,39,26,9,16,23
70,Fail,53,21,5,11,42
70,Fail,40,28,0,21,19
70,Fail,44,34,0,14,30
70,Fail,37,43,0,13,24
70,Fail,53,21,0,14,39
70,Fail,45,24,0,17,28
70,Fail,45,25,0,16,29
70,Fail,45,30,0,16,29
70,Fail,47,27,0,15,32
70,Fail,46,32,0,8,38
70,Fail,51,25,1,12,39
70,Fail,49,29,0,11,38
70,Fail,41,35,0,20,21
70,Fail,42,28,5,13,29
70,Fail,49,26,0,16,33
70,Fail,52,24,1,13,39
70,Fail,53,25,0,9,44
70,Fail,45,28,7,14,31
70,Fail,56,17,4,12,44
70,Fail,54,23,3,10,44
70,Fail,48,29,4,9,39
70,Fail,53,29,0,10,43
70,Fail,51,20,0,16,35
70,Fail,43,27,4,15,28
70,Fail,48,26,0,15,33
70,Fail,41,29,0,15,26
70,Fail,43,29,5,14,29
70,Fail,45,18,2,20,25
70,Fail,53,16,1,15,38
70,Fail,56,22,2,11,45
70,Fail,44,25,7,12,32
70,Fail,42,30,10,13,29
70,Fail,46,33,0,15,31
70,Fail,52,26,0,8,44
70,Fail,44,25,8,13,31
70,Fail,52,21,1,16,36
70,Fail,43,34,0,10,33
70,Fail,51,20,1,16,35
70,Fail,43,31,7,13,30
70,Fail,53,19,2,9,44
70,Fail,45,32,7,6,39
70,Fail,44,30,2,14,30
70,Fail,43,27,0,18,25
70,Fail,53,21,3,9,44
70,Fail,47,20,9,12,35
70,Fail,53,20,5,12,41
70,Fail,49,34,0,10,39
70,Fail,46,25,6,16,30
70,Fail,53,22,0,11,42
70,Fail,46,26,0,14,32
70,Fail,50,28,0,11,39
70,Fail,48,30,0,13,35
70,Fail,53,26,1,10,43
70,Fail,45,26,0,17,28
70,Fail,48,24,5,12,36
70,Fail,51,23,0,9,42
70,Fail,48,27,0,14,34
70,Fail,42,26,0,22,20
70,Fail,47,24,4,13,34
70,Fail,50,27,0,13,37
70,Fail,52,27,0,8,44
70,Fail,56,18,0,12,44
70,Fail,43,25,2,19,24
70,Fail,42,33,7,12,30
70,Fail,40,33,2,16,24
70,Fail,49,23,0,16,33
70,Fail,50,20,8,15,35
70,Fail,49,32,1,10,39
70,Fail,48,24,4,14,34
70,Fail,50,20,2,15,35
70,Fail,53,16,1,19,34
70,Fail,43,26,0,17,26
70,Fail,43,27,7,14,29
70,Fail,54,23,4,10,44
70,Fail,47,26,6,11,36
70,Fail,49,20,7,12,37
70,Fail,35,44,0,11,24
70,Fail,42,33,0,13,29
70,Fail,40,33,7,13,27
70,Fail,55,25,0,10,45
70,Fail,53,20,0,12,41
70,Fail,56,23,2,6,50
70,Fail,41,27,4,17,24
70,Fail,49,26,0,17,32
70,Fail,52,16,3,16,36
70,Fail,46,24,2,13,33
70,Fail,51,30,0,9,42
70,Fail,50,24,1,8,42
70,Fail,45,26,2,16,29
70,Fail,48,21,2,14,34
70,Fail,53,24,0,8,45
70,Fail,49,26,6,6,43
70,Fail,56,19,1,12,44
70,Fail,53,22,0,14,39
70,Fail,49,20,2,18,31
70,Fail,47,30,0,15,32
70,Fail,58,17,0,14,44
70,Fail,49,25,0,13,36
70,Fail,49,32,0,10,39
70,Fail,47,28,8,9,38
70,Fail,50,24,0,14,36
70,Fail,46,27,2,11,35
70,Fail,51,24,0,10,41
70,Fail,52,34,4,4,48
70,Fail,47,31,0,13,34
70,Fail,40,27,5,15,25
70,Fail,47,29,6,7,40
70,Fail,41,37,0,14,27
70,Fail,42,31,5,13,29
70,Fail,50,24,1,9,41
70,Fail,42,27,8,18,24
70,Fail,45,27,1,14,31
70,Fail,50,24,7,14,36
70,Fail,48,37,0,10,38
70,Fail,45,27,1,11,34
70,Fail,46,37,0,10,36
70,Fail,49,22,14,10,39
70,Fail,44,36,0,13,31
70,Fail,50,19,0,20,30
70,Fail,50,23,3,13,37
70,Fail,49,21,2,17,32
70,Fail,47,29,5,14,33
70,Fail,46,29,1,14,32
70,Fail,49,23,4,15,34
70,Fail,40,34,1,13,27
70,Fail,47,30,0,12,35
70,Fail,46,29,2,12,34
70,Fail,47,27,4,14,33
70,Fail,44,34,0,19,25
70,Fail,50,22,1,12,38
70,Fail,49,21,4,13,36
70,Fail,46,29,0,15,31
70,Fail,46,28,6,13,33
70,Fail,46,31,0,16,30
70,Fail,49,25,0,11,38
70,Fail,54,25,0,11,43
70,Fail,49,18,9,13,36
70,Fail,53,30,0,9,44
70,Fail,46,23,0,18,28
70,Fail,47,24,9,12,35
70,Fail,49,30,2,8,41
70,Fail,48,24,3,15,33
70,Fail,48,29,0,11,37
70,Fail,52,28,4,10,42
70,Fail,46,19,0,21,25
70,Fail,44,32,0,13,31
70,Fail,46,28,0,16,30
70,Fail,57,24,0,13,44
70,Fail,60,13,0,11,49
70,Fail,62,15,2,12,50
70,Fail,39,31,5,16,23
70,Fail,48,20,0,19,29
70,Fail,51,28,4,9,42
70,Fail,50,30,0,10,40
70,Fail,48,27,0,10,38
70,Fail,44,31,0,13,31
70,Fail,51,25,0,15,36
70,Fail,52,28,2,11,41
70,Fail,46,28,0,17,29
70,Fail,45,30,2,13,32
70,Fail,43,36,0,11,32
70,Fail,43,24,5,16,27
70,Fail,52,19,4,13,39
70,Fail,45,31,0,11,34
70,Fail,49,30,0,14,35
70,Fail,41,36,0,14,27
70,Fail,47,26,0,14,33
70,Fail,48,21,10,17,31
70,Fail,54,20,3,12,42
70,Fail,51,22,0,17,34
70,Fail,46,33,3,8,38
70,Fail,50,30,0,7,43
70,Fail,43,34,0,13,30
70,Fail,47,32,0,13,34
70,Fail,45,33,0,12,33
70,Fail,49,25,1,13,36
70,Fail,43,36,0,13,30
70,Fail,51,22,0,12,39
70,Fail,50,31,0,13,37
70,Fail,47,36,0,9,38
70,Fail,48,30,6,6,42
70,Fail,45,26,0,18,27
70,Fail,53,24,0,14,39
70,Fail,52,21,1,9,43
70,Fail,56,30,0,10,46
70,Fail,49,28,4,9,40
70,Fail,50,27,1,12,38
70,Fail,60,20,0,11,49
70,Fail,41,30,11,12,29
70,Fail,45,34,0,11,34
70,Fail,50,20,3,15,35
70,Fail,45,31,0,11,34
70,Fail,43,31,0,14,29
70,Fail,53,24,0,10,43
70,Fail,51,24,1,13,38
70,Fail,53,20,1,13,40
70,Fail,50,24,1,12,38
70,Fail,47,27,0,14,33
70,Fail,45,21,1,16,29
70,Fail,53,21,3,11,42
70,Fail,51,23,4,11,40
70,Fail,52,18,1,12,40
70,Fail,44,28,6,12,32
70,Fail,48,29,0,13,35
70,Fail,50,25,0,13,37
70,Fail,57,25,0,8,49
70,Fail,52,27,3,9,43
70,Fail,47,35,0,10,37
70,Fail,49,34,0,9,40
70,Fail,38,33,7,14,24
70,Fail,45,30,0,15,30
70,Fail,54,20,1,16,38
70,Fail,49,30,0,13,36
70,Fail,46,25,0,15,31
70,Fail,51,23,0,16,35
70,Fail,59,21,1,7,52
70,Fail,49,29,9,6,43
70,Fail,42,32,0,15,27
70,Fail,41,33,0,17,24
70,Fail,46,24,3,19,27
70,Fail,54,22,4,10,44
70,Fail,46,29,0,15,31
70,Fail,45,35,0,11,34
70,Fail,49,32,0,11,38
70,Fail,44,30,4,11,33
70,Fail,51,22,2,13,38
70,Fail,53,20,4,18,35
70,Fail,50,23,1,12,38
70,Fail,46,27,3,13,33
70,Fail,58,25,0,9,49
70,Fail,49,34,0,10,39
70,Fail,52,26,0,11,41
70,Fail,61,22,0,9,52
70,Fail,50,23,0,13,37
70,Fail,51,20,0,15,36
70,Fail,51,32,0,9,42
70,Fail,53,20,0,13,40
70,Fail,43,31,2,11,32
70,Fail,52,24,1,14,38
70,Fail,44,24,5,17,27
70,Fail,50,27,0,10,40
70,Fail,56,22,4,8,48
70,Fail,49,25,0,17,32
70,Fail,60,24,0,5,55
70,Fail,50,25,6,11,39
70,Fail,47,29,2,10,37
70,Fail,47,28,0,12,35
70,Fail,54,26,0,8,46
70,Fail,44,31,12,7,37
70,Fail,58,23,2,8,50
70,Fail,50,22,0,16,34
70,Fail,46,27,7,9,37
70,Fail,54,23,0,11,43
70,Fail,52,25,0,11,41
70,Fail,43,31,0,14,29
70,Fail,53,22,7,8,45
70,Fail,46,29,0,14,32
70,Fail,54,22,1,9,45
70,Fail,52,19,4,14,38
70,Fail,58,23,0,10,48
70,Fail,49,20,7,14,35
70,Fail,44,32,0,12,32
70,Fail,44,22,9,15,29
70,Fail,48,34,0,11,37
70,Fail,49,31,0,10,39
70,Fail,40,23,7,19,21
70,Fail,45,32,0,10,35
70,Fail,39,38,0,11,28
70,Fail,47,23,6,16,31
70,Fail,50,22,5,14,36
70,Fail,41,25,0,16,25
70,Fail,40,32,0,19,21
70,Fail,47,36,0,10,37
70,Fail,51,30,2,7,44
70,Fail,53,22,4,8,45
70,Fail,44,41,0,9,35
70,Fail,38,41,0,14,24
70,Fail,46,26,0,18,28
70,Fail,54,25,1,6,48
70,Fail,51,24,0,11,40
70,Fail,47,31,0,11,36
70,Fail,44,28,0,12,32
70,Fail,47,26,0,20,27
70,Fail,47,33,0,7,40
70,Fail,48,31,0,12,36
70,Fail,47,22,12,13,34
70,Fail,52,28,0,9,43
70,Fail,51,25,3,11,40
70,Fail,40,27,8,13,27
70,Fail,45,30,1,16,29
70,Fail,46,29,0,14,32
70,Fail,47,28,0,13,34
70,Fail,52,23,0,17,35
70,Fail,51,26,0,11,40
70,Fail,53,21,0,17,36
70,Fail,43,31,5,15,28
70,Fail,40,31,0,17,23
70,Fail,52,27,3,8,44
70,Fail,42,31,0,15,27
70,Fail,42,29,0,19,23
70,Fail,49,21,4,14,35
70,Fail,41,25,14,11,30
70,Fail,45,33,0,15,30
70,Fail,52,27,0,8,44
70,Fail,50,26,0,13,37
70,Fail,43,28,0,18,25
70,Fail,46,23,8,12,34
70,Fail,46,23,3,15,31
70,Fail,55,22,2,10,45
70,Fail,59,19,0,14,45
70,Fail,58,24,2,8,50
70,Fail,50,26,0,13,37
70,Fail,51,28,0,10,41
70,Fail,51,20,0,18,33
70,Fail,47,24,6,16,31
70,Fail,39,36,5,11,28
70,Fail,48,26,2,9,39
70,Fail,52,29,2,9,43
70,Fail,52,20,1,16,36
70,Fail,40,39,0,14,26
70,Fail,51,29,0,9,42
70,Fail,48,36,0,9,39
70,Fail,51,25,0,10,41
70,Fail,51,22,5,13,38
70,Fail,49,18,7,16,33
70,Fail,51,28,1,12,39
70,Fail,48,26,2,12,36
70,Fail,54,17,0,12,42
70,Fail,46,32,0,9,37
70,Fail,49,23,0,17,32
70,Fail,49,33,2,8,41
70,Fail,44,35,0,14,30
70,Fail,51,20,8,9,42
70,Fail,48,27,0,16,32
70,Fail,51,20,5,11,40
70,Fail,53,17,0,11,42
70,Fail,45,30,0,12,33
70,Fail,47,26,0,15,32
70,Fail,47,30,6,8,39
70,Fail,44,35,0,7,37
70,Fail,52,23,5,11,41
70,Fail,52,25,6,7,45
70,Fail,44,26,0,17,27
70,Fail,44,30,0,11,33
70,Fail,52,21,4,11,41
70,Fail,48,30,0,14,34
70,Fail,53,17,7,13,40
70,Fail,49,27,4,9,40
70,Fail,57,22,0,8,49
70,Fail,46,27,0,14,32
70,Fail,44,32,1,13,31
70,Fail,48,28,0,16,32
70,Fail,48,29,1,12,36
70,Fail,54,19,0,11,43
70,Fail,51,22,8,7,44
70,Fail,49,31,0,14,35
70,Fail,44,29,6,13,31
70,Fail,53,32,0,7,46
70,Fail,51,26,2,11,40
70,Fail,41,28,9,17,24
70,Fail,52,26,0,10,42
70,Fail,51,23,0,17,34
70,Fail,45,34,0,12,33
70,Fail,42,36,0,16,26
70,Fail,46,26,4,16,30
70,Fail,46,29,0,13,33
70,Fail,49,31,0,12,37
70,Fail,53,31,0,10,43
70,Fail,52,25,2,12,40
70,Fail,51,24,0,17,34
70,Fail,55,23,0,11,44
70,Fail,52,33,0,7,45
70,Fail,53,21,5,7,46
70,Fail,52,26,3,9,43
70,Fail,48,27,0,13,35
70,Fail,53,19,1,12,41
70,Fail,42,34,0,16,26
70,Fail,46,28,4,13,33
70,Fail,51,27,0,8,43
70,Fail,46,29,7,9,37
70,Fail,49,30,0,11,38
70,Fail,56,22,0,13,43
70,Fail,51,24,0,9,42
70,Fail,48,23,3,13,35
70,Fail,46,31,0,13,33
70,Fail,41,36,0,13,28
70,Fail,57,23,0,8,49
70,Fail,52,24,0,13,39
70,Fail,51,19,0,17,34
70,Fail,49,32,0,9,40
70,Fail,48,26,1,15,33
70,Fail,44,34,0,13,31
70,Fail,54,23,0,11,43
70,Fail,54,30,0,9,45
70,Fail,49,26,0,16,33
70,Fail,45,23,5,16,29
70,Fail,47,28,2,15,32
70,Fail,44,29,5,16,28
70,Fail,49,27,0,13,36
70,Fail,51,31,0,8,43
70,Fail,52,27,0,13,39
70,Fail,47,28,1,10,37
70,Fail,48,25,6,15,33
70,Fail,50,26,1,11,39
70,Fail,43,30,1,18,25
70,Fail,52,25,1,10,42
70,Fail,40,35,2,14,26
70,Fail,54,25,0,12,42
70,Fail,52,26,0,9,43
70,Fail,49,25,6,11,38
70,Fail,49,29,0,11,38
70,Fail,53,22,0,15,38
70,Fail,60,19,0,8,52
70,Fail,48,30,0,12,36
70,Fail,52,23,0,15,37
70,Fail,49,24,3,10,39
70,Fail,44,33,1,11,33
70,Fail,42,28,3,14,28
70,Fail,45,28,2,10,35
70,Fail,49,26,0,14,35
70,Fail,55,22,5,12,43
70,Fail,51,23,1,11,40
70,Fail,47,26,5,13,34
70,Fail,56,25,0,11,45
70,Fail,53,31,0,9,44
70,Fail,43,33,4,9,34
70,Fail,49,35,0,10,39
70,Fail,45,30,0,12,33
70,Fail,50,26,5,10,40
70,Fail,44,21,12,16,28
70,Fail,49,27,0,12,37
70,Fail,47,26,1,11,36
70,Fail,50,30,0,12,38
70,Fail,48,31,6,9,39
70,Fail,49,19,4,17,32
70,Fail,56,18,0,12,44
70,Fail,39,34,0,15,24
70,Fail,51,25,0,13,38
70,Fail,50,36,0,6,44
70,Fail,50,22,0,16,34
70,Fail,41,34,0,15,26
70,Fail,55,25,0,9,46
70,Fail,44,23,6,15,29
70,Fail,49,30,0,11,38
70,Fail,55,19,0,10,45
70,Fail,42,32,0,13,29
70,Fail,50,26,0,12,38
70,Fail,51,24,0,9,42
70,Fail,54,22,0,12,42
70,Fail,46,21,9,15,31
70,Fail,50,26,4,10,40
70,Fail,46,35,0,9,37
70,Fail,33,38,4,18,15
70,Fail,53,19,1,17,36
70,Fail,49,24,2,16,33
70,Fail,37,43,0,18,19
70,Fail,58,21,4,11,47
70,Fail,52,31,0,8,44
70,Fail,51,23,0,15,36
70,Fail,54,25,0,10,44
70,Fail,44,28,2,12,32
70,Fail,52,27,0,7,45
70,Fail,48,31,0,12,36
70,Fail,49,37,0,4,45
70,Fail,50,21,10,12,38
70,Fail,49,26,4,7,42
70,Fail,52,29,0,12,40
70,Fail,45,26,5,14,31
70,Fail,51,26,0,10,41
70,Fail,47,29,3,14,33
70,Fail,49,26,0,13,36
70,Fail,37,38,0,15,22
70,Fail,46,34,0,13,33
70,Fail,57,24,1,5,52
70,Fail,51,25,3,12,39
70,Fail,51,24,0,12,39
70,Fail,48,19,3,16,32
70,Fail,51,26,3,11,40
70,Fail,56,17,1,18,38
70,Fail,55,26,0,12,43
70,Fail,50,27,0,14,36
70,Fail,46,29,11,6,40
70,Fail,50,27,0,10,40
70,Fail,41,32,5,12,29
70,Fail,46,26,4,10,36
70,Fail,49,30,4,9,40
70,Fail,51,23,0,12,39
70,Fail,49,27,2,13,36
70,Fail,56,15,2,11,45
70,Fail,49,34,0,12,37
70,Fail,49,32,0,7,42
70,Fail,50,32,0,10,40
70,Fail,50,17,8,15,35
70,Fail,51,24,0,12,39
70,Fail,53,22,1,10,43
70,Fail,47,32,0,12,35
70,Fail,49,25,4,11,38
70,Fail,49,27,0,10,39
70,Fail,45,37,0,8,37
70,Fail,53,20,2,17,36
70,Fail,62,16,2,12,50
70,Fail,48,32,0,12,36
70,Fail,43,31,4,12,31
70,Fail,49,23,0,15,34
70,Fail,53,24,0,12,41
70,Fail,60,17,1,10,50
70,Fail,43,26,12,10,33
70,Fail,54,25,0,11,43
70,Fail,43,27,7,12,31
70,Fail,48,27,0,11,37
70,Fail,49,24,2,14,35
70,Fail,44,24,4,20,24
70,Fail,50,23,0,12,38
70,Fail,49,25,1,11,38
70,Fail,51,23,2,12,39
70,Fail,50,28,0,12,38
70,Fail,39,31,0,18,21
70,Fail,46,25,0,18,28
70,Fail,52,21,0,13,39
70,Fail,50,29,0,10,40
70,Fail,49,31,0,11,38
70,Fail,43,20,11,16,27
70,Fail,52,28,0,8,44
70,Fail,54,23,0,11,43
70,Fail,47,28,0,15,32
70,Fail,50,29,0,9,41
70,Fail,43,27,9,11,32
70,Fail,46,30,0,11,35
70,Fail,42,39,0,11,31
70,Fail,47,27,5,10,37
70,Fail,49,24,0,14,35
70,Fail,51,20,2,17,34
70,Fail,48,31,0,8,40
70,Fail,42,35,0,13,29
70,Fail,48,25,3,13,35
70,Fail,49,24,0,12,37
70,Fail,42,31,0,18,24
70,Fail,53,20,1,12,41
70,Fail,51,27,0,12,39
70,Fail,50,23,0,13,37
70,Fail,50,24,0,13,37
70,Fail,43,39,0,6,37
70,Fail,39,26,17,16,23
70,Fail,43,33,0,13,30
70,Fail,47,21,0,21,26
70,Fail,46,23,2,17,29
70,Fail,43,27,1,17,26
70,Fail,43,34,0,11,32
70,Fail,52,28,0,8,44
70,Fail,49,25,2,16,33
70,Fail,47,28,3,14,33
70,Fail,50,24,4,10,40
70,Fail,42,33,2,9,33
70,Fail,48,29,1,11,37
70,Fail,41,30,1,16,25
70,Fail,52,31,0,9,43
70,Fail,41,30,2,14,27
70,Fail,50,23,6,11,39
70,Fail,55,24,1,10,45
70,Fail,54,26,0,9,45
70,Fail,48,25,3,11,37
70,Fail,51,26,0,10,41
70,Fail,44,31,0,17,27
70,Fail,47,24,6,15,32
70,Fail,45,32,4,10,35
70,Fail,50,28,0,10,40
70,Fail,38,34,3,15,23
70,Fail,52,26,2,9,43
70,Fail,43,42,0,8,35
70,Fail,45,29,0,13,32
70,Fail,45,27,6,11,34
70,Fail,44,30,1,15,29
70,Fail,48,24,17,8,40
70,Fail,57,25,2,5,52
70,Fail,52,26,0,9,43
70,Fail,48,28,4,5,43
70,Fail,44,27,3,14,30
70,Fail,54,23,0,12,42
70,Fail,50,21,4,13,37
70,Fail,48,34,0,11,37
70,Fail,43,31,2,17,26
70,Fail,54,23,5,11,43
70,Fail,44,31,3,14,30
70,Fail,49,21,2,13,36
70,Fail,45,28,0,16,29
70,Fail,50,19,6,14,36
70,Fail,45,28,6,12,33
70,Fail,48,34,0,10,38
70,Fail,48,24,3,17,31
70,Fail,48,23,11,8,40
70,Fail,51,27,0,11,40
70,Fail,52,30,0,11,41
70,Fail,47,30,2,11,36
70,Fail,47,33,0,12,35
70,Fail,48,31,0,10,38
70,Fail,42,32,1,13,29
70,Fail,51,24,0,11,40
70,Fail,53,36,0,7,46
70,Fail,49,23,0,15,34
70,Fail,52,24,0,16,36
70,Fail,39,34,0,15,24
70,Fail,41,29,10,13,28
70,Fail,49,29,0,13,36
70,Fail,45,29,0,12,33
70,Fail,45,28,0,15,30
70,Fail,53,21,1,13,40
70,Fail,47,25,6,12,35
70,Fail,42,26,3,19,23
70,Fail,54,20,1,14,40
70,Fail,47,33,0,10,37
70,Fail,39,31,0,19,20
70,Fail,50,30,0,12,38
70,Fail,39,25,7,21,18
70,Fail,54,22,0,13,41
70,Fail,45,33,0,13,32
70,Fail,43,33,0,11,32
70,Fail,47,29,0,14,33
70,Fail,53,23,3,6,47
70,Fail,52,22,0,14,38
70,Fail,50,30,0,10,40
70,Fail,51,28,0,11,40
70,Fail,55,22,2,10,45
70,Fail,46,23,1,17,29
70,Fail,50,28,0,10,40
70,Fail,49,22,6,14,35
70,Fail,48,31,0,10,38
70,Fail,48,21,7,12,36
70,Fail,52,31,0,5,47
70,Fail,46,33,0,13,33
70,Fail,54,20,0,10,44
70,Fail,52,25,0,11,41
70,Fail,38,33,0,18,20
70,Fail,45,33,0,12,33
70,Fail,47,28,0,15,32
70,Fail,43,36,0,17,26
70,Fail,45,25,2,15,30
70,Fail,43,34,5,9,34
70,Fail,48,25,0,14,34
70,Fail,48,26,0,17,31
70,Fail,44,27,7,13,31
70,Fail,45,36,0,11,34
70,Fail,57,19,0,15,42
70,Fail,47,29,0,15,32
70,Fail,45,27,0,18,27
70,Fail,50,29,0,13,37
70,Fail,50,25,5,8,42
70,Fail,43,34,0,12,31
70,Fail,49,26,7,13,36
70,Fail,43,35,0,11,32
70,Fail,47,25,1,10,37
70,Fail,52,26,0,11,41
70,Fail,46,35,0,11,35
70,Fail,50,24,0,14,36
70,Fail,45,29,1,14,31
70,Fail,48,25,1,13,35
70,Fail,41,34,0,18,23
70,Fail,52,28,0,9,43
70,Fail,37,37,0,19,18
70,Fail,43,28,1,14,29
70,Fail,51,27,0,9,42
70,Fail,52,22,5,9,43
70,Fail,49,30,0,9,40
70,Fail,55,21,0,13,42
70,Fail,43,30,0,17,26
70,Fail,48,27,6,6,42
70,Fail,50,27,2,10,40
70,Fail,45,31,0,15,30
70,Fail,53,27,0,13,40
70,Fail,48,23,7,15,33
70,Fail,42,30,2,16,26
70,Fail,49,33,0,8,41
70,Fail,48,25,0,14,34
70,Fail,56,26,0,11,45
70,Fail,49,28,0,12,37
70,Fail,51,26,0,11,40
70,Fail,58,18,0,13,45
70,Fail,40,33,1,15,25
70,Fail,50,22,0,12,38
70,Fail,47,26,1,16,31
70,Fail,47,30,0,11,36
70,Fail,46,27,1,13,33
70,Fail,49,26,2,13,36
70,Fail,50,22,3,15,35
70,Fail,52,19,1,16,36
70,Fail,59,16,5,11,48
70,Fail,43,35,0,18,25
70,Fail,43,40,0,7,36
70,Fail,39,32,0,18,21
70,Fail,46,30,0,13,33
70,Fail,52,23,0,15,37
70,Fail,43,25,13,11,32
70,Fail,48,31,0,9,39
70,Fail,47,26,8,10,37
70,Fail,51,19,0,16,35
70,Fail,51,26,0,14,37
70,Fail,43,25,12,11,32
70,Fail,49,20,3,15,34
70,Fail,48,26,0,16,32
70,Fail,53,24,1,10,43
70,Fail,49,25,4,12,37
70,Fail,51,22,5,14,37
70,Fail,46,25,0,16,30
70,Fail,51,20,1,16,35
70,Fail,50,28,1,11,39
70,Fail,55,23,0,12,43
70,Fail,54,29,0,8,46
70,Fail,48,28,8,6,42
70,Fail,43,29,8,14,29
70,Fail,48,27,1,13,35
70,Fail,52,19,3,13,39
70,Fail,44,30,3,11,33
70,Fail,46,34,0,7,39
70,Fail,51,24,0,15,36
70,Fail,49,29,5,7,42
70,Fail,55,18,3,11,44
70,Fail,51,23,8,11,40
70,Fail,46,26,2,16,30
70,Fail,57,23,0,5,52
70,Fail,46,25,0,13,33
70,Fail,49,25,3,14,35
70,Fail,49,24,2,13,36
70,Fail,48,24,0,15,33
70,Fail,50,23,4,14,36
70,Fail,46,35,0,10,36
70,Fail,52,26,0,11,41
70,Fail,52,24,0,18,34
70,Fail,50,29,0,13,37
70,Fail,53,24,7,9,44
70,Fail,47,30,0,14,33
70,Fail,48,33,0,13,35
70,Fail,54,21,3,14,40
70,Fail,47,34,0,8,39
70,Fail,48,31,0,12,36
70,Fail,51,27,0,12,39
70,Fail,43,26,10,12,31
70,Fail,63,22,0,3,60
70,Fail,44,32,3,13,31
70,Fail,56,22,1,9,47
70,Fail,48,28,2,11,37
70,Fail,52,22,6,12,40
70,Fail,41,29,1,15,26
70,Fail,53,20,0,16,37
70,Fail,50,24,0,13,37
70,Fail,53,14,0,15,38
70,Fail,47,25,4,11,36
70,Fail,51,24,7,11,40
70,Fail,43,33,0,14,29
70,Fail,49,28,0,12,37
70,Fail,47,23,2,15,32
70,Fail,46,32,0,12,34
70,Fail,47,29,0,12,35
70,Fail,50,23,0,16,34
70,Fail,52,30,0,9,43
70,Fail,47,29,6,10,37
70,Fail,48,34,0,10,38
70,Fail,55,23,0,10,45
70,Fail,50,23,0,17,33
70,Fail,52,26,0,13,39
70,Fail,40,33,4,12,28
70,Fail,58,20,3,12,46
70,Fail,47,30,4,6,41
70,Fail,50,26,2,9,41
70,Fail,47,22,8,18,29
70,Fail,44,24,0,16,28
70,Fail,47,25,2,16,31
70,Fail,54,25,0,11,43
70,Fail,48,27,2,14,34
70,Fail,52,26,1,9,43
70,Fail,42,27,9,11,31
70,Fail,53,20,0,11,42
70,Fail,47,28,10,9,38
70,Fail,52,19,0,15,37
70,Fail,53,22,3,15,38
70,Fail,37,39,4,12,25
70,Fail,52,23,4,9,43
70,Fail,53,21,1,18,35
70,Fail,59,17,2,10,49
70,Fail,56,16,1,15,41
70,Fail,42,39,0,13,29
70,Fail,46,28,0,16,30
70,Fail,46,35,0,9,37
70,Fail,44,39,0,8,36
70,Fail,44,32,0,16,28
70,Fail,54,18,0,17,37
70,Fail,48,27,2,13,35
70,Fail,54,17,1,16,38
70,Fail,50,33,0,10,40
70,Fail,45,27,7,14,31
70,Fail,48,25,5,11,37
70,Fail,47,31,0,8,39
70,Fail,44,31,3,12,32
70,Fail,52,31,0,6,46
70,Fail,48,29,0,15,33
70,Fail,50,26,0,15,35
70,Fail,48,26,0,16,32
70,Fail,51,25,0,11,40
70,Fail,50,32,0,6,44
70,Fail,55,22,1,8,47
70,Fail,52,21,2,10,42
70,Fail,50,28,0,10,40
70,Fail,50,30,0,10,40
70,Fail,45,23,5,17,28
70,Fail,45,30,0,15,30
70,Fail,47,35,0,11,36
70,Fail,45,30,3,11,34
70,Fail,44,24,0,18,26
70,Fail,47,22,3,14,33
70,Fail,56,17,1,15,41
70,Fail,47,29,0,12,35
70,Fail,53,21,7,10,43
70,Fail,52,22,3,11,41
70,Fail,52,30,0,9,43
70,Fail,42,32,9,7,35
70,Fail,57,18,0,10,47
70,Fail,48,28,0,15,33
70,Fail,42,26,4,14,28
70,Fail,46,30,0,12,34
70,Fail,47,30,6,12,35
70,Fail,49,24,1,13,36
70,Fail,39,34,6,13,26
70,Fail,44,27,10,13,31
70,Fail,53,26,2,9,44
70,Fail,47,27,7,10,37
70,Fail,51,18,0,17,34
70,Fail,48,28,0,12,36
70,Fail,47,27,1,13,34
70,Fail,53,23,2,15,38
70,Fail,45,27,8,12,33
70,Fail,46,35,0,10,36
70,Fail,52,25,4,9,43
70,Fail,54,20,6,12,42
70,Fail,53,27,0,9,44
70,Fail,48,30,0,14,34
70,Fail,52,22,6,8,44
70,Fail,50,21,6,12,38
70,Fail,49,26,6,11,38
70,Fail,46,29,8,11,35
70,Fail,45,27,0,16,29
70,Fail,52,33,0,7,45
70,Fail,39,35,0,16,23
70,Fail,46,20,4,18,28
70,Fail,48,27,2,12,36
70,Fail,50,25,4,13,37
70,Fail,43,25,0,21,22
70,Fail,52,24,0,15,37
70,Fail,57,22,0,11,46
70,Fail,54,22,5,7,47
70,Fail,45,31,0,13,32
70,Fail,48,26,0,15,33
70,Fail,48,21,0,16,32
70,Fail,61,18,0,9,52
70,Fail,53,21,7,10,43
70,Fail,45,20,5,17,28
70,Fail,43,33,1,11,32
70,Fail,47,28,0,17,30
70,Fail,47,39,0,4,43
70,Fail,46,26,1,15,31
70,Fail,44,25,1,14,30
70,Fail,46,30,0,15,31
70,Fail,43,30,0,17,26
70,Fail,51,23,3,12,39
70,Fail,46,25,2,17,29
70,Fail,49,26,8,9,40
70,Fail,36,28,6,19,17
70,Fail,48,23,4,12,36
70,Fail,43,25,2,19,24
70,Fail,52,26,0,12,40
70,Fail,50,16,0,22,28
70,Fail,46,32,0,14,32
70,Fail,54,20,2,11,43
70,Fail,47,27,0,14,33
70,Fail,40,29,8,14,26
70,Fail,48,31,0,14,34
70,Fail,51,16,0,16,35
70,Fail,45,28,0,15,30
70,Fail,51,30,0,10,41
70,Fail,53,22,2,12,41
70,Fail,45,26,5,12,33
70,Fail,47,30,0,14,33
70,Fail,49,27,0,12,37
70,Fail,49,19,1,18,31
70,Fail,55,21,0,14,41
70,Fail,43,27,5,14,29
70,Fail,42,34,9,8,34
70,Fail,46,30,0,9,37
70,Fail,51,26,0,7,44
70,Fail,45,22,9,13,32
70,Fail,53,23,0,12,41
70,Fail,58,28,0,5,53
70,Fail,44,24,0,21,23
70,Fail,48,21,0,21,27
70,Fail,44,28,1,14,30
70,Fail,35,37,0,16,19
70,Fail,44,37,0,8,36
70,Fail,41,24,12,15,26
70,Fail,43,34,0,14,29
70,Fail,57,24,4,7,50
70,Fail,48,21,0,15,33
70,Fail,46,29,4,10,36
70,Fail,45,34,0,13,32
70,Fail,44,38,0,9,35
70,Fail,48,23,2,18,30
70,Fail,51,22,0,16,35
70,Fail,46,31,0,13,33
70,Fail,50,33,0,9,41
70,Fail,44,24,7,13,31
70,Fail,47,34,0,10,37
70,Fail,55,24,0,11,44
70,Fail,44,33,0,17,27
70,Fail,60,22,0,12,48
70,Fail,53,26,0,11,42
70,Fail,44,37,0,11,33
70,Fail,50,27,1,9,41
70,Fail,45,25,8,18,27
70,Fail,52,22,3,11,41
70,Fail,38,37,0,17,21
70,Fail,39,35,0,18,21
70,Fail,43,33,0,14,29
70,Fail,47,29,0,15,32
70,Fail,49,23,5,10,39
70,Fail,38,38,0,12,26
70,Fail,46,29,0,15,31
70,Fail,45,28,4,12,33
70,Fail,41,31,0,16,25
70,Fail,56,25,2,7,49
70,Fail,55,29,0,6,49
70,Fail,38,33,8,14,24
70,Fail,40,31,0,14,26
70,Fail,46,31,0,14,32
70,Fail,46,22,6,14,32
70,Fail,46,21,2,18,28
70,Fail,50,30,0,13,37
70,Fail,50,21,1,17,33
70,Fail,46,24,1,17,29
70,Fail,47,30,1,11,36
70,Fail,48,29,2,12,36
70,Fail,50,23,1,14,36
70,Fail,39,40,0,12,27
70,Fail,45,27,4,11,34
70,Fail,50,28,0,11,39
70,Fail,54,20,0,12,42
70,Fail,50,24,0,12,38
70,Fail,47,23,0,21,26
70,Fail,52,27,0,5,47
70,Fail,42,33,0,13,29
70,Fail,42,32,0,14,28
70,Fail,39,29,4,16,23
70,Fail,49,26,0,16,33
70,Fail,50,30,0,9,41
70,Fail,45,31,3,15,30
70,Fail,47,34,0,12,35
70,Fail,43,28,8,12,31
70,Fail,50,25,0,14,36
70,Fail,50,24,0,14,36
70,Fail,52,32,0,7,45
70,Fail,55,27,0,9,46
70,Fail,49,29,0,9,40
70,Fail,48,28,0,16,32
70,Fail,47,23,6,14,33
70,Fail,42,27,7,17,25
70,Fail,51,20,0,12,39
70,Fail,41,34,0,15,26
70,Fail,46,33,0,10,36
70,Fail,57,26,0,5,52
70,Fail,46,23,8,10,36
70,Fail,48,26,0,17,31
70,Fail,50,27,0,13,37
70,Fail,47,33,0,10,37
70,Fail,52,29,0,7,45
70,Fail,47,27,0,12,35
70,Fail,58,22,1,6,52
70,Fail,51,27,0,12,39
70,Fail,40,34,0,17,23
70,Fail,50,23,2,10,40
70,Fail,45,31,0,13,32
70,Fail,47,21,7,14,33
70,Fail,45,32,4,11,34
70,Fail,37,35,0,18,19
70,Fail,51,22,4,15,36
70,Fail,48,23,1,14,34
70,Fail,48,33,0,15,33
70,Fail,51,28,5,8,43
70,Fail,47,30,0,11,36
70,Fail,46,23,4,15,31
70,Fail,47,28,0,11,36
70,Fail,54,23,0,8,46
70,Fail,49,27,0,15,34
70,Fail,48,32,0,11,37
70,Fail,48,33,0,11,37
70,Fail,56,18,1,13,43
70,Fail,49,33,0,11,38
70,Fail,50,23,1,14,36
70,Fail,43,26,6,16,27
70,Fail,50,19,6,15,35
70,Fail,47,21,0,18,29
70,Fail,53,25,1,10,43
70,Fail,42,37,0,10,32
70,Fail,43,27,0,21,22
70,Fail,43,24,5,16,27
70,Fail,52,28,4,8,44
70,Fail,43,29,4,13,30
70,Fail,46,25,1,17,29
70,Fail,50,28,0,14,36
70,Fail,56,20,0,14,42
70,Fail,45,28,0,16,29
70,Fail,54,28,0,9,45
70,Fail,48,32,0,12,36
70,Fail,42,35,0,14,28
70,Fail,52,24,4,4,48
70,Fail,46,30,1,10,36
70,Fail,54,23,0,9,45
70,Fail,61,14,0,13,48
70,Fail,54,22,1,11,43
70,Fail,50,27,2,11,39
70,Fail,49,25,4,12,37
70,Fail,44,32,0,12,32
70,Fail,48,28,0,14,34
70,Fail,46,32,0,10,36
70,Fail,54,28,0,7,47
70,Fail,55,22,0,10,45
70,Fail,51,22,0,15,36
70,Fail,48,24,3,15,33
70,Fail,54,23,2,8,46
70,Fail,51,24,0,12,39
70,Fail,44,30,0,16,28
70,Fail,54,20,0,10,44
70,Fail,54,19,8,10,44
70,Fail,58,17,2,11,47
70,Fail,55,20,3,10,45
70,Fail,43,35,0,12,31
70,Fail,55,23,0,12,43
70,Fail,44,27,4,19,25
70,Fail,52,26,0,11,41
70,Fail,49,23,7,11,38
70,Fail,52,32,3,2,50
70,Fail,52,23,9,9,43
70,Fail,46,25,9,11,35
70,Fail,45,34,0,12,33
70,Fail,54,25,0,9,45
70,Fail,56,20,0,13,43
70,Fail,45,27,0,18,27
70,Fail,48,32,0,7,41
70,Fail,49,25,7,11,38
70,Fail,50,28,1,11,39
70,Fail,41,30,2,16,25
70,Fail,43,31,7,14,29
70,Fail,47,25,5,12,35
70,Fail,50,29,0,11,39
70,Fail,44,34,0,13,31
70,Fail,46,21,0,23,23
70,Fail,54,25,2,9,45
70,Fail,52,28,0,9,43
70,Fail,46,31,0,13,33
70,Fail,46,23,7,11,35
70,Fail,45,36,0,9,36
70,Fail,44,22,0,21,23
70,Fail,48,29,4,8,40
70,Fail,44,27,6,13,31
70,Fail,58,19,2,11,47
70,Fail,55,23,0,12,43
70,Fail,46,24,6,16,30
70,Fail,54,18,1,16,38
70,Fail,43,28,10,10,33
70,Fail,53,30,0,10,43
70,Fail,51,32,0,8,43
70,Fail,46,28,5,11,35
70,Fail,51,24,8,8,43
70,Fail,51,21,2,13,38
70,Fail,46,23,5,16,30
70,Fail,51,23,5,11,40
70,Fail,48,22,3,14,34
70,Fail,52,22,9,10,42
70,Fail,43,34,0,15,28
70,Fail,49,27,0,14,35
70,Fail,42,32,0,14,28
70,Fail,52,25,0,13,39
70,Fail,37,35,7,10,27
70,Fail,50,24,0,13,37
70,Fail,42,25,4,18,24
70,Fail,53,27,0,12,41
70,Fail,45,25,7,15,30
70,Fail,46,26,5,12,34
70,Fail,41,33,0,13,28
70,Fail,45,33,0,12,33
70,Fail,48,27,0,13,35
70,Fail,57,23,0,11,46
70,Fail,52,26,5,8,44
70,Fail,41,32,4,11,30
70,Fail,55,15,3,14,41
70,Fail,43,32,3,9,34
70,Fail,47,24,0,17,30
70,Fail,46,26,0,13,33
70,Fail,37,34,0,21,16
70,Fail,49,24,0,16,33
70,Fail,49,25,4,10,39
70,Fail,55,18,3,13,42
70,Fail,51,26,1,11,40
70,Fail,47,22,9,15,32
70,Fail,45,22,0,20,25
70,Fail,42,30,0,14,28
70,Fail,46,32,0,13,33
70,Fail,55,27,1,10,45
70,Fail,51,21,10,12,39
70,Fail,45,26,2,11,34
70,Fail,51,21,1,13,38
70,Fail,41,36,1,11,30
70,Fail,52,30,0,6,46
70,Fail,46,23,8,14,32
70,Fail,51,18,0,18,33
70,Fail,50,28,0,11,39
70,Fail,52,24,0,10,42
70,Fail,54,29,0,6,48
70,Fail,46,30,1,11,35
70,Fail,50,21,5,13,37
70,Fail,42,35,2,9,33
70,Fail,45,35,0,13,32
70,Fail,47,20,5,14,33
70,Fail,37,42,0,11,26
70,Fail,49,29,0,11,38
70,Fail,43,25,0,19,24
70,Fail,46,29,4,12,34
70,Fail,52,25,6,7,45
70,Fail,42,31,0,14,28
70,Fail,52,25,0,11,41
70,Fail,46,36,0,11,35
70,Fail,37,27,6,22,15
70,Fail,48,26,0,13,35
70,Fail,47,21,4,16,31
70,Fail,51,27,4,10,41
70,Fail,56,19,2,13,43
70,Fail,46,26,0,15,31
80,Fail,47,23,5,12,35
80,Fail,36,42,0,12,24
80,Fail,46,24,0,19,27
80,Fail,45,30,0,15,30
80,Fail,47,31,1,10,37
80,Fail,48,21,2,18,30
80,Fail,48,19,1,19,29
80,Fail,49,17,7,18,31
80,Fail,61,22,0,3,58
80,Fail,43,32,3,14,29
80,Fail,46,27,1,17,29
80,Fail,36,34,0,19,17
80,Fail,46,36,0,10,36
80,Fail,54,21,1,13,41
80,Fail,53,18,2,16,37
80,Fail,47,29,0,14,33
80,Fail,50,28,0,9,41
80,Fail,46,35,0,10,36
80,Fail,50,26,0,12,38
80,Fail,41,30,6,18,23
80,Fail,48,36,0,8,40
80,Fail,44,35,0,11,33
80,Fail,61,20,0,6,55
80,Fail,50,21,10,11,39
80,Fail,45,32,0,16,29
80,Fail,58,19,0,9,49
80,Fail,48,25,0,16,32
80,Fail,56,21,0,12,44
80,Fail,44,30,0,16,28
80,Fail,43,29,3,15,28
80,Fail,48,29,0,12,36
80,Fail,47,24,2,16,31
80,Fail,47,24,4,13,34
80,Fail,49,33,0,9,40
80,Fail,53,25,0,11,42
80,Fail,46,25,0,16,30
80,Fail,47,31,0,10,37
80,Fail,55,19,1,13,42
80,Fail,54,22,6,8,46
80,Fail,47,22,2,12,35
80,Fail,45,28,8,12,33
80,Fail,48,25,0,15,33
80,Fail,61,18,3,4,57
80,Fail,51,24,0,14,37
80,Fail,49,25,5,9,40
80,Fail,52,26,0,11,41
80,Fail,50,24,0,16,34
80,Fail,45,33,0,13,32
80,Fail,49,22,4,14,35
80,Fail,46,24,1,17,29
80,Fail,50,23,0,11,39
80,Fail,43,25,3,18,25
80,Fail,47,36,0,8,39
80,Fail,55,18,5,10,45
80,Fail,46,36,0,12,34
80,Fail,46,30,0,11,35
80,Fail,49,25,0,11,38
80,Fail,43,30,0,13,30
80,Fail,46,32,0,12,34
80,Fail,48,22,9,11,37
80,Fail,45,36,0,7,38
80,Fail,55,19,0,10,45
80,Fail,46,29,1,11,35
80,Fail,56,20,0,11,45
80,Fail,44,26,6,12,32
80,Fail,34,30,11,20,14
80,Fail,51,25,4,13,38
80,Fail,41,34,4,12,29
80,Fail,50,22,2,16,34
80,Fail,56,28,1,8,48
80,Fail,46,27,0,17,29
80,Fail,51,24,0,12,39
80,Fail,53,21,0,14,39
80,Fail,53,24,0,12,41
80,Fail,48,22,0,18,30
80,Fail,59,21,0,6,53
80,Fail,54,22,3,13,41
80,Fail,45,33,0,13,32
80,Fail,54,21,1,14,40
80,Fail,47,32,0,11,36
80,Fail,50,27,0,11,39
80,Fail,45,30,3,13,32
80,Fail,43,31,0,18,25
80,Fail,42,30,6,16,26
80,Fail,51,21,0,17,34
80,Fail,45,26,0,15,30
80,Fail,42,29,13,11,31
80,Fail,48,29,2,12,36
80,Fail,52,25,0,12,40
80,Fail,52,29,0,9,43
80,Fail,48,29,0,13,35
80,Fail,53,30,0,7,46
80,Fail,39,37,0,17,22
80,Fail,44,30,0,13,31
80,Fail,41,38,0,12,29
80,Fail,52,20,7,11,41
80,Fail,47,25,8,12,35
80,Fail,44,29,1,14,30
80,Fail,51,22,0,18,33
80,Fail,53,22,1,15,38
80,Fail,51,25,3,9,42
80,Fail,46,31,1,10,36
80,Fail,45,37,0,8,37
80,Fail,48,28,5,10,38
80,Fail,44,28,7,14,30
80,Fail,51,25,1,14,37
80,Fail,50,27,6,10,40
80,Fail,49,20,4,15,34
80,Fail,46,22,3,17,29
80,Fail,53,27,0,10,43
80,Fail,48,26,6,8,40
80,Fail,45,27,0,16,29
80,Fail,51,19,4,18,33
80,Fail,45,25,4,15,30
80,Fail,54,25,0,7,47
80,Fail,51,24,4,9,42
80,Fail,45,28,1,15,30
80,Fail,48,33,0,10,38
80,Fail,42,23,0,20,22
80,Fail,42,28,5,13,29
80,Fail,45,33,0,16,29
80,Fail,45,30,4,8,37
80,Fail,43,24,8,16,27
80,Fail,46,23,6,17,29
80,Fail,50,26,0,9,41
80,Fail,48,30,0,12,36
80,Fail,50,28,0,15,35
80,Fail,42,35,0,15,27
80,Fail,52,28,2,9,43
80,Fail,43,23,5,18,25
80,Fail,56,26,1,5,51
80,Fail,36,31,1,18,18
80,Fail,40,33,0,13,27
80,Fail,48,27,0,13,35
80,Fail,52,27,4,7,45
80,Fail,44,29,0,16,28
80,Fail,50,26,0,13,37
80,Fail,41,38,0,12,29
80,Fail,47,35,0,8,39
80,Fail,44,36,0,12,32
80,Fail,47,29,0,14,33
80,Fail,38,27,6,17,21
80,Fail,45,25,8,13,32
80,Fail,48,22,8,13,35
80,Fail,52,20,10,13,39
80,Fail,46,25,2,17,29
80,Fail,49,25,10,9,40
80,Fail,48,29,1,10,38
80,Fail,43,29,6,16,27
80,Fail,51,31,0,7,44
80,Fail,53,20,0,16,37
80,Fail,54,22,0,9,45
80,Fail,44,28,0,20,24
80,Fail,45,19,7,15,30
80,Fail,56,26,0,8,48
80,Fail,47,28,0,14,33
80,Fail,47,27,6,13,34
80,Fail,32,32,13,13,19
80,Fail,49,31,0,10,39
80,Fail,48,39,0,7,41
80,Fail,48,20,4,16,32
80,Fail,55,23,0,12,43
80,Fail,45,28,0,16,29
80,Fail,45,28,0,18,27
80,Fail,55,18,3,9,46
80,Fail,39,33,0,18,21
80,Fail,41,39,0,12,29
80,Fail,49,23,4,12,37
80,Fail,44,28,3,12,32
80,Fail,46,32,0,11,35
80,Fail,44,26,5,13,31
80,Fail,46,28,3,8,38
80,Fail,47,28,0,17,30
80,Fail,50,35,0,9,41
80,Fail,48,30,0,11,37
80,Fail,54,16,4,16,38
80,Fail,43,32,0,14,29
80,Fail,43,23,7,16,27
80,Fail,34,40,0,20,14
80,Fail,47,26,3,13,34
80,Fail,45,29,2,14,31
80,Fail,45,27,5,13,32
80,Fail,46,31,0,14,32
80,Fail,48,25,10,11,37
80,Fail,50,24,0,15,35
80,Fail,49,25,5,12,37
80,Fail,42,28,2,19,23
80,Fail,48,26,5,13,35
80,Fail,39,38,0,13,26
80,Fail,57,25,0,12,45
80,Fail,44,30,0,18,26
80,Fail,48,25,0,18,30
80,Fail,48,31,0,12,36
80,Fail,40,30,2,18,22
80,Fail,48,30,0,10,38
80,Fail,48,25,2,11,37
80,Fail,43,34,3,11,32
80,Fail,47,30,3,10,37
80,Fail,59,18,0,10,49
80,Fail,39,42,0,9,30
80,Fail,49,35,0,9,40
80,Fail,46,30,0,11,35
80,Fail,55,28,1,6,49
80,Fail,54,27,0,7,47
80,Fail,50,25,0,12,38
80,Fail,52,23,1,13,39
80,Fail,44,36,0,11,33
80,Fail,45,30,3,9,36
80,Fail,55,29,0,6,49
80,Fail,61,24,0,4,57
80,Fail,45,29,6,11,34
80,Fail,56,23,0,6,50
80,Fail,43,28,8,13,30
80,Fail,40,34,0,15,25
80,Fail,51,27,0,11,40
80,Fail,47,25,3,16,31
80,Fail,51,27,0,12,39
80,Fail,50,31,0,12,38
80,Fail,48,25,9,9,39
80,Fail,49,29,1,9,40
80,Fail,51,23,0,14,37
80,Fail,46,26,5,12,34
80,Fail,51,31,0,10,41
80,Fail,47,23,2,18,29
80,Fail,51,17,1,15,36
80,Fail,48,26,3,14,34
80,Fail,42,33,0,15,27
80,Fail,50,27,3,10,40
80,Fail,50,24,1,10,40
80,Fail,51,23,0,17,34
80,Fail,45,31,2,13,32
80,Fail,50,24,3,8,42
80,Fail,45,24,6,14,31
80,Fail,56,22,0,9,47
80,Fail,41,32,0,11,30
80,Fail,42,35,0,16,26
80,Fail,41,25,0,19,22
80,Fail,53,24,0,11,42
80,Fail,48,21,1,18,30
80,Fail,47,29,0,15,32
80,Fail,45,29,0,18,27
80,Fail,54,24,0,13,41
80,Fail,47,25,8,11,36
80,Fail,49,23,0,13,36
80,Fail,43,32,2,16,27
80,Fail,46,38,0,6,40
80,Fail,52,27,0,11,41
80,Fail,49,27,5,10,39
80,Fail,53,23,0,10,43
80,Fail,57,24,1,7,50
80,Fail,45,25,3,12,33
80,Fail,47,28,4,9,38
80,Fail,47,23,2,13,34
80,Fail,51,24,4,12,39
80,Fail,45,25,8,15,30
80,Fail,46,33,0,13,33
80,Fail,44,27,0,13,31
80,Fail,47,23,2,15,32
80,Fail,51,23,0,16,35
80,Fail,47,28,0,16,31
80,Fail,45,27,8,14,31
80,Fail,47,33,0,9,38
80,Fail,49,27,3,11,38
80,Fail,48,30,0,10,38
80,Fail,45,26,2,17,28
80,Fail,54,27,0,7,47
80,Fail,52,23,3,12,40
80,Fail,46,26,5,14,32
80,Fail,40,26,7,19,21
80,Fail,44,32,0,12,32
80,Fail,52,25,0,10,42
80,Fail,44,31,3,12,32
80,Fail,53,29,1,4,49
80,Fail,47,25,4,13,34
80,Fail,43,26,0,19,24
80,Fail,52,26,0,12,40
80,Fail,46,30,0,16,30
80,Fail,38,40,0,12,26
80,Fail,52,26,5,7,45
80,Fail,44,33,0,12,32
80,Fail,56,26,0,11,45
80,Fail,57,19,6,12,45
80,Fail,42,26,0,14,28
80,Fail,55,27,0,9,46
80,Fail,50,25,0,13,37
80,Fail,42,32,8,12,30
80,Fail,41,23,6,21,20
80,Fail,50,28,5,10,40
80,Fail,50,24,1,10,40
80,Fail,47,26,0,15,32
80,Fail,45,30,5,8,37
80,Fail,54,21,0,11,43
80,Fail,50,25,4,12,38
80,Fail,52,20,1,14,38
80,Fail,47,22,10,15,32
80,Fail,59,15,5,9,50
80,Fail,49,26,0,17,32
80,Fail,51,21,0,12,39
80,Fail,41,30,4,15,26
80,Fail,49,31,0,7,42
80,Fail,59,18,1,9,50
80,Fail,45,25,7,12,33
80,Fail,45,25,3,14,31
80,Fail,49,32,0,13,36
80,Fail,57,21,0,11,46
80,Fail,46,21,4,18,28
80,Fail,57,17,10,8,49
80,Fail,52,30,0,10,42
80,Fail,44,30,0,13,31
80,Fail,44,28,2,15,29
80,Fail,51,21,6,10,41
80,Fail,44,27,4,12,32
80,Fail,54,26,1,5,49
80,Fail,48,27,4,11,37
80,Fail,49,33,0,10,39
80,Fail,52,28,3,10,42
80,Fail,47,28,0,14,33
80,Fail,51,25,1,12,39
80,Fail,46,26,0,17,29
80,Fail,51,22,3,11,40
80,Fail,50,29,0,10,40
80,Fail,52,25,0,10,42
80,Fail,43,33,0,12,31
80,Fail,52,27,0,14,38
80,Fail,58,21,0,11,47
80,Fail,50,27,3,11,39
80,Fail,51,25,0,10,41
80,Fail,56,25,5,6,50
80,Fail,45,32,0,11,34
80,Fail,60,19,2,7,53
80,Fail,49,28,8,10,39
80,Fail,51,19,4,13,38
80,Fail,50,22,7,9,41
80,Fail,35,35,11,11,24
80,Fail,53,26,0,11,42
80,Fail,48,28,2,10,38
80,Fail,53,17,11,10,43
80,Fail,46,26,3,15,31
80,Fail,49,29,1,15,34
80,Fail,55,19,6,13,42
80,Fail,50,22,3,14,36
80,Fail,43,35,0,11,32
80,Fail,48,17,6,20,28
80,Fail,56,23,0,13,43
80,Fail,49,25,0,14,35
80,Fail,60,20,1,8,52
80,Fail,45,30,0,17,28
80,Fail,49,30,1,11,38
80,Fail,45,23,9,15,30
80,Fail,46,29,0,16,30
80,Fail,51,27,1,14,37
80,Fail,52,29,2,8,44
80,Fail,55,24,0,10,45
80,Fail,46,29,2,14,32
80,Fail,49,22,5,12,37
80,Fail,42,23,4,19,23
80,Fail,47,26,5,11,36
80,Fail,50,23,0,14,36
80,Fail,47,19,3,18,29
80,Fail,53,26,0,9,44
80,Fail,50,21,1,13,37
80,Fail,48,27,0,16,32
80,Fail,46,23,10,15,31
80,Fail,41,33,0,14,27
80,Fail,42,32,0,19,23
80,Fail,52,27,0,13,39
80,Fail,43,32,10,12,31
80,Fail,45,21,5,19,26
80,Fail,48,24,6,12,36
80,Fail,47,23,0,19,28
80,Fail,40,39,0,10,30
80,Fail,49,25,0,16,33
80,Fail,59,21,0,6,53
80,Fail,44,25,0,21,23
80,Fail,49,29,5,9,40
80,Fail,41,41,0,10,31
80,Fail,49,16,0,19,30
80,Fail,43,33,0,11,32
80,Fail,44,33,0,13,31
80,Fail,42,33,4,9,33
80,Fail,42,29,6,14,28
80,Fail,45,27,0,17,28
80,Fail,45,29,0,14,31
80,Fail,41,31,7,12,29
80,Fail,48,29,0,13,35
80,Fail,52,27,0,13,39
80,Fail,51,20,1,14,37
80,Fail,51,22,2,13,38
80,Fail,46,27,1,13,33
80,Fail,50,26,0,10,40
80,Fail,46,24,7,13,33
80,Fail,46,30,0,15,31
80,Fail,41,42,0,10,31
80,Fail,48,27,0,11,37
80,Fail,50,19,1,19,31
80,Fail,44,35,0,13,31
80,Fail,47,22,7,13,34
80,Fail,51,27,0,13,38
80,Fail,46,27,9,11,35
80,Fail,50,27,0,14,36
80,Fail,51,28,2,6,45
80,Fail,50,32,0,7,43
80,Fail,46,27,4,10,36
80,Fail,39,33,0,18,21
80,Fail,46,24,8,13,33
80,Fail,46,32,2,11,35
80,Fail,45,34,0,9,36
80,Fail,41,29,7,16,25
80,Fail,54,26,0,8,46
80,Fail,47,21,2,20,27
80,Fail,46,33,0,10,36
80,Fail,54,22,0,11,43
80,Fail,40,34,0,15,25
80,Fail,50,22,5,11,39
80,Fail,47,33,0,10,37
80,Fail,54,25,1,9,45
80,Fail,52,21,11,9,43
80,Fail,51,21,1,13,38
80,Fail,45,36,0,8,37
80,Fail,50,25,6,9,41
80,Fail,47,25,0,15,32
80,Fail,44,21,9,14,30
80,Fail,50,26,0,13,37
80,Fail,44,29,0,10,34
80,Fail,44,27,9,11,33
80,Fail,46,27,2,14,32
80,Fail,44,30,0,13,31
80,Fail,52,21,6,8,44
80,Fail,48,24,0,18,30
80,Fail,38,27,4,20,18
80,Fail,49,23,0,16,33
80,Fail,50,24,2,10,40
80,Fail,46,33,0,14,32
80,Fail,55,15,2,12,43
80,Fail,45,27,2,9,36
80,Fail,52,22,0,12,40
80,Fail,56,22,0,8,48
80,Fail,49,32,0,8,41
80,Fail,50,23,2,16,34
80,Fail,50,25,2,13,37
80,Fail,47,26,5,15,32
80,Fail,43,19,3,22,21
80,Fail,45,26,0,20,25
80,Fail,53,23,6,10,43
80,Fail,52,25,0,11,41
80,Fail,45,32,0,13,32
80,Fail,46,26,0,19,27
80,Fail,49,27,0,17,32
80,Fail,48,24,1,13,35
80,Fail,45,35,0,15,30
80,Fail,53,26,8,7,46
80,Fail,50,20,5,12,38
80,Fail,58,21,2,13,45
80,Fail,48,30,0,12,36
80,Fail,49,26,0,13,36
80,Fail,51,27,0,10,41
80,Fail,41,38,0,13,28
80,Fail,58,20,0,11,47
80,Fail,47,29,0,14,33
80,Fail,43,30,7,7,36
80,Fail,47,24,7,14,33
80,Fail,48,23,9,10,38
80,Fail,41,29,2,13,28
80,Fail,47,30,0,16,31
80,Fail,48,23,6,11,37
80,Fail,57,23,0,11,46
80,Fail,42,28,5,16,26
80,Fail,42,30,10,12,30
80,Fail,52,21,0,12,40
80,Fail,44,29,4,14,30
80,Fail,54,22,0,10,44
80,Fail,44,33,1,14,30
80,Fail,43,30,0,15,28
80,Fail,47,32,0,11,36
80,Fail,47,26,0,14,33
80,Fail,51,31,0,11,40
80,Fail,47,26,0,18,29
80,Fail,46,26,0,11,35
80,Fail,40,35,0,14,26
80,Fail,51,29,0,9,42
80,Fail,50,23,11,11,39
80,Fail,52,21,0,14,38
80,Fail,47,22,1,16,31
80,Fail,52,19,0,17,35
80,Fail,51,30,0,11,40
80,Fail,48,21,3,17,31
80,Fail,44,23,4,18,26
80,Fail,43,30,2,15,28
80,Fail,50,28,0,11,39
80,Fail,46,28,0,17,29
80,Fail,46,25,0,14,32
80,Fail,43,33,0,15,28
80,Fail,47,28,0,14,33
80,Fail,55,22,0,14,41
80,Fail,50,24,5,13,37
80,Fail,36,29,1,22,14
80,Fail,48,27,5,9,39
80,Fail,52,23,2,10,42
80,Fail,45,35,0,11,34
80,Fail,46,27,1,11,35
80,Fail,51,21,1,15,36
80,Fail,52,23,0,16,36
80,Fail,44,32,1,13,31
80,Fail,54,29,0,8,46
80,Fail,48,24,0,13,35
80,Fail,46,31,0,12,34
80,Fail,53,25,0,10,43
80,Fail,48,28,0,16,32
80,Fail,43,37,0,8,35
80,Fail,46,31,0,10,36
80,Fail,58,24,1,7,51
80,Fail,44,29,0,15,29
80,Fail,47,28,3,14,33
80,Fail,54,21,2,9,45
80,Fail,51,26,0,13,38
80,Fail,52,25,0,12,40
80,Fail,50,32,2,3,47
80,Fail,47,34,0,8,39
80,Fail,53,22,0,14,39
80,Fail,42,31,2,13,29
80,Fail,46,32,3,10,36
80,Fail,44,36,0,12,32
80,Fail,41,36,9,10,31
80,Fail,46,22,0,20,26
80,Fail,52,28,0,12,40
80,Fail,45,31,1,11,34
80,Fail,55,17,1,14,41
80,Fail,49,24,8,10,39
80,Fail,52,25,0,13,39
80,Fail,41,39,0,10,31
80,Fail,49,30,0,13,36
80,Fail,54,23,0,11,43
80,Fail,52,19,3,11,41
80,Fail,49,24,1,13,36
80,Fail,41,40,0,14,27
80,Fail,47,34,0,11,36
80,Fail,50,26,0,11,39
80,Fail,57,21,0,10,47
80,Fail,55,25,3,7,48
80,Fail,47,23,0,20,27
80,Fail,44,29,5,14,30
80,Fail,50,30,1,10,40
80,Fail,52,24,0,11,41
80,Fail,47,23,7,12,35
80,Fail,45,27,0,15,30
80,Fail,51,27,0,12,39
80,Fail,45,27,8,11,34
80,Fail,46,29,3,8,38
80,Fail,40,25,0,22,18
80,Fail,51,28,0,12,39
80,Fail,43,36,0,12,31
80,Fail,50,32,0,10,40
80,Fail,48,26,0,14,34
80,Fail,42,25,5,18,24
80,Fail,51,26,0,11,40
80,Fail,48,26,0,10,38
80,Fail,52,19,1,16,36
80,Fail,58,22,0,10,48
80,Fail,39,27,2,18,21
80,Fail,44,37,0,7,37
80,Fail,51,24,5,9,42
80,Fail,50,28,0,11,39
80,Fail,52,28,2,7,45
80,Fail,52,19,0,15,37
80,Fail,60,18,1,10,50
80,Fail,48,29,0,11,37
80,Fail,42,35,8,9,33
80,Fail,40,24,12,18,22
80,Fail,53,17,6,9,44
80,Fail,56,19,0,12,44
80,Fail,40,32,8,12,28
80,Fail,49,25,0,16,33
80,Fail,50,22,7,13,37
80,Fail,51,23,0,10,41
80,Fail,44,38,0,8,36
80,Fail,46,28,6,11,35
80,Fail,54,19,2,13,41
80,Fail,45,23,3,15,30
80,Fail,50,26,0,13,37
80,Fail,46,28,0,14,32
80,Fail,44,29,5,13,31
80,Fail,47,34,0,12,35
80,Fail,44,25,2,18,26
80,Fail,49,25,0,16,33
80,Fail,45,33,2,16,29
80,Fail,42,40,0,7,35
80,Fail,45,30,1,14,31
80,Fail,47,26,0,15,32
80,Fail,52,24,1,12,40
80,Fail,53,21,2,10,43
80,Fail,45,26,0,13,32
80,Fail,47,28,0,15,32
80,Fail,58,19,8,9,49
80,Fail,53,27,0,11,42
80,Fail,56,18,1,9,47
80,Fail,54,24,0,9,45
80,Fail,40,35,0,16,24
80,Fail,42,36,2,10,32
80,Fail,51,28,0,12,39
80,Fail,46,33,0,10,36
80,Fail,49,25,4,10,39
80,Fail,48,30,4,9,39
80,Fail,50,23,0,12,38
80,Fail,47,30,0,14,33
80,Fail,43,32,0,16,27
80,Fail,47,25,7,14,33
80,Fail,48,27,1,11,37
80,Fail,40,22,8,26,14
80,Fail,53,27,2,7,46
80,Fail,54,22,0,8,46
80,Fail,45,24,0,18,27
80,Fail,50,24,0,12,38
80,Fail,46,35,0,12,34
80,Fail,49,26,0,8,41
80,Fail,52,32,0,9,43
80,Fail,54,19,1,11,43
80,Fail,54,17,0,22,32
80,Fail,48,27,0,15,33
80,Fail,44,27,7,15,29
80,Fail,50,23,0,13,37
80,Fail,56,20,3,12,44
80,Fail,53,23,3,9,44
80,Fail,49,26,0,13,36
80,Fail,42,30,1,12,30
80,Fail,36,33,3,17,19
80,Fail,55,16,2,12,43
80,Fail,52,25,3,8,44
80,Fail,49,26,3,10,39
80,Fail,48,35,0,8,40
80,Fail,47,27,4,12,35
80,Fail,50,29,0,11,39
80,Fail,46,30,0,15,31
80,Fail,41,33,0,20,21
80,Fail,44,29,0,12,32
80,Fail,53,25,0,8,45
80,Fail,57,16,0,15,42
80,Fail,51,30,0,12,39
80,Fail,49,29,0,15,34
80,Fail,54,21,1,7,47
80,Fail,40,32,2,15,25
80,Fail,51,25,0,16,35
80,Fail,54,20,1,9,45
80,Fail,36,43,0,15,21
80,Fail,52,30,1,9,43
80,Fail,45,33,0,11,34
80,Fail,36,38,6,8,28
80,Fail,42,25,7,21,21
80,Fail,57,20,1,11,46
80,Fail,43,26,0,15,28
80,Fail,59,17,0,17,42
80,Fail,50,24,0,13,37
80,Fail,47,24,0,18,29
80,Fail,58,20,3,10,48
80,Fail,50,28,0,12,38
80,Fail,48,28,0,13,35
80,Fail,44,33,0,11,33
80,Fail,51,25,0,12,39
80,Fail,47,30,1,9,38
80,Fail,44,30,6,11,33
80,Fail,46,29,0,14,32
80,Fail,54,22,0,12,42
80,Fail,49,20,11,16,33
80,Fail,45,29,0,15,30
80,Fail,41,31,5,14,27
80,Fail,37,31,7,17,20
80,Fail,54,19,6,10,44
80,Fail,48,34,0,10,38
80,Fail,47,29,0,10,37
80,Fail,44,30,0,17,27
80,Fail,47,34,0,10,37
80,Fail,43,32,0,18,25
80,Fail,47,22,11,12,35
80,Fail,46,33,0,8,38
80,Fail,37,29,10,20,17
80,Fail,54,26,0,7,47
80,Fail,46,31,4,10,36
80,Fail,46,30,0,12,34
80,Fail,42,36,0,13,29
80,Fail,47,24,0,21,26
80,Fail,43,35,0,16,27
80,Fail,51,19,0,17,34
80,Fail,46,23,0,16,30
80,Fail,43,26,0,22,21
80,Fail,48,25,0,17,31
80,Fail,50,27,2,11,39
80,Fail,44,33,0,12,32
80,Fail,49,32,0,9,40
80,Fail,50,26,1,14,36
80,Fail,47,24,9,16,31
80,Fail,54,21,1,13,41
80,Fail,44,35,0,12,32
80,Fail,54,27,0,10,44
80,Fail,55,18,3,11,44
80,Fail,42,33,0,13,29
80,Fail,43,33,6,11,32
80,Fail,45,31,6,7,38
80,Fail,58,16,5,11,47
80,Fail,47,29,2,9,38
80,Fail,50,25,0,16,34
80,Fail,46,32,0,13,33
80,Fail,53,26,0,10,43
80,Fail,44,41,0,7,37
80,Fail,45,22,0,14,31
80,Fail,50,31,0,10,40
80,Fail,44,31,6,9,35
80,Fail,42,32,0,17,25
80,Fail,47,35,1,8,39
80,Fail,46,32,0,11,35
80,Fail,44,30,9,9,35
80,Fail,53,22,0,15,38
80,Fail,51,32,0,6,45
80,Fail,51,29,0,9,42
80,Fail,55,17,0,15,40
80,Fail,55,22,3,6,49
80,Fail,49,27,0,13,36
80,Fail,52,28,0,7,45
80,Fail,38,39,0,15,23
80,Fail,53,21,5,9,44
80,Fail,49,22,6,9,40
80,Fail,46,27,0,15,31
80,Fail,55,18,8,7,48
80,Fail,50,28,0,10,40
80,Fail,48,25,8,11,37
80,Fail,51,26,0,11,40
80,Fail,44,32,2,13,31
80,Fail,47,27,0,16,31
80,Fail,49,30,1,11,38
80,Fail,52,28,7,6,46
80,Fail,48,25,0,19,29
80,Fail,44,33,1,11,33
80,Fail,48,26,5,15,33
80,Fail,45,29,2,16,29
80,Fail,56,25,0,8,48
80,Fail,55,19,0,11,44
80,Fail,44,40,0,12,32
80,Fail,55,24,0,8,47
80,Fail,40,35,0,17,23
80,Fail,43,39,0,13,30
80,Fail,44,40,0,9,35
80,Fail,54,25,0,12,42
80,Fail,51,27,0,9,42
80,Fail,52,19,0,18,34
80,Fail,48,24,0,17,31
80,Fail,45,35,0,9,36
80,Fail,48,29,0,13,35
80,Fail,48,31,7,6,42
80,Fail,43,29,4,15,28
80,Fail,53,23,0,14,39
80,Fail,42,33,0,14,28
80,Fail,45,27,3,14,31
80,Fail,41,25,6,17,24
80,Fail,50,27,0,11,39
80,Fail,49,23,0,14,35
80,Fail,52,29,0,6,46
80,Fail,55,30,0,7,48
80,Fail,46,30,0,9,37
80,Fail,52,23,1,15,37
80,Fail,53,24,2,14,39
80,Fail,49,25,0,16,33
80,Fail,38,30,9,16,22
80,Fail,52,25,0,12,40
80,Fail,44,23,9,16,28
80,Fail,51,31,0,7,44
80,Fail,44,24,0,22,22
80,Fail,41,34,3,13,28
80,Fail,49,35,0,10,39
80,Fail,40,24,7,19,21
80,Fail,49,29,2,5,44
80,Fail,42,28,7,14,28
80,Fail,37,33,0,20,17
80,Fail,57,28,0,8,49
80,Fail,41,30,5,13,28
80,Fail,57,19,1,13,44
80,Fail,47,23,5,13,34
80,Fail,46,30,0,13,33
80,Fail,51,28,1,9,42
80,Fail,48,34,5,8,40
80,Fail,51,20,1,13,38
80,Fail,47,21,3,17,30
80,Fail,49,25,0,11,38
80,Fail,40,34,0,14,26
80,Fail,41,24,6,18,23
80,Fail,46,33,0,13,33
80,Fail,44,25,8,18,26
80,Fail,53,27,0,11,42
80,Fail,47,23,0,18,29
80,Fail,44,18,12,18,26
80,Fail,43,37,0,8,35
80,Fail,50,30,0,10,40
80,Fail,42,31,5,18,24
80,Fail,46,31,0,12,34
80,Fail,50,24,3,11,39
80,Fail,46,26,6,12,34
80,Fail,49,25,4,13,36
80,Fail,54,23,1,11,43
80,Fail,50,22,9,7,43
80,Fail,46,36,0,9,37
80,Fail,49,27,0,11,38
80,Fail,47,27,0,13,34
80,Fail,48,29,0,11,37
80,Fail,48,30,0,11,37
80,Fail,47,28,3,13,34
80,Fail,43,33,0,14,29
80,Fail,49,29,0,10,39
80,Fail,48,25,0,17,31
80,Fail,54,18,0,16,38
80,Fail,54,20,1,15,39
80,Fail,35,31,6,21,14
80,Fail,45,26,7,13,32
80,Fail,54,17,7,10,44
80,Fail,43,30,0,16,27
80,Fail,42,29,7,13,29
80,Fail,47,26,1,16,31
80,Fail,51,25,0,14,37
80,Fail,47,22,0,21,26
80,Fail,52,22,5,10,42
80,Fail,53,21,3,16,37
80,Fail,53,20,0,16,37
80,Fail,46,28,2,11,35
80,Fail,49,21,3,14,35
80,Fail,46,30,0,12,34
80,Fail,39,39,0,14,25
80,Fail,47,24,8,11,36
80,Fail,53,26,2,9,44
80,Fail,46,26,1,13,33
80,Fail,54,27,0,9,45
80,Fail,50,22,5,12,38
80,Fail,47,26,0,18,29
80,Fail,47,33,0,11,36
80,Fail,51,26,0,14,37
80,Fail,40,42,0,8,32
80,Fail,46,31,0,10,36
80,Fail,59,18,0,12,47
80,Fail,48,24,0,16,32
80,Fail,46,27,0,16,30
80,Fail,37,41,0,14,23
80,Fail,47,28,0,16,31
80,Fail,47,33,0,12,35
80,Fail,42,28,8,15,27
80,Fail,53,28,1,6,47
80,Fail,52,24,3,9,43
80,Fail,52,27,6,4,48
80,Fail,41,41,0,9,32
80,Fail,53,13,5,15,38
80,Fail,42,32,0,17,25
80,Fail,50,22,6,14,36
80,Fail,48,22,2,17,31
80,Fail,42,20,6,23,19
80,Fail,53,20,5,10,43
80,Fail,46,33,0,10,36
80,Fail,46,25,4,16,30
80,Fail,55,20,1,12,43
80,Fail,53,12,12,15,38
80,Fail,57,21,0,10,47
80,Fail,50,26,7,6,44
80,Fail,46,23,2,16,30
80,Fail,46,26,0,14,32
80,Fail,39,36,3,12,27
80,Fail,46,25,7,16,30
80,Fail,47,35,0,12,35
80,Fail,50,31,0,11,39
80,Fail,49,23,0,13,36
80,Fail,46,26,0,15,31
80,Fail,52,29,0,10,42
80,Fail,45,40,0,4,41
80,Fail,45,29,0,12,33
80,Fail,47,33,0,9,38
80,Fail,42,30,8,13,29
80,Fail,48,28,0,13,35
80,Fail,51,33,0,5,46
80,Fail,47,26,0,16,31
80,Fail,46,23,6,18,28
80,Fail,49,27,0,9,40
80,Fail,46,27,0,19,27
80,Fail,47,32,0,10,37
80,Fail,49,23,10,8,41
80,Fail,50,19,0,18,32
80,Fail,51,22,9,11,40
80,Fail,50,25,0,16,34
80,Fail,44,36,0,8,36
80,Fail,54,27,0,7,47
80,Fail,52,23,6,9,43
80,Fail,54,27,0,8,46
80,Fail,55,21,0,12,43
80,Fail,46,24,0,19,27
80,Fail,49,23,5,11,38
80,Fail,53,24,3,12,41
80,Fail,46,26,2,15,31
80,Fail,51,26,0,16,35
80,Fail,52,19,2,13,39
80,Fail,51,24,0,11,40
80,Fail,50,22,4,14,36
80,Fail,51,29,3,8,43
80,Fail,55,21,1,10,45
80,Fail,44,26,0,16,28
80,Fail,54,24,0,10,44
80,Fail,48,28,0,10,38
80,Fail,56,22,2,8,48
80,Fail,47,27,4,14,33
80,Fail,54,20,0,16,38
80,Fail,45,27,0,16,29
80,Fail,51,24,0,13,38
80,Fail,53,22,0,12,41
80,Fail,48,22,3,14,34
80,Fail,51,30,0,8,43
80,Fail,48,25,2,13,35
80,Fail,53,18,1,18,35
80,Fail,47,35,0,8,39
80,Fail,49,27,4,10,39
80,Fail,53,30,0,7,46
80,Fail,53,22,0,11,42
80,Fail,48,26,0,9,39
80,Fail,44,29,7,12,32
80,Fail,48,29,0,13,35
80,Fail,42,33,2,15,27
80,Fail,49,28,0,16,33
80,Fail,38,35,0,18,20
80,Fail,54,21,0,12,42
80,Fail,46,31,0,10,36
80,Fail,54,22,0,8,46
80,Fail,43,25,3,17,26
80,Fail,50,28,1,8,42
80,Fail,51,26,0,11,40
80,Fail,48,24,4,12,36
80,Fail,53,17,0,18,35
80,Fail,59,23,0,6,53
80,Fail,50,28,0,12,38
80,Fail,44,28,0,16,28
80,Fail,46,30,1,12,34
80,Fail,47,18,14,12,35
80,Fail,58,14,1,15,43
80,Fail,50,18,1,16,34
80,Fail,48,26,0,15,33
80,Fail,55,23,4,11,44
80,Fail,51,30,0,8,43
80,Fail,42,25,0,24,18
80,Fail,50,30,0,12,38
80,Fail,49,26,1,8,41
80,Fail,53,26,0,11,42
80,Fail,52,24,3,14,38
80,Fail,47,30,0,11,36
80,Fail,47,27,2,13,34
80,Fail,45,32,0,17,28
80,Fail,50,26,0,17,33
80,Fail,50,19,6,17,33
80,Fail,53,19,1,15,38
80,Fail,43,30,0,17,26
80,Fail,49,26,0,14,35
80,Fail,54,22,7,7,47
80,Fail,45,32,0,13,32
80,Fail,52,22,5,8,44
80,Fail,48,19,1,17,31
80,Fail,50,24,4,11,39
80,Fail,48,30,5,7,41
80,Fail,43,35,0,14,29
80,Fail,49,25,0,17,32
80,Fail,46,24,5,14,32
80,Fail,51,32,0,8,43
80,Fail,46,19,2,18,28
80,Fail,54,20,0,13,41
80,Fail,49,28,0,13,36
80,Fail,49,27,0,13,36
80,Fail,40,33,6,9,31
80,Fail,42,33,0,14,28
80,Fail,49,23,7,9,40
80,Fail,49,24,0,12,37
80,Fail,53,29,0,9,44
80,Fail,45,33,0,11,34
80,Fail,46,27,4,11,35
80,Fail,53,23,1,14,39
80,Fail,54,21,0,15,39
80,Fail,51,26,1,14,37
80,Fail,53,22,0,12,41
80,Fail,47,31,0,14,33
80,Fail,52,24,0,13,39
80,Fail,49,29,0,10,39
80,Fail,46,31,0,12,34
80,Fail,48,31,1,12,36
80,Fail,48,33,5,7,41
80,Fail,43,22,0,21,22
80,Fail,43,30,0,18,25
80,Fail,42,33,0,14,28
80,Fail,46,22,6,19,27
80,Fail,49,26,6,11,38
80,Fail,55,27,0,9,46
80,Fail,49,23,0,15,34
80,Fail,50,31,0,8,42
80,Fail,55,29,0,5,50
80,Fail,48,27,14,5,43
80,Fail,43,30,0,9,34
80,Fail,43,34,0,14,29
80,Fail,60,14,0,11,49
80,Fail,49,23,0,14,35
80,Fail,49,26,5,10,39
80,Fail,47,32,0,8,39
80,Fail,53,23,2,13,40
80,Fail,41,34,0,14,27
80,Fail,52,23,3,12,40
80,Fail,49,30,0,15,34
80,Fail,46,30,0,15,31
80,Fail,46,31,0,10,36
80,Fail,47,20,5,18,29
80,Fail,45,29,9,10,35
80,Fail,46,30,0,11,35
80,Fail,51,23,2,13,38
80,Fail,52,27,0,10,42
80,Fail,54,20,2,12,42
80,Fail,51,26,0,16,35
80,Fail,45,23,0,20,25
80,Fail,54,22,0,12,42
80,Fail,48,24,0,19,29
80,Fail,43,35,0,11,32
80,Fail,46,22,7,16,30
80,Fail,49,18,1,19,30
80,Fail,43,37,0,6,37
80,Fail,45,29,5,12,33
80,Fail,44,25,1,19,25
80,Fail,51,26,2,10,41
80,Fail,44,19,14,13,31
80,Fail,45,28,11,12,33
80,Fail,53,26,0,12,41
80,Fail,49,35,0,10,39
80,Fail,51,23,4,13,38
80,Fail,49,21,1,14,35
80,Fail,49,27,0,13,36
80,Fail,47,33,0,7,40
80,Fail,45,26,0,15,30
80,Fail,55,22,0,10,45
80,Fail,43,35,0,12,31
80,Fail,56,21,0,14,42
80,Fail,54,24,4,9,45
80,Fail,48,21,3,18,30
80,Fail,52,16,2,19,33
80,Fail,40,32,5,17,23
80,Fail,52,31,0,6,46
80,Fail,41,23,9,17,24
80,Fail,49,25,0,18,31
80,Fail,44,33,0,15,29
80,Fail,47,26,0,15,32
80,Fail,47,29,4,11,36
80,Fail,47,23,4,14,33
80,Fail,42,28,4,15,27
80,Fail,49,21,0,20,29
80,Fail,45,25,3,20,25
80,Fail,56,17,1,12,44
80,Fail,47,37,0,6,41
80,Fail,48,28,0,10,38
80,Fail,50,23,7,11,39
80,Fail,53,26,0,10,43
80,Fail,52,26,6,7,45
80,Fail,40,26,0,25,15
80,Fail,48,28,1,10,38
80,Fail,45,28,3,14,31
80,Fail,45,28,2,16,29
80,Fail,40,26,12,15,25
80,Fail,48,20,7,15,33
80,Fail,55,19,2,12,43
80,Fail,50,23,0,15,35
80,Fail,54,25,5,9,45
80,Fail,56,19,1,13,43
80,Fail,53,22,3,15,38
80,Fail,52,27,0,10,42
80,Fail,41,34,0,16,25
80,Fail,44,26,5,12,32
80,Fail,50,24,0,15,35
80,Fail,50,19,7,15,35
80,Fail,44,27,0,19,25
80,Fail,53,29,0,5,48
80,Fail,53,21,0,17,36
80,Fail,43,31,0,18,25
80,Fail,47,26,0,13,34
80,Fail,48,31,0,11,37
80,Fail,56,27,0,8,48
80,Fail,50,26,2,10,40
80,Fail,49,29,5,9,40
80,Fail,46,25,4,16,30
80,Fail,45,28,9,12,33
80,Fail,43,35,2,11,32
80,Fail,48,25,3,13,35
80,Fail,46,28,6,12,34
80,Fail,50,26,0,19,31
80,Fail,46,29,1,16,30
80,Fail,46,31,5,8,38
80,Fail,48,27,0,14,34
80,Fail,57,27,0,6,51
80,Fail,52,21,0,16,36
80,Fail,44,27,4,15,29
80,Fail,44,22,7,16,28
80,Fail,47,26,0,15,32
80,Fail,47,27,0,8,39
80,Fail,41,31,0,13,28
80,Fail,45,25,9,15,30
80,Fail,51,22,6,12,39
80,Fail,47,33,0,11,36
80,Fail,48,31,0,13,35
80,Fail,43,28,0,18,25
80,Fail,47,31,0,12,35
80,Fail,50,33,0,11,39
80,Fail,51,26,0,13,38
80,Fail,48,30,0,10,38
80,Fail,48,32,0,11,37
80,Fail,45,34,0,12,33
80,Fail,52,26,0,14,38
80,Fail,44,34,0,16,28
80,Fail,50,24,0,17,33
80,Fail,48,31,0,9,39
80,Fail,42,34,0,12,30
80,Fail,45,32,0,16,29
80,Fail,52,24,0,10,42
80,Fail,45,25,9,16,29
80,Fail,51,31,0,7,44
80,Fail,43,27,10,13,30
80,Fail,51,24,3,13,38
80,Fail,44,35,0,12,32
80,Fail,48,21,4,13,35
80,Fail,50,22,5,8,42
80,Fail,43,25,10,11,32
80,Fail,45,27,0,12,33
80,Fail,53,21,0,10,43
80,Fail,48,27,0,14,34
80,Fail,54,26,0,14,40
80,Fail,46,35,0,16,30
80,Fail,42,38,2,10,32
80,Fail,47,31,0,12,35
80,Fail,45,28,4,12,33
80,Fail,55,22,0,13,42
80,Fail,49,30,1,9,40
80,Fail,42,28,0,19,23
80,Fail,60,24,0,7,53
80,Fail,51,25,3,12,39
80,Fail,43,28,0,16,27
80,Fail,42,26,6,14,28
80,Fail,47,31,0,13,34
80,Fail,55,19,2,9,46
80,Fail,53,24,0,13,40
80,Fail,46,28,0,19,27
80,Fail,49,28,0,12,37
80,Fail,53,27,5,8,45
80,Fail,43,26,6,15,28
80,Fail,50,25,2,12,38
80,Fail,44,31,7,10,34
80,Fail,53,23,4,12,41
80,Fail,44,28,0,13,31
80,Fail,50,21,0,18,32
80,Fail,44,27,1,15,29
80,Fail,42,34,3,12,30
80,Fail,49,25,0,13,36
80,Fail,53,20,1,14,39
80,Fail,49,27,8,10,39
80,Fail,50,22,0,10,40
80,Fail,53,28,2,6,47
80,Fail,50,25,0,11,39
80,Fail,48,25,1,13,35
80,Fail,46,32,0,15,31
80,Fail,42,38,0,14,28
80,Fail,52,27,0,9,43
80,Fail,46,28,6,11,35
80,Fail,54,20,2,10,44
80,Fail,53,24,3,9,44
80,Fail,52,26,1,7,45
80,Fail,49,32,0,7,42
80,Fail,43,34,0,14,29
80,Fail,46,23,6,13,33
80,Fail,49,30,0,8,41
80,Fail,49,30,0,9,40
80,Fail,43,28,3,16,27
80,Fail,49,24,3,14,35
80,Fail,50,25,4,13,37
80,Fail,41,32,0,16,25
80,Fail,41,33,0,17,24
80,Fail,42,31,0,17,25
80,Fail,43,31,8,11,32
80,Fail,42,32,0,16,26
80,Fail,49,24,4,12,37
80,Fail,45,34,0,14,31
80,Fail,50,22,4,15,35
80,Fail,50,29,0,11,39
80,Fail,52,24,1,11,41
80,Fail,48,19,2,17,31
80,Fail,50,27,0,13,37
80,Fail,51,28,0,11,40
80,Fail,47,32,0,15,32
80,Fail,49,24,0,14,35
80,Fail,47,32,0,11,36
80,Fail,52,25,4,9,43
80,Fail,41,29,0,15,26
80,Fail,45,21,10,12,33
80,Fail,56,22,3,8,48
80,Fail,41,23,11,16,25
80,Fail,47,22,1,19,28
80,Fail,46,27,0,12,34
80,Fail,49,29,0,8,41
80,Fail,53,22,0,15,38
80,Fail,43,30,10,9,34
80,Fail,55,17,5,10,45
80,Fail,50,34,0,12,38
80,Fail,49,24,5,11,38
80,Fail,52,26,0,9,43
80,Fail,44,31,0,18,26
80,Fail,51,23,1,9,42
80,Fail,51,25,0,10,41
80,Fail,49,18,1,16,33
80,Fail,52,23,0,15,37
80,Fail,56,16,5,11,45
80,Fail,58,23,0,10,48
80,Fail,53,26,0,9,44
80,Fail,53,26,0,9,44
80,Fail,53,24,0,10,43
80,Fail,43,35,0,13,30
80,Fail,50,31,0,10,40
80,Fail,40,29,9,14,26
80,Fail,50,18,0,19,31
80,Fail,54,19,0,15,39
80,Fail,55,26,3,8,47
80,Fail,47,34,0,12,35
80,Fail,42,28,1,18,24
80,Fail,41,33,0,14,27
80,Fail,50,30,0,10,40
80,Fail,46,32,3,11,35
80,Fail,49,28,5,9,40
80,Fail,46,29,0,15,31
80,Fail,43,27,0,21,22
80,Fail,49,36,0,9,40
80,Fail,48,27,0,13,35
80,Fail,44,26,0,18,26
80,Fail,52,26,0,11,41
80,Fail,47,24,12,9,38
80,Fail,41,38,0,12,29
80,Fail,46,20,8,14,32
80,Fail,50,26,0,12,38
80,Fail,44,24,5,16,28
80,Fail,50,26,0,12,38
80,Fail,48,25,0,16,32
80,Fail,47,30,0,13,34
80,Fail,46,22,10,15,31
80,Fail,48,27,2,9,39
80,Fail,54,21,0,13,41
80,Fail,48,25,3,13,35
80,Fail,49,21,2,15,34
80,Fail,46,33,0,14,32
80,Fail,51,25,1,11,40
80,Fail,51,24,0,9,42
80,Fail,47,28,2,10,37
80,Fail,46,32,0,15,31
80,Fail,51,24,4,7,44
80,Fail,47,33,0,10,37
80,Fail,53,24,1,11,42
80,Fail,50,33,0,10,40
80,Fail,56,17,0,15,41
80,Fail,46,29,0,11,35
80,Fail,46,29,0,12,34
80,Fail,48,25,0,15,33
80,Fail,49,27,3,11,38
80,Fail,45,35,0,12,33
80,Fail,48,31,0,10,38
80,Fail,55,24,0,11,44
80,Fail,47,27,3,13,34
80,Fail,46,21,4,14,32
80,Fail,44,29,0,16,28
80,Fail,42,35,1,14,28
80,Fail,50,24,0,11,39
80,Fail,50,24,0,13,37
80,Fail,47,30,0,14,33
80,Fail,47,32,0,12,35
80,Fail,47,30,1,14,33
80,Fail,48,31,0,9,39
80,Fail,47,25,0,13,34
80,Fail,52,29,0,14,38
80,Fail,44,37,0,14,30
80,Fail,53,24,0,15,38
80,Fail,47,27,12,9,38
80,Fail,40,31,7,11,29
80,Fail,52,20,0,16,36
80,Fail,51,22,2,10,41
80,Fail,49,26,3,11,38
80,Fail,51,24,0,17,34
80,Fail,50,34,0,6,44
80,Fail,49,27,1,12,37
80,Fail,47,39,0,9,38
80,Fail,51,27,0,10,41
80,Fail,49,25,0,16,33
80,Fail,54,22,1,8,46
80,Fail,40,41,0,15,25
80,Fail,51,20,7,15,36
80,Fail,51,24,0,18,33
80,Fail,51,24,0,13,38
80,Fail,48,31,0,11,37
80,Fail,46,24,3,14,32
80,Fail,45,17,3,21,24
80,Fail,45,32,0,14,31
80,Fail,55,26,0,6,49
80,Fail,44,36,0,14,30
80,Fail,52,23,0,12,40
80,Fail,45,26,0,17,28
80,Fail,58,20,0,7,51
80,Fail,56,30,0,5,51
80,Fail,54,27,0,10,44
80,Fail,42,30,0,14,28
80,Fail,50,25,0,11,39
80,Fail,51,23,2,13,38
80,Fail,51,21,0,16,35
80,Fail,53,26,0,11,42
80,Fail,50,22,6,16,34
80,Fail,47,31,1,9,38
80,Fail,42,34,0,13,29
80,Fail,47,29,3,9,38
80,Fail,57,23,0,9,48
80,Fail,47,34,0,9,38
80,Fail,45,27,2,12,33
80,Fail,50,24,4,13,37
80,Fail,48,29,6,9,39
80,Fail,46,26,0,16,30
80,Fail,42,25,10,12,30
80,Fail,50,23,0,10,40
80,Fail,50,24,5,13,37
80,Fail,53,30,0,12,41
80,Fail,52,26,0,10,42
80,Fail,44,33,0,12,32
80,Fail,45,28,1,14,31
80,Fail,46,28,1,10,36
80,Fail,57,25,0,8,49
80,Fail,52,25,2,8,44
80,Fail,50,25,4,10,40
80,Fail,43,36,0,10,33
80,Fail,51,21,7,14,37
80,Fail,52,21,4,11,41
80,Fail,43,36,0,18,25
80,Fail,53,26,0,10,43
80,Fail,52,18,2,12,40
80,Fail,44,30,5,12,32
80,Fail,46,24,5,14,32
80,Fail,45,23,4,18,27
80,Fail,51,22,4,13,38
80,Fail,46,25,1,14,32
80,Fail,40,35,0,13,27
80,Fail,41,33,1,15,26
80,Fail,52,18,2,14,38
80,Fail,43,39,0,9,34
80,Fail,49,22,4,13,36
80,Fail,44,33,0,17,27
80,Fail,54,23,2,9,45
80,Fail,51,28,0,12,39
80,Fail,44,22,6,20,24
80,Fail,53,26,0,13,40
80,Fail,46,31,0,11,35
80,Fail,41,29,4,16,25
80,Fail,37,24,10,19,18
80,Fail,51,25,1,8,43
80,Fail,56,22,0,8,48
80,Fail,48,25,4,13,35
80,Fail,48,33,0,11,37
80,Fail,52,25,1,11,41
80,Fail,45,29,3,11,34
80,Fail,51,18,4,15,36
80,Fail,49,23,2,14,35
80,Fail,53,23,0,12,41
80,Fail,48,23,4,14,34
80,Fail,51,24,0,12,39
80,Fail,50,26,2,12,38
80,Fail,47,32,0,14,33
80,Fail,45,26,13,11,34
80,Fail,44,28,4,14,30
80,Fail,52,27,0,7,45
80,Fail,44,27,5,15,29
80,Fail,49,17,2,22,27
80,Fail,49,20,1,17,32
80,Fail,53,25,0,10,43
80,Fail,47,38,3,6,41
80,Fail,48,33,0,10,38
80,Fail,53,24,1,10,43
80,Fail,53,25,0,12,41
80,Fail,51,25,0,13,38
80,Fail,46,34,0,16,30
80,Fail,46,23,3,15,31
80,Fail,49,26,0,14,35
80,Fail,52,25,0,9,43
80,Fail,42,25,10,12,30
80,Fail,42,31,5,12,30
80,Fail,44,35,0,12,32
80,Fail,45,27,6,13,32
80,Fail,47,30,0,11,36
80,Fail,44,28,2,12,32
80,Fail,52,19,0,16,36
80,Fail,46,34,0,6,40
80,Fail,48,35,0,4,44
80,Fail,49,28,0,12,37
80,Fail,46,35,0,8,38
80,Fail,44,29,0,13,31
80,Fail,42,36,0,14,28
80,Fail,41,20,10,18,23
80,Fail,42,29,4,16,26
80,Fail,50,22,1,10,40
80,Fail,45,28,0,17,28
80,Fail,43,34,0,9,34
80,Fail,47,38,0,9,38
80,Fail,62,18,0,8,54
80,Fail,50,31,0,14,36
80,Fail,48,25,1,18,30
80,Fail,45,31,0,13,32
80,Fail,40,26,0,25,15
80,Fail,51,17,0,15,36
80,Fail,47,29,0,14,33
80,Fail,40,30,8,14,26
80,Fail,49,24,1,16,33
80,Fail,48,19,0,20,28
80,Fail,44,27,5,13,31
80,Fail,45,33,0,17,28
80,Fail,45,30,1,7,38
80,Fail,50,32,0,8,42
80,Fail,48,29,0,14,34
80,Fail,50,31,0,10,40
80,Fail,43,30,0,14,29
80,Fail,48,35,0,8,40
80,Fail,48,25,0,15,33
80,Fail,40,38,0,13,27
80,Fail,45,26,1,14,31
80,Fail,52,25,0,16,36
80,Fail,45,26,7,13,32
80,Fail,49,29,0,9,40
80,Fail,54,30,1,7,47
80,Fail,45,26,0,16,29
80,Fail,52,24,1,13,39
80,Fail,53,26,0,8,45
80,Fail,55,22,1,10,45
80,Fail,44,38,0,12,32
80,Fail,53,15,9,10,43
80,Fail,47,35,0,6,41
80,Fail,50,20,3,19,31
80,Fail,48,27,0,13,35
80,Fail,44,30,2,17,27
80,Fail,51,23,0,16,35
80,Fail,48,26,6,12,36
80,Fail,46,27,0,16,30
80,Fail,53,18,5,11,42
80,Fail,50,23,0,12,38
80,Fail,49,30,0,11,38
80,Fail,53,18,3,15,38
80,Fail,40,27,2,19,21
80,Fail,42,38,0,13,29
80,Fail,48,36,0,8,40
80,Fail,49,27,0,9,40
80,Fail,52,27,2,9,43
80,Fail,46,35,0,11,35
80,Fail,45,28,6,11,34
80,Fail,50,25,0,13,37
80,Fail,48,32,2,11,37
80,Fail,44,33,0,13,31
80,Fail,45,29,4,14,31
80,Fail,48,27,10,11,37
80,Fail,53,22,0,13,40
80,Fail,46,34,1,10,36
80,Fail,49,28,1,9,40
80,Fail,44,25,4,13,31
80,Fail,46,30,0,14,32
80,Fail,51,24,0,15,36
80,Fail,53,26,0,13,40
80,Fail,45,32,0,16,29
80,Fail,43,25,8,15,28
80,Fail,48,29,3,11,37
80,Fail,55,17,4,14,41
80,Fail,45,27,6,14,31
80,Fail,49,35,0,7,42
80,Fail,54,21,0,14,40
80,Fail,51,26,0,16,35
80,Fail,45,34,0,12,33
80,Fail,49,18,5,21,28
80,Fail,56,23,0,11,45
80,Fail,49,29,0,11,38
80,Fail,48,25,2,14,34
80,Fail,46,30,0,14,32
80,Fail,42,34,0,13,29
80,Fail,44,27,4,12,32
80,Fail,49,24,6,14,35
80,Fail,51,20,3,13,38
80,Fail,48,28,5,9,39
80,Fail,40,34,1,15,25
80,Fail,50,22,0,16,34
80,Fail,49,24,0,17,32
80,Fail,49,28,2,7,42
80,Fail,52,22,0,16,36
80,Fail,57,19,0,13,44
80,Fail,49,29,0,11,38
80,Fail,51,21,7,14,37
80,Fail,40,29,5,14,26
80,Fail,46,27,0,14,32
80,Fail,45,22,0,17,28
80,Fail,55,26,3,10,45
80,Fail,42,26,5,19,23
80,Fail,43,24,8,11,32
80,Fail,43,36,0,13,30
80,Fail,42,27,5,16,26
80,Fail,50,27,0,12,38
80,Fail,41,18,17,17,24
80,Fail,47,25,4,15,32
80,Fail,43,31,0,16,27
80,Fail,54,22,0,17,37
80,Fail,48,30,0,12,36
80,Fail,50,22,3,14,36
80,Fail,45,26,2,12,33
80,Fail,52,27,0,10,42
80,Fail,48,27,3,12,36
80,Fail,52,22,4,13,39
80,Fail,48,25,0,17,31
80,Fail,43,30,5,13,30
80,Fail,52,24,3,9,43
80,Fail,55,19,1,9,46
80,Fail,57,22,0,10,47
80,Fail,44,35,0,13,31
80,Fail,51,27,0,14,37
80,Fail,43,24,9,17,26
80,Fail,47,27,8,10,37
80,Fail,45,29,0,14,31
80,Fail,43,34,0,14,29
80,Fail,44,31,0,20,24
80,Fail,39,37,0,16,23
80,Fail,51,26,0,14,37
80,Fail,53,28,4,6,47
80,Fail,45,27,3,13,32
80,Fail,50,30,0,10,40
80,Fail,55,25,6,6,49
80,Fail,51,31,0,10,41
80,Fail,51,22,3,12,39
80,Fail,46,25,0,16,30
80,Fail,45,31,2,10,35
80,Fail,35,27,8,21,14
80,Fail,55,19,0,12,43
80,Fail,47,29,0,13,34
80,Fail,44,34,6,8,36
80,Fail,44,31,0,14,30
80,Fail,41,24,6,18,23
80,Fail,48,34,0,11,37
80,Fail,46,26,4,16,30
80,Fail,44,35,0,18,26
80,Fail,42,30,0,20,22
80,Fail,42,28,15,10,32
80,Fail,46,31,0,11,35
80,Fail,55,16,3,14,41
80,Fail,37,39,0,14,23
80,Fail,52,20,4,10,42
80,Fail,44,36,0,11,33
80,Fail,55,26,0,6,49
80,Fail,46,27,0,16,30
80,Fail,49,25,1,15,34
80,Fail,50,18,1,20,30
80,Fail,55,21,8,6,49
80,Fail,42,27,9,14,28
80,Fail,48,33,0,11,37
80,Fail,43,28,1,14,29
80,Fail,48,28,0,15,33
80,Fail,39,38,0,13,26
80,Fail,45,30,3,12,33
80,Fail,35,29,5,19,16
80,Fail,45,21,4,19,26
80,Fail,48,28,6,12,36
80,Fail,51,16,0,19,32
80,Fail,51,23,2,14,37
80,Fail,47,29,3,11,36
80,Fail,49,21,9,14,35
80,Fail,35,41,0,15,20
80,Fail,59,17,8,6,53
80,Fail,52,26,0,10,42
80,Fail,45,28,1,13,32
80,Fail,47,24,0,15,32
80,Fail,59,23,0,6,53
80,Fail,54,24,0,10,44
80,Fail,49,24,3,12,37
80,Fail,44,25,6,17,27
80,Fail,50,22,2,14,36
80,Fail,47,23,4,14,33
80,Fail,50,23,0,16,34
80,Fail,51,28,0,12,39
80,Fail,55,21,0,13,42
80,Fail,44,32,0,16,28
80,Fail,55,20,0,13,42
80,Fail,44,31,0,11,33
80,Fail,53,25,0,14,39
80,Fail,55,19,0,13,42
80,Fail,44,29,0,18,26
80,Fail,48,28,0,14,34
80,Fail,49,32,0,8,41
80,Fail,45,32,0,12,33
80,Fail,46,22,2,14,32
80,Fail,47,23,8,12,35
80,Fail,50,23,0,19,31
80,Fail,37,36,1,17,20
80,Fail,47,24,2,14,33
80,Fail,44,28,0,17,27
80,Fail,47,22,6,13,34
80,Fail,53,25,0,7,46
80,Fail,43,25,7,16,27
80,Fail,55,24,0,14,41
80,Fail,48,29,2,11,37
80,Fail,57,16,0,13,44
80,Fail,53,28,3,10,43
80,Fail,46,32,2,7,39
80,Fail,52,24,0,13,39
80,Fail,51,27,2,12,39
80,Fail,50,27,2,9,41
80,Fail,42,34,0,11,31
80,Fail,51,30,1,8,43
80,Fail,41,37,0,12,29
80,Fail,46,32,0,11,35
80,Fail,54,27,0,12,42
80,Fail,49,33,0,11,38
80,Fail,46,21,3,14,32
80,Fail,44,33,0,12,32
80,Fail,48,30,0,10,38
80,Fail,50,37,0,6,44
80,Fail,43,28,3,19,24
80,Fail,51,20,2,16,35
80,Fail,50,21,0,13,37
80,Fail,55,23,4,8,47
80,Fail,41,31,0,19,22
80,Fail,47,20,3,19,28
80,Fail,51,23,3,13,38
80,Fail,42,29,5,14,28
80,Fail,47,31,0,13,34
80,Fail,47,29,6,9,38
80,Fail,54,26,0,7,47
80,Fail,45,25,1,17,28
80,Fail,43,34,0,13,30
80,Fail,41,28,1,17,24
80,Fail,52,25,4,13,39
80,Fail,53,28,0,9,44
80,Fail,46,26,8,13,33
80,Fail,47,25,5,15,32
80,Fail,46,22,8,15,31
80,Fail,41,30,5,15,26
80,Fail,49,22,5,15,34
80,Fail,41,39,0,13,28
80,Fail,51,28,0,15,36
80,Fail,44,24,7,13,31
80,Fail,42,27,2,19,23
80,Fail,43,35,0,11,32
80,Fail,46,23,6,13,33
80,Fail,42,26,5,19,23
80,Fail,42,20,5,19,23
80,Fail,40,35,0,16,24
80,Fail,54,19,2,14,40
80,Fail,49,25,0,10,39
80,Fail,41,40,0,13,28
80,Fail,45,33,0,9,36
80,Fail,42,33,5,13,29
80,Fail,41,30,3,14,27
80,Fail,42,21,7,21,21
80,Fail,53,26,0,8,45
80,Fail,56,16,4,15,41
80,Fail,47,25,0,17,30
80,Fail,51,23,0,13,38
80,Fail,51,23,1,12,39
80,Fail,53,20,0,15,38
80,Fail,51,31,0,7,44
80,Fail,48,35,0,7,41
80,Fail,49,25,1,10,39
80,Fail,45,28,4,12,33
80,Fail,45,27,6,15,30
80,Fail,50,21,0,19,31
80,Fail,51,20,7,17,34
80,Fail,49,25,0,12,37
80,Fail,55,35,0,6,49
80,Fail,46,24,8,11,35
80,Fail,52,28,0,9,43
80,Fail,52,26,0,7,45
80,Fail,44,30,0,14,30
80,Fail,55,26,0,11,44
80,Fail,53,21,1,12,41
80,Fail,51,24,8,7,44
80,Fail,48,21,3,12,36
80,Fail,43,29,0,16,27
80,Fail,44,39,0,9,35
80,Fail,48,33,0,9,39
80,Fail,55,21,0,14,41
80,Fail,48,30,5,7,41
80,Fail,47,26,6,11,36
80,Fail,51,25,0,12,39
80,Fail,48,26,4,14,34
80,Fail,45,20,2,19,26
80,Fail,44,23,9,17,27
80,Fail,48,26,0,14,34
80,Fail,45,31,2,13,32
80,Fail,45,31,5,13,32
80,Fail,49,25,3,13,36
80,Fail,41,38,0,13,28
80,Fail,47,29,0,12,35
80,Fail,50,29,0,13,37
80,Fail,52,26,4,6,46
80,Fail,44,28,5,13,31
80,Fail,51,29,0,9,42
80,Fail,45,24,5,15,30
80,Fail,51,25,0,13,38
80,Fail,50,23,6,10,40
80,Fail,51,29,0,10,41
80,Fail,36,33,0,20,16
80,Fail,42,31,1,17,25
80,Fail,52,25,0,11,41
80,Fail,40,31,6,19,21
80,Fail,38,37,5,12,26
80,Fail,42,27,10,14,28
80,Fail,42,23,11,15,27
80,Fail,49,17,7,14,35
80,Fail,46,28,6,10,36
80,Fail,45,34,0,11,34
80,Fail,45,32,0,14,31
80,Fail,44,34,0,16,28
80,Fail,50,26,0,12,38
80,Fail,46,31,5,10,36
80,Fail,45,28,8,10,35
80,Fail,56,18,0,11,45
80,Fail,50,23,2,12,38
80,Fail,40,34,12,9,31
80,Fail,49,29,0,15,34
80,Fail,48,26,0,13,35
80,Fail,59,17,0,11,48
80,Fail,42,40,0,10,32
80,Fail,44,28,1,16,28
80,Fail,44,22,5,18,26
80,Fail,52,29,0,9,43
80,Fail,42,24,5,20,22
80,Fail,34,41,0,15,19
80,Fail,45,36,0,9,36
80,Fail,50,26,3,11,39
80,Fail,58,18,2,10,48
80,Fail,51,30,0,11,40
80,Fail,47,23,3,15,32
80,Fail,55,26,0,11,44
80,Fail,48,20,5,15,33
80,Fail,49,32,0,10,39
80,Fail,54,23,0,10,44
80,Fail,38,39,0,13,25
80,Fail,46,30,5,11,35
80,Fail,51,25,1,13,38
80,Fail,51,34,0,7,44
80,Fail,43,36,0,12,31
80,Fail,48,33,0,9,39
80,Fail,49,25,0,13,36
80,Fail,49,32,0,13,36
80,Fail,42,32,0,17,25
80,Fail,50,26,3,11,39
80,Fail,48,30,0,10,38
80,Fail,51,26,0,10,41
80,Fail,49,24,0,16,33
80,Fail,54,25,0,9,45
80,Fail,41,37,0,12,29
80,Fail,38,33,0,20,18
80,Fail,48,25,4,18,30
80,Fail,56,23,0,11,45
80,Fail,42,23,6,16,26
80,Fail,44,33,0,14,30
80,Fail,55,27,0,8,47
80,Fail,43,33,0,12,31
80,Fail,47,26,3,15,32
80,Fail,43,35,0,10,33
80,Fail,47,23,10,14,33
80,Fail,50,26,0,14,36
80,Fail,44,22,5,17,27
80,Fail,54,28,0,7,47
80,Fail,46,25,0,17,29
80,Fail,52,22,0,9,43
80,Fail,56,17,2,12,44
80,Fail,47,19,10,16,31
80,Fail,45,33,0,13,32
80,Fail,51,25,0,10,41
80,Fail,47,30,0,14,33
80,Fail,49,28,0,12,37
80,Fail,44,35,0,10,34
80,Fail,51,28,0,15,36
80,Fail,54,18,2,14,40
80,Fail,49,27,0,10,39
80,Fail,51,22,5,12,39
80,Fail,50,23,0,16,34
80,Fail,54,23,0,15,39
80,Fail,49,26,1,12,37
80,Fail,56,23,0,11,45
80,Fail,44,27,8,10,34
80,Fail,52,21,0,16,36
80,Fail,47,25,8,13,34
80,Fail,54,28,0,8,46
80,Fail,49,30,0,9,40
80,Fail,45,28,5,14,31
80,Fail,52,18,6,15,37
80,Fail,50,22,14,6,44
80,Fail,50,34,3,8,42
80,Fail,48,26,0,15,33
80,Fail,54,25,3,9,45
80,Fail,48,37,0,11,37
80,Fail,48,24,7,8,40
80,Fail,45,32,0,14,31
80,Fail,51,26,0,11,40
80,Fail,48,26,0,15,33
80,Fail,49,25,0,18,31
80,Fail,45,32,0,12,33
80,Fail,47,35,0,5,42
80,Fail,52,24,0,12,40
80,Fail,47,29,0,15,32
80,Fail,53,21,0,10,43
80,Fail,54,22,0,10,44
80,Fail,50,24,0,13,37
80,Fail,52,23,0,13,39
80,Fail,66,12,0,11,55
80,Fail,53,26,7,5,48
80,Fail,45,23,10,14,31
80,Fail,50,28,7,8,42
80,Fail,52,24,0,15,37
80,Fail,53,21,2,16,37
80,Fail,54,24,0,10,44
80,Fail,55,21,3,10,45
80,Fail,52,23,1,13,39
80,Fail,49,25,0,19,30
80,Fail,49,29,2,10,39
80,Fail,44,22,14,12,32
80,Fail,48,29,3,11,37
80,Fail,49,32,0,11,38
80,Fail,48,23,0,16,32
80,Fail,49,21,1,17,32
80,Fail,47,32,4,5,42
80,Fail,52,28,0,12,40
80,Fail,45,27,0,12,33
80,Fail,48,30,0,13,35
80,Fail,49,27,0,16,33
80,Fail,46,24,4,17,29
80,Fail,49,24,0,14,35
80,Fail,51,27,1,9,42
80,Fail,43,23,4,20,23
80,Fail,54,21,0,15,39
80,Fail,47,24,0,17,30
80,Fail,46,33,0,10,36
80,Fail,45,34,0,11,34
80,Fail,45,27,0,18,27
80,Fail,50,20,4,12,38
80,Fail,46,30,0,13,33
80,Fail,52,20,0,19,33
80,Fail,47,31,0,13,34
80,Fail,46,33,0,10,36
80,Fail,45,37,0,10,35
80,Fail,44,25,5,11,33
80,Fail,43,27,2,16,27
80,Fail,58,16,3,13,45
80,Fail,49,31,0,13,36
80,Fail,48,27,4,11,37
80,Fail,47,30,0,8,39
80,Fail,43,30,0,15,28
80,Fail,38,39,0,16,22
80,Fail,47,28,8,10,37
80,Fail,35,28,10,20,15
80,Fail,45,28,0,14,31
80,Fail,43,32,3,11,32
80,Fail,45,21,6,17,28
80,Fail,45,32,5,9,36
80,Fail,48,27,6,10,38
80,Fail,44,25,6,15,29
80,Fail,59,21,0,8,51
80,Fail,45,31,0,15,30
80,Fail,58,27,0,6,52
80,Fail,50,31,0,9,41
80,Fail,42,30,0,17,25
80,Fail,47,22,10,12,35
80,Fail,53,19,1,8,45
80,Fail,51,21,3,13,38
80,Fail,46,25,0,19,27
80,Fail,43,40,0,8,35
80,Fail,39,38,0,15,24
80,Fail,50,22,1,15,35
80,Fail,49,28,1,9,40
80,Fail,55,28,0,5,50
80,Fail,45,32,0,12,33
80,Fail,45,31,0,15,30
80,Fail,55,21,1,11,44
80,Fail,47,29,0,13,34
80,Fail,44,34,0,11,33
80,Fail,48,24,1,13,35
80,Fail,48,29,0,12,36
80,Fail,46,27,0,13,33
80,Fail,52,25,6,8,44
80,Fail,47,20,4,18,29
80,Fail,53,30,0,9,44
80,Fail,56,14,4,16,40
80,Fail,49,20,6,15,34
80,Fail,45,27,8,12,33
80,Fail,52,25,0,11,41
80,Fail,44,29,3,15,29
80,Fail,47,25,0,16,31
80,Fail,49,29,0,11,38
80,Fail,44,39,0,11,33
80,Fail,45,30,0,15,30
80,Fail,48,23,0,15,33
80,Fail,47,24,0,18,29
80,Fail,44,25,0,21,23
80,Fail,49,31,0,10,39
80,Fail,50,31,0,14,36
80,Fail,40,36,0,11,29
80,Fail,56,19,0,12,44
80,Fail,45,33,3,11,34
80,Fail,49,28,0,8,41
80,Fail,47,24,2,20,27
80,Fail,35,33,8,16,19
80,Fail,50,24,7,11,39
80,Fail,43,30,5,10,33
80,Fail,55,17,11,11,44
80,Fail,56,17,2,13,43
80,Fail,59,19,0,12,47
80,Fail,46,26,3,14,32
80,Fail,55,20,5,9,46
80,Fail,50,26,2,11,39
80,Fail,46,26,2,14,32
80,Fail,51,27,4,10,41
80,Fail,46,25,10,15,31
80,Fail,47,23,0,16,31
80,Fail,48,26,0,15,33
80,Fail,43,31,3,14,29
80,Fail,45,31,0,15,30
80,Fail,46,26,4,13,33
80,Fail,44,29,1,12,32
80,Fail,51,20,4,10,41
80,Fail,45,39,0,9,36
80,Fail,47,29,8,11,36
80,Fail,44,29,6,8,36
80,Fail,47,35,0,10,37
80,Fail,41,35,0,12,29
80,Fail,39,38,0,16,23
80,Fail,51,23,0,14,37
80,Fail,56,23,0,9,47
80,Fail,49,27,6,9,40
80,Fail,45,28,1,15,30
80,Fail,47,33,0,11,36
80,Fail,46,27,1,14,32
80,Fail,48,29,0,12,36
80,Fail,44,34,0,11,33
80,Fail,53,23,5,14,39
80,Fail,48,23,0,17,31
80,Fail,47,29,0,15,32
80,Fail,50,25,0,14,36
80,Fail,52,28,0,7,45
80,Fail,41,29,0,20,21
80,Fail,53,23,0,13,40
80,Fail,48,23,4,13,35
80,Fail,44,22,11,13,31
80,Fail,55,27,0,6,49
80,Fail,59,24,0,9,50
80,Fail,42,31,0,12,30
80,Fail,50,24,2,8,42
80,Fail,46,27,8,8,38
80,Fail,45,30,4,9,36
80,Fail,47,29,0,13,34
80,Fail,43,36,0,11,32
80,Fail,49,23,0,14,35
80,Fail,47,26,0,16,31
80,Fail,51,25,1,10,41
80,Fail,58,19,5,10,48
80,Fail,46,32,0,13,33
80,Fail,48,27,0,15,33
80,Fail,38,34,0,13,25
80,Fail,46,31,1,10,36
80,Fail,50,22,3,17,33
80,Fail,42,38,0,11,31
80,Fail,51,29,0,12,39
80,Fail,48,29,1,11,37
80,Fail,55,23,0,12,43
80,Fail,49,21,0,18,31
80,Fail,46,23,4,13,33
80,Fail,53,19,2,11,42
80,Fail,54,25,0,13,41
80,Fail,50,28,0,13,37
80,Fail,49,29,0,14,35
80,Fail,43,28,8,13,30
80,Fail,44,26,0,21,23
80,Fail,51,23,0,14,37
80,Fail,44,34,5,11,33
80,Fail,48,21,8,12,36
80,Fail,54,26,0,10,44
80,Fail,49,26,0,17,32
80,Fail,38,32,0,17,21
80,Fail,56,22,0,10,46
80,Fail,44,29,0,12,32
80,Fail,49,26,0,14,35
80,Fail,46,24,8,9,37
80,Fail,40,31,2,21,19
80,Fail,49,32,0,9,40
80,Fail,40,38,0,15,25
80,Fail,50,18,5,11,39
80,Fail,49,23,2,11,38
80,Fail,52,27,0,10,42
80,Fail,44,24,7,16,28
80,Fail,56,20,0,10,46
80,Fail,48,27,0,11,37
80,Fail,47,25,0,13,34
80,Fail,52,34,0,6,46
80,Fail,44,28,0,13,31
80,Fail,44,38,0,11,33
80,Fail,42,33,0,14,28
80,Fail,48,29,1,10,38
80,Fail,40,37,0,18,22
80,Fail,50,26,0,12,38
80,Fail,50,32,0,9,41
80,Fail,41,27,13,10,31
80,Fail,46,24,9,15,31
80,Fail,49,20,3,18,31
80,Fail,44,33,0,17,27
80,Fail,50,24,2,16,34
80,Fail,52,14,0,18,34
80,Fail,45,36,0,11,34
80,Fail,48,25,0,13,35
80,Fail,51,26,9,6,45
80,Fail,50,22,6,13,37
80,Fail,42,30,0,12,30
80,Fail,48,25,5,11,37
80,Fail,42,28,2,14,28
80,Fail,48,27,3,12,36
80,Fail,51,22,2,16,35
80,Fail,42,22,10,14,28
80,Fail,52,24,0,13,39
80,Fail,55,18,6,11,44
80,Fail,37,37,6,11,26
80,Fail,42,31,9,11,31
80,Fail,45,31,0,11,34
80,Fail,53,21,5,10,43
80,Fail,52,22,5,10,42
80,Fail,51,30,0,11,40
80,Fail,42,29,6,12,30
80,Fail,50,21,8,11,39
80,Fail,59,22,3,5,54
80,Fail,48,26,5,13,35
80,Fail,45,33,0,12,33
80,Fail,57,22,0,7,50
80,Fail,46,31,0,15,31
80,Fail,47,32,0,11,36
80,Fail,51,23,7,8,43
80,Fail,45,31,0,14,31
80,Fail,53,17,2,18,35
80,Fail,46,22,10,16,30
80,Fail,45,26,7,15,30
80,Fail,54,28,0,8,46
80,Fail,46,36,0,11,35
80,Fail,54,24,0,10,44
80,Fail,50,29,0,10,40
80,Fail,47,28,2,12,35
80,Fail,43,28,10,12,31
80,Fail,52,27,0,9,43
80,Fail,49,24,0,18,31
80,Fail,47,29,0,12,35
80,Fail,49,26,0,14,35
80,Fail,43,30,9,12,31
80,Fail,52,26,1,9,43
80,Fail,49,24,6,13,36
80,Fail,45,31,0,15,30
80,Fail,54,33,0,7,47
80,Fail,45,28,1,13,32
80,Fail,44,32,1,12,32
80,Fail,45,34,0,12,33
80,Fail,48,31,0,12,36
80,Fail,44,36,0,10,34
80,Fail,39,31,0,20,19
80,Fail,44,27,1,14,30
80,Fail,49,29,2,9,40
80,Fail,50,20,6,13,37
80,Fail,56,29,0,7,49
80,Fail,49,22,3,15,34
80,Fail,41,25,0,18,23
80,Fail,45,26,5,10,35
80,Fail,52,28,0,10,42
80,Fail,32,29,13,16,16
80,Fail,55,27,0,7,48
80,Fail,49,21,4,12,37
80,Fail,52,29,0,11,41
80,Fail,46,34,0,8,38
80,Fail,50,28,0,15,35
80,Fail,52,23,0,12,40
80,Fail,52,26,0,15,37
80,Fail,53,24,1,13,40
80,Fail,46,35,0,13,33
80,Fail,51,25,0,12,39
80,Fail,51,23,1,13,38
80,Fail,54,26,0,12,42
80,Fail,46,28,2,17,29
80,Fail,52,20,3,13,39
80,Fail,52,25,9,7,45
80,Fail,52,29,0,5,47
80,Fail,52,27,0,11,41
80,Fail,50,23,1,13,37
80,Fail,40,36,0,17,23
80,Fail,48,26,5,10,38
80,Fail,47,27,3,10,37
80,Fail,49,25,1,11,38
80,Fail,45,23,10,15,30
80,Fail,50,34,0,10,40
80,Fail,46,28,0,15,31
80,Fail,45,30,0,14,31
80,Fail,51,34,0,7,44
80,Fail,51,17,6,15,36
80,Fail,44,24,3,16,28
80,Fail,52,20,3,9,43
80,Fail,48,25,2,15,33
80,Fail,49,30,8,5,44
80,Fail,41,27,2,19,22
80,Fail,43,29,0,16,27
80,Fail,44,29,0,17,27
80,Fail,47,28,0,15,32
80,Fail,57,18,3,12,45
80,Fail,48,31,0,10,38
80,Fail,53,22,2,11,42
80,Fail,40,32,5,17,23
80,Fail,49,27,0,12,37
80,Fail,55,18,0,15,40
80,Fail,39,23,0,26,13
80,Fail,52,15,1,19,33
80,Fail,46,25,1,17,29
80,Fail,45,28,4,10,35
80,Fail,45,32,0,11,34
80,Fail,56,18,0,13,43
80,Fail,57,16,3,14,43
80,Fail,41,40,0,10,31
80,Fail,53,22,6,6,47
80,Fail,56,19,2,11,45
80,Fail,45,27,4,14,31
80,Fail,39,26,0,19,20
80,Fail,43,24,9,18,25
80,Fail,51,22,1,16,35
80,Fail,48,31,0,12,36
80,Fail,54,20,6,9,45
80,Fail,39,29,9,11,28
80,Fail,57,16,8,8,49
80,Fail,53,19,3,9,44
80,Fail,51,23,3,11,40
80,Fail,54,22,0,12,42
80,Fail,51,24,0,12,39
80,Fail,47,29,0,17,30
80,Fail,41,29,0,21,20
80,Fail,50,21,1,15,35
80,Fail,42,34,0,13,29
80,Fail,55,14,9,12,43
80,Fail,52,16,11,15,37
80,Fail,52,22,11,6,46
80,Fail,53,23,4,11,42
80,Fail,43,29,6,15,28
80,Fail,55,26,0,7,48
80,Fail,51,16,4,15,36
80,Fail,45,25,10,8,37
80,Fail,47,24,8,12,35
80,Fail,50,29,0,12,38
80,Fail,50,31,0,11,39
80,Fail,43,25,4,15,28
80,Fail,50,29,0,9,41
80,Fail,49,20,5,15,34
80,Fail,46,26,3,17,29
80,Fail,50,30,0,9,41
80,Fail,49,27,0,16,33
80,Fail,47,32,0,10,37
80,Fail,47,22,3,13,34
80,Fail,46,34,0,9,37
80,Fail,54,28,0,6,48
80,Fail,47,27,0,17,30
80,Fail,50,21,0,18,32
80,Fail,44,27,0,19,25
80,Fail,49,25,10,8,41
80,Fail,55,28,0,6,49
80,Fail,46,24,6,18,28
80,Fail,47,30,0,9,38
80,Fail,40,35,0,15,25
80,Fail,50,33,0,8,42
80,Fail,49,28,0,14,35
80,Fail,56,26,0,9,47
80,Fail,53,28,0,6,47
80,Fail,50,20,6,13,37
80,Fail,53,25,0,9,44
80,Fail,54,16,4,14,40
80,Fail,42,25,0,21,21
80,Fail,54,21,1,10,44
80,Fail,42,25,8,14,28
80,Fail,51,28,0,8,43
80,Fail,54,16,5,12,42
80,Fail,54,23,0,13,41
80,Fail,44,32,0,10,34
80,Fail,45,33,0,12,33
80,Fail,47,25,6,13,34
80,Fail,49,37,0,8,41
80,Fail,55,16,0,14,41
80,Fail,55,23,6,7,48
80,Fail,44,27,3,15,29
80,Fail,53,20,2,13,40
80,Fail,44,35,0,11,33
80,Fail,55,24,4,10,45
80,Fail,44,37,0,11,33
80,Fail,44,38,0,7,37
80,Fail,52,23,0,12,40
80,Fail,43,23,5,17,26
80,Fail,50,24,2,11,39
80,Fail,50,24,1,15,35
80,Fail,50,26,2,12,38
80,Fail,38,28,8,18,20
80,Fail,51,31,0,7,44
80,Fail,39,41,0,10,29
80,Fail,52,22,0,13,39
80,Fail,40,40,0,10,30
80,Fail,49,27,1,10,39
80,Fail,42,33,0,14,28
80,Fail,43,39,0,10,33
80,Fail,46,18,4,20,26
80,Fail,44,31,0,12,32
80,Fail,46,33,0,12,34
80,Fail,47,19,10,17,30
80,Fail,50,23,0,18,32
80,Fail,42,27,14,10,32
80,Fail,47,31,0,9,38
80,Fail,47,28,4,10,37
80,Fail,47,36,0,9,38
80,Fail,45,26,4,17,28
80,Fail,43,24,9,16,27
80,Fail,50,26,0,13,37
80,Fail,50,28,0,14,36
80,Fail,55,22,3,10,45
80,Fail,44,36,0,9,35
80,Fail,46,29,2,12,34
80,Fail,51,32,0,9,42
80,Fail,51,23,0,15,36
80,Fail,49,32,0,7,42
80,Fail,52,25,4,12,40
80,Fail,53,24,0,10,43
80,Fail,39,33,0,15,24
80,Fail,55,25,0,10,45
80,Fail,45,26,6,12,33
80,Fail,49,26,1,14,35
80,Fail,48,26,0,15,33
80,Fail,50,34,0,7,43
80,Fail,57,21,5,8,49
80,Fail,53,20,4,12,41
80,Fail,50,22,2,15,35
80,Fail,50,26,0,12,38
80,Fail,41,28,7,11,30
80,Fail,46,24,1,17,29
80,Fail,42,30,8,11,31
80,Fail,52,21,0,15,37
80,Fail,39,35,6,10,29
80,Fail,44,26,9,10,34
80,Fail,47,27,0,15,32
80,Fail,48,22,6,15,33
80,Fail,43,34,0,16,27
80,Fail,54,20,5,11,43
80,Fail,43,30,0,17,26
80,Fail,42,33,0,19,23
80,Fail,44,29,0,17,27
80,Fail,60,17,0,12,48
80,Fail,55,17,3,13,42
80,Fail,57,21,0,11,46
80,Fail,45,25,4,15,30
80,Fail,46,24,1,15,31
80,Fail,54,25,2,9,45
80,Fail,47,21,6,13,34
80,Fail,40,31,0,13,27
80,Fail,47,28,2,13,34
80,Fail,43,29,4,17,26
80,Fail,42,35,0,12,30
80,Fail,56,24,0,8,48
80,Fail,45,27,10,12,33
80,Fail,45,26,0,16,29
80,Fail,46,27,3,13,33
80,Fail,54,16,6,14,40
80,Fail,59,21,3,10,49
80,Fail,53,27,0,5,48
80,Fail,48,31,0,13,35
80,Fail,55,25,0,9,46
80,Fail,54,27,4,7,47
80,Fail,52,25,0,11,41
80,Fail,44,37,0,11,33
80,Fail,45,28,0,16,29
80,Fail,57,20,0,10,47
80,Fail,52,30,0,7,45
80,Fail,52,21,1,13,39
80,Fail,46,27,3,11,35
80,Fail,46,29,1,11,35
80,Fail,41,25,11,14,27
80,Fail,45,27,3,14,31
80,Fail,43,26,6,16,27
80,Fail,52,29,2,8,44
80,Fail,52,23,0,10,42
80,Fail,49,24,7,9,40
80,Fail,48,33,5,6,42
80,Fail,50,25,3,12,38
80,Fail,45,29,5,11,34
80,Fail,44,28,0,15,29
80,Fail,52,20,0,16,36
80,Fail,57,23,0,5,52
80,Fail,44,32,2,12,32
80,Fail,50,25,1,16,34
80,Fail,48,27,4,9,39
80,Fail,41,25,6,20,21
80,Fail,47,28,1,15,32
80,Fail,43,30,0,14,29
80,Fail,48,28,0,13,35
80,Fail,41,31,0,17,24
80,Fail,46,31,0,10,36
80,Fail,45,31,0,13,32
80,Fail,43,31,6,8,35
80,Fail,53,23,0,16,37
80,Fail,53,27,1,8,45
80,Fail,40,34,0,16,24
80,Fail,51,22,8,12,39
80,Fail,46,25,1,17,29
80,Fail,54,22,4,14,40
80,Fail,53,24,3,9,44
80,Fail,46,19,4,20,26
80,Fail,56,21,3,8,48
80,Fail,46,27,0,13,33
80,Fail,51,23,3,15,36
80,Fail,45,27,1,16,29
80,Fail,50,22,1,13,37
80,Fail,54,23,0,11,43
80,Fail,61,17,0,13,48
80,Fail,49,27,3,11,38
80,Fail,45,28,0,13,32
80,Fail,46,19,13,14,32
80,Fail,47,28,0,12,35
80,Fail,45,27,0,18,27
80,Fail,50,25,3,12,38
80,Fail,49,17,13,15,34
80,Fail,48,29,0,14,34
80,Fail,56,21,1,9,47
80,Fail,51,27,2,12,39
80,Fail,43,34,0,11,32
80,Fail,42,31,0,15,27
80,Fail,45,25,7,17,28
80,Fail,52,27,0,13,39
80,Fail,46,29,6,11,35
80,Fail,47,38,0,8,39
80,Fail,51,21,5,10,41
80,Fail,46,17,4,19,27
80,Fail,49,23,5,12,37
80,Fail,44,26,0,16,28
80,Fail,48,21,4,16,32
80,Fail,45,25,6,17,28
80,Fail,40,25,9,13,27
80,Fail,52,22,0,16,36
80,Fail,49,23,2,12,37
80,Fail,48,27,6,12,36
80,Fail,50,28,3,10,40
80,Fail,51,23,0,12,39
80,Fail,40,33,0,17,23
80,Fail,48,27,9,10,38
80,Fail,42,32,0,19,23
80,Fail,47,20,0,21,26
80,Fail,59,26,0,9,50
80,Fail,47,31,0,12,35
80,Fail,45,28,1,14,31
80,Fail,52,23,0,13,39
80,Fail,44,21,0,26,18
80,Fail,49,28,0,9,40
80,Fail,49,22,6,12,37
80,Fail,43,34,7,11,32
80,Fail,56,22,8,10,46
80,Fail,48,25,11,6,42
80,Fail,49,20,3,15,34
80,Fail,44,30,0,15,29
80,Fail,53,23,0,10,43
80,Fail,55,24,0,12,43
80,Fail,43,28,3,16,27
80,Fail,43,27,4,14,29
80,Fail,43,35,0,10,33
80,Fail,50,26,3,14,36
80,Fail,44,34,0,15,29
80,Fail,43,29,6,15,28
80,Fail,44,34,0,14,30
80,Fail,38,37,0,17,21
80,Fail,49,28,5,9,40
80,Fail,49,27,1,12,37
80,Fail,42,34,0,15,27
80,Fail,48,30,0,11,37
80,Fail,56,25,0,9,47
80,Fail,48,31,5,6,42
80,Fail,47,31,4,8,39
80,Fail,40,30,5,13,27
80,Fail,48,26,1,12,36
80,Fail,45,29,0,17,28
80,Fail,46,34,0,13,33
80,Fail,47,27,5,14,33
80,Fail,41,38,0,13,28
80,Fail,53,31,0,9,44
80,Fail,50,29,0,15,35
80,Fail,50,23,5,9,41
80,Fail,45,33,0,9,36
80,Fail,53,26,0,10,43
80,Fail,45,25,18,6,39
80,Fail,45,29,0,13,32
80,Fail,50,29,0,12,38
80,Fail,60,15,3,11,49
80,Fail,38,32,8,16,22
80,Fail,48,21,1,17,31
80,Fail,43,27,2,15,28
80,Fail,47,21,1,21,26
80,Fail,42,36,2,10,32
80,Fail,49,27,1,14,35
80,Fail,50,20,5,16,34
80,Fail,47,33,4,10,37
80,Fail,52,27,0,11,41
80,Fail,61,18,0,9,52
80,Fail,43,29,0,16,27
80,Fail,35,35,1,16,19
80,Fail,46,25,1,16,30
80,Fail,55,24,0,8,47
80,Fail,49,21,5,16,33
80,Fail,56,21,1,10,46
80,Fail,58,18,0,12,46
80,Fail,61,17,4,10,51
80,Fail,40,26,9,16,24
80,Fail,47,30,5,12,35
80,Fail,50,27,0,12,38
80,Fail,46,30,1,9,37
80,Fail,56,24,0,8,48
80,Fail,41,39,0,13,28
80,Fail,52,26,0,14,38
80,Fail,51,31,1,9,42
80,Fail,43,25,7,13,30
80,Fail,45,28,7,12,33
80,Fail,54,19,1,12,42
80,Fail,45,27,0,17,28
80,Fail,44,24,7,17,27
80,Fail,46,35,0,9,37
80,Fail,36,37,0,18,18
80,Fail,45,27,0,17,28
80,Fail,53,24,0,12,41
80,Fail,56,26,0,10,46
80,Fail,42,30,0,17,25
80,Fail,51,22,4,10,41
80,Fail,53,22,0,10,43
80,Fail,46,24,9,11,35
80,Fail,46,22,5,17,29
80,Fail,45,31,5,14,31
80,Fail,50,26,0,11,39
80,Fail,49,25,6,11,38
80,Fail,45,27,2,16,29
80,Fail,50,19,4,15,35
80,Fail,53,23,2,11,42
80,Fail,46,33,0,11,35
80,Fail,43,28,0,15,28
80,Fail,42,35,0,12,30
80,Fail,49,30,0,10,39
80,Fail,51,21,2,14,37
80,Fail,48,22,6,15,33
80,Fail,49,24,1,12,37
80,Fail,44,30,2,13,31
80,Fail,50,29,0,12,38
80,Fail,46,39,0,7,39
80,Fail,49,25,0,15,34
80,Fail,50,33,0,11,39
80,Fail,47,31,0,10,37
80,Fail,47,28,0,14,33
80,Fail,46,24,0,19,27
80,Fail,44,29,0,17,27
80,Fail,52,31,0,7,45
80,Fail,45,37,0,12,33
80,Fail,46,27,0,16,30
80,Fail,46,29,0,15,31
80,Fail,43,26,7,17,26
80,Fail,52,22,1,9,43
80,Fail,53,27,0,9,44
80,Fail,49,24,0,16,33
80,Fail,46,32,0,12,34
80,Fail,47,30,1,13,34
80,Fail,44,22,9,15,29
80,Fail,47,25,0,16,31
80,Fail,47,31,0,11,36
80,Fail,46,26,5,12,34
80,Fail,44,25,0,20,24
80,Fail,47,29,0,16,31
80,Fail,46,28,6,11,35
80,Fail,52,24,0,14,38
80,Fail,45,35,0,11,34
80,Fail,44,32,1,11,33
80,Fail,47,30,0,10,37
80,Fail,49,21,2,14,35
80,Fail,42,26,9,15,27
80,Fail,48,26,1,14,34
80,Fail,49,28,0,9,40
80,Fail,50,26,0,13,37
80,Fail,45,22,4,17,28
80,Fail,51,33,0,9,42
80,Fail,49,37,0,8,41
80,Fail,51,28,0,12,39
80,Fail,57,20,0,11,46
80,Fail,57,26,0,2,55
80,Fail,47,36,0,10,37
80,Fail,48,28,0,13,35
80,Fail,53,25,0,11,42
80,Fail,56,16,0,17,39
80,Fail,49,26,13,5,44
80,Fail,50,29,0,8,42
80,Fail,48,20,4,16,32
80,Fail,48,23,7,10,38
80,Fail,60,20,3,7,53
80,Fail,49,25,2,7,42
80,Fail,44,25,8,14,30
80,Fail,44,31,3,14,30
80,Fail,48,22,0,21,27
80,Fail,39,32,0,17,22
80,Fail,51,27,0,10,41
80,Fail,47,28,0,14,33
80,Fail,44,23,9,11,33
80,Fail,46,33,4,7,39
80,Fail,56,24,0,11,45
80,Fail,48,27,0,14,34
80,Fail,49,26,3,9,40
80,Fail,49,28,7,9,40
80,Fail,51,21,4,16,35
80,Fail,44,31,6,9,35
80,Fail,44,23,8,12,32
80,Fail,45,33,3,9,36
80,Fail,35,34,10,17,18
80,Fail,50,32,0,8,42
80,Fail,45,23,3,12,33
80,Fail,46,34,0,12,34
80,Fail,43,29,0,19,24
80,Fail,47,36,0,7,40
80,Fail,45,35,0,9,36
80,Fail,49,22,3,15,34
80,Fail,48,29,0,12,36
80,Fail,52,22,0,13,39
80,Fail,59,18,0,13,46
80,Fail,42,29,4,17,25
80,Fail,49,21,7,16,33
80,Fail,49,29,0,14,35
80,Fail,53,26,0,10,43
80,Fail,44,23,7,17,27
80,Fail,45,32,0,14,31
80,Fail,50,23,7,9,41
80,Fail,48,27,5,11,37
80,Fail,48,27,4,13,35
80,Fail,45,21,3,20,25
80,Fail,46,26,4,15,31
80,Fail,56,15,3,14,42
80,Fail,42,26,8,15,27
80,Fail,50,25,0,13,37
80,Fail,49,23,0,17,32
80,Fail,52,26,7,11,41
80,Fail,55,21,6,10,45
80,Fail,52,28,0,10,42
80,Fail,55,25,0,6,49
80,Fail,46,28,1,16,30
80,Fail,54,25,0,14,40
80,Fail,49,24,3,9,40
80,Fail,52,28,0,12,40
80,Fail,46,35,0,11,35
80,Fail,49,28,4,4,45
80,Fail,58,23,0,9,49
80,Fail,51,32,0,9,42
80,Fail,51,30,0,7,44
80,Fail,58,20,2,10,48
80,Fail,47,30,0,16,31
80,Fail,50,26,0,13,37
80,Fail,52,20,4,14,38
80,Fail,50,26,0,15,35
80,Fail,38,32,0,14,24
80,Fail,45,32,2,10,35
80,Fail,43,30,0,18,25
80,Fail,41,37,0,14,27
80,Fail,39,28,1,21,18
80,Fail,54,22,0,14,40
80,Fail,48,32,0,11,37
80,Fail,42,37,0,12,30
80,Fail,52,18,7,15,37
80,Fail,50,20,7,12,38
80,Fail,43,30,0,16,27
80,Fail,50,21,4,13,37
80,Fail,41,31,0,19,22
80,Fail,48,26,1,10,38
80,Fail,44,24,4,14,30
80,Fail,46,28,0,16,30
80,Fail,55,30,0,5,50
80,Fail,49,28,0,14,35
80,Fail,52,24,0,15,37
80,Fail,54,22,3,10,44
80,Fail,51,24,0,14,37
80,Fail,53,26,1,12,41
80,Fail,40,35,0,14,26
80,Fail,53,21,1,15,38
80,Fail,47,24,6,12,35
80,Fail,44,24,5,17,27
80,Fail,54,20,3,13,41
80,Fail,52,28,0,9,43
80,Fail,46,26,0,12,34
80,Fail,40,31,7,13,27
80,Fail,46,26,4,12,34
80,Fail,42,23,1,20,22
80,Fail,42,34,0,15,27
80,Fail,41,38,0,11,30
80,Fail,50,21,0,14,36
80,Fail,46,31,1,7,39
80,Fail,44,26,0,15,29
80,Fail,51,29,2,7,44
80,Fail,47,36,0,7,40
80,Fail,48,21,2,16,32
80,Fail,55,26,0,7,48
80,Fail,54,19,4,12,42
80,Fail,48,32,0,8,40
80,Fail,48,28,0,14,34
80,Fail,57,19,1,13,44
80,Fail,44,33,0,10,34
80,Fail,48,24,1,10,38
80,Fail,49,31,1,8,41
80,Fail,45,30,0,15,30
80,Fail,52,24,0,14,38
80,Fail,48,30,0,11,37
80,Fail,50,30,0,10,40
80,Fail,41,32,0,17,24
80,Fail,47,28,8,7,40
80,Fail,44,29,0,17,27
80,Fail,52,24,0,14,38
80,Fail,45,25,5,15,30
80,Fail,48,32,0,12,36
80,Fail,49,23,0,12,37
80,Fail,42,33,3,12,30
80,Fail,50,30,0,10,40
80,Fail,43,35,0,12,31
80,Fail,53,28,0,10,43
80,Fail,50,30,5,6,44
80,Fail,49,25,3,12,37
80,Fail,45,31,4,10,35
80,Fail,52,26,5,6,46
80,Fail,51,20,0,18,33
80,Fail,47,35,0,11,36
80,Fail,45,19,8,18,27
80,Fail,56,21,0,11,45
80,Fail,44,36,0,11,33
80,Fail,50,22,5,11,39
80,Fail,55,19,0,9,46
80,Fail,45,34,0,13,32
80,Fail,43,27,1,22,21
80,Fail,47,31,0,14,33
80,Fail,47,26,6,10,37
80,Fail,53,30,0,9,44
80,Fail,34,34,7,19,15
80,Fail,47,29,6,8,39
80,Fail,49,35,0,9,40
80,Fail,56,23,0,8,48
80,Fail,51,26,0,12,39
80,Fail,48,26,6,8,40
80,Fail,54,21,3,11,43
80,Fail,38,32,15,10,28
80,Fail,53,22,0,8,45
80,Fail,48,29,5,6,42
80,Fail,45,33,6,7,38
80,Fail,51,24,0,11,40
80,Fail,45,24,2,11,34
80,Fail,45,25,1,16,29
80,Fail,50,26,5,3,47
80,Fail,54,23,0,9,45
80,Fail,43,39,0,11,32
80,Fail,37,45,0,10,27
80,Fail,50,32,0,8,42
80,Fail,56,23,0,10,46
80,Fail,40,43,0,7,33
80,Fail,45,36,4,8,37
80,Fail,47,19,8,19,28
80,Fail,55,19,12,6,49
80,Fail,51,22,0,15,36
80,Fail,47,32,0,10,37
80,Fail,56,20,3,10,46
80,Fail,47,28,6,11,36
80,Fail,50,20,7,13,37
80,Fail,53,26,0,9,44
80,Fail,46,29,2,11,35
80,Fail,44,30,0,13,31
80,Fail,41,31,7,12,29
80,Fail,44,24,1,18,26
80,Fail,51,18,4,17,34
80,Fail,51,22,2,14,37
80,Fail,44,29,0,15,29
80,Fail,54,24,0,9,45
80,Fail,41,30,11,15,26
80,Fail,46,33,0,11,35
80,Fail,45,38,0,8,37
80,Fail,44,30,9,10,34
80,Fail,40,30,0,19,21
80,Fail,59,21,3,7,52
80,Fail,44,35,0,10,34
80,Fail,45,30,0,19,26
80,Fail,47,24,0,19,28
80,Fail,42,36,0,15,27
80,Fail,46,25,0,13,33
80,Fail,49,30,0,14,35
80,Fail,46,33,4,5,41
80,Fail,41,30,10,11,30
80,Fail,54,23,3,14,40
80,Fail,48,31,0,12,36
80,Fail,43,39,0,9,34
80,Fail,54,22,1,9,45
80,Fail,40,37,0,11,29
80,Fail,49,21,2,13,36
80,Fail,47,32,0,15,32
80,Fail,44,28,2,14,30
80,Fail,50,26,0,13,37
80,Fail,48,22,9,11,37
80,Fail,48,22,5,15,33
80,Fail,54,18,2,15,39
80,Fail,42,29,1,18,24
80,Fail,39,34,7,12,27
80,Fail,39,36,3,17,22
80,Fail,43,35,0,15,28
80,Fail,48,27,1,11,37
80,Fail,46,26,0,15,31
80,Fail,48,23,0,18,30
80,Fail,44,30,1,15,29
80,Fail,49,25,0,16,33
80,Fail,53,20,3,8,45
80,Fail,42,31,0,14,28
80,Fail,54,21,0,9,45
80,Fail,49,24,3,15,34
80,Fail,52,25,0,11,41
80,Fail,51,26,0,11,40
80,Fail,50,27,0,12,38
80,Fail,48,25,1,10,38
80,Fail,45,25,9,15,30
80,Fail,45,34,2,9,36
80,Fail,53,17,5,15,38
80,Fail,53,17,2,13,40
80,Fail,44,25,5,12,32
80,Fail,40,28,11,13,27
80,Fail,48,26,0,13,35
80,Fail,52,28,1,10,42
80,Fail,43,25,2,20,23
80,Fail,49,29,2,9,40
80,Fail,49,27,0,10,39
80,Fail,40,31,0,19,21
80,Fail,56,21,0,14,42
80,Fail,52,27,0,11,41
80,Fail,55,22,2,11,44
80,Fail,53,20,0,12,41
80,Fail,49,38,0,6,43
80,Fail,45,32,2,14,31
80,Fail,42,31,0,15,27
80,Fail,53,21,1,14,39
80,Fail,44,29,0,16,28
80,Fail,50,30,0,9,41
80,Fail,48,23,2,15,33
80,Fail,55,22,3,11,44
80,Fail,53,22,0,11,42
80,Fail,53,27,0,10,43
80,Fail,55,20,3,13,42
80,Fail,38,36,0,16,22
80,Fail,45,30,1,11,34
80,Fail,47,23,1,17,30
80,Fail,41,28,0,20,21
80,Fail,43,27,1,21,22
80,Fail,51,24,3,10,41
80,Fail,46,36,0,12,34
80,Fail,42,28,1,17,25
80,Fail,45,33,1,12,33
80,Fail,52,22,1,12,40
80,Fail,46,22,13,11,35
80,Fail,48,26,0,13,35
80,Fail,44,26,8,12,32
80,Fail,44,33,0,14,30
80,Fail,40,23,10,21,19
80,Fail,46,37,0,9,37
80,Fail,43,28,0,18,25
80,Fail,42,28,10,10,32
80,Fail,58,16,2,11,47
80,Fail,48,29,6,9,39
80,Fail,38,40,0,13,25
80,Fail,52,26,0,10,42
80,Fail,51,30,0,8,43
80,Fail,45,25,10,16,29
80,Fail,55,25,0,13,42
80,Fail,49,22,5,11,38
80,Fail,53,20,5,10,43
80,Fail,47,32,0,11,36
80,Fail,50,22,0,18,32
80,Fail,42,33,0,14,28
80,Fail,48,33,0,8,40
80,Fail,56,20,4,9,47
80,Fail,47,30,0,15,32
80,Fail,43,35,0,13,30
80,Fail,51,24,7,9,42
80,Fail,52,26,0,12,40
80,Fail,45,26,11,11,34
80,Fail,50,19,3,13,37
80,Fail,50,27,0,12,38
80,Fail,49,29,0,10,39
80,Fail,53,31,0,7,46
80,Fail,53,16,4,15,38
80,Fail,51,24,0,14,37
80,Fail,52,23,2,11,41
80,Fail,53,27,1,9,44
80,Fail,46,28,0,14,32
80,Fail,47,25,0,15,32
80,Fail,48,25,6,9,39
80,Fail,41,35,0,16,25
80,Fail,44,29,3,10,34
80,Fail,45,27,0,19,26
80,Fail,43,29,0,15,28
80,Fail,55,30,0,5,50
80,Fail,47,26,0,15,32
80,Fail,47,32,0,16,31
80,Fail,49,28,0,15,34
80,Fail,50,19,8,15,35
80,Fail,45,35,0,14,31
80,Fail,53,22,4,7,46
80,Fail,48,30,0,11,37
80,Fail,47,27,2,13,34
80,Fail,45,36,0,12,33
80,Fail,47,27,9,11,36
80,Fail,53,21,0,11,42
80,Fail,49,16,9,16,33
80,Fail,51,16,3,16,35
80,Fail,50,27,0,10,40
80,Fail,46,29,2,11,35
80,Fail,46,23,8,12,34
80,Fail,50,23,0,14,36
80,Fail,49,23,1,13,36
80,Fail,43,32,0,17,26
80,Fail,40,30,0,15,25
80,Fail,44,36,0,10,34
80,Fail,53,29,2,9,44
80,Fail,50,29,3,11,39
80,Fail,38,32,10,12,26
80,Fail,38,30,0,18,20
80,Fail,50,27,0,12,38
80,Fail,44,24,7,16,28
80,Fail,50,25,0,8,42
80,Fail,49,28,0,12,37
80,Fail,53,24,5,9,44
80,Fail,45,35,0,13,32
80,Fail,44,38,0,8,36
80,Fail,44,33,0,13,31
80,Fail,49,18,0,22,27
80,Fail,47,26,4,15,32
80,Fail,44,41,0,7,37
80,Fail,52,20,0,12,40
80,Fail,57,18,4,8,49
80,Fail,48,26,0,17,31
80,Fail,51,25,0,12,39
80,Fail,43,33,0,18,25
80,Fail,44,38,0,9,35
80,Fail,55,20,4,12,43
80,Fail,44,23,8,16,28
80,Fail,42,30,1,14,28
80,Fail,53,29,0,5,48
80,Fail,51,24,0,15,36
80,Fail,44,36,0,12,32
80,Fail,55,23,1,11,44
80,Fail,54,29,0,10,44
80,Fail,50,33,0,9,41
80,Fail,47,25,4,13,34
80,Fail,45,34,0,15,30
80,Fail,56,23,3,10,46
80,Fail,51,30,0,9,42
80,Fail,47,26,0,17,30
80,Fail,49,22,1,17,32
80,Fail,49,23,0,16,33
80,Fail,53,24,5,8,45
80,Fail,54,19,1,11,43
80,Fail,52,27,0,7,45
80,Fail,49,24,4,13,36
80,Fail,48,39,0,3,45
80,Fail,42,28,8,13,29
80,Fail,46,23,0,18,28
80,Fail,42,23,6,20,22
80,Fail,48,24,6,11,37
80,Fail,47,31,1,12,35
80,Fail,53,24,2,11,42
80,Fail,53,22,4,13,40
80,Fail,42,26,5,14,28
80,Fail,50,28,0,10,40
80,Fail,47,29,1,11,36
80,Fail,50,22,3,13,37
80,Fail,49,34,0,9,40
80,Fail,50,23,0,14,36
80,Fail,47,28,0,12,35
80,Fail,39,36,0,15,24
80,Fail,51,31,1,8,43
80,Fail,43,27,2,16,27
80,Fail,49,29,0,8,41
80,Fail,35,34,7,17,18
80,Fail,47,37,0,9,38
80,Fail,41,32,0,18,23
80,Fail,41,26,3,18,23
80,Fail,45,37,0,7,38
80,Fail,50,26,0,15,35
80,Fail,52,29,0,7,45
80,Fail,45,22,0,18,27
80,Fail,47,27,0,14,33
80,Fail,41,30,0,16,25
80,Fail,45,31,0,12,33
80,Fail,51,29,0,11,40
80,Fail,45,37,0,9,36
80,Fail,44,32,0,12,32
80,Fail,54,18,0,12,42
80,Fail,55,24,0,10,45
80,Fail,48,35,0,11,37
80,Fail,50,24,6,12,38
80,Fail,46,28,0,15,31
80,Fail,50,28,0,11,39
80,Fail,45,26,0,17,28
80,Fail,29,37,13,16,13
80,Fail,53,23,0,12,41
80,Fail,46,29,4,7,39
80,Fail,56,24,1,10,46
80,Fail,51,25,8,7,44
80,Fail,44,34,0,13,31
80,Fail,43,29,7,12,31
80,Fail,46,27,0,16,30
80,Fail,52,20,5,10,42
80,Fail,56,22,0,11,45
80,Fail,45,28,5,15,30
80,Fail,53,26,0,9,44
80,Fail,51,28,0,6,45
80,Fail,48,22,10,14,34
80,Fail,49,32,0,11,38
80,Fail,47,29,0,14,33
80,Fail,49,27,3,10,39
80,Fail,49,20,4,17,32
80,Fail,54,17,3,15,39
80,Fail,44,29,0,17,27
80,Fail,45,28,5,11,34
80,Fail,57,23,0,9,48
80,Fail,52,25,0,11,41
80,Fail,49,23,8,13,36
80,Fail,48,26,1,15,33
80,Fail,43,27,5,15,28
80,Fail,41,30,6,13,28
80,Fail,48,38,0,9,39
80,Fail,49,24,0,15,34
80,Fail,53,21,3,14,39
80,Fail,53,22,0,14,39
80,Fail,46,30,3,12,34
80,Fail,46,29,0,16,30
80,Fail,48,24,5,10,38
80,Fail,46,28,0,15,31
80,Fail,55,17,4,12,43
80,Fail,46,30,3,13,33
80,Fail,50,27,0,11,39
80,Fail,40,29,0,19,21
80,Fail,44,27,4,13,31
80,Fail,42,29,3,13,29
80,Fail,46,30,0,10,36
80,Fail,47,23,5,14,33
80,Fail,47,22,5,13,34
80,Fail,44,27,0,19,25
80,Fail,44,27,8,12,32
80,Fail,47,26,0,18,29
80,Fail,46,34,0,14,32
80,Fail,50,24,2,9,41
80,Fail,45,30,0,13,32
80,Fail,46,28,6,12,34
80,Fail,41,22,12,20,21
80,Fail,52,23,0,11,41
80,Fail,50,21,8,12,38
80,Fail,47,25,0,19,28
80,Fail,49,23,0,17,32
80,Fail,46,28,3,17,29
80,Fail,48,34,0,7,41
80,Fail,44,28,0,14,30
80,Fail,48,16,9,18,30
80,Fail,46,32,0,14,32
80,Fail,48,27,1,11,37
80,Fail,53,20,2,13,40
80,Fail,53,24,6,7,46
80,Fail,46,30,5,9,37
80,Fail,35,50,0,13,22
80,Fail,47,26,3,13,34
80,Fail,52,23,5,12,40
80,Fail,44,25,6,15,29
80,Fail,50,17,9,17,33
80,Fail,49,23,4,12,37
80,Fail,50,22,0,17,33
80,Fail,56,20,4,11,45
80,Fail,53,21,0,12,41
80,Fail,48,33,0,11,37
80,Fail,43,26,1,16,27
80,Fail,54,18,8,8,46
80,Fail,48,22,3,13,35
80,Fail,48,20,6,15,33
80,Fail,54,28,2,8,46
80,Fail,45,29,0,13,32
80,Fail,50,29,0,11,39
80,Fail,45,33,0,17,28
80,Fail,48,28,0,11,37
80,Fail,45,26,0,21,24
80,Fail,52,26,0,13,39
80,Fail,52,26,0,11,41
80,Fail,47,39,0,8,39
80,Fail,46,31,0,13,33
80,Fail,46,31,0,10,36
80,Fail,48,22,0,19,29
80,Fail,57,24,1,10,47
80,Fail,44,30,2,13,31
80,Fail,46,29,0,12,34
80,Fail,43,26,0,16,27
80,Fail,43,32,1,14,29
80,Fail,47,30,0,13,34
80,Fail,47,21,4,16,31
80,Fail,55,23,0,10,45
80,Fail,48,24,3,12,36
80,Fail,46,27,0,17,29
80,Fail,49,34,0,8,41
80,Fail,49,27,0,17,32
80,Fail,47,29,0,10,37
80,Fail,46,28,0,15,31
80,Fail,51,23,0,14,37
80,Fail,48,23,0,16,32
80,Fail,46,22,4,16,30
80,Fail,47,28,1,13,34
80,Fail,45,24,6,13,32
80,Fail,46,25,0,17,29
80,Fail,48,24,5,11,37
80,Fail,45,27,0,16,29
80,Fail,54,21,5,7,47
80,Fail,51,23,1,13,38
80,Fail,50,23,0,15,35
80,Fail,45,30,0,13,32
80,Fail,45,27,0,17,28
80,Fail,54,24,3,10,44
80,Fail,52,25,0,15,37
80,Fail,46,23,2,14,32
80,Fail,53,22,1,11,42
80,Fail,41,34,0,18,23
80,Fail,39,29,9,16,23
80,Fail,49,29,0,8,41
80,Fail,46,23,3,19,27
80,Fail,53,29,0,4,49
80,Fail,46,31,0,15,31
80,Fail,44,25,4,15,29
80,Fail,49,25,2,14,35
80,Fail,53,23,0,15,38
80,Fail,43,20,10,19,24
80,Fail,53,19,0,15,38
80,Fail,51,26,2,13,38
80,Fail,47,36,0,9,38
80,Fail,48,26,0,16,32
80,Fail,41,32,0,14,27
80,Fail,53,27,0,10,43
80,Fail,47,25,0,12,35
80,Fail,48,35,0,10,38
80,Fail,39,27,8,17,22
80,Fail,48,24,1,13,35
80,Fail,51,22,5,18,33
80,Fail,47,27,2,12,35
80,Fail,54,22,5,13,41
80,Fail,52,29,0,9,43
80,Fail,47,26,0,19,28
80,Fail,53,23,0,10,43
80,Fail,44,30,0,12,32
80,Fail,45,24,5,17,28
80,Fail,46,25,9,14,32
80,Fail,44,28,12,7,37
80,Fail,50,26,0,11,39
80,Fail,52,27,0,9,43
80,Fail,47,23,7,10,37
80,Fail,51,23,1,10,41
80,Fail,43,26,8,15,28
80,Fail,53,23,7,8,45
80,Fail,51,25,0,14,37
80,Fail,41,27,3,16,25
80,Fail,50,27,0,15,35
80,Fail,48,21,3,16,32
80,Fail,54,19,0,18,36
80,Fail,57,25,0,7,50
80,Fail,45,34,0,9,36
80,Fail,51,22,1,13,38
80,Fail,48,23,6,16,32
80,Fail,55,19,3,11,44
80,Fail,51,22,0,16,35
80,Fail,51,29,0,11,40
80,Fail,51,30,1,10,41
80,Fail,50,21,2,15,35
80,Fail,46,28,4,11,35
80,Fail,51,27,1,9,42
80,Fail,49,23,5,14,35
80,Fail,46,31,0,15,31
80,Fail,50,18,6,19,31
80,Fail,45,26,0,15,30
80,Fail,47,17,5,17,30
80,Fail,38,34,0,20,18
80,Fail,48,31,0,12,36
80,Fail,46,20,4,19,27
80,Fail,46,21,4,17,29
80,Fail,45,33,0,11,34
80,Fail,47,26,0,13,34
80,Fail,51,30,0,11,40
80,Fail,54,33,0,8,46
80,Fail,45,39,0,6,39
80,Fail,51,30,0,8,43
80,Fail,48,32,0,12,36
80,Fail,44,33,2,12,32
80,Fail,52,20,1,13,39
80,Fail,44,38,0,10,34
80,Fail,52,29,0,9,43
80,Fail,52,22,0,14,38
80,Fail,47,26,0,12,35
80,Fail,44,27,8,14,30
80,Fail,54,17,1,14,40
80,Fail,46,26,3,13,33
80,Fail,43,30,0,15,28
80,Fail,37,36,4,14,23
80,Fail,46,25,5,14,32
80,Fail,52,26,0,9,43
80,Fail,54,17,0,17,37
80,Fail,49,27,0,11,38
80,Fail,52,30,0,7,45
80,Fail,45,28,5,13,32
80,Fail,48,28,0,7,41
80,Fail,51,25,1,11,40
80,Fail,39,33,2,14,25
80,Fail,47,25,0,11,36
80,Fail,44,36,0,7,37
80,Fail,58,15,2,13,45
80,Fail,43,30,6,10,33
80,Fail,45,31,0,17,28
80,Fail,52,23,1,12,40
80,Fail,46,27,0,13,33
80,Fail,58,24,0,11,47
80,Fail,51,33,0,7,44
80,Fail,51,23,0,16,35
80,Fail,46,30,7,10,36
80,Fail,46,36,0,10,36
80,Fail,47,32,0,14,33
80,Fail,55,16,2,12,43
80,Fail,48,29,0,13,35
80,Fail,45,24,3,17,28
80,Fail,49,29,0,10,39
80,Fail,48,24,0,13,35
80,Fail,48,29,0,8,40
80,Fail,54,30,0,8,46
80,Fail,47,23,5,13,34
80,Fail,41,24,2,17,24
80,Fail,47,27,3,12,35
80,Fail,43,30,0,12,31
80,Fail,52,23,0,12,40
80,Fail,46,28,0,13,33
80,Fail,51,25,4,13,38
80,Fail,57,20,1,10,47
80,Fail,48,25,0,13,35
80,Fail,50,30,0,9,41
80,Fail,52,28,3,8,44
80,Fail,51,26,3,13,38
80,Fail,50,29,0,13,37
80,Fail,48,27,2,11,37
80,Fail,55,20,4,11,44
80,Fail,43,36,0,13,30
80,Fail,55,26,6,7,48
80,Fail,53,23,0,10,43
80,Fail,48,22,0,12,36
80,Fail,53,23,0,14,39
80,Fail,39,38,7,12,27
80,Fail,45,37,0,11,34
80,Fail,50,25,0,13,37
80,Fail,49,31,0,12,37
80,Fail,48,27,0,14,34
80,Fail,54,20,0,13,41
80,Fail,44,37,0,9,35
80,Fail,54,25,0,15,39
80,Fail,51,28,0,9,42
80,Fail,49,28,0,10,39
80,Fail,52,26,0,12,40
80,Fail,48,28,0,12,36
80,Fail,44,35,0,9,35
80,Fail,50,23,0,12,38
80,Fail,44,28,0,12,32
80,Fail,47,32,2,12,35
80,Fail,51,24,7,11,40
80,Fail,47,22,14,12,35
80,Fail,50,22,0,16,34
80,Fail,42,30,0,13,29
80,Fail,53,26,0,13,40
80,Fail,47,33,0,11,36
80,Fail,52,20,8,10,42
80,Fail,45,31,0,13,32
80,Fail,53,18,1,15,38
80,Fail,56,21,1,12,44
80,Fail,50,28,0,8,42
80,Fail,44,42,0,9,35
80,Fail,49,25,0,11,38
80,Fail,50,31,0,12,38
80,Fail,54,24,0,9,45
80,Fail,33,48,0,12,21
80,Fail,46,20,1,19,27
80,Fail,48,28,0,10,38
80,Fail,44,29,2,13,31
80,Fail,49,34,0,11,38
80,Fail,50,22,9,12,38
80,Fail,52,24,0,14,38
80,Fail,49,26,0,14,35
80,Fail,48,29,0,12,36
80,Fail,43,30,3,14,29
80,Fail,45,27,0,17,28
80,Fail,44,27,1,17,27
80,Fail,50,22,1,14,36
80,Fail,50,24,0,15,35
80,Fail,52,26,1,11,41
80,Fail,43,37,0,11,32
80,Fail,54,26,0,11,43
80,Fail,47,32,2,14,33
80,Fail,59,23,0,6,53
80,Fail,53,24,0,10,43
80,Fail,52,26,1,13,39
80,Fail,35,38,0,18,17
80,Fail,48,34,0,12,36
80,Fail,45,21,5,12,33
80,Fail,50,30,0,8,42
80,Fail,47,23,0,19,28
80,Fail,39,36,0,14,25
80,Fail,39,29,6,17,22
80,Fail,44,31,0,14,30
80,Fail,44,29,0,14,30
80,Fail,54,21,3,10,44
80,Fail,43,27,4,15,28
80,Fail,49,26,7,8,41
80,Fail,47,29,5,9,38
80,Fail,52,21,2,14,38
80,Fail,55,26,0,8,47
80,Fail,51,24,5,11,40
80,Fail,52,21,1,14,38
80,Fail,47,28,0,15,32
80,Fail,51,20,7,15,36
80,Fail,49,21,7,17,32
80,Fail,38,35,3,14,24
80,Fail,45,27,0,16,29
80,Fail,46,26,4,11,35
80,Fail,56,15,0,15,41
80,Fail,48,21,4,15,33
80,Fail,42,27,7,17,25
80,Fail,51,21,10,12,39
80,Fail,51,19,0,15,36
80,Fail,41,33,0,20,21
80,Fail,55,18,1,14,41
80,Fail,45,24,2,14,31
80,Fail,52,29,0,7,45
80,Fail,50,21,0,17,33
80,Fail,44,31,0,13,31
80,Fail,43,33,3,18,25
80,Fail,41,31,0,19,22
80,Fail,43,27,0,18,25
80,Fail,60,27,0,4,56
80,Fail,36,38,3,13,23
80,Fail,44,32,0,12,32
80,Fail,45,29,4,11,34
80,Fail,51,32,0,8,43
80,Fail,51,32,0,8,43
80,Fail,51,25,0,15,36
80,Fail,46,28,0,16,30
80,Fail,52,22,0,14,38
80,Fail,42,39,0,6,36
80,Fail,47,19,12,13,34
80,Fail,49,31,4,10,39
80,Fail,49,29,0,8,41
80,Fail,39,37,0,13,26
80,Fail,52,29,0,11,41
80,Fail,37,37,4,12,25
80,Fail,46,33,1,9,37
80,Fail,43,31,5,11,32
80,Fail,51,25,5,11,40
80,Fail,36,34,0,24,12
80,Fail,40,37,0,14,26
80,Fail,48,21,10,13,35
80,Fail,49,29,0,14,35
80,Fail,50,25,0,15,35
80,Fail,48,22,1,12,36
80,Fail,53,26,0,7,46
80,Fail,54,28,0,9,45
80,Fail,52,24,5,9,43
80,Fail,57,23,0,8,49
80,Fail,40,37,0,16,24
80,Fail,40,26,7,20,20
80,Fail,54,28,0,9,45
80,Fail,53,24,0,8,45
80,Fail,44,29,2,12,32
80,Fail,45,29,6,11,34
80,Fail,52,22,5,9,43
80,Fail,49,27,0,8,41
80,Fail,53,22,6,9,44
80,Fail,50,22,0,14,36
80,Fail,47,28,1,12,35
80,Fail,50,22,4,9,41
80,Fail,50,19,6,16,34
80,Fail,48,27,0,13,35
80,Fail,52,25,0,15,37
80,Fail,56,26,0,11,45
80,Fail,46,34,0,13,33
80,Fail,52,23,7,10,42
80,Fail,43,27,1,17,26
80,Fail,43,37,0,12,31
80,Fail,41,38,0,12,29
80,Fail,47,26,0,14,33
80,Fail,51,25,0,15,36
80,Fail,47,30,0,14,33
80,Fail,45,29,0,13,32
80,Fail,48,33,0,9,39
80,Fail,48,28,0,14,34
80,Fail,49,22,7,12,37
80,Fail,47,26,4,11,36
80,Fail,52,28,0,7,45
80,Fail,58,24,0,4,54
80,Fail,40,20,10,19,21
80,Fail,52,24,0,15,37
80,Fail,54,22,0,13,41
80,Fail,47,25,3,13,34
80,Fail,51,21,8,13,38
80,Fail,37,33,9,15,22
80,Fail,54,20,3,13,41
80,Fail,55,22,0,10,45
80,Fail,44,26,11,13,31
80,Fail,48,25,0,15,33
80,Fail,45,30,0,13,32
80,Fail,48,28,0,11,37
80,Fail,47,34,0,10,37
80,Fail,40,41,0,15,25
80,Fail,54,24,0,10,44
80,Fail,51,29,0,11,40
80,Fail,48,23,9,10,38
80,Fail,51,25,0,12,39
80,Fail,50,19,0,16,34
80,Fail,50,25,5,12,38
80,Fail,48,32,0,12,36
80,Fail,45,33,0,9,36
80,Fail,50,22,0,16,34
80,Fail,47,22,10,12,35
80,Fail,46,24,14,12,34
80,Fail,45,28,1,13,32
80,Fail,53,25,0,12,41
80,Fail,44,21,6,21,23
80,Fail,53,28,0,7,46
80,Fail,50,27,0,13,37
80,Fail,47,29,3,8,39
80,Fail,48,22,0,16,32
80,Fail,40,29,0,18,22
80,Fail,41,29,0,17,24
80,Fail,56,22,0,9,47
80,Fail,48,27,4,11,37
80,Fail,46,33,0,11,35
80,Fail,45,25,0,18,27
80,Fail,45,27,0,14,31
80,Fail,49,26,0,14,35
80,Fail,46,30,0,15,31
80,Fail,51,27,0,14,37
80,Fail,54,12,3,20,34
80,Fail,48,23,2,15,33
80,Fail,40,27,12,12,28
80,Fail,51,33,0,6,45
80,Fail,48,32,0,8,40
80,Fail,48,29,0,11,37
80,Fail,46,26,0,12,34
80,Fail,47,18,4,20,27
80,Fail,49,29,0,12,37
80,Fail,48,33,0,10,38
80,Fail,52,18,1,15,37
80,Fail,51,29,0,6,45
80,Fail,52,24,3,8,44
80,Fail,48,21,2,15,33
80,Fail,47,30,0,11,36
80,Fail,49,33,0,12,37
80,Fail,44,28,9,11,33
80,Fail,55,23,0,12,43
80,Fail,52,20,8,10,42
80,Fail,53,24,2,10,43
80,Fail,36,41,0,12,24
80,Fail,52,18,4,17,35
80,Fail,44,30,4,15,29
80,Fail,50,30,0,10,40
80,Fail,47,29,1,11,36
80,Fail,52,21,2,11,41
80,Fail,50,28,0,16,34
80,Fail,43,30,0,16,27
80,Fail,42,35,0,10,32
80,Fail,49,25,0,12,37
80,Fail,37,33,10,13,24
80,Fail,47,23,6,15,32
80,Fail,58,22,0,8,50
80,Fail,47,29,2,10,37
80,Fail,51,20,2,13,38
80,Fail,53,26,0,13,40
80,Fail,52,20,0,17,35
80,Fail,46,27,0,17,29
80,Fail,41,31,0,15,26
80,Fail,45,37,0,8,37
80,Fail,49,25,0,9,40
80,Fail,47,22,6,14,33
80,Fail,43,28,0,17,26
80,Fail,52,24,0,16,36
80,Fail,43,27,6,10,33
80,Fail,54,15,6,14,40
80,Fail,56,24,0,7,49
80,Fail,55,25,0,9,46
80,Fail,46,30,0,15,31
80,Fail,50,26,5,7,43
80,Fail,49,27,0,13,36
80,Fail,46,31,0,11,35
80,Fail,49,28,0,11,38
80,Fail,45,23,10,16,29
80,Fail,48,32,4,11,37
80,Fail,47,19,12,14,33
80,Fail,50,31,0,11,39
80,Fail,52,21,9,13,39
80,Fail,46,27,0,15,31
80,Fail,50,21,3,8,42
80,Fail,56,19,1,16,40
80,Fail,46,30,0,10,36
80,Fail,48,26,4,9,39
80,Fail,46,24,8,11,35
80,Fail,58,21,0,11,47
80,Fail,51,27,4,8,43
80,Fail,45,31,0,12,33
80,Fail,42,37,0,10,32
80,Fail,51,23,4,8,43
80,Fail,49,25,2,12,37
80,Fail,45,22,10,16,29
80,Fail,50,17,6,13,37
80,Fail,49,15,13,15,34
80,Fail,47,38,0,7,40
80,Fail,44,34,0,13,31
80,Fail,52,19,0,14,38
80,Fail,41,31,5,12,29
80,Fail,50,24,0,15,35
80,Fail,47,34,0,11,36
80,Fail,49,25,0,13,36
80,Fail,51,26,8,8,43
80,Fail,50,28,4,11,39
80,Fail,59,23,0,11,48
80,Fail,54,12,2,15,39
80,Fail,52,23,0,16,36
80,Fail,45,31,2,13,32
80,Fail,46,27,0,16,30
80,Fail,49,26,0,15,34
80,Fail,47,25,4,10,37
80,Fail,45,31,0,11,34
80,Fail,44,26,1,13,31
80,Fail,47,33,0,7,40
80,Fail,54,21,0,13,41
80,Fail,42,35,0,14,28
80,Fail,54,21,0,12,42
80,Fail,53,21,0,13,40
80,Fail,50,21,2,14,36
80,Fail,43,35,0,14,29
80,Fail,42,27,9,18,24
80,Fail,53,17,12,13,40
80,Fail,50,25,0,16,34
80,Fail,51,33,0,9,42
80,Fail,43,29,15,10,33
80,Fail,45,42,0,6,39
80,Fail,61,16,1,11,50
80,Fail,52,22,10,11,41
80,Fail,39,37,0,15,24
80,Fail,52,23,3,12,40
80,Fail,48,24,0,16,32
80,Fail,48,23,0,15,33
80,Fail,47,30,0,9,38
80,Fail,49,21,10,11,38
80,Fail,50,22,3,13,37
80,Fail,55,24,0,9,46
80,Fail,43,36,0,14,29
80,Fail,43,32,2,10,33
80,Fail,53,19,3,10,43
80,Fail,53,29,0,8,45
80,Fail,48,31,0,10,38
80,Fail,40,27,7,18,22
80,Fail,60,17,0,11,49
80,Fail,55,20,0,14,41
80,Fail,51,31,0,12,39
80,Fail,37,38,0,13,24
80,Fail,43,28,6,15,28
80,Fail,48,24,1,17,31
80,Fail,46,31,0,11,35
80,Fail,52,20,0,16,36
80,Fail,42,38,0,8,34
80,Fail,51,28,0,13,38
80,Fail,43,22,6,18,25
80,Fail,49,24,0,17,32
80,Fail,50,22,0,15,35
80,Fail,48,27,3,10,38
80,Fail,44,32,1,16,28
80,Fail,57,23,1,6,51
80,Fail,49,25,1,12,37
80,Fail,48,30,0,11,37
80,Fail,44,26,5,14,30
80,Fail,48,27,0,10,38
80,Fail,50,21,6,12,38
80,Fail,54,21,3,9,45
80,Fail,56,20,3,11,45
80,Fail,54,19,3,12,42
80,Fail,39,30,7,17,22
80,Fail,51,21,1,13,38
80,Fail,39,32,0,15,24
80,Fail,51,20,0,15,36
80,Fail,41,34,7,11,30
80,Fail,48,27,0,13,35
80,Fail,48,17,6,17,31
80,Fail,47,27,1,13,34
80,Fail,44,31,0,11,33
80,Fail,47,28,6,12,35
80,Fail,47,38,0,9,38
80,Fail,55,29,0,5,50
80,Fail,47,26,0,18,29
80,Fail,45,35,0,10,35
80,Fail,52,27,0,10,42
80,Fail,50,19,0,18,32
80,Fail,50,25,0,16,34
80,Fail,50,25,1,10,40
80,Fail,38,34,3,13,25
80,Fail,49,29,2,9,40
80,Fail,47,28,0,16,31
80,Fail,47,33,0,11,36
80,Fail,51,23,9,9,42
80,Fail,34,40,4,13,21
80,Fail,46,36,0,12,34
80,Fail,51,29,0,13,38
80,Fail,53,23,0,10,43
80,Fail,54,24,0,14,40
80,Fail,47,24,8,12,35
80,Fail,44,26,2,15,29
80,Fail,44,24,9,13,31
80,Fail,44,31,0,15,29
80,Fail,45,25,7,15,30
80,Fail,54,28,0,11,43
80,Fail,51,18,3,12,39
80,Fail,51,29,0,10,41
80,Fail,49,23,5,14,35
80,Fail,53,22,0,12,41
80,Fail,47,24,0,16,31
80,Fail,46,21,6,17,29
80,Fail,44,29,0,18,26
80,Fail,45,26,6,13,32
80,Fail,55,23,0,10,45
80,Fail,41,33,0,15,26
80,Fail,46,32,0,14,32
80,Fail,59,18,3,12,47
80,Fail,52,25,1,9,43
80,Fail,52,26,2,15,37
80,Fail,48,25,0,12,36
80,Fail,48,23,5,16,32
80,Fail,44,27,2,17,27
80,Fail,65,23,0,5,60
80,Fail,45,28,7,14,31
80,Fail,48,21,4,14,34
80,Fail,50,20,4,15,35
80,Fail,43,27,0,14,29
80,Fail,50,25,0,17,33
80,Fail,45,27,0,15,30
80,Fail,50,19,10,11,39
80,Fail,47,28,0,18,29
80,Fail,42,30,4,14,28
80,Fail,49,25,2,14,35
80,Fail,47,28,0,13,34
80,Fail,46,24,2,11,35
80,Fail,60,21,0,11,49
80,Fail,50,29,1,9,41
80,Fail,47,27,1,15,32
80,Fail,51,16,0,21,30
80,Fail,52,22,0,13,39
80,Fail,49,22,11,9,40
80,Fail,50,28,3,11,39
80,Fail,51,20,4,12,39
80,Fail,51,25,3,12,39
80,Fail,45,28,0,14,31
80,Fail,52,18,1,14,38
80,Fail,50,24,0,15,35
80,Fail,53,26,0,12,41
80,Fail,47,25,1,12,35
80,Fail,45,34,0,12,33
80,Fail,57,19,0,14,43
80,Fail,53,19,3,11,42
80,Fail,53,21,3,15,38
80,Fail,41,35,0,11,30
80,Fail,53,29,1,7,46
80,Fail,38,33,8,13,25
80,Fail,51,24,0,10,41
80,Fail,43,29,0,14,29
80,Fail,51,22,4,12,39
80,Fail,51,29,1,8,43
80,Fail,44,29,3,17,27
80,Fail,45,38,0,6,39
80,Fail,56,26,0,8,48
80,Fail,43,41,0,11,32
80,Fail,48,22,5,12,36
80,Fail,53,15,1,17,36
80,Fail,44,35,0,12,32
80,Fail,42,29,0,16,26
80,Fail,48,27,0,15,33
80,Fail,47,32,6,8,39
80,Fail,45,30,0,15,30
80,Fail,38,25,14,15,23
80,Fail,46,35,0,11,35
80,Fail,57,17,0,14,43
80,Fail,46,23,0,16,30
80,Fail,51,30,0,11,40
80,Fail,45,30,8,11,34
80,Fail,59,15,2,8,51
80,Fail,54,22,0,9,45
80,Fail,51,21,4,16,35
80,Fail,50,32,0,9,41
80,Fail,48,28,7,10,38
80,Fail,50,24,0,16,34
80,Fail,47,25,6,13,34
80,Fail,49,28,0,12,37
80,Fail,47,30,2,9,38
80,Fail,43,36,1,6,37
80,Fail,57,16,0,15,42
80,Fail,48,23,0,12,36
80,Fail,52,22,5,8,44
80,Fail,51,24,2,12,39
80,Fail,52,19,0,14,38
80,Fail,52,24,1,11,41
80,Fail,53,21,0,12,41
80,Fail,45,26,2,12,33
80,Fail,49,27,3,13,36
80,Fail,54,18,4,10,44
80,Fail,50,23,0,15,35
80,Fail,48,23,0,16,32
80,Fail,48,27,0,7,41
80,Fail,52,20,4,13,39
80,Fail,58,22,0,8,50
80,Fail,49,30,3,9,40
80,Fail,43,37,0,13,30
80,Fail,43,22,10,13,30
80,Fail,55,19,2,12,43
80,Fail,42,32,0,16,26
80,Fail,58,24,0,8,50
80,Fail,52,25,0,10,42
80,Fail,43,25,0,18,25
80,Fail,48,30,0,8,40
80,Fail,45,30,3,12,33
80,Fail,51,25,0,13,38
80,Fail,46,28,6,12,34
80,Fail,48,26,1,13,35
80,Fail,40,31,0,16,24
80,Fail,41,42,0,12,29
80,Fail,57,27,0,5,52
80,Fail,54,24,0,10,44
80,Fail,45,26,0,17,28
80,Fail,46,22,12,11,35
80,Fail,49,35,0,9,40
80,Fail,50,25,0,13,37
80,Fail,48,26,0,16,32
80,Fail,51,23,0,12,39
80,Fail,47,31,0,12,35
80,Fail,45,33,0,14,31
80,Fail,49,28,0,14,35
80,Fail,43,28,0,18,25
80,Fail,44,34,0,10,34
80,Fail,56,24,0,12,44
80,Fail,50,28,0,11,39
80,Fail,43,33,4,10,33
80,Fail,48,32,1,9,39
80,Fail,50,25,7,10,40
80,Fail,42,31,5,13,29
80,Fail,50,24,5,11,39
80,Fail,45,32,0,9,36
80,Fail,54,21,0,10,44
80,Fail,61,21,0,8,53
80,Fail,45,26,8,14,31
80,Fail,47,27,0,12,35
80,Fail,45,22,8,19,26
80,Fail,44,37,0,12,32
80,Fail,56,20,0,14,42
80,Fail,43,35,0,15,28
80,Fail,53,20,0,13,40
80,Fail,51,18,6,11,40
80,Fail,48,21,11,11,37
80,Fail,49,27,0,15,34
80,Fail,49,29,0,11,38
80,Fail,53,19,0,15,38
80,Fail,50,24,8,10,40
80,Fail,45,29,0,16,29
80,Fail,48,24,4,11,37
80,Fail,43,34,0,14,29
80,Fail,44,31,0,12,32
80,Fail,42,36,0,15,27
80,Fail,48,23,0,17,31
80,Fail,48,33,0,11,37
80,Fail,50,23,4,13,37
80,Fail,48,27,1,14,34
80,Fail,49,23,3,15,34
80,Fail,45,30,0,15,30
80,Fail,48,31,0,10,38
80,Fail,54,28,0,9,45
80,Fail,47,23,5,14,33
80,Fail,50,27,1,14,36
80,Fail,53,19,2,14,39
80,Fail,48,29,0,10,38
80,Fail,57,23,3,9,48
80,Fail,44,31,0,13,31
80,Fail,50,24,0,6,44
80,Fail,43,31,0,13,30
80,Fail,54,27,0,11,43
80,Fail,48,27,0,16,32
80,Fail,47,34,0,10,37
80,Fail,55,18,0,11,44
80,Fail,47,25,2,13,34
80,Fail,49,16,3,20,29
80,Fail,48,35,0,9,39
80,Fail,48,29,1,10,38
80,Fail,35,44,0,11,24
80,Fail,50,24,0,13,37
80,Fail,55,23,0,16,39
80,Fail,52,23,0,13,39
80,Fail,42,30,0,13,29
80,Fail,50,21,11,12,38
80,Fail,45,34,0,16,29
80,Fail,45,31,2,8,37
80,Fail,55,24,2,11,44
80,Fail,56,25,0,8,48
80,Fail,45,24,0,19,26
80,Fail,48,32,0,10,38
80,Fail,44,31,0,13,31
80,Fail,48,31,0,13,35
80,Fail,46,31,0,14,32
80,Fail,47,25,7,11,36
80,Fail,42,34,0,14,28
80,Fail,45,33,0,17,28
80,Fail,55,18,7,17,38
80,Fail,47,23,5,13,34
80,Fail,47,27,1,11,36
80,Fail,52,27,1,11,41
80,Fail,41,23,8,18,23
80,Fail,51,26,0,9,42
80,Fail,53,24,0,13,40
80,Fail,49,31,0,10,39
80,Fail,47,27,0,17,30
80,Fail,46,31,1,12,34
80,Fail,47,22,0,17,30
80,Fail,53,20,0,16,37
80,Fail,53,18,4,19,34
80,Fail,49,33,1,5,44
80,Fail,46,27,0,20,26
80,Fail,55,23,0,9,46
80,Fail,44,32,3,10,34
80,Fail,47,27,2,15,32
80,Fail,49,25,2,13,36
80,Fail,44,28,0,16,28
80,Fail,55,24,0,14,41
80,Fail,48,20,4,12,36
80,Fail,45,27,0,16,29
80,Fail,42,26,1,16,26
80,Fail,43,28,2,15,28
80,Fail,43,26,4,15,28
80,Fail,47,23,0,16,31
80,Fail,41,31,6,9,32
80,Fail,44,23,10,14,30
80,Fail,51,25,0,13,38
80,Fail,46,35,0,10,36
80,Fail,39,30,0,18,21
80,Fail,53,23,1,9,44
80,Fail,49,25,0,15,34
80,Fail,46,37,0,7,39
80,Fail,45,31,0,16,29
80,Fail,55,28,0,8,47
80,Fail,45,30,0,13,32
80,Fail,51,20,0,12,39
80,Fail,48,34,0,9,39
80,Fail,44,29,0,14,30
80,Fail,36,33,4,16,20
80,Fail,48,26,2,11,37
80,Fail,51,21,2,13,38
80,Fail,49,27,0,16,33
80,Fail,45,31,0,17,28
80,Fail,54,20,0,11,43
80,Fail,52,24,0,15,37
80,Fail,45,29,0,15,30
80,Fail,48,16,8,19,29
80,Fail,43,31,0,17,26
80,Fail,57,19,1,11,46
80,Fail,46,29,2,12,34
80,Fail,46,20,0,20,26
80,Fail,40,24,12,17,23
80,Fail,45,23,0,16,29
80,Fail,47,29,0,13,34
80,Fail,47,24,2,14,33
80,Fail,53,23,4,7,46
80,Fail,56,19,0,15,41
80,Fail,46,25,4,12,34
80,Fail,49,25,1,11,38
80,Fail,52,26,0,8,44
80,Fail,47,22,0,18,29
80,Fail,45,31,0,8,37
80,Fail,47,29,0,11,36
80,Fail,39,30,7,15,24
80,Fail,56,20,0,13,43
80,Fail,49,35,0,9,40
80,Fail,40,37,6,10,30
80,Fail,52,18,0,17,35
80,Fail,44,29,0,14,30
80,Fail,52,20,0,15,37
80,Fail,49,26,0,15,34
80,Fail,51,20,2,12,39
80,Fail,53,20,0,17,36
80,Fail,44,30,4,13,31
80,Fail,44,30,6,12,32
80,Fail,48,21,5,15,33
80,Fail,49,26,3,10,39
80,Fail,50,25,0,13,37
80,Fail,44,29,0,14,30
80,Fail,52,23,6,9,43
80,Fail,47,25,0,16,31
80,Fail,46,25,0,15,31
80,Fail,48,24,2,16,32
80,Fail,37,34,10,12,25
80,Fail,53,21,2,10,43
80,Fail,43,33,0,9,34
80,Fail,47,24,8,12,35
80,Fail,61,17,1,10,51
80,Fail,43,35,0,16,27
80,Fail,40,37,0,14,26
80,Fail,45,28,0,15,30
80,Fail,43,31,6,9,34
80,Fail,49,22,4,15,34
80,Fail,53,19,0,16,37
80,Fail,41,36,6,9,32
80,Fail,44,27,6,12,32
80,Fail,44,27,4,14,30
80,Fail,48,24,1,18,30
80,Fail,46,27,0,17,29
80,Fail,46,30,0,10,36
80,Fail,52,25,0,11,41
80,Fail,56,19,2,13,43
80,Fail,49,26,0,11,38
80,Fail,50,33,0,9,41
80,Fail,47,25,1,14,33
80,Fail,48,30,0,9,39
80,Fail,38,35,10,12,26
80,Fail,34,42,0,14,20
80,Fail,46,30,3,12,34
80,Fail,59,19,0,7,52
80,Fail,59,14,0,13,46
80,Fail,51,26,1,8,43
80,Fail,48,23,6,11,37
80,Fail,54,25,0,10,44
80,Fail,49,30,3,9,40
80,Fail,46,22,3,17,29
80,Fail,45,28,0,16,29
80,Fail,46,26,1,17,29
80,Fail,42,28,5,15,27
80,Fail,57,25,0,8,49
80,Fail,57,21,0,10,47
80,Fail,53,26,2,8,45
80,Fail,56,26,0,5,51
80,Fail,50,21,2,8,42
80,Fail,50,19,6,15,35
80,Fail,52,24,3,9,43
80,Fail,51,30,0,9,42
80,Fail,46,29,1,13,33
80,Fail,45,25,1,18,27
80,Fail,48,27,3,8,40
80,Fail,48,28,0,11,37
80,Fail,45,33,0,16,29
80,Fail,51,26,0,10,41
80,Fail,44,18,14,13,31
80,Fail,54,19,0,13,41
80,Fail,44,31,0,14,30
80,Fail,43,35,0,17,26
80,Fail,48,26,3,12,36
80,Fail,46,30,0,12,34
80,Fail,47,28,4,10,37
80,Fail,42,34,0,15,27
80,Fail,37,37,5,13,24
80,Fail,54,22,0,10,44
80,Fail,53,24,0,14,39
80,Fail,38,31,1,18,20
80,Fail,46,29,3,10,36
80,Fail,54,27,1,9,45
80,Fail,50,27,0,12,38
80,Fail,47,24,6,14,33
80,Fail,52,19,6,11,41
80,Fail,48,29,0,13,35
80,Fail,60,15,0,15,45
80,Fail,49,21,7,15,34
80,Fail,43,34,0,13,30
80,Fail,42,27,10,15,27
80,Fail,52,20,2,10,42
80,Fail,52,24,0,10,42
80,Fail,63,18,0,10,53
80,Fail,48,26,7,9,39
80,Fail,43,23,4,20,23
80,Fail,38,39,0,13,25
80,Fail,49,25,0,14,35
80,Fail,43,27,10,8,35
80,Fail,39,34,0,16,23
80,Fail,53,20,0,15,38
80,Fail,49,30,0,12,37
80,Fail,52,23,5,10,42
80,Fail,55,21,6,6,49
80,Fail,53,25,0,13,40
80,Fail,48,26,0,12,36
80,Fail,52,23,0,10,42
80,Fail,57,21,0,7,50
80,Fail,42,29,5,17,25
80,Fail,43,33,1,14,29
80,Fail,52,20,5,14,38
80,Fail,62,19,0,7,55
80,Fail,35,38,0,19,16
80,Fail,52,26,5,8,44
80,Fail,49,26,4,11,38
80,Fail,53,26,0,9,44
80,Fail,54,20,6,11,43
80,Fail,53,22,5,12,41
80,Fail,45,26,6,13,32
80,Fail,56,19,1,10,46
80,Fail,49,28,0,11,38
80,Fail,48,32,0,11,37
80,Fail,48,27,0,11,37
80,Fail,57,24,0,6,51
80,Fail,44,28,8,12,32
80,Fail,48,26,0,16,32
80,Fail,46,29,0,14,32
80,Fail,47,24,0,17,30
80,Fail,52,25,1,12,40
80,Fail,55,23,0,10,45
80,Fail,52,19,1,17,35
80,Fail,40,34,4,14,26
80,Fail,47,31,2,11,36
80,Fail,54,23,6,8,46
80,Fail,42,40,0,14,28
80,Fail,46,24,12,14,32
80,Fail,48,34,0,9,39
80,Fail,44,35,0,12,32
80,Fail,49,24,0,12,37
80,Fail,49,29,0,12,37
80,Fail,51,29,0,10,41
80,Fail,47,25,7,12,35
80,Fail,42,30,2,15,27
80,Fail,33,38,0,22,11
80,Fail,42,25,9,11,31
80,Fail,49,25,2,12,37
80,Fail,49,22,6,12,37
80,Fail,51,19,8,15,36
80,Fail,48,26,3,15,33
80,Fail,45,25,6,12,33
80,Fail,48,27,0,17,31
80,Fail,44,30,4,12,32
80,Fail,45,30,0,12,33
80,Fail,53,21,1,10,43
80,Fail,52,21,3,10,42
80,Fail,55,19,0,12,43
80,Fail,51,25,0,15,36
80,Fail,53,27,0,10,43
80,Fail,52,25,4,11,41
80,Fail,49,23,3,14,35
80,Fail,50,27,0,10,40
80,Fail,45,24,5,14,31
80,Fail,51,28,0,9,42
80,Fail,48,23,8,14,34
80,Fail,52,24,0,11,41
80,Fail,43,25,0,17,26
80,Fail,49,32,2,4,45
80,Fail,59,19,10,6,53
80,Fail,44,23,0,18,26
80,Fail,53,24,0,10,43
80,Fail,45,25,4,18,27
80,Fail,49,25,3,12,37
80,Fail,52,23,2,12,40
80,Fail,40,33,9,12,28
80,Fail,46,32,1,11,35
80,Fail,55,24,0,10,45
80,Fail,36,37,0,17,19
80,Fail,44,23,7,14,30
80,Fail,45,31,0,14,31
80,Fail,51,26,0,14,37
80,Fail,51,27,1,9,42
80,Fail,48,27,0,11,37
80,Fail,50,25,5,11,39
80,Fail,37,38,0,16,21
80,Fail,43,36,0,15,28
80,Fail,48,25,7,15,33
80,Fail,46,29,0,13,33
80,Fail,40,37,0,15,25
80,Fail,43,30,3,14,29
80,Fail,48,37,0,7,41
80,Fail,49,24,0,16,33
80,Fail,39,31,0,17,22
80,Fail,50,30,0,12,38
80,Fail,49,18,7,13,36
80,Fail,43,23,10,11,32
80,Fail,47,29,0,11,36
80,Fail,44,24,2,19,25
80,Fail,39,29,8,15,24
80,Fail,48,22,2,17,31
80,Fail,49,26,0,11,38
80,Fail,49,23,5,11,38
80,Fail,48,28,0,13,35
80,Fail,48,24,5,14,34
80,Fail,54,18,3,16,38
80,Fail,48,22,7,14,34
80,Fail,41,24,10,15,26
80,Fail,44,36,0,12,32
80,Fail,37,30,7,16,21
80,Fail,48,24,4,11,37
80,Fail,35,35,2,16,19
80,Fail,51,23,0,14,37
80,Fail,47,27,0,12,35
80,Fail,48,31,0,13,35
80,Fail,42,38,0,12,30
80,Fail,50,26,0,12,38
80,Fail,55,21,0,11,44
80,Fail,49,29,0,11,38
80,Fail,50,26,0,12,38
80,Fail,48,23,7,13,35
80,Fail,46,32,0,11,35
80,Fail,49,34,0,6,43
80,Fail,51,23,0,13,38
80,Fail,42,31,0,16,26
80,Fail,39,37,0,14,25
80,Fail,51,24,3,12,39
80,Fail,46,25,0,11,35
80,Fail,48,26,3,12,36
80,Fail,44,25,3,16,28
80,Fail,45,34,1,11,34
80,Fail,42,30,5,12,30
80,Fail,47,21,0,17,30
80,Fail,47,25,0,14,33
80,Fail,52,27,0,15,37
80,Fail,42,28,9,14,28
80,Fail,51,21,6,10,41
80,Fail,49,30,0,10,39
80,Fail,53,22,2,14,39
80,Fail,55,16,4,15,40
80,Fail,51,26,0,7,44
80,Fail,47,29,1,10,37
80,Fail,45,27,6,15,30
80,Fail,45,28,9,10,35
80,Fail,51,25,0,11,40
80,Fail,49,30,0,13,36
80,Fail,47,29,0,14,33
80,Fail,46,25,0,15,31
80,Fail,54,20,1,13,41
80,Fail,43,33,3,14,29
80,Fail,42,34,0,12,30
80,Fail,37,26,17,13,24
80,Fail,41,34,1,12,29
80,Fail,46,23,3,14,32
80,Fail,55,21,0,11,44
80,Fail,44,32,7,7,37
80,Fail,43,26,1,16,27
80,Fail,47,26,8,10,37
80,Fail,53,22,0,14,39
80,Fail,52,20,7,14,38
80,Fail,52,30,0,8,44
80,Fail,41,38,0,11,30
80,Fail,41,35,8,8,33
80,Fail,51,27,0,16,35
80,Fail,39,33,8,12,27
80,Fail,41,34,0,15,26
80,Fail,50,25,0,12,38
80,Fail,47,26,0,11,36
80,Fail,50,29,0,11,39
80,Fail,58,18,1,10,48
80,Fail,55,18,0,16,39
80,Fail,51,30,0,8,43
80,Fail,49,25,0,16,33
80,Fail,52,25,0,9,43
80,Fail,57,22,1,10,47
80,Fail,51,20,0,18,33
80,Fail,51,22,0,14,37
80,Fail,52,27,0,10,42
80,Fail,53,24,0,10,43
80,Fail,50,22,0,18,32
80,Fail,43,35,0,13,30
80,Fail,51,24,0,14,37
80,Fail,50,30,0,12,38
80,Fail,43,32,0,15,28
80,Fail,43,33,0,11,32
80,Fail,45,29,2,13,32
80,Fail,42,32,3,11,31
80,Fail,43,44,0,9,34
80,Fail,46,29,1,13,33
80,Fail,40,37,0,14,26
80,Fail,52,17,1,19,33
80,Fail,48,21,0,20,28
80,Fail,49,36,0,9,40
80,Fail,42,26,9,13,29
80,Fail,60,13,2,14,46
80,Fail,46,28,0,16,30
80,Fail,53,20,2,11,42
80,Fail,52,25,0,9,43
80,Fail,48,28,0,13,35
80,Fail,52,31,0,6,46
80,Fail,41,27,0,22,19
80,Fail,50,32,0,7,43
80,Fail,47,27,7,9,38
80,Fail,39,39,0,13,26
80,Fail,53,29,0,9,44
80,Fail,53,19,10,8,45
80,Fail,49,22,0,14,35
80,Fail,46,30,0,14,32
80,Fail,48,31,0,14,34
80,Fail,47,24,4,11,36
80,Fail,50,22,5,12,38
80,Fail,52,28,0,10,42
80,Fail,48,34,6,4,44
80,Fail,42,34,0,10,32
80,Fail,48,26,0,13,35
80,Fail,44,30,0,15,29
80,Fail,46,28,7,11,35
80,Fail,51,28,0,10,41
80,Fail,44,35,0,10,34
80,Fail,54,24,2,12,42
80,Fail,46,32,0,9,37
80,Fail,52,27,0,10,42
80,Fail,46,30,0,14,32
80,Fail,45,28,9,8,37
80,Fail,50,26,3,8,42
80,Fail,54,20,0,11,43
80,Fail,49,28,4,9,40
80,Fail,51,23,3,12,39
80,Fail,54,22,5,7,47
80,Fail,46,28,4,11,35
80,Fail,55,25,0,8,47
80,Fail,48,28,0,16,32
80,Fail,47,30,1,12,35
80,Fail,44,25,0,16,28
80,Fail,53,21,0,11,42
80,Fail,42,37,0,9,33
80,Fail,53,26,0,11,42
80,Fail,50,26,0,13,37
80,Fail,49,29,0,13,36
80,Fail,48,25,0,11,37
80,Fail,53,23,1,13,40
80,Fail,51,20,6,10,41
80,Fail,46,27,4,12,34
80,Fail,54,24,8,7,47
80,Fail,46,23,0,14,32
80,Fail,54,24,0,12,42
80,Fail,47,32,0,9,38
80,Fail,41,36,0,14,27
80,Fail,49,27,4,8,41
80,Fail,51,21,0,15,36
80,Fail,49,24,7,12,37
80,Fail,50,27,3,10,40
80,Fail,52,30,0,7,45
80,Fail,51,24,2,9,42
80,Fail,51,27,1,12,39
80,Fail,50,32,0,12,38
80,Fail,48,25,4,11,37
80,Fail,46,25,0,17,29
80,Fail,52,22,0,18,34
80,Fail,46,23,2,15,31
80,Fail,43,32,5,10,33
80,Fail,45,27,3,14,31
80,Fail,55,22,1,11,44
80,Fail,47,31,0,15,32
80,Fail,51,24,0,12,39
80,Fail,54,19,3,14,40
80,Fail,44,29,3,14,30
80,Fail,56,24,0,9,47
80,Fail,53,23,4,12,41
80,Fail,43,32,2,14,29
80,Fail,47,22,0,21,26
80,Fail,54,30,3,10,44
80,Fail,44,36,0,9,35
80,Fail,45,26,4,11,34
80,Fail,50,29,0,10,40
80,Fail,53,23,0,12,41
80,Fail,49,29,2,8,41
80,Fail,44,41,0,7,37
80,Fail,37,29,5,17,20
80,Fail,46,29,0,15,31
80,Fail,52,23,0,13,39
80,Fail,50,33,0,12,38
80,Fail,37,40,0,16,21
80,Fail,52,29,0,9,43
80,Fail,44,35,1,11,33
80,Fail,49,32,0,8,41
80,Fail,43,21,10,16,27
80,Fail,54,22,3,10,44
80,Fail,43,34,3,11,32
80,Fail,48,31,0,6,42
80,Fail,57,22,0,9,48
80,Fail,49,30,0,11,38
80,Fail,51,17,9,14,37
80,Fail,46,33,0,9,37
80,Fail,49,26,0,15,34
80,Fail,48,35,0,9,39
80,Fail,42,27,0,18,24
80,Fail,47,31,0,8,39
80,Fail,58,17,2,10,48
80,Fail,37,32,8,16,21
80,Fail,48,33,0,10,38
80,Fail,41,36,0,12,29
80,Fail,45,27,8,13,32
80,Fail,43,34,0,11,32
80,Fail,50,24,0,14,36
80,Fail,42,33,3,16,26
80,Fail,48,24,4,13,35
80,Fail,46,26,8,11,35
80,Fail,48,26,8,12,36
80,Fail,48,26,0,14,34
80,Fail,47,25,0,13,34
80,Fail,51,24,0,12,39
80,Fail,43,32,4,11,32
80,Fail,44,28,1,17,27
80,Fail,50,22,7,11,39
80,Fail,51,29,0,8,43
80,Fail,45,28,3,17,28
80,Fail,47,32,4,6,41
80,Fail,52,25,1,14,38
80,Fail,54,20,6,9,45
80,Fail,49,33,0,9,40
80,Fail,44,28,6,9,35
80,Fail,50,28,0,10,40
80,Fail,49,22,0,17,32
80,Fail,52,18,5,16,36
80,Fail,48,28,0,15,33
80,Fail,46,36,0,9,37
80,Fail,35,30,10,18,17
80,Fail,46,32,0,12,34
80,Fail,46,29,0,16,30
80,Fail,44,24,6,18,26
80,Fail,55,15,3,14,41
80,Fail,49,24,0,14,35
80,Fail,54,28,0,9,45
80,Fail,54,21,4,7,47
80,Fail,45,30,3,12,33
80,Fail,44,24,7,10,34
80,Fail,47,32,0,11,36
80,Fail,47,26,5,14,33
80,Fail,45,28,1,14,31
80,Fail,47,27,5,12,35
80,Fail,45,23,7,20,25
80,Fail,47,32,0,12,35
80,Fail,38,34,0,20,18
80,Fail,54,29,0,13,41
80,Fail,48,19,2,16,32
80,Fail,47,27,0,15,32
80,Fail,48,30,0,10,38
80,Fail,46,28,0,13,33
80,Fail,42,22,0,23,19
80,Fail,56,20,0,14,42
80,Fail,44,29,0,17,27
80,Fail,46,25,3,15,31
80,Fail,53,23,3,10,43
80,Fail,54,22,4,12,42
80,Fail,54,31,0,10,44
80,Fail,47,28,0,12,35
80,Fail,40,24,9,15,25
80,Fail,52,30,0,8,44
80,Fail,50,26,6,7,43
80,Fail,54,22,5,10,44
80,Fail,53,24,0,11,42
80,Fail,50,24,3,14,36
80,Fail,43,27,3,15,28
80,Fail,48,27,4,12,36
80,Fail,51,15,9,13,38
80,Fail,43,32,0,16,27
80,Fail,45,23,7,16,29
80,Fail,45,33,0,10,35
80,Fail,49,25,1,14,35
80,Fail,43,33,1,11,32
80,Fail,51,17,6,13,38
80,Fail,48,26,2,11,37
80,Fail,50,17,1,17,33
80,Fail,54,24,2,8,46
80,Fail,44,23,1,18,26
80,Fail,44,28,1,15,29
80,Fail,49,31,0,10,39
80,Fail,56,15,2,16,40
80,Fail,52,23,1,14,38
80,Fail,52,19,9,12,40
80,Fail,46,23,4,16,30
80,Fail,46,26,0,18,28
80,Fail,45,23,5,12,33
80,Fail,42,27,2,19,23
80,Fail,48,29,0,13,35
80,Fail,45,35,0,9,36
80,Fail,44,32,0,15,29
80,Fail,52,30,0,8,44
80,Fail,48,30,0,9,39
80,Fail,44,23,4,17,27
80,Fail,43,26,3,13,30
80,Fail,54,27,0,11,43
80,Fail,43,32,9,10,33
80,Fail,52,25,4,11,41
80,Fail,48,26,2,16,32
80,Fail,48,28,0,14,34
80,Fail,50,28,0,15,35
80,Fail,41,40,0,13,28
80,Fail,54,18,2,11,43
80,Fail,53,20,3,10,43
80,Fail,44,38,0,12,32
80,Fail,55,22,4,8,47
80,Fail,45,33,0,17,28
80,Fail,46,31,1,11,35
80,Fail,58,20,0,11,47
80,Fail,50,16,1,16,34
80,Fail,42,26,5,15,27
80,Fail,56,20,1,8,48
80,Fail,40,33,1,15,25
80,Fail,44,27,0,18,26
80,Fail,45,38,0,8,37
80,Fail,47,22,8,15,32
80,Fail,37,30,3,13,24
80,Fail,57,21,0,13,44
80,Fail,46,30,0,16,30
80,Fail,58,20,3,5,53
80,Fail,45,33,0,9,36
80,Fail,53,18,1,14,39
80,Fail,47,29,0,16,31
80,Fail,52,21,2,7,45
80,Fail,43,37,0,10,33
80,Fail,50,26,8,12,38
80,Fail,51,25,0,14,37
80,Fail,52,22,3,12,40
80,Fail,52,26,1,10,42
80,Fail,55,25,0,8,47
80,Fail,50,24,1,11,39
80,Fail,45,30,0,15,30
80,Fail,44,30,5,10,34
80,Fail,52,19,2,15,37
80,Fail,41,33,0,15,26
80,Fail,59,12,1,13,46
80,Fail,49,31,0,12,37
80,Fail,52,23,0,13,39
80,Fail,49,25,3,16,33
80,Fail,49,25,4,10,39
80,Fail,54,24,10,7,47
80,Fail,43,27,0,16,27
80,Fail,41,23,3,16,25
80,Fail,51,23,8,8,43
80,Fail,45,25,2,14,31
80,Fail,44,29,1,15,29
80,Fail,43,29,0,17,26
80,Fail,60,23,0,6,54
80,Fail,46,26,6,10,36
80,Fail,49,34,0,7,42
80,Fail,47,24,3,17,30
80,Fail,46,27,0,13,33
80,Fail,51,27,6,6,45
80,Fail,45,30,0,14,31
80,Fail,45,26,3,14,31
80,Fail,51,25,6,14,37
80,Fail,54,23,4,9,45
80,Fail,53,26,0,11,42
80,Fail,47,25,5,15,32
80,Fail,52,22,6,11,41
80,Fail,62,18,0,7,55
80,Fail,49,27,0,10,39
80,Fail,44,26,2,14,30
80,Fail,48,35,0,9,39
80,Fail,48,30,0,12,36
80,Fail,52,18,2,16,36
80,Fail,49,19,3,18,31
80,Fail,53,25,0,11,42
80,Fail,42,26,0,21,21
80,Fail,50,28,0,10,40
80,Fail,45,32,0,15,30
80,Fail,47,26,7,12,35
80,Fail,45,26,11,13,32
80,Fail,51,17,6,16,35
80,Fail,48,22,0,18,30
80,Fail,49,26,0,14,35
80,Fail,42,39,0,11,31
80,Fail,52,22,1,10,42
80,Fail,49,24,3,18,31
80,Fail,56,16,7,14,42
80,Fail,43,31,0,19,24
80,Fail,53,20,0,12,41
80,Fail,46,27,3,14,32
80,Fail,48,22,0,15,33
80,Fail,49,26,1,13,36
80,Fail,50,20,6,14,36
80,Fail,50,26,0,13,37
80,Fail,43,30,0,18,25
80,Fail,51,24,0,15,36
80,Fail,41,28,0,17,24
80,Fail,49,30,1,9,40
80,Fail,43,26,0,15,28
80,Fail,43,35,0,12,31
80,Fail,47,27,0,13,34
80,Fail,47,26,7,11,36
80,Fail,51,25,4,9,42
80,Fail,59,17,0,13,46
80,Fail,45,23,5,18,27
80,Fail,42,39,0,11,31
80,Fail,52,22,4,10,42
80,Fail,45,35,0,15,30
80,Fail,48,27,0,11,37
80,Fail,47,22,3,18,29
80,Fail,54,23,0,14,40
80,Fail,53,27,0,9,44
80,Fail,42,24,3,17,25
80,Fail,47,25,4,13,34
80,Fail,47,25,8,12,35
80,Fail,50,22,0,15,35
80,Fail,48,30,4,8,40
80,Fail,49,26,0,13,36
80,Fail,52,23,0,8,44
80,Fail,49,26,0,11,38
80,Fail,43,35,0,15,28
80,Fail,47,27,2,14,33
80,Fail,53,26,2,7,46
80,Fail,37,41,0,12,25
80,Fail,49,23,3,15,34
80,Fail,50,26,2,14,36
80,Fail,50,26,0,11,39
80,Fail,59,24,0,11,48
80,Fail,59,21,0,6,53
80,Fail,42,24,8,15,27
80,Fail,47,27,0,15,32
80,Fail,51,25,2,9,42
80,Fail,48,24,3,16,32
80,Fail,47,30,0,13,34
80,Fail,40,32,8,13,27
80,Fail,51,37,0,4,47
80,Fail,53,23,0,13,40
80,Fail,48,31,0,12,36
80,Fail,53,27,0,6,47
80,Fail,45,26,2,10,35
80,Fail,53,21,1,15,38
80,Fail,49,26,0,14,35
80,Fail,47,28,2,12,35
80,Fail,49,31,0,12,37
80,Fail,45,33,0,11,34
80,Fail,48,27,0,14,34
80,Fail,51,19,6,15,36
80,Fail,47,21,6,15,32
80,Fail,47,28,0,15,32
80,Fail,54,19,3,10,44
80,Fail,45,28,0,18,27
80,Fail,49,27,8,9,40
80,Fail,50,27,0,13,37
80,Fail,51,29,5,5,46
80,Fail,51,25,0,15,36
80,Fail,49,26,0,14,35
80,Fail,54,23,0,15,39
80,Fail,50,30,0,11,39
80,Fail,45,34,0,11,34
80,Fail,47,22,6,12,35
80,Fail,52,24,1,13,39
80,Fail,57,18,0,15,42
80,Fail,54,17,7,12,42
80,Fail,43,34,0,13,30
80,Fail,47,25,8,11,36
80,Fail,38,36,1,15,23
80,Fail,49,31,0,11,38
80,Fail,49,28,1,12,37
80,Fail,44,31,3,14,30
80,Fail,46,29,0,16,30
80,Fail,45,26,2,15,30
80,Fail,39,28,11,12,27
80,Fail,48,26,0,16,32
80,Fail,44,31,9,8,36
80,Fail,40,38,0,14,26
80,Fail,39,36,0,14,25
80,Fail,48,30,1,9,39
80,Fail,55,18,3,11,44
80,Fail,44,28,3,14,30
80,Fail,54,26,0,9,45
80,Fail,45,25,8,11,34
80,Fail,59,25,0,10,49
80,Fail,55,22,0,10,45
80,Fail,43,27,0,18,25
80,Fail,47,21,0,18,29
80,Fail,47,36,0,9,38
80,Fail,46,32,3,7,39
80,Fail,51,24,0,11,40
80,Fail,46,27,0,18,28
80,Fail,51,21,0,19,32
80,Fail,51,23,2,12,39
80,Fail,47,24,2,16,31
80,Fail,43,27,5,18,25
80,Fail,54,24,0,10,44
80,Fail,43,45,0,6,37
80,Fail,41,38,0,12,29
80,Fail,44,28,0,16,28
80,Fail,52,28,0,11,41
80,Fail,54,25,4,9,45
80,Fail,49,23,0,13,36
80,Fail,50,22,0,14,36
80,Fail,44,37,0,10,34
80,Fail,52,27,0,13,39
80,Fail,49,27,5,11,38
80,Fail,36,27,7,21,15
80,Fail,41,34,6,13,28
80,Fail,44,27,2,17,27
80,Fail,50,28,0,11,39
80,Fail,46,25,2,12,34
80,Fail,49,29,0,13,36
80,Fail,50,26,7,10,40
80,Fail,47,27,0,18,29
80,Fail,53,20,6,12,41
80,Fail,41,45,0,8,33
80,Fail,51,26,0,13,38
80,Fail,45,31,5,11,34
80,Fail,46,31,0,13,33
80,Fail,43,31,3,11,32
80,Fail,52,25,3,9,43
80,Fail,47,26,1,15,32
80,Fail,45,26,0,18,27
80,Fail,53,23,0,10,43
80,Fail,49,27,8,10,39
80,Fail,45,30,0,14,31
80,Fail,40,32,0,18,22
80,Fail,42,34,0,10,32
80,Fail,53,27,0,9,44
80,Fail,48,18,4,21,27
80,Fail,44,32,0,13,31
80,Fail,49,20,10,13,36
80,Fail,47,30,0,16,31
80,Fail,46,28,0,14,32
80,Fail,52,26,0,12,40
80,Fail,41,33,0,13,28
80,Fail,35,46,0,11,24
80,Fail,48,27,4,10,38
80,Fail,50,26,0,10,40
80,Fail,52,24,2,12,40
80,Fail,47,31,5,10,37
80,Fail,53,21,0,10,43
80,Fail,46,33,0,14,32
80,Fail,54,26,0,11,43
80,Fail,42,27,4,15,27
80,Fail,40,37,0,11,29
80,Fail,50,28,0,6,44
80,Fail,52,23,0,15,37
80,Fail,49,31,0,13,36
80,Fail,51,24,5,10,41
80,Fail,41,25,11,14,27
80,Fail,54,20,0,7,47
80,Fail,45,25,0,16,29
80,Fail,45,26,6,14,31
80,Fail,52,18,4,9,43
80,Fail,54,12,2,17,37
80,Fail,50,28,0,10,40
80,Fail,49,30,3,8,41
80,Fail,49,24,0,18,31
80,Fail,52,27,0,11,41
80,Fail,45,30,9,7,38
80,Fail,50,22,8,13,37
80,Fail,46,23,6,12,34
80,Fail,49,26,4,10,39
80,Fail,43,36,0,11,32
80,Fail,49,24,1,14,35
80,Fail,53,19,0,12,41
80,Fail,46,27,0,20,26
80,Fail,43,25,0,20,23
80,Fail,43,29,4,13,30
80,Fail,49,25,5,9,40
80,Fail,51,31,0,9,42
80,Fail,37,30,12,15,22
80,Fail,44,29,0,17,27
80,Fail,48,28,4,12,36
80,Fail,49,27,0,12,37
80,Fail,52,25,0,13,39
80,Fail,39,32,1,19,20
80,Fail,44,28,3,13,31
80,Fail,50,29,0,10,40
80,Fail,48,21,7,19,29
80,Fail,41,28,9,14,27
80,Fail,43,27,6,17,26
80,Fail,55,22,0,5,50
80,Fail,44,33,0,15,29
80,Fail,58,21,3,8,50
80,Fail,48,32,0,10,38
80,Fail,43,34,0,13,30
80,Fail,44,32,4,9,35
80,Fail,50,28,0,11,39
80,Fail,44,20,13,14,30
80,Fail,57,18,2,12,45
80,Fail,56,19,0,15,41
80,Fail,56,21,0,14,42
80,Fail,52,20,3,12,40
80,Fail,50,28,0,15,35
80,Fail,51,28,0,8,43
80,Fail,48,22,1,20,28
80,Fail,51,25,0,12,39
80,Fail,47,31,0,11,36
80,Fail,51,25,0,9,42
80,Fail,47,34,0,10,37
80,Fail,55,27,0,7,48
80,Fail,53,23,0,14,39
80,Fail,53,21,0,16,37
80,Fail,44,29,0,16,28
80,Fail,41,35,0,13,28
80,Fail,54,23,0,11,43
80,Fail,53,16,5,13,40
80,Fail,42,24,5,14,28
80,Fail,44,27,5,13,31
80,Fail,49,31,2,10,39
80,Fail,59,22,2,8,51
80,Fail,43,38,0,9,34
80,Fail,40,44,0,6,34
80,Fail,53,25,0,9,44
80,Fail,46,26,3,11,35
80,Fail,52,22,4,13,39
80,Fail,42,36,0,15,27
80,Fail,50,25,1,10,40
80,Fail,45,36,0,12,33
80,Fail,53,23,2,10,43
80,Fail,48,31,0,11,37
80,Fail,47,30,0,14,33
80,Fail,52,26,1,9,43
80,Fail,53,22,0,13,40
80,Fail,44,27,3,12,32
80,Fail,52,28,0,12,40
80,Fail,61,19,0,7,54
80,Fail,47,32,0,12,35
80,Fail,42,37,0,12,30
80,Fail,46,28,2,16,30
80,Fail,55,21,1,9,46
80,Fail,51,23,2,11,40
80,Fail,44,29,0,15,29
80,Fail,52,34,0,7,45
80,Fail,49,24,1,17,32
80,Fail,52,29,0,12,40
80,Fail,48,25,2,14,34
80,Fail,43,26,3,17,26
80,Fail,53,22,0,12,41
80,Fail,47,21,9,14,33
80,Fail,45,23,10,14,31
80,Fail,53,24,0,11,42
80,Fail,55,23,0,13,42
80,Fail,45,23,7,15,30
80,Fail,58,22,0,6,52
80,Fail,40,37,0,16,24
80,Fail,53,27,0,9,44
80,Fail,52,17,4,12,40
80,Fail,46,33,0,14,32
80,Fail,51,19,3,15,36
80,Fail,51,16,5,19,32
80,Fail,39,36,0,19,20
80,Fail,48,28,0,11,37
80,Fail,53,22,6,12,41
80,Fail,52,25,0,14,38
80,Fail,45,31,0,12,33
80,Fail,44,33,0,13,31
80,Fail,46,31,2,13,33
80,Fail,46,28,4,12,34
80,Fail,50,22,0,11,39
80,Fail,51,18,3,13,38
80,Fail,54,23,1,10,44
80,Fail,56,28,0,8,48
80,Fail,51,27,0,13,38
80,Fail,51,22,4,11,40
80,Fail,51,24,5,8,43
80,Fail,53,23,0,12,41
80,Fail,49,31,0,10,39
80,Fail,50,18,4,15,35
80,Fail,46,32,1,13,33
80,Fail,47,30,2,10,37
80,Fail,39,37,0,18,21
80,Fail,45,28,7,11,34
80,Fail,48,22,4,18,30
80,Fail,45,37,0,9,36
80,Fail,39,33,1,16,23
80,Fail,54,24,0,12,42
80,Fail,47,26,0,15,32
80,Fail,49,22,6,14,35
80,Fail,38,33,2,17,21
80,Fail,54,23,0,13,41
80,Fail,47,32,0,9,38
80,Fail,51,27,5,9,42
80,Fail,46,27,6,13,33
80,Fail,61,19,0,10,51
80,Fail,59,14,2,12,47
80,Fail,50,29,1,10,40
80,Fail,55,24,0,12,43
80,Fail,56,19,4,10,46
80,Fail,50,24,2,12,38
80,Fail,45,32,0,13,32
80,Fail,48,30,6,4,44
80,Fail,52,23,2,10,42
80,Fail,41,27,0,22,19
80,Fail,44,34,0,12,32
80,Fail,47,21,7,16,31
80,Fail,56,25,0,12,44
80,Fail,46,28,0,15,31
80,Fail,46,28,0,17,29
80,Fail,43,22,5,20,23
80,Fail,44,30,2,12,32
80,Fail,51,31,0,10,41
80,Fail,52,22,0,13,39
80,Fail,38,28,0,22,16
80,Fail,48,22,1,16,32
80,Fail,53,15,5,14,39
80,Fail,44,34,0,12,32
80,Fail,48,29,0,14,34
80,Fail,52,22,5,12,40
80,Fail,46,27,0,15,31
80,Fail,37,33,3,19,18
80,Fail,47,28,5,13,34
80,Fail,42,31,4,13,29
80,Fail,62,21,1,7,55
80,Fail,46,35,0,10,36
80,Fail,54,25,0,13,41
80,Fail,45,28,0,16,29
80,Fail,48,30,1,10,38
80,Fail,46,22,13,13,33
80,Fail,52,24,1,12,40
80,Fail,49,28,0,11,38
80,Fail,42,27,6,13,29
80,Fail,48,29,0,15,33
80,Fail,50,26,0,11,39
80,Fail,49,23,1,11,38
80,Fail,43,32,0,16,27
80,Fail,49,21,4,17,32
80,Fail,46,39,0,6,40
80,Fail,46,31,0,5,41
80,Fail,47,30,0,12,35
80,Fail,43,31,0,18,25
80,Fail,44,23,3,17,27
80,Fail,50,29,0,12,38
80,Fail,48,33,0,11,37
80,Fail,53,20,2,13,40
80,Fail,40,26,1,19,21
80,Fail,39,38,0,14,25
80,Fail,44,29,0,16,28
80,Fail,51,22,0,17,34
80,Fail,47,18,6,17,30
80,Fail,37,37,2,14,23
80,Fail,51,24,6,9,42
80,Fail,42,32,3,11,31
80,Fail,44,32,2,10,34
80,Fail,51,26,1,12,39
80,Fail,52,20,0,15,37
80,Fail,53,23,4,10,43
80,Fail,44,30,0,13,31
80,Fail,44,27,3,15,29
80,Fail,51,24,1,16,35
80,Fail,50,24,0,13,37
80,Fail,46,28,1,19,27
80,Fail,47,29,5,9,38
80,Fail,39,32,6,11,28
80,Fail,40,29,3,15,25
80,Fail,49,25,0,13,36
80,Fail,49,21,10,6,43
80,Fail,46,33,0,12,34
80,Fail,55,20,4,10,45
80,Fail,40,24,0,19,21
80,Fail,44,34,0,12,32
80,Fail,43,41,0,8,35
80,Fail,45,35,0,11,34
80,Fail,46,24,2,17,29
80,Fail,45,38,0,6,39
80,Fail,51,21,1,11,40
80,Fail,47,29,0,14,33
80,Fail,49,24,0,13,36
80,Fail,48,18,3,21,27
80,Fail,45,32,2,8,37
80,Fail,46,28,1,13,33
80,Fail,48,37,0,7,41
80,Fail,52,20,0,16,36
80,Fail,43,21,7,20,23
80,Fail,43,38,0,13,30
80,Fail,43,24,6,19,24
80,Fail,46,32,5,7,39
80,Fail,49,22,6,15,34
80,Fail,41,36,2,12,29
80,Fail,44,28,1,16,28
80,Fail,42,40,0,10,32
80,Fail,48,29,1,14,34
80,Fail,48,31,0,9,39
80,Fail,47,25,5,14,33
80,Fail,48,30,0,11,37
80,Fail,54,14,6,13,41
80,Fail,53,32,0,9,44
80,Fail,49,26,3,12,37
80,Fail,47,30,0,13,34
80,Fail,42,32,1,12,30
80,Fail,47,26,3,14,33
80,Fail,51,23,0,11,40
80,Fail,46,37,0,9,37
80,Fail,49,23,0,15,34
80,Fail,43,26,4,15,28
80,Fail,51,27,2,11,40
80,Fail,44,26,6,16,28
80,Fail,46,28,7,7,39
80,Fail,42,37,0,7,35
80,Fail,54,23,1,8,46
80,Fail,49,24,0,16,33
80,Fail,55,26,0,8,47
80,Fail,51,27,0,8,43
80,Fail,58,20,4,9,49
80,Fail,50,24,0,18,32
80,Fail,38,33,4,18,20
80,Fail,43,34,0,12,31
80,Fail,47,35,0,9,38
80,Fail,45,27,0,15,30
80,Fail,50,22,0,18,32
80,Fail,48,29,0,14,34
80,Fail,43,29,3,13,30
80,Fail,42,28,7,17,25
80,Fail,44,32,0,10,34
80,Fail,51,24,0,10,41
80,Fail,46,35,0,12,34
80,Fail,50,26,4,14,36
80,Fail,52,22,0,10,42
80,Fail,41,38,0,11,30
80,Fail,50,31,0,10,40
80,Fail,45,23,9,13,32
80,Fail,50,25,0,15,35
80,Fail,61,18,0,10,51
80,Fail,47,25,0,15,32
80,Fail,48,26,2,7,41
80,Fail,46,29,3,10,36
80,Fail,51,29,0,9,42
80,Fail,49,35,0,5,44
80,Fail,51,30,0,6,45
80,Fail,49,25,4,10,39
80,Fail,49,26,5,9,40
80,Fail,51,29,0,10,41
80,Fail,51,29,0,8,43
80,Fail,51,25,1,10,41
80,Fail,45,33,0,14,31
80,Fail,47,25,0,12,35
80,Fail,44,24,11,13,31
80,Fail,39,32,6,12,27
80,Fail,49,23,0,11,38
80,Fail,46,32,0,12,34
80,Fail,47,29,4,10,37
80,Fail,49,20,5,15,34
80,Fail,44,22,6,17,27
80,Fail,48,24,0,15,33
80,Fail,50,29,0,10,40
80,Fail,45,32,2,14,31
80,Fail,49,34,0,10,39
80,Fail,54,22,4,9,45
80,Fail,40,35,5,15,25
80,Fail,46,25,6,10,36
80,Fail,42,38,0,12,30
80,Fail,48,26,0,11,37
80,Fail,38,41,0,13,25
80,Fail,45,31,3,12,33
80,Fail,50,22,7,9,41
80,Fail,43,25,4,14,29
80,Fail,43,27,12,10,33
80,Fail,48,27,2,10,38
80,Fail,47,32,0,8,39
80,Fail,50,22,0,15,35
80,Fail,47,20,4,22,25
80,Fail,56,17,0,12,44
80,Fail,45,28,0,16,29
80,Fail,53,25,1,11,42
80,Fail,46,37,0,9,37
80,Fail,55,22,4,7,48
80,Fail,43,27,0,20,23
80,Fail,43,25,2,19,24
80,Fail,44,25,2,20,24
80,Fail,44,22,10,17,27
80,Fail,51,31,0,9,42
80,Fail,44,21,3,19,25
80,Fail,48,28,2,11,37
80,Fail,42,33,8,16,26
80,Fail,53,22,0,9,44
80,Fail,51,22,0,15,36
80,Fail,49,29,0,9,40
80,Fail,46,26,1,14,32
80,Fail,49,28,0,15,34
80,Fail,44,26,1,20,24
80,Fail,60,23,0,5,55
80,Fail,50,29,0,8,42
80,Fail,50,22,3,15,35
80,Fail,44,39,0,7,37
80,Fail,50,24,0,12,38
80,Fail,44,28,0,20,24
80,Fail,54,24,2,11,43
80,Fail,51,28,0,9,42
80,Fail,40,26,3,20,20
80,Fail,50,22,0,18,32
80,Fail,50,21,4,14,36
80,Fail,48,31,0,12,36
80,Fail,47,27,1,13,34
80,Fail,46,27,1,13,33
80,Fail,48,15,7,19,29
80,Fail,51,19,5,14,37
80,Fail,47,26,0,17,30
80,Fail,44,22,10,15,29
80,Fail,52,22,2,11,41
80,Fail,51,28,5,8,43
80,Fail,44,29,7,13,31
80,Fail,52,25,0,10,42
80,Fail,52,23,0,11,41
80,Fail,45,29,7,10,35
80,Fail,48,21,0,15,33
80,Fail,47,25,5,10,37
80,Fail,38,37,7,11,27
80,Fail,38,31,4,17,21
80,Fail,43,34,0,15,28
80,Fail,43,38,0,11,32
80,Fail,47,29,0,11,36
80,Fail,35,39,0,15,20
80,Fail,57,22,1,9,48
80,Fail,51,29,0,10,41
80,Fail,48,16,11,14,34
80,Fail,46,26,5,15,31
80,Fail,45,26,2,18,27
80,Fail,47,25,0,16,31
80,Fail,55,23,0,12,43
80,Fail,46,18,9,15,31
80,Fail,43,35,0,13,30
80,Fail,45,32,4,10,35
80,Fail,40,35,5,8,32
80,Fail,53,24,4,10,43
80,Fail,46,32,3,7,39
80,Fail,49,22,0,17,32
80,Fail,48,30,0,11,37
80,Fail,43,24,9,12,31
80,Fail,49,30,0,10,39
80,Fail,48,27,0,10,38
80,Fail,45,31,0,14,31
80,Fail,50,19,1,16,34
80,Fail,47,27,4,11,36
80,Fail,52,25,0,13,39
80,Fail,43,24,0,21,22
80,Fail,48,24,0,18,30
80,Fail,44,35,0,13,31
80,Fail,49,32,0,7,42
80,Fail,44,32,1,9,35
80,Fail,48,26,3,12,36
80,Fail,50,22,1,19,31
80,Fail,45,32,1,11,34
80,Fail,50,24,0,15,35
80,Fail,53,20,5,14,39
80,Fail,52,23,0,14,38
80,Fail,53,23,8,10,43
80,Fail,46,32,3,10,36
80,Fail,46,32,0,9,37
80,Fail,48,21,0,16,32
80,Fail,49,30,0,14,35
80,Fail,56,21,6,10,46
80,Fail,49,27,0,13,36
80,Fail,48,35,0,12,36
80,Fail,48,24,4,12,36
80,Fail,52,22,0,12,40
80,Fail,50,28,0,12,38
80,Fail,47,19,4,17,30
80,Fail,45,24,5,15,30
80,Fail,56,23,1,10,46
80,Fail,50,28,0,10,40
80,Fail,54,24,0,12,42
80,Fail,48,24,7,10,38
80,Fail,55,21,0,14,41
80,Fail,47,29,0,11,36
80,Fail,50,21,0,16,34
80,Fail,46,28,0,17,29
80,Fail,48,24,9,9,39
80,Fail,48,26,0,11,37
80,Fail,52,26,3,9,43
80,Fail,36,39,3,17,19
80,Fail,44,23,8,16,28
80,Fail,47,37,0,8,39
80,Fail,46,21,2,23,23
80,Fail,46,25,1,15,31
80,Fail,47,25,0,18,29
80,Fail,50,27,3,8,42
80,Fail,50,29,0,8,42
80,Fail,43,28,3,13,30
80,Fail,47,31,0,12,35
80,Fail,49,31,0,9,40
80,Fail,46,29,0,13,33
80,Fail,48,28,0,12,36
80,Fail,35,29,5,17,18
80,Fail,50,29,0,12,38
80,Fail,52,22,2,14,38
80,Fail,54,24,0,12,42
80,Fail,33,31,3,19,14
80,Fail,47,26,0,12,35
80,Fail,51,27,0,12,39
80,Fail,45,33,0,10,35
80,Fail,44,25,3,17,27
80,Fail,38,38,0,15,23
80,Fail,46,29,7,11,35
80,Fail,48,22,0,20,28
80,Fail,45,30,0,15,30
80,Fail,45,25,6,10,35
80,Fail,47,20,2,14,33
80,Fail,50,32,0,12,38
80,Fail,53,25,1,12,41
80,Fail,49,24,0,14,35
80,Fail,53,19,0,17,36
80,Fail,35,37,3,17,18
80,Fail,48,32,0,13,35
80,Fail,47,24,5,19,28
80,Fail,49,28,0,13,36
80,Fail,50,22,5,15,35
80,Fail,45,29,7,11,34
80,Fail,47,21,9,16,31
80,Fail,37,33,3,16,21
80,Fail,49,33,0,9,40
80,Fail,52,24,0,13,39
80,Fail,56,17,4,13,43
80,Fail,44,25,7,16,28
80,Fail,47,32,0,13,34
80,Fail,45,30,6,9,36
80,Fail,56,19,1,12,44
80,Fail,48,25,0,15,33
80,Fail,44,31,4,9,35
80,Fail,51,28,0,12,39
80,Fail,45,36,0,7,38
80,Fail,59,21,0,7,52
80,Fail,43,27,0,19,24
80,Fail,56,19,1,11,45
80,Fail,53,19,0,16,37
80,Fail,40,31,0,16,24
80,Fail,42,29,0,16,26
80,Fail,45,28,0,16,29
80,Fail,42,32,4,14,28
80,Fail,54,31,2,4,50
80,Fail,51,25,2,9,42
80,Fail,42,23,8,17,25
80,Fail,50,27,0,13,37
80,Fail,50,24,0,15,35
80,Fail,42,32,4,17,25
80,Fail,41,41,0,12,29
80,Fail,45,31,0,11,34
80,Fail,44,30,4,11,33
80,Fail,47,26,0,14,33
80,Fail,44,27,0,13,31
80,Fail,47,32,0,11,36
80,Fail,42,34,7,8,34
80,Fail,42,30,4,14,28
80,Fail,55,22,2,11,44
80,Fail,48,26,6,11,37
80,Fail,44,22,0,25,19
80,Fail,44,28,4,11,33
80,Fail,33,43,0,18,15
80,Fail,43,34,2,13,30
80,Fail,42,37,0,15,27
80,Fail,52,17,5,18,34
80,Fail,51,23,0,13,38
80,Fail,55,18,0,14,41
80,Fail,50,23,2,14,36
80,Fail,52,30,0,9,43
80,Fail,52,19,5,14,38
80,Fail,43,35,5,13,30
80,Fail,51,28,0,11,40
80,Fail,50,23,8,12,38
80,Fail,46,34,6,11,35
80,Fail,43,31,5,13,30
80,Fail,44,35,0,12,32
80,Fail,52,29,0,9,43
80,Fail,42,38,0,11,31
80,Fail,42,37,0,16,26
80,Fail,50,31,0,12,38
80,Fail,46,36,0,12,34
80,Fail,53,24,0,12,41
80,Fail,49,26,0,15,34
80,Fail,52,23,0,15,37
80,Fail,50,25,1,10,40
80,Fail,51,24,0,11,40
80,Fail,50,31,3,8,42
80,Fail,45,30,1,12,33
80,Fail,46,22,7,15,31
80,Fail,51,20,3,14,37
80,Fail,43,33,0,18,25
80,Fail,42,28,0,14,28
80,Fail,52,21,0,14,38
80,Fail,50,26,4,11,39
80,Fail,51,27,0,13,38
80,Fail,44,28,1,17,27
80,Fail,44,30,0,16,28
80,Fail,41,35,0,14,27
80,Fail,36,44,0,12,24
80,Fail,46,29,3,10,36
80,Fail,47,26,0,17,30
80,Fail,42,35,0,13,29
80,Fail,51,25,0,12,39
80,Fail,46,25,5,13,33
80,Fail,46,32,0,12,34
80,Fail,46,30,0,12,34
80,Fail,49,24,2,11,38
80,Fail,45,30,0,16,29
80,Fail,51,23,4,10,41
80,Fail,48,32,0,13,35
80,Fail,43,33,0,15,28
80,Fail,43,27,5,15,28
80,Fail,46,32,0,16,30
80,Fail,53,18,4,13,40
80,Fail,44,30,5,11,33
80,Fail,49,21,10,11,38
80,Fail,50,26,3,12,38
80,Fail,46,31,0,12,34
80,Fail,52,22,0,12,40
80,Fail,43,27,0,18,25
80,Fail,55,23,0,8,47
80,Fail,49,30,0,11,38
80,Fail,53,24,0,8,45
80,Fail,44,31,0,17,27
80,Fail,48,27,3,9,39
80,Fail,46,37,0,8,38
80,Fail,52,19,0,17,35
80,Fail,46,24,0,19,27
80,Fail,52,30,0,9,43
80,Fail,52,22,3,11,41
80,Fail,52,25,0,12,40
80,Fail,48,21,1,17,31
80,Fail,50,25,0,13,37
80,Fail,46,27,6,12,34
80,Fail,47,20,11,16,31
80,Fail,51,23,2,13,38
80,Fail,48,26,2,13,35
80,Fail,45,27,0,17,28
80,Fail,51,23,3,14,37
80,Fail,50,28,0,11,39
80,Fail,51,29,0,10,41
80,Fail,54,20,2,11,43
80,Fail,42,31,6,13,29
80,Fail,41,26,8,17,24
80,Fail,50,31,0,12,38
80,Fail,50,20,0,17,33
80,Fail,47,29,0,10,37
80,Fail,48,23,0,18,30
80,Fail,48,24,0,18,30
80,Fail,45,30,0,16,29
80,Fail,50,36,0,5,45
80,Fail,50,26,2,10,40
80,Fail,44,37,0,10,34
80,Fail,39,32,1,19,20
80,Fail,42,33,0,16,26
80,Fail,50,25,3,10,40
80,Fail,44,31,2,16,28
80,Fail,47,23,9,15,32
80,Fail,47,25,0,19,28
80,Fail,38,32,7,16,22
80,Fail,46,28,0,16,30
80,Fail,43,33,11,8,35
80,Fail,49,30,0,14,35
80,Fail,52,28,0,12,40
80,Fail,46,28,10,6,40
80,Fail,39,38,0,16,23
80,Fail,41,39,0,12,29
80,Fail,43,33,8,9,34
80,Fail,40,34,2,15,25
80,Fail,37,35,0,15,22
80,Fail,44,26,9,11,33
80,Fail,54,19,0,16,38
80,Fail,44,34,0,12,32
80,Fail,47,28,4,12,35
80,Fail,38,42,0,11,27
80,Fail,49,29,4,10,39
80,Fail,36,38,0,20,16
80,Fail,51,27,7,9,42
80,Fail,47,29,5,10,37
80,Fail,50,27,0,8,42
80,Fail,46,21,10,17,29
80,Fail,52,27,4,7,45
80,Fail,48,22,5,12,36
80,Fail,45,32,0,14,31
80,Fail,51,21,6,15,36
80,Fail,55,19,0,13,42
80,Fail,52,23,0,15,37
80,Fail,42,33,0,17,25
80,Fail,48,25,9,10,38
80,Fail,52,24,3,10,42
80,Fail,50,22,6,14,36
80,Fail,50,19,4,14,36
80,Fail,40,38,0,10,30
80,Fail,49,32,1,8,41
80,Fail,53,18,4,15,38
80,Fail,44,25,9,12,32
80,Fail,49,21,7,15,34
80,Fail,51,21,5,11,40
80,Fail,48,32,0,12,36
80,Fail,52,25,0,13,39
80,Fail,49,33,0,8,41
80,Fail,43,31,0,15,28
80,Fail,46,36,0,9,37
80,Fail,48,29,0,9,39
80,Fail,39,27,12,14,25
80,Fail,51,25,2,12,39
80,Fail,45,29,7,8,37
80,Fail,54,27,0,10,44
80,Fail,50,24,6,12,38
80,Fail,50,24,0,16,34
80,Fail,49,27,0,12,37
80,Fail,52,27,4,9,43
80,Fail,51,31,0,12,39
80,Fail,48,31,6,7,41
80,Fail,43,35,0,13,30
80,Fail,46,29,0,14,32
80,Fail,39,36,0,20,19
80,Fail,55,21,0,8,47
80,Fail,42,32,0,14,28
80,Fail,46,30,0,12,34
80,Fail,50,28,0,10,40
80,Fail,48,27,4,12,36
80,Fail,49,19,1,18,31
80,Fail,39,34,7,12,27
80,Fail,49,27,4,8,41
80,Fail,54,28,0,7,47
80,Fail,41,33,0,16,25
80,Fail,47,22,14,11,36
80,Fail,47,26,0,14,33
80,Fail,46,35,0,8,38
80,Fail,53,28,0,8,45
80,Fail,48,28,6,10,38
80,Fail,49,25,4,13,36
80,Fail,51,24,4,11,40
80,Fail,49,27,2,11,38
80,Fail,53,26,0,11,42
80,Fail,41,32,2,16,25
80,Fail,47,31,0,12,35
80,Fail,50,21,6,14,36
80,Fail,49,29,0,7,42
80,Fail,43,32,0,13,30
80,Fail,42,35,1,12,30
80,Fail,50,28,3,11,39
80,Fail,43,24,5,15,28
80,Fail,48,24,3,13,35
80,Fail,42,25,9,17,25
80,Fail,55,21,0,11,44
80,Fail,37,36,0,18,19
80,Fail,45,31,0,15,30
80,Fail,48,19,2,19,29
80,Fail,46,37,0,10,36
80,Fail,45,31,0,11,34
80,Fail,44,30,3,9,35
80,Fail,43,25,7,15,28
80,Fail,46,25,0,18,28
80,Fail,42,29,3,15,27
80,Fail,50,27,4,14,36
80,Fail,41,34,5,14,27
80,Fail,47,26,10,13,34
80,Fail,53,17,9,9,44
80,Fail,48,21,0,18,30
80,Fail,53,22,1,10,43
80,Fail,45,34,0,14,31
80,Fail,45,34,0,14,31
80,Fail,50,27,0,14,36
80,Fail,41,32,6,14,27
80,Fail,48,28,0,13,35
80,Fail,47,27,4,15,32
80,Fail,45,24,0,18,27
80,Fail,45,29,2,12,33
80,Fail,58,17,1,11,47
80,Fail,47,25,0,20,27
80,Fail,46,34,0,10,36
80,Fail,49,17,6,20,29
80,Fail,46,28,1,13,33
80,Fail,43,29,4,14,29
80,Fail,47,28,2,13,34
80,Fail,51,25,4,9,42
80,Fail,46,25,2,14,32
80,Fail,49,27,2,14,35
80,Fail,49,34,0,11,38
80,Fail,48,32,0,9,39
80,Fail,44,26,0,14,30
80,Fail,49,28,0,14,35
80,Fail,49,30,5,7,42
80,Fail,47,37,0,7,40
80,Fail,45,34,0,12,33
80,Fail,50,34,0,7,43
80,Fail,39,27,16,10,29
80,Fail,46,29,0,13,33
80,Fail,48,26,0,14,34
80,Fail,54,20,0,9,45
80,Fail,46,27,13,9,37
80,Fail,53,22,0,17,36
80,Fail,54,24,0,9,45
80,Fail,46,30,0,15,31
80,Fail,47,24,0,17,30
80,Fail,44,32,0,10,34
80,Fail,49,29,3,8,41
80,Fail,46,28,9,10,36
80,Fail,47,28,0,13,34
80,Fail,43,28,0,19,24
80,Fail,51,17,2,15,36
80,Fail,45,27,2,13,32
80,Fail,45,31,0,13,32
80,Fail,38,33,12,8,30
80,Fail,46,24,3,12,34
80,Fail,44,30,1,11,33
80,Fail,44,31,7,11,33
80,Fail,48,26,7,9,39
80,Fail,48,28,0,10,38
80,Fail,49,28,0,10,39
80,Fail,42,28,5,14,28
80,Fail,45,29,3,12,33
80,Fail,50,28,0,9,41
80,Fail,45,23,5,15,30
80,Fail,50,21,3,17,33
80,Fail,51,30,0,12,39
80,Fail,51,24,0,17,34
80,Fail,48,26,6,11,37
80,Fail,44,24,5,17,27
80,Fail,59,19,0,10,49
80,Fail,44,23,0,18,26
80,Fail,41,28,5,13,28
80,Fail,50,23,8,8,42
80,Fail,43,35,0,14,29
80,Fail,55,24,7,7,48
80,Fail,50,25,0,12,38
80,Fail,52,26,0,14,38
80,Fail,49,22,0,14,35
80,Fail,44,30,2,11,33
80,Fail,54,15,7,14,40
80,Fail,51,25,0,11,40
80,Fail,49,23,6,14,35
80,Fail,48,28,0,15,33
80,Fail,51,27,0,13,38
80,Fail,47,26,0,14,33
80,Fail,46,32,0,12,34
80,Fail,46,27,0,17,29
80,Fail,54,18,3,13,41
80,Fail,49,23,6,14,35
80,Fail,52,24,0,14,38
80,Fail,45,32,2,11,34
80,Fail,54,20,1,13,41
80,Fail,57,20,3,8,49
80,Fail,41,31,0,15,26
80,Fail,42,30,0,17,25
80,Fail,49,23,5,11,38
80,Fail,44,33,0,14,30
80,Fail,50,29,0,15,35
80,Fail,49,32,0,8,41
80,Fail,49,31,0,10,39
80,Fail,47,28,1,10,37
80,Fail,37,40,0,15,22
80,Fail,48,31,0,8,40
80,Fail,59,20,0,10,49
80,Fail,45,28,0,16,29
80,Fail,52,23,2,10,42
80,Fail,53,20,0,14,39
80,Fail,60,19,0,11,49
80,Fail,40,30,7,17,23
80,Fail,45,24,0,19,26
80,Fail,45,29,8,12,33
80,Fail,42,30,0,16,26
80,Fail,46,31,0,13,33
80,Fail,51,26,2,11,40
80,Fail,46,32,0,15,31
80,Fail,45,25,5,14,31
80,Fail,49,30,2,8,41
80,Fail,52,18,1,16,36
80,Fail,51,18,1,16,35
80,Fail,50,25,0,13,37
80,Fail,42,30,0,17,25
80,Fail,44,32,0,16,28
80,Fail,43,24,8,15,28
80,Fail,45,36,0,11,34
80,Fail,58,22,1,8,50
80,Fail,43,35,0,11,32
80,Fail,47,33,0,13,34
80,Fail,45,29,0,16,29
80,Fail,51,26,4,11,40
80,Fail,45,29,0,13,32
80,Fail,53,25,0,11,42
80,Fail,45,27,2,15,30
80,Fail,45,31,0,13,32
80,Fail,47,20,9,12,35
80,Fail,43,28,6,10,33
80,Fail,49,29,0,11,38
80,Fail,40,35,5,14,26
80,Fail,42,28,3,13,29
80,Fail,49,18,6,12,37
80,Fail,47,26,0,14,33
80,Fail,47,21,6,15,32
80,Fail,43,29,3,15,28
80,Fail,44,28,0,13,31
80,Fail,48,34,0,10,38
80,Fail,51,23,0,18,33
80,Fail,48,26,0,13,35
80,Fail,41,37,1,10,31
80,Fail,52,23,0,15,37
80,Fail,48,25,0,17,31
80,Fail,55,25,0,9,46
80,Fail,41,38,0,11,30
80,Fail,49,26,0,10,39
80,Fail,43,31,4,15,28
80,Fail,43,38,0,12,31
80,Fail,47,26,0,16,31
80,Fail,46,27,0,12,34
80,Fail,41,33,10,8,33
80,Fail,51,23,5,9,42
80,Fail,54,15,4,13,41
80,Fail,54,24,5,10,44
80,Fail,49,21,0,15,34
80,Fail,40,29,0,22,18
80,Fail,40,38,0,16,24
80,Fail,51,29,0,12,39
80,Fail,55,24,0,10,45
80,Fail,51,25,0,14,37
80,Fail,55,21,0,10,45
80,Fail,48,25,0,14,34
80,Fail,43,36,0,12,31
80,Fail,44,31,0,10,34
80,Fail,47,21,5,18,29
80,Fail,35,26,9,21,14
80,Fail,45,33,0,8,37
80,Fail,46,29,1,13,33
80,Fail,52,26,1,11,41
80,Fail,41,28,2,16,25
80,Fail,46,29,3,13,33
80,Fail,45,26,7,13,32
80,Fail,54,25,0,5,49
80,Fail,52,17,4,13,39
80,Fail,46,41,0,10,36
80,Fail,53,26,0,9,44
80,Fail,45,27,1,16,29
80,Fail,51,25,0,14,37
80,Fail,49,30,1,10,39
80,Fail,48,30,1,9,39
80,Fail,53,28,0,6,47
80,Fail,50,21,8,15,35
80,Fail,44,33,0,19,25
80,Fail,45,26,0,15,30
80,Fail,50,16,4,14,36
80,Fail,48,27,0,13,35
80,Fail,45,21,9,15,30
80,Fail,44,27,3,15,29
80,Fail,43,33,4,12,31
80,Fail,54,27,0,12,42
80,Fail,41,37,0,14,27
80,Fail,47,24,5,12,35
80,Fail,47,27,8,10,37
80,Fail,45,24,0,20,25
80,Fail,49,22,6,13,36
80,Fail,52,22,0,13,39
80,Fail,51,24,0,15,36
80,Fail,40,34,5,13,27
80,Fail,51,28,0,11,40
80,Fail,44,29,1,11,33
80,Fail,47,23,4,10,37
80,Fail,55,22,1,8,47
80,Fail,46,24,5,19,27
80,Fail,43,36,0,13,30
80,Fail,47,38,0,7,40
80,Fail,39,30,8,11,28
80,Fail,43,29,0,15,28
80,Fail,48,29,0,12,36
80,Fail,46,27,5,10,36
80,Fail,47,28,0,12,35
80,Fail,42,32,0,15,27
80,Fail,48,28,0,9,39
80,Fail,53,22,0,10,43
80,Fail,46,36,0,7,39
80,Fail,52,22,2,10,42
80,Fail,63,19,0,7,56
80,Fail,44,31,1,15,29
80,Fail,49,33,0,7,42
80,Fail,46,37,0,11,35
80,Fail,49,22,1,18,31
80,Fail,51,19,3,14,37
80,Fail,49,32,3,8,41
80,Fail,48,29,1,9,39
80,Fail,55,22,0,10,45
80,Fail,51,30,0,8,43
80,Fail,47,32,0,9,38
80,Fail,49,30,0,12,37
80,Fail,45,22,0,21,24
80,Fail,43,34,0,15,28
80,Fail,46,23,1,16,30
80,Fail,48,19,4,18,30
80,Fail,43,26,3,17,26
80,Fail,54,29,1,7,47
80,Fail,41,34,9,10,31
80,Fail,53,26,0,9,44
80,Fail,43,22,5,23,20
80,Fail,47,28,1,13,34
80,Fail,39,33,2,17,22
80,Fail,45,22,10,12,33
80,Fail,46,24,4,11,35
80,Fail,49,24,1,14,35
80,Fail,53,25,1,11,42
80,Fail,52,27,0,12,40
80,Fail,56,20,0,12,44
80,Fail,50,28,0,11,39
80,Fail,40,34,4,16,24
80,Fail,56,18,0,18,38
80,Fail,55,20,0,15,40
80,Fail,48,22,5,11,37
80,Fail,45,22,12,12,33
80,Fail,53,25,0,8,45
80,Fail,56,22,1,10,46
80,Fail,57,24,0,8,49
80,Fail,49,23,2,16,33
80,Fail,49,23,6,11,38
80,Fail,48,26,7,9,39
80,Fail,46,25,4,14,32
80,Fail,45,28,5,13,32
80,Fail,47,30,1,14,33
80,Fail,55,24,3,9,46
80,Fail,47,22,8,11,36
80,Fail,49,20,3,14,35
80,Fail,46,29,6,13,33
80,Fail,53,22,0,13,40
80,Fail,45,28,1,9,36
80,Fail,48,34,0,11,37
80,Fail,53,19,0,18,35
80,Fail,44,34,4,8,36
80,Fail,51,28,0,8,43
80,Fail,56,20,0,12,44
80,Fail,50,24,3,13,37
80,Fail,54,22,0,13,41
80,Fail,43,25,7,18,25
80,Fail,44,25,4,12,32
80,Fail,53,21,6,8,45
80,Fail,50,30,0,9,41
80,Fail,48,26,0,13,35
80,Fail,48,24,6,16,32
80,Fail,50,27,0,13,37
80,Fail,43,31,4,15,28
80,Fail,46,28,2,10,36
80,Fail,54,21,5,12,42
80,Fail,50,25,0,13,37
80,Fail,43,33,0,12,31
80,Fail,47,19,5,18,29
80,Fail,48,22,1,17,31
80,Fail,42,31,0,18,24
80,Fail,51,16,8,14,37
80,Fail,54,23,1,7,47
80,Fail,46,33,2,9,37
80,Fail,54,20,0,16,38
80,Fail,41,37,0,15,26
80,Fail,55,20,0,13,42
80,Fail,51,30,0,10,41
80,Fail,48,27,5,13,35
80,Fail,56,24,0,9,47
80,Fail,47,27,0,15,32
80,Fail,38,37,0,15,23
80,Fail,44,38,0,10,34
80,Fail,50,28,0,15,35
80,Fail,48,24,4,12,36
80,Fail,42,30,12,10,32
80,Fail,39,25,12,16,23
80,Fail,41,40,0,11,30
80,Fail,46,24,7,19,27
80,Fail,45,33,5,6,39
80,Fail,50,25,0,12,38
80,Fail,46,21,4,17,29
80,Fail,46,27,2,14,32
80,Fail,41,40,0,11,30
80,Fail,46,25,2,12,34
80,Fail,53,21,1,11,42
80,Fail,44,35,0,12,32
80,Fail,43,26,3,12,31
80,Fail,45,33,0,12,33
80,Fail,45,31,6,11,34
80,Fail,53,25,0,8,45
80,Fail,50,28,0,13,37
80,Fail,46,32,0,10,36
80,Fail,50,23,6,11,39
80,Fail,49,31,3,7,42
80,Fail,50,19,6,10,40
80,Fail,41,35,0,7,34
80,Fail,56,26,0,9,47
80,Fail,47,25,0,14,33
80,Fail,55,24,0,13,42
80,Fail,44,32,0,13,31
80,Fail,46,27,3,14,32
80,Fail,43,34,0,15,28
80,Fail,50,23,1,12,38
80,Fail,50,28,0,14,36
80,Fail,53,25,3,11,42
80,Fail,49,23,0,16,33
80,Fail,48,31,0,13,35
80,Fail,42,29,8,12,30
80,Fail,40,33,2,16,24
80,Fail,49,29,0,10,39
80,Fail,56,24,0,10,46
80,Fail,44,26,0,19,25
80,Fail,54,26,1,7,47
80,Fail,46,22,7,14,32
80,Fail,46,28,0,13,33
80,Fail,51,25,0,9,42
80,Fail,58,27,0,7,51
80,Fail,45,29,0,17,28
80,Fail,55,21,0,11,44
80,Fail,53,24,0,7,46
80,Fail,55,26,0,5,50
80,Fail,46,36,0,10,36
80,Fail,47,27,4,11,36
80,Fail,52,23,1,11,41
80,Fail,45,24,0,15,30
80,Fail,42,27,3,15,27
80,Fail,45,28,3,13,32
80,Fail,50,30,0,11,39
80,Fail,43,30,7,10,33
80,Fail,49,23,1,15,34
80,Fail,43,36,0,13,30
80,Fail,46,34,0,10,36
80,Fail,36,32,5,16,20
80,Fail,47,26,0,15,32
80,Fail,49,32,0,10,39
80,Fail,43,33,0,17,26
80,Fail,48,21,6,14,34
80,Fail,48,17,15,13,35
80,Fail,43,34,0,14,29
80,Fail,48,25,0,13,35
80,Fail,49,25,3,12,37
80,Fail,47,26,2,14,33
80,Fail,49,25,8,11,38
80,Fail,47,19,4,16,31
80,Fail,51,26,2,11,40
80,Fail,40,31,6,13,27
80,Fail,48,25,0,15,33
80,Fail,49,24,6,11,38
80,Fail,41,28,7,13,28
80,Fail,49,22,2,15,34
80,Fail,51,29,0,11,40
80,Fail,44,36,0,9,35
80,Fail,52,20,3,14,38
80,Fail,47,25,2,14,33
80,Fail,39,29,0,22,17
80,Fail,50,26,2,12,38
80,Fail,43,27,10,11,32
80,Fail,43,33,0,12,31
80,Fail,50,27,0,11,39
80,Fail,47,25,0,15,32
80,Fail,46,22,0,19,27
80,Fail,49,33,0,12,37
80,Fail,47,27,0,15,32
80,Fail,53,28,0,8,45
80,Fail,47,30,2,9,38
80,Fail,45,34,0,15,30
80,Fail,41,26,7,18,23
80,Fail,39,24,2,24,15
80,Fail,48,31,0,14,34
80,Fail,51,29,1,11,40
80,Fail,55,24,5,7,48
80,Fail,49,24,5,10,39
80,Fail,55,30,0,5,50
80,Fail,46,32,0,8,38
80,Fail,46,29,0,14,32
80,Fail,42,26,0,18,24
80,Fail,50,30,0,11,39
80,Fail,50,27,0,11,39
80,Fail,50,24,0,14,36
80,Fail,53,18,1,13,40
80,Fail,48,26,1,13,35
80,Fail,47,22,2,17,30
80,Fail,51,24,4,9,42
80,Fail,49,28,0,10,39
80,Fail,45,29,0,17,28
80,Fail,52,20,2,13,39
80,Fail,48,19,0,19,29
80,Fail,47,27,0,11,36
80,Fail,41,46,0,8,33
80,Fail,43,35,0,14,29
80,Fail,53,24,0,13,40
80,Fail,54,22,3,11,43
80,Fail,48,28,0,10,38
80,Fail,43,32,0,13,30
80,Fail,54,20,0,10,44
80,Fail,48,30,0,11,37
80,Fail,44,33,0,7,37
80,Fail,47,38,0,8,39
80,Fail,51,31,0,9,42
80,Fail,44,28,0,15,29
80,Fail,49,25,0,17,32
80,Fail,47,26,1,12,35
80,Fail,52,27,0,11,41
80,Fail,58,21,3,9,49
80,Fail,51,26,2,13,38
80,Fail,49,24,0,15,34
80,Fail,47,31,4,5,42
80,Fail,53,26,7,7,46
80,Fail,45,27,0,16,29
80,Fail,53,25,0,13,40
80,Fail,49,28,0,15,34
80,Fail,50,29,0,11,39
80,Fail,54,16,7,11,43
80,Fail,45,28,2,12,33
80,Fail,40,33,0,19,21
80,Fail,51,22,1,14,37
80,Fail,52,21,5,10,42
80,Fail,46,35,0,14,32
80,Fail,48,27,0,14,34
80,Fail,51,26,0,9,42
80,Fail,48,32,0,12,36
80,Fail,52,20,0,18,34
80,Fail,46,25,0,13,33
80,Fail,50,31,0,7,43
80,Fail,42,29,1,13,29
80,Fail,45,29,0,14,31
80,Fail,48,26,0,13,35
80,Fail,49,23,0,16,33
80,Fail,42,36,0,14,28
80,Fail,54,23,1,12,42
80,Fail,51,16,1,19,32
80,Fail,47,27,0,12,35
80,Fail,45,31,0,14,31
80,Fail,56,22,0,13,43
80,Fail,51,27,0,10,41
80,Fail,45,30,0,15,30
80,Fail,48,31,0,12,36
80,Fail,52,22,7,9,43
80,Fail,54,24,0,9,45
80,Fail,49,22,0,17,32
80,Fail,48,32,1,9,39
80,Fail,45,27,0,16,29
80,Fail,50,28,0,10,40
80,Fail,45,27,0,16,29
80,Fail,51,23,1,13,38
80,Fail,51,31,0,13,38
80,Fail,52,20,7,11,41
80,Fail,60,20,0,11,49
80,Fail,48,33,0,12,36
80,Fail,41,31,1,13,28
80,Fail,52,26,0,14,38
80,Fail,50,27,0,12,38
80,Fail,47,23,6,14,33
80,Fail,38,43,0,12,26
80,Fail,33,31,7,21,12
80,Fail,42,29,1,15,27
80,Fail,49,27,1,11,38
80,Fail,47,30,0,14,33
80,Fail,56,27,1,8,48
80,Fail,50,22,4,13,37
80,Fail,56,22,5,8,48
80,Fail,40,36,0,17,23
80,Fail,43,25,9,14,29
80,Fail,43,27,0,13,30
80,Fail,53,19,0,13,40
80,Fail,45,25,5,15,30
80,Fail,51,28,3,10,41
80,Fail,47,30,0,11,36
80,Fail,56,17,0,9,47
80,Fail,52,23,4,11,41
80,Fail,48,34,0,13,35
80,Fail,46,23,6,16,30
80,Fail,43,33,0,13,30
80,Fail,51,23,0,13,38
80,Fail,57,24,0,7,50
80,Fail,54,21,2,11,43
80,Fail,48,31,0,10,38
80,Fail,47,33,0,13,34
80,Fail,51,20,0,17,34
80,Fail,54,25,0,10,44
80,Fail,41,35,0,18,23
80,Fail,44,24,2,14,30
80,Fail,45,26,0,19,26
80,Fail,47,30,0,12,35
80,Fail,54,19,0,13,41
80,Fail,49,24,0,11,38
80,Fail,52,23,2,13,39
80,Fail,60,17,1,8,52
80,Fail,47,24,1,16,31
80,Fail,47,28,3,12,35
80,Fail,45,30,0,14,31
80,Fail,53,23,2,10,43
80,Fail,47,25,5,11,36
80,Fail,50,19,9,15,35
80,Fail,49,31,0,10,39
80,Fail,44,36,0,10,34
80,Fail,39,35,0,12,27
80,Fail,41,28,8,15,26
80,Fail,43,27,8,15,28
80,Fail,54,24,0,9,45
80,Fail,54,23,0,15,39
80,Fail,49,28,0,15,34
80,Fail,48,27,0,12,36
80,Fail,56,24,0,8,48
80,Fail,55,25,5,10,45
80,Fail,53,17,2,16,37
80,Fail,39,32,3,14,25
80,Fail,42,32,0,15,27
80,Fail,47,29,0,15,32
80,Fail,41,33,0,18,23
80,Fail,50,27,0,16,34
80,Fail,53,22,2,9,44
80,Fail,49,30,0,9,40
80,Fail,44,28,2,14,30
80,Fail,49,29,0,14,35
80,Fail,46,31,0,14,32
80,Fail,48,28,4,9,39
80,Fail,50,30,0,11,39
80,Fail,52,26,0,11,41
80,Fail,42,38,0,16,26
80,Fail,50,30,2,8,42
80,Fail,37,33,6,14,23
80,Fail,48,32,0,14,34
80,Fail,52,25,0,13,39
80,Fail,61,16,4,9,52
80,Fail,55,25,0,8,47
80,Fail,47,25,4,11,36
80,Fail,49,20,9,15,34
80,Fail,59,16,7,10,49
80,Fail,48,30,8,4,44
80,Fail,39,33,0,19,20
80,Fail,42,30,1,16,26
80,Fail,42,32,0,17,25
80,Fail,48,28,6,8,40
80,Fail,51,25,0,15,36
80,Fail,51,26,2,11,40
80,Fail,58,21,0,10,48
80,Fail,46,36,0,9,37
80,Fail,56,18,2,11,45
80,Fail,48,23,9,10,38
80,Fail,47,24,4,15,32
80,Fail,45,30,0,15,30
80,Fail,48,21,3,13,35
80,Fail,41,35,0,18,23
80,Fail,45,27,0,18,27
80,Fail,52,24,6,11,41
80,Fail,51,27,0,14,37
80,Fail,44,26,7,15,29
80,Fail,48,38,0,12,36
80,Fail,51,22,0,14,37
80,Fail,50,28,3,7,43
80,Fail,48,29,0,16,32
80,Fail,55,20,1,11,44
80,Fail,52,28,0,8,44
80,Fail,56,26,0,8,48
80,Fail,49,26,4,10,39
80,Fail,48,25,0,14,34
80,Fail,49,24,2,15,34
80,Fail,41,39,0,13,28
80,Fail,49,22,6,9,40
80,Fail,46,27,0,16,30
80,Fail,49,27,0,13,36
80,Fail,54,25,0,14,40
80,Fail,49,27,0,13,36
80,Fail,46,24,0,21,25
80,Fail,50,25,2,10,40
80,Fail,49,31,0,12,37
80,Fail,42,34,0,17,25
80,Fail,45,24,4,16,29
80,Fail,51,22,4,13,38
80,Fail,52,24,4,10,42
80,Fail,50,30,0,8,42
80,Fail,44,35,0,13,31
80,Fail,50,30,0,13,37
80,Fail,46,22,6,16,30
80,Fail,46,29,0,16,30
80,Fail,49,30,0,10,39
80,Fail,50,21,1,19,31
80,Fail,53,24,0,14,39
80,Fail,42,29,2,15,27
80,Fail,44,29,0,16,28
80,Fail,49,21,4,13,36
80,Fail,46,27,3,14,32
80,Fail,49,32,1,8,41
80,Fail,47,28,9,6,41
80,Fail,48,23,4,14,34
80,Fail,39,28,8,14,25
80,Fail,49,30,0,10,39
80,Fail,43,31,1,14,29
80,Fail,44,27,4,14,30
80,Fail,49,26,4,10,39
80,Fail,43,35,0,13,30
80,Fail,50,31,0,10,40
80,Fail,46,32,0,14,32
80,Fail,53,22,3,11,42
80,Fail,43,30,5,16,27
80,Fail,53,23,3,11,42
80,Fail,57,18,0,13,44
80,Fail,56,14,2,13,43
80,Fail,43,27,5,10,33
80,Fail,43,33,2,12,31
80,Fail,49,27,0,14,35
80,Fail,47,34,0,12,35
80,Fail,48,23,5,12,36
80,Fail,63,19,0,7,56
80,Fail,43,29,1,14,29
80,Fail,43,27,0,17,26
80,Fail,54,24,1,9,45
80,Fail,51,30,0,10,41
80,Fail,41,30,10,14,27
80,Fail,46,32,6,10,36
80,Fail,58,14,5,13,45
80,Fail,47,31,0,15,32
80,Fail,45,26,9,12,33
80,Fail,48,20,4,19,29
80,Fail,50,26,0,10,40
80,Fail,44,28,0,18,26
80,Fail,45,33,0,7,38
80,Fail,42,29,6,15,27
80,Fail,47,27,0,17,30
80,Fail,46,28,8,12,34
80,Fail,60,16,0,14,46
80,Fail,42,38,0,12,30
80,Fail,44,25,2,15,29
80,Fail,56,17,6,13,43
80,Fail,37,29,1,22,15
80,Fail,45,27,5,13,32
80,Fail,48,32,0,10,38
80,Fail,40,35,0,17,23
80,Fail,44,22,6,22,22
80,Fail,56,22,3,7,49
80,Fail,46,23,8,13,33
80,Fail,51,28,0,10,41
80,Fail,48,28,8,11,37
80,Fail,45,27,5,12,33
80,Fail,40,28,2,16,24
80,Fail,53,25,0,6,47
80,Fail,45,33,0,13,32
80,Fail,50,23,0,15,35
80,Fail,43,33,1,11,32
80,Fail,48,24,7,10,38
80,Fail,58,27,0,7,51
80,Fail,52,23,5,11,41
80,Fail,41,26,10,10,31
80,Fail,53,16,3,17,36
80,Fail,55,24,1,7,48
80,Fail,48,20,8,16,32
80,Fail,52,22,3,10,42
80,Fail,54,22,7,8,46
80,Fail,49,29,1,9,40
80,Fail,49,25,1,13,36
80,Fail,50,15,2,19,31
80,Fail,48,18,2,16,32
80,Fail,48,36,0,9,39
80,Fail,46,33,0,12,34
80,Fail,39,34,0,18,21
80,Fail,51,22,6,9,42
80,Fail,45,30,0,12,33
80,Fail,54,24,0,11,43
80,Fail,46,30,0,13,33
80,Fail,41,35,0,12,29
80,Fail,57,20,5,9,48
80,Fail,47,30,3,11,36
80,Fail,45,34,0,12,33
80,Fail,50,28,0,11,39
80,Fail,49,29,0,7,42
80,Fail,51,32,0,9,42
80,Fail,53,24,2,9,44
80,Fail,39,36,0,19,20
80,Fail,41,28,1,18,23
80,Fail,45,29,2,13,32
80,Fail,39,30,11,11,28
80,Fail,42,26,2,19,23
80,Fail,34,37,0,21,13
80,Fail,45,39,0,9,36
80,Fail,46,21,7,18,28
80,Fail,41,29,0,18,23
80,Fail,60,22,2,7,53
80,Fail,54,27,0,8,46
80,Fail,51,21,0,15,36
80,Fail,48,20,1,18,30
80,Fail,48,27,0,10,38
80,Fail,54,19,0,9,45
80,Fail,40,39,0,14,26
80,Fail,46,37,0,11,35
80,Fail,50,25,0,10,40
80,Fail,47,25,0,16,31
80,Fail,50,19,4,17,33
80,Fail,44,23,1,22,22
80,Fail,53,22,2,13,40
80,Fail,38,23,6,19,19
80,Fail,47,24,3,16,31
80,Fail,50,36,0,4,46
80,Fail,46,29,0,13,33
80,Fail,44,22,4,20,24
80,Fail,51,29,0,8,43
80,Fail,46,30,0,11,35
80,Fail,51,28,1,10,41
80,Fail,50,20,4,13,37
80,Fail,48,26,0,17,31
80,Fail,48,27,5,11,37
80,Fail,44,30,3,15,29
80,Fail,54,24,0,10,44
80,Fail,44,32,0,16,28
80,Fail,47,27,0,13,34
80,Fail,40,40,0,11,29
80,Fail,56,25,0,7,49
80,Fail,44,27,5,16,28
80,Fail,45,23,9,14,31
80,Fail,43,33,0,16,27
80,Fail,56,20,1,11,45
80,Fail,54,20,0,16,38
80,Fail,47,21,9,14,33
80,Fail,47,35,0,12,35
80,Fail,48,29,0,12,36
80,Fail,49,23,6,11,38
80,Fail,43,32,0,15,28
80,Fail,48,36,0,10,38
80,Fail,49,26,2,12,37
80,Fail,49,32,0,11,38
80,Fail,50,24,3,12,38
80,Fail,43,31,0,17,26
80,Fail,49,29,0,12,37
80,Fail,51,29,0,11,40
80,Fail,51,28,1,12,39
80,Fail,51,30,0,9,42
80,Fail,59,16,1,10,49
80,Fail,55,21,0,10,45
80,Fail,50,28,0,15,35
80,Fail,42,35,0,12,30
80,Fail,56,16,0,15,41
80,Fail,43,29,5,13,30
80,Fail,46,32,0,13,33
80,Fail,46,26,9,10,36
80,Fail,58,20,0,12,46
80,Fail,48,22,7,11,37
80,Fail,54,24,2,11,43
80,Fail,56,25,1,4,52
80,Fail,46,30,0,11,35
80,Fail,53,24,0,12,41
80,Fail,52,29,0,13,39
80,Fail,54,20,0,11,43
80,Fail,47,23,4,16,31
80,Fail,45,28,1,15,30
80,Fail,39,33,0,19,20
80,Fail,41,32,0,17,24
80,Fail,49,26,3,14,35
80,Fail,48,23,0,10,38
80,Fail,45,17,9,16,29
80,Fail,45,29,2,14,31
80,Fail,48,22,5,17,31
80,Fail,50,28,0,10,40
80,Fail,51,34,0,7,44
80,Fail,43,26,4,13,30
80,Fail,49,26,0,15,34
80,Fail,42,31,2,10,32
80,Fail,48,30,0,17,31
80,Fail,54,21,0,16,38
80,Fail,50,29,0,12,38
80,Fail,47,30,0,10,37
80,Fail,51,30,0,8,43
80,Fail,48,27,4,11,37
80,Fail,52,24,0,15,37
80,Fail,56,23,1,6,50
80,Fail,47,25,3,16,31
80,Fail,36,42,0,15,21
80,Fail,53,24,0,14,39
80,Fail,47,26,0,13,34
80,Fail,50,27,0,9,41
80,Fail,40,25,3,18,22
80,Fail,54,21,1,8,46
80,Fail,47,31,1,10,37
80,Fail,51,24,1,13,38
80,Fail,54,24,0,13,41
80,Fail,38,29,8,17,21
80,Fail,46,36,0,13,33
80,Fail,50,21,0,19,31
80,Fail,57,21,0,13,44
80,Fail,45,30,0,15,30
80,Fail,46,29,0,14,32
80,Fail,51,27,0,9,42
80,Fail,53,27,0,12,41
80,Fail,40,39,0,12,28
80,Fail,50,27,0,11,39
80,Fail,46,24,0,17,29
80,Fail,40,35,0,16,24
80,Fail,43,32,0,12,31
80,Fail,50,24,0,16,34
80,Fail,48,26,6,13,35
80,Fail,51,25,5,10,41
80,Fail,54,28,3,11,43
80,Fail,56,21,0,11,45
80,Fail,50,26,0,14,36
80,Fail,50,28,0,9,41
80,Fail,50,36,0,8,42
80,Fail,47,34,0,13,34
80,Fail,51,22,4,12,39
80,Fail,51,22,10,10,41
80,Fail,44,31,4,10,34
80,Fail,38,33,0,18,20
80,Fail,44,33,0,14,30
80,Fail,48,25,4,12,36
80,Fail,49,29,0,16,33
80,Fail,54,22,0,7,47
80,Fail,42,34,0,15,27
80,Fail,44,25,0,18,26
80,Fail,48,26,10,9,39
80,Fail,44,30,0,14,30
80,Fail,42,29,8,14,28
80,Fail,48,34,0,9,39
80,Fail,42,39,0,9,33
80,Fail,52,27,0,7,45
80,Fail,40,29,3,13,27
80,Fail,48,29,0,13,35
80,Fail,51,22,0,13,38
80,Fail,42,30,9,13,29
80,Fail,54,19,3,12,42
80,Fail,46,31,0,16,30
80,Fail,50,31,0,9,41
80,Fail,49,29,0,13,36
80,Fail,46,24,9,9,37
80,Fail,52,27,0,10,42
80,Fail,47,21,5,19,28
80,Fail,55,31,0,6,49
80,Fail,51,24,0,12,39
80,Fail,42,33,0,14,28
80,Fail,40,32,0,19,21
80,Fail,55,21,3,10,45
80,Fail,49,23,4,14,35
80,Fail,47,17,3,21,26
80,Fail,50,25,1,12,38
80,Fail,55,24,2,11,44
80,Fail,47,29,0,8,39
80,Fail,51,23,0,15,36
80,Fail,49,22,5,13,36
80,Fail,41,30,5,14,27
80,Fail,46,26,4,13,33
80,Fail,48,26,0,11,37
80,Fail,47,28,0,13,34
80,Fail,37,39,0,14,23
80,Fail,44,32,0,12,32
80,Fail,50,26,2,9,41
80,Fail,60,16,0,10,50
80,Fail,46,26,6,15,31
80,Fail,51,24,3,12,39
80,Fail,41,38,0,10,31
80,Fail,46,31,2,9,37
80,Fail,49,27,0,10,39
80,Fail,46,25,2,16,30
80,Fail,52,22,0,12,40
80,Fail,53,25,0,8,45
80,Fail,41,28,7,17,24
80,Fail,46,29,2,10,36
80,Fail,50,27,0,10,40
80,Fail,48,40,0,4,44
80,Fail,52,24,2,10,42
80,Fail,51,20,0,15,36
80,Fail,56,20,0,13,43
80,Fail,49,30,2,8,41
80,Fail,44,22,5,20,24
80,Fail,49,24,1,17,32
80,Fail,44,32,0,13,31
80,Fail,54,22,3,11,43
80,Fail,52,24,4,8,44
80,Fail,48,32,4,6,42
80,Fail,51,22,3,12,39
80,Fail,51,26,1,10,41
80,Fail,48,28,0,13,35
80,Fail,46,28,3,10,36
80,Fail,50,25,3,10,40
80,Fail,53,19,0,15,38
80,Fail,51,25,0,12,39
80,Fail,47,27,0,14,33
80,Fail,39,41,0,12,27
80,Fail,47,24,0,17,30
80,Fail,46,20,7,15,31
80,Fail,53,20,2,11,42
80,Fail,46,32,0,12,34
80,Fail,51,24,0,15,36
80,Fail,49,19,3,19,30
80,Fail,46,25,0,15,31
80,Fail,48,29,0,12,36
80,Fail,52,21,2,11,41
80,Fail,50,27,2,9,41
80,Fail,52,23,0,15,37
80,Fail,42,34,0,13,29
80,Fail,49,30,0,11,38
80,Fail,53,21,0,16,37
80,Fail,52,25,0,11,41
80,Fail,49,25,6,13,36
80,Fail,41,24,10,20,21
80,Fail,49,28,0,9,40
80,Fail,54,21,4,12,42
80,Fail,50,26,0,9,41
80,Fail,54,23,0,16,38
80,Fail,51,22,2,13,38
80,Fail,47,28,6,14,33
80,Fail,48,31,0,8,40
80,Fail,51,22,0,17,34
80,Fail,42,32,0,17,25
80,Fail,56,20,0,12,44
80,Fail,40,35,0,15,25
80,Fail,48,26,0,17,31
80,Fail,45,27,6,11,34
80,Fail,42,36,0,14,28
80,Fail,47,25,2,13,34
80,Fail,45,28,4,14,31
80,Fail,51,25,2,11,40
80,Fail,49,22,7,14,35
80,Fail,48,19,0,18,30
80,Fail,48,26,0,16,32
80,Fail,54,26,1,9,45
80,Fail,40,32,0,15,25
80,Fail,52,24,0,11,41
80,Fail,50,26,2,10,40
80,Fail,46,23,4,15,31
80,Fail,55,25,0,12,43
80,Fail,45,28,0,18,27
80,Fail,47,30,0,11,36
80,Fail,51,21,1,13,38
80,Fail,45,28,0,16,29
80,Fail,39,39,0,15,24
80,Fail,48,25,5,16,32
80,Fail,48,33,0,10,38
80,Fail,54,22,0,12,42
80,Fail,46,33,0,12,34
80,Fail,57,23,1,12,45
80,Fail,41,34,0,17,24
80,Fail,50,25,0,9,41
80,Fail,43,33,0,13,30
80,Fail,54,22,0,10,44
80,Fail,48,33,0,6,42
80,Fail,41,33,4,12,29
80,Fail,41,36,2,11,30
80,Fail,51,26,0,14,37
80,Fail,45,29,1,13,32
80,Fail,52,24,0,13,39
80,Fail,57,23,1,9,48
80,Fail,42,28,6,14,28
80,Fail,51,27,0,9,42
80,Fail,47,24,0,17,30
80,Fail,48,27,6,11,37
80,Fail,38,37,0,17,21
80,Fail,58,20,3,10,48
80,Fail,43,24,13,14,29
80,Fail,48,33,0,6,42
80,Fail,55,19,0,11,44
80,Fail,49,24,6,11,38
80,Fail,51,21,0,16,35
80,Fail,45,30,3,10,35
80,Fail,44,33,0,10,34
80,Fail,55,23,0,13,42
80,Fail,50,24,0,15,35
80,Fail,58,19,1,10,48
80,Fail,53,23,3,13,40
80,Fail,45,26,0,15,30
80,Fail,55,23,0,11,44
80,Fail,51,25,0,12,39
80,Fail,47,24,4,17,30
80,Fail,44,37,0,12,32
80,Fail,46,33,0,12,34
80,Fail,44,31,2,9,35
80,Fail,50,21,0,16,34
80,Fail,48,24,1,9,39
80,Fail,48,23,5,14,34
80,Fail,49,30,0,11,38
80,Fail,45,38,0,8,37
80,Fail,45,35,0,15,30
80,Fail,51,25,0,14,37
80,Fail,41,22,6,23,18
80,Fail,47,27,0,13,34
80,Fail,45,34,0,9,36
80,Fail,47,29,4,12,35
80,Fail,49,22,2,19,30
80,Fail,46,30,0,13,33
80,Fail,49,23,0,12,37
80,Fail,48,22,2,14,34
80,Fail,42,31,6,15,27
80,Fail,43,34,0,11,32
80,Fail,45,29,6,11,34
80,Fail,43,21,10,12,31
80,Fail,50,32,0,9,41
80,Fail,49,25,0,11,38
80,Fail,48,25,4,12,36
80,Fail,46,33,0,10,36
80,Fail,47,25,6,12,35
80,Fail,44,25,13,10,34
80,Fail,54,19,2,14,40
80,Fail,47,29,5,9,38
80,Fail,44,29,0,17,27
80,Fail,45,26,0,15,30
80,Fail,44,27,6,14,30
80,Fail,59,20,0,10,49
80,Fail,46,38,0,10,36
80,Fail,48,28,0,12,36
80,Fail,50,19,5,18,32
80,Fail,45,31,0,11,34
80,Fail,61,17,0,8,53
80,Fail,47,17,3,22,25
80,Fail,49,21,4,14,35
80,Fail,55,21,0,15,40
80,Fail,54,25,2,7,47
80,Fail,41,23,11,17,24
80,Fail,58,17,5,10,48
80,Fail,47,26,2,11,36
80,Fail,50,24,0,11,39
80,Fail,43,34,2,11,32
80,Fail,56,24,0,10,46
80,Fail,53,30,0,9,44
80,Fail,51,27,0,9,42
80,Fail,53,22,1,16,37
80,Fail,47,29,0,11,36
80,Fail,48,24,2,15,33
80,Fail,58,20,0,10,48
80,Fail,42,30,5,19,23
80,Fail,51,29,0,11,40
80,Fail,46,29,0,16,30
80,Fail,42,32,4,10,32
80,Fail,45,40,0,5,40
80,Fail,48,24,4,11,37
80,Fail,36,30,11,17,19
80,Fail,50,24,4,12,38
80,Fail,49,27,1,8,41
80,Fail,52,20,3,13,39
80,Fail,42,32,0,16,26
80,Fail,47,24,2,16,31
80,Fail,49,36,0,7,42
80,Fail,49,30,0,10,39
80,Fail,47,30,1,11,36
80,Fail,54,25,0,8,46
80,Fail,48,32,5,7,41
80,Fail,45,24,6,18,27
80,Fail,51,20,0,14,37
80,Fail,46,33,0,11,35
80,Fail,50,24,4,11,39
80,Fail,55,23,0,13,42
80,Fail,45,33,0,16,29
80,Fail,51,28,1,10,41
80,Fail,54,24,0,7,47
80,Fail,45,38,0,8,37
80,Fail,48,26,3,15,33
80,Fail,51,29,0,10,41
80,Fail,51,21,4,13,38
80,Fail,44,39,0,11,33
80,Fail,43,24,5,19,24
80,Fail,51,23,7,13,38
80,Fail,50,24,4,13,37
80,Fail,52,20,1,11,41
80,Fail,58,20,6,8,50
80,Fail,52,23,0,15,37
80,Fail,46,26,5,14,32
80,Fail,54,20,2,9,45
80,Fail,38,32,0,17,21
80,Fail,49,22,5,15,34
80,Fail,48,19,11,16,32
80,Fail,48,24,0,19,29
80,Fail,45,27,4,12,33
80,Fail,51,27,2,9,42
80,Fail,51,30,0,10,41
80,Fail,46,26,8,13,33
80,Fail,45,28,0,14,31
80,Fail,52,24,5,12,40
80,Fail,44,29,1,13,31
80,Fail,42,36,0,12,30
80,Fail,53,26,0,7,46
80,Fail,47,21,0,16,31
80,Fail,47,16,8,20,27
80,Fail,45,27,5,11,34
80,Fail,58,19,0,10,48
80,Fail,51,25,0,15,36
80,Fail,57,17,0,10,47
80,Fail,52,17,1,17,35
80,Fail,49,30,0,7,42
80,Fail,48,21,1,17,31
80,Fail,50,25,3,8,42
80,Fail,49,19,1,19,30
80,Fail,51,26,0,9,42
80,Fail,43,33,0,14,29
80,Fail,50,22,11,10,40
80,Fail,46,26,1,12,34
80,Fail,47,31,0,15,32
80,Fail,51,22,8,12,39
80,Fail,53,21,4,12,41
80,Fail,51,22,1,15,36
80,Fail,46,23,7,15,31
80,Fail,43,34,0,15,28
80,Fail,43,22,10,14,29
80,Fail,44,25,0,17,27
80,Fail,47,32,0,9,38
80,Fail,52,24,0,12,40
80,Fail,58,19,2,11,47
80,Fail,46,31,0,8,38
80,Fail,47,28,3,14,33
80,Fail,53,25,3,8,45
80,Fail,53,21,3,8,45
80,Fail,43,37,0,11,32
80,Fail,40,32,0,18,22
80,Fail,48,33,0,7,41
80,Fail,61,16,4,7,54
80,Fail,50,24,1,15,35
80,Fail,51,24,1,11,40
80,Fail,45,21,7,18,27
80,Fail,45,37,0,7,38
80,Fail,44,24,0,20,24
80,Fail,40,32,8,12,28
80,Fail,47,30,2,9,38
80,Fail,47,24,11,6,41
80,Fail,48,28,6,16,32
80,Fail,40,25,4,22,18
80,Fail,48,30,0,12,36
80,Fail,51,23,0,16,35
80,Fail,50,25,0,15,35
80,Fail,46,28,2,13,33
80,Fail,53,21,4,12,41
80,Fail,48,19,5,17,31
80,Fail,42,29,0,20,22
80,Fail,52,28,0,11,41
80,Fail,47,27,3,14,33
80,Fail,54,20,3,13,41
80,Fail,49,28,2,11,38
80,Fail,48,30,0,13,35
80,Fail,41,33,0,13,28
80,Fail,55,24,0,10,45
80,Fail,47,28,5,13,34
80,Fail,54,19,7,13,41
80,Fail,48,19,5,18,30
80,Fail,42,36,0,12,30
80,Fail,47,24,1,17,30
80,Fail,53,27,0,13,40
80,Fail,50,28,0,13,37
80,Fail,46,30,2,14,32
80,Fail,48,30,0,11,37
80,Fail,49,26,0,14,35
80,Fail,51,37,0,8,43
80,Fail,47,24,4,16,31
80,Fail,48,24,2,12,36
80,Fail,46,32,0,12,34
80,Fail,42,31,4,13,29
80,Fail,52,33,0,7,45
80,Fail,46,30,1,16,30
80,Fail,48,27,3,9,39
80,Fail,46,26,5,14,32
80,Fail,44,40,0,8,36
80,Fail,51,21,7,11,40
80,Fail,56,20,0,14,42
80,Fail,47,24,0,14,33
80,Fail,43,26,6,15,28
80,Fail,57,25,0,8,49
80,Fail,51,23,3,14,37
80,Fail,43,27,8,12,31
80,Fail,45,28,0,20,25
80,Fail,53,20,0,15,38
80,Fail,45,36,0,10,35
80,Fail,44,32,0,13,31
80,Fail,58,21,0,10,48
80,Fail,56,22,0,12,44
80,Fail,49,24,1,15,34
80,Fail,42,33,6,11,31
80,Fail,53,22,0,13,40
80,Fail,48,33,0,10,38
80,Fail,54,24,2,6,48
80,Fail,39,28,1,17,22
80,Fail,50,25,1,10,40
80,Fail,48,31,0,13,35
80,Fail,46,25,3,13,33
80,Fail,46,32,4,8,38
80,Fail,49,27,0,11,38
80,Fail,43,38,0,8,35
80,Fail,47,34,0,11,36
80,Fail,51,27,0,11,40
80,Fail,37,43,0,11,26
80,Fail,41,29,6,15,26
80,Fail,51,26,0,11,40
80,Fail,47,31,0,12,35
80,Fail,50,31,0,9,41
80,Fail,41,36,0,14,27
80,Fail,47,26,3,11,36
80,Fail,45,29,0,13,32
80,Fail,53,25,3,11,42
80,Fail,50,23,3,12,38
80,Fail,43,33,0,15,28
80,Fail,49,24,0,15,34
80,Fail,49,24,6,9,40
80,Fail,54,26,2,5,49
80,Fail,51,29,0,10,41
80,Fail,43,26,10,11,32
80,Fail,40,30,3,14,26
80,Fail,49,18,2,20,29
80,Fail,54,27,0,9,45
80,Fail,49,25,0,17,32
80,Fail,56,22,1,11,45
80,Fail,45,27,2,11,34
80,Fail,44,33,0,13,31
80,Fail,45,33,0,7,38
80,Fail,50,30,0,12,38
80,Fail,46,33,0,11,35
80,Fail,50,23,0,14,36
80,Fail,46,30,0,12,34
80,Fail,49,25,0,11,38
80,Fail,51,21,4,9,42
80,Fail,46,23,1,16,30
80,Fail,49,23,1,14,35
80,Fail,49,24,4,12,37
80,Fail,42,38,0,11,31
80,Fail,46,30,0,14,32
80,Fail,53,21,1,13,40
80,Fail,45,24,9,16,29
80,Fail,46,24,0,13,33
80,Fail,53,25,3,9,44
80,Fail,52,32,0,8,44
80,Fail,48,27,6,14,34
80,Fail,47,23,0,21,26
80,Fail,43,39,0,12,31
80,Fail,52,22,4,10,42
80,Fail,49,24,0,15,34
80,Fail,42,36,0,14,28
80,Fail,51,32,0,9,42
80,Fail,39,38,0,9,30
80,Fail,46,25,1,15,31
80,Fail,50,32,0,10,40
80,Fail,45,22,4,16,29
80,Fail,51,22,11,8,43
80,Fail,43,32,0,13,30
80,Fail,47,25,6,14,33
80,Fail,49,28,3,8,41
80,Fail,45,30,3,14,31
80,Fail,42,20,11,17,25
80,Fail,56,18,3,11,45
80,Fail,47,26,1,14,33
80,Fail,49,32,0,9,40
80,Fail,45,20,6,14,31
80,Fail,53,26,0,11,42
80,Fail,43,42,0,8,35
80,Fail,51,25,1,9,42
80,Fail,55,19,5,13,42
80,Fail,48,24,5,14,34
80,Fail,44,36,0,12,32
80,Fail,43,34,0,13,30
80,Fail,47,28,0,10,37
80,Fail,45,33,0,10,35
80,Fail,56,25,0,8,48
80,Fail,53,21,2,11,42
80,Fail,50,22,5,11,39
80,Fail,48,28,0,15,33
80,Fail,48,31,0,12,36
80,Fail,44,35,0,14,30
80,Fail,48,31,2,10,38
80,Fail,57,25,0,7,50
80,Fail,44,34,0,13,31
80,Fail,46,27,5,10,36
80,Fail,53,26,2,10,43
80,Fail,45,27,0,14,31
80,Fail,42,27,1,19,23
80,Fail,58,21,0,10,48
80,Fail,46,29,0,14,32
80,Fail,47,26,1,11,36
80,Fail,56,31,0,9,47
80,Fail,43,23,7,18,25
80,Fail,49,26,0,17,32
80,Fail,54,22,0,11,43
80,Fail,48,30,0,11,37
80,Fail,47,24,0,17,30
80,Fail,45,25,2,12,33
80,Fail,44,34,0,16,28
80,Fail,48,28,0,13,35
80,Fail,43,30,0,16,27
80,Fail,48,27,0,15,33
80,Fail,41,29,3,15,26
80,Fail,47,28,3,9,38
80,Fail,56,26,0,7,49
80,Fail,54,24,8,6,48
80,Fail,46,30,0,14,32
80,Fail,42,31,0,15,27
80,Fail,56,26,0,9,47
80,Fail,49,22,2,13,36
80,Fail,60,18,2,12,48
80,Fail,48,17,4,22,26
80,Fail,43,30,7,8,35
80,Fail,56,24,4,5,51
80,Fail,49,21,10,11,38
80,Fail,54,20,2,13,41
80,Fail,60,22,0,10,50
80,Fail,39,36,3,12,27
80,Fail,47,31,5,9,38
80,Fail,52,31,4,6,46
80,Fail,43,26,7,13,30
80,Fail,48,26,2,15,33
80,Fail,42,28,0,15,27
80,Fail,53,27,0,8,45
80,Fail,46,22,6,18,28
80,Fail,47,35,0,12,35
80,Fail,49,26,0,14,35
80,Fail,42,38,0,10,32
80,Fail,51,32,0,10,41
80,Fail,50,20,6,14,36
80,Fail,48,30,0,16,32
80,Fail,47,25,7,11,36
80,Fail,50,29,0,12,38
80,Fail,51,27,0,13,38
80,Fail,42,33,3,15,27
80,Fail,45,21,7,16,29
80,Fail,45,30,4,14,31
80,Fail,43,27,0,19,24
80,Fail,45,30,3,10,35
80,Fail,49,27,0,11,38
80,Fail,45,29,0,17,28
80,Fail,51,24,0,14,37
80,Fail,45,29,0,15,30
80,Fail,49,27,0,14,35
80,Fail,43,32,2,12,31
80,Fail,41,27,1,20,21
80,Fail,45,38,0,8,37
80,Fail,43,26,0,17,26
80,Fail,46,29,0,17,29
80,Fail,46,33,1,6,40
80,Fail,50,29,1,9,41
80,Fail,53,24,0,12,41
80,Fail,54,23,0,12,42
80,Fail,42,40,0,11,31
80,Fail,56,25,2,8,48
80,Fail,54,23,0,13,41
80,Fail,49,17,6,12,37
80,Fail,44,35,0,11,33
80,Fail,50,25,3,14,36
80,Fail,56,27,0,13,43
80,Fail,57,25,0,8,49
80,Fail,48,27,0,15,33
80,Fail,53,24,5,6,47
80,Fail,48,26,8,12,36
80,Fail,52,30,0,10,42
80,Fail,52,26,0,10,42
80,Fail,46,25,2,13,33
80,Fail,45,22,0,19,26
80,Fail,49,28,0,14,35
80,Fail,53,26,2,10,43
80,Fail,50,19,7,13,37
80,Fail,46,27,0,13,33
80,Fail,50,28,0,8,42
80,Fail,46,24,0,14,32
80,Fail,50,28,3,11,39
80,Fail,44,26,0,21,23
80,Fail,40,39,0,13,27
80,Fail,44,27,0,19,25
80,Fail,50,30,0,13,37
80,Fail,52,24,0,10,42
80,Fail,56,23,1,8,48
80,Fail,45,33,2,10,35
80,Fail,46,29,0,14,32
80,Fail,44,22,6,15,29
80,Fail,50,22,0,11,39
80,Fail,58,17,3,10,48
80,Fail,56,22,0,10,46
80,Fail,46,30,0,14,32
80,Fail,50,24,0,12,38
80,Fail,42,35,0,14,28
80,Fail,49,31,0,12,37
80,Fail,46,31,0,11,35
80,Fail,51,24,3,12,39
80,Fail,48,31,0,13,35
80,Fail,40,27,7,16,24
80,Fail,45,18,11,15,30
80,Fail,48,27,3,14,34
80,Fail,44,26,0,19,25
80,Fail,48,20,0,21,27
80,Fail,50,21,8,12,38
80,Fail,44,28,2,18,26
80,Fail,52,25,0,10,42
80,Fail,49,27,5,10,39
80,Fail,49,27,4,11,38
80,Fail,44,23,0,21,23
80,Fail,48,26,0,15,33
80,Fail,50,24,2,11,39
80,Fail,52,26,0,12,40
80,Fail,54,21,7,12,42
80,Fail,52,33,0,6,46
80,Fail,45,29,2,12,33
80,Fail,51,26,0,16,35
80,Fail,52,15,11,11,41
80,Fail,55,24,0,12,43
80,Fail,39,29,2,18,21
80,Fail,47,23,4,12,35
80,Fail,43,24,1,18,25
80,Fail,55,20,0,12,43
80,Fail,39,25,13,19,20
80,Fail,47,25,3,15,32
80,Fail,39,33,8,14,25
80,Fail,49,19,6,14,35
80,Fail,45,30,2,12,33
80,Fail,55,25,0,10,45
80,Fail,54,22,0,14,40
80,Fail,46,36,0,10,36
80,Fail,56,20,1,13,43
80,Fail,43,38,0,14,29
80,Fail,44,31,2,13,31
80,Fail,49,26,0,13,36
80,Fail,49,29,0,11,38
80,Fail,52,21,4,13,39
80,Fail,53,28,3,7,46
80,Fail,50,33,0,7,43
80,Fail,50,23,0,14,36
80,Fail,52,21,1,16,36
80,Fail,52,20,2,13,39
80,Fail,38,32,4,17,21
80,Fail,50,26,2,9,41
80,Fail,50,21,7,9,41
80,Fail,54,23,0,13,41
80,Fail,44,30,4,12,32
80,Fail,48,30,0,7,41
80,Fail,50,28,3,9,41
80,Fail,51,30,0,9,42
80,Fail,47,28,3,9,38
80,Fail,49,27,0,14,35
80,Fail,53,22,0,14,39
80,Fail,49,27,0,12,37
80,Fail,44,36,0,11,33
80,Fail,45,26,9,10,35
80,Fail,39,35,0,16,23
80,Fail,46,26,3,15,31
80,Fail,40,37,0,11,29
80,Fail,42,32,0,13,29
80,Fail,48,21,5,16,32
80,Fail,44,27,5,15,29
80,Fail,49,29,0,13,36
80,Fail,48,24,3,10,38
80,Fail,49,29,0,12,37
80,Fail,44,27,0,13,31
80,Fail,44,28,0,17,27
80,Fail,43,28,9,9,34
80,Fail,49,24,0,14,35
80,Fail,38,30,8,12,26
80,Fail,42,31,7,10,32
80,Fail,46,17,6,17,29
80,Fail,45,23,0,19,26
80,Fail,53,25,0,12,41
80,Fail,55,25,0,8,47
80,Fail,53,22,2,11,42
80,Fail,50,26,0,15,35
80,Fail,47,16,0,22,25
80,Fail,51,20,0,18,33
80,Fail,48,22,7,14,34
80,Fail,51,20,1,14,37
80,Fail,44,29,0,17,27
80,Fail,53,28,0,12,41
80,Fail,47,30,1,11,36
80,Fail,46,24,0,17,29
80,Fail,42,31,3,15,27
80,Fail,46,24,0,20,26
80,Fail,50,24,9,10,40
80,Fail,42,42,0,12,30
80,Fail,46,33,0,14,32
80,Fail,53,25,0,14,39
80,Fail,45,23,9,13,32
80,Fail,44,23,2,20,24
80,Fail,53,26,0,9,44
80,Fail,51,19,7,9,42
80,Fail,53,16,2,16,37
80,Fail,51,16,7,16,35
80,Fail,44,30,2,14,30
80,Fail,48,17,7,14,34
80,Fail,57,20,0,13,44
80,Fail,44,25,2,18,26
80,Fail,47,29,0,11,36
80,Fail,46,32,0,12,34
80,Fail,51,22,0,13,38
80,Fail,49,35,0,6,43
80,Fail,49,23,9,12,37
80,Fail,51,22,4,11,40
80,Fail,51,24,2,13,38
80,Fail,50,29,0,7,43
80,Fail,52,28,0,13,39
80,Fail,45,24,1,18,27
80,Fail,48,24,0,15,33
80,Fail,47,31,3,7,40
80,Fail,51,31,0,6,45
80,Fail,42,33,0,12,30
80,Fail,52,29,1,8,44
80,Fail,54,22,0,9,45
80,Fail,48,16,2,20,28
80,Fail,46,21,3,17,29
80,Fail,52,25,3,7,45
80,Fail,47,25,4,16,31
80,Fail,43,27,4,16,27
80,Fail,44,21,13,13,31
80,Fail,46,24,3,15,31
80,Fail,45,27,7,15,30
80,Fail,48,29,7,7,41
80,Fail,47,27,0,13,34
80,Fail,42,30,9,9,33
80,Fail,41,38,0,14,27
80,Fail,42,37,0,14,28
80,Fail,54,21,0,13,41
80,Fail,51,25,1,8,43
80,Fail,53,20,0,16,37
80,Fail,46,31,2,12,34
80,Fail,48,23,3,19,29
80,Fail,57,19,1,13,44
80,Fail,50,23,1,13,37
80,Fail,54,24,0,9,45
80,Fail,54,23,2,10,44
80,Fail,51,20,3,11,40
80,Fail,48,26,0,14,34
80,Fail,46,27,1,13,33
80,Fail,47,33,0,11,36
80,Fail,54,28,0,10,44
80,Fail,53,21,0,11,42
80,Fail,42,31,2,12,30
80,Fail,47,27,0,14,33
80,Fail,46,30,0,12,34
80,Fail,41,40,0,11,30
80,Fail,51,27,0,11,40
80,Fail,50,24,0,17,33
80,Fail,45,39,0,13,32
80,Fail,44,27,0,13,31
80,Fail,50,25,0,13,37
80,Fail,53,25,0,8,45
80,Fail,47,35,0,7,40
80,Fail,47,22,4,13,34
80,Fail,51,20,4,11,40
80,Fail,49,26,0,16,33
80,Fail,51,24,6,11,40
80,Fail,46,31,0,14,32
80,Fail,49,30,0,11,38
80,Fail,49,31,0,13,36
80,Fail,42,33,0,16,26
80,Fail,36,33,6,16,20
80,Fail,51,28,0,10,41
80,Fail,47,31,0,14,33
80,Fail,46,28,0,16,30
80,Fail,43,31,1,13,30
80,Fail,46,33,0,13,33
80,Fail,50,21,4,14,36
80,Fail,52,28,0,11,41
80,Fail,54,21,4,10,44
80,Fail,50,28,0,7,43
80,Fail,52,24,4,9,43
80,Fail,53,15,0,20,33
80,Fail,50,20,3,17,33
80,Fail,50,22,0,15,35
80,Fail,51,21,0,11,40
80,Fail,51,22,9,7,44
80,Fail,48,26,2,12,36
80,Fail,54,23,3,10,44
80,Fail,50,25,0,15,35
80,Fail,57,23,2,7,50
80,Fail,47,30,0,13,34
80,Fail,50,28,0,12,38
80,Fail,49,28,9,7,42
80,Fail,51,23,0,11,40
80,Fail,52,20,0,13,39
80,Fail,46,37,0,10,36
80,Fail,48,26,3,11,37
80,Fail,41,38,0,14,27
80,Fail,52,22,0,16,36
80,Fail,46,35,0,14,32
80,Fail,58,20,0,14,44
80,Fail,52,27,0,10,42
80,Fail,38,37,4,12,26
80,Fail,48,26,0,12,36
80,Fail,49,32,0,9,40
80,Fail,52,21,2,16,36
80,Fail,44,35,0,12,32
80,Fail,40,42,0,8,32
80,Fail,51,27,6,7,44
80,Fail,54,20,2,13,41
80,Fail,42,28,4,14,28
80,Fail,47,33,0,11,36
80,Fail,56,19,0,8,48
80,Fail,41,35,0,12,29
80,Fail,49,28,4,10,39
80,Fail,52,25,4,11,41
80,Fail,47,24,0,14,33
80,Fail,46,37,0,8,38
80,Fail,49,22,0,13,36
80,Fail,44,24,4,14,30
80,Fail,44,32,0,10,34
80,Fail,47,29,3,8,39
80,Fail,55,20,4,14,41
80,Fail,44,24,12,11,33
80,Fail,48,24,1,12,36
80,Fail,47,35,0,12,35
80,Fail,50,32,0,12,38
80,Fail,43,33,0,16,27
80,Fail,45,27,0,17,28
80,Fail,45,26,7,13,32
80,Fail,46,36,0,9,37
80,Fail,50,23,4,13,37
80,Fail,46,21,10,17,29
80,Fail,49,26,0,11,38
80,Fail,52,27,7,4,48
80,Fail,41,31,7,13,28
80,Fail,49,25,0,11,38
80,Fail,49,30,2,10,39
80,Fail,46,35,0,12,34
80,Fail,50,27,1,12,38
80,Fail,38,43,0,12,26
80,Fail,49,30,0,16,33
80,Fail,41,34,0,9,32
80,Fail,52,19,14,8,44
80,Fail,50,25,0,17,33
80,Fail,48,16,8,18,30
80,Fail,51,17,4,18,33
80,Fail,48,22,5,14,34
80,Fail,56,19,2,9,47
80,Fail,58,27,0,7,51
80,Fail,50,20,2,15,35
80,Fail,49,22,6,12,37
80,Fail,48,28,0,13,35
80,Fail,46,24,5,12,34
80,Fail,42,29,4,18,24
80,Fail,51,28,0,10,41
80,Fail,46,26,0,16,30
80,Fail,52,19,9,13,39
80,Fail,48,23,4,14,34
80,Fail,47,29,2,14,33
80,Fail,57,17,0,14,43
80,Fail,44,24,9,13,31
80,Fail,49,28,0,13,36
80,Fail,52,24,4,11,41
80,Fail,50,23,1,15,35
80,Fail,47,30,0,9,38
80,Fail,57,23,0,11,46
80,Fail,46,36,0,12,34
80,Fail,57,19,8,9,48
80,Fail,45,24,0,22,23
80,Fail,40,35,4,13,27
80,Fail,51,23,4,9,42
80,Fail,45,38,0,7,38
80,Fail,58,22,1,9,49
80,Fail,52,22,6,10,42
80,Fail,45,31,0,17,28
80,Fail,44,24,6,14,30
80,Fail,44,25,3,16,28
80,Fail,47,31,0,12,35
80,Fail,57,17,0,11,46
80,Fail,50,21,0,16,34
80,Fail,56,21,0,10,46
80,Fail,46,26,5,11,35
80,Fail,52,27,1,10,42
80,Fail,42,33,0,11,31
80,Fail,46,35,0,9,37
80,Fail,53,16,8,10,43
80,Fail,48,30,0,9,39
80,Fail,43,27,7,12,31
80,Fail,41,34,0,11,30
80,Fail,46,29,0,12,34
80,Fail,39,35,6,12,27
80,Fail,39,34,0,17,22
80,Fail,47,30,0,16,31
80,Fail,51,23,3,12,39
80,Fail,43,25,9,13,30
80,Fail,56,25,0,8,48
80,Fail,48,31,0,13,35
80,Fail,54,24,0,14,40
80,Fail,50,24,4,13,37
80,Fail,50,21,0,17,33
80,Fail,54,20,0,9,45
80,Fail,49,28,0,9,40
80,Fail,48,28,0,14,34
80,Fail,47,28,0,14,33
80,Fail,50,22,4,15,35
80,Fail,42,28,7,13,29
80,Fail,42,30,0,18,24
80,Fail,49,26,0,15,34
80,Fail,51,28,0,10,41
80,Fail,57,17,1,13,44
80,Fail,50,29,0,8,42
80,Fail,48,20,7,14,34
80,Fail,44,36,2,8,36
80,Fail,47,36,0,10,37
80,Fail,48,19,2,19,29
80,Fail,46,33,0,12,34
80,Fail,44,35,0,12,32
80,Fail,47,29,0,13,34
80,Fail,45,41,0,8,37
80,Fail,47,32,0,8,39
80,Fail,49,33,0,8,41
80,Fail,50,34,0,5,45
80,Fail,46,27,5,11,35
80,Fail,44,25,5,13,31
80,Fail,42,26,6,13,29
80,Fail,44,22,2,19,25
80,Fail,39,30,9,12,27
80,Fail,47,27,0,13,34
80,Fail,50,24,0,13,37
80,Fail,49,27,3,9,40
80,Fail,52,17,5,13,39
80,Fail,45,24,6,14,31
80,Fail,48,32,0,11,37
80,Fail,45,26,5,10,35
80,Fail,48,33,0,12,36
80,Fail,54,21,0,9,45
80,Fail,36,33,9,16,20
80,Fail,48,30,0,11,37
80,Fail,46,32,0,12,34
80,Fail,54,24,5,10,44
80,Fail,50,23,3,12,38
80,Fail,40,30,0,18,22
80,Fail,47,36,0,8,39
80,Fail,46,27,2,14,32
80,Fail,51,25,0,8,43
80,Fail,44,40,0,11,33
80,Fail,43,28,0,17,26
80,Fail,53,29,4,5,48
80,Fail,52,25,4,9,43
80,Fail,47,24,1,19,28
80,Fail,43,37,0,11,32
80,Fail,47,29,0,9,38
80,Fail,44,33,0,10,34
80,Fail,47,22,11,13,34
80,Fail,43,42,0,10,33
80,Fail,46,19,9,15,31
80,Fail,55,20,0,13,42
80,Fail,52,19,3,13,39
80,Fail,41,25,5,18,23
80,Fail,42,34,0,15,27
80,Fail,53,25,2,11,42
80,Fail,42,23,6,17,25
80,Fail,49,22,8,12,37
80,Fail,52,23,1,12,40
80,Fail,57,27,1,8,49
80,Fail,50,23,2,14,36
80,Fail,48,20,12,14,34
80,Fail,50,26,0,13,37
80,Fail,41,40,0,10,31
80,Fail,43,29,3,12,31
80,Fail,50,32,5,9,41
80,Fail,49,24,3,15,34
80,Fail,46,29,9,9,37
80,Fail,42,30,4,14,28
80,Fail,37,35,0,18,19
80,Fail,46,28,0,16,30
80,Fail,51,24,3,9,42
80,Fail,47,28,0,16,31
80,Fail,50,25,8,10,40
80,Fail,50,20,2,16,34
80,Fail,42,31,0,13,29
80,Fail,54,22,4,9,45
80,Fail,48,35,0,9,39
80,Fail,49,33,0,8,41
80,Fail,52,22,0,16,36
80,Fail,48,30,3,10,38
80,Fail,46,25,8,14,32
80,Fail,48,22,4,15,33
80,Fail,52,23,0,13,39
80,Fail,48,32,0,10,38
80,Fail,45,22,3,18,27
80,Fail,49,29,0,12,37
80,Fail,49,26,1,16,33
80,Fail,46,30,3,11,35
80,Fail,46,19,10,18,28
80,Fail,44,22,2,17,27
80,Fail,47,32,2,6,41
80,Fail,51,27,0,14,37
80,Fail,49,32,0,7,42
80,Fail,49,23,4,14,35
80,Fail,46,26,4,15,31
80,Fail,46,29,5,14,32
80,Fail,48,29,0,13,35
80,Fail,45,27,0,19,26
80,Fail,47,24,0,20,27
80,Fail,44,32,5,10,34
80,Fail,47,28,0,15,32
80,Fail,48,31,6,6,42
80,Fail,44,37,0,9,35
80,Fail,47,30,4,12,35
80,Fail,47,35,0,10,37
80,Fail,52,21,3,15,37
80,Fail,49,25,0,12,37
80,Fail,52,21,5,9,43
80,Fail,58,23,0,12,46
80,Fail,46,25,1,15,31
80,Fail,50,30,0,9,41
80,Fail,50,25,2,12,38
80,Fail,50,33,0,7,43
80,Fail,44,29,4,13,31
80,Fail,45,30,0,16,29
80,Fail,55,27,0,7,48
80,Fail,51,16,2,18,33
80,Fail,46,28,8,11,35
80,Fail,45,34,0,10,35
80,Fail,45,32,0,11,34
80,Fail,51,26,1,15,36
80,Fail,49,18,0,19,30
80,Fail,44,27,6,14,30
80,Fail,48,28,0,14,34
80,Fail,49,25,0,14,35
80,Fail,35,41,0,16,19
80,Fail,47,29,0,13,34
80,Fail,48,27,0,14,34
80,Fail,55,22,2,7,48
80,Fail,44,27,4,15,29
80,Fail,47,28,5,10,37
80,Fail,49,19,3,14,35
80,Fail,54,20,0,13,41
80,Fail,48,26,0,18,30
80,Fail,47,26,8,11,36
80,Fail,49,29,0,15,34
80,Fail,53,27,4,8,45
80,Fail,59,23,0,4,55
80,Fail,43,38,0,11,32
80,Fail,52,27,0,11,41
80,Fail,54,25,2,6,48
80,Fail,54,29,0,9,45
80,Fail,49,23,6,12,37
80,Fail,49,21,6,12,37
80,Fail,50,23,0,15,35
80,Fail,47,25,2,12,35
80,Fail,48,25,3,14,34
80,Fail,46,34,0,10,36
80,Fail,43,35,0,14,29
80,Fail,52,26,0,9,43
80,Fail,43,36,0,16,27
80,Fail,54,19,1,19,35
80,Fail,49,21,9,15,34
80,Fail,49,29,0,14,35
80,Fail,45,25,9,11,34
80,Fail,47,34,0,11,36
80,Fail,46,36,0,11,35
80,Fail,51,34,0,7,44
80,Fail,39,38,0,13,26
80,Fail,42,33,0,13,29
80,Fail,40,32,0,17,23
80,Fail,54,15,2,19,35
80,Fail,40,27,10,18,22
80,Fail,38,29,12,15,23
80,Fail,53,22,0,16,37
80,Fail,52,17,6,12,40
80,Fail,45,35,0,11,34
80,Fail,48,30,0,12,36
80,Fail,42,30,0,19,23
80,Fail,44,25,9,14,30
80,Fail,54,23,1,8,46
80,Fail,53,26,6,5,48
80,Fail,51,22,0,11,40
80,Fail,54,21,0,16,38
80,Fail,46,32,0,11,35
80,Fail,42,23,9,15,27
80,Fail,43,28,3,13,30
80,Fail,47,34,0,10,37
80,Fail,56,13,3,16,40
80,Fail,50,29,2,9,41
80,Fail,44,24,7,12,32
80,Fail,46,27,0,16,30
80,Fail,63,13,5,8,55
80,Fail,46,27,2,12,34
80,Fail,55,22,3,12,43
80,Fail,53,24,3,10,43
80,Fail,53,22,0,12,41
80,Fail,47,29,0,17,30
80,Fail,52,35,0,7,45
80,Fail,46,27,5,14,32
80,Fail,57,18,0,9,48
80,Fail,50,33,0,9,41
80,Fail,45,37,0,9,36
80,Fail,53,22,0,13,40
80,Fail,40,28,6,18,22
80,Fail,49,29,0,11,38
80,Fail,50,24,3,14,36
80,Fail,44,27,6,13,31
80,Fail,48,29,0,13,35
80,Fail,44,31,7,6,38
80,Fail,47,31,0,13,34
80,Fail,39,34,1,13,26
80,Fail,43,34,0,11,32
80,Fail,53,21,0,10,43
80,Fail,48,25,4,14,34
80,Fail,44,31,1,12,32
80,Fail,54,18,4,12,42
80,Fail,50,31,0,10,40
80,Fail,51,25,0,13,38
80,Fail,52,29,0,8,44
80,Fail,52,24,0,9,43
80,Fail,48,26,0,16,32
80,Fail,53,23,0,10,43
80,Fail,50,30,0,11,39
80,Fail,47,32,0,10,37
80,Fail,51,22,0,13,38
80,Fail,38,36,0,17,21
80,Fail,43,32,0,12,31
80,Fail,45,25,6,16,29
80,Fail,50,29,0,10,40
80,Fail,46,27,1,12,34
80,Fail,51,23,0,13,38
80,Fail,47,22,0,17,30
80,Fail,49,27,1,10,39
80,Fail,50,27,0,11,39
80,Fail,39,39,0,13,26
80,Fail,54,24,3,13,41
80,Fail,41,39,0,12,29
80,Fail,50,24,4,15,35
80,Fail,51,23,6,11,40
80,Fail,48,28,0,14,34
80,Fail,56,21,1,8,48
80,Fail,52,26,0,10,42
80,Fail,54,25,0,12,42
80,Fail,45,30,0,12,33
80,Fail,54,22,0,11,43
80,Fail,44,35,0,10,34
80,Fail,50,23,5,11,39
80,Fail,50,27,0,13,37
80,Fail,59,16,3,13,46
80,Fail,44,28,0,16,28
80,Fail,47,33,0,13,34
80,Fail,51,27,0,12,39
80,Fail,45,29,4,12,33
80,Fail,52,21,0,12,40
80,Fail,45,24,0,17,28
80,Fail,47,22,5,11,36
80,Fail,43,26,9,15,28
80,Fail,35,30,1,22,13
80,Fail,53,17,7,14,39
80,Fail,45,34,0,16,29
80,Fail,56,26,0,7,49
80,Fail,50,29,2,9,41
80,Fail,51,26,2,11,40
80,Fail,45,32,0,8,37
80,Fail,56,23,6,7,49
80,Fail,46,33,0,13,33
80,Fail,48,27,0,16,32
80,Fail,47,37,0,8,39
80,Fail,45,27,0,15,30
80,Fail,44,37,0,12,32
80,Fail,54,24,0,11,43
80,Fail,42,34,5,10,32
80,Fail,49,25,5,14,35
80,Fail,46,20,10,13,33
80,Fail,47,28,3,11,36
80,Fail,49,24,1,13,36
80,Fail,44,32,0,13,31
80,Fail,49,24,2,12,37
80,Fail,49,25,0,11,38
80,Fail,48,25,9,13,35
80,Fail,43,22,6,15,28
80,Fail,48,18,4,16,32
80,Fail,48,26,1,14,34
80,Fail,46,27,1,13,33
80,Fail,48,34,0,7,41
80,Fail,51,25,0,9,42
80,Fail,43,36,0,15,28
80,Fail,48,26,0,12,36
80,Fail,41,34,0,17,24
80,Fail,41,34,0,18,23
80,Fail,47,32,0,10,37
80,Fail,57,15,3,15,42
80,Fail,48,26,0,10,38
80,Fail,49,25,0,12,37
80,Fail,55,20,5,9,46
80,Fail,52,27,0,9,43
80,Fail,47,29,0,9,38
80,Fail,42,33,0,16,26
80,Fail,47,27,6,12,35
80,Fail,37,29,6,20,17
80,Fail,42,28,3,15,27
80,Fail,50,28,0,16,34
80,Fail,43,34,3,10,33
80,Fail,53,28,1,9,44
80,Fail,49,26,7,9,40
80,Fail,47,29,0,12,35
80,Fail,45,32,0,15,30
80,Fail,42,41,0,8,34
80,Fail,54,16,0,17,37
80,Fail,51,26,2,6,45
80,Fail,41,23,6,19,22
80,Fail,55,27,0,6,49
80,Fail,54,25,0,9,45
80,Fail,56,25,0,7,49
80,Fail,44,34,0,13,31
80,Fail,48,26,5,12,36
80,Fail,43,29,5,11,32
80,Fail,48,27,0,15,33
80,Fail,52,18,7,15,37
80,Fail,52,26,0,12,40
80,Fail,45,31,0,12,33
80,Fail,49,31,0,11,38
80,Fail,51,24,6,5,46
80,Fail,42,32,0,14,28
80,Fail,50,26,0,13,37
80,Fail,45,28,5,11,34
80,Fail,44,35,0,12,32
80,Fail,48,38,0,8,40
80,Fail,50,23,5,11,39
80,Fail,57,23,0,7,50
80,Fail,50,28,1,10,40
80,Fail,47,25,0,15,32
80,Fail,35,38,6,13,22
80,Fail,49,28,0,13,36
80,Fail,52,24,3,10,42
80,Fail,52,18,0,15,37
80,Fail,48,25,2,12,36
80,Fail,47,29,0,15,32
80,Fail,58,21,0,10,48
80,Fail,51,24,0,15,36
80,Fail,50,23,1,11,39
80,Fail,54,20,0,16,38
80,Fail,41,30,8,13,28
80,Fail,48,29,0,12,36
80,Fail,51,24,0,14,37
80,Fail,52,29,0,12,40
80,Fail,49,25,2,12,37
80,Fail,49,27,2,10,39
80,Fail,54,23,1,10,44
80,Fail,45,27,1,15,30
80,Fail,43,42,0,9,34
80,Fail,51,24,3,9,42
80,Fail,47,25,8,13,34
80,Fail,47,23,7,12,35
80,Fail,39,36,0,19,20
80,Fail,49,23,2,14,35
80,Fail,41,27,8,16,25
80,Fail,46,32,0,11,35
80,Fail,48,35,0,9,39
80,Fail,51,19,0,16,35
80,Fail,44,25,0,21,23
80,Fail,54,19,0,16,38
80,Fail,46,23,9,16,30
80,Fail,45,31,0,12,33
80,Fail,50,28,9,8,42
80,Fail,46,29,0,14,32
80,Fail,51,30,3,9,42
80,Fail,53,21,0,8,45
80,Fail,47,37,0,9,38
80,Fail,52,20,1,10,42
80,Fail,48,24,0,13,35
80,Fail,44,25,7,14,30
80,Fail,48,31,0,9,39
80,Fail,47,29,0,11,36
80,Fail,48,34,0,10,38
80,Fail,52,18,9,15,37
80,Fail,55,22,2,9,46
80,Fail,49,29,0,13,36
80,Fail,58,24,0,7,51
80,Fail,51,26,1,13,38
80,Fail,45,32,0,13,32
80,Fail,56,22,7,4,52
80,Fail,45,27,2,11,34
80,Fail,54,25,0,12,42
80,Fail,37,39,0,18,19
80,Fail,48,23,6,13,35
80,Fail,44,31,9,6,38
80,Fail,48,32,0,15,33
80,Fail,57,16,4,14,43
80,Fail,41,26,7,14,27
80,Fail,54,22,0,12,42
80,Fail,47,34,0,11,36
80,Fail,55,20,2,12,43
80,Fail,53,27,0,12,41
80,Fail,50,24,0,14,36
80,Fail,59,18,0,8,51
80,Fail,48,27,5,9,39
80,Fail,56,24,0,8,48
80,Fail,52,24,2,9,43
80,Fail,56,21,0,11,45
80,Fail,54,18,3,13,41
80,Fail,47,23,7,13,34
80,Fail,53,22,1,13,40
80,Fail,53,17,0,16,37
80,Fail,43,30,0,15,28
80,Fail,48,32,0,15,33
80,Fail,50,27,0,16,34
80,Fail,42,33,0,15,27
80,Fail,39,38,0,14,25
80,Fail,45,31,3,11,34
80,Fail,45,24,0,15,30
80,Fail,46,21,5,15,31
80,Fail,47,20,6,13,34
80,Fail,47,32,2,10,37
80,Fail,50,26,1,15,35
80,Fail,55,25,0,9,46
80,Fail,47,18,0,22,25
80,Fail,54,20,1,15,39
80,Fail,56,19,0,15,41
80,Fail,56,16,2,10,46
80,Fail,44,31,3,10,34
80,Fail,50,26,3,13,37
80,Fail,46,25,8,11,35
80,Fail,52,31,0,6,46
80,Fail,44,27,3,14,30
80,Fail,45,29,2,10,35
80,Fail,45,32,0,16,29
80,Fail,47,33,0,14,33
80,Fail,50,21,4,13,37
80,Fail,43,22,2,21,22
80,Fail,38,33,0,17,21
80,Fail,51,26,1,9,42
80,Fail,56,19,8,8,48
80,Fail,43,39,0,13,30
80,Fail,44,32,5,10,34
80,Fail,57,22,2,7,50
80,Fail,43,36,0,11,32
80,Fail,51,25,3,12,39
80,Fail,51,21,4,15,36
80,Fail,47,23,2,15,32
80,Fail,52,22,0,17,35
80,Fail,45,36,0,10,35
80,Fail,49,25,1,12,37
80,Fail,44,28,0,15,29
80,Fail,52,28,0,12,40
80,Fail,43,35,0,16,27
80,Fail,48,29,2,8,40
80,Fail,45,29,0,20,25
80,Fail,52,20,3,12,40
80,Fail,46,32,0,8,38
80,Fail,47,28,0,14,33
80,Fail,52,28,0,12,40
80,Fail,51,30,0,14,37
80,Fail,44,33,0,16,28
80,Fail,50,24,0,14,36
80,Fail,49,26,1,12,37
80,Fail,55,26,1,10,45
80,Fail,46,31,0,14,32
80,Fail,41,35,0,17,24
80,Fail,42,31,8,12,30
80,Fail,43,19,6,19,24
80,Fail,49,24,8,12,37
80,Fail,48,18,7,12,36
80,Fail,35,42,0,16,19
80,Fail,47,31,0,13,34
80,Fail,51,23,1,14,37
80,Fail,47,23,3,15,32
80,Fail,52,21,4,12,40
80,Fail,51,32,0,9,42
80,Fail,36,34,8,16,20
80,Fail,43,38,0,10,33
80,Fail,45,27,2,13,32
80,Fail,46,25,0,19,27
80,Fail,41,32,0,17,24
80,Fail,49,20,0,17,32
80,Fail,50,21,0,14,36
80,Fail,51,30,0,8,43
80,Fail,48,28,0,17,31
80,Fail,43,32,8,12,31
80,Fail,49,23,0,14,35
80,Fail,46,27,7,8,38
80,Fail,55,22,0,11,44
80,Fail,46,27,2,14,32
80,Fail,45,35,0,13,32
80,Fail,49,25,2,12,37
80,Fail,52,21,0,15,37
80,Fail,44,32,9,10,34
80,Fail,51,29,3,9,42
80,Fail,39,31,3,16,23
80,Fail,52,27,0,11,41
80,Fail,45,23,0,20,25
80,Fail,44,28,1,13,31
80,Fail,53,21,3,14,39
80,Fail,44,37,0,7,37
80,Fail,50,26,2,12,38
80,Fail,58,21,2,9,49
80,Fail,44,26,8,15,29
80,Fail,44,33,0,16,28
80,Fail,56,24,2,8,48
80,Fail,50,28,0,11,39
80,Fail,48,21,5,16,32
80,Fail,47,20,0,18,29
80,Fail,40,31,5,16,24
80,Fail,58,22,2,10,48
80,Fail,48,30,1,11,37
80,Fail,44,33,0,12,32
80,Fail,50,20,0,16,34
80,Fail,47,34,0,13,34
80,Fail,52,23,1,10,42
80,Fail,51,29,0,9,42
80,Fail,49,29,0,13,36
80,Fail,50,26,0,12,38
80,Fail,40,28,12,13,27
80,Fail,45,32,0,15,30
80,Fail,45,30,2,12,33
80,Fail,48,23,7,13,35
80,Fail,49,30,0,11,38
80,Fail,55,26,0,8,47
80,Fail,50,22,2,13,37
80,Fail,57,22,0,9,48
80,Fail,57,25,0,8,49
80,Fail,49,28,3,11,38
80,Fail,46,33,0,11,35
80,Fail,51,22,4,13,38
80,Fail,45,26,8,11,34
80,Fail,46,34,0,12,34
80,Fail,50,27,0,9,41
80,Fail,46,25,0,14,32
80,Fail,37,40,0,15,22
80,Fail,50,24,0,13,37
80,Fail,49,18,9,14,35
80,Fail,48,23,5,14,34
80,Fail,45,29,1,9,36
80,Fail,46,22,3,13,33
80,Fail,44,28,0,17,27
80,Fail,57,20,0,8,49
80,Fail,44,28,0,16,28
80,Fail,52,22,1,13,39
80,Fail,45,27,10,12,33
80,Fail,47,32,0,11,36
80,Fail,43,29,0,15,28
80,Fail,52,16,0,15,37
80,Fail,49,31,0,10,39
80,Fail,43,26,5,16,27
80,Fail,42,28,0,19,23
80,Fail,49,30,0,14,35
80,Fail,43,26,1,20,23
80,Fail,51,25,0,10,41
80,Fail,44,32,0,15,29
80,Fail,55,19,1,11,44
80,Fail,49,26,2,14,35
80,Fail,55,26,0,8,47
80,Fail,47,27,0,15,32
80,Fail,52,25,0,11,41
80,Fail,47,26,5,11,36
80,Fail,51,24,3,12,39
80,Fail,52,24,0,13,39
80,Fail,45,31,4,8,37
80,Fail,48,33,4,5,43
80,Fail,53,20,2,12,41
80,Fail,45,25,5,16,29
80,Fail,43,31,12,9,34
80,Fail,45,28,4,14,31
80,Fail,44,30,4,9,35
80,Fail,46,42,0,6,40
80,Fail,52,30,0,8,44
80,Fail,54,27,0,9,45
80,Fail,42,25,0,20,22
80,Fail,56,27,5,7,49
80,Fail,46,22,4,15,31
80,Fail,44,30,0,13,31
80,Fail,48,21,6,12,36
80,Fail,44,30,4,11,33
80,Fail,42,28,3,16,26
80,Fail,51,29,1,9,42
80,Fail,42,23,7,16,26
80,Fail,45,21,6,17,28
80,Fail,49,24,6,15,34
80,Fail,43,24,8,16,27
80,Fail,47,30,0,12,35
80,Fail,44,24,6,16,28
80,Fail,54,26,0,10,44
80,Fail,51,26,0,13,38
80,Fail,50,28,4,9,41
80,Fail,44,35,0,11,33
80,Fail,45,28,0,11,34
80,Fail,45,30,0,12,33
80,Fail,48,24,6,13,35
80,Fail,45,29,0,12,33
80,Fail,44,37,0,12,32
80,Fail,37,26,4,22,15
80,Fail,42,26,0,21,21
80,Fail,50,32,0,9,41
80,Fail,51,23,1,12,39
80,Fail,46,23,8,12,34
80,Fail,43,32,0,16,27
80,Fail,44,24,8,18,26
80,Fail,51,17,3,16,35
80,Fail,53,33,0,9,44
80,Fail,43,36,0,11,32
80,Fail,50,28,0,11,39
80,Fail,45,33,0,10,35
80,Fail,43,25,8,17,26
80,Fail,49,25,4,9,40
80,Fail,46,19,3,14,32
80,Fail,45,27,0,22,23
80,Fail,49,26,0,10,39
80,Fail,53,19,7,11,42
80,Fail,51,20,3,16,35
80,Fail,49,25,0,11,38
80,Fail,48,28,3,14,34
80,Fail,52,20,7,12,40
80,Fail,52,31,0,9,43
80,Fail,49,25,0,17,32
80,Fail,46,29,5,10,36
80,Fail,44,33,4,11,33
80,Fail,50,29,1,9,41
80,Fail,47,39,0,6,41
80,Fail,48,27,11,5,43
80,Fail,50,25,0,14,36
80,Fail,45,31,1,11,34
80,Fail,48,26,3,13,35
80,Fail,50,18,3,18,32
80,Fail,51,18,0,20,31
80,Fail,44,32,0,13,31
80,Fail,47,28,1,12,35
80,Fail,39,42,0,10,29
80,Fail,49,30,0,10,39
80,Fail,45,27,1,15,30
80,Fail,55,21,0,9,46
80,Fail,41,30,11,12,29
80,Fail,49,30,0,13,36
80,Fail,49,27,0,16,33
80,Fail,51,26,2,12,39
80,Fail,51,18,7,13,38
80,Fail,51,25,1,11,40
80,Fail,50,27,0,11,39
80,Fail,54,24,0,11,43
80,Fail,52,21,4,14,38
80,Fail,47,27,1,15,32
80,Fail,46,24,7,15,31
80,Fail,47,28,0,10,37
80,Fail,44,34,0,14,30
80,Fail,49,30,0,11,38
80,Fail,52,28,0,11,41
80,Fail,61,14,3,11,50
80,Fail,48,24,0,16,32
80,Fail,55,23,0,10,45
80,Fail,50,28,5,6,44
80,Fail,49,22,0,19,30
80,Fail,48,30,0,10,38
80,Fail,50,21,4,13,37
80,Fail,52,21,8,11,41
80,Fail,47,26,3,10,37
80,Fail,46,37,0,8,38
80,Fail,47,32,3,9,38
80,Fail,41,28,12,13,28
80,Fail,41,31,6,13,28
80,Fail,51,23,0,20,31
80,Fail,45,31,0,14,31
80,Fail,45,29,0,15,30
80,Fail,38,29,6,16,22
80,Fail,49,25,0,15,34
80,Fail,48,31,0,12,36
80,Fail,51,23,2,13,38
80,Fail,47,29,0,14,33
80,Fail,43,30,4,11,32
80,Fail,40,30,1,19,21
80,Fail,46,33,0,10,36
80,Fail,54,21,0,13,41
80,Fail,50,22,4,13,37
80,Fail,45,37,0,10,35
80,Fail,50,22,0,13,37
80,Fail,49,19,4,15,34
80,Fail,44,37,0,6,38
80,Fail,50,21,8,12,38
80,Fail,54,29,0,10,44
80,Fail,45,27,2,16,29
80,Fail,52,25,0,9,43
80,Fail,53,19,4,8,45
80,Fail,57,26,0,7,50
80,Fail,47,35,0,8,39
80,Fail,38,28,0,20,18
80,Fail,49,21,0,18,31
80,Fail,48,21,0,17,31
80,Fail,50,22,4,14,36
80,Fail,46,28,2,16,30
80,Fail,45,21,3,22,23
80,Fail,44,26,5,16,28
80,Fail,43,33,0,13,30
80,Fail,41,29,1,20,21
80,Fail,41,38,0,13,28
80,Fail,56,17,0,13,43
80,Fail,45,27,4,10,35
80,Fail,46,28,0,11,35
80,Fail,51,29,0,11,40
80,Fail,48,23,0,19,29
80,Fail,50,21,6,15,35
80,Fail,49,24,1,14,35
80,Fail,47,30,0,14,33
80,Fail,51,29,0,9,42
80,Fail,51,24,0,12,39
80,Fail,57,22,0,11,46
80,Fail,45,22,7,17,28
80,Fail,48,31,0,7,41
80,Fail,47,26,0,18,29
80,Fail,49,26,0,14,35
80,Fail,52,25,0,13,39
80,Fail,49,23,7,8,41
80,Fail,51,27,0,11,40
80,Fail,47,28,3,12,35
80,Fail,37,33,8,15,22
80,Fail,52,26,2,10,42
80,Fail,53,21,1,10,43
80,Fail,44,25,7,14,30
80,Fail,48,25,4,13,35
80,Fail,41,28,2,14,27
80,Fail,49,25,0,16,33
80,Fail,48,34,0,10,38
80,Fail,46,35,0,8,38
80,Fail,53,17,8,13,40
80,Fail,47,32,0,9,38
80,Fail,48,25,0,16,32
80,Fail,47,29,0,12,35
80,Fail,53,23,0,12,41
80,Fail,47,30,0,16,31
80,Fail,46,28,6,10,36
80,Fail,49,26,0,13,36
80,Fail,37,37,0,14,23
80,Fail,51,32,0,9,42
80,Fail,48,27,5,7,41
80,Fail,45,28,4,15,30
80,Fail,53,20,0,18,35
80,Fail,50,24,0,12,38
80,Fail,51,26,2,10,41
80,Fail,49,32,0,8,41
80,Fail,53,28,2,7,46
80,Fail,53,20,0,12,41
80,Fail,47,30,0,12,35
80,Fail,51,23,1,13,38
80,Fail,47,25,9,10,37
80,Fail,44,27,0,18,26
80,Fail,55,23,2,8,47
80,Fail,40,34,8,11,29
80,Fail,49,26,0,13,36
80,Fail,58,20,2,7,51
80,Fail,48,28,4,7,41
80,Fail,48,29,0,14,34
80,Fail,47,31,0,11,36
80,Fail,49,30,0,17,32
80,Fail,46,24,5,15,31
80,Fail,49,33,0,7,42
80,Fail,44,28,0,14,30
80,Fail,41,35,0,17,24
80,Fail,36,30,9,16,20
80,Fail,53,22,3,9,44
80,Fail,51,22,1,12,39
80,Fail,52,22,0,15,37
80,Fail,46,31,0,14,32
80,Fail,45,25,10,10,35
80,Fail,49,29,2,8,41
80,Fail,54,27,2,4,50
80,Fail,52,24,0,11,41
80,Fail,49,33,0,9,40
80,Fail,47,32,0,12,35
80,Fail,53,26,0,12,41
80,Fail,44,23,8,13,31
80,Fail,57,35,0,3,54
80,Fail,52,25,5,12,40
80,Fail,48,27,0,15,33
80,Fail,45,30,0,15,30
80,Fail,49,34,0,10,39
80,Fail,49,28,1,12,37
80,Fail,43,20,9,19,24
80,Fail,49,29,0,11,38
80,Fail,50,23,8,11,39
80,Fail,43,27,0,18,25
80,Fail,48,34,0,6,42
80,Fail,48,28,2,11,37
80,Fail,50,22,4,13,37
80,Fail,51,27,0,12,39
80,Fail,41,32,0,18,23
80,Fail,51,31,0,9,42
80,Fail,54,25,3,7,47
80,Fail,47,27,2,12,35
80,Fail,52,22,7,10,42
80,Fail,55,22,0,7,48
80,Fail,47,25,2,16,31
80,Fail,60,18,0,10,50
80,Fail,53,23,0,11,42
80,Fail,46,26,0,14,32
80,Fail,41,37,0,15,26
80,Fail,53,23,1,12,41
80,Fail,51,27,0,8,43
80,Fail,40,29,6,15,25
80,Fail,49,22,10,8,41
80,Fail,48,28,0,12,36
80,Fail,50,29,0,12,38
80,Fail,46,29,0,12,34
80,Fail,47,26,7,10,37
80,Fail,53,21,1,13,40
80,Fail,56,10,1,17,39
80,Fail,51,27,0,11,40
80,Fail,46,28,0,15,31
80,Fail,43,40,0,11,32
80,Fail,48,31,0,14,34
80,Fail,44,29,5,12,32
80,Fail,51,23,0,12,39
80,Fail,47,23,0,19,28
80,Fail,43,34,0,14,29
80,Fail,48,28,0,17,31
80,Fail,46,22,4,15,31
80,Fail,39,26,11,17,22
80,Fail,57,25,0,8,49
80,Fail,49,28,0,15,34
80,Fail,44,30,0,15,29
80,Fail,45,35,0,9,36
80,Fail,52,24,0,10,42
80,Fail,51,30,0,9,42
80,Fail,43,28,0,21,22
80,Fail,44,29,11,10,34
80,Fail,46,30,5,12,34
80,Fail,51,24,0,13,38
80,Fail,42,29,6,12,30
80,Fail,45,26,5,13,32
80,Fail,48,25,0,14,34
80,Fail,50,31,0,11,39
80,Fail,45,35,0,12,33
80,Fail,51,31,1,5,46
80,Fail,58,26,0,10,48
80,Fail,52,24,1,12,40
80,Fail,47,28,0,12,35
80,Fail,48,29,0,15,33
80,Fail,59,21,0,8,51
80,Fail,48,21,2,19,29
80,Fail,50,25,0,7,43
80,Fail,45,23,3,17,28
80,Fail,50,26,1,13,37
80,Fail,55,24,0,10,45
80,Fail,52,25,1,11,41
80,Fail,44,27,5,15,29
80,Fail,43,21,9,15,28
80,Fail,47,30,0,12,35
80,Fail,52,29,0,12,40
80,Fail,45,23,1,19,26
80,Fail,41,30,11,11,30
80,Fail,52,28,2,6,46
80,Fail,51,19,8,16,35
80,Fail,51,28,0,10,41
80,Fail,51,23,3,11,40
80,Fail,49,25,3,13,36
80,Fail,49,20,0,17,32
80,Fail,36,42,0,15,21
80,Fail,40,33,10,14,26
80,Fail,53,19,2,13,40
80,Fail,45,27,0,16,29
80,Fail,49,28,0,10,39
80,Fail,57,24,0,8,49
80,Fail,40,35,0,13,27
80,Fail,47,27,2,18,29
80,Fail,44,39,0,11,33
80,Fail,53,22,3,11,42
80,Fail,47,36,0,10,37
80,Fail,36,42,0,15,21
80,Fail,48,24,1,14,34
80,Fail,46,26,7,13,33
80,Fail,57,19,0,14,43
80,Fail,47,26,1,12,35
80,Fail,44,29,1,13,31
80,Fail,54,26,0,8,46
80,Fail,50,26,0,11,39
80,Fail,47,18,14,15,32
80,Fail,49,30,0,13,36
80,Fail,41,33,0,15,26
80,Fail,53,26,0,8,45
80,Fail,49,21,2,9,40
80,Fail,57,18,2,15,42
80,Fail,39,39,0,13,26
80,Fail,44,28,5,13,31
80,Fail,41,29,1,15,26
80,Fail,50,23,0,15,35
80,Fail,52,19,3,17,35
80,Fail,50,23,4,14,36
80,Fail,46,28,5,12,34
80,Fail,45,34,0,13,32
80,Fail,41,35,3,13,28
80,Fail,48,30,0,11,37
80,Fail,46,32,0,12,34
80,Fail,53,22,0,13,40
80,Fail,49,24,7,9,40
80,Fail,53,22,3,8,45
80,Fail,48,29,0,8,40
80,Fail,38,37,0,16,22
80,Fail,56,28,0,8,48
80,Fail,47,27,0,12,35
80,Fail,46,23,1,16,30
80,Fail,55,22,9,6,49
80,Fail,52,18,1,11,41
80,Fail,49,23,2,14,35
80,Fail,50,18,11,14,36
80,Fail,45,27,2,14,31
80,Fail,50,22,0,15,35
80,Fail,51,19,7,16,35
80,Fail,44,42,0,8,36
80,Fail,55,21,3,9,46
80,Fail,55,25,2,8,47
80,Fail,45,38,0,11,34
80,Fail,48,23,1,17,31
80,Fail,53,28,0,11,42
80,Fail,62,21,0,8,54
80,Fail,47,34,0,9,38
80,Fail,51,24,1,12,39
80,Fail,43,33,0,16,27
80,Fail,54,25,7,5,49
80,Fail,43,33,0,13,30
80,Fail,47,29,0,11,36
80,Fail,45,25,2,17,28
80,Fail,51,31,0,7,44
80,Fail,48,19,2,20,28
80,Fail,54,27,0,9,45
80,Fail,56,25,0,8,48
80,Fail,49,32,0,9,40
80,Fail,54,25,0,7,47
80,Fail,37,25,15,17,20
80,Fail,39,29,0,25,14
80,Fail,48,23,0,18,30
80,Fail,45,37,0,7,38
80,Fail,46,33,0,14,32
80,Fail,44,39,0,14,30
80,Fail,52,22,0,10,42
80,Fail,44,37,0,10,34
80,Fail,51,28,0,9,42
80,Fail,39,31,2,18,21
80,Fail,47,24,0,17,30
80,Fail,51,25,0,12,39
80,Fail,50,32,0,11,39
80,Fail,47,27,0,16,31
80,Fail,53,19,0,13,40
80,Fail,43,35,1,11,32
80,Fail,57,23,0,7,50
80,Fail,52,24,4,12,40
80,Fail,52,28,0,7,45
80,Fail,47,31,0,12,35
80,Fail,49,26,1,13,36
80,Fail,45,39,0,8,37
80,Fail,52,22,4,11,41
80,Fail,56,25,0,10,46
80,Fail,46,35,0,11,35
80,Fail,56,21,0,14,42
80,Fail,49,22,0,14,35
80,Fail,52,18,6,11,41
80,Fail,45,28,5,13,32
80,Fail,47,28,0,12,35
80,Fail,45,27,6,9,36
80,Fail,49,27,0,12,37
80,Fail,51,28,0,9,42
80,Fail,47,34,0,14,33
80,Fail,46,29,0,16,30
80,Fail,52,21,0,14,38
80,Fail,52,30,0,11,41
80,Fail,45,31,5,13,32
80,Fail,50,26,0,12,38
80,Fail,55,24,0,10,45
80,Fail,36,37,0,20,16
80,Fail,41,32,13,6,35
80,Fail,45,21,0,18,27
80,Fail,51,28,0,14,37
80,Fail,56,21,1,10,46
80,Fail,48,26,4,12,36
80,Fail,52,22,0,14,38
80,Fail,49,27,0,11,38
80,Fail,47,29,0,14,33
80,Fail,47,28,0,14,33
80,Fail,42,41,0,9,33
80,Fail,44,29,0,17,27
80,Fail,46,27,0,15,31
80,Fail,52,24,3,9,43
80,Fail,48,28,2,14,34
80,Fail,56,28,0,10,46
80,Fail,46,31,0,9,37
80,Fail,50,20,5,13,37
80,Fail,49,25,7,9,40
80,Fail,49,25,0,16,33
80,Fail,44,34,0,14,30
80,Fail,55,27,0,4,51
80,Fail,50,23,0,14,36
80,Fail,44,27,2,14,30
80,Fail,55,28,0,5,50
80,Fail,52,19,6,19,33
80,Fail,45,27,9,13,32
80,Fail,48,33,0,9,39
80,Fail,49,25,0,16,33
80,Fail,50,28,0,16,34
80,Fail,43,31,1,12,31
80,Fail,45,32,1,8,37
80,Fail,49,23,2,16,33
80,Fail,45,30,3,12,33
80,Fail,45,29,8,13,32
80,Fail,52,23,1,11,41
80,Fail,40,33,5,11,29
80,Fail,48,30,2,9,39
80,Fail,53,25,0,9,44
80,Fail,46,22,0,19,27
80,Fail,43,35,0,13,30
80,Fail,44,27,0,17,27
80,Fail,43,31,3,10,33
80,Fail,47,30,0,13,34
80,Fail,46,34,0,11,35
80,Fail,49,24,6,13,36
80,Fail,52,29,0,9,43
80,Fail,51,20,0,13,38
80,Fail,48,20,6,14,34
80,Fail,46,31,0,10,36
80,Fail,44,28,0,16,28
80,Fail,53,23,0,12,41
80,Fail,48,23,2,14,34
80,Fail,51,20,2,15,36
80,Fail,53,26,0,9,44
80,Fail,42,33,0,16,26
80,Fail,44,41,0,5,39
80,Fail,59,22,2,5,54
80,Fail,48,30,0,10,38
80,Fail,54,24,2,11,43
80,Fail,40,28,1,19,21
80,Fail,47,28,0,12,35
80,Fail,51,23,4,12,39
80,Fail,51,27,6,7,44
80,Fail,42,30,8,13,29
80,Fail,51,21,7,12,39
80,Fail,43,34,0,15,28
80,Fail,53,22,3,9,44
80,Fail,53,17,3,14,39
80,Fail,46,28,7,13,33
80,Fail,55,18,2,13,42
80,Fail,44,24,11,14,30
80,Fail,45,26,0,16,29
80,Fail,46,26,1,14,32
80,Fail,44,29,3,14,30
80,Fail,46,29,2,8,38
80,Fail,57,18,0,12,45
80,Fail,50,26,0,14,36
80,Fail,57,18,3,8,49
80,Fail,42,28,6,16,26
80,Fail,47,29,0,15,32
80,Fail,49,30,6,7,42
80,Fail,48,20,1,16,32
80,Fail,43,32,0,14,29
80,Fail,49,25,1,10,39
80,Fail,51,18,1,14,37
80,Fail,44,26,8,13,31
80,Fail,48,27,0,12,36
80,Fail,49,25,1,13,36
80,Fail,48,23,0,15,33
80,Fail,52,28,0,11,41
80,Fail,46,31,1,12,34
80,Fail,44,33,3,15,29
80,Fail,46,30,0,11,35
80,Fail,53,27,3,6,47
80,Fail,54,21,0,15,39
80,Fail,43,33,0,13,30
80,Fail,45,27,1,18,27
80,Fail,46,23,3,19,27
80,Fail,43,28,4,15,28
80,Fail,47,22,10,10,37
80,Fail,46,41,0,7,39
80,Fail,49,29,0,10,39
80,Fail,46,32,2,6,40
80,Fail,45,30,0,15,30
80,Fail,43,37,0,9,34
80,Fail,45,24,10,15,30
80,Fail,42,38,0,7,35
80,Fail,50,28,0,12,38
80,Fail,46,32,0,14,32
80,Fail,47,25,1,13,34
80,Fail,51,24,7,9,42
80,Fail,48,21,5,13,35
80,Fail,48,26,0,11,37
80,Fail,49,26,0,16,33
80,Fail,48,27,0,9,39
80,Fail,54,23,0,13,41
80,Fail,44,21,7,11,33
80,Fail,50,22,4,15,35
80,Fail,44,31,3,12,32
80,Fail,56,20,4,9,47
80,Fail,53,27,0,7,46
80,Fail,44,25,3,15,29
80,Fail,42,39,0,7,35
80,Fail,46,28,0,14,32
80,Fail,46,31,1,12,34
80,Fail,50,28,0,11,39
80,Fail,57,21,0,9,48
80,Fail,51,22,0,15,36
80,Fail,53,23,0,13,40
80,Fail,42,30,9,10,32
80,Fail,44,33,0,11,33
80,Fail,47,34,0,11,36
80,Fail,53,17,5,13,40
80,Fail,51,23,1,12,39
80,Fail,55,22,0,10,45
80,Fail,50,20,5,16,34
80,Fail,46,35,2,5,41
80,Fail,50,24,4,9,41
80,Fail,53,23,1,14,39
80,Fail,44,28,1,15,29
80,Fail,56,18,0,13,43
80,Fail,46,32,2,9,37
80,Fail,55,24,0,10,45
80,Fail,49,26,4,9,40
80,Fail,41,25,5,17,24
80,Fail,47,31,0,15,32
80,Fail,58,17,0,14,44
80,Fail,46,32,4,12,34
80,Fail,48,30,0,14,34
80,Fail,47,27,0,12,35
80,Fail,51,30,0,5,46
80,Fail,46,22,0,19,27
80,Fail,47,33,0,11,36
80,Fail,51,15,15,13,38
80,Fail,46,30,0,13,33
80,Fail,49,21,6,14,35
80,Fail,50,26,4,12,38
80,Fail,47,27,9,11,36
80,Fail,46,23,4,14,32
80,Fail,52,21,5,10,42
80,Fail,48,25,3,14,34
80,Fail,49,28,4,10,39
80,Fail,45,29,4,9,36
80,Fail,47,28,0,14,33
80,Fail,49,29,0,11,38
80,Fail,42,32,0,18,24
80,Fail,45,25,7,12,33
80,Fail,49,21,0,16,33
80,Fail,56,29,0,6,50
80,Fail,53,24,5,9,44
80,Fail,54,13,0,18,36
80,Fail,46,29,11,6,40
80,Fail,54,18,2,16,38
80,Fail,54,24,0,12,42
80,Fail,48,30,0,12,36
80,Fail,47,28,2,14,33
80,Fail,52,23,0,13,39
80,Fail,43,29,6,11,32
80,Fail,50,28,0,12,38
80,Fail,52,27,0,11,41
80,Fail,46,25,5,13,33
80,Fail,44,29,4,13,31
80,Fail,43,34,0,13,30
80,Fail,53,24,0,13,40
80,Fail,45,30,0,13,32
80,Fail,46,30,0,14,32
80,Fail,46,32,0,11,35
80,Fail,47,15,9,17,30
80,Fail,51,22,0,13,38
80,Fail,49,25,2,13,36
80,Fail,51,22,0,16,35
80,Fail,53,24,1,11,42
80,Fail,48,22,4,14,34
80,Fail,46,29,7,12,34
80,Fail,47,32,0,13,34
80,Fail,50,29,0,12,38
80,Fail,46,23,7,14,32
80,Fail,48,31,0,15,33
80,Fail,47,29,0,12,35
80,Fail,42,39,0,10,32
80,Fail,52,22,1,13,39
80,Fail,42,38,0,11,31
80,Fail,54,25,2,11,43
80,Fail,49,23,5,11,38
80,Fail,45,30,6,10,35
80,Fail,48,34,0,10,38
80,Fail,51,24,0,11,40
80,Fail,52,21,7,13,39
80,Fail,44,33,0,15,29
80,Fail,44,41,0,6,38
80,Fail,53,15,3,18,35
80,Fail,45,24,10,12,33
80,Fail,51,24,2,11,40
80,Fail,45,29,0,13,32
80,Fail,46,33,0,14,32
80,Fail,51,23,3,12,39
80,Fail,45,29,6,12,33
80,Fail,46,28,0,15,31
80,Fail,51,26,1,11,40
80,Fail,46,27,3,12,34
80,Fail,42,31,5,13,29
80,Fail,47,24,4,10,37
80,Fail,50,25,0,12,38
80,Fail,44,32,0,9,35
80,Fail,49,26,0,16,33
80,Fail,52,20,0,13,39
80,Fail,43,27,1,17,26
80,Fail,43,32,0,15,28
80,Fail,47,25,1,14,33
80,Fail,51,27,0,12,39
80,Fail,48,28,0,15,33
80,Fail,51,25,0,12,39
80,Fail,51,24,2,9,42
80,Fail,49,27,0,10,39
80,Fail,52,24,1,10,42
80,Fail,50,23,0,9,41
80,Fail,48,27,5,9,39
80,Fail,50,21,9,12,38
80,Fail,51,22,0,19,32
80,Fail,46,25,0,13,33
80,Fail,37,30,3,19,18
80,Fail,47,34,0,13,34
80,Fail,40,29,6,18,22
80,Fail,37,35,0,16,21
80,Fail,46,30,2,12,34
80,Fail,47,30,0,10,37
80,Fail,49,32,0,12,37
80,Fail,44,21,2,19,25
80,Fail,51,28,2,10,41
80,Fail,58,20,1,8,50
80,Fail,52,26,3,8,44
80,Fail,46,34,5,5,41
80,Fail,51,23,0,10,41
80,Fail,44,29,0,16,28
80,Fail,42,33,0,14,28
80,Fail,50,29,2,9,41
80,Fail,46,26,0,16,30
80,Fail,49,31,0,14,35
80,Fail,47,30,2,8,39
80,Fail,51,29,0,8,43
80,Fail,45,32,4,9,36
80,Fail,55,23,0,13,42
80,Fail,46,25,2,17,29
80,Fail,48,25,2,15,33
80,Fail,52,24,0,13,39
80,Fail,48,21,12,14,34
80,Fail,49,24,0,15,34
80,Fail,53,20,1,12,41
80,Fail,49,28,6,12,37
80,Fail,43,34,0,12,31
80,Fail,50,24,2,14,36
80,Fail,44,23,6,17,27
80,Fail,46,32,0,10,36
80,Fail,47,18,2,19,28
80,Fail,47,36,0,7,40
80,Fail,55,22,2,11,44
80,Fail,47,27,0,12,35
80,Fail,46,24,0,17,29
80,Fail,53,31,0,6,47
80,Fail,53,18,2,15,38
80,Fail,38,28,10,15,23
80,Fail,45,33,0,11,34
80,Fail,40,37,9,7,33
80,Fail,37,34,0,20,17
80,Fail,47,31,0,13,34
80,Fail,50,23,0,13,37
80,Fail,49,19,8,18,31
80,Fail,50,29,3,8,42
80,Fail,44,26,9,14,30
80,Fail,54,24,0,11,43
80,Fail,44,38,0,11,33
80,Fail,43,35,0,10,33
80,Fail,41,29,6,16,25
80,Fail,42,31,4,12,30
80,Fail,40,28,1,17,23
80,Fail,56,20,1,10,46
80,Fail,42,29,0,20,22
80,Fail,50,24,0,13,37
80,Fail,54,22,1,5,49
80,Fail,56,22,4,9,47
80,Fail,40,35,0,17,23
80,Fail,44,25,8,14,30
80,Fail,50,27,0,13,37
80,Fail,44,31,0,18,26
80,Fail,47,30,3,11,36
80,Fail,51,30,0,13,38
80,Fail,50,23,1,11,39
80,Fail,47,28,0,13,34
80,Fail,46,32,1,11,35
80,Fail,51,23,0,14,37
80,Fail,45,26,0,16,29
80,Fail,40,39,0,13,27
80,Fail,45,30,0,15,30
80,Fail,48,27,2,14,34
80,Fail,49,25,0,14,35
80,Fail,43,21,7,21,22
80,Fail,50,20,0,18,32
80,Fail,50,27,0,13,37
80,Fail,42,30,0,16,26
80,Fail,52,20,0,11,41
80,Fail,46,26,0,12,34
80,Fail,49,19,5,17,32
80,Fail,49,23,5,12,37
80,Fail,52,31,0,7,45
80,Fail,50,26,0,12,38
80,Fail,51,30,2,4,47
80,Fail,53,20,2,17,36
80,Fail,51,25,6,15,36
80,Fail,45,23,4,19,26
80,Fail,47,31,0,12,35
80,Fail,55,15,4,14,41
80,Fail,49,23,0,15,34
80,Fail,50,30,4,10,40
80,Fail,44,31,3,11,33
80,Fail,48,33,0,8,40
80,Fail,54,21,7,8,46
80,Fail,47,31,0,12,35
80,Fail,47,30,1,9,38
80,Fail,44,31,2,15,29
80,Fail,42,33,0,16,26
80,Fail,43,37,6,8,35
80,Fail,48,28,0,9,39
80,Fail,44,32,0,12,32
80,Fail,45,24,5,17,28
80,Fail,53,30,0,7,46
80,Fail,43,25,0,21,22
80,Fail,45,27,2,15,30
80,Fail,41,29,0,17,24
80,Fail,45,30,6,8,37
80,Fail,57,17,3,7,50
80,Fail,47,30,0,13,34
80,Fail,44,34,0,13,31
80,Fail,50,22,0,17,33
80,Fail,42,32,6,10,32
80,Fail,54,22,0,10,44
80,Fail,50,25,0,12,38
80,Fail,56,20,6,8,48
80,Fail,48,29,0,10,38
80,Fail,42,39,0,10,32
80,Fail,49,36,0,7,42
80,Fail,47,26,1,14,33
80,Fail,49,25,0,14,35
80,Fail,55,19,2,11,44
80,Fail,56,22,1,10,46
80,Fail,39,29,0,21,18
80,Fail,43,31,7,9,34
80,Fail,50,28,0,11,39
80,Fail,51,23,3,12,39
80,Fail,42,33,0,12,30
80,Fail,58,27,0,10,48
80,Fail,42,31,0,15,27
80,Fail,51,28,0,11,40
80,Fail,47,35,0,9,38
80,Fail,48,29,4,10,38
80,Fail,47,30,0,12,35
80,Fail,51,25,2,12,39
80,Fail,43,35,0,16,27
80,Fail,49,29,0,13,36
80,Fail,54,27,0,10,44
80,Fail,51,25,0,14,37
80,Fail,51,27,2,11,40
80,Fail,54,21,0,9,45
80,Fail,39,34,0,16,23
80,Fail,52,23,0,11,41
80,Fail,40,41,0,11,29
80,Fail,49,28,3,11,38
80,Fail,45,33,0,11,34
80,Fail,40,36,0,10,30
80,Fail,51,27,1,9,42
80,Fail,41,30,0,16,25
80,Fail,57,20,0,10,47
80,Fail,49,30,0,12,37
80,Fail,50,25,4,9,41
80,Fail,54,27,0,6,48
80,Fail,53,18,7,12,41
80,Fail,49,21,7,14,35
80,Fail,40,41,0,10,30
80,Fail,37,28,16,9,28
80,Fail,39,37,0,14,25
80,Fail,45,32,0,12,33
80,Fail,56,23,0,7,49
80,Fail,46,24,1,17,29
80,Fail,48,33,0,13,35
80,Fail,39,33,0,17,22
80,Fail,43,37,0,12,31
80,Fail,50,20,6,12,38
80,Fail,48,26,0,12,36
80,Fail,53,28,0,7,46
80,Fail,53,23,0,15,38
80,Fail,47,31,2,8,39
80,Fail,49,27,1,11,38
80,Fail,47,30,4,8,39
80,Fail,50,28,0,9,41
80,Fail,48,32,0,11,37
80,Fail,45,31,0,13,32
80,Fail,55,22,0,9,46
80,Fail,50,21,5,12,38
80,Fail,41,34,0,15,26
80,Fail,51,26,1,12,39
80,Fail,45,20,9,15,30
80,Fail,41,36,0,14,27
80,Fail,52,29,4,7,45
80,Fail,44,24,1,17,27
80,Fail,41,33,0,15,26
80,Fail,42,33,1,15,27
80,Fail,54,23,8,5,49
80,Fail,46,27,2,11,35
80,Fail,44,25,8,12,32
80,Fail,53,20,0,13,40
80,Fail,45,25,4,13,32
80,Fail,47,28,4,10,37
80,Fail,46,31,3,13,33
80,Fail,48,27,0,11,37
80,Fail,43,28,7,12,31
80,Fail,42,29,7,14,28
80,Fail,47,26,2,10,37
80,Fail,45,38,0,10,35
80,Fail,44,35,0,8,36
80,Fail,49,22,3,15,34
80,Fail,60,18,0,9,51
80,Fail,51,31,2,7,44
80,Fail,42,36,0,17,25
80,Fail,49,25,4,10,39
80,Fail,51,19,6,12,39
80,Fail,50,25,0,15,35
80,Fail,52,25,1,7,45
80,Fail,50,22,0,15,35
80,Fail,50,23,2,11,39
80,Fail,47,26,3,17,30
80,Fail,49,27,0,14,35
80,Fail,45,26,10,11,34
80,Fail,54,26,0,10,44
80,Fail,54,31,0,9,45
80,Fail,50,28,0,10,40
80,Fail,44,31,0,19,25
80,Fail,46,29,5,11,35
80,Fail,52,25,4,10,42
80,Fail,46,38,0,13,33
80,Fail,56,19,0,11,45
80,Fail,54,15,7,10,44
80,Fail,48,32,0,10,38
80,Fail,48,26,3,11,37
80,Fail,54,22,3,9,45
80,Fail,51,25,0,13,38
80,Fail,47,31,0,11,36
80,Fail,42,35,0,15,27
80,Fail,48,19,6,14,34
80,Fail,58,17,6,11,47
80,Fail,49,27,0,11,38
80,Fail,52,26,0,14,38
80,Fail,45,23,5,16,29
80,Fail,52,24,1,13,39
80,Fail,45,24,1,14,31
80,Fail,43,25,7,15,28
80,Fail,50,26,1,12,38
80,Fail,56,20,2,15,41
80,Fail,43,28,2,15,28
80,Fail,59,22,0,12,47
80,Fail,46,27,0,13,33
80,Fail,48,24,3,17,31
80,Fail,41,32,6,11,30
80,Fail,56,21,0,11,45
80,Fail,48,30,0,10,38
80,Fail,45,32,0,13,32
80,Fail,48,27,1,14,34
80,Fail,53,26,0,8,45
80,Fail,48,26,0,12,36
80,Fail,48,22,7,13,35
80,Fail,52,25,0,13,39
80,Fail,42,29,0,18,24
80,Fail,55,22,1,9,46
80,Fail,50,29,0,11,39
80,Fail,46,22,1,15,31
80,Fail,55,18,6,9,46
80,Fail,50,22,0,13,37
80,Fail,47,32,0,15,32
80,Fail,52,30,6,2,50
80,Fail,45,33,0,15,30
80,Fail,49,29,0,12,37
80,Fail,47,32,0,14,33
80,Fail,47,26,2,17,30
80,Fail,54,26,1,8,46
80,Fail,40,31,0,16,24
80,Fail,41,29,4,14,27
80,Fail,49,25,0,13,36
80,Fail,51,19,4,13,38
80,Fail,54,28,3,7,47
80,Fail,54,24,0,10,44
80,Fail,49,25,0,11,38
80,Fail,57,18,5,12,45
80,Fail,53,24,0,7,46
80,Fail,51,28,4,6,45
80,Fail,42,33,0,9,33
80,Fail,42,25,9,12,30
80,Fail,53,24,0,13,40
80,Fail,50,26,0,11,39
80,Fail,50,25,6,11,39
80,Fail,50,21,6,12,38
80,Fail,43,42,0,10,33
80,Fail,50,26,1,14,36
80,Fail,40,30,2,18,22
80,Fail,46,34,0,11,35
80,Fail,49,23,7,11,38
80,Fail,54,25,0,9,45
80,Fail,46,34,0,12,34
80,Fail,57,23,5,5,52
80,Fail,40,30,0,18,22
80,Fail,49,18,4,19,30
80,Fail,45,35,0,8,37
80,Fail,49,25,5,11,38
80,Fail,53,24,0,6,47
80,Fail,52,27,3,5,47
80,Fail,43,35,4,9,34
80,Fail,47,26,0,14,33
80,Fail,42,27,2,14,28
80,Fail,50,32,0,9,41
80,Fail,53,19,9,9,44
80,Fail,48,24,0,12,36
80,Fail,41,32,0,15,26
80,Fail,50,20,6,17,33
80,Fail,48,20,5,16,32
80,Fail,43,33,3,10,33
80,Fail,47,32,0,7,40
80,Fail,44,28,0,14,30
80,Fail,50,25,0,12,38
80,Fail,43,22,1,23,20
80,Fail,48,27,0,13,35
80,Fail,41,23,7,17,24
80,Fail,51,25,0,10,41
80,Fail,47,29,2,11,36
80,Fail,53,26,2,8,45
80,Fail,51,22,3,11,40
80,Fail,53,25,0,10,43
80,Fail,52,30,0,14,38
80,Fail,51,27,3,9,42
80,Fail,48,23,0,15,33
80,Fail,44,26,7,13,31
80,Fail,48,24,0,16,32
80,Fail,52,21,0,16,36
80,Fail,51,30,0,9,42
80,Fail,50,26,4,8,42
80,Fail,51,18,4,16,35
80,Fail,54,23,0,8,46
80,Fail,45,27,0,17,28
80,Fail,49,33,0,7,42
80,Fail,47,33,0,10,37
80,Fail,48,28,0,16,32
80,Fail,47,31,8,7,40
80,Fail,53,23,0,11,42
80,Fail,51,24,4,10,41
80,Fail,45,32,0,13,32
80,Fail,52,19,5,13,39
80,Fail,47,29,0,16,31
80,Fail,52,20,2,16,36
80,Fail,50,26,0,10,40
80,Fail,49,31,0,11,38
80,Fail,51,25,3,12,39
80,Fail,45,34,0,12,33
80,Fail,52,26,0,10,42
80,Fail,42,33,4,7,35
80,Fail,53,21,1,15,38
80,Fail,49,30,0,6,43
80,Fail,52,25,0,12,40
80,Fail,51,24,0,11,40
80,Fail,47,28,3,13,34
80,Fail,56,27,0,7,49
80,Fail,51,22,4,13,38
80,Fail,42,36,7,10,32
80,Fail,47,27,3,15,32
80,Fail,54,18,5,7,47
80,Fail,44,29,2,14,30
80,Fail,47,29,1,13,34
80,Fail,49,33,0,7,42
80,Fail,42,31,0,15,27
80,Fail,53,20,5,11,42
80,Fail,49,31,1,9,40
80,Fail,51,20,6,10,41
80,Fail,41,30,0,15,26
80,Fail,51,24,0,14,37
80,Fail,55,19,4,8,47
80,Fail,50,27,0,11,39
80,Fail,50,28,0,14,36
80,Fail,46,30,0,16,30
80,Fail,47,21,6,15,32
80,Fail,49,30,0,10,39
80,Fail,50,27,3,11,39
80,Fail,52,22,7,12,40
80,Fail,39,34,8,13,26
80,Fail,49,28,0,11,38
80,Fail,37,27,10,20,17
80,Fail,48,28,1,13,35
80,Fail,43,30,0,13,30
80,Fail,47,28,2,10,37
80,Fail,41,29,7,10,31
80,Fail,54,31,0,5,49
80,Fail,53,25,4,8,45
80,Fail,48,23,0,17,31
80,Fail,45,32,0,12,33
80,Fail,41,34,0,14,27
80,Fail,55,21,5,8,47
80,Fail,52,27,4,6,46
80,Fail,47,23,0,19,28
80,Fail,39,40,0,16,23
80,Fail,54,23,2,8,46
80,Fail,46,35,0,9,37
80,Fail,46,29,4,12,34
80,Fail,51,25,6,6,45
80,Fail,52,29,0,11,41
80,Fail,45,21,7,16,29
80,Fail,47,32,4,9,38
80,Fail,48,25,4,11,37
80,Fail,47,36,0,11,36
80,Fail,43,33,2,14,29
80,Fail,43,29,0,16,27
80,Fail,40,42,0,13,27
80,Fail,59,21,3,8,51
80,Fail,47,32,1,6,41
80,Fail,40,35,0,15,25
80,Fail,44,34,0,11,33
80,Fail,44,28,4,11,33
80,Fail,52,27,0,8,44
80,Fail,49,24,0,15,34
80,Fail,43,25,5,20,23
80,Fail,52,27,0,8,44
80,Fail,52,20,0,14,38
80,Fail,48,25,8,7,41
80,Fail,51,24,0,13,38
80,Fail,44,32,0,17,27
80,Fail,39,24,8,20,19
80,Fail,45,33,0,12,33
80,Fail,54,20,9,10,44
80,Fail,50,23,4,12,38
80,Fail,41,37,0,13,28
80,Fail,47,35,0,7,40
80,Fail,48,26,0,13,35
80,Fail,43,28,5,16,27
80,Fail,48,19,2,16,32
80,Fail,43,26,0,19,24
80,Fail,53,23,4,7,46
80,Fail,48,27,0,15,33
80,Fail,53,21,1,15,38
80,Fail,50,25,2,10,40
80,Fail,48,28,0,17,31
80,Fail,44,23,2,18,26
80,Fail,42,31,2,17,25
80,Fail,55,24,0,11,44
80,Fail,49,24,3,12,37
80,Fail,47,24,0,17,30
80,Fail,46,31,0,12,34
80,Fail,52,21,4,12,40
80,Fail,55,23,0,10,45
80,Fail,45,31,0,16,29
80,Fail,54,21,0,11,43
80,Fail,45,34,0,15,30
80,Fail,50,25,0,13,37
80,Fail,38,37,0,17,21
80,Fail,46,30,5,11,35
80,Fail,54,19,1,18,36
80,Fail,40,38,0,14,26
80,Fail,54,31,0,5,49
80,Fail,46,18,10,18,28
80,Fail,50,19,3,13,37
80,Fail,50,25,0,12,38
80,Fail,46,26,6,12,34
80,Fail,51,25,2,13,38
80,Fail,45,30,0,13,32
80,Fail,59,18,0,13,46
80,Fail,46,29,0,13,33
80,Fail,37,40,0,13,24
80,Fail,43,28,3,14,29
80,Fail,50,24,0,10,40
80,Fail,48,27,0,13,35
80,Fail,50,28,0,13,37
80,Fail,43,35,0,15,28
80,Fail,53,22,0,13,40
80,Fail,50,22,4,12,38
80,Fail,45,30,0,15,30
80,Fail,47,24,0,20,27
80,Fail,53,21,4,6,47
80,Fail,49,22,6,11,38
80,Fail,48,25,0,16,32
80,Fail,42,45,0,9,33
80,Fail,45,30,5,11,34
80,Fail,47,23,2,16,31
80,Fail,45,30,0,14,31
80,Fail,44,35,0,11,33
80,Fail,50,26,0,13,37
80,Fail,54,22,0,11,43
80,Fail,48,32,1,6,42
80,Fail,54,25,0,8,46
80,Fail,47,26,0,13,34
80,Fail,50,23,0,9,41
80,Fail,56,22,0,11,45
80,Fail,40,27,0,21,19
80,Fail,52,24,4,9,43
80,Fail,44,27,9,15,29
80,Fail,51,28,0,8,43
80,Fail,45,30,0,14,31
80,Fail,39,35,0,12,27
80,Fail,46,23,6,15,31
80,Fail,49,25,0,17,32
80,Fail,52,25,0,13,39
80,Fail,46,30,0,14,32
80,Fail,52,27,0,10,42
80,Fail,52,22,4,11,41
80,Fail,47,27,2,15,32
80,Fail,50,28,0,10,40
80,Fail,51,22,0,15,36
80,Fail,39,26,12,14,25
80,Fail,46,27,0,17,29
80,Fail,55,25,2,11,44
80,Fail,41,39,0,14,27
80,Fail,50,20,2,13,37
80,Fail,43,37,0,13,30
80,Fail,48,20,2,13,35
80,Fail,50,26,3,11,39
80,Fail,48,27,1,10,38
80,Fail,54,28,0,8,46
80,Fail,54,23,2,9,45
80,Fail,42,33,0,16,26
80,Fail,53,22,0,14,39
80,Fail,42,29,4,16,26
80,Fail,40,41,0,11,29
80,Fail,54,22,3,8,46
80,Fail,47,23,1,17,30
80,Fail,55,21,0,14,41
80,Fail,46,31,0,14,32
80,Fail,50,26,0,8,42
80,Fail,45,33,0,12,33
80,Fail,60,18,0,11,49
80,Fail,49,26,0,14,35
80,Fail,53,28,0,8,45
80,Fail,44,23,15,14,30
80,Fail,43,36,0,10,33
80,Fail,44,31,0,15,29
80,Fail,52,28,0,9,43
80,Fail,55,27,4,6,49
80,Fail,53,29,0,10,43
80,Fail,49,22,3,13,36
80,Fail,49,27,0,17,32
80,Fail,42,36,0,12,30
80,Fail,39,24,1,24,15
80,Fail,44,24,0,21,23
80,Fail,47,28,5,10,37
80,Fail,56,21,3,9,47
80,Fail,49,26,4,9,40
80,Fail,38,40,0,15,23
80,Fail,44,28,6,11,33
80,Fail,54,29,0,11,43
80,Fail,47,33,0,13,34
80,Fail,52,27,0,11,41
80,Fail,46,27,0,13,33
80,Fail,48,27,3,11,37
80,Fail,45,22,6,17,28
80,Fail,45,31,0,15,30
80,Fail,46,18,4,20,26
80,Fail,52,28,6,7,45
80,Fail,53,24,2,14,39
80,Fail,44,26,6,14,30
80,Fail,51,19,8,10,41
80,Fail,43,26,6,14,29
80,Fail,50,23,0,12,38
80,Fail,44,20,11,17,27
80,Fail,43,29,8,8,35
80,Fail,49,21,9,14,35
80,Fail,51,21,5,11,40
80,Fail,45,36,0,9,36
80,Fail,41,34,0,13,28
80,Fail,41,33,0,18,23
80,Fail,43,31,0,20,23
80,Fail,50,26,5,12,38
80,Fail,46,29,2,13,33
80,Fail,49,25,0,10,39
80,Fail,54,22,1,13,41
80,Fail,52,21,0,7,45
80,Fail,40,32,0,18,22
80,Fail,50,23,2,17,33
80,Fail,39,48,0,6,33
80,Fail,54,23,0,9,45
80,Fail,45,27,3,12,33
80,Fail,46,29,1,10,36
80,Fail,45,25,5,14,31
80,Fail,60,21,0,11,49
80,Fail,48,31,0,14,34
80,Fail,47,27,0,11,36
80,Fail,47,25,0,13,34
80,Fail,40,30,0,18,22
80,Fail,54,20,0,13,41
80,Fail,47,18,4,19,28
80,Fail,44,43,0,7,37
80,Fail,48,23,8,14,34
80,Fail,53,27,0,11,42
80,Fail,52,24,0,15,37
80,Fail,46,23,2,18,28
80,Fail,61,20,0,10,51
80,Fail,47,38,0,8,39
80,Fail,37,37,0,16,21
80,Fail,51,29,0,10,41
80,Fail,48,30,2,10,38
80,Fail,47,28,7,8,39
80,Fail,50,27,0,9,41
80,Fail,42,35,0,12,30
80,Fail,49,32,0,9,40
80,Fail,58,24,0,9,49
80,Fail,49,23,2,11,38
80,Fail,46,29,0,15,31
80,Fail,45,23,1,16,29
80,Fail,47,32,3,6,41
80,Fail,51,16,1,19,32
80,Fail,50,31,0,6,44
80,Fail,38,31,7,16,22
80,Fail,52,24,10,7,45
80,Fail,47,24,4,14,33
80,Fail,44,24,8,18,26
80,Fail,54,19,1,13,41
80,Fail,53,18,2,13,40
80,Fail,51,34,0,8,43
80,Fail,46,19,12,17,29
80,Fail,48,30,0,8,40
80,Fail,46,36,0,13,33
80,Fail,55,22,0,12,43
80,Fail,44,24,0,17,27
80,Fail,47,26,5,11,36
80,Fail,50,28,0,11,39
80,Fail,40,36,0,16,24
80,Fail,54,19,1,12,42
80,Fail,52,27,0,9,43
80,Fail,51,26,0,12,39
80,Fail,45,27,1,17,28
80,Fail,50,34,0,7,43
80,Fail,48,25,2,15,33
80,Fail,45,27,5,17,28
80,Fail,52,22,2,8,44
80,Fail,47,31,7,8,39
80,Fail,42,32,0,14,28
80,Fail,51,21,0,13,38
80,Fail,56,23,0,10,46
80,Fail,46,28,0,14,32
80,Fail,51,24,6,15,36
80,Fail,49,28,1,11,38
80,Fail,49,32,4,8,41
80,Fail,52,25,1,8,44
80,Fail,54,21,2,10,44
80,Fail,45,35,3,9,36
80,Fail,42,29,1,17,25
80,Fail,42,36,0,15,27
80,Fail,57,21,0,10,47
80,Fail,47,33,0,10,37
80,Fail,53,21,2,12,41
80,Fail,42,35,0,12,30
80,Fail,53,24,0,11,42
80,Fail,45,28,0,14,31
80,Fail,44,32,0,12,32
80,Fail,54,21,4,10,44
80,Fail,49,17,12,16,33
80,Fail,47,25,4,14,33
80,Fail,40,26,8,16,24
80,Fail,48,30,0,13,35
80,Fail,51,30,0,9,42
80,Fail,42,28,0,21,21
80,Fail,44,23,6,15,29
80,Fail,46,26,4,12,34
80,Fail,54,20,0,12,42
80,Fail,48,24,0,16,32
80,Fail,47,32,5,6,41
80,Fail,43,31,0,15,28
80,Fail,51,24,0,12,39
80,Fail,51,26,2,13,38
80,Fail,46,29,0,15,31
80,Fail,45,28,1,15,30
80,Fail,38,32,0,19,19
80,Fail,49,28,0,9,40
80,Fail,49,33,0,7,42
80,Fail,41,35,6,10,31
80,Fail,51,23,8,8,43
80,Fail,43,26,7,12,31
80,Fail,47,32,3,11,36
80,Fail,53,24,1,13,40
80,Fail,51,23,0,13,38
80,Fail,43,27,10,12,31
80,Fail,49,29,0,13,36
80,Fail,54,28,0,6,48
80,Fail,46,35,0,6,40
80,Fail,53,29,0,11,42
80,Fail,48,31,0,13,35
80,Fail,50,29,0,11,39
80,Fail,46,25,0,17,29
80,Fail,45,26,4,9,36
80,Fail,39,36,0,13,26
80,Fail,49,25,0,16,33
80,Fail,48,30,0,11,37
80,Fail,59,16,0,11,48
80,Fail,51,22,0,14,37
80,Fail,47,35,0,12,35
80,Fail,49,22,3,13,36
80,Fail,54,20,1,13,41
80,Fail,49,30,0,6,43
80,Fail,51,22,0,15,36
80,Fail,47,26,0,12,35
80,Fail,43,29,4,12,31
80,Fail,46,31,0,14,32
80,Fail,40,28,1,21,19
80,Fail,53,25,1,12,41
80,Fail,46,32,0,15,31
80,Fail,51,27,3,9,42
80,Fail,47,27,9,5,42
80,Fail,53,27,0,7,46
80,Fail,42,26,8,12,30
80,Fail,45,32,1,13,32
80,Fail,59,18,4,7,52
80,Fail,50,30,0,12,38
80,Fail,55,26,0,7,48
80,Fail,48,23,0,15,33
80,Fail,47,29,0,13,34
80,Fail,45,32,0,16,29
80,Fail,50,26,7,10,40
80,Fail,46,33,2,9,37
80,Fail,44,21,0,20,24
80,Fail,53,22,0,15,38
80,Fail,43,41,0,7,36
80,Fail,47,25,0,15,32
80,Fail,47,24,9,11,36
80,Fail,48,25,0,18,30
80,Fail,52,27,0,9,43
80,Fail,52,24,2,8,44
80,Fail,46,30,2,10,36
80,Fail,47,27,0,10,37
80,Fail,45,28,1,17,28
80,Fail,55,22,0,7,48
80,Fail,42,35,0,12,30
80,Fail,40,35,0,17,23
80,Fail,46,34,0,10,36
80,Fail,46,35,0,13,33
80,Fail,40,32,3,15,25
80,Fail,52,31,1,7,45
80,Fail,37,28,3,22,15
80,Fail,45,29,3,11,34
80,Fail,42,32,0,11,31
80,Fail,46,30,0,12,34
80,Fail,49,23,1,15,34
80,Fail,45,30,2,13,32
80,Fail,44,32,11,6,38
80,Fail,54,21,3,13,41
80,Fail,49,25,4,13,36
80,Fail,36,42,0,13,23
80,Fail,52,22,2,12,40
80,Fail,48,27,0,8,40
80,Fail,43,30,3,11,32
80,Fail,57,27,0,5,52
80,Fail,53,18,5,13,40
80,Fail,47,25,7,13,34
80,Fail,44,31,9,9,35
80,Fail,50,29,0,9,41
80,Fail,49,25,3,13,36
80,Fail,48,25,0,18,30
80,Fail,57,18,0,17,40
80,Fail,45,29,2,9,36
80,Fail,44,32,0,15,29
80,Fail,36,44,0,14,22
80,Fail,48,24,7,11,37
80,Fail,50,25,3,12,38
80,Fail,39,30,0,22,17
80,Fail,48,35,0,9,39
80,Fail,51,23,3,14,37
80,Fail,47,24,7,14,33
80,Fail,42,38,0,11,31
80,Fail,50,30,0,12,38
80,Fail,54,26,0,10,44
80,Fail,46,33,3,11,35
80,Fail,54,25,1,11,43
80,Fail,43,27,5,16,27
80,Fail,53,14,0,20,33
80,Fail,51,24,3,11,40
80,Fail,52,30,0,7,45
80,Fail,52,25,0,7,45
80,Fail,53,22,7,10,43
80,Fail,44,27,1,19,25
80,Fail,46,25,7,12,34
80,Fail,54,29,0,8,46
80,Fail,45,32,0,10,35
80,Fail,55,27,2,8,47
80,Fail,45,32,3,10,35
80,Fail,51,29,0,7,44
80,Fail,54,18,3,12,42
80,Fail,47,29,2,11,36
80,Fail,37,31,5,16,21
80,Fail,59,20,0,11,48
80,Fail,54,22,0,10,44
80,Fail,44,36,0,11,33
80,Fail,51,29,0,7,44
80,Fail,42,31,0,14,28
80,Fail,46,24,3,13,33
80,Fail,46,31,1,10,36
80,Fail,52,20,3,13,39
80,Fail,45,29,2,15,30
80,Fail,42,33,6,12,30
80,Fail,51,26,0,9,42
80,Fail,49,16,5,15,34
80,Fail,47,24,4,14,33
80,Fail,49,16,13,15,34
80,Fail,48,26,4,10,38
80,Fail,46,22,8,16,30
80,Fail,51,35,0,12,39
80,Fail,49,24,3,11,38
80,Fail,44,25,3,20,24
80,Fail,52,25,8,7,45
80,Fail,46,25,0,16,30
80,Fail,46,20,0,19,27
80,Fail,49,28,0,12,37
80,Fail,49,25,0,13,36
80,Fail,47,30,3,9,38
80,Fail,46,36,0,11,35
80,Fail,44,29,2,16,28
80,Fail,48,27,1,12,36
80,Fail,46,22,8,16,30
80,Fail,43,40,0,8,35
80,Fail,42,27,0,18,24
80,Fail,46,27,0,19,27
80,Fail,47,22,4,14,33
80,Fail,51,23,1,13,38
80,Fail,44,28,6,15,29
80,Fail,48,25,5,8,40
80,Fail,46,29,4,10,36
80,Fail,44,32,8,10,34
80,Fail,44,31,0,17,27
80,Fail,47,33,2,9,38
80,Fail,40,38,0,13,27
80,Fail,46,29,0,12,34
80,Fail,50,33,0,7,43
80,Fail,32,36,3,18,14
80,Fail,48,21,10,13,35
80,Fail,51,20,0,16,35
80,Fail,45,28,1,17,28
80,Fail,55,17,0,15,40
80,Fail,50,19,0,17,33
80,Fail,48,27,0,14,34
80,Fail,54,24,0,10,44
80,Fail,46,23,3,16,30
80,Fail,54,18,1,12,42
80,Fail,46,35,0,10,36
80,Fail,46,31,1,9,37
80,Fail,50,25,1,13,37
80,Fail,55,16,1,14,41
80,Fail,56,15,0,16,40
80,Fail,41,22,0,25,16
80,Fail,38,21,4,24,14
80,Fail,46,31,0,15,31
80,Fail,48,24,1,15,33
80,Fail,48,22,3,17,31
80,Fail,51,25,3,11,40
80,Fail,47,20,3,20,27
80,Fail,47,22,8,12,35
80,Fail,56,24,0,11,45
80,Fail,47,34,0,12,35
80,Fail,48,23,5,11,37
80,Fail,52,22,0,11,41
80,Fail,45,24,0,18,27
80,Fail,51,25,0,9,42
80,Fail,50,26,0,15,35
80,Fail,46,29,2,11,35
80,Fail,45,29,10,8,37
80,Fail,44,32,0,15,29
80,Fail,49,24,6,12,37
80,Fail,36,37,5,13,23
80,Fail,53,25,0,11,42
80,Fail,46,28,0,17,29
80,Fail,52,19,1,14,38
80,Fail,56,16,2,11,45
80,Fail,44,35,0,10,34
80,Fail,39,40,0,14,25
80,Fail,43,36,0,11,32
80,Fail,43,33,0,16,27
80,Fail,45,34,0,11,34
80,Fail,54,21,0,13,41
80,Fail,52,22,4,11,41
80,Fail,45,28,1,16,29
80,Fail,55,25,0,11,44
80,Fail,48,29,6,7,41
80,Fail,48,29,2,11,37
80,Fail,48,28,7,10,38
80,Fail,51,21,0,12,39
80,Fail,51,25,1,10,41
80,Fail,50,24,0,11,39
80,Fail,46,30,0,16,30
80,Fail,50,23,5,14,36
80,Fail,49,26,0,16,33
80,Fail,48,20,8,14,34
80,Fail,52,24,2,10,42
80,Fail,47,25,0,15,32
80,Fail,47,24,0,18,29
80,Fail,46,28,0,15,31
80,Fail,47,23,4,14,33
80,Fail,45,25,3,17,28
80,Fail,46,28,4,13,33
80,Fail,52,22,0,15,37
80,Fail,51,24,7,11,40
80,Fail,54,21,0,16,38
80,Fail,39,33,8,10,29
80,Fail,48,28,0,12,36
80,Fail,45,37,0,13,32
80,Fail,53,23,1,15,38
80,Fail,52,23,0,14,38
80,Fail,53,25,0,15,38
80,Fail,55,22,2,10,45
80,Fail,51,25,4,9,42
80,Fail,45,23,0,16,29
80,Fail,50,27,0,13,37
80,Fail,50,19,3,17,33
80,Fail,51,27,3,6,45
80,Fail,44,33,0,14,30
80,Fail,43,28,0,14,29
80,Fail,45,27,4,13,32
80,Fail,47,26,2,12,35
80,Fail,50,23,1,13,37
80,Fail,48,24,0,15,33
80,Fail,43,32,0,15,28
80,Fail,53,22,1,11,42
80,Fail,48,27,0,14,34
80,Fail,48,23,3,17,31
80,Fail,45,30,4,8,37
80,Fail,45,32,0,12,33
80,Fail,40,35,0,13,27
80,Fail,44,28,7,11,33
80,Fail,50,33,0,11,39
80,Fail,46,22,16,11,35
80,Fail,44,29,2,16,28
80,Fail,54,27,0,8,46
80,Fail,46,25,3,13,33
80,Fail,51,26,2,8,43
80,Fail,50,24,4,14,36
80,Fail,62,17,0,8,54
80,Fail,51,17,7,13,38
80,Fail,47,30,0,15,32
80,Fail,46,31,0,13,33
80,Fail,53,23,0,10,43
80,Fail,48,24,2,15,33
80,Fail,51,21,0,18,33
80,Fail,50,17,1,15,35
80,Fail,47,27,0,13,34
80,Fail,53,30,0,10,43
80,Fail,45,31,2,10,35
80,Fail,58,19,0,10,48
80,Fail,51,27,0,6,45
80,Fail,51,28,0,11,40
80,Fail,49,26,6,8,41
80,Fail,53,20,4,11,42
80,Fail,51,18,5,14,37
80,Fail,48,32,0,12,36
80,Fail,41,36,0,16,25
80,Fail,51,29,0,12,39
80,Fail,47,24,0,13,34
80,Fail,43,28,0,18,25
80,Fail,43,30,8,9,34
80,Fail,44,30,0,17,27
80,Fail,57,19,2,11,46
80,Fail,42,30,10,12,30
80,Fail,51,24,0,10,41
80,Fail,47,22,0,17,30
80,Fail,53,25,0,12,41
80,Fail,47,33,0,9,38
80,Fail,44,28,0,16,28
80,Fail,47,29,8,9,38
80,Fail,55,21,0,11,44
80,Fail,50,23,0,16,34
80,Fail,52,25,0,16,36
80,Fail,51,26,0,14,37
80,Fail,45,30,0,14,31
80,Fail,44,28,3,10,34
80,Fail,52,24,3,12,40
80,Fail,51,25,0,13,38
80,Fail,46,32,0,15,31
80,Fail,46,27,3,15,31
80,Fail,51,28,0,9,42
80,Fail,51,26,5,10,41
80,Fail,52,17,6,11,41
80,Fail,54,24,0,10,44
80,Fail,47,27,0,10,37
80,Fail,53,22,3,11,42
80,Fail,45,28,0,15,30
80,Fail,47,21,1,15,32
80,Fail,44,21,1,22,22
80,Fail,48,26,0,14,34
80,Fail,46,32,0,15,31
80,Fail,48,27,1,17,31
80,Fail,39,35,0,14,25
80,Fail,51,24,0,15,36
80,Fail,42,34,0,14,28
80,Fail,46,30,2,11,35
80,Fail,44,30,0,15,29
80,Fail,52,24,3,12,40
80,Fail,47,19,1,19,28
80,Fail,52,20,0,14,38
80,Fail,49,23,0,12,37
80,Fail,43,19,9,23,20
80,Fail,53,24,0,10,43
80,Fail,52,23,0,12,40
80,Fail,49,28,1,14,35
80,Fail,45,26,3,13,32
80,Fail,48,22,0,16,32
80,Fail,54,22,5,3,51
80,Fail,47,23,6,14,33
80,Fail,49,28,1,10,39
80,Fail,50,21,5,13,37
80,Fail,54,19,1,13,41
80,Fail,44,34,0,10,34
80,Fail,51,26,1,12,39
80,Fail,52,30,0,10,42
80,Fail,50,27,0,12,38
80,Fail,48,22,5,16,32
80,Fail,48,24,0,16,32
80,Fail,52,28,0,10,42
80,Fail,55,20,0,13,42
80,Fail,48,31,0,9,39
80,Fail,49,22,3,16,33
80,Fail,54,25,2,12,42
80,Fail,53,25,0,17,36
80,Fail,43,30,0,15,28
80,Fail,54,22,0,14,40
80,Fail,51,26,4,9,42
80,Fail,42,30,3,16,26
80,Fail,48,36,0,7,41
80,Fail,44,32,0,11,33
80,Fail,53,20,1,11,42
80,Fail,42,30,3,17,25
80,Fail,49,32,0,9,40
80,Fail,45,34,0,13,32
80,Fail,49,20,4,17,32
80,Fail,60,13,1,11,49
80,Fail,46,29,0,10,36
80,Fail,42,31,0,16,26
80,Fail,53,26,2,9,44
80,Fail,47,26,5,14,33
80,Fail,48,22,0,17,31
80,Fail,55,29,0,7,48
80,Fail,49,28,0,13,36
80,Fail,51,30,0,15,36
80,Fail,51,27,0,11,40
80,Fail,40,31,3,20,20
80,Fail,50,29,0,12,38
80,Fail,48,26,3,15,33
80,Fail,51,26,1,10,41
80,Fail,53,26,0,9,44
80,Fail,43,30,0,19,24
80,Fail,52,24,5,11,41
80,Fail,53,21,6,13,40
80,Fail,47,25,0,16,31
80,Fail,54,28,0,8,46
80,Fail,45,35,0,11,34
80,Fail,43,31,0,16,27
80,Fail,45,31,0,14,31
80,Fail,43,38,0,10,33
80,Fail,51,27,1,10,41
80,Fail,40,37,0,15,25
80,Fail,46,26,5,13,33
80,Fail,45,21,10,17,28
80,Fail,40,36,0,19,21
80,Fail,47,26,3,12,35
80,Fail,54,22,0,12,42
80,Fail,40,34,2,14,26
80,Fail,54,21,2,13,41
80,Fail,51,26,2,9,42
80,Fail,36,36,3,18,18
80,Fail,43,31,0,15,28
80,Fail,44,29,0,13,31
80,Fail,46,25,0,18,28
80,Fail,45,30,2,11,34
80,Fail,45,30,4,11,34
80,Fail,48,31,0,10,38
80,Fail,52,29,0,10,42
80,Fail,45,29,9,9,36
80,Fail,48,25,3,15,33
80,Fail,44,28,6,13,31
80,Fail,47,27,6,10,37
80,Fail,49,23,0,17,32
80,Fail,47,28,0,13,34
80,Fail,53,21,0,16,37
80,Fail,47,26,2,14,33
80,Fail,44,28,3,12,32
80,Fail,49,23,7,14,35
80,Fail,50,25,5,11,39
80,Fail,44,34,0,12,32
80,Fail,53,24,0,8,45
80,Fail,46,31,0,12,34
80,Fail,43,33,0,13,30
80,Fail,44,36,0,14,30
80,Fail,45,23,9,14,31
80,Fail,47,28,0,16,31
80,Fail,42,34,0,13,29
80,Fail,50,28,3,10,40
80,Fail,56,23,4,7,49
80,Fail,36,41,0,15,21
80,Fail,52,27,1,10,42
80,Fail,40,37,0,12,28
80,Fail,50,24,0,17,33
80,Fail,50,26,5,7,43
80,Fail,48,34,0,8,40
80,Fail,46,34,0,13,33
80,Fail,48,27,0,12,36
80,Fail,57,24,0,12,45
80,Fail,52,26,0,11,41
80,Fail,40,31,0,17,23
80,Fail,53,27,0,9,44
80,Fail,51,32,0,9,42
80,Fail,48,30,0,13,35
80,Fail,46,25,0,15,31
80,Fail,46,22,8,14,32
80,Fail,48,23,2,15,33
80,Fail,53,20,0,13,40
80,Fail,48,31,0,12,36
80,Fail,56,26,0,10,46
80,Fail,40,34,0,12,28
80,Fail,47,23,3,11,36
80,Fail,52,21,6,13,39
80,Fail,47,24,0,17,30
80,Fail,46,19,5,19,27
80,Fail,46,25,0,17,29
80,Fail,44,30,2,14,30
80,Fail,56,21,2,12,44
80,Fail,44,28,5,14,30
80,Fail,42,25,8,17,25
80,Fail,44,22,3,18,26
80,Fail,40,42,0,13,27
80,Fail,46,30,0,12,34
80,Fail,53,28,0,12,41
80,Fail,41,26,2,20,21
80,Fail,49,26,2,7,42
80,Fail,45,30,0,12,33
80,Fail,49,31,2,7,42
80,Fail,48,34,7,3,45
80,Fail,50,20,8,13,37
80,Fail,50,26,1,12,38
80,Fail,54,25,4,7,47
80,Fail,50,28,0,10,40
80,Fail,53,20,2,16,37
80,Fail,52,23,3,7,45
80,Fail,56,20,1,14,42
80,Fail,45,32,0,12,33
80,Fail,47,29,2,11,36
80,Fail,47,34,0,8,39
80,Fail,44,28,0,15,29
80,Fail,44,30,0,12,32
80,Fail,40,40,0,8,32
80,Fail,51,27,4,9,42
80,Fail,49,21,10,8,41
80,Fail,45,29,1,18,27
80,Fail,53,23,6,10,43
80,Fail,44,27,3,15,29
80,Fail,53,30,0,8,45
80,Fail,42,41,0,11,31
80,Fail,44,33,0,12,32
80,Fail,56,21,3,12,44
80,Fail,57,18,1,11,46
80,Fail,41,23,9,19,22
80,Fail,45,29,3,13,32
80,Fail,45,24,2,17,28
80,Fail,54,20,7,10,44
80,Fail,55,21,0,11,44
80,Fail,48,31,0,11,37
80,Fail,43,25,6,15,28
80,Fail,43,34,0,17,26
80,Fail,45,33,0,13,32
80,Fail,52,25,1,13,39
80,Fail,49,30,0,13,36
80,Fail,49,23,0,15,34
80,Fail,47,30,0,11,36
80,Fail,50,28,6,11,39
80,Fail,55,20,0,10,45
80,Fail,52,22,0,16,36
80,Fail,44,38,0,12,32
80,Fail,50,27,0,14,36
80,Fail,55,20,1,13,42
80,Fail,46,19,4,20,26
80,Fail,40,23,6,19,21
80,Fail,45,34,0,12,33
80,Fail,55,27,0,9,46
80,Fail,51,20,0,15,36
80,Fail,45,26,7,14,31
80,Fail,48,28,2,11,37
80,Fail,50,25,0,15,35
80,Fail,47,21,11,10,37
80,Fail,35,32,7,17,18
80,Fail,51,24,1,12,39
80,Fail,45,27,0,18,27
80,Fail,48,29,0,13,35
80,Fail,55,19,0,14,41
80,Fail,50,20,0,16,34
80,Fail,46,34,5,6,40
80,Fail,40,29,4,15,25
80,Fail,51,22,7,10,41
80,Fail,56,26,0,6,50
80,Fail,47,22,13,14,33
80,Fail,47,21,8,17,30
80,Fail,51,27,0,11,40
80,Fail,50,27,0,14,36
80,Fail,49,26,0,12,37
80,Fail,35,31,3,22,13
80,Fail,45,28,7,11,34
80,Fail,43,30,4,15,28
80,Fail,46,21,0,21,25
80,Fail,40,27,15,12,28
80,Fail,44,27,2,15,29
80,Fail,51,31,0,10,41
80,Fail,50,23,3,12,38
80,Fail,52,25,1,10,42
80,Fail,43,24,2,18,25
80,Fail,48,29,0,12,36
80,Fail,53,28,0,10,43
80,Fail,53,22,0,10,43
80,Fail,47,29,0,14,33
80,Fail,50,22,0,16,34
80,Fail,55,26,0,7,48
80,Fail,43,23,4,18,25
80,Fail,47,17,5,16,31
80,Fail,49,27,0,12,37
80,Fail,47,29,0,13,34
80,Fail,37,32,3,15,22
80,Fail,48,21,2,19,29
80,Fail,48,27,6,9,39
80,Fail,42,42,0,7,35
80,Fail,46,31,0,13,33
80,Fail,54,15,8,11,43
80,Fail,45,25,0,19,26
80,Fail,45,27,0,13,32
80,Fail,57,24,0,8,49
80,Fail,44,26,1,14,30
80,Fail,50,23,0,13,37
80,Fail,44,25,3,15,29
80,Fail,47,25,0,16,31
80,Fail,49,39,0,6,43
80,Fail,51,25,4,10,41
80,Fail,48,25,0,14,34
80,Fail,55,19,0,12,43
80,Fail,45,31,0,12,33
80,Fail,49,26,0,11,38
80,Fail,49,36,0,7,42
80,Fail,53,24,0,9,44
80,Fail,52,24,0,11,41
80,Fail,47,24,0,15,32
80,Fail,52,23,0,13,39
80,Fail,49,29,0,8,41
80,Fail,45,27,3,11,34
80,Fail,52,22,0,13,39
80,Fail,48,27,0,14,34
80,Fail,54,22,2,12,42
80,Fail,43,31,3,13,30
80,Fail,48,34,0,9,39
80,Fail,55,24,0,10,45
80,Fail,43,29,3,14,29
80,Fail,46,27,0,19,27
80,Fail,47,21,6,15,32
80,Fail,54,16,0,16,38
80,Fail,41,33,0,14,27
80,Fail,48,30,0,11,37
80,Fail,49,27,0,13,36
80,Fail,51,27,3,10,41
80,Fail,54,20,10,8,46
80,Fail,50,24,0,11,39
80,Fail,53,23,0,12,41
80,Fail,43,31,7,11,32
80,Fail,40,31,0,16,24
80,Fail,47,30,6,10,37
80,Fail,45,26,14,10,35
80,Fail,51,27,0,11,40
80,Fail,47,18,10,15,32
80,Fail,44,31,0,15,29
80,Fail,52,19,0,18,34
80,Fail,49,23,4,11,38
80,Fail,48,24,1,19,29
80,Fail,33,44,0,17,16
80,Fail,50,23,0,17,33
80,Fail,44,32,0,12,32
80,Fail,45,25,0,17,28
80,Fail,47,33,0,13,34
80,Fail,53,28,0,8,45
80,Fail,56,24,0,11,45
80,Fail,44,35,0,10,34
80,Fail,52,20,1,13,39
80,Fail,48,28,0,13,35
80,Fail,47,24,4,13,34
80,Fail,42,40,0,10,32
80,Fail,46,27,0,13,33
80,Fail,48,28,2,13,35
80,Fail,56,15,0,14,42
80,Fail,46,28,0,15,31
80,Fail,48,24,4,11,37
80,Fail,53,24,0,12,41
80,Fail,44,27,0,16,28
80,Fail,41,35,0,16,25
80,Fail,50,19,2,18,32
80,Fail,52,27,0,11,41
80,Fail,45,19,4,20,25
80,Fail,55,23,0,14,41
80,Fail,49,22,0,17,32
80,Fail,52,25,5,7,45
80,Fail,45,29,0,14,31
80,Fail,49,28,0,13,36
80,Fail,48,28,2,10,38
80,Fail,52,27,0,8,44
80,Fail,45,40,0,9,36
80,Fail,47,34,0,11,36
80,Fail,46,27,0,13,33
80,Fail,40,27,2,16,24
80,Fail,39,34,0,14,25
80,Fail,42,27,6,15,27
80,Fail,47,28,0,12,35
80,Fail,51,23,1,15,36
80,Fail,51,20,3,14,37
80,Fail,47,22,5,14,33
80,Fail,41,29,0,20,21
80,Fail,45,37,0,6,39
80,Fail,47,31,5,7,40
80,Fail,48,24,4,13,35
80,Fail,47,23,13,9,38
80,Fail,53,23,0,12,41
80,Fail,50,33,0,9,41
80,Fail,48,26,0,12,36
80,Fail,56,26,0,8,48
80,Fail,39,34,0,17,22
80,Fail,51,25,0,12,39
80,Fail,50,31,0,10,40
80,Fail,51,30,0,9,42
80,Fail,49,30,0,13,36
80,Fail,47,28,0,12,35
80,Fail,44,25,0,18,26
80,Fail,47,31,0,13,34
80,Fail,47,32,0,13,34
80,Fail,44,26,5,13,31
80,Fail,42,27,9,14,28
80,Fail,43,35,0,11,32
80,Fail,54,23,0,15,39
80,Fail,33,40,0,21,12
80,Fail,47,30,0,11,36
80,Fail,46,33,0,11,35
80,Fail,53,19,0,14,39
80,Fail,46,26,7,17,29
80,Fail,53,24,2,9,44
80,Fail,44,24,11,15,29
80,Fail,52,26,3,9,43
80,Fail,43,29,1,15,28
80,Fail,43,33,0,9,34
80,Fail,55,17,6,8,47
80,Fail,56,18,0,13,43
80,Fail,41,37,0,13,28
80,Fail,48,30,0,10,38
80,Fail,55,27,0,10,45
80,Fail,48,32,1,7,41
80,Fail,43,29,4,14,29
80,Fail,47,24,4,14,33
80,Fail,49,23,0,13,36
80,Fail,50,31,0,7,43
80,Fail,50,23,2,15,35
80,Fail,48,26,6,11,37
80,Fail,45,30,0,12,33
80,Fail,52,22,4,12,40
80,Fail,50,27,0,11,39
80,Fail,60,19,1,9,51
80,Fail,51,25,1,10,41
80,Fail,50,26,1,12,38
80,Fail,48,22,2,16,32
80,Fail,47,33,0,12,35
80,Fail,53,27,0,5,48
80,Fail,43,33,4,13,30
80,Fail,45,38,0,9,36
80,Fail,52,24,0,12,40
80,Fail,46,24,1,18,28
80,Fail,56,22,0,12,44
80,Fail,52,27,0,11,41
80,Fail,42,31,0,18,24
80,Fail,52,24,4,10,42
80,Fail,46,27,1,12,34
80,Fail,46,27,0,16,30
80,Fail,51,24,5,10,41
80,Fail,49,30,0,9,40
80,Fail,55,16,3,11,44
80,Fail,44,28,0,19,25
80,Fail,49,20,1,13,36
80,Fail,56,24,0,15,41
80,Fail,50,19,0,18,32
80,Fail,52,22,2,18,34
80,Fail,48,29,0,13,35
80,Fail,45,30,0,13,32
80,Fail,45,36,0,11,34
80,Fail,56,23,0,8,48
80,Fail,60,11,0,14,46
80,Fail,45,29,0,14,31
80,Fail,43,27,1,20,23
80,Fail,47,26,4,9,38
80,Fail,43,27,0,19,24
80,Fail,49,24,0,14,35
80,Fail,50,22,1,15,35
80,Fail,49,25,5,13,36
80,Fail,44,33,0,11,33
80,Fail,46,28,0,13,33
80,Fail,42,35,0,16,26
80,Fail,49,30,0,11,38
80,Fail,39,28,1,20,19
80,Fail,51,25,6,11,40
80,Fail,58,18,0,10,48
80,Fail,46,33,0,12,34
80,Fail,40,38,0,14,26
80,Fail,39,29,0,17,22
80,Fail,46,26,1,15,31
80,Fail,52,22,0,12,40
80,Fail,48,23,0,20,28
80,Fail,44,30,0,14,30
80,Fail,46,32,0,10,36
80,Fail,49,24,7,11,38
80,Fail,48,28,2,12,36
80,Fail,49,29,0,10,39
80,Fail,44,26,5,16,28
80,Fail,48,28,4,14,34
80,Fail,44,36,0,11,33
80,Fail,40,32,2,15,25
80,Fail,46,38,0,9,37
80,Fail,42,30,0,14,28
80,Fail,50,30,0,10,40
80,Fail,47,29,0,14,33
80,Fail,43,28,0,19,24
80,Fail,45,29,0,13,32
80,Fail,54,28,0,8,46
80,Fail,41,33,2,14,27
80,Fail,43,28,8,13,30
80,Fail,48,29,0,9,39
80,Fail,53,17,4,15,38
80,Fail,52,30,0,9,43
80,Fail,41,38,0,14,27
80,Fail,52,30,0,8,44
80,Fail,50,24,0,12,38
80,Fail,51,27,0,10,41
80,Fail,44,29,0,17,27
80,Fail,44,25,9,12,32
80,Fail,46,34,0,10,36
80,Fail,50,28,0,10,40
80,Fail,39,31,0,18,21
80,Fail,53,25,0,8,45
80,Fail,49,25,0,15,34
80,Fail,48,22,4,17,31
80,Fail,48,32,0,11,37
80,Fail,45,33,0,13,32
80,Fail,43,26,0,19,24
80,Fail,59,21,0,6,53
80,Fail,46,29,1,14,32
80,Fail,51,32,0,10,41
80,Fail,49,32,0,11,38
80,Fail,44,17,10,24,20
80,Fail,54,23,3,8,46
80,Fail,50,26,2,11,39
80,Fail,44,20,2,20,24
80,Fail,45,26,5,17,28
80,Fail,47,30,0,15,32
80,Fail,38,30,1,17,21
80,Fail,38,41,0,15,23
80,Fail,42,28,4,15,27
80,Fail,44,27,1,18,26
80,Fail,41,40,0,9,32
80,Fail,43,34,0,13,30
80,Fail,38,37,0,12,26
80,Fail,52,19,6,9,43
80,Fail,46,26,0,15,31
80,Fail,42,36,0,12,30
80,Fail,53,28,0,11,42
80,Fail,51,28,0,13,38
80,Fail,58,20,1,10,48
80,Fail,52,24,1,13,39
80,Fail,54,18,3,15,39
80,Fail,44,24,7,16,28
80,Fail,46,20,7,19,27
80,Fail,50,19,3,18,32
80,Fail,42,27,6,18,24
80,Fail,46,36,0,12,34
80,Fail,46,26,0,13,33
80,Fail,52,28,0,7,45
80,Fail,49,29,1,10,39
80,Fail,53,28,0,12,41
80,Fail,47,21,0,20,27
80,Fail,40,34,1,11,29
80,Fail,43,25,0,20,23
80,Fail,51,23,3,13,38
80,Fail,41,37,0,12,29
80,Fail,51,22,3,15,36
80,Fail,48,31,1,10,38
80,Fail,46,28,0,12,34
80,Fail,52,17,3,14,38
80,Fail,49,33,0,8,41
80,Fail,54,25,0,10,44
80,Fail,45,25,0,17,28
80,Fail,52,28,0,10,42
80,Fail,51,25,0,12,39
80,Fail,46,27,0,14,32
80,Fail,39,43,0,16,23
80,Fail,44,31,1,14,30
80,Fail,55,28,0,7,48
80,Fail,50,24,0,8,42
80,Fail,51,23,0,12,39
80,Fail,42,38,0,15,27
80,Fail,50,21,2,11,39
80,Fail,45,20,9,17,28
80,Fail,55,19,2,10,45
80,Fail,42,31,2,12,30
80,Fail,51,24,0,14,37
80,Fail,41,28,12,14,27
80,Fail,52,24,0,12,40
80,Fail,48,24,7,9,39
80,Fail,44,27,4,15,29
80,Fail,50,25,0,15,35
80,Fail,43,35,0,10,33
80,Fail,49,28,1,9,40
80,Fail,47,32,0,13,34
80,Fail,42,20,11,17,25
80,Fail,54,16,2,17,37
80,Fail,48,30,0,11,37
80,Fail,43,24,6,14,29
80,Fail,47,24,4,15,32
80,Fail,50,23,3,16,34
80,Fail,46,25,4,11,35
80,Fail,48,27,1,13,35
80,Fail,44,28,6,14,30
80,Fail,47,29,0,13,34
80,Fail,53,18,8,14,39
80,Fail,48,23,4,14,34
80,Fail,47,25,4,13,34
80,Fail,47,34,0,7,40
80,Fail,49,30,2,9,40
80,Fail,50,21,1,13,37
80,Fail,52,28,0,12,40
80,Fail,46,29,0,16,30
80,Fail,46,21,4,18,28
80,Fail,39,30,0,17,22
80,Fail,37,40,0,13,24
80,Fail,54,30,0,7,47
80,Fail,41,36,3,10,31
80,Fail,40,33,0,15,25
80,Fail,51,32,0,10,41
80,Fail,53,18,5,15,38
80,Fail,56,22,0,8,48
80,Fail,50,23,4,11,39
80,Fail,42,29,3,15,27
80,Fail,56,23,2,7,49
80,Fail,48,17,6,19,29
80,Fail,44,24,0,15,29
80,Fail,48,26,6,13,35
80,Fail,46,32,0,9,37
80,Fail,47,38,0,5,42
80,Fail,51,21,2,11,40
80,Fail,48,28,2,12,36
80,Fail,55,28,0,7,48
80,Fail,48,27,0,13,35
80,Fail,42,29,6,14,28
80,Fail,41,38,0,15,26
80,Fail,39,29,0,20,19
80,Fail,48,25,3,17,31
80,Fail,53,22,2,10,43
80,Fail,52,20,0,13,39
80,Fail,48,31,0,10,38
80,Fail,49,22,5,13,36
80,Fail,45,30,1,13,32
80,Fail,50,28,2,10,40
80,Fail,55,31,0,6,49
80,Fail,43,33,0,14,29
80,Fail,63,13,0,8,55
80,Fail,44,36,0,13,31
80,Fail,52,24,1,8,44
80,Fail,42,39,0,11,31
80,Fail,52,27,1,9,43
80,Fail,41,28,6,16,25
80,Fail,47,25,0,10,37
80,Fail,47,28,0,14,33
80,Fail,49,33,0,7,42
80,Fail,53,18,6,13,40
80,Fail,48,21,5,11,37
80,Fail,58,19,3,10,48
80,Fail,48,25,1,14,34
80,Fail,50,31,1,6,44
80,Fail,53,22,2,12,41
80,Fail,45,28,6,15,30
80,Fail,58,16,0,11,47
80,Fail,45,27,1,14,31
80,Fail,41,28,0,21,20
80,Fail,47,32,2,8,39
80,Fail,49,28,0,11,38
80,Fail,49,34,0,5,44
80,Fail,42,29,2,13,29
80,Fail,50,30,0,10,40
80,Fail,58,23,0,10,48
80,Fail,52,21,6,13,39
80,Fail,42,37,0,10,32
80,Fail,48,27,2,12,36
80,Fail,51,24,7,10,41
80,Fail,53,21,2,13,40
80,Fail,41,31,0,16,25
80,Fail,46,32,3,9,37
80,Fail,52,18,0,17,35
80,Fail,41,29,3,18,23
80,Fail,47,31,3,10,37
80,Fail,46,25,2,16,30
80,Fail,58,22,0,9,49
80,Fail,48,31,0,11,37
80,Fail,45,26,1,14,31
80,Fail,50,23,0,17,33
80,Fail,51,29,0,7,44
80,Fail,48,27,3,13,35
80,Fail,53,24,0,11,42
80,Fail,46,27,0,11,35
80,Fail,55,17,3,12,43
80,Fail,48,23,6,12,36
80,Fail,47,29,0,15,32
80,Fail,46,20,4,26,20
80,Fail,48,25,0,16,32
80,Fail,52,25,2,8,44
80,Fail,48,32,4,8,40
80,Fail,47,31,0,12,35
80,Fail,39,39,0,12,27
80,Fail,48,23,1,13,35
80,Fail,49,28,0,12,37
80,Fail,48,24,1,15,33
80,Fail,51,23,8,9,42
80,Fail,58,19,0,9,49
80,Fail,40,36,0,14,26
80,Fail,54,27,0,10,44
80,Fail,51,24,2,16,35
80,Fail,53,27,0,12,41
80,Fail,45,31,0,11,34
80,Fail,45,32,2,15,30
80,Fail,49,26,1,11,38
80,Fail,48,33,2,9,39
80,Fail,47,31,0,13,34
80,Fail,57,30,0,4,53
80,Fail,44,26,12,7,37
80,Fail,50,29,2,10,40
80,Fail,55,22,0,10,45
80,Fail,59,21,3,8,51
80,Fail,51,33,0,8,43
80,Fail,44,34,2,12,32
80,Fail,49,31,0,12,37
80,Fail,47,26,0,13,34
80,Fail,37,37,5,12,25
80,Fail,47,34,0,10,37
80,Fail,53,31,0,5,48
80,Fail,49,34,0,6,43
80,Fail,48,21,10,14,34
80,Fail,46,37,0,10,36
80,Fail,49,25,4,12,37
80,Fail,55,20,2,14,41
80,Fail,47,29,0,15,32
80,Fail,46,28,0,14,32
80,Fail,49,33,0,11,38
80,Fail,38,44,0,12,26
80,Fail,42,28,2,15,27
80,Fail,47,29,0,13,34
80,Fail,48,25,0,15,33
80,Fail,50,27,4,11,39
80,Fail,42,29,10,15,27
80,Fail,53,23,0,13,40
80,Fail,51,22,6,13,38
80,Fail,48,20,6,14,34
80,Fail,42,40,0,11,31
80,Fail,50,24,0,12,38
80,Fail,50,32,0,10,40
80,Fail,47,33,0,8,39
80,Fail,48,27,0,16,32
80,Fail,54,19,0,17,37
80,Fail,46,28,0,16,30
80,Fail,45,30,2,16,29
80,Fail,54,25,0,9,45
80,Fail,53,29,0,11,42
80,Fail,51,22,4,13,38
80,Fail,37,42,0,13,24
80,Fail,52,26,0,12,40
80,Fail,53,20,8,10,43
80,Fail,52,22,7,12,40
80,Fail,45,32,0,13,32
80,Fail,51,28,3,10,41
80,Fail,48,28,0,17,31
80,Fail,49,27,0,13,36
80,Fail,45,27,0,22,23
80,Fail,42,26,10,14,28
80,Fail,43,27,7,13,30
80,Fail,52,17,4,14,38
80,Fail,51,21,4,16,35
80,Fail,56,21,0,15,41
80,Fail,46,38,0,10,36
80,Fail,51,24,1,10,41
80,Fail,49,24,8,10,39
80,Fail,46,25,1,16,30
80,Fail,48,28,0,17,31
80,Fail,54,20,3,11,43
80,Fail,45,30,2,14,31
80,Fail,45,35,0,11,34
80,Fail,46,27,2,13,33
80,Fail,46,28,3,14,32
80,Fail,46,26,0,15,31
80,Fail,47,21,2,16,31
80,Fail,47,30,0,15,32
80,Fail,53,20,0,13,40
80,Fail,52,22,0,13,39
80,Fail,39,31,10,9,30
80,Fail,39,32,0,15,24
80,Fail,42,31,7,15,27
80,Fail,53,22,1,9,44
80,Fail,40,44,0,10,30
80,Fail,54,22,3,8,46
80,Fail,41,33,0,17,24
80,Fail,50,24,0,15,35
80,Fail,47,31,0,13,34
80,Fail,56,20,1,9,47
80,Fail,53,30,0,6,47
80,Fail,44,40,0,12,32
80,Fail,50,27,1,10,40
80,Fail,47,28,3,11,36
80,Fail,46,36,0,10,36
80,Fail,40,40,0,13,27
80,Fail,43,21,7,23,20
80,Fail,58,21,3,10,48
80,Fail,42,33,3,13,29
80,Fail,45,29,2,12,33
80,Fail,54,22,0,11,43
80,Fail,47,21,4,15,32
80,Fail,37,32,11,12,25
80,Fail,40,36,0,14,26
80,Fail,52,20,0,8,44
80,Fail,52,21,10,9,43
80,Fail,44,24,6,19,25
80,Fail,40,30,13,9,31
80,Fail,43,35,0,16,27
80,Fail,51,24,0,12,39
80,Fail,49,25,10,7,42
80,Fail,50,21,8,15,35
80,Fail,52,20,7,10,42
80,Fail,43,33,0,12,31
80,Fail,51,28,0,8,43
80,Fail,50,25,0,11,39
80,Fail,44,27,4,16,28
80,Fail,55,15,5,12,43
80,Fail,48,31,0,9,39
80,Fail,44,28,0,15,29
80,Fail,44,26,3,15,29
80,Fail,55,20,0,11,44
80,Fail,46,30,1,13,33
80,Fail,40,35,0,16,24
80,Fail,52,26,0,12,40
80,Fail,45,23,0,18,27
80,Fail,47,30,0,16,31
80,Fail,47,30,4,9,38
80,Fail,42,33,6,10,32
80,Fail,51,27,0,12,39
80,Fail,50,29,0,9,41
80,Fail,49,29,0,14,35
80,Fail,51,29,0,6,45
80,Fail,44,31,0,15,29
80,Fail,38,41,0,8,30
80,Fail,48,31,0,10,38
80,Fail,49,35,0,9,40
80,Fail,51,22,0,15,36
80,Fail,52,21,4,13,39
80,Fail,48,27,1,16,32
80,Fail,49,27,0,12,37
80,Fail,55,25,1,9,46
80,Fail,44,30,0,15,29
80,Fail,44,35,0,17,27
80,Fail,49,34,0,9,40
80,Fail,54,19,6,11,43
80,Fail,47,31,0,11,36
80,Fail,56,21,0,11,45
80,Fail,47,22,0,19,28
80,Fail,51,20,0,19,32
80,Fail,43,39,0,11,32
80,Fail,52,29,2,5,47
80,Fail,52,28,0,10,42
80,Fail,53,26,0,11,42
80,Fail,44,34,0,10,34
80,Fail,50,16,4,19,31
80,Fail,45,35,0,12,33
80,Fail,47,27,0,14,33
80,Fail,40,33,0,18,22
80,Fail,50,24,0,16,34
80,Fail,44,28,0,20,24
80,Fail,40,32,4,17,23
80,Fail,46,24,5,13,33
80,Fail,43,32,5,11,32
80,Fail,57,18,5,10,47
80,Fail,53,26,0,10,43
80,Fail,54,23,3,10,44
80,Fail,56,18,3,11,45
80,Fail,44,30,4,12,32
80,Fail,56,22,2,10,46
80,Fail,53,28,0,7,46
80,Fail,40,35,0,15,25
80,Fail,45,26,4,17,28
80,Fail,55,23,0,11,44
80,Fail,52,21,5,12,40
80,Fail,51,21,11,11,40
80,Fail,47,30,0,13,34
80,Fail,49,20,3,18,31
80,Fail,41,37,0,13,28
80,Fail,45,25,5,13,32
80,Fail,48,29,0,11,37
80,Fail,44,33,1,8,36
80,Fail,45,27,0,16,29
80,Fail,43,28,7,12,31
80,Fail,44,31,0,12,32
80,Fail,49,20,5,15,34
80,Fail,50,26,0,13,37
80,Fail,56,23,0,9,47
80,Fail,56,21,0,11,45
80,Fail,47,26,4,13,34
80,Fail,50,17,4,15,35
80,Fail,37,29,4,24,13
80,Fail,50,29,4,9,41
80,Fail,45,35,0,10,35
80,Fail,49,28,0,11,38
80,Fail,32,33,10,14,18
80,Fail,43,24,8,15,28
80,Fail,48,29,0,14,34
80,Fail,48,29,0,10,38
80,Fail,53,24,0,14,39
80,Fail,41,36,0,15,26
80,Fail,53,25,0,8,45
80,Fail,48,26,5,13,35
80,Fail,38,44,0,10,28
80,Fail,57,26,1,6,51
80,Fail,40,38,0,13,27
80,Fail,49,28,0,14,35
80,Fail,44,21,7,19,25
80,Fail,48,27,0,10,38
80,Fail,51,26,0,11,40
80,Fail,44,24,11,13,31
80,Fail,41,36,0,15,26
80,Fail,44,31,0,17,27
80,Fail,50,22,0,15,35
80,Fail,42,36,0,12,30
80,Fail,52,23,0,15,37
80,Fail,37,34,7,11,26
80,Fail,49,30,3,8,41
80,Fail,41,33,0,14,27
80,Fail,48,22,10,11,37
80,Fail,48,29,1,8,40
80,Fail,53,24,2,8,45
80,Fail,52,26,1,11,41
80,Fail,53,24,0,9,44
80,Fail,46,33,0,14,32
80,Fail,51,28,0,10,41
80,Fail,45,28,0,15,30
80,Fail,51,26,2,15,36
80,Fail,44,28,4,11,33
80,Fail,53,21,5,11,42
80,Fail,47,32,0,12,35
80,Fail,45,32,3,9,36
80,Fail,46,28,0,17,29
80,Fail,47,34,0,15,32
80,Fail,47,23,4,11,36
80,Fail,50,23,0,18,32
80,Fail,48,18,13,12,36
80,Fail,47,30,0,13,34
80,Fail,54,24,0,9,45
80,Fail,45,34,0,12,33
80,Fail,46,26,1,13,33
80,Fail,57,26,0,7,50
80,Fail,48,31,2,9,39
80,Fail,51,22,2,14,37
80,Fail,50,29,0,12,38
80,Fail,40,28,0,20,20
80,Fail,44,34,0,14,30
80,Fail,45,26,0,17,28
80,Fail,51,22,0,11,40
80,Fail,52,25,7,5,47
80,Fail,49,23,8,12,37
80,Fail,53,25,1,8,45
80,Fail,53,23,1,8,45
80,Fail,50,22,0,15,35
80,Fail,46,28,3,14,32
80,Fail,47,30,4,13,34
80,Fail,54,17,4,15,39
80,Fail,51,22,2,13,38
80,Fail,40,26,3,18,22
80,Fail,52,27,5,4,48
80,Fail,54,19,5,10,44
80,Fail,47,26,0,15,32
80,Fail,44,35,0,13,31
80,Fail,44,35,0,12,32
80,Fail,49,30,0,9,40
80,Fail,45,29,0,13,32
80,Fail,49,30,0,11,38
80,Fail,48,30,0,14,34
80,Fail,39,39,0,11,28
80,Fail,38,43,0,10,28
80,Fail,41,33,0,13,28
80,Fail,47,33,0,8,39
80,Fail,47,33,0,11,36
80,Fail,47,25,3,9,38
80,Fail,49,17,3,18,31
80,Fail,44,40,0,11,33
80,Fail,38,30,7,17,21
80,Fail,55,25,0,5,50
80,Fail,43,30,9,12,31
80,Fail,56,13,3,14,42
80,Fail,39,29,0,18,21
80,Fail,52,21,3,17,35
80,Fail,49,27,1,14,35
80,Fail,41,32,0,12,29
80,Fail,39,32,0,21,18
80,Fail,52,26,2,8,44
80,Fail,55,17,1,11,44
80,Fail,49,23,2,14,35
80,Fail,49,31,0,11,38
80,Fail,54,22,0,11,43
80,Fail,43,29,7,13,30
80,Fail,38,27,14,15,23
80,Fail,45,24,4,15,30
80,Fail,41,34,0,17,24
80,Fail,51,23,7,10,41
80,Fail,43,32,0,14,29
80,Fail,53,24,4,11,42
80,Fail,43,31,0,14,29
80,Fail,43,28,0,17,26
80,Fail,46,26,0,15,31
80,Fail,57,18,0,12,45
80,Fail,52,27,0,10,42
80,Fail,52,24,2,11,41
80,Fail,40,42,0,8,32
80,Fail,46,23,5,13,33
80,Fail,46,26,7,10,36
80,Fail,38,32,2,18,20
80,Fail,50,31,0,10,40
80,Fail,50,31,0,5,45
80,Fail,49,30,0,11,38
80,Fail,51,24,4,10,41
80,Fail,42,21,8,17,25
80,Fail,42,29,11,13,29
80,Fail,49,24,0,21,28
80,Fail,54,26,0,4,50
80,Fail,42,23,6,20,22
80,Fail,47,25,1,12,35
80,Fail,48,28,5,11,37
80,Fail,47,26,3,13,34
80,Fail,52,30,0,9,43
80,Fail,45,25,0,18,27
90,Fail,48,31,2,9,39
90,Fail,46,33,0,11,35
90,Fail,49,26,1,11,38
90,Fail,49,25,1,13,36
90,Fail,54,25,1,9,45
90,Fail,44,33,0,14,30
90,Fail,48,31,0,8,40
90,Fail,48,26,0,16,32
90,Fail,48,24,4,9,39
90,Fail,44,34,0,14,30
90,Fail,51,24,0,15,36
90,Fail,49,26,6,10,39
90,Fail,51,24,0,11,40
90,Fail,52,22,3,13,39
90,Fail,45,22,7,20,25
90,Fail,42,32,0,17,25
90,Fail,40,37,0,14,26
90,Fail,45,29,1,15,30
90,Fail,43,32,0,18,25
90,Fail,54,20,2,9,45
90,Fail,48,20,2,17,31
90,Fail,49,27,0,12,37
90,Fail,48,28,0,11,37
90,Fail,42,28,6,14,28
90,Fail,42,28,7,12,30
90,Fail,46,32,0,11,35
90,Fail,45,33,0,10,35
90,Fail,45,27,0,17,28
90,Fail,49,17,5,16,33
90,Fail,53,20,2,16,37
90,Fail,43,25,3,17,26
90,Fail,53,21,2,12,41
90,Fail,51,17,8,13,38
90,Fail,41,40,0,13,28
90,Fail,57,20,0,9,48
90,Fail,46,30,0,14,32
90,Fail,45,30,2,14,31
90,Fail,47,28,4,13,34
90,Fail,49,26,0,13,36
90,Fail,57,18,2,7,50
90,Fail,46,30,0,15,31
90,Fail,40,21,6,21,19
90,Fail,53,25,0,14,39
90,Fail,58,22,0,7,51
90,Fail,49,26,2,10,39
90,Fail,48,30,0,11,37
90,Fail,45,27,3,13,32
90,Fail,51,23,3,12,39
90,Fail,44,31,0,14,30
90,Fail,54,25,4,9,45
90,Fail,61,22,0,8,53
90,Fail,50,18,3,16,34
90,Fail,44,37,0,11,33
90,Fail,55,21,0,9,46
90,Fail,48,28,0,13,35
90,Fail,54,22,0,9,45
90,Fail,53,25,1,8,45
90,Fail,54,23,0,10,44
90,Fail,55,20,0,12,43
90,Fail,44,28,6,14,30
90,Fail,53,24,0,12,41
90,Fail,45,33,0,11,34
90,Fail,49,23,5,14,35
90,Fail,53,30,0,11,42
90,Fail,46,29,4,12,34
90,Fail,47,27,5,11,36
90,Fail,42,36,0,12,30
90,Fail,51,26,5,9,42
90,Fail,46,23,2,19,27
90,Fail,57,19,5,8,49
90,Fail,47,29,4,9,38
90,Fail,52,29,0,9,43
90,Fail,46,26,5,13,33
90,Fail,49,18,1,17,32
90,Fail,40,32,5,13,27
90,Fail,47,29,0,11,36
90,Fail,47,26,4,10,37
90,Fail,45,30,0,12,33
90,Fail,51,30,0,9,42
90,Fail,55,19,0,13,42
90,Fail,52,29,1,3,49
90,Fail,50,28,0,12,38
90,Fail,44,30,0,14,30
90,Fail,54,22,0,11,43
90,Fail,40,36,0,15,25
90,Fail,51,26,5,7,44
90,Fail,49,30,5,9,40
90,Fail,50,27,0,13,37
90,Fail,40,30,1,19,21
90,Fail,49,29,0,9,40
90,Fail,52,29,0,9,43
90,Fail,50,28,3,10,40
90,Fail,46,27,0,17,29
90,Fail,40,26,7,18,22
90,Fail,42,31,0,20,22
90,Fail,46,28,3,13,33
90,Fail,51,25,1,10,41
90,Fail,49,32,0,7,42
90,Fail,38,31,10,14,24
90,Fail,55,26,2,11,44
90,Fail,41,41,0,11,30
90,Fail,52,23,1,12,40
90,Fail,40,36,0,14,26
90,Fail,45,26,0,18,27
90,Fail,48,19,6,13,35
90,Fail,48,26,0,16,32
90,Fail,47,23,8,10,37
90,Fail,48,24,6,16,32
90,Fail,46,31,0,15,31
90,Fail,52,25,0,12,40
90,Fail,41,25,5,22,19
90,Fail,45,35,0,12,33
90,Fail,51,25,3,11,40
90,Fail,50,34,0,7,43
90,Fail,49,26,1,11,38
90,Fail,47,34,0,8,39
90,Fail,47,28,0,15,32
90,Fail,48,27,1,13,35
90,Fail,58,19,2,10,48
90,Fail,46,31,0,13,33
90,Fail,52,27,0,8,44
90,Fail,42,36,4,8,34
90,Fail,51,22,1,13,38
90,Fail,46,34,0,8,38
90,Fail,46,22,6,11,35
90,Fail,55,17,6,11,44
90,Fail,51,25,3,9,42
90,Fail,57,21,5,8,49
90,Fail,34,43,0,16,18
90,Fail,53,26,0,9,44
90,Fail,45,32,0,15,30
90,Fail,47,21,0,18,29
90,Fail,50,28,0,10,40
90,Fail,38,36,1,16,22
90,Fail,42,39,0,12,30
90,Fail,52,24,0,13,39
90,Fail,53,18,5,13,40
90,Fail,52,19,5,14,38
90,Fail,46,28,4,12,34
90,Fail,46,34,0,11,35
90,Fail,44,25,5,16,28
90,Fail,49,27,5,8,41
90,Fail,50,32,0,8,42
90,Fail,45,32,0,14,31
90,Fail,46,26,7,15,31
90,Fail,49,27,10,8,41
90,Fail,50,30,0,9,41
90,Fail,51,22,0,17,34
90,Fail,51,24,1,14,37
90,Fail,50,23,1,13,37
90,Fail,42,30,2,13,29
90,Fail,52,29,0,14,38
90,Fail,56,22,3,9,47
90,Fail,51,20,9,10,41
90,Fail,40,30,5,16,24
90,Fail,53,26,4,7,46
90,Fail,47,28,0,12,35
90,Fail,46,22,1,19,27
90,Fail,46,25,7,15,31
90,Fail,41,28,8,13,28
90,Fail,52,24,0,9,43
90,Fail,44,29,4,13,31
90,Fail,44,25,0,22,22
90,Fail,54,17,3,12,42
90,Fail,50,25,1,11,39
90,Fail,47,34,0,10,37
90,Fail,46,29,1,16,30
90,Fail,41,31,0,15,26
90,Fail,54,25,0,8,46
90,Fail,47,30,0,14,33
90,Fail,59,20,0,8,51
90,Fail,51,19,0,17,34
90,Fail,58,21,0,11,47
90,Fail,51,17,3,15,36
90,Fail,53,27,1,8,45
90,Fail,50,25,2,12,38
90,Fail,40,33,0,12,28
90,Fail,38,32,5,16,22
90,Fail,48,32,0,12,36
90,Fail,46,30,0,15,31
90,Fail,45,33,0,11,34
90,Fail,46,29,0,15,31
90,Fail,57,18,0,13,44
90,Fail,40,35,6,10,30
90,Fail,45,30,0,11,34
90,Fail,45,38,0,12,33
90,Fail,45,31,8,7,38
90,Fail,44,28,1,14,30
90,Fail,58,15,1,16,42
90,Fail,43,35,0,15,28
90,Fail,43,27,4,14,29
90,Fail,45,33,0,6,39
90,Fail,48,27,2,9,39
90,Fail,45,29,0,14,31
90,Fail,47,24,1,15,32
90,Fail,51,30,1,8,43
90,Fail,49,25,0,10,39
90,Fail,48,26,0,11,37
90,Fail,42,45,0,9,33
90,Fail,44,25,10,12,32
90,Fail,50,34,0,8,42
90,Fail,49,22,0,17,32
90,Fail,42,25,4,16,26
90,Fail,46,34,0,10,36
90,Fail,44,26,3,19,25
90,Fail,45,24,3,15,30
90,Fail,48,25,6,16,32
90,Fail,57,19,1,12,45
90,Fail,50,27,0,13,37
90,Fail,49,24,0,13,36
90,Fail,44,28,10,12,32
90,Fail,58,17,5,8,50
90,Fail,53,31,0,8,45
90,Fail,56,22,1,8,48
90,Fail,42,36,0,10,32
90,Fail,48,29,0,15,33
90,Fail,50,21,3,14,36
90,Fail,42,31,0,17,25
90,Fail,50,27,0,11,39
90,Fail,40,28,5,12,28
90,Fail,46,22,3,17,29
90,Fail,51,29,0,12,39
90,Fail,51,28,0,8,43
90,Fail,48,29,7,10,38
90,Fail,50,28,0,12,38
90,Fail,38,36,8,12,26
90,Fail,51,19,4,14,37
90,Fail,47,23,6,14,33
90,Fail,46,21,9,13,33
90,Fail,46,36,0,10,36
90,Fail,46,24,1,18,28
90,Fail,41,38,0,10,31
90,Fail,47,25,5,11,36
90,Fail,58,22,0,12,46
90,Fail,42,28,3,16,26
90,Fail,50,33,0,9,41
90,Fail,49,21,7,11,38
90,Fail,44,21,7,18,26
90,Fail,46,30,5,11,35
90,Fail,51,25,1,15,36
90,Fail,47,28,0,10,37
90,Fail,43,39,0,7,36
90,Fail,48,23,0,16,32
90,Fail,53,25,3,11,42
90,Fail,42,30,10,13,29
90,Fail,50,26,1,12,38
90,Fail,52,26,0,13,39
90,Fail,53,21,9,11,42
90,Fail,49,25,0,15,34
90,Fail,51,19,4,15,36
90,Fail,48,27,0,13,35
90,Fail,44,21,5,20,24
90,Fail,45,25,0,16,29
90,Fail,43,27,6,14,29
90,Fail,47,28,0,13,34
90,Fail,38,33,0,19,19
90,Fail,45,34,0,10,35
90,Fail,42,29,11,7,35
90,Fail,45,40,0,10,35
90,Fail,52,23,0,12,40
90,Fail,54,19,6,12,42
90,Fail,51,20,1,14,37
90,Fail,49,34,0,9,40
90,Fail,47,29,0,14,33
90,Fail,49,31,0,13,36
90,Fail,59,24,2,7,52
90,Fail,47,22,6,15,32
90,Fail,44,32,0,15,29
90,Fail,49,24,0,15,34
90,Fail,51,29,0,10,41
90,Fail,44,20,12,13,31
90,Fail,51,22,2,14,37
90,Fail,38,38,0,17,21
90,Fail,50,25,0,11,39
90,Fail,49,20,9,15,34
90,Fail,52,25,0,14,38
90,Fail,43,30,0,14,29
90,Fail,50,22,7,10,40
90,Fail,49,28,0,13,36
90,Fail,47,28,4,11,36
90,Fail,52,24,4,16,36
90,Fail,54,19,1,12,42
90,Fail,46,37,0,11,35
90,Fail,54,24,1,12,42
90,Fail,51,25,0,11,40
90,Fail,53,23,0,14,39
90,Fail,41,31,6,14,27
90,Fail,51,28,0,12,39
90,Fail,49,28,7,8,41
90,Fail,43,25,13,11,32
90,Fail,44,29,1,17,27
90,Fail,50,25,7,9,41
90,Fail,52,21,4,12,40
90,Fail,48,21,0,15,33
90,Fail,47,25,1,15,32
90,Fail,47,30,2,9,38
90,Fail,47,21,2,20,27
90,Fail,44,30,5,7,37
90,Fail,47,30,0,10,37
90,Fail,47,32,0,16,31
90,Fail,44,41,0,9,35
90,Fail,47,32,0,9,38
90,Fail,48,28,0,14,34
90,Fail,43,33,0,11,32
90,Fail,48,21,4,15,33
90,Fail,51,22,0,17,34
90,Fail,51,24,0,16,35
90,Fail,46,23,4,12,34
90,Fail,50,18,1,17,33
90,Fail,52,23,3,14,38
90,Fail,51,24,0,12,39
90,Fail,46,31,0,13,33
90,Fail,43,34,0,12,31
90,Fail,48,33,0,10,38
90,Fail,48,28,0,14,34
90,Fail,52,20,3,11,41
90,Fail,49,23,0,14,35
90,Fail,47,23,5,17,30
90,Fail,49,26,0,16,33
90,Fail,47,22,8,12,35
90,Fail,44,33,0,14,30
90,Fail,48,28,0,12,36
90,Fail,52,23,0,12,40
90,Fail,54,30,0,9,45
90,Fail,47,28,0,15,32
90,Fail,51,33,0,8,43
90,Fail,55,25,0,8,47
90,Fail,42,25,9,17,25
90,Fail,54,17,7,12,42
90,Fail,46,22,3,17,29
90,Fail,45,32,2,9,36
90,Fail,51,24,5,12,39
90,Fail,46,37,0,11,35
90,Fail,52,21,0,13,39
90,Fail,47,34,0,12,35
90,Fail,50,23,0,16,34
90,Fail,49,21,2,15,34
90,Fail,43,28,0,17,26
90,Fail,51,27,0,12,39
90,Fail,48,25,0,12,36
90,Fail,56,21,0,10,46
90,Fail,49,21,8,12,37
90,Fail,46,28,0,17,29
90,Fail,47,36,0,11,36
90,Fail,40,22,1,23,17
90,Fail,44,27,0,18,26
90,Fail,50,27,1,11,39
90,Fail,53,33,0,7,46
90,Fail,49,28,0,9,40
90,Fail,48,28,1,12,36
90,Fail,42,33,2,15,27
90,Fail,53,26,1,5,48
90,Fail,52,26,2,9,43
90,Fail,59,24,0,6,53
90,Fail,43,24,5,16,27
90,Fail,42,38,0,11,31
90,Fail,39,30,10,13,26
90,Fail,49,26,4,9,40
90,Fail,46,26,0,17,29
90,Fail,41,30,0,16,25
90,Fail,47,26,1,16,31
90,Fail,54,22,2,8,46
90,Fail,53,25,0,9,44
90,Fail,48,30,2,11,37
90,Fail,46,26,6,10,36
90,Fail,52,27,0,9,43
90,Fail,50,30,3,8,42
90,Fail,45,27,5,13,32
90,Fail,44,30,0,12,32
90,Fail,48,23,0,15,33
90,Fail,51,27,0,11,40
90,Fail,48,34,0,6,42
90,Fail,48,27,5,12,36
90,Fail,46,33,0,13,33
90,Fail,46,26,4,15,31
90,Fail,55,26,0,12,43
90,Fail,44,32,0,16,28
90,Fail,50,28,0,13,37
90,Fail,45,31,2,11,34
90,Fail,44,23,9,15,29
90,Fail,54,32,0,5,49
90,Fail,49,26,5,11,38
90,Fail,52,25,0,12,40
90,Fail,49,21,5,12,37
90,Fail,55,19,0,10,45
90,Fail,54,20,3,13,41
90,Fail,45,28,0,13,32
90,Fail,47,25,0,16,31
90,Fail,45,27,1,13,32
90,Fail,53,15,7,14,39
90,Fail,41,24,3,18,23
90,Fail,52,23,3,9,43
90,Fail,54,23,0,12,42
90,Fail,45,25,7,13,32
90,Fail,51,28,3,9,42
90,Fail,51,27,1,16,35
90,Fail,48,30,0,11,37
90,Fail,46,22,11,13,33
90,Fail,48,28,0,16,32
90,Fail,52,28,0,8,44
90,Fail,41,19,8,21,20
90,Fail,54,20,1,13,41
90,Fail,49,24,7,13,36
90,Fail,49,24,4,16,33
90,Fail,51,27,0,13,38
90,Fail,42,35,3,9,33
90,Fail,51,25,0,12,39
90,Fail,49,23,2,13,36
90,Fail,54,22,2,8,46
90,Fail,47,26,2,9,38
90,Fail,51,32,0,13,38
90,Fail,44,30,0,17,27
90,Fail,42,30,0,17,25
90,Fail,55,26,0,8,47
90,Fail,55,20,1,13,42
90,Fail,50,23,0,12,38
90,Fail,44,31,6,14,30
90,Fail,42,31,4,15,27
90,Fail,54,20,3,10,44
90,Fail,51,24,0,12,39
90,Fail,44,34,0,13,31
90,Fail,49,26,0,15,34
90,Fail,42,26,3,17,25
90,Fail,49,29,2,4,45
90,Fail,50,23,2,13,37
90,Fail,43,32,0,15,28
90,Fail,55,22,2,6,49
90,Fail,51,25,0,11,40
90,Fail,55,23,0,8,47
90,Fail,49,25,0,15,34
90,Fail,54,18,5,8,46
90,Fail,51,21,0,17,34
90,Fail,52,21,0,13,39
90,Fail,40,33,4,11,29
90,Fail,46,30,0,12,34
90,Fail,46,36,0,11,35
90,Fail,46,33,0,13,33
90,Fail,52,20,13,8,44
90,Fail,49,27,0,12,37
90,Fail,44,33,0,14,30
90,Fail,47,20,10,15,32
90,Fail,51,28,2,9,42
90,Fail,49,27,0,16,33
90,Fail,48,34,0,10,38
90,Fail,51,24,2,10,41
90,Fail,39,33,0,15,24
90,Fail,59,21,0,10,49
90,Fail,42,24,8,17,25
90,Fail,35,39,9,12,23
90,Fail,55,15,1,16,39
90,Fail,46,31,0,14,32
90,Fail,47,34,0,10,37
90,Fail,40,26,10,14,26
90,Fail,47,23,8,9,38
90,Fail,40,32,5,18,22
90,Fail,50,28,0,11,39
90,Fail,45,26,1,14,31
90,Fail,45,38,0,10,35
90,Fail,52,20,11,7,45
90,Fail,56,19,4,13,43
90,Fail,50,24,0,14,36
90,Fail,52,25,3,13,39
90,Fail,49,24,0,18,31
90,Fail,46,26,0,14,32
90,Fail,48,24,5,13,35
90,Fail,45,25,5,13,32
90,Fail,57,28,3,4,53
90,Fail,45,32,0,13,32
90,Fail,49,21,0,17,32
90,Fail,42,38,0,13,29
90,Fail,48,27,0,15,33
90,Fail,39,26,4,16,23
90,Fail,51,27,0,8,43
90,Fail,50,32,0,8,42
90,Fail,50,24,0,14,36
90,Fail,50,20,0,16,34
90,Fail,47,26,6,13,34
90,Fail,48,21,0,15,33
90,Fail,45,25,0,16,29
90,Fail,52,26,1,9,43
90,Fail,47,18,11,13,34
90,Fail,46,24,9,11,35
90,Fail,47,31,0,8,39
90,Fail,48,26,0,13,35
90,Fail,45,29,1,13,32
90,Fail,47,26,3,11,36
90,Fail,48,24,2,13,35
90,Fail,45,22,11,15,30
90,Fail,51,26,0,11,40
90,Fail,40,32,0,17,23
90,Fail,50,26,7,7,43
90,Fail,43,34,0,15,28
90,Fail,46,31,0,13,33
90,Fail,50,28,2,9,41
90,Fail,46,30,0,11,35
90,Fail,50,23,3,8,42
90,Fail,43,30,0,14,29
90,Fail,48,27,0,14,34
90,Fail,50,34,0,9,41
90,Fail,48,28,4,8,40
90,Fail,38,36,5,10,28
90,Fail,54,24,3,12,42
90,Fail,42,42,0,9,33
90,Fail,52,27,0,13,39
90,Fail,50,21,9,10,40
90,Fail,54,26,0,11,43
90,Fail,50,18,8,13,37
90,Fail,54,22,4,11,43
90,Fail,47,28,3,9,38
90,Fail,43,32,0,16,27
90,Fail,44,26,10,11,33
90,Fail,48,29,0,14,34
90,Fail,55,31,0,6,49
90,Fail,56,25,0,7,49
90,Fail,46,37,0,8,38
90,Fail,47,30,0,12,35
90,Fail,48,32,1,12,36
90,Fail,48,25,0,19,29
90,Fail,44,30,0,15,29
90,Fail,40,32,0,17,23
90,Fail,53,28,0,9,44
90,Fail,42,38,0,12,30
90,Fail,48,26,4,12,36
90,Fail,45,35,0,11,34
90,Fail,42,32,0,12,30
90,Fail,52,20,3,16,36
90,Fail,33,36,9,13,20
90,Fail,47,32,0,12,35
90,Fail,55,22,0,10,45
90,Fail,47,28,0,14,33
90,Fail,51,31,0,8,43
90,Fail,54,26,0,8,46
90,Fail,48,21,0,15,33
90,Fail,44,27,9,17,27
90,Fail,50,22,8,14,36
90,Fail,35,34,0,19,16
90,Fail,41,37,0,14,27
90,Fail,52,26,2,8,44
90,Fail,54,21,4,10,44
90,Fail,41,29,3,16,25
90,Fail,46,26,6,14,32
90,Fail,37,37,1,13,24
90,Fail,56,23,3,10,46
90,Fail,52,31,0,8,44
90,Fail,46,25,3,13,33
90,Fail,51,27,0,13,38
90,Fail,49,34,0,9,40
90,Fail,53,25,0,9,44
90,Fail,54,25,0,8,46
90,Fail,43,29,1,12,31
90,Fail,51,20,4,13,38
90,Fail,50,28,9,8,42
90,Fail,48,24,4,13,35
90,Fail,49,22,7,14,35
90,Fail,43,28,2,13,30
90,Fail,45,20,8,18,27
90,Fail,45,30,6,9,36
90,Fail,47,30,0,12,35
90,Fail,43,29,2,13,30
90,Fail,53,22,0,13,40
90,Fail,50,30,0,8,42
90,Fail,52,24,0,11,41
90,Fail,45,33,0,8,37
90,Fail,47,32,0,12,35
90,Fail,49,25,0,16,33
90,Fail,45,26,0,21,24
90,Fail,51,28,1,10,41
90,Fail,43,29,12,9,34
90,Fail,54,24,0,10,44
90,Fail,42,36,0,11,31
90,Fail,44,30,7,11,33
90,Fail,51,27,0,10,41
90,Fail,40,38,0,16,24
90,Fail,49,22,0,15,34
90,Fail,43,38,0,12,31
90,Fail,43,33,0,15,28
90,Fail,51,14,5,18,33
90,Fail,53,23,0,12,41
90,Fail,46,31,0,11,35
90,Fail,48,23,0,20,28
90,Fail,51,23,0,10,41
90,Fail,50,22,3,11,39
90,Fail,49,25,5,13,36
90,Fail,43,29,11,7,36
90,Fail,43,33,0,15,28
90,Fail,40,42,0,8,32
90,Fail,43,27,8,11,32
90,Fail,44,29,0,19,25
90,Fail,41,34,2,14,27
90,Fail,53,22,0,12,41
90,Fail,56,21,0,15,41
90,Fail,51,22,0,14,37
90,Fail,55,21,0,11,44
90,Fail,49,28,1,13,36
90,Fail,44,30,0,13,31
90,Fail,40,42,0,11,29
90,Fail,45,32,0,14,31
90,Fail,42,38,0,13,29
90,Fail,55,27,0,10,45
90,Fail,49,21,3,18,31
90,Fail,52,16,4,18,34
90,Fail,53,24,8,5,48
90,Fail,44,43,0,5,39
90,Fail,47,33,0,13,34
90,Fail,50,25,0,14,36
90,Fail,43,30,0,16,27
90,Fail,49,31,0,10,39
90,Fail,48,24,2,16,32
90,Fail,41,41,0,12,29
90,Fail,54,21,1,12,42
90,Fail,48,23,3,14,34
90,Fail,55,25,2,10,45
90,Fail,41,28,7,13,28
90,Fail,44,35,1,8,36
90,Fail,44,35,0,10,34
90,Fail,51,29,0,8,43
90,Fail,53,28,0,10,43
90,Fail,48,35,0,10,38
90,Fail,46,27,0,10,36
90,Fail,46,25,12,8,38
90,Fail,55,23,0,11,44
90,Fail,44,25,4,16,28
90,Fail,47,21,5,16,31
90,Fail,51,32,0,11,40
90,Fail,49,28,0,11,38
90,Fail,49,17,9,14,35
90,Fail,54,30,0,9,45
90,Fail,55,21,2,9,46
90,Fail,47,28,9,6,41
90,Fail,46,30,0,14,32
90,Fail,43,29,0,14,29
90,Fail,50,30,0,9,41
90,Fail,45,31,0,13,32
90,Fail,47,29,0,11,36
90,Fail,47,24,5,17,30
90,Fail,52,25,3,9,43
90,Fail,52,26,0,11,41
90,Fail,49,25,0,10,39
90,Fail,49,23,1,13,36
90,Fail,48,28,0,16,32
90,Fail,48,30,0,14,34
90,Fail,46,21,6,18,28
90,Fail,40,28,13,14,26
90,Fail,44,25,8,13,31
90,Fail,55,21,4,6,49
90,Fail,49,28,0,10,39
90,Fail,48,31,0,11,37
90,Fail,49,29,0,15,34
90,Fail,44,26,0,16,28
90,Fail,49,25,0,14,35
90,Fail,58,17,1,12,46
90,Fail,44,35,0,13,31
90,Fail,44,32,0,12,32
90,Fail,51,25,0,12,39
90,Fail,41,28,11,13,28
90,Fail,40,31,7,15,25
90,Fail,51,23,0,15,36
90,Fail,50,26,0,11,39
90,Fail,52,28,0,11,41
90,Fail,48,35,0,9,39
90,Fail,46,33,0,7,39
90,Fail,46,25,0,17,29
90,Fail,49,20,5,15,34
90,Fail,42,24,7,18,24
90,Fail,47,25,5,15,32
90,Fail,54,24,0,10,44
90,Fail,45,26,6,9,36
90,Fail,48,31,0,11,37
90,Fail,50,26,0,13,37
90,Fail,42,31,1,15,27
90,Fail,47,33,0,12,35
90,Fail,43,25,6,14,29
90,Fail,43,28,9,10,33
90,Fail,50,24,0,14,36
90,Fail,50,31,0,11,39
90,Fail,45,25,0,17,28
90,Fail,45,23,10,17,28
90,Fail,55,26,0,7,48
90,Fail,50,19,0,17,33
90,Fail,36,38,3,11,25
90,Fail,57,21,2,8,49
90,Fail,54,25,1,8,46
90,Fail,50,24,0,15,35
90,Fail,48,27,2,11,37
90,Fail,48,18,7,18,30
90,Fail,47,29,0,12,35
90,Fail,53,25,0,11,42
90,Fail,43,33,0,16,27
90,Fail,56,25,1,11,45
90,Fail,49,31,0,10,39
90,Fail,53,26,0,11,42
90,Fail,51,28,0,12,39
90,Fail,40,41,0,14,26
90,Fail,53,20,0,12,41
90,Fail,49,15,8,18,31
90,Fail,35,41,0,17,18
90,Fail,46,33,0,16,30
90,Fail,53,30,0,8,45
90,Fail,48,24,3,12,36
90,Fail,52,28,0,8,44
90,Fail,39,37,0,12,27
90,Fail,45,26,0,14,31
90,Fail,50,23,5,13,37
90,Fail,51,29,0,11,40
90,Fail,45,33,0,10,35
90,Fail,51,27,0,8,43
90,Fail,47,35,1,7,40
90,Fail,47,29,1,9,38
90,Fail,48,29,0,9,39
90,Fail,45,30,0,14,31
90,Fail,49,26,4,14,35
90,Fail,44,26,6,16,28
90,Fail,37,32,5,16,21
90,Fail,48,27,0,16,32
90,Fail,46,29,4,10,36
90,Fail,48,28,2,13,35
90,Fail,45,26,0,16,29
90,Fail,51,28,0,14,37
90,Fail,44,31,2,14,30
90,Fail,42,30,3,9,33
90,Fail,49,28,0,14,35
90,Fail,46,26,0,12,34
90,Fail,50,21,2,13,37
90,Fail,51,20,2,11,40
90,Fail,50,21,3,12,38
90,Fail,51,24,0,14,37
90,Fail,45,33,0,10,35
90,Fail,50,31,0,8,42
90,Fail,48,22,4,14,34
90,Fail,46,29,3,9,37
90,Fail,39,32,2,11,28
90,Fail,42,33,0,14,28
90,Fail,56,24,0,8,48
90,Fail,43,43,0,9,34
90,Fail,50,24,3,14,36
90,Fail,49,29,0,14,35
90,Fail,53,23,2,9,44
90,Fail,48,27,0,12,36
90,Fail,44,33,5,10,34
90,Fail,53,32,0,6,47
90,Fail,42,30,0,17,25
90,Fail,43,35,0,13,30
90,Fail,50,23,4,11,39
90,Fail,50,26,0,13,37
90,Fail,47,22,2,19,28
90,Fail,60,19,0,11,49
90,Fail,45,27,0,18,27
90,Fail,45,22,7,16,29
90,Fail,51,30,0,12,39
90,Fail,40,36,0,15,25
90,Fail,59,19,0,7,52
90,Fail,52,25,0,11,41
90,Fail,42,35,0,12,30
90,Fail,53,20,0,14,39
90,Fail,47,23,8,12,35
90,Fail,40,34,0,16,24
90,Fail,36,29,14,17,19
90,Fail,46,30,0,13,33
90,Fail,41,42,0,9,32
90,Fail,50,24,1,14,36
90,Fail,44,28,0,16,28
90,Fail,45,26,3,12,33
90,Fail,36,43,4,6,30
90,Fail,58,22,2,8,50
90,Fail,43,36,0,10,33
90,Fail,45,32,0,13,32
90,Fail,40,32,0,14,26
90,Fail,38,35,0,16,22
90,Fail,49,22,0,16,33
90,Fail,52,25,0,13,39
90,Fail,50,24,1,14,36
90,Fail,48,28,8,8,40
90,Fail,43,23,12,14,29
90,Fail,51,19,4,13,38
90,Fail,47,26,0,13,34
90,Fail,46,25,5,13,33
90,Fail,57,25,0,13,44
90,Fail,46,25,10,12,34
90,Fail,45,29,0,16,29
90,Fail,46,28,0,16,30
90,Fail,50,30,1,8,42
90,Fail,49,26,3,10,39
90,Fail,50,25,3,11,39
90,Fail,50,21,3,16,34
90,Fail,48,27,0,13,35
90,Fail,51,33,0,7,44
90,Fail,41,35,6,9,32
90,Fail,49,23,5,13,36
90,Fail,47,25,4,15,32
90,Fail,39,42,0,11,28
90,Fail,42,27,0,17,25
90,Fail,44,29,2,16,28
90,Fail,48,24,5,11,37
90,Fail,45,29,0,12,33
90,Fail,51,24,2,11,40
90,Fail,44,35,0,9,35
90,Fail,45,29,5,13,32
90,Fail,52,27,0,10,42
90,Fail,47,19,3,19,28
90,Fail,49,28,3,8,41
90,Fail,53,23,1,7,46
90,Fail,48,28,0,10,38
90,Fail,52,25,1,8,44
90,Fail,45,26,8,11,34
90,Fail,45,27,10,12,33
90,Fail,47,26,1,11,36
90,Fail,52,24,0,12,40
90,Fail,46,32,0,12,34
90,Fail,45,24,5,14,31
90,Fail,44,36,0,12,32
90,Fail,49,29,0,14,35
90,Fail,46,33,0,13,33
90,Fail,40,27,3,19,21
90,Fail,47,32,0,14,33
90,Fail,49,23,4,14,35
90,Fail,37,28,13,15,22
90,Fail,52,25,0,12,40
90,Fail,52,27,0,13,39
90,Fail,56,16,1,16,40
90,Fail,49,24,2,16,33
90,Fail,46,23,10,11,35
90,Fail,50,32,0,8,42
90,Fail,47,22,0,19,28
90,Fail,52,27,1,8,44
90,Fail,49,22,6,12,37
90,Fail,52,30,0,9,43
90,Fail,48,29,4,7,41
90,Fail,48,27,5,11,37
90,Fail,54,16,1,13,41
90,Fail,43,29,2,15,28
90,Fail,54,28,0,11,43
90,Fail,52,26,0,14,38
90,Fail,48,23,3,15,33
90,Fail,48,26,2,10,38
90,Fail,55,25,0,8,47
90,Fail,51,25,2,12,39
90,Fail,51,28,1,6,45
90,Fail,50,23,0,12,38
90,Fail,50,22,2,15,35
90,Fail,38,30,5,19,19
90,Fail,48,22,8,13,35
90,Fail,48,28,0,14,34
90,Fail,50,28,1,10,40
90,Fail,55,20,3,14,41
90,Fail,44,29,0,13,31
90,Fail,55,24,0,8,47
90,Fail,42,23,12,13,29
90,Fail,46,35,0,12,34
90,Fail,47,32,0,16,31
90,Fail,44,27,10,9,35
90,Fail,58,20,2,8,50
90,Fail,48,31,0,11,37
90,Fail,47,25,3,16,31
90,Fail,46,27,3,13,33
90,Fail,40,26,9,15,25
90,Fail,47,33,0,11,36
90,Fail,51,26,0,11,40
90,Fail,52,19,4,16,36
90,Fail,45,37,0,13,32
90,Fail,50,25,0,12,38
90,Fail,44,36,0,15,29
90,Fail,42,37,0,11,31
90,Fail,53,27,6,7,46
90,Fail,46,22,7,14,32
90,Fail,54,19,0,13,41
90,Fail,42,29,9,14,28
90,Fail,37,37,6,13,24
90,Fail,51,21,2,17,34
90,Fail,45,24,6,18,27
90,Fail,46,30,0,12,34
90,Fail,47,30,0,10,37
90,Fail,47,19,0,18,29
90,Fail,45,33,0,15,30
90,Fail,46,36,0,7,39
90,Fail,45,31,0,13,32
90,Fail,43,28,10,11,32
90,Fail,49,31,5,7,42
90,Fail,46,23,3,16,30
90,Fail,47,26,0,14,33
90,Fail,49,29,0,11,38
90,Fail,55,24,6,9,46
90,Fail,44,29,0,15,29
90,Fail,56,26,0,9,47
90,Fail,51,22,5,14,37
90,Fail,43,28,5,13,30
90,Fail,55,25,0,8,47
90,Fail,54,19,3,13,41
90,Fail,53,21,0,10,43
90,Fail,51,18,3,17,34
90,Fail,52,18,6,8,44
90,Fail,43,26,0,16,27
90,Fail,42,27,1,13,29
90,Fail,43,27,1,16,27
90,Fail,50,28,1,11,39
90,Fail,56,27,0,6,50
90,Fail,51,33,0,10,41
90,Fail,46,31,0,16,30
90,Fail,49,24,5,11,38
90,Fail,52,28,0,12,40
90,Fail,54,28,0,9,45
90,Fail,42,28,1,12,30
90,Fail,47,31,0,11,36
90,Fail,50,29,3,7,43
90,Fail,45,26,3,14,31
90,Fail,51,30,0,8,43
90,Fail,52,23,0,13,39
90,Fail,40,34,13,7,33
90,Fail,48,29,3,11,37
90,Fail,43,31,3,15,28
90,Fail,41,27,14,11,30
90,Fail,54,23,0,14,40
90,Fail,53,26,0,13,40
90,Fail,43,33,7,12,31
90,Fail,40,36,0,16,24
90,Fail,43,30,0,13,30
90,Fail,46,28,0,16,30
90,Fail,45,29,0,16,29
90,Fail,51,18,0,16,35
90,Fail,56,24,1,8,48
90,Fail,50,19,0,21,29
90,Fail,49,31,0,8,41
90,Fail,46,29,2,12,34
90,Fail,51,27,0,14,37
90,Fail,48,28,0,14,34
90,Fail,39,27,12,12,27
90,Fail,54,24,2,13,41
90,Fail,47,27,1,11,36
90,Fail,49,27,0,14,35
90,Fail,48,28,6,9,39
90,Fail,49,28,1,11,38
90,Fail,49,35,0,8,41
90,Fail,44,32,0,13,31
90,Fail,48,29,0,11,37
90,Fail,52,23,0,13,39
90,Fail,50,22,3,12,38
90,Fail,46,29,0,12,34
90,Fail,45,28,5,10,35
90,Fail,51,23,2,12,39
90,Fail,49,31,0,8,41
90,Fail,47,36,0,9,38
90,Fail,46,26,5,13,33
90,Fail,50,28,0,16,34
90,Fail,57,19,1,11,46
90,Fail,46,30,0,12,34
90,Fail,49,28,0,14,35
90,Fail,56,20,2,12,44
90,Fail,41,31,1,16,25
90,Fail,50,26,0,12,38
90,Fail,53,23,8,7,46
90,Fail,50,31,1,6,44
90,Fail,42,29,0,20,22
90,Fail,50,28,0,11,39
90,Fail,48,23,2,17,31
90,Fail,48,24,7,15,33
90,Fail,43,33,0,17,26
90,Fail,48,30,0,8,40
90,Fail,47,22,0,15,32
90,Fail,43,33,0,12,31
90,Fail,46,27,6,12,34
90,Fail,37,35,0,15,22
90,Fail,42,32,6,11,31
90,Fail,51,26,0,11,40
90,Fail,53,27,0,8,45
90,Fail,51,30,0,10,41
90,Fail,54,25,0,7,47
90,Fail,44,34,0,10,34
90,Fail,53,22,6,7,46
90,Fail,40,26,11,17,23
90,Fail,47,25,2,17,30
90,Fail,53,31,0,8,45
90,Fail,42,38,0,16,26
90,Fail,44,28,0,18,26
90,Fail,47,29,0,12,35
90,Fail,44,28,8,16,28
90,Fail,45,28,2,14,31
90,Fail,54,22,2,11,43
90,Fail,50,25,0,14,36
90,Fail,56,20,0,10,46
90,Fail,42,29,5,12,30
90,Fail,57,22,0,13,44
90,Fail,44,31,0,15,29
90,Fail,49,31,1,8,41
90,Fail,52,18,3,16,36
90,Fail,53,23,0,14,39
90,Fail,48,28,6,12,36
90,Fail,49,30,1,10,39
90,Fail,42,31,0,18,24
90,Fail,51,20,0,15,36
90,Fail,55,16,4,14,41
90,Fail,40,30,7,9,31
90,Fail,48,20,3,17,31
90,Fail,56,17,1,12,44
90,Fail,47,31,0,17,30
90,Fail,44,28,3,14,30
90,Fail,42,27,2,16,26
90,Fail,50,28,0,11,39
90,Fail,45,25,3,17,28
90,Fail,46,27,10,11,35
90,Fail,45,25,0,17,28
90,Fail,51,26,0,9,42
90,Fail,36,31,2,19,17
90,Fail,47,30,0,13,34
90,Fail,46,23,1,16,30
90,Fail,45,32,0,14,31
90,Fail,47,24,5,16,31
90,Fail,52,26,0,11,41
90,Fail,43,36,1,13,30
90,Fail,47,28,0,13,34
90,Fail,53,17,0,14,39
90,Fail,56,21,3,10,46
90,Fail,57,23,0,7,50
90,Fail,49,26,0,14,35
90,Fail,50,23,2,13,37
90,Fail,49,29,8,8,41
90,Fail,60,17,0,11,49
90,Fail,51,26,0,10,41
90,Fail,52,19,1,13,39
90,Fail,44,26,0,19,25
90,Fail,46,29,4,8,38
90,Fail,41,37,0,11,30
90,Fail,46,27,2,14,32
90,Fail,41,37,0,15,26
90,Fail,49,28,0,12,37
90,Fail,44,25,2,17,27
90,Fail,47,27,4,16,31
90,Fail,50,25,1,11,39
90,Fail,56,17,1,15,41
90,Fail,49,37,0,7,42
90,Fail,46,25,10,12,34
90,Fail,51,29,3,6,45
90,Fail,54,24,3,10,44
90,Fail,52,26,3,10,42
90,Fail,52,20,6,8,44
90,Fail,46,27,0,16,30
90,Fail,49,25,0,13,36
90,Fail,45,26,6,13,32
90,Fail,53,16,0,16,37
90,Fail,52,29,0,10,42
90,Fail,37,34,6,15,22
90,Fail,44,30,1,15,29
90,Fail,50,23,2,9,41
90,Fail,48,21,5,17,31
90,Fail,38,39,0,18,20
90,Fail,41,30,0,15,26
90,Fail,45,24,2,14,31
90,Fail,46,31,4,12,34
90,Fail,51,21,7,9,42
90,Fail,50,24,0,12,38
90,Fail,47,34,0,12,35
90,Fail,48,31,4,10,38
90,Fail,46,24,5,11,35
90,Fail,44,31,1,18,26
90,Fail,54,18,7,10,44
90,Fail,39,42,0,15,24
90,Fail,48,27,0,15,33
90,Fail,48,31,0,13,35
90,Fail,53,27,0,12,41
90,Fail,52,26,1,10,42
90,Fail,52,25,0,11,41
90,Fail,43,33,0,11,32
90,Fail,46,30,0,12,34
90,Fail,39,31,3,19,20
90,Fail,55,15,4,13,42
90,Fail,45,21,9,14,31
90,Fail,47,27,0,14,33
90,Fail,52,19,1,15,37
90,Fail,54,25,0,13,41
90,Fail,54,30,0,11,43
90,Fail,56,22,2,8,48
90,Fail,44,31,5,9,35
90,Fail,47,26,5,9,38
90,Fail,54,19,10,10,44
90,Fail,47,29,0,12,35
90,Fail,58,25,2,4,54
90,Fail,48,26,0,13,35
90,Fail,54,23,0,10,44
90,Fail,50,27,3,9,41
90,Fail,41,37,0,9,32
90,Fail,49,22,4,12,37
90,Fail,48,24,2,13,35
90,Fail,42,22,4,21,21
90,Fail,44,26,0,17,27
90,Fail,41,28,11,16,25
90,Fail,44,30,0,16,28
90,Fail,46,31,0,11,35
90,Fail,46,28,0,15,31
90,Fail,44,27,2,14,30
90,Fail,50,21,5,11,39
90,Fail,51,26,0,12,39
90,Fail,47,25,0,15,32
90,Fail,37,45,0,12,25
90,Fail,41,26,9,14,27
90,Fail,49,20,3,17,32
90,Fail,47,28,0,14,33
90,Fail,38,38,0,16,22
90,Fail,46,27,1,15,31
90,Fail,49,26,6,9,40
90,Fail,52,23,0,13,39
90,Fail,44,35,0,14,30
90,Fail,50,23,1,14,36
90,Fail,53,20,3,13,40
90,Fail,52,19,7,8,44
90,Fail,44,28,5,15,29
90,Fail,45,30,2,14,31
90,Fail,49,26,0,13,36
90,Fail,46,26,0,18,28
90,Fail,41,31,11,11,30
90,Fail,46,27,3,14,32
90,Fail,45,27,0,11,34
90,Fail,48,29,3,13,35
90,Fail,52,24,0,11,41
90,Fail,49,22,1,16,33
90,Fail,53,20,0,12,41
90,Fail,45,37,3,7,38
90,Fail,38,38,0,15,23
90,Fail,46,29,0,16,30
90,Fail,45,26,2,16,29
90,Fail,34,49,0,7,27
90,Fail,49,24,0,14,35
90,Fail,46,25,0,21,25
90,Fail,43,26,6,16,27
90,Fail,48,32,0,13,35
90,Fail,48,24,0,15,33
90,Fail,47,33,0,11,36
90,Fail,59,17,0,12,47
90,Fail,44,22,7,17,27
90,Fail,47,27,3,11,36
90,Fail,49,26,4,9,40
90,Fail,45,24,2,15,30
90,Fail,47,33,0,9,38
90,Fail,50,26,3,11,39
90,Fail,43,21,2,26,17
90,Fail,51,26,0,9,42
90,Fail,46,22,6,13,33
90,Fail,50,24,0,15,35
90,Fail,45,24,1,20,25
90,Fail,46,24,4,12,34
90,Fail,44,24,8,15,29
90,Fail,44,29,6,11,33
90,Fail,50,26,0,20,30
90,Fail,45,28,0,12,33
90,Fail,49,28,3,9,40
90,Fail,51,24,2,11,40
90,Fail,46,32,0,12,34
90,Fail,42,30,3,11,31
90,Fail,55,25,0,13,42
90,Fail,46,32,0,11,35
90,Fail,45,23,6,15,30
90,Fail,44,30,1,14,30
90,Fail,51,29,1,9,42
90,Fail,37,44,0,14,23
90,Fail,48,32,0,12,36
90,Fail,55,21,0,12,43
90,Fail,53,27,0,6,47
90,Fail,44,30,3,13,31
90,Fail,56,20,5,9,47
90,Fail,49,27,0,13,36
90,Fail,42,29,1,18,24
90,Fail,57,13,0,15,42
90,Fail,45,31,0,10,35
90,Fail,45,29,0,14,31
90,Fail,59,21,0,7,52
90,Fail,53,28,0,8,45
90,Fail,52,25,1,10,42
90,Fail,49,30,0,14,35
90,Fail,48,25,0,15,33
90,Fail,51,28,1,8,43
90,Fail,39,32,5,13,26
90,Fail,40,33,6,12,28
90,Fail,47,27,0,16,31
90,Fail,60,18,3,10,50
90,Fail,50,30,0,9,41
90,Fail,47,27,0,12,35
90,Fail,47,32,0,12,35
90,Fail,46,33,0,12,34
90,Fail,49,22,6,13,36
90,Fail,52,23,1,11,41
90,Fail,53,25,0,8,45
90,Fail,54,24,0,13,41
90,Fail,42,33,0,15,27
90,Fail,50,28,0,13,37
90,Fail,48,29,0,14,34
90,Fail,42,30,0,15,27
90,Fail,48,26,5,12,36
90,Fail,52,22,2,11,41
90,Fail,48,22,5,15,33
90,Fail,49,25,0,18,31
90,Fail,45,36,0,7,38
90,Fail,53,31,0,9,44
90,Fail,46,32,0,13,33
90,Fail,45,28,8,11,34
90,Fail,53,24,0,12,41
90,Fail,55,23,1,11,44
90,Fail,53,30,1,8,45
90,Fail,41,33,0,14,27
90,Fail,48,32,0,10,38
90,Fail,43,37,0,9,34
90,Fail,56,19,0,9,47
90,Fail,48,24,0,14,34
90,Fail,48,24,0,16,32
90,Fail,48,25,1,12,36
90,Fail,55,23,0,10,45
90,Fail,47,34,0,9,38
90,Fail,49,22,9,13,36
90,Fail,49,22,0,16,33
90,Fail,45,32,0,13,32
90,Fail,58,22,0,6,52
90,Fail,50,29,0,11,39
90,Fail,50,25,0,14,36
90,Fail,54,21,1,13,41
90,Fail,53,21,0,12,41
90,Fail,56,24,2,10,46
90,Fail,45,26,2,16,29
90,Fail,43,27,6,14,29
90,Fail,43,36,0,14,29
90,Fail,44,23,5,14,30
90,Fail,42,33,0,17,25
90,Fail,54,25,0,13,41
90,Fail,44,25,0,22,22
90,Fail,45,30,0,13,32
90,Fail,52,24,0,12,40
90,Fail,47,23,7,14,33
90,Fail,53,26,2,9,44
90,Fail,39,32,6,13,26
90,Fail,50,26,1,17,33
90,Fail,44,37,0,13,31
90,Fail,50,28,0,11,39
90,Fail,47,25,9,13,34
90,Fail,42,24,3,18,24
90,Fail,56,16,2,13,43
90,Fail,50,22,2,17,33
90,Fail,50,27,0,11,39
90,Fail,51,26,0,13,38
90,Fail,43,32,0,11,32
90,Fail,50,24,5,13,37
90,Fail,50,28,0,16,34
90,Fail,43,26,0,15,28
90,Fail,49,25,7,13,36
90,Fail,54,20,3,9,45
90,Fail,56,27,1,5,51
90,Fail,52,21,2,11,41
90,Fail,47,21,3,19,28
90,Fail,53,23,8,7,46
90,Fail,41,28,1,16,25
90,Fail,47,31,0,13,34
90,Fail,55,24,0,9,46
90,Fail,43,39,0,8,35
90,Fail,59,22,0,8,51
90,Fail,39,28,8,20,19
90,Fail,52,29,1,5,47
90,Fail,49,22,1,17,32
90,Fail,48,35,0,9,39
90,Fail,48,29,2,10,38
90,Fail,48,24,10,13,35
90,Fail,52,22,0,17,35
90,Fail,49,27,0,15,34
90,Fail,46,26,10,13,33
90,Fail,41,32,1,15,26
90,Fail,45,37,0,11,34
90,Fail,39,39,0,14,25
90,Fail,48,28,2,11,37
90,Fail,55,24,0,12,43
90,Fail,47,25,0,14,33
90,Fail,43,29,0,20,23
90,Fail,51,28,0,11,40
90,Fail,48,31,0,9,39
90,Fail,54,16,3,16,38
90,Fail,45,31,0,12,33
90,Fail,45,30,4,9,36
90,Fail,52,26,1,11,41
90,Fail,46,30,0,12,34
90,Fail,53,25,2,10,43
90,Fail,44,34,0,14,30
90,Fail,42,28,0,19,23
90,Fail,44,40,0,11,33
90,Fail,44,35,0,13,31
90,Fail,40,30,5,14,26
90,Fail,50,21,0,14,36
90,Fail,47,25,7,13,34
90,Fail,54,22,0,10,44
90,Fail,50,25,0,14,36
90,Fail,40,33,0,18,22
90,Fail,49,35,0,9,40
90,Fail,48,29,0,16,32
90,Fail,45,28,0,17,28
90,Fail,48,32,0,11,37
90,Fail,39,37,0,12,27
90,Fail,36,32,0,19,17
90,Fail,50,24,0,17,33
90,Fail,50,22,1,15,35
90,Fail,55,26,0,8,47
90,Fail,47,30,0,14,33
90,Fail,57,24,1,6,51
90,Fail,53,19,6,9,44
90,Fail,48,27,0,17,31
90,Fail,53,25,1,10,43
90,Fail,52,25,0,14,38
90,Fail,42,37,0,13,29
90,Fail,45,24,3,15,30
90,Fail,42,37,0,11,31
90,Fail,53,20,2,13,40
90,Fail,52,24,0,13,39
90,Fail,46,37,0,11,35
90,Fail,47,25,13,9,38
90,Fail,47,29,0,14,33
90,Fail,48,34,0,13,35
90,Fail,49,22,5,14,35
90,Fail,49,28,0,15,34
90,Fail,44,33,0,11,33
90,Fail,49,33,0,9,40
90,Fail,43,27,2,17,26
90,Fail,44,37,0,11,33
90,Fail,46,36,0,8,38
90,Fail,48,17,8,15,33
90,Fail,46,24,9,13,33
90,Fail,48,27,4,8,40
90,Fail,53,29,0,7,46
90,Fail,49,25,0,16,33
90,Fail,55,27,0,9,46
90,Fail,43,26,8,14,29
90,Fail,50,30,0,7,43
90,Fail,45,23,0,18,27
90,Fail,51,25,0,12,39
90,Fail,61,16,1,8,53
90,Fail,43,29,7,15,28
90,Fail,52,15,10,15,37
90,Fail,46,37,0,8,38
90,Fail,51,19,0,17,34
90,Fail,46,27,0,18,28
90,Fail,44,31,6,10,34
90,Fail,46,25,0,14,32
90,Fail,56,17,2,15,41
90,Fail,52,28,0,12,40
90,Fail,47,27,0,14,33
90,Fail,43,38,0,14,29
90,Fail,43,24,12,17,26
90,Fail,46,25,0,14,32
90,Fail,51,24,6,11,40
90,Fail,40,29,5,19,21
90,Fail,54,22,2,10,44
90,Fail,54,26,0,12,42
90,Fail,56,23,3,10,46
90,Fail,36,45,0,12,24
90,Fail,45,27,0,17,28
90,Fail,58,23,0,11,47
90,Fail,43,31,8,8,35
90,Fail,47,34,0,8,39
90,Fail,45,36,0,10,35
90,Fail,50,23,4,15,35
90,Fail,51,26,0,8,43
90,Fail,59,16,4,12,47
90,Fail,44,31,1,13,31
90,Fail,48,29,0,12,36
90,Fail,46,25,2,15,31
90,Fail,53,23,0,13,40
90,Fail,44,29,0,14,30
90,Fail,56,24,0,8,48
90,Fail,42,37,0,13,29
90,Fail,38,37,0,14,24
90,Fail,44,35,0,13,31
90,Fail,50,23,5,13,37
90,Fail,48,30,0,10,38
90,Fail,42,38,0,12,30
90,Fail,45,31,0,16,29
90,Fail,49,30,0,12,37
90,Fail,54,22,0,13,41
90,Fail,53,29,0,7,46
90,Fail,46,26,2,14,32
90,Fail,53,23,2,13,40
90,Fail,44,42,0,11,33
90,Fail,41,34,3,11,30
90,Fail,44,34,0,12,32
90,Fail,50,19,8,11,39
90,Fail,55,21,0,13,42
90,Fail,46,24,7,13,33
90,Fail,51,22,7,10,41
90,Fail,49,28,0,12,37
90,Fail,47,27,3,10,37
90,Fail,40,30,0,17,23
90,Fail,46,29,7,9,37
90,Fail,55,22,0,14,41
90,Fail,51,22,0,14,37
90,Fail,46,28,0,13,33
90,Fail,44,31,0,13,31
90,Fail,51,26,0,11,40
90,Fail,46,34,0,10,36
90,Fail,52,20,6,12,40
90,Fail,46,33,0,10,36
90,Fail,47,31,0,12,35
90,Fail,46,28,1,16,30
90,Fail,42,27,10,14,28
90,Fail,48,30,0,13,35
90,Fail,42,38,0,13,29
90,Fail,47,31,0,13,34
90,Fail,50,24,3,12,38
90,Fail,47,28,3,7,40
90,Fail,51,27,5,8,43
90,Fail,52,18,0,18,34
90,Fail,48,28,0,13,35
90,Fail,51,28,2,10,41
90,Fail,49,24,6,9,40
90,Fail,41,38,0,14,27
90,Fail,46,30,0,12,34
90,Fail,47,29,0,13,34
90,Fail,49,32,4,7,42
90,Fail,46,31,0,10,36
90,Fail,50,23,3,10,40
90,Fail,54,19,1,12,42
90,Fail,52,22,4,12,40
90,Fail,37,22,11,21,16
90,Fail,47,28,0,13,34
90,Fail,44,24,9,16,28
90,Fail,52,30,0,12,40
90,Fail,47,34,5,9,38
90,Fail,47,34,0,8,39
90,Fail,46,28,5,13,33
90,Fail,49,29,0,10,39
90,Fail,51,28,6,9,42
90,Fail,54,20,0,11,43
90,Fail,51,26,0,10,41
90,Fail,45,26,6,11,34
90,Fail,53,26,5,8,45
90,Fail,50,22,6,13,37
90,Fail,49,28,0,9,40
90,Fail,53,33,0,9,44
90,Fail,50,32,0,11,39
90,Fail,47,31,0,8,39
90,Fail,48,29,0,12,36
90,Fail,50,22,3,12,38
90,Fail,44,26,5,11,33
90,Fail,43,34,1,10,33
90,Fail,49,23,0,13,36
90,Fail,45,35,0,14,31
90,Fail,44,33,2,13,31
90,Fail,43,33,0,15,28
90,Fail,58,19,4,6,52
90,Fail,45,33,0,14,31
90,Fail,54,27,0,10,44
90,Fail,50,18,4,17,33
90,Fail,51,28,0,12,39
90,Fail,42,41,0,10,32
90,Fail,49,31,0,12,37
90,Fail,53,20,0,15,38
90,Fail,45,30,0,15,30
90,Fail,52,21,3,11,41
90,Fail,51,28,0,13,38
90,Fail,43,32,0,14,29
90,Fail,44,34,0,13,31
90,Fail,49,29,1,11,38
90,Fail,49,28,0,12,37
90,Fail,50,25,0,11,39
90,Fail,42,37,0,13,29
90,Fail,54,19,1,13,41
90,Fail,46,28,5,12,34
90,Fail,48,34,0,12,36
90,Fail,42,27,3,18,24
90,Fail,52,24,5,11,41
90,Fail,47,36,0,7,40
90,Fail,54,15,4,19,35
90,Fail,41,26,4,20,21
90,Fail,47,28,1,13,34
90,Fail,52,16,15,9,43
90,Fail,53,22,1,13,40
90,Fail,44,26,0,22,22
90,Fail,45,30,1,14,31
90,Fail,48,21,0,19,29
90,Fail,48,21,6,11,37
90,Fail,49,31,0,10,39
90,Fail,50,22,1,12,38
90,Fail,42,27,8,15,27
90,Fail,52,20,9,8,44
90,Fail,42,35,1,10,32
90,Fail,49,20,8,13,36
90,Fail,50,30,0,11,39
90,Fail,52,19,3,12,40
90,Fail,45,29,0,14,31
90,Fail,41,37,0,16,25
90,Fail,57,20,0,9,48
90,Fail,48,32,0,9,39
90,Fail,40,32,0,20,20
90,Fail,53,23,0,12,41
90,Fail,54,18,1,17,37
90,Fail,40,40,0,10,30
90,Fail,44,31,0,16,28
90,Fail,53,26,0,11,42
90,Fail,48,27,0,15,33
90,Fail,50,21,0,11,39
90,Fail,43,28,1,17,26
90,Fail,50,25,5,11,39
90,Fail,45,28,0,18,27
90,Fail,49,25,0,17,32
90,Fail,48,29,10,7,41
90,Fail,42,31,0,17,25
90,Fail,49,16,4,17,32
90,Fail,45,34,0,8,37
90,Fail,42,28,5,15,27
90,Fail,47,29,1,13,34
90,Fail,43,27,9,13,30
90,Fail,46,33,0,10,36
90,Fail,53,25,0,11,42
90,Fail,54,19,0,13,41
90,Fail,49,25,0,15,34
90,Fail,52,23,0,12,40
90,Fail,45,24,7,12,33
90,Fail,45,24,4,12,33
90,Fail,46,30,0,12,34
90,Fail,49,30,0,14,35
90,Fail,46,29,0,11,35
90,Fail,52,22,5,10,42
90,Fail,48,22,0,17,31
90,Fail,40,25,6,15,25
90,Fail,54,18,0,14,40
90,Fail,42,26,8,18,24
90,Fail,37,33,10,12,25
90,Fail,50,29,0,10,40
90,Fail,44,36,0,7,37
90,Fail,55,26,0,9,46
90,Fail,52,24,1,13,39
90,Fail,52,23,2,13,39
90,Fail,52,26,0,11,41
90,Fail,49,26,2,12,37
90,Fail,51,24,0,14,37
90,Fail,47,26,8,9,38
90,Fail,48,22,15,6,42
90,Fail,49,25,1,14,35
90,Fail,40,42,0,12,28
90,Fail,41,35,0,8,33
90,Fail,43,32,0,14,29
90,Fail,54,23,7,8,46
90,Fail,50,32,0,11,39
90,Fail,56,28,0,6,50
90,Fail,46,27,2,13,33
90,Fail,55,17,1,15,40
90,Fail,44,31,0,13,31
90,Fail,44,32,2,11,33
90,Fail,48,27,0,15,33
90,Fail,52,22,7,12,40
90,Fail,53,25,1,10,43
90,Fail,54,20,5,9,45
90,Fail,55,23,1,7,48
90,Fail,46,29,0,17,29
90,Fail,40,27,5,22,18
90,Fail,41,27,7,13,28
90,Fail,52,22,0,15,37
90,Fail,41,30,0,19,22
90,Fail,45,27,3,15,30
90,Fail,51,24,2,10,41
90,Fail,44,26,1,17,27
90,Fail,49,22,8,10,39
90,Fail,46,28,3,13,33
90,Fail,48,27,0,10,38
90,Fail,51,24,0,14,37
90,Fail,43,33,3,11,32
90,Fail,45,28,0,16,29
90,Fail,43,30,0,13,30
90,Fail,45,32,0,12,33
90,Fail,45,27,6,14,31
90,Fail,44,31,0,15,29
90,Fail,42,40,0,10,32
90,Fail,53,20,3,14,39
90,Fail,46,37,0,5,41
90,Fail,40,35,0,15,25
90,Fail,54,26,0,8,46
90,Fail,50,30,0,11,39
90,Fail,38,37,0,17,21
90,Fail,48,26,1,15,33
90,Fail,51,31,0,9,42
90,Fail,44,29,0,17,27
90,Fail,49,26,0,14,35
90,Fail,49,34,0,8,41
90,Fail,55,25,2,12,43
90,Fail,38,36,0,16,22
90,Fail,49,29,0,13,36
90,Fail,48,31,2,9,39
90,Fail,46,39,0,11,35
90,Fail,44,31,0,13,31
90,Fail,48,26,2,17,31
90,Fail,50,31,0,9,41
90,Fail,49,29,0,12,37
90,Fail,49,28,0,13,36
90,Fail,52,21,8,10,42
90,Fail,46,29,0,16,30
90,Fail,43,39,0,14,29
90,Fail,48,27,3,13,35
90,Fail,40,31,0,22,18
90,Fail,55,19,0,13,42
90,Fail,51,22,1,15,36
90,Fail,51,30,0,8,43
90,Fail,50,26,0,10,40
90,Fail,48,30,0,10,38
90,Fail,54,33,0,6,48
90,Fail,52,26,0,11,41
90,Fail,61,17,1,6,55
90,Fail,50,25,2,11,39
90,Fail,43,33,0,9,34
90,Fail,51,27,0,11,40
90,Fail,57,24,0,6,51
90,Fail,52,29,3,8,44
90,Fail,52,25,0,11,41
90,Fail,50,31,0,12,38
90,Fail,47,31,0,13,34
90,Fail,44,27,5,14,30
90,Fail,48,30,0,13,35
90,Fail,47,22,6,16,31
90,Fail,52,25,5,11,41
90,Fail,45,37,0,11,34
90,Fail,40,23,8,17,23
90,Fail,49,28,0,12,37
90,Fail,54,22,0,14,40
90,Fail,46,28,2,11,35
90,Fail,51,20,6,16,35
90,Fail,51,29,0,12,39
90,Fail,51,29,1,9,42
90,Fail,44,35,0,8,36
90,Fail,49,23,1,17,32
90,Fail,46,32,0,15,31
90,Fail,43,29,0,16,27
90,Fail,54,25,3,8,46
90,Fail,43,33,0,16,27
90,Fail,54,24,1,10,44
90,Fail,43,32,0,15,28
90,Fail,39,33,0,14,25
90,Fail,42,31,1,15,27
90,Fail,55,21,4,6,49
90,Fail,53,20,3,12,41
90,Fail,41,38,0,15,26
90,Fail,49,22,4,15,34
90,Fail,42,30,0,11,31
90,Fail,53,22,0,12,41
90,Fail,49,28,0,12,37
90,Fail,53,22,4,6,47
90,Fail,44,29,6,10,34
90,Fail,52,17,8,15,37
90,Fail,49,28,2,13,36
90,Fail,44,30,2,11,33
90,Fail,57,21,5,6,51
90,Fail,53,21,4,11,42
90,Fail,43,36,0,12,31
90,Fail,50,26,7,12,38
90,Fail,44,24,4,15,29
90,Fail,46,20,6,20,26
90,Fail,52,31,0,10,42
90,Fail,49,21,0,13,36
90,Fail,41,23,10,13,28
90,Fail,60,19,0,5,55
90,Fail,47,30,0,13,34
90,Fail,50,35,0,6,44
90,Fail,48,24,3,14,34
90,Fail,50,31,0,11,39
90,Fail,47,30,0,10,37
90,Fail,50,24,0,11,39
90,Fail,47,20,3,17,30
90,Fail,47,29,6,8,39
90,Fail,39,34,3,13,26
90,Fail,44,26,1,17,27
90,Fail,43,27,1,14,29
90,Fail,50,24,9,6,44
90,Fail,56,17,1,12,44
90,Fail,60,15,0,14,46
90,Fail,48,30,2,10,38
90,Fail,45,31,2,9,36
90,Fail,53,17,4,16,37
90,Fail,44,34,0,12,32
90,Fail,52,26,0,15,37
90,Fail,43,30,0,15,28
90,Fail,52,25,0,14,38
90,Fail,47,26,0,10,37
90,Fail,40,31,0,17,23
90,Fail,52,22,1,12,40
90,Fail,46,39,0,7,39
90,Fail,51,27,0,15,36
90,Fail,45,21,6,17,28
90,Fail,42,29,7,13,29
90,Fail,44,34,0,15,29
90,Fail,52,26,0,13,39
90,Fail,48,33,0,9,39
90,Fail,51,22,0,15,36
90,Fail,50,23,3,16,34
90,Fail,49,31,2,6,43
90,Fail,45,31,1,12,33
90,Fail,41,29,2,17,24
90,Fail,51,26,0,10,41
90,Fail,48,25,0,15,33
90,Fail,48,27,0,13,35
90,Fail,52,22,0,13,39
90,Fail,54,22,1,11,43
90,Fail,43,25,6,15,28
90,Fail,41,37,0,14,27
90,Fail,43,34,0,12,31
90,Fail,53,25,0,9,44
90,Fail,50,25,0,12,38
90,Fail,45,24,6,14,31
90,Fail,51,25,0,12,39
90,Fail,48,25,6,10,38
90,Fail,48,28,0,14,34
90,Fail,48,29,0,15,33
90,Fail,52,25,3,11,41
90,Fail,46,32,2,11,35
90,Fail,44,37,0,10,34
90,Fail,54,24,2,7,47
90,Fail,45,32,2,12,33
90,Fail,45,31,0,15,30
90,Fail,45,34,0,10,35
90,Fail,53,25,0,9,44
90,Fail,47,29,0,12,35
90,Fail,53,22,0,15,38
90,Fail,39,30,6,19,20
90,Fail,50,23,0,14,36
90,Fail,51,23,0,12,39
90,Fail,49,21,2,16,33
90,Fail,47,30,1,12,35
90,Fail,49,23,0,18,31
90,Fail,52,31,0,5,47
90,Fail,49,25,3,13,36
90,Fail,47,29,0,15,32
90,Fail,46,30,0,16,30
90,Fail,43,29,0,13,30
90,Fail,41,32,2,11,30
90,Fail,54,22,5,10,44
90,Fail,51,28,2,12,39
90,Fail,49,24,0,14,35
90,Fail,46,29,9,7,39
90,Fail,44,33,0,14,30
90,Fail,54,16,1,15,39
90,Fail,46,33,0,14,32
90,Fail,47,28,0,13,34
90,Fail,46,26,0,16,30
90,Fail,48,26,0,14,34
90,Fail,49,28,6,8,41
90,Fail,47,29,2,10,37
90,Fail,54,25,0,10,44
90,Fail,49,28,0,14,35
90,Fail,48,28,0,12,36
90,Fail,46,29,0,15,31
90,Fail,51,20,1,15,36
90,Fail,54,23,0,10,44
90,Fail,48,31,0,10,38
90,Fail,43,26,0,16,27
90,Fail,49,23,3,14,35
90,Fail,52,22,5,11,41
90,Fail,44,25,3,14,30
90,Fail,44,28,9,14,30
90,Fail,48,26,2,14,34
90,Fail,57,14,0,10,47
90,Fail,46,31,0,14,32
90,Fail,50,35,0,7,43
90,Fail,46,29,6,16,30
90,Fail,44,31,0,16,28
90,Fail,45,23,9,14,31
90,Fail,46,35,0,10,36
90,Fail,52,23,2,11,41
90,Fail,45,27,3,13,32
90,Fail,49,31,0,11,38
90,Fail,51,27,0,13,38
90,Fail,48,26,1,12,36
90,Fail,49,27,0,13,36
90,Fail,41,26,9,18,23
90,Fail,45,39,0,6,39
90,Fail,43,39,0,12,31
90,Fail,51,28,0,10,41
90,Fail,47,28,7,9,38
90,Fail,45,29,0,18,27
90,Fail,49,30,0,12,37
90,Fail,45,29,0,12,33
90,Fail,46,26,2,13,33
90,Fail,46,30,1,15,31
90,Fail,46,32,0,9,37
90,Fail,52,23,2,13,39
90,Fail,43,22,7,19,24
90,Fail,45,23,7,15,30
90,Fail,44,29,0,13,31
90,Fail,52,29,0,11,41
90,Fail,41,33,0,14,27
90,Fail,49,26,0,10,39
90,Fail,39,31,0,16,23
90,Fail,44,32,5,8,36
90,Fail,51,19,0,18,33
90,Fail,52,23,3,9,43
90,Fail,45,32,0,10,35
90,Fail,38,33,0,20,18
90,Fail,57,21,2,6,51
90,Fail,54,19,0,12,42
90,Fail,49,25,0,13,36
90,Fail,53,29,2,8,45
90,Fail,51,15,7,17,34
90,Fail,41,38,0,11,30
90,Fail,42,35,0,12,30
90,Fail,52,19,1,14,38
90,Fail,40,27,15,12,28
90,Fail,51,21,0,11,40
90,Fail,55,19,0,13,42
90,Fail,39,30,10,13,26
90,Fail,45,37,0,6,39
90,Fail,45,26,0,15,30
90,Fail,44,33,0,15,29
90,Fail,55,21,0,10,45
90,Fail,44,34,0,13,31
90,Fail,55,19,2,13,42
90,Fail,37,32,10,14,23
90,Fail,41,32,3,16,25
90,Fail,55,20,7,9,46
90,Fail,53,19,5,8,45
90,Fail,46,31,0,12,34
90,Fail,57,18,2,14,43
90,Fail,48,31,0,13,35
90,Fail,46,27,0,11,35
90,Fail,50,27,0,14,36
90,Fail,45,30,4,12,33
90,Fail,41,25,8,15,26
90,Fail,46,31,1,12,34
90,Fail,45,25,6,16,29
90,Fail,47,29,0,11,36
90,Fail,47,31,2,8,39
90,Fail,51,27,3,8,43
90,Fail,46,17,6,20,26
90,Fail,44,34,0,15,29
90,Fail,46,25,0,14,32
90,Fail,38,37,0,13,25
90,Fail,46,36,0,11,35
90,Fail,50,27,0,10,40
90,Fail,46,27,6,11,35
90,Fail,53,24,2,12,41
90,Fail,50,28,2,11,39
90,Fail,52,28,0,8,44
90,Fail,44,31,4,14,30
90,Fail,46,29,0,18,28
90,Fail,48,29,0,14,34
90,Fail,50,30,0,10,40
90,Fail,52,28,0,10,42
90,Fail,49,28,0,16,33
90,Fail,54,27,0,9,45
90,Fail,47,25,7,11,36
90,Fail,47,30,2,11,36
90,Fail,46,23,11,12,34
90,Fail,45,33,0,13,32
90,Fail,50,25,4,14,36
90,Fail,41,25,3,20,21
90,Fail,53,23,0,12,41
90,Fail,46,30,0,15,31
90,Fail,51,27,0,15,36
90,Fail,52,20,2,14,38
90,Fail,47,22,8,14,33
90,Fail,51,21,0,12,39
90,Fail,49,31,1,8,41
90,Fail,44,34,0,16,28
90,Fail,59,19,0,11,48
90,Fail,51,23,4,11,40
90,Fail,47,31,0,11,36
90,Fail,52,20,9,15,37
90,Fail,44,35,0,13,31
90,Fail,49,27,0,9,40
90,Fail,47,29,0,10,37
90,Fail,61,19,0,9,52
90,Fail,48,21,9,9,39
90,Fail,48,26,0,13,35
90,Fail,47,24,6,16,31
90,Fail,52,23,0,13,39
90,Fail,45,35,0,15,30
90,Fail,45,29,2,11,34
90,Fail,48,37,0,7,41
90,Fail,53,29,2,5,48
90,Fail,43,29,4,13,30
90,Fail,50,28,5,8,42
90,Fail,50,27,3,9,41
90,Fail,52,23,2,12,40
90,Fail,54,23,5,9,45
90,Fail,51,21,3,10,41
90,Fail,45,31,6,10,35
90,Fail,47,23,8,13,34
90,Fail,60,17,2,9,51
90,Fail,55,23,2,6,49
90,Fail,50,25,5,12,38
90,Fail,41,35,3,14,27
90,Fail,50,22,0,16,34
90,Fail,53,29,0,9,44
90,Fail,49,28,0,11,38
90,Fail,44,31,0,16,28
90,Fail,53,23,0,10,43
90,Fail,50,34,0,8,42
90,Fail,53,22,3,13,40
90,Fail,47,25,2,13,34
90,Fail,51,22,2,13,38
90,Fail,51,22,0,16,35
90,Fail,49,33,0,11,38
90,Fail,51,20,1,13,38
90,Fail,51,26,1,10,41
90,Fail,44,32,0,11,33
90,Fail,47,33,0,11,36
90,Fail,48,27,1,16,32
90,Fail,38,25,7,16,22
90,Fail,47,34,0,11,36
90,Fail,62,17,0,6,56
90,Fail,46,24,5,13,33
90,Fail,43,24,6,19,24
90,Fail,38,43,0,12,26
90,Fail,47,25,0,14,33
90,Fail,45,21,7,14,31
90,Fail,48,27,1,13,35
90,Fail,52,26,6,8,44
90,Fail,51,28,0,11,40
90,Fail,45,26,8,12,33
90,Fail,48,28,5,11,37
90,Fail,48,21,7,11,37
90,Fail,50,26,2,12,38
90,Fail,44,29,0,18,26
90,Fail,50,31,2,5,45
90,Fail,56,22,0,10,46
90,Fail,44,33,0,16,28
90,Fail,47,23,1,16,31
90,Fail,55,22,0,12,43
90,Fail,48,29,4,13,35
90,Fail,47,28,0,16,31
90,Fail,45,37,0,6,39
90,Fail,53,27,0,10,43
90,Fail,43,31,0,14,29
90,Fail,50,27,0,14,36
90,Fail,48,29,1,10,38
90,Fail,48,29,0,10,38
90,Fail,49,27,0,18,31
90,Fail,43,32,2,12,31
90,Fail,52,24,0,10,42
90,Fail,53,23,0,9,44
90,Fail,53,32,0,8,45
90,Fail,45,31,0,15,30
90,Fail,53,23,0,20,33
90,Fail,54,22,0,9,45
90,Fail,49,29,0,13,36
90,Fail,51,25,3,15,36
90,Fail,48,22,0,18,30
90,Fail,46,27,0,14,32
90,Fail,47,28,0,12,35
90,Fail,44,29,8,9,35
90,Fail,42,28,4,14,28
90,Fail,45,25,2,17,28
90,Fail,44,26,5,14,30
90,Fail,49,23,5,12,37
90,Fail,55,24,3,9,46
90,Fail,48,29,0,13,35
90,Fail,54,20,5,15,39
90,Fail,46,20,4,19,27
90,Fail,41,37,0,14,27
90,Fail,40,30,2,16,24
90,Fail,50,19,6,13,37
90,Fail,49,29,0,9,40
90,Fail,57,14,2,16,41
90,Fail,42,30,0,19,23
90,Fail,51,25,0,14,37
90,Fail,38,39,0,13,25
90,Fail,55,24,0,8,47
90,Fail,49,24,5,12,37
90,Fail,48,29,0,13,35
90,Fail,50,30,0,11,39
90,Fail,39,35,0,17,22
90,Fail,44,32,0,14,30
90,Fail,46,28,0,16,30
90,Fail,37,28,1,22,15
90,Fail,46,22,10,14,32
90,Fail,54,25,0,10,44
90,Fail,49,31,0,10,39
90,Fail,43,35,0,13,30
90,Fail,43,28,0,20,23
90,Fail,46,26,1,16,30
90,Fail,43,25,0,20,23
90,Fail,45,20,6,17,28
90,Fail,48,20,6,15,33
90,Fail,49,30,0,12,37
90,Fail,46,29,0,15,31
90,Fail,49,25,1,13,36
90,Fail,48,34,0,9,39
90,Fail,46,21,3,17,29
90,Fail,42,24,6,15,27
90,Fail,47,25,0,16,31
90,Fail,47,36,0,13,34
90,Fail,52,27,0,10,42
90,Fail,46,36,0,11,35
90,Fail,48,26,5,14,34
90,Fail,42,25,11,12,30
90,Fail,44,29,4,15,29
90,Fail,48,22,0,14,34
90,Fail,47,26,0,13,34
90,Fail,43,31,5,8,35
90,Fail,42,39,0,11,31
90,Fail,40,34,0,16,24
90,Fail,48,26,0,11,37
90,Fail,53,19,0,17,36
90,Fail,54,26,0,9,45
90,Fail,52,20,1,13,39
90,Fail,53,24,0,15,38
90,Fail,49,24,8,10,39
90,Fail,55,23,4,8,47
90,Fail,50,27,0,11,39
90,Fail,42,28,6,14,28
90,Fail,42,35,0,16,26
90,Fail,41,26,9,12,29
90,Fail,44,30,6,12,32
90,Fail,46,34,0,13,33
90,Fail,48,26,0,15,33
90,Fail,53,22,3,13,40
90,Fail,58,20,0,13,45
90,Fail,36,30,13,14,22
90,Fail,46,33,0,9,37
90,Fail,49,25,1,14,35
90,Fail,55,22,0,10,45
90,Fail,52,24,2,13,39
90,Fail,47,34,2,9,38
90,Fail,46,23,12,15,31
90,Fail,54,22,0,13,41
90,Fail,47,24,8,11,36
90,Fail,45,23,4,17,28
90,Fail,51,23,3,13,38
90,Fail,49,24,3,14,35
90,Fail,54,24,1,11,43
90,Fail,42,35,5,9,33
90,Fail,49,25,8,8,41
90,Fail,45,23,3,18,27
90,Fail,48,30,0,12,36
90,Fail,43,27,5,13,30
90,Fail,46,27,7,10,36
90,Fail,45,38,0,8,37
90,Fail,45,30,0,14,31
90,Fail,47,25,5,15,32
90,Fail,59,23,0,9,50
90,Fail,48,29,0,11,37
90,Fail,54,25,5,7,47
90,Fail,43,36,0,14,29
90,Fail,49,23,5,11,38
90,Fail,51,30,0,9,42
90,Fail,54,21,1,9,45
90,Fail,51,22,1,10,41
90,Fail,45,28,4,13,32
90,Fail,50,26,1,14,36
90,Fail,46,23,3,18,28
90,Fail,45,28,0,17,28
90,Fail,43,29,2,14,29
90,Fail,49,29,2,11,38
90,Fail,47,29,5,8,39
90,Fail,48,37,0,9,39
90,Fail,47,34,0,9,38
90,Fail,49,37,0,7,42
90,Fail,46,29,5,12,34
90,Fail,55,21,3,14,41
90,Fail,54,20,3,9,45
90,Fail,47,27,0,18,29
90,Fail,48,22,4,14,34
90,Fail,46,29,7,9,37
90,Fail,40,31,8,15,25
90,Fail,46,26,5,9,37
90,Fail,49,27,0,13,36
90,Fail,51,28,6,7,44
90,Fail,50,25,0,11,39
90,Fail,50,28,0,7,43
90,Fail,46,23,10,14,32
90,Fail,39,37,3,11,28
90,Fail,55,27,3,8,47
90,Fail,47,37,0,9,38
90,Fail,50,29,4,11,39
90,Fail,44,27,1,18,26
90,Fail,53,26,0,7,46
90,Fail,44,27,9,12,32
90,Fail,46,24,6,14,32
90,Fail,46,29,0,13,33
90,Fail,42,43,0,8,34
90,Fail,41,30,7,11,30
90,Fail,44,28,10,13,31
90,Fail,48,30,0,13,35
90,Fail,53,24,1,13,40
90,Fail,53,26,0,10,43
90,Fail,50,21,0,15,35
90,Fail,41,36,0,14,27
90,Fail,52,20,2,13,39
90,Fail,50,29,0,11,39
90,Fail,49,23,5,14,35
90,Fail,47,27,0,17,30
90,Fail,42,33,1,12,30
90,Fail,41,32,3,10,31
90,Fail,47,28,0,13,34
90,Fail,53,24,0,11,42
90,Fail,51,24,3,13,38
90,Fail,46,27,5,12,34
90,Fail,53,19,0,11,42
90,Fail,45,25,2,16,29
90,Fail,50,29,0,11,39
90,Fail,50,24,0,12,38
90,Fail,55,29,0,4,51
90,Fail,49,24,6,14,35
90,Fail,42,34,0,12,30
90,Fail,52,26,0,9,43
90,Fail,49,26,6,10,39
90,Fail,49,19,7,16,33
90,Fail,42,32,0,18,24
90,Fail,49,25,0,14,35
90,Fail,43,33,0,16,27
90,Fail,48,28,0,12,36
90,Fail,47,23,0,18,29
90,Fail,53,25,0,9,44
90,Fail,52,27,0,12,40
90,Fail,55,27,0,6,49
90,Fail,51,30,0,8,43
90,Fail,42,22,6,17,25
90,Fail,47,26,2,15,32
90,Fail,48,31,0,14,34
90,Fail,50,15,2,20,30
90,Fail,50,26,0,12,38
90,Fail,49,23,0,15,34
90,Fail,45,25,2,15,30
90,Fail,48,26,0,10,38
90,Fail,50,27,6,10,40
90,Fail,46,22,5,17,29
90,Fail,54,20,7,9,45
90,Fail,45,32,0,12,33
90,Fail,47,29,2,13,34
90,Fail,53,18,5,11,42
90,Fail,45,31,0,15,30
90,Fail,44,30,0,16,28
90,Fail,48,35,0,12,36
90,Fail,46,32,3,7,39
90,Fail,45,31,7,10,35
90,Fail,51,25,0,12,39
90,Fail,51,29,1,7,44
90,Fail,46,31,0,11,35
90,Fail,52,22,6,12,40
90,Fail,45,33,0,13,32
90,Fail,37,32,1,18,19
90,Fail,52,25,0,9,43
90,Fail,42,33,0,13,29
90,Fail,48,24,2,14,34
90,Fail,48,24,13,6,42
90,Fail,44,30,3,12,32
90,Fail,48,28,7,8,40
90,Fail,48,31,3,9,39
90,Fail,43,29,0,19,24
90,Fail,54,17,7,11,43
90,Fail,46,31,0,14,32
90,Fail,57,16,2,12,45
90,Fail,46,33,0,12,34
90,Fail,39,34,0,17,22
90,Fail,50,25,0,15,35
90,Fail,48,29,0,15,33
90,Fail,50,20,5,11,39
90,Fail,51,16,1,16,35
90,Fail,49,32,2,9,40
90,Fail,50,20,0,19,31
90,Fail,48,28,6,7,41
90,Fail,52,28,3,5,47
90,Fail,53,23,6,10,43
90,Fail,44,26,5,15,29
90,Fail,51,22,3,13,38
90,Fail,47,36,0,10,37
90,Fail,45,28,0,18,27
90,Fail,54,33,0,6,48
90,Fail,50,25,4,15,35
90,Fail,50,29,0,11,39
90,Fail,55,25,0,9,46
90,Fail,57,28,0,8,49
90,Fail,47,27,3,12,35
90,Fail,44,29,7,10,34
90,Fail,48,22,2,13,35
90,Fail,45,36,0,10,35
90,Fail,47,24,1,13,34
90,Fail,54,22,3,7,47
90,Fail,45,33,0,10,35
90,Fail,42,25,7,14,28
90,Fail,47,26,3,14,33
90,Fail,39,43,0,12,27
90,Fail,49,36,0,9,40
90,Fail,49,22,7,12,37
90,Fail,50,26,1,10,40
90,Fail,46,26,0,15,31
90,Fail,44,18,4,22,22
90,Fail,50,27,2,11,39
90,Fail,43,33,1,16,27
90,Fail,50,26,1,10,40
90,Fail,54,27,1,7,47
90,Fail,47,28,4,10,37
90,Fail,51,21,2,14,37
90,Fail,48,23,5,12,36
90,Fail,52,23,1,12,40
90,Fail,53,28,1,8,45
90,Fail,50,28,0,11,39
90,Fail,56,22,2,4,52
90,Fail,45,22,5,18,27
90,Fail,55,19,0,14,41
90,Fail,48,29,0,15,33
90,Fail,44,24,2,15,29
90,Fail,51,24,0,11,40
90,Fail,47,34,0,11,36
90,Fail,46,27,3,12,34
90,Fail,39,29,7,18,21
90,Fail,55,21,0,12,43
90,Fail,50,22,6,11,39
90,Fail,46,22,7,13,33
90,Fail,49,26,5,8,41
90,Fail,52,21,0,16,36
90,Fail,44,28,3,13,31
90,Fail,53,20,0,14,39
90,Fail,47,22,6,13,34
90,Fail,45,24,2,19,26
90,Fail,55,26,0,9,46
90,Fail,55,25,2,7,48
90,Fail,50,23,0,14,36
90,Fail,48,26,2,13,35
90,Fail,48,27,0,9,39
90,Fail,49,28,5,13,36
90,Fail,43,42,0,5,38
90,Fail,43,39,0,10,33
90,Fail,45,23,11,13,32
90,Fail,52,20,1,15,37
90,Fail,49,24,0,16,33
90,Fail,52,21,2,14,38
90,Fail,49,28,0,13,36
90,Fail,43,34,0,16,27
90,Fail,53,22,3,12,41
90,Fail,50,29,0,9,41
90,Fail,38,30,7,17,21
90,Fail,52,22,0,16,36
90,Fail,40,25,11,11,29
90,Fail,52,32,0,6,46
90,Fail,43,28,6,12,31
90,Fail,49,30,0,12,37
90,Fail,47,23,0,15,32
90,Fail,40,36,0,16,24
90,Fail,38,32,1,18,20
90,Fail,47,24,0,16,31
90,Fail,51,23,3,12,39
90,Fail,51,33,0,6,45
90,Fail,45,28,2,15,30
90,Fail,43,35,0,14,29
90,Fail,58,23,2,6,52
90,Fail,43,29,2,14,29
90,Fail,48,26,3,7,41
90,Fail,42,25,1,20,22
90,Fail,50,31,1,10,40
90,Fail,41,28,0,17,24
90,Fail,39,35,5,11,28
90,Fail,55,19,4,13,42
90,Fail,50,19,0,17,33
90,Fail,40,31,0,18,22
90,Fail,56,23,3,6,50
90,Fail,51,24,6,12,39
90,Fail,48,25,12,9,39
90,Fail,33,47,0,14,19
90,Fail,45,35,0,10,35
90,Fail,47,31,6,8,39
90,Fail,51,27,0,10,41
90,Fail,43,31,0,16,27
90,Fail,56,22,1,7,49
90,Fail,47,34,0,10,37
90,Fail,46,31,0,8,38
90,Fail,50,21,1,13,37
90,Fail,41,32,0,18,23
90,Fail,46,26,3,14,32
90,Fail,46,25,4,15,31
90,Fail,55,26,0,11,44
90,Fail,53,26,0,10,43
90,Fail,47,22,3,17,30
90,Fail,49,26,1,14,35
90,Fail,47,32,0,14,33
90,Fail,45,31,0,14,31
90,Fail,47,32,0,10,37
90,Fail,39,33,0,17,22
90,Fail,53,29,0,8,45
90,Fail,55,23,3,10,45
90,Fail,52,22,0,13,39
90,Fail,41,34,0,14,27
90,Fail,54,21,1,14,40
90,Fail,47,32,0,11,36
90,Fail,49,27,0,13,36
90,Fail,43,33,5,11,32
90,Fail,60,25,0,4,56
90,Fail,44,31,0,12,32
90,Fail,52,26,3,12,40
90,Fail,43,25,9,15,28
90,Fail,53,29,0,8,45
90,Fail,51,28,1,9,42
90,Fail,55,18,2,13,42
90,Fail,48,26,0,18,30
90,Fail,43,33,3,11,32
90,Fail,50,25,0,15,35
90,Fail,40,28,8,14,26
90,Fail,48,24,3,21,27
90,Fail,39,27,0,21,18
90,Fail,44,39,0,10,34
90,Fail,49,26,0,10,39
90,Fail,55,24,0,9,46
90,Fail,47,25,2,12,35
90,Fail,54,24,2,11,43
90,Fail,50,33,0,7,43
90,Fail,47,27,2,13,34
90,Fail,51,19,3,17,34
90,Fail,47,26,0,14,33
90,Fail,47,27,0,13,34
90,Fail,41,30,0,15,26
90,Fail,50,24,2,14,36
90,Fail,47,26,0,17,30
90,Fail,48,21,5,15,33
90,Fail,40,34,0,16,24
90,Fail,59,21,0,9,50
90,Fail,45,35,0,13,32
90,Fail,40,32,0,15,25
90,Fail,55,15,5,8,47
90,Fail,47,22,1,12,35
90,Fail,49,26,0,13,36
90,Fail,52,29,0,8,44
90,Fail,50,24,4,13,37
90,Fail,45,31,0,15,30
90,Fail,45,18,6,22,23
90,Fail,48,15,6,15,33
90,Fail,50,36,0,9,41
90,Fail,44,30,2,13,31
90,Fail,52,25,0,9,43
90,Fail,49,25,0,11,38
90,Fail,41,35,0,15,26
90,Fail,46,30,0,13,33
90,Fail,48,26,4,10,38
90,Fail,46,36,0,8,38
90,Fail,45,22,5,19,26
90,Fail,43,24,0,19,24
90,Fail,39,35,0,17,22
90,Fail,57,22,0,11,46
90,Fail,53,21,3,12,41
90,Fail,43,35,0,6,37
90,Fail,48,23,7,15,33
90,Fail,48,31,0,10,38
90,Fail,47,24,4,15,32
90,Fail,55,25,0,9,46
90,Fail,50,24,3,13,37
90,Fail,51,24,2,13,38
90,Fail,39,36,0,18,21
90,Fail,49,20,2,19,30
90,Fail,44,27,7,14,30
90,Fail,45,25,6,8,37
90,Fail,47,30,0,15,32
90,Fail,44,24,3,20,24
90,Fail,45,26,0,16,29
90,Fail,47,33,0,15,32
90,Fail,46,30,5,8,38
90,Fail,54,26,3,9,45
90,Fail,49,23,7,11,38
90,Fail,43,29,4,16,27
90,Fail,40,36,5,11,29
90,Fail,52,20,1,12,40
90,Fail,43,31,0,13,30
90,Fail,50,24,6,13,37
90,Fail,44,30,0,15,29
90,Fail,45,24,0,18,27
90,Fail,45,31,0,14,31
90,Fail,53,26,0,11,42
90,Fail,51,24,2,14,37
90,Fail,54,27,0,4,50
90,Fail,48,32,0,9,39
90,Fail,46,20,4,17,29
90,Fail,45,37,0,7,38
90,Fail,42,29,4,13,29
90,Fail,45,28,1,17,28
90,Fail,44,28,2,16,28
90,Fail,45,27,3,17,28
90,Fail,46,27,10,11,35
90,Fail,53,24,3,10,43
90,Fail,46,29,3,12,34
90,Fail,44,22,0,22,22
90,Fail,56,20,3,12,44
90,Fail,52,22,0,12,40
90,Fail,47,25,7,14,33
90,Fail,52,18,1,18,34
90,Fail,45,31,0,12,33
90,Fail,49,20,5,13,36
90,Fail,43,41,0,9,34
90,Fail,53,23,6,9,44
90,Fail,45,27,3,12,33
90,Fail,55,24,0,12,43
90,Fail,44,31,0,17,27
90,Fail,48,31,0,9,39
90,Fail,45,23,8,15,30
90,Fail,48,30,0,14,34
90,Fail,47,25,3,15,32
90,Fail,45,31,0,12,33
90,Fail,53,27,0,7,46
90,Fail,46,28,0,15,31
90,Fail,45,29,3,12,33
90,Fail,50,31,3,2,48
90,Fail,46,29,0,16,30
90,Fail,48,22,5,15,33
90,Fail,48,25,0,14,34
90,Fail,46,27,0,12,34
90,Fail,52,22,0,13,39
90,Fail,47,21,11,12,35
90,Fail,44,35,0,9,35
90,Fail,50,25,4,13,37
90,Fail,46,30,0,15,31
90,Fail,52,24,0,13,39
90,Fail,49,21,3,15,34
90,Fail,58,24,0,9,49
90,Fail,39,23,6,22,17
90,Fail,48,23,0,15,33
90,Fail,41,25,14,12,29
90,Fail,45,25,0,17,28
90,Fail,53,18,7,11,42
90,Fail,49,27,0,15,34
90,Fail,49,22,0,15,34
90,Fail,45,31,0,11,34
90,Fail,48,22,10,13,35
90,Fail,44,32,4,8,36
90,Fail,47,27,0,13,34
90,Fail,50,20,0,18,32
90,Fail,47,27,5,12,35
90,Fail,49,34,0,9,40
90,Fail,47,29,0,9,38
90,Fail,51,27,0,8,43
90,Fail,56,24,0,10,46
90,Fail,50,23,0,10,40
90,Fail,46,19,1,19,27
90,Fail,47,25,10,10,37
90,Fail,49,21,8,15,34
90,Fail,50,21,0,14,36
90,Fail,55,25,0,10,45
90,Fail,50,25,4,11,39
90,Fail,50,26,0,12,38
90,Fail,48,34,0,11,37
90,Fail,50,24,0,14,36
90,Fail,46,31,0,16,30
90,Fail,48,28,0,12,36
90,Fail,57,22,2,8,49
90,Fail,50,30,0,9,41
90,Fail,49,21,0,14,35
90,Fail,54,19,5,10,44
90,Fail,42,38,0,12,30
90,Fail,44,24,10,14,30
90,Fail,44,31,2,14,30
90,Fail,47,24,8,9,38
90,Fail,47,25,5,14,33
90,Fail,48,16,6,19,29
90,Fail,47,29,0,14,33
90,Fail,47,22,0,19,28
90,Fail,45,42,0,9,36
90,Fail,46,26,0,14,32
90,Fail,47,30,0,13,34
90,Fail,50,28,0,12,38
90,Fail,42,26,5,16,26
90,Fail,46,24,0,17,29
90,Fail,51,19,7,15,36
90,Fail,43,34,0,16,27
90,Fail,47,24,8,15,32
90,Fail,45,26,0,13,32
90,Fail,48,17,2,20,28
90,Fail,50,20,0,18,32
90,Fail,49,29,6,9,40
90,Fail,49,28,0,13,36
90,Fail,44,28,7,10,34
90,Fail,49,31,0,12,37
90,Fail,51,28,0,14,37
90,Fail,48,29,0,13,35
90,Fail,50,23,1,17,33
90,Fail,54,26,0,6,48
90,Fail,49,28,0,12,37
90,Fail,45,27,0,12,33
90,Fail,46,28,8,10,36
90,Fail,41,27,8,16,25
90,Fail,43,35,0,11,32
90,Fail,51,21,2,17,34
90,Fail,53,27,1,11,42
90,Fail,49,20,5,15,34
90,Fail,50,25,0,16,34
90,Fail,45,28,7,9,36
90,Fail,36,43,0,11,25
90,Fail,43,30,0,15,28
90,Fail,45,28,9,11,34
90,Fail,38,23,13,16,22
90,Fail,46,32,0,11,35
90,Fail,46,25,0,16,30
90,Fail,48,30,5,11,37
90,Fail,41,33,0,17,24
90,Fail,49,23,4,14,35
90,Fail,44,23,6,13,31
90,Fail,55,22,0,17,38
90,Fail,47,27,0,15,32
90,Fail,41,32,0,17,24
90,Fail,56,19,1,12,44
90,Fail,42,26,4,18,24
90,Fail,47,30,0,12,35
90,Fail,45,27,4,15,30
90,Fail,43,29,0,17,26
90,Fail,41,32,0,16,25
90,Fail,54,19,0,15,39
90,Fail,37,36,0,13,24
90,Fail,51,27,0,13,38
90,Fail,49,21,0,17,32
90,Fail,47,27,4,11,36
90,Fail,50,31,0,8,42
90,Fail,54,24,1,11,43
90,Fail,50,25,1,13,37
90,Fail,46,29,0,11,35
90,Fail,48,22,1,17,31
90,Fail,40,34,0,15,25
90,Fail,57,18,5,10,47
90,Fail,47,21,1,18,29
90,Fail,50,27,5,8,42
90,Fail,50,25,6,12,38
90,Fail,49,30,0,10,39
90,Fail,37,46,0,10,27
90,Fail,46,26,0,13,33
90,Fail,43,28,0,20,23
90,Fail,46,31,0,14,32
90,Fail,54,22,0,15,39
90,Fail,44,30,0,17,27
90,Fail,44,34,1,13,31
90,Fail,40,31,5,16,24
90,Fail,45,33,0,13,32
90,Fail,50,26,0,13,37
90,Fail,50,25,2,12,38
90,Fail,49,26,2,7,42
90,Fail,57,24,0,7,50
90,Fail,49,30,0,7,42
90,Fail,49,24,0,14,35
90,Fail,52,28,0,8,44
90,Fail,44,30,9,9,35
90,Fail,49,30,0,7,42
90,Fail,52,25,0,10,42
90,Fail,46,34,0,9,37
90,Fail,46,24,4,17,29
90,Fail,41,33,5,11,30
90,Fail,52,24,0,13,39
90,Fail,54,25,0,10,44
90,Fail,51,26,3,10,41
90,Fail,46,27,3,15,31
90,Fail,47,23,7,12,35
90,Fail,56,15,6,12,44
90,Fail,44,25,1,19,25
90,Fail,41,40,0,12,29
90,Fail,45,25,9,9,36
90,Fail,49,24,4,13,36
90,Fail,50,28,0,13,37
90,Fail,52,25,0,12,40
90,Fail,54,20,2,12,42
90,Fail,51,35,0,6,45
90,Fail,49,20,1,17,32
90,Fail,43,33,0,13,30
90,Fail,50,22,0,16,34
90,Fail,49,29,0,12,37
90,Fail,50,15,1,17,33
90,Fail,46,32,0,11,35
90,Fail,51,29,4,7,44
90,Fail,39,33,0,20,19
90,Fail,53,24,0,11,42
90,Fail,49,30,0,14,35
90,Fail,51,31,0,8,43
90,Fail,42,36,0,13,29
90,Fail,46,28,4,11,35
90,Fail,49,29,0,10,39
90,Fail,49,23,5,13,36
90,Fail,46,31,0,15,31
90,Fail,52,23,3,11,41
90,Fail,42,39,0,14,28
90,Fail,45,26,0,16,29
90,Fail,48,28,0,15,33
90,Fail,51,23,0,13,38
90,Fail,50,26,3,15,35
90,Fail,49,23,4,15,34
90,Fail,48,30,0,13,35
90,Fail,42,38,0,10,32
90,Fail,47,29,5,11,36
90,Fail,49,21,4,14,35
90,Fail,42,34,0,13,29
90,Fail,38,43,0,12,26
90,Fail,49,21,3,15,34
90,Fail,54,34,0,3,51
90,Fail,41,30,0,14,27
90,Fail,52,22,0,15,37
90,Fail,51,23,0,15,36
90,Fail,46,31,0,11,35
90,Fail,41,27,0,20,21
90,Fail,49,25,0,13,36
90,Fail,49,29,0,12,37
90,Fail,48,22,3,19,29
90,Fail,44,29,0,17,27
90,Fail,46,35,0,9,37
90,Fail,43,29,0,18,25
90,Fail,47,24,0,19,28
90,Fail,51,19,0,18,33
90,Fail,57,27,0,8,49
90,Fail,48,31,0,12,36
90,Fail,49,23,5,10,39
90,Fail,41,28,0,21,20
90,Fail,41,32,9,14,27
90,Fail,46,31,0,12,34
90,Fail,56,21,2,13,43
90,Fail,46,25,8,13,33
90,Fail,56,16,0,17,39
90,Fail,49,30,0,15,34
90,Fail,57,18,1,13,44
90,Fail,48,25,0,16,32
90,Fail,44,25,0,16,28
90,Fail,50,27,0,10,40
90,Fail,48,32,1,10,38
90,Fail,50,30,0,9,41
90,Fail,51,25,0,10,41
90,Fail,51,26,0,14,37
90,Fail,44,30,3,12,32
90,Fail,40,37,0,16,24
90,Fail,43,27,14,10,33
90,Fail,47,33,3,7,40
90,Fail,47,29,2,14,33
90,Fail,50,20,1,18,32
90,Fail,52,22,1,13,39
90,Fail,53,24,0,11,42
90,Fail,51,29,0,9,42
90,Fail,53,25,4,9,44
90,Fail,48,31,2,8,40
90,Fail,46,28,0,16,30
90,Fail,47,21,0,19,28
90,Fail,49,25,0,18,31
90,Fail,44,31,0,15,29
90,Fail,61,22,0,7,54
90,Fail,45,27,0,19,26
90,Fail,48,27,5,14,34
90,Fail,55,18,0,13,42
90,Fail,56,19,4,10,46
90,Fail,56,25,0,5,51
90,Fail,45,27,2,13,32
90,Fail,39,34,2,9,30
90,Fail,47,23,2,14,33
90,Fail,51,27,0,7,44
90,Fail,49,28,0,11,38
90,Fail,45,22,6,17,28
90,Fail,50,24,2,10,40
90,Fail,51,22,1,12,39
90,Fail,52,24,2,11,41
90,Fail,47,22,0,18,29
90,Fail,47,29,0,10,37
90,Fail,44,25,13,13,31
90,Fail,53,19,0,13,40
90,Fail,46,25,2,18,28
90,Fail,42,27,8,14,28
90,Fail,47,34,0,9,38
90,Fail,38,32,0,17,21
90,Fail,43,37,0,13,30
90,Fail,50,34,0,7,43
90,Fail,48,23,1,13,35
90,Fail,36,33,11,14,22
90,Fail,48,24,3,14,34
90,Fail,51,25,0,10,41
90,Fail,44,29,0,13,31
90,Fail,49,30,0,9,40
90,Fail,60,16,0,14,46
90,Fail,47,22,5,15,32
90,Fail,51,18,0,20,31
90,Fail,49,24,1,15,34
90,Fail,51,26,0,7,44
90,Fail,54,19,0,11,43
90,Fail,46,34,2,7,39
90,Fail,50,25,0,16,34
90,Fail,50,26,0,14,36
90,Fail,45,32,0,13,32
90,Fail,46,25,3,15,31
90,Fail,56,20,0,14,42
90,Fail,43,22,9,17,26
90,Fail,56,25,0,9,47
90,Fail,48,36,0,10,38
90,Fail,47,23,5,11,36
90,Fail,51,31,0,8,43
90,Fail,53,16,8,12,41
90,Fail,45,22,8,13,32
90,Fail,44,30,4,13,31
90,Fail,43,30,3,13,30
90,Fail,50,27,0,9,41
90,Fail,47,27,3,11,36
90,Fail,53,22,4,9,44
90,Fail,45,31,5,11,34
90,Fail,47,24,0,19,28
90,Fail,52,22,0,15,37
90,Fail,46,30,0,13,33
90,Fail,47,23,0,21,26
90,Fail,50,33,0,3,47
90,Fail,50,22,4,13,37
90,Fail,44,29,5,13,31
90,Fail,53,22,4,11,42
90,Fail,54,19,0,13,41
90,Fail,45,34,0,13,32
90,Fail,53,25,1,11,42
90,Fail,50,19,1,18,32
90,Fail,46,31,0,14,32
90,Fail,49,26,0,11,38
90,Fail,50,27,11,7,43
90,Fail,55,22,0,15,40
90,Fail,45,32,0,15,30
90,Fail,53,21,0,12,41
90,Fail,52,24,0,14,38
90,Fail,43,29,6,13,30
90,Fail,48,31,0,13,35
90,Fail,52,23,0,10,42
90,Fail,51,22,0,11,40
90,Fail,51,22,4,16,35
90,Fail,48,33,0,11,37
90,Fail,47,36,0,11,36
90,Fail,46,28,8,12,34
90,Fail,51,25,0,13,38
90,Fail,50,26,0,11,39
90,Fail,53,24,0,8,45
90,Fail,50,25,3,11,39
90,Fail,58,21,1,10,48
90,Fail,57,23,0,12,45
90,Fail,47,26,6,12,35
90,Fail,47,26,0,18,29
90,Fail,42,24,7,18,24
90,Fail,50,25,2,11,39
90,Fail,47,36,0,12,35
90,Fail,45,36,0,7,38
90,Fail,42,29,11,11,31
90,Fail,49,32,0,16,33
90,Fail,43,29,5,12,31
90,Fail,49,29,1,8,41
90,Fail,49,28,0,12,37
90,Fail,48,24,6,12,36
90,Fail,51,24,3,11,40
90,Fail,48,24,5,10,38
90,Fail,44,26,4,16,28
90,Fail,44,30,5,14,30
90,Fail,52,26,0,11,41
90,Fail,47,32,0,15,32
90,Fail,41,34,7,11,30
90,Fail,44,34,0,12,32
90,Fail,46,31,0,16,30
90,Fail,46,37,0,8,38
90,Fail,48,24,8,15,33
90,Fail,51,24,0,14,37
90,Fail,50,31,4,6,44
90,Fail,55,21,0,10,45
90,Fail,53,26,0,8,45
90,Fail,44,29,3,14,30
90,Fail,47,21,6,16,31
90,Fail,48,26,10,11,37
90,Fail,39,35,0,17,22
90,Fail,39,34,5,13,26
90,Fail,52,26,2,12,40
90,Fail,50,31,0,8,42
90,Fail,47,27,7,13,34
90,Fail,45,30,0,13,32
90,Fail,47,21,3,20,27
90,Fail,44,28,3,14,30
90,Fail,50,27,0,11,39
90,Fail,50,26,0,12,38
90,Fail,50,27,2,12,38
90,Fail,51,35,0,7,44
90,Fail,45,35,0,8,37
90,Fail,49,25,2,10,39
90,Fail,40,37,0,15,25
90,Fail,48,27,1,12,36
90,Fail,50,29,1,8,42
90,Fail,47,28,0,16,31
90,Fail,50,29,0,9,41
90,Fail,52,26,0,14,38
90,Fail,42,24,15,12,30
90,Fail,55,22,0,11,44
90,Fail,48,28,4,11,37
90,Fail,52,28,1,6,46
90,Fail,34,31,13,15,19
90,Fail,51,26,0,12,39
90,Fail,49,22,0,14,35
90,Fail,51,25,0,15,36
90,Fail,53,24,0,14,39
90,Fail,54,28,0,11,43
90,Fail,49,22,6,10,39
90,Fail,47,26,4,10,37
90,Fail,43,26,3,18,25
90,Fail,44,37,0,11,33
90,Fail,44,32,2,13,31
90,Fail,50,27,0,12,38
90,Fail,45,21,9,16,29
90,Fail,47,25,0,12,35
90,Fail,38,34,7,15,23
90,Fail,52,19,0,16,36
90,Fail,47,41,0,6,41
90,Fail,45,33,0,16,29
90,Fail,46,25,2,13,33
90,Fail,52,25,0,10,42
90,Fail,44,27,0,16,28
90,Fail,47,25,3,10,37
90,Fail,45,29,0,11,34
90,Fail,49,32,0,13,36
90,Fail,47,28,0,13,34
90,Fail,50,30,0,9,41
90,Fail,46,34,0,11,35
90,Fail,52,19,2,14,38
90,Fail,45,33,0,11,34
90,Fail,45,29,0,17,28
90,Fail,50,25,0,16,34
90,Fail,46,26,3,15,31
90,Fail,48,30,4,7,41
90,Fail,45,32,0,13,32
90,Fail,37,31,0,19,18
90,Fail,51,22,4,11,40
90,Fail,58,19,0,11,47
90,Fail,51,25,5,10,41
90,Fail,42,29,1,18,24
90,Fail,46,24,0,19,27
90,Fail,50,26,6,9,41
90,Fail,44,35,0,14,30
90,Fail,49,24,3,10,39
90,Fail,40,36,0,15,25
90,Fail,51,23,5,8,43
90,Fail,45,31,0,16,29
90,Fail,47,37,0,10,37
90,Fail,54,24,2,9,45
90,Fail,51,22,1,13,38
90,Fail,48,25,0,17,31
90,Fail,48,27,1,10,38
90,Fail,46,30,3,10,36
90,Fail,42,31,5,11,31
90,Fail,48,29,0,13,35
90,Fail,55,26,0,12,43
90,Fail,46,28,0,15,31
90,Fail,52,24,0,7,45
90,Fail,51,26,3,9,42
90,Fail,40,33,3,15,25
90,Fail,47,25,2,17,30
90,Fail,44,21,6,18,26
90,Fail,46,29,3,12,34
90,Fail,49,29,0,11,38
90,Fail,45,20,1,23,22
90,Fail,45,25,6,17,28
90,Fail,47,34,0,8,39
90,Fail,36,29,5,18,18
90,Fail,47,29,0,9,38
90,Fail,52,23,0,17,35
90,Fail,43,36,0,14,29
90,Fail,43,20,8,19,24
90,Fail,43,30,0,16,27
90,Fail,45,30,5,11,34
90,Fail,46,32,0,12,34
90,Fail,47,28,2,13,34
90,Fail,47,24,1,18,29
90,Fail,52,24,0,12,40
90,Fail,50,32,0,10,40
90,Fail,41,26,0,23,18
90,Fail,44,25,1,18,26
90,Fail,52,25,1,10,42
90,Fail,46,29,0,13,33
90,Fail,50,21,2,12,38
90,Fail,46,30,0,12,34
90,Fail,50,27,1,13,37
90,Fail,45,21,13,13,32
90,Fail,50,25,1,12,38
90,Fail,52,20,2,13,39
90,Fail,44,28,5,14,30
90,Fail,58,24,0,9,49
90,Fail,54,26,0,9,45
90,Fail,49,25,0,16,33
90,Fail,37,22,10,23,14
90,Fail,50,25,0,12,38
90,Fail,51,27,0,14,37
90,Fail,50,20,2,17,33
90,Fail,53,24,0,12,41
90,Fail,51,30,0,11,40
90,Fail,49,26,0,15,34
90,Fail,48,21,2,18,30
90,Fail,47,27,0,12,35
90,Fail,48,31,0,12,36
90,Fail,54,22,0,12,42
90,Fail,49,23,0,13,36
90,Fail,49,30,0,8,41
90,Fail,51,26,0,11,40
90,Fail,48,31,0,10,38
90,Fail,44,36,0,13,31
90,Fail,46,25,0,16,30
90,Fail,48,20,0,20,28
90,Fail,50,25,2,15,35
90,Fail,55,23,3,9,46
90,Fail,50,24,5,11,39
90,Fail,48,25,5,12,36
90,Fail,45,26,0,16,29
90,Fail,45,26,6,14,31
90,Fail,52,30,0,6,46
90,Fail,45,30,6,9,36
90,Fail,53,30,0,7,46
90,Fail,42,27,3,18,24
90,Fail,61,16,0,10,51
90,Fail,53,28,0,12,41
90,Fail,45,28,4,10,35
90,Fail,49,27,0,11,38
90,Fail,52,22,1,13,39
90,Fail,49,31,0,12,37
90,Fail,56,23,0,9,47
90,Fail,45,23,4,17,28
90,Fail,54,14,6,14,40
90,Fail,49,29,0,12,37
90,Fail,47,35,0,10,37
90,Fail,43,32,0,15,28
90,Fail,41,31,0,16,25
90,Fail,52,23,0,14,38
90,Fail,54,24,0,9,45
90,Fail,49,26,2,13,36
90,Fail,44,30,2,14,30
90,Fail,43,31,0,14,29
90,Fail,57,18,0,15,42
90,Fail,42,32,0,14,28
90,Fail,46,30,8,8,38
90,Fail,48,27,5,8,40
90,Fail,49,23,1,16,33
90,Fail,57,16,3,12,45
90,Fail,52,30,0,13,39
90,Fail,51,28,0,14,37
90,Fail,50,31,0,8,42
90,Fail,48,24,3,14,34
90,Fail,53,26,0,12,41
90,Fail,52,26,0,11,41
90,Fail,49,25,4,11,38
90,Fail,43,36,0,11,32
90,Fail,46,17,15,16,30
90,Fail,52,24,0,12,40
90,Fail,57,19,1,13,44
90,Fail,49,21,10,14,35
90,Fail,43,35,0,10,33
90,Fail,38,39,0,13,25
90,Fail,44,26,0,16,28
90,Fail,44,27,0,16,28
90,Fail,53,23,0,15,38
90,Fail,52,23,0,12,40
90,Fail,49,28,4,11,38
90,Fail,47,30,0,12,35
90,Fail,53,27,0,10,43
90,Fail,44,29,2,15,29
90,Fail,45,31,0,13,32
90,Fail,44,26,5,15,29
90,Fail,48,25,6,15,33
90,Fail,51,31,0,8,43
90,Fail,51,22,0,14,37
90,Fail,50,23,0,10,40
90,Fail,51,21,1,11,40
90,Fail,53,23,4,11,42
90,Fail,50,25,0,13,37
90,Fail,44,31,0,13,31
90,Fail,51,28,0,13,38
90,Fail,57,20,0,10,47
90,Fail,54,23,0,13,41
90,Fail,44,28,8,11,33
90,Fail,48,31,4,9,39
90,Fail,43,35,0,14,29
90,Fail,46,26,8,7,39
90,Fail,56,22,3,12,44
90,Fail,48,25,0,13,35
90,Fail,43,36,0,13,30
90,Fail,47,26,6,16,31
90,Fail,48,32,1,11,37
90,Fail,42,33,2,11,31
90,Fail,36,33,7,17,19
90,Fail,48,31,0,13,35
90,Fail,58,27,0,7,51
90,Fail,41,30,0,15,26
90,Fail,52,25,2,6,46
90,Fail,47,29,0,12,35
90,Fail,48,22,0,17,31
90,Fail,43,28,0,13,30
90,Fail,43,30,0,18,25
90,Fail,53,28,0,9,44
90,Fail,36,39,11,9,27
90,Fail,42,39,0,13,29
90,Fail,55,19,5,11,44
90,Fail,43,29,3,15,28
90,Fail,46,29,3,9,37
90,Fail,49,28,0,12,37
90,Fail,48,24,0,14,34
90,Fail,39,38,0,11,28
90,Fail,53,16,2,12,41
90,Fail,53,17,1,12,41
90,Fail,42,36,0,14,28
90,Fail,43,27,0,17,26
90,Fail,53,21,0,13,40
90,Fail,45,29,7,12,33
90,Fail,52,26,0,7,45
90,Fail,50,23,2,12,38
90,Fail,50,23,8,10,40
90,Fail,44,31,2,12,32
90,Fail,50,22,0,13,37
90,Fail,46,28,0,10,36
90,Fail,47,30,3,11,36
90,Fail,40,40,0,9,31
90,Fail,45,25,2,12,33
90,Fail,46,36,0,11,35
90,Fail,42,24,6,17,25
90,Fail,53,18,5,14,39
90,Fail,50,25,0,10,40
90,Fail,45,36,0,11,34
90,Fail,44,24,10,15,29
90,Fail,50,23,6,7,43
90,Fail,44,32,3,7,37
90,Fail,50,22,4,13,37
90,Fail,51,25,3,13,38
90,Fail,40,31,0,14,26
90,Fail,45,32,2,12,33
90,Fail,44,31,0,17,27
90,Fail,49,20,10,12,37
90,Fail,50,26,0,11,39
90,Fail,43,29,0,19,24
90,Fail,52,23,0,14,38
90,Fail,48,27,0,14,34
90,Fail,44,27,0,20,24
90,Fail,46,31,2,13,33
90,Fail,47,30,1,8,39
90,Fail,48,28,1,10,38
90,Fail,51,28,0,8,43
90,Fail,47,41,0,5,42
90,Fail,47,22,0,15,32
90,Fail,47,26,4,15,32
90,Fail,42,38,0,12,30
90,Fail,53,28,0,6,47
90,Fail,58,17,3,9,49
90,Fail,53,21,0,12,41
90,Fail,51,30,0,9,42
90,Fail,49,32,0,9,40
90,Fail,52,25,3,10,42
90,Fail,48,31,0,15,33
90,Fail,47,29,0,14,33
90,Fail,50,19,5,16,34
90,Fail,48,22,0,17,31
90,Fail,36,47,0,12,24
90,Fail,47,25,0,16,31
90,Fail,41,37,0,12,29
90,Fail,49,29,3,9,40
90,Fail,47,26,0,12,35
90,Fail,52,18,9,15,37
90,Fail,44,24,6,16,28
90,Fail,51,23,4,13,38
90,Fail,47,30,0,13,34
90,Fail,50,22,9,11,39
90,Fail,54,27,0,7,47
90,Fail,55,30,0,7,48
90,Fail,51,26,0,12,39
90,Fail,46,24,6,13,33
90,Fail,43,37,0,11,32
90,Fail,44,29,5,13,31
90,Fail,43,34,0,12,31
90,Fail,56,18,1,12,44
90,Fail,41,38,0,11,30
90,Fail,53,14,0,16,37
90,Fail,41,32,1,17,24
90,Fail,48,28,0,13,35
90,Fail,49,32,0,7,42
90,Fail,48,31,0,10,38
90,Fail,44,28,0,13,31
90,Fail,46,29,0,15,31
90,Fail,52,21,7,12,40
90,Fail,51,23,0,15,36
90,Fail,53,30,4,5,48
90,Fail,51,26,3,10,41
90,Fail,48,22,7,12,36
90,Fail,50,22,3,12,38
90,Fail,48,24,7,13,35
90,Fail,55,23,0,10,45
90,Fail,37,30,10,15,22
90,Fail,44,25,4,17,27
90,Fail,47,34,0,11,36
90,Fail,47,28,3,12,35
90,Fail,44,33,0,15,29
90,Fail,52,19,2,14,38
90,Fail,52,21,2,13,39
90,Fail,43,33,0,15,28
90,Fail,50,25,3,11,39
90,Fail,51,23,5,9,42
90,Fail,55,26,2,9,46
90,Fail,41,38,0,15,26
90,Fail,49,28,3,11,38
90,Fail,53,23,1,11,42
90,Fail,44,33,0,14,30
90,Fail,42,29,3,16,26
90,Fail,43,33,0,16,27
90,Fail,47,37,0,10,37
90,Fail,49,35,0,11,38
90,Fail,46,21,2,22,24
90,Fail,45,30,0,13,32
90,Fail,51,29,1,11,40
90,Fail,52,24,0,11,41
90,Fail,45,29,4,12,33
90,Fail,40,37,0,14,26
90,Fail,50,24,2,10,40
90,Fail,50,31,0,12,38
90,Fail,48,26,0,18,30
90,Fail,48,34,0,8,40
90,Fail,48,39,0,8,40
90,Fail,45,26,6,15,30
90,Fail,48,24,5,15,33
90,Fail,50,32,0,7,43
90,Fail,50,31,0,11,39
90,Fail,45,33,7,6,39
90,Fail,53,26,6,6,47
90,Fail,45,28,0,18,27
90,Fail,47,21,4,16,31
90,Fail,45,30,0,14,31
90,Fail,42,32,2,14,28
90,Fail,45,32,0,12,33
90,Fail,42,35,3,11,31
90,Fail,45,35,0,13,32
90,Fail,44,27,0,17,27
90,Fail,46,31,0,12,34
90,Fail,45,30,0,14,31
90,Fail,46,31,1,10,36
90,Fail,45,29,0,17,28
90,Fail,44,36,0,12,32
90,Fail,45,28,7,15,30
90,Fail,50,22,5,13,37
90,Fail,52,29,0,12,40
90,Fail,48,26,0,16,32
90,Fail,47,25,6,13,34
90,Fail,49,23,1,15,34
90,Fail,45,35,0,9,36
90,Fail,47,26,1,13,34
90,Fail,49,24,0,12,37
90,Fail,42,29,3,13,29
90,Fail,48,26,0,15,33
90,Fail,46,24,0,16,30
90,Fail,55,26,0,9,46
90,Fail,50,27,0,13,37
90,Fail,45,24,5,14,31
90,Fail,47,22,0,19,28
90,Fail,44,33,1,9,35
90,Fail,45,30,2,12,33
90,Fail,45,28,0,11,34
90,Fail,47,27,9,11,36
90,Fail,54,27,0,7,47
90,Fail,38,36,7,8,30
90,Fail,47,34,0,11,36
90,Fail,43,27,3,13,30
90,Fail,51,21,7,9,42
90,Fail,40,34,0,14,26
90,Fail,49,25,0,11,38
90,Fail,51,24,5,11,40
90,Fail,49,23,0,17,32
90,Fail,54,24,1,10,44
90,Fail,55,18,6,11,44
90,Fail,48,21,4,15,33
90,Fail,49,26,4,13,36
90,Fail,46,29,3,12,34
90,Fail,47,34,0,9,38
90,Fail,48,28,0,14,34
90,Fail,47,35,0,13,34
90,Fail,45,32,0,11,34
90,Fail,43,33,2,14,29
90,Fail,49,31,0,8,41
90,Fail,42,23,0,22,20
90,Fail,44,28,0,14,30
90,Fail,47,32,0,10,37
90,Fail,46,24,6,14,32
90,Fail,51,20,4,11,40
90,Fail,34,34,0,22,12
90,Fail,40,40,0,12,28
90,Fail,52,24,0,9,43
90,Fail,44,26,3,14,30
90,Fail,50,37,1,6,44
90,Fail,45,28,0,16,29
90,Fail,51,33,0,8,43
90,Fail,48,28,4,13,35
90,Fail,49,26,5,13,36
90,Fail,53,25,0,11,42
90,Fail,45,32,4,11,34
90,Fail,49,25,3,14,35
90,Fail,42,33,0,18,24
90,Fail,52,22,3,9,43
90,Fail,39,40,0,9,30
90,Fail,47,31,0,10,37
90,Fail,44,31,0,12,32
90,Fail,48,22,0,16,32
90,Fail,41,35,0,17,24
90,Fail,43,30,0,17,26
90,Fail,55,14,11,12,43
90,Fail,50,21,2,15,35
90,Fail,53,30,0,8,45
90,Fail,52,27,0,7,45
90,Fail,57,26,1,9,48
90,Fail,51,29,0,14,37
90,Fail,45,33,3,9,36
90,Fail,46,28,0,12,34
90,Fail,49,23,0,11,38
90,Fail,41,37,0,17,24
90,Fail,47,33,0,12,35
90,Fail,48,36,2,4,44
90,Fail,47,35,3,7,40
90,Fail,44,26,8,13,31
90,Fail,41,36,0,13,28
90,Fail,49,25,0,14,35
90,Fail,48,25,1,15,33
90,Fail,44,34,0,10,34
90,Fail,48,26,0,14,34
90,Fail,43,27,5,15,28
90,Fail,51,33,0,4,47
90,Fail,56,20,0,13,43
90,Fail,47,23,10,7,40
90,Fail,54,14,9,14,40
90,Fail,48,26,4,8,40
90,Fail,50,31,0,7,43
90,Fail,47,35,0,9,38
90,Fail,51,27,0,12,39
90,Fail,57,22,2,12,45
90,Fail,43,26,3,15,28
90,Fail,45,35,0,14,31
90,Fail,48,22,7,13,35
90,Fail,52,28,1,6,46
90,Fail,48,26,0,13,35
90,Fail,46,33,5,7,39
90,Fail,48,23,2,14,34
90,Fail,52,20,2,13,39
90,Fail,57,14,3,11,46
90,Fail,48,27,0,14,34
90,Fail,43,42,0,8,35
90,Fail,52,30,4,7,45
90,Fail,49,33,0,8,41
90,Fail,47,24,4,15,32
90,Fail,52,25,5,9,43
90,Fail,41,27,5,18,23
90,Fail,52,24,0,11,41
90,Fail,46,28,0,17,29
90,Fail,47,29,1,15,32
90,Fail,38,23,9,21,17
90,Fail,55,20,0,10,45
90,Fail,55,24,2,7,48
90,Fail,51,23,0,13,38
90,Fail,50,26,0,11,39
90,Fail,44,30,0,17,27
90,Fail,48,25,6,11,37
90,Fail,45,28,0,15,30
90,Fail,44,23,8,15,29
90,Fail,53,25,1,11,42
90,Fail,52,36,0,2,50
90,Fail,47,21,6,15,32
90,Fail,46,24,2,15,31
90,Fail,54,23,0,8,46
90,Fail,34,26,17,10,24
90,Fail,47,23,3,13,34
90,Fail,47,28,0,15,32
90,Fail,50,27,2,9,41
90,Fail,55,27,0,11,44
90,Fail,49,21,4,17,32
90,Fail,49,27,0,12,37
90,Fail,50,27,1,11,39
90,Fail,49,33,0,8,41
90,Fail,54,24,3,7,47
90,Fail,51,34,0,9,42
90,Fail,42,25,5,16,26
90,Fail,48,23,3,17,31
90,Fail,46,30,0,17,29
90,Fail,50,20,2,16,34
90,Fail,43,28,6,14,29
90,Fail,50,25,0,10,40
90,Fail,48,27,8,10,38
90,Fail,46,29,0,15,31
90,Fail,45,25,1,20,25
90,Fail,51,30,0,11,40
90,Fail,44,31,0,14,30
90,Fail,49,21,6,10,39
90,Fail,44,25,3,14,30
90,Fail,48,30,2,9,39
90,Fail,46,24,4,17,29
90,Fail,53,21,0,11,42
90,Fail,46,20,5,18,28
90,Fail,47,17,9,19,28
90,Fail,55,22,4,9,46
90,Fail,45,28,2,14,31
90,Fail,51,25,1,12,39
90,Fail,47,24,3,14,33
90,Fail,45,29,0,11,34
90,Fail,43,32,0,16,27
90,Fail,51,27,4,6,45
90,Fail,49,27,3,14,35
90,Fail,44,25,7,14,30
90,Fail,47,26,0,12,35
90,Fail,53,21,5,12,41
90,Fail,46,26,7,12,34
90,Fail,47,31,0,13,34
90,Fail,44,33,0,10,34
90,Fail,44,36,0,10,34
90,Fail,44,26,4,15,29
90,Fail,48,20,1,19,29
90,Fail,50,19,1,16,34
90,Fail,50,19,1,17,33
90,Fail,48,33,0,11,37
90,Fail,47,34,0,10,37
90,Fail,45,32,2,10,35
90,Fail,46,32,0,17,29
90,Fail,48,28,0,16,32
90,Fail,48,30,0,12,36
90,Fail,49,24,1,12,37
90,Fail,59,21,1,6,53
90,Fail,45,27,0,18,27
90,Fail,47,28,0,13,34
90,Fail,51,21,1,13,38
90,Fail,48,32,0,9,39
90,Fail,49,24,6,13,36
90,Fail,44,28,0,17,27
90,Fail,50,22,5,14,36
90,Fail,47,26,4,15,32
90,Fail,46,25,4,16,30
90,Fail,45,29,7,11,34
90,Fail,43,29,9,13,30
90,Fail,46,28,9,10,36
90,Fail,41,29,5,14,27
90,Fail,43,34,6,10,33
90,Fail,48,22,5,13,35
90,Fail,53,22,0,12,41
90,Fail,43,35,0,10,33
90,Fail,46,27,0,16,30
90,Fail,47,36,0,7,40
90,Fail,47,25,5,14,33
90,Fail,50,18,2,15,35
90,Fail,48,26,0,16,32
90,Fail,48,26,3,11,37
90,Fail,48,24,0,17,31
90,Fail,58,22,0,10,48
90,Fail,39,39,0,17,22
90,Fail,53,25,0,11,42
90,Fail,51,23,3,13,38
90,Fail,55,32,0,8,47
90,Fail,50,23,10,9,41
90,Fail,45,31,0,11,34
90,Fail,47,25,7,14,33
90,Fail,47,26,7,13,34
90,Fail,50,25,7,9,41
90,Fail,40,30,0,20,20
90,Fail,39,35,0,15,24
90,Fail,48,28,2,13,35
90,Fail,40,30,1,19,21
90,Fail,46,27,1,15,31
90,Fail,51,26,0,12,39
90,Fail,56,27,0,11,45
90,Fail,48,27,0,12,36
90,Fail,45,20,6,21,24
90,Fail,51,26,0,8,43
90,Fail,47,28,0,13,34
90,Fail,49,26,13,7,42
90,Fail,56,24,0,10,46
90,Fail,47,29,3,9,38
90,Fail,52,22,6,7,45
90,Fail,45,31,0,10,35
90,Fail,44,28,4,12,32
90,Fail,50,25,0,10,40
90,Fail,52,22,0,12,40
90,Fail,47,33,0,10,37
90,Fail,39,27,9,15,24
90,Fail,58,18,1,9,49
90,Fail,58,21,0,11,47
90,Fail,52,22,8,11,41
90,Fail,45,26,0,18,27
90,Fail,45,33,0,12,33
90,Fail,48,28,0,10,38
90,Fail,48,27,4,6,42
90,Fail,47,27,4,11,36
90,Fail,49,23,2,14,35
90,Fail,53,25,0,10,43
90,Fail,45,31,0,15,30
90,Fail,49,24,4,16,33
90,Fail,48,30,0,7,41
90,Fail,52,28,0,9,43
90,Fail,52,24,0,12,40
90,Fail,46,29,4,13,33
90,Fail,53,32,0,5,48
90,Fail,45,22,5,14,31
90,Fail,45,29,0,20,25
90,Fail,48,25,0,14,34
90,Fail,46,24,4,14,32
90,Fail,58,24,0,7,51
90,Fail,48,21,0,12,36
90,Fail,49,27,0,15,34
90,Fail,46,28,2,13,33
90,Fail,51,18,3,16,35
90,Fail,52,16,6,20,32
90,Fail,52,25,0,12,40
90,Fail,45,18,7,19,26
90,Fail,50,25,0,12,38
90,Fail,47,26,2,12,35
90,Fail,57,21,3,8,49
90,Fail,56,25,0,11,45
90,Fail,47,27,0,14,33
90,Fail,60,19,0,10,50
90,Fail,46,27,2,15,31
90,Fail,50,29,0,12,38
90,Fail,55,23,0,12,43
90,Fail,43,22,13,14,29
90,Fail,50,29,0,10,40
90,Fail,49,23,4,11,38
90,Fail,48,25,0,16,32
90,Fail,46,24,2,20,26
90,Fail,52,22,0,16,36
90,Fail,48,29,0,15,33
90,Fail,49,32,0,12,37
90,Fail,47,29,0,12,35
90,Fail,55,23,0,11,44
90,Fail,41,31,5,16,25
90,Fail,48,23,0,13,35
90,Fail,53,22,3,11,42
90,Fail,42,26,6,18,24
90,Fail,51,31,0,7,44
90,Fail,46,29,2,14,32
90,Fail,48,30,0,10,38
90,Fail,44,34,0,15,29
90,Fail,53,21,4,9,44
90,Fail,46,34,0,10,36
90,Fail,45,29,1,12,33
90,Fail,50,29,5,7,43
90,Fail,47,25,5,14,33
90,Fail,46,21,4,19,27
90,Fail,40,41,0,11,29
90,Fail,42,20,9,20,22
90,Fail,45,19,11,17,28
90,Fail,48,33,0,12,36
90,Fail,39,45,0,9,30
90,Fail,50,29,0,9,41
90,Fail,46,27,2,11,35
90,Fail,41,40,2,6,35
90,Fail,50,25,1,13,37
90,Fail,37,27,10,15,22
90,Fail,43,30,2,11,32
90,Fail,49,24,0,18,31
90,Fail,50,19,7,12,38
90,Fail,55,22,0,12,43
90,Fail,51,21,0,13,38
90,Fail,46,22,8,17,29
90,Fail,50,23,0,14,36
90,Fail,51,27,0,12,39
90,Fail,47,30,0,14,33
90,Fail,52,23,0,9,43
90,Fail,52,26,0,11,41
90,Fail,44,30,0,17,27
90,Fail,51,23,0,12,39
90,Fail,51,26,0,13,38
90,Fail,45,31,0,13,32
90,Fail,58,20,0,9,49
90,Fail,41,30,9,13,28
90,Fail,47,31,0,14,33
90,Fail,40,32,0,18,22
90,Fail,43,34,0,15,28
90,Fail,51,25,1,12,39
90,Fail,48,22,0,15,33
90,Fail,51,26,0,10,41
90,Fail,42,26,1,20,22
90,Fail,52,31,0,10,42
90,Fail,49,27,4,11,38
90,Fail,46,30,0,9,37
90,Fail,41,30,9,14,27
90,Fail,48,34,0,9,39
90,Fail,53,29,0,6,47
90,Fail,45,28,0,18,27
90,Fail,46,29,2,12,34
90,Fail,52,21,0,15,37
90,Fail,37,31,12,12,25
90,Fail,52,23,3,11,41
90,Fail,42,27,6,14,28
90,Fail,50,24,1,16,34
90,Fail,50,26,0,13,37
90,Fail,51,17,11,12,39
90,Fail,47,26,0,20,27
90,Fail,51,25,6,10,41
90,Fail,43,30,4,15,28
90,Fail,58,19,2,11,47
90,Fail,52,21,5,8,44
90,Fail,45,28,7,11,34
90,Fail,53,18,9,11,42
90,Fail,50,25,0,14,36
90,Fail,43,32,2,7,36
90,Fail,51,27,0,16,35
90,Fail,50,30,1,11,39
90,Fail,51,24,3,13,38
90,Fail,49,29,0,15,34
90,Fail,42,27,3,16,26
90,Fail,51,27,2,8,43
90,Fail,52,23,3,11,41
90,Fail,50,27,0,12,38
90,Fail,47,31,3,10,37
90,Fail,51,26,0,11,40
90,Fail,54,26,0,11,43
90,Fail,47,33,0,6,41
90,Fail,51,19,0,17,34
90,Fail,45,33,2,7,38
90,Fail,47,33,0,9,38
90,Fail,45,30,0,12,33
90,Fail,49,21,0,18,31
90,Fail,45,24,0,18,27
90,Fail,40,35,0,17,23
90,Fail,41,24,11,18,23
90,Fail,52,24,3,14,38
90,Fail,54,27,0,9,45
90,Fail,49,30,4,12,37
90,Fail,46,28,4,9,37
90,Fail,42,28,7,14,28
90,Fail,44,34,0,11,33
90,Fail,53,25,0,9,44
90,Fail,52,28,0,15,37
90,Fail,42,37,1,10,32
90,Fail,53,19,6,10,43
90,Fail,49,18,1,17,32
90,Fail,44,24,7,15,29
90,Fail,45,29,0,12,33
90,Fail,46,19,11,15,31
90,Fail,46,26,0,20,26
90,Fail,47,25,0,17,30
90,Fail,51,27,2,9,42
90,Fail,46,24,0,22,24
90,Fail,50,26,0,12,38
90,Fail,44,32,0,14,30
90,Fail,44,29,0,16,28
90,Fail,44,37,1,9,35
90,Fail,45,30,0,13,32
90,Fail,40,31,0,20,20
90,Fail,48,24,0,15,33
90,Fail,45,35,0,10,35
90,Fail,38,26,10,13,25
90,Fail,49,26,3,12,37
90,Fail,46,25,0,16,30
90,Fail,37,42,0,13,24
90,Fail,45,28,3,16,29
90,Fail,50,29,0,13,37
90,Fail,46,31,0,14,32
90,Fail,44,33,0,12,32
90,Fail,48,33,0,9,39
90,Fail,51,25,1,7,44
90,Fail,50,31,0,13,37
90,Fail,46,26,10,15,31
90,Fail,46,29,0,14,32
90,Fail,48,30,0,11,37
90,Fail,51,28,0,10,41
90,Fail,46,29,0,15,31
90,Fail,51,23,0,19,32
90,Fail,52,29,0,7,45
90,Fail,56,22,0,12,44
90,Fail,37,37,0,16,21
90,Fail,49,25,5,13,36
90,Fail,51,22,0,13,38
90,Fail,41,43,0,12,29
90,Fail,44,27,3,12,32
90,Fail,50,27,0,12,38
90,Fail,48,29,2,8,40
90,Fail,47,29,0,15,32
90,Fail,52,29,0,12,40
90,Fail,50,25,0,15,35
90,Fail,46,28,0,17,29
90,Fail,54,23,2,14,40
90,Fail,52,19,3,16,36
90,Fail,52,22,8,6,46
90,Fail,47,25,0,15,32
90,Fail,44,38,0,10,34
90,Fail,43,30,0,16,27
90,Fail,50,28,2,10,40
90,Fail,56,19,0,4,52
90,Fail,44,24,0,19,25
90,Fail,39,27,5,17,22
90,Fail,46,32,0,13,33
90,Fail,46,29,0,14,32
90,Fail,51,24,0,16,35
90,Fail,46,35,0,7,39
90,Fail,48,30,2,13,35
90,Fail,47,29,0,11,36
90,Fail,52,29,0,7,45
90,Fail,47,24,5,12,35
90,Fail,40,28,7,15,25
90,Fail,49,23,4,14,35
90,Fail,44,36,0,13,31
90,Fail,47,21,1,17,30
90,Fail,56,22,2,7,49
90,Fail,44,37,0,9,35
90,Fail,50,22,5,12,38
90,Fail,48,28,0,16,32
90,Fail,53,29,0,13,40
90,Fail,44,29,0,14,30
90,Fail,53,23,2,11,42
90,Fail,51,22,0,11,40
90,Fail,49,25,0,12,37
90,Fail,57,19,0,9,48
90,Fail,45,36,0,10,35
90,Fail,46,31,0,16,30
90,Fail,39,34,0,17,22
90,Fail,55,22,0,11,44
90,Fail,46,25,0,17,29
90,Fail,51,22,8,11,40
90,Fail,50,26,4,14,36
90,Fail,53,27,1,9,44
90,Fail,47,25,3,15,32
90,Fail,48,23,0,16,32
90,Fail,59,21,3,8,51
90,Fail,50,23,0,13,37
90,Fail,50,24,2,14,36
90,Fail,44,19,17,17,27
90,Fail,49,28,0,13,36
90,Fail,47,27,11,11,36
90,Fail,47,27,1,12,35
90,Fail,47,24,1,17,30
90,Fail,50,21,6,12,38
90,Fail,50,27,3,10,40
90,Fail,49,23,3,11,38
90,Fail,49,28,0,10,39
90,Fail,52,22,0,16,36
90,Fail,45,28,5,14,31
90,Fail,48,35,0,9,39
90,Fail,54,22,4,9,45
90,Fail,50,24,4,14,36
90,Fail,47,21,3,19,28
90,Fail,46,36,0,11,35
90,Fail,36,34,0,20,16
90,Fail,47,26,0,13,34
90,Fail,55,19,0,14,41
90,Fail,48,31,6,9,39
90,Fail,53,22,3,11,42
90,Fail,46,32,0,12,34
90,Fail,49,21,3,15,34
90,Fail,49,27,0,14,35
90,Fail,37,42,0,9,28
90,Fail,46,29,0,14,32
90,Fail,53,25,0,13,40
90,Fail,57,30,0,7,50
90,Fail,47,24,1,17,30
90,Fail,54,27,0,11,43
90,Fail,46,32,0,13,33
90,Fail,46,26,4,13,33
90,Fail,49,25,4,13,36
90,Fail,51,30,0,10,41
90,Fail,42,34,0,9,33
90,Fail,44,27,6,16,28
90,Fail,50,28,1,12,38
90,Fail,45,35,0,12,33
90,Fail,46,27,0,14,32
90,Fail,46,29,0,14,32
90,Fail,48,24,10,10,38
90,Fail,52,19,7,10,42
90,Fail,37,37,0,13,24
90,Fail,48,32,4,7,41
90,Fail,36,40,4,14,22
90,Fail,51,29,0,11,40
90,Fail,45,35,0,9,36
90,Fail,52,19,6,12,40
90,Fail,45,23,5,16,29
90,Fail,42,32,0,13,29
90,Fail,53,31,0,10,43
90,Fail,45,28,0,17,28
90,Fail,48,32,4,9,39
90,Fail,51,25,3,10,41
90,Fail,45,29,0,13,32
90,Fail,47,20,8,12,35
90,Fail,44,34,0,12,32
90,Fail,44,29,1,13,31
90,Fail,49,25,0,14,35
90,Fail,51,29,0,9,42
90,Fail,45,31,4,13,32
90,Fail,50,29,2,11,39
90,Fail,45,29,1,14,31
90,Fail,42,22,0,24,18
90,Fail,44,32,0,12,32
90,Fail,50,29,0,13,37
90,Fail,54,26,0,10,44
90,Fail,51,24,3,16,35
90,Fail,45,30,11,8,37
90,Fail,42,36,0,12,30
90,Fail,50,18,5,16,34
90,Fail,49,33,0,9,40
90,Fail,48,35,0,10,38
90,Fail,45,27,5,14,31
90,Fail,49,27,0,15,34
90,Fail,47,28,5,8,39
90,Fail,49,30,0,12,37
90,Fail,46,31,0,10,36
90,Fail,55,27,0,9,46
90,Fail,54,24,0,11,43
90,Fail,41,40,0,13,28
90,Fail,44,29,0,17,27
90,Fail,56,21,3,7,49
90,Fail,45,28,5,12,33
90,Fail,48,28,4,11,37
90,Fail,53,25,1,11,42
90,Fail,53,22,0,16,37
90,Fail,51,18,4,15,36
90,Fail,41,40,0,10,31
90,Fail,56,21,0,12,44
90,Fail,56,21,0,13,43
90,Fail,51,26,0,11,40
90,Fail,47,25,3,12,35
90,Fail,52,28,0,12,40
90,Fail,48,24,6,12,36
90,Fail,55,18,0,9,46
90,Fail,47,26,8,13,34
90,Fail,47,35,0,8,39
90,Fail,54,17,3,18,36
90,Fail,49,25,5,10,39
90,Fail,58,26,3,5,53
90,Fail,45,31,0,13,32
90,Fail,53,22,0,10,43
90,Fail,50,24,2,10,40
90,Fail,49,27,0,14,35
90,Fail,39,44,0,13,26
90,Fail,50,19,6,11,39
90,Fail,49,26,0,13,36
90,Fail,44,29,0,19,25
90,Fail,48,31,0,11,37
90,Fail,47,28,8,8,39
90,Fail,46,29,0,18,28
90,Fail,53,18,0,13,40
90,Fail,51,23,5,15,36
90,Fail,47,33,0,13,34
90,Fail,52,19,0,13,39
90,Fail,46,29,0,11,35
90,Fail,50,25,1,11,39
90,Fail,51,26,3,14,37
90,Fail,46,21,7,15,31
90,Fail,42,31,0,14,28
90,Fail,49,27,0,15,34
90,Fail,44,33,10,7,37
90,Fail,52,35,0,7,45
90,Fail,46,30,3,8,38
90,Fail,45,35,0,12,33
90,Fail,40,38,0,13,27
90,Fail,53,27,4,6,47
90,Fail,38,38,0,13,25
90,Fail,53,18,0,15,38
90,Fail,46,28,0,19,27
90,Fail,44,32,6,10,34
90,Fail,45,36,0,10,35
90,Fail,50,24,4,13,37
90,Fail,42,46,0,7,35
90,Fail,48,30,0,12,36
90,Fail,49,21,0,19,30
90,Fail,54,23,0,7,47
90,Fail,53,29,0,10,43
90,Fail,43,33,0,12,31
90,Fail,50,25,0,15,35
90,Fail,45,32,0,16,29
90,Fail,47,27,1,16,31
90,Fail,41,28,2,18,23
90,Fail,44,30,1,15,29
90,Fail,50,25,2,13,37
90,Fail,46,36,0,8,38
90,Fail,51,23,0,16,35
90,Fail,41,30,2,16,25
90,Fail,48,23,2,17,31
90,Fail,47,25,10,9,38
90,Fail,49,27,3,13,36
90,Fail,51,26,0,12,39
90,Fail,51,26,2,11,40
90,Fail,42,27,9,14,28
90,Fail,44,30,6,12,32
90,Fail,49,27,0,12,37
90,Fail,50,18,7,11,39
90,Fail,48,34,0,11,37
90,Fail,52,24,0,11,41
90,Fail,49,23,0,15,34
90,Fail,50,24,4,11,39
90,Fail,43,34,0,13,30
90,Fail,52,16,2,14,38
90,Fail,51,24,2,14,37
90,Fail,47,32,0,15,32
90,Fail,45,33,0,13,32
90,Fail,48,24,3,12,36
90,Fail,53,28,0,9,44
90,Fail,53,18,4,12,41
90,Fail,45,29,5,11,34
90,Fail,50,26,0,14,36
90,Fail,46,22,12,12,34
90,Fail,51,26,2,9,42
90,Fail,51,23,8,10,41
90,Fail,52,19,7,13,39
90,Fail,46,38,0,9,37
90,Fail,46,37,0,9,37
90,Fail,50,29,0,11,39
90,Fail,49,20,3,19,30
90,Fail,50,21,4,17,33
90,Fail,44,26,5,13,31
90,Fail,45,32,0,13,32
90,Fail,52,18,7,13,39
90,Fail,41,31,0,15,26
90,Fail,48,17,6,13,35
90,Fail,49,21,3,18,31
90,Fail,48,26,0,10,38
90,Fail,47,31,0,14,33
90,Fail,52,27,1,6,46
90,Fail,50,24,0,14,36
90,Fail,50,18,6,17,33
90,Fail,50,31,0,10,40
90,Fail,52,23,0,12,40
90,Fail,55,20,0,12,43
90,Fail,43,41,0,9,34
90,Fail,54,24,2,9,45
90,Fail,46,38,0,13,33
90,Fail,39,42,0,10,29
90,Fail,45,38,0,10,35
90,Fail,45,30,8,12,33
90,Fail,53,27,0,9,44
90,Fail,50,25,2,12,38
90,Fail,48,32,0,8,40
90,Fail,52,20,0,20,32
90,Fail,50,33,0,6,44
90,Fail,49,23,10,8,41
90,Fail,54,25,1,9,45
90,Fail,44,27,0,17,27
90,Fail,48,22,0,14,34
90,Fail,46,29,4,8,38
90,Fail,47,28,0,14,33
90,Fail,39,27,17,11,28
90,Fail,48,28,7,6,42
90,Fail,49,20,2,19,30
90,Fail,53,26,3,6,47
90,Fail,49,31,0,10,39
90,Fail,44,24,7,14,30
90,Fail,51,23,1,14,37
90,Fail,56,25,0,8,48
90,Fail,46,27,0,15,31
90,Fail,51,19,4,15,36
90,Fail,43,25,2,17,26
90,Fail,47,28,4,11,36
90,Fail,50,24,4,14,36
90,Fail,41,35,0,14,27
90,Fail,51,28,0,11,40
90,Fail,52,23,0,13,39
90,Fail,43,34,0,14,29
90,Fail,55,22,4,6,49
90,Fail,47,23,6,11,36
90,Fail,43,29,0,17,26
90,Fail,43,32,6,11,32
90,Fail,52,16,5,15,37
90,Fail,51,22,3,14,37
90,Fail,49,25,1,13,36
90,Fail,47,23,0,18,29
90,Fail,51,18,1,18,33
90,Fail,42,30,2,19,23
90,Fail,48,27,2,15,33
90,Fail,48,20,9,14,34
90,Fail,53,18,4,14,39
90,Fail,52,24,0,16,36
90,Fail,46,26,2,14,32
90,Fail,48,19,13,10,38
90,Fail,46,35,0,11,35
90,Fail,52,22,6,11,41
90,Fail,45,33,0,15,30
90,Fail,50,27,0,12,38
90,Fail,41,34,0,17,24
90,Fail,50,17,1,19,31
90,Fail,50,26,0,13,37
90,Fail,53,16,0,19,34
90,Fail,43,25,4,15,28
90,Fail,53,28,0,9,44
90,Fail,54,23,0,8,46
90,Fail,59,22,1,5,54
90,Fail,44,33,0,11,33
90,Fail,42,32,9,11,31
90,Fail,55,15,3,17,38
90,Fail,48,29,5,12,36
90,Fail,52,28,0,11,41
90,Fail,51,26,0,12,39
90,Fail,47,29,4,13,34
90,Fail,45,28,0,16,29
90,Fail,49,21,8,12,37
90,Fail,51,18,3,16,35
90,Fail,49,23,8,9,40
90,Fail,55,23,0,10,45
90,Fail,51,25,2,12,39
90,Fail,39,33,7,15,24
90,Fail,55,23,2,11,44
90,Fail,50,34,0,6,44
90,Fail,42,32,0,10,32
90,Fail,46,28,10,9,37
90,Fail,50,22,0,21,29
90,Fail,51,23,0,12,39
90,Fail,53,25,5,11,42
90,Fail,41,35,0,14,27
90,Fail,47,26,0,11,36
90,Fail,54,25,0,14,40
90,Fail,51,25,0,12,39
90,Fail,45,24,0,19,26
90,Fail,54,23,3,11,43
90,Fail,50,27,0,11,39
90,Fail,51,22,1,13,38
90,Fail,46,25,0,19,27
90,Fail,46,35,0,13,33
90,Fail,46,23,7,16,30
90,Fail,42,28,10,12,30
90,Fail,46,26,0,21,25
90,Fail,47,28,2,10,37
90,Fail,43,24,8,20,23
90,Fail,45,32,3,10,35
90,Fail,46,30,0,13,33
90,Fail,47,30,0,11,36
90,Fail,49,31,0,12,37
90,Fail,45,29,6,8,37
90,Fail,47,27,0,12,35
90,Fail,45,23,0,22,23
90,Fail,49,24,0,13,36
90,Fail,51,24,0,11,40
90,Fail,54,20,7,9,45
90,Fail,54,20,1,15,39
90,Fail,50,28,1,10,40
90,Fail,43,26,0,18,25
90,Fail,64,17,0,7,57
90,Fail,51,24,0,12,39
90,Fail,52,29,0,9,43
90,Fail,46,28,0,16,30
90,Fail,42,29,2,13,29
90,Fail,44,35,0,10,34
90,Fail,54,19,3,10,44
90,Fail,58,21,0,9,49
90,Fail,42,32,0,18,24
90,Fail,52,22,0,13,39
90,Fail,40,27,8,14,26
90,Fail,45,28,0,17,28
90,Fail,51,19,4,13,38
90,Fail,49,22,3,14,35
90,Fail,47,31,0,11,36
90,Fail,47,31,0,11,36
90,Fail,40,36,0,13,27
90,Fail,49,24,9,9,40
90,Fail,51,19,4,15,36
90,Fail,48,28,0,11,37
90,Fail,54,21,0,12,42
90,Fail,48,30,0,12,36
90,Fail,49,28,3,13,36
90,Fail,54,22,0,11,43
90,Fail,37,25,16,12,25
90,Fail,46,31,5,8,38
90,Fail,50,28,0,10,40
90,Fail,49,22,0,15,34
90,Fail,42,31,0,16,26
90,Fail,45,31,0,9,36
90,Fail,48,31,0,13,35
90,Fail,44,32,0,17,27
90,Fail,46,29,1,13,33
90,Fail,42,31,1,16,26
90,Fail,44,25,6,15,29
90,Fail,46,29,7,11,35
90,Fail,49,27,0,14,35
90,Fail,42,23,6,16,26
90,Fail,46,26,6,14,32
90,Fail,46,32,7,6,40
90,Fail,48,32,0,13,35
90,Fail,45,33,0,12,33
90,Fail,48,34,0,10,38
90,Fail,50,24,0,14,36
90,Fail,51,29,0,14,37
90,Fail,49,24,0,17,32
90,Fail,52,26,6,8,44
90,Fail,47,24,2,16,31
90,Fail,54,24,1,12,42
90,Fail,53,22,2,12,41
90,Fail,53,29,0,8,45
90,Fail,46,22,6,14,32
90,Fail,54,32,0,6,48
90,Fail,57,21,5,8,49
90,Fail,48,30,0,10,38
90,Fail,48,28,3,13,35
90,Fail,49,25,0,12,37
90,Fail,44,29,0,16,28
90,Fail,51,28,0,10,41
90,Fail,56,19,4,8,48
90,Fail,50,22,3,13,37
90,Fail,45,25,0,18,27
90,Fail,41,39,0,10,31
90,Fail,49,27,0,9,40
90,Fail,47,18,12,12,35
90,Fail,48,23,8,12,36
90,Fail,45,27,7,12,33
90,Fail,51,27,5,6,45
90,Fail,54,30,0,4,50
90,Fail,48,26,4,11,37
90,Fail,38,35,5,14,24
90,Fail,48,24,3,15,33
90,Fail,44,30,2,12,32
90,Fail,52,29,0,9,43
90,Fail,52,22,4,13,39
90,Fail,54,20,1,12,42
90,Fail,50,23,6,9,41
90,Fail,52,23,0,14,38
90,Fail,47,25,0,15,32
90,Fail,41,32,5,13,28
90,Fail,42,30,3,13,29
90,Fail,52,27,0,10,42
90,Fail,42,31,0,12,30
90,Fail,51,29,0,15,36
90,Fail,45,30,0,13,32
90,Fail,43,28,0,19,24
90,Fail,41,30,1,18,23
90,Fail,49,26,0,12,37
90,Fail,44,27,6,13,31
90,Fail,46,23,6,14,32
90,Fail,46,20,1,21,25
90,Fail,49,28,0,13,36
90,Fail,55,18,9,8,47
90,Fail,54,22,0,12,42
90,Fail,50,27,0,10,40
90,Fail,42,30,5,13,29
90,Fail,41,38,0,14,27
90,Fail,50,30,0,9,41
90,Fail,34,37,0,22,12
90,Fail,46,28,6,12,34
90,Fail,45,29,0,16,29
90,Fail,50,24,4,12,38
90,Fail,45,31,0,14,31
90,Fail,47,29,3,11,36
90,Fail,36,29,9,17,19
90,Fail,43,34,0,14,29
90,Fail,50,28,0,7,43
90,Fail,42,22,10,14,28
90,Fail,54,24,0,11,43
90,Fail,55,22,0,10,45
90,Fail,49,29,0,11,38
90,Fail,42,38,0,12,30
90,Fail,43,27,5,17,26
90,Fail,39,41,0,13,26
90,Fail,49,26,4,11,38
90,Fail,51,26,2,9,42
90,Fail,51,30,0,5,46
90,Fail,51,26,0,17,34
90,Fail,53,21,0,13,40
90,Fail,41,35,0,11,30
90,Fail,43,39,0,10,33
90,Fail,42,25,6,20,22
90,Fail,50,29,0,13,37
90,Fail,45,27,10,8,37
90,Fail,46,30,0,13,33
90,Fail,43,25,14,11,32
90,Fail,48,24,6,11,37
90,Fail,41,39,0,12,29
90,Fail,47,31,0,11,36
90,Fail,49,19,5,15,34
90,Fail,39,23,3,22,17
90,Fail,46,31,0,12,34
90,Fail,51,19,0,19,32
90,Fail,59,17,1,13,46
90,Fail,51,26,6,7,44
90,Fail,48,25,1,13,35
90,Fail,45,38,0,12,33
90,Fail,39,40,0,15,24
90,Fail,51,16,2,14,37
90,Fail,38,27,3,20,18
90,Fail,45,28,5,16,29
90,Fail,41,40,0,16,25
90,Fail,49,32,0,10,39
90,Fail,48,26,0,14,34
90,Fail,44,25,13,9,35
90,Fail,47,28,1,12,35
90,Fail,47,20,4,14,33
90,Fail,42,24,8,17,25
90,Fail,41,36,3,12,29
90,Fail,49,29,0,11,38
90,Fail,46,21,8,17,29
90,Fail,48,30,0,12,36
90,Fail,44,27,3,14,30
90,Fail,40,38,0,10,30
90,Fail,50,21,3,15,35
90,Fail,41,29,1,17,24
90,Fail,46,26,6,10,36
90,Fail,48,28,1,11,37
90,Fail,43,17,7,23,20
90,Fail,42,34,0,15,27
90,Fail,45,25,1,14,31
90,Fail,37,43,0,12,25
90,Fail,44,28,8,10,34
90,Fail,42,37,0,13,29
90,Fail,55,22,0,11,44
90,Fail,53,23,4,13,40
90,Fail,44,32,0,11,33
90,Fail,54,25,0,10,44
90,Fail,51,25,0,12,39
90,Fail,50,18,0,17,33
90,Fail,48,23,6,14,34
90,Fail,47,31,1,9,38
90,Fail,47,23,3,17,30
90,Fail,45,27,5,12,33
90,Fail,50,30,0,12,38
90,Fail,46,32,4,6,40
90,Fail,44,33,0,15,29
90,Fail,53,20,0,19,34
90,Fail,51,29,1,10,41
90,Fail,56,22,1,11,45
90,Fail,52,26,0,9,43
90,Fail,48,25,2,16,32
90,Fail,49,23,3,14,35
90,Fail,42,27,0,23,19
90,Fail,51,33,0,6,45
90,Fail,47,20,8,16,31
90,Fail,51,26,0,11,40
90,Fail,47,27,9,10,37
90,Fail,50,33,0,8,42
90,Fail,46,29,0,19,27
90,Fail,46,33,0,13,33
90,Fail,48,26,0,14,34
90,Fail,43,31,0,16,27
90,Fail,58,19,0,9,49
90,Fail,51,26,0,12,39
90,Fail,49,31,0,9,40
90,Fail,57,19,4,11,46
90,Fail,42,23,0,19,23
90,Fail,42,36,0,10,32
90,Fail,54,19,3,12,42
90,Fail,47,31,0,15,32
90,Fail,39,40,0,16,23
90,Fail,47,33,0,10,37
90,Fail,47,27,0,16,31
90,Fail,48,22,1,16,32
90,Fail,52,28,0,9,43
90,Fail,40,43,0,11,29
90,Fail,45,30,0,11,34
90,Fail,47,21,0,18,29
90,Fail,47,31,0,9,38
90,Fail,60,23,0,7,53
90,Fail,54,18,1,14,40
90,Fail,42,32,0,10,32
90,Fail,49,23,6,13,36
90,Fail,52,23,1,10,42
90,Fail,45,37,0,13,32
90,Fail,45,34,0,11,34
90,Fail,48,26,8,11,37
90,Fail,42,25,0,16,26
90,Fail,42,31,5,15,27
90,Fail,49,31,0,10,39
90,Fail,45,28,0,15,30
90,Fail,49,23,6,14,35
90,Fail,54,30,0,7,47
90,Fail,52,19,8,16,36
90,Fail,57,25,0,7,50
90,Fail,47,31,2,11,36
90,Fail,53,29,0,5,48
90,Fail,44,30,0,13,31
90,Fail,48,34,0,9,39
90,Fail,42,34,0,16,26
90,Fail,50,25,0,17,33
90,Fail,48,25,6,14,34
90,Fail,51,25,0,9,42
90,Fail,51,21,1,11,40
90,Fail,46,38,0,13,33
90,Fail,48,21,2,17,31
90,Fail,46,21,7,16,30
90,Fail,48,30,0,12,36
90,Fail,47,34,0,11,36
90,Fail,50,22,3,15,35
90,Fail,38,43,0,12,26
90,Fail,50,27,0,11,39
90,Fail,45,29,2,12,33
90,Fail,43,21,9,17,26
90,Fail,50,26,0,12,38
90,Fail,50,31,0,10,40
90,Fail,46,25,2,14,32
90,Fail,44,28,0,18,26
90,Fail,48,23,3,17,31
90,Fail,51,28,0,11,40
90,Fail,41,29,7,14,27
90,Fail,59,25,0,3,56
90,Fail,49,26,3,14,35
90,Fail,54,14,1,15,39
90,Fail,54,16,1,11,43
90,Fail,49,29,0,12,37
90,Fail,45,27,2,12,33
90,Fail,52,29,0,12,40
90,Fail,52,26,7,8,44
90,Fail,43,28,0,17,26
90,Fail,49,26,3,9,40
90,Fail,50,19,5,14,36
90,Fail,54,14,0,22,32
90,Fail,45,31,0,15,30
90,Fail,53,25,1,8,45
90,Fail,40,21,12,16,24
90,Fail,47,22,6,14,33
90,Fail,48,27,4,12,36
90,Fail,43,30,3,15,28
90,Fail,54,20,4,6,48
90,Fail,45,26,1,19,26
90,Fail,51,28,0,7,44
90,Fail,47,28,4,13,34
90,Fail,56,24,0,13,43
90,Fail,44,32,0,13,31
90,Fail,43,34,0,14,29
90,Fail,45,31,2,8,37
90,Fail,43,26,7,15,28
90,Fail,46,29,0,15,31
90,Fail,44,23,7,18,26
90,Fail,50,35,0,9,41
90,Fail,50,29,0,12,38
90,Fail,51,23,7,8,43
90,Fail,59,17,0,10,49
90,Fail,52,24,5,9,43
90,Fail,53,27,1,9,44
90,Fail,49,22,5,15,34
90,Fail,52,20,9,11,41
90,Fail,39,37,0,15,24
90,Fail,42,28,0,17,25
90,Fail,43,34,0,13,30
90,Fail,52,26,0,10,42
90,Fail,47,30,0,11,36
90,Fail,54,25,0,11,43
90,Fail,53,19,6,12,41
90,Fail,43,24,2,17,26
90,Fail,47,22,8,12,35
90,Fail,50,27,0,13,37
90,Fail,49,33,0,5,44
90,Fail,43,24,4,17,26
90,Fail,45,25,1,19,26
90,Fail,43,40,0,11,32
90,Fail,49,26,0,17,32
90,Fail,41,28,7,12,29
90,Fail,53,27,1,10,43
90,Fail,48,29,0,12,36
90,Fail,44,31,0,14,30
90,Fail,51,27,0,13,38
90,Fail,40,29,5,18,22
90,Fail,50,29,1,9,41
90,Fail,53,26,0,11,42
90,Fail,44,36,0,10,34
90,Fail,58,23,0,5,53
90,Fail,58,15,2,11,47
90,Fail,55,20,0,13,42
90,Fail,50,25,0,13,37
90,Fail,49,32,0,11,38
90,Fail,51,19,5,13,38
90,Fail,52,29,0,7,45
90,Fail,51,22,3,13,38
90,Fail,47,30,3,9,38
90,Fail,53,21,0,16,37
90,Fail,51,20,2,12,39
90,Fail,44,20,10,16,28
90,Fail,49,27,0,13,36
90,Fail,38,42,0,16,22
90,Fail,53,22,0,13,40
90,Fail,49,36,0,6,43
90,Fail,42,27,2,13,29
90,Fail,50,26,0,15,35
90,Fail,40,39,0,11,29
90,Fail,48,27,10,4,44
90,Fail,39,23,6,22,17
90,Fail,53,19,3,16,37
90,Fail,52,23,7,11,41
90,Fail,38,44,0,13,25
90,Fail,46,30,0,14,32
90,Fail,55,22,2,11,44
90,Fail,46,20,1,21,25
90,Fail,55,20,0,11,44
90,Fail,46,22,5,17,29
90,Fail,57,21,4,9,48
90,Fail,47,24,0,13,34
90,Fail,50,15,8,18,32
90,Fail,40,41,0,12,28
90,Fail,39,32,0,17,22
90,Fail,54,20,5,12,42
90,Fail,42,34,3,12,30
90,Fail,45,28,4,13,32
90,Fail,51,19,0,17,34
90,Fail,40,36,0,13,27
90,Fail,40,29,6,16,24
90,Fail,45,34,0,11,34
90,Fail,52,25,0,11,41
90,Fail,49,27,6,11,38
90,Fail,47,32,0,13,34
90,Fail,49,18,4,18,31
90,Fail,44,36,0,10,34
90,Fail,41,33,0,18,23
90,Fail,52,23,0,16,36
90,Fail,55,23,0,11,44
90,Fail,52,22,2,12,40
90,Fail,46,31,0,12,34
90,Fail,48,22,6,12,36
90,Fail,48,23,0,16,32
90,Fail,47,29,0,12,35
90,Fail,47,28,0,15,32
90,Fail,43,33,0,11,32
90,Fail,52,19,0,13,39
90,Fail,51,27,4,11,40
90,Fail,51,22,0,12,39
90,Fail,48,28,0,14,34
90,Fail,48,22,1,16,32
90,Fail,42,27,0,21,21
90,Fail,49,23,4,10,39
90,Fail,48,24,4,10,38
90,Fail,53,18,9,11,42
90,Fail,48,28,0,15,33
90,Fail,45,25,0,17,28
90,Fail,52,22,3,10,42
90,Fail,53,25,2,11,42
90,Fail,52,26,0,14,38
90,Fail,49,23,0,14,35
90,Fail,46,25,4,14,32
90,Fail,37,31,0,20,17
90,Fail,38,35,9,11,27
90,Fail,49,26,0,14,35
90,Fail,52,30,0,10,42
90,Fail,38,35,0,14,24
90,Fail,44,33,0,12,32
90,Fail,50,24,0,13,37
90,Fail,42,35,6,8,34
90,Fail,52,27,0,12,40
90,Fail,48,26,0,12,36
90,Fail,50,21,0,17,33
90,Fail,44,36,0,14,30
90,Fail,48,31,0,11,37
90,Fail,42,34,0,13,29
90,Fail,46,23,3,16,30
90,Fail,47,28,0,13,34
90,Fail,56,18,0,13,43
90,Fail,53,23,5,8,45
90,Fail,47,33,0,9,38
90,Fail,50,22,0,15,35
90,Fail,42,23,6,18,24
90,Fail,46,24,9,12,34
90,Fail,46,33,0,11,35
90,Fail,53,20,3,10,43
90,Fail,49,29,0,11,38
90,Fail,39,33,8,10,29
90,Fail,54,26,0,10,44
90,Fail,50,21,0,19,31
90,Fail,47,26,2,13,34
90,Fail,50,25,4,11,39
90,Fail,42,29,0,19,23
90,Fail,43,35,4,9,34
90,Fail,50,19,0,17,33
90,Fail,44,30,0,17,27
90,Fail,45,20,13,14,31
90,Fail,44,28,1,16,28
90,Fail,48,27,1,14,34
90,Fail,51,34,0,3,48
90,Fail,47,32,2,6,41
90,Fail,54,19,5,10,44
90,Fail,51,25,1,11,40
90,Fail,49,28,0,11,38
90,Fail,46,32,2,12,34
90,Fail,47,30,5,9,38
90,Fail,56,24,0,7,49
90,Fail,49,24,7,9,40
90,Fail,46,26,2,13,33
90,Fail,50,26,5,8,42
90,Fail,56,18,1,14,42
90,Fail,48,25,1,13,35
90,Fail,51,37,0,4,47
90,Fail,43,31,8,12,31
90,Fail,38,31,12,15,23
90,Fail,46,24,1,16,30
90,Fail,46,36,0,12,34
90,Fail,46,30,0,12,34
90,Fail,56,22,0,11,45
90,Fail,45,21,10,16,29
90,Fail,49,39,0,6,43
90,Fail,40,32,0,21,19
90,Fail,47,30,0,15,32
90,Fail,45,31,0,14,31
90,Fail,50,25,0,18,32
90,Fail,51,22,0,13,38
90,Fail,51,27,0,11,40
90,Fail,51,26,2,10,41
90,Fail,46,25,3,16,30
90,Fail,39,34,2,16,23
90,Fail,46,23,6,12,34
90,Fail,52,21,3,7,45
90,Fail,49,29,0,11,38
90,Fail,39,34,0,19,20
90,Fail,50,23,0,13,37
90,Fail,45,25,9,11,34
90,Fail,56,24,0,7,49
90,Fail,46,30,7,9,37
90,Fail,59,21,1,6,53
90,Fail,43,24,5,18,25
90,Fail,51,30,2,9,42
90,Fail,46,24,8,13,33
90,Fail,48,24,3,18,30
90,Fail,45,32,0,11,34
90,Fail,43,37,0,9,34
90,Fail,44,25,0,20,24
90,Fail,47,28,5,14,33
90,Fail,47,29,0,17,30
90,Fail,51,26,5,9,42
90,Fail,43,28,0,19,24
90,Fail,46,25,0,16,30
90,Fail,44,32,0,15,29
90,Fail,45,31,0,10,35
90,Fail,56,25,0,7,49
90,Fail,46,30,12,6,40
90,Fail,50,24,2,12,38
90,Fail,50,27,6,6,44
90,Fail,46,34,0,13,33
90,Fail,51,22,3,13,38
90,Fail,49,25,0,13,36
90,Fail,51,27,0,12,39
90,Fail,37,38,1,18,19
90,Fail,45,32,1,10,35
90,Fail,48,24,1,11,37
90,Fail,54,18,2,14,40
90,Fail,46,25,4,14,32
90,Fail,49,25,6,14,35
90,Fail,54,20,1,11,43
90,Fail,57,17,0,12,45
90,Fail,50,23,0,16,34
90,Fail,52,26,0,9,43
90,Fail,45,25,2,12,33
90,Fail,47,23,9,13,34
90,Fail,54,27,4,7,47
90,Fail,50,27,0,12,38
90,Fail,43,23,5,19,24
90,Fail,47,28,2,11,36
90,Fail,47,30,0,13,34
90,Fail,45,35,0,14,31
90,Fail,53,30,0,6,47
90,Fail,51,28,0,11,40
90,Fail,47,28,0,14,33
90,Fail,54,26,0,11,43
90,Fail,44,30,0,15,29
90,Fail,51,31,0,8,43
90,Fail,50,31,0,11,39
90,Fail,49,32,0,11,38
90,Fail,54,22,0,12,42
90,Fail,45,28,2,13,32
90,Fail,42,36,0,12,30
90,Fail,42,33,0,12,30
90,Fail,46,30,0,15,31
90,Fail,52,20,3,14,38
90,Fail,53,20,0,14,39
90,Fail,49,32,2,9,40
90,Fail,48,31,0,12,36
90,Fail,47,33,0,16,31
90,Fail,50,27,1,10,40
90,Fail,47,26,0,12,35
90,Fail,43,38,0,10,33
90,Fail,45,28,7,13,32
90,Fail,40,32,5,12,28
90,Fail,46,29,0,12,34
90,Fail,49,25,3,12,37
90,Fail,48,27,0,15,33
90,Fail,50,34,0,8,42
90,Fail,50,32,0,10,40
90,Fail,49,30,0,11,38
90,Fail,47,31,3,12,35
90,Fail,41,40,0,10,31
90,Fail,48,19,8,15,33
90,Fail,47,29,1,14,33
90,Fail,44,31,0,16,28
90,Fail,47,30,3,11,36
90,Fail,46,26,4,12,34
90,Fail,44,31,0,11,33
90,Fail,41,25,8,18,23
90,Fail,44,19,10,15,29
90,Fail,52,22,7,12,40
90,Fail,52,25,0,14,38
90,Fail,49,25,0,14,35
90,Fail,48,24,0,13,35
90,Fail,45,32,3,11,34
90,Fail,54,25,0,6,48
90,Fail,49,23,0,15,34
90,Fail,40,34,6,14,26
90,Fail,55,20,3,12,43
90,Fail,42,32,0,15,27
90,Fail,56,19,0,9,47
90,Fail,48,29,0,14,34
90,Fail,42,39,0,13,29
90,Fail,49,32,0,13,36
90,Fail,46,23,3,15,31
90,Fail,47,20,4,19,28
90,Fail,49,28,0,13,36
90,Fail,53,18,0,14,39
90,Fail,47,26,7,10,37
90,Fail,49,28,0,13,36
90,Fail,51,17,0,16,35
90,Fail,45,27,11,10,35
90,Fail,50,21,1,15,35
90,Fail,45,33,3,7,38
90,Fail,48,23,6,14,34
90,Fail,49,28,0,17,32
90,Fail,53,28,0,9,44
90,Fail,56,25,0,8,48
90,Fail,43,38,0,12,31
90,Fail,47,28,1,13,34
90,Fail,47,22,2,18,29
90,Fail,49,23,11,11,38
90,Fail,55,24,4,6,49
90,Fail,46,30,6,10,36
90,Fail,49,29,3,8,41
90,Fail,52,24,0,14,38
90,Fail,49,26,0,11,38
90,Fail,38,27,7,17,21
90,Fail,52,31,0,5,47
90,Fail,44,28,5,15,29
90,Fail,42,30,2,16,26
90,Fail,42,39,0,10,32
90,Fail,43,34,0,13,30
90,Fail,56,16,2,13,43
90,Fail,43,37,5,9,34
90,Fail,44,24,4,17,27
90,Fail,40,21,1,23,17
90,Fail,48,28,0,9,39
90,Fail,46,28,3,13,33
90,Fail,50,32,0,11,39
90,Fail,53,18,10,10,43
90,Fail,50,22,1,18,32
90,Fail,55,28,0,7,48
90,Fail,46,30,4,15,31
90,Fail,44,33,0,12,32
90,Fail,50,21,7,10,40
90,Fail,50,23,0,11,39
90,Fail,40,36,6,14,26
90,Fail,47,25,0,17,30
90,Fail,44,37,0,13,31
90,Fail,52,29,0,10,42
90,Fail,40,30,8,13,27
90,Fail,44,29,3,14,30
90,Fail,49,31,0,9,40
90,Fail,48,29,0,15,33
90,Fail,46,34,0,12,34
90,Fail,40,29,0,19,21
90,Fail,49,25,4,10,39
90,Fail,47,25,2,13,34
90,Fail,53,17,5,17,36
90,Fail,52,20,2,14,38
90,Fail,52,23,5,13,39
90,Fail,52,26,0,14,38
90,Fail,42,28,6,11,31
90,Fail,49,27,3,8,41
90,Fail,50,24,5,11,39
90,Fail,54,26,0,6,48
90,Fail,49,19,0,18,31
90,Fail,46,26,0,20,26
90,Fail,48,30,4,9,39
90,Fail,33,43,0,16,17
90,Fail,55,21,0,16,39
90,Fail,53,19,4,12,41
90,Fail,45,29,4,12,33
90,Fail,48,31,2,10,38
90,Fail,44,27,0,17,27
90,Fail,50,32,0,8,42
90,Fail,45,32,0,13,32
90,Fail,48,30,0,12,36
90,Fail,46,30,0,14,32
90,Fail,52,29,0,9,43
90,Fail,48,31,0,10,38
90,Fail,47,22,6,18,29
90,Fail,47,25,7,14,33
90,Fail,59,25,0,7,52
90,Fail,47,31,0,10,37
90,Fail,55,23,0,15,40
90,Fail,52,23,0,9,43
90,Fail,49,22,5,15,34
90,Fail,47,25,5,10,37
90,Fail,46,22,4,15,31
90,Fail,53,22,1,14,39
90,Fail,46,32,0,11,35
90,Fail,47,29,1,10,37
90,Fail,48,29,0,7,41
90,Fail,47,32,0,12,35
90,Fail,50,28,0,9,41
90,Fail,43,18,9,19,24
90,Fail,57,17,6,12,45
90,Fail,55,19,1,14,41
90,Fail,50,28,4,8,42
90,Fail,48,21,0,17,31
90,Fail,45,27,3,11,34
90,Fail,44,31,0,17,27
90,Fail,44,29,5,13,31
90,Fail,53,21,1,11,42
90,Fail,52,21,3,12,40
90,Fail,48,34,0,8,40
90,Fail,51,19,5,17,34
90,Fail,42,34,0,15,27
90,Fail,46,32,0,8,38
90,Fail,48,33,0,11,37
90,Fail,62,19,0,10,52
90,Fail,49,28,0,16,33
90,Fail,53,29,0,7,46
90,Fail,46,24,1,17,29
90,Fail,41,30,3,16,25
90,Fail,56,15,6,16,40
90,Fail,54,22,0,10,44
90,Fail,50,23,1,14,36
90,Fail,46,30,6,8,38
90,Fail,48,34,0,9,39
90,Fail,40,37,0,15,25
90,Fail,50,25,0,14,36
90,Fail,48,34,0,10,38
90,Fail,53,21,0,14,39
90,Fail,49,26,2,14,35
90,Fail,44,30,5,13,31
90,Fail,45,26,0,18,27
90,Fail,51,19,2,17,34
90,Fail,43,24,0,22,21
90,Fail,47,33,2,9,38
90,Fail,48,26,0,13,35
90,Fail,47,27,5,7,40
90,Fail,46,29,0,11,35
90,Fail,56,16,2,14,42
90,Fail,54,23,0,15,39
90,Fail,48,29,0,11,37
90,Fail,49,27,0,11,38
90,Fail,48,26,0,13,35
90,Fail,54,22,0,10,44
90,Fail,48,24,1,17,31
90,Fail,43,33,4,13,30
90,Fail,46,26,0,16,30
90,Fail,43,32,0,14,29
90,Fail,49,34,0,10,39
90,Fail,45,22,3,18,27
90,Fail,42,38,0,7,35
90,Fail,53,21,1,12,41
90,Fail,54,26,0,8,46
90,Fail,48,26,2,14,34
90,Fail,48,33,0,11,37
90,Fail,44,31,2,12,32
90,Fail,46,26,7,9,37
90,Fail,46,33,0,14,32
90,Fail,49,22,5,16,33
90,Fail,46,30,0,14,32
90,Fail,43,30,0,18,25
90,Fail,55,21,0,15,40
90,Fail,48,20,0,21,27
90,Fail,56,28,0,6,50
90,Fail,56,27,0,7,49
90,Fail,46,34,0,8,38
90,Fail,58,19,0,14,44
90,Fail,46,28,4,13,33
90,Fail,47,26,5,11,36
90,Fail,49,25,6,10,39
90,Fail,45,28,0,15,30
90,Fail,49,24,0,16,33
90,Fail,46,30,0,11,35
90,Fail,54,22,0,11,43
90,Fail,42,26,5,14,28
90,Fail,49,20,6,11,38
90,Fail,46,24,4,13,33
90,Fail,43,25,1,17,26
90,Fail,49,29,0,11,38
90,Fail,55,21,0,16,39
90,Fail,51,29,0,10,41
90,Fail,51,20,0,19,32
90,Fail,53,28,0,12,41
90,Fail,47,16,11,16,31
90,Fail,45,29,0,14,31
90,Fail,46,30,7,7,39
90,Fail,49,27,1,7,42
90,Fail,51,29,0,12,39
90,Fail,52,30,0,9,43
90,Fail,57,17,2,14,43
90,Fail,41,32,0,15,26
90,Fail,46,33,0,14,32
90,Fail,42,28,5,16,26
90,Fail,43,28,3,16,27
90,Fail,45,35,0,11,34
90,Fail,45,26,4,15,30
90,Fail,53,26,0,9,44
90,Fail,55,23,2,8,47
90,Fail,41,39,0,9,32
90,Fail,45,25,5,10,35
90,Fail,41,27,5,15,26
90,Fail,55,21,0,12,43
90,Fail,47,25,0,15,32
90,Fail,51,23,3,14,37
90,Fail,50,28,0,12,38
90,Fail,47,23,11,12,35
90,Fail,47,27,1,15,32
90,Fail,53,20,2,14,39
90,Fail,42,38,0,13,29
90,Fail,42,38,0,7,35
90,Fail,45,31,2,12,33
90,Fail,47,23,4,13,34
90,Fail,49,24,0,16,33
90,Fail,59,23,0,8,51
90,Fail,47,26,0,17,30
90,Fail,45,29,2,10,35
90,Fail,48,25,1,14,34
90,Fail,50,21,5,13,37
90,Fail,48,25,0,13,35
90,Fail,46,45,0,7,39
90,Fail,53,29,0,9,44
90,Fail,51,30,1,8,43
90,Fail,45,31,0,13,32
90,Fail,50,19,10,12,38
90,Fail,46,25,0,19,27
90,Fail,38,36,0,14,24
90,Fail,51,34,0,7,44
90,Fail,49,25,0,14,35
90,Fail,50,35,0,10,40
90,Fail,40,27,5,21,19
90,Fail,48,32,0,15,33
90,Fail,50,23,2,12,38
90,Fail,45,29,0,13,32
90,Fail,45,28,0,16,29
90,Fail,48,27,0,16,32
90,Fail,48,20,5,17,31
90,Fail,48,27,2,11,37
90,Fail,49,26,0,15,34
90,Fail,41,29,4,17,24
90,Fail,49,29,0,10,39
90,Fail,50,27,1,12,38
90,Fail,44,31,0,13,31
90,Fail,43,25,5,17,26
90,Fail,48,23,0,15,33
90,Fail,40,25,11,13,27
90,Fail,50,20,2,15,35
90,Fail,46,31,1,11,35
90,Fail,48,30,3,9,39
90,Fail,48,26,0,13,35
90,Fail,51,24,3,11,40
90,Fail,46,19,1,21,25
90,Fail,45,39,0,8,37
90,Fail,43,31,5,10,33
90,Fail,53,25,3,9,44
90,Fail,49,21,2,14,35
90,Fail,54,26,1,10,44
90,Fail,50,30,2,9,41
90,Fail,57,23,0,8,49
90,Fail,50,21,4,12,38
90,Fail,46,27,4,14,32
90,Fail,44,30,3,12,32
90,Fail,46,27,3,16,30
90,Fail,53,25,0,11,42
90,Fail,40,30,2,17,23
90,Fail,50,24,5,11,39
90,Fail,49,26,0,13,36
90,Fail,46,22,0,17,29
90,Fail,51,22,0,12,39
90,Fail,52,23,0,14,38
90,Fail,44,30,6,10,34
90,Fail,56,20,0,13,43
90,Fail,48,25,3,14,34
90,Fail,53,24,0,13,40
90,Fail,49,24,4,11,38
90,Fail,53,18,3,11,42
90,Fail,48,26,1,12,36
90,Fail,48,30,0,12,36
90,Fail,53,22,0,12,41
90,Fail,50,23,4,16,34
90,Fail,44,26,5,14,30
90,Fail,46,28,0,16,30
90,Fail,51,25,4,8,43
90,Fail,41,26,10,12,29
90,Fail,46,30,2,11,35
90,Fail,51,20,4,17,34
90,Fail,43,34,0,15,28
90,Fail,50,23,0,17,33
90,Fail,49,25,5,12,37
90,Fail,40,36,0,16,24
90,Fail,49,25,3,13,36
90,Fail,42,26,2,18,24
90,Fail,46,31,0,12,34
90,Fail,48,30,0,10,38
90,Fail,47,24,2,17,30
90,Fail,56,29,0,9,47
90,Fail,49,26,6,12,37
90,Fail,51,24,1,11,40
90,Fail,45,28,0,14,31
90,Fail,47,38,0,6,41
90,Fail,49,21,2,15,34
90,Fail,51,22,7,10,41
90,Fail,45,25,4,10,35
90,Fail,47,29,0,12,35
90,Fail,51,30,0,11,40
90,Fail,42,22,7,15,27
90,Fail,50,29,0,12,38
90,Fail,55,17,1,13,42
90,Fail,41,32,5,11,30
90,Fail,46,31,0,13,33
90,Fail,48,34,0,5,43
90,Fail,49,27,0,16,33
90,Fail,49,26,0,11,38
90,Fail,46,29,7,10,36
90,Fail,44,23,3,15,29
90,Fail,48,23,3,16,32
90,Fail,46,34,0,8,38
90,Fail,55,29,0,10,45
90,Fail,54,19,0,16,38
90,Fail,48,28,0,17,31
90,Fail,50,27,0,14,36
90,Fail,48,24,5,14,34
90,Fail,49,31,0,10,39
90,Fail,45,32,0,13,32
90,Fail,50,25,0,14,36
90,Fail,46,22,0,21,25
90,Fail,43,35,0,11,32
90,Fail,45,29,1,13,32
90,Fail,55,24,1,7,48
90,Fail,48,24,0,13,35
90,Fail,51,29,1,9,42
90,Fail,53,21,5,6,47
90,Fail,43,38,6,6,37
90,Fail,42,34,0,17,25
90,Fail,47,23,5,15,32
90,Fail,52,23,2,11,41
90,Fail,51,31,0,10,41
90,Fail,50,24,6,14,36
90,Fail,49,25,0,10,39
90,Fail,46,37,0,11,35
90,Fail,47,29,2,12,35
90,Fail,52,19,0,18,34
90,Fail,49,20,0,17,32
90,Fail,43,28,0,19,24
90,Fail,46,26,0,18,28
90,Fail,50,22,6,16,34
90,Fail,44,24,11,9,35
90,Fail,46,26,3,16,30
90,Fail,44,29,4,13,31
90,Fail,46,18,16,13,33
90,Fail,45,22,15,13,32
90,Fail,43,36,0,13,30
90,Fail,55,24,1,9,46
90,Fail,49,20,8,14,35
90,Fail,47,26,0,14,33
90,Fail,54,21,2,10,44
90,Fail,52,26,3,7,45
90,Fail,48,24,6,10,38
90,Fail,53,26,7,7,46
90,Fail,54,19,0,11,43
90,Fail,50,28,0,11,39
90,Fail,45,35,0,6,39
90,Fail,47,22,6,15,32
90,Fail,50,29,0,10,40
90,Fail,51,22,0,16,35
90,Fail,45,31,0,15,30
90,Fail,56,22,0,11,45
90,Fail,42,28,3,17,25
90,Fail,46,28,0,14,32
90,Fail,45,25,1,15,30
90,Fail,45,25,1,18,27
90,Fail,51,22,0,15,36
90,Fail,48,28,2,12,36
90,Fail,44,31,0,16,28
90,Fail,51,23,0,13,38
90,Fail,56,21,4,7,49
90,Fail,45,25,9,12,33
90,Fail,46,30,0,10,36
90,Fail,49,28,0,16,33
90,Fail,40,27,10,11,29
90,Fail,48,30,0,10,38
90,Fail,46,31,0,13,33
90,Fail,44,29,0,17,27
90,Fail,49,24,6,9,40
90,Fail,48,29,0,12,36
90,Fail,48,29,2,10,38
90,Fail,41,31,2,15,26
90,Fail,40,35,0,13,27
90,Fail,46,28,6,15,31
90,Fail,50,19,2,14,36
90,Fail,50,26,0,13,37
90,Fail,47,23,0,18,29
90,Fail,36,39,0,14,22
90,Fail,38,33,3,14,24
90,Fail,51,27,0,10,41
90,Fail,47,35,0,11,36
90,Fail,49,33,0,8,41
90,Fail,43,27,2,19,24
90,Fail,52,27,1,11,41
90,Fail,58,28,0,4,54
90,Fail,45,25,8,12,33
90,Fail,48,31,0,11,37
90,Fail,50,22,1,17,33
90,Fail,51,26,0,12,39
90,Fail,40,38,0,15,25
90,Fail,50,23,5,10,40
90,Fail,44,33,1,12,32
90,Fail,44,41,0,9,35
90,Fail,50,27,0,12,38
90,Fail,50,27,1,10,40
90,Fail,49,27,3,10,39
90,Fail,45,22,12,10,35
90,Fail,48,21,2,16,32
90,Fail,46,31,0,16,30
90,Fail,48,26,5,15,33
90,Fail,40,37,4,10,30
90,Fail,45,24,4,16,29
90,Fail,39,30,7,14,25
90,Fail,49,25,1,13,36
90,Fail,52,26,1,13,39
90,Fail,47,36,0,7,40
90,Fail,51,26,0,12,39
90,Fail,53,17,0,18,35
90,Fail,50,20,7,17,33
90,Fail,45,25,0,20,25
90,Fail,50,24,3,14,36
90,Fail,47,29,0,13,34
90,Fail,39,32,0,19,20
90,Fail,54,22,0,10,44
90,Fail,54,19,0,15,39
90,Fail,53,23,2,13,40
90,Fail,47,24,0,19,28
90,Fail,43,35,0,15,28
90,Fail,48,27,2,14,34
90,Fail,43,44,0,8,35
90,Fail,46,26,6,10,36
90,Fail,46,25,2,17,29
90,Fail,51,17,3,17,34
90,Fail,52,30,0,12,40
90,Fail,46,15,9,17,29
90,Fail,52,26,0,13,39
90,Fail,42,38,3,7,35
90,Fail,46,27,0,15,31
90,Fail,54,23,1,10,44
90,Fail,52,26,4,11,41
90,Fail,46,28,0,17,29
90,Fail,42,34,3,10,32
90,Fail,48,34,0,10,38
90,Fail,44,38,0,8,36
90,Fail,51,28,1,8,43
90,Fail,47,29,0,12,35
90,Fail,46,30,0,16,30
90,Fail,51,28,0,14,37
90,Fail,58,22,0,10,48
90,Fail,49,28,4,8,41
90,Fail,50,22,2,15,35
90,Fail,44,28,4,14,30
90,Fail,50,29,0,10,40
90,Fail,46,26,0,17,29
90,Fail,51,29,0,12,39
90,Fail,47,28,0,11,36
90,Fail,50,18,9,13,37
90,Fail,52,34,0,7,45
90,Fail,44,29,5,14,30
90,Fail,46,27,6,13,33
90,Fail,60,12,1,10,50
90,Fail,47,29,2,8,39
90,Fail,55,18,0,13,42
90,Fail,49,26,5,9,40
90,Fail,46,27,5,11,35
90,Fail,37,30,10,17,20
90,Fail,44,26,11,12,32
90,Fail,48,31,1,8,40
90,Fail,45,27,4,15,30
90,Fail,42,26,4,15,27
90,Fail,48,25,4,12,36
90,Fail,57,19,1,10,47
90,Fail,52,26,2,10,42
90,Fail,50,28,0,12,38
90,Fail,58,19,0,8,50
90,Fail,47,24,1,18,29
90,Fail,46,31,3,11,35
90,Fail,47,29,0,14,33
90,Fail,46,26,4,12,34
90,Fail,52,24,0,11,41
90,Fail,36,32,6,16,20
90,Fail,39,33,1,16,23
90,Fail,43,25,1,18,25
90,Fail,50,25,1,13,37
90,Fail,42,40,0,14,28
90,Fail,47,29,0,16,31
90,Fail,49,25,0,11,38
90,Fail,49,29,0,12,37
90,Fail,50,23,0,17,33
90,Fail,44,29,0,18,26
90,Fail,51,24,5,11,40
90,Fail,53,31,0,6,47
90,Fail,50,25,2,11,39
90,Fail,39,27,6,20,19
90,Fail,54,22,0,18,36
90,Fail,47,22,13,13,34
90,Fail,47,22,0,18,29
90,Fail,46,32,0,12,34
90,Fail,44,33,0,13,31
90,Fail,51,20,2,10,41
90,Fail,51,23,4,10,41
90,Fail,52,30,2,7,45
90,Fail,48,25,5,11,37
90,Fail,51,24,3,12,39
90,Fail,54,14,7,13,41
90,Fail,43,34,0,14,29
90,Fail,55,22,0,12,43
90,Fail,46,26,7,12,34
90,Fail,48,30,0,14,34
90,Fail,56,22,0,13,43
90,Fail,43,28,0,20,23
90,Fail,52,22,0,14,38
90,Fail,47,20,0,16,31
90,Fail,40,27,11,14,26
90,Fail,58,19,0,12,46
90,Fail,50,24,0,16,34
90,Fail,50,32,0,11,39
90,Fail,51,25,0,8,43
90,Fail,53,28,0,9,44
90,Fail,42,32,6,12,30
90,Fail,52,21,1,12,40
90,Fail,49,27,9,8,41
90,Fail,47,33,0,10,37
90,Fail,49,26,0,15,34
90,Fail,43,32,3,13,30
90,Fail,49,29,0,14,35
90,Fail,52,25,0,10,42
90,Fail,59,21,0,11,48
90,Fail,45,30,0,13,32
90,Fail,56,22,1,10,46
90,Fail,48,20,6,16,32
90,Fail,52,24,0,10,42
90,Fail,58,23,0,7,51
90,Fail,49,23,0,15,34
90,Fail,39,26,11,17,22
90,Fail,50,27,0,12,38
90,Fail,51,22,4,15,36
90,Fail,57,20,0,11,46
90,Fail,49,31,0,12,37
90,Fail,51,23,0,12,39
90,Fail,48,33,0,10,38
90,Fail,53,21,5,8,45
90,Fail,43,37,0,15,28
90,Fail,49,24,0,14,35
90,Fail,45,28,9,5,40
90,Fail,47,21,9,16,31
90,Fail,56,25,0,10,46
90,Fail,42,26,7,17,25
90,Fail,54,22,0,12,42
90,Fail,44,30,6,11,33
90,Fail,50,23,1,13,37
90,Fail,58,16,0,15,43
90,Fail,44,27,7,15,29
90,Fail,47,21,2,12,35
90,Fail,45,23,6,17,28
90,Fail,45,23,3,20,25
90,Fail,52,27,2,11,41
90,Fail,46,24,3,16,30
90,Fail,49,24,2,16,33
90,Fail,46,27,0,13,33
90,Fail,54,25,0,9,45
90,Fail,37,26,13,16,21
90,Fail,51,28,0,11,40
90,Fail,40,28,11,13,27
90,Fail,55,34,0,5,50
90,Fail,56,24,3,8,48
90,Fail,53,20,2,15,38
90,Fail,48,22,8,14,34
90,Fail,52,26,0,12,40
90,Fail,48,23,0,17,31
90,Fail,46,34,0,12,34
90,Fail,39,30,3,18,21
90,Fail,50,22,0,19,31
90,Fail,47,33,0,12,35
90,Fail,51,25,0,14,37
90,Fail,48,18,0,21,27
90,Fail,39,30,0,25,14
90,Fail,50,27,4,8,42
90,Fail,50,23,0,17,33
90,Fail,44,27,4,15,29
90,Fail,42,25,3,17,25
90,Fail,48,30,0,10,38
90,Fail,45,36,0,10,35
90,Fail,42,29,6,13,29
90,Fail,43,41,0,13,30
90,Fail,45,38,0,11,34
90,Fail,53,29,0,8,45
90,Fail,42,32,2,13,29
90,Fail,53,32,0,6,47
90,Fail,48,15,6,21,27
90,Fail,45,35,0,12,33
90,Fail,44,32,0,12,32
90,Fail,42,36,0,11,31
90,Fail,49,35,0,8,41
90,Fail,46,28,2,11,35
90,Fail,52,23,0,11,41
90,Fail,52,23,2,12,40
90,Fail,38,38,0,18,20
90,Fail,45,31,0,14,31
90,Fail,56,27,0,9,47
90,Fail,50,20,5,12,38
90,Fail,44,31,6,12,32
90,Fail,49,26,0,15,34
90,Fail,49,28,0,11,38
90,Fail,57,24,4,5,52
90,Fail,49,25,0,14,35
90,Fail,46,20,6,14,32
90,Fail,46,29,4,13,33
90,Fail,45,25,1,18,27
90,Fail,44,32,2,12,32
90,Fail,49,18,12,16,33
90,Fail,51,28,0,9,42
90,Fail,45,31,0,15,30
90,Fail,42,29,7,13,29
90,Fail,44,34,0,12,32
90,Fail,43,31,4,11,32
90,Fail,40,30,0,18,22
90,Fail,48,22,3,16,32
90,Fail,55,18,0,18,37
90,Fail,49,22,7,14,35
90,Fail,54,19,1,14,40
90,Fail,47,32,0,7,40
90,Fail,47,23,0,19,28
90,Fail,49,31,0,13,36
90,Fail,52,20,0,12,40
90,Fail,42,39,0,12,30
90,Fail,53,21,2,12,41
90,Fail,48,26,3,14,34
90,Fail,46,31,4,7,39
90,Fail,43,28,6,11,32
90,Fail,43,34,0,10,33
90,Fail,55,21,1,11,44
90,Fail,43,40,0,13,30
90,Fail,46,19,16,15,31
90,Fail,48,33,0,8,40
90,Fail,54,24,0,11,43
90,Fail,48,30,0,15,33
90,Fail,53,22,0,13,40
90,Fail,44,34,0,16,28
90,Fail,42,30,5,11,31
90,Fail,49,24,1,13,36
90,Fail,48,30,0,12,36
90,Fail,49,28,5,10,39
90,Fail,44,32,0,12,32
90,Fail,41,28,11,12,29
90,Fail,48,32,0,12,36
90,Fail,51,25,0,13,38
90,Fail,45,27,0,14,31
90,Fail,44,33,0,14,30
90,Fail,48,25,0,14,34
90,Fail,52,24,2,10,42
90,Fail,45,32,0,12,33
90,Fail,50,29,0,9,41
90,Fail,51,23,3,12,39
90,Fail,40,29,2,17,23
90,Fail,45,24,10,10,35
90,Fail,58,20,4,8,50
90,Fail,49,24,5,12,37
90,Fail,42,21,7,21,21
90,Fail,52,28,0,8,44
90,Fail,43,33,0,14,29
90,Fail,52,29,0,12,40
90,Fail,50,27,0,14,36
90,Fail,46,32,0,13,33
90,Fail,43,29,0,13,30
90,Fail,54,29,0,8,46
90,Fail,49,22,6,11,38
90,Fail,41,32,1,13,28
90,Fail,47,27,2,14,33
90,Fail,44,36,0,11,33
90,Fail,40,29,4,15,25
90,Fail,40,30,0,16,24
90,Fail,48,23,6,13,35
90,Fail,49,23,4,14,35
90,Fail,45,29,8,9,36
90,Fail,48,27,0,15,33
90,Fail,35,41,0,14,21
90,Fail,49,31,5,8,41
90,Fail,39,37,0,16,23
90,Fail,39,30,1,18,21
90,Fail,50,33,0,11,39
90,Fail,48,32,0,9,39
90,Fail,44,28,0,16,28
90,Fail,47,38,0,8,39
90,Fail,50,30,0,9,41
90,Fail,50,29,0,9,41
90,Fail,47,27,0,18,29
90,Fail,44,26,5,15,29
90,Fail,44,30,3,12,32
90,Fail,52,24,3,9,43
90,Fail,46,33,0,10,36
90,Fail,57,25,0,9,48
90,Fail,46,23,3,20,26
90,Fail,50,27,4,8,42
90,Fail,50,22,10,10,40
90,Fail,51,21,1,17,34
90,Fail,51,18,1,15,36
90,Fail,48,26,8,11,37
90,Fail,48,21,4,17,31
90,Fail,49,26,0,14,35
90,Fail,53,23,0,12,41
90,Fail,49,20,3,16,33
90,Fail,42,28,7,12,30
90,Fail,51,25,0,7,44
90,Fail,47,32,2,11,36
90,Fail,49,25,4,13,36
90,Fail,49,29,0,7,42
90,Fail,56,21,4,10,46
90,Fail,48,26,7,10,38
90,Fail,45,36,0,8,37
90,Fail,44,27,8,14,30
90,Fail,52,24,6,9,43
90,Fail,36,24,7,25,11
90,Fail,48,26,4,14,34
90,Fail,50,26,4,10,40
90,Fail,50,28,0,11,39
90,Fail,49,24,0,14,35
90,Fail,52,29,0,8,44
90,Fail,46,22,4,17,29
90,Fail,43,32,0,15,28
90,Fail,43,30,3,14,29
90,Fail,48,21,2,18,30
90,Fail,52,17,5,16,36
90,Fail,47,26,5,15,32
90,Fail,46,25,1,18,28
90,Fail,46,21,6,15,31
90,Fail,41,42,0,13,28
90,Fail,44,27,0,21,23
90,Fail,48,28,0,12,36
90,Fail,59,24,0,9,50
90,Fail,47,27,0,12,35
90,Fail,56,16,1,15,41
90,Fail,48,24,5,13,35
90,Fail,48,32,0,11,37
90,Fail,50,24,1,16,34
90,Fail,45,35,0,10,35
90,Fail,45,26,0,15,30
90,Fail,46,23,5,13,33
90,Fail,55,20,3,11,44
90,Fail,49,24,3,15,34
90,Fail,50,20,5,14,36
90,Fail,51,28,0,11,40
90,Fail,52,23,0,11,41
90,Fail,47,21,0,20,27
90,Fail,40,34,0,21,19
90,Fail,53,32,0,9,44
90,Fail,50,31,0,10,40
90,Fail,48,28,0,14,34
90,Fail,47,36,0,6,41
90,Fail,50,31,0,9,41
90,Fail,45,36,4,7,38
90,Fail,50,25,0,14,36
90,Fail,40,30,0,17,23
90,Fail,46,28,3,13,33
90,Fail,49,26,5,11,38
90,Fail,46,31,0,10,36
90,Fail,44,27,0,18,26
90,Fail,49,33,0,9,40
90,Fail,45,31,1,13,32
90,Fail,39,31,1,20,19
90,Fail,50,32,0,9,41
90,Fail,39,32,1,15,24
90,Fail,53,19,0,15,38
90,Fail,52,28,0,9,43
90,Fail,51,20,0,13,38
90,Fail,54,28,0,11,43
90,Fail,50,27,4,10,40
90,Fail,38,36,0,15,23
90,Fail,45,33,0,12,33
90,Fail,37,41,0,15,22
90,Fail,45,35,0,11,34
90,Fail,52,28,0,10,42
90,Fail,54,18,1,15,39
90,Fail,44,30,0,12,32
90,Fail,54,21,2,11,43
90,Fail,48,27,1,14,34
90,Fail,51,22,0,18,33
90,Fail,45,27,2,14,31
90,Fail,49,32,0,10,39
90,Fail,50,31,0,8,42
90,Fail,42,26,8,14,28
90,Fail,46,32,0,16,30
90,Fail,45,36,0,8,37
90,Fail,56,18,5,10,46
90,Fail,46,27,5,11,35
90,Fail,50,23,0,14,36
90,Fail,44,33,0,12,32
90,Fail,49,24,12,8,41
90,Fail,37,30,10,15,22
90,Fail,46,29,0,12,34
90,Fail,45,31,0,19,26
90,Fail,53,25,2,8,45
90,Fail,47,23,5,13,34
90,Fail,52,24,2,9,43
90,Fail,47,26,5,11,36
90,Fail,45,30,0,12,33
90,Fail,42,37,0,9,33
90,Fail,43,34,0,11,32
90,Fail,51,28,0,11,40
90,Fail,51,23,2,15,36
90,Fail,47,29,0,11,36
90,Fail,44,26,0,19,25
90,Fail,55,20,2,8,47
90,Fail,53,23,2,8,45
90,Fail,52,22,1,13,39
90,Fail,46,23,3,19,27
90,Fail,54,21,2,12,42
90,Fail,46,30,0,16,30
90,Fail,42,34,5,13,29
90,Fail,50,23,4,15,35
90,Fail,45,27,5,14,31
90,Fail,50,30,0,11,39
90,Fail,47,33,0,14,33
90,Fail,37,42,0,12,25
90,Fail,40,38,0,16,24
90,Fail,55,22,1,9,46
90,Fail,49,23,4,16,33
90,Fail,48,32,0,10,38
90,Fail,45,24,2,19,26
90,Fail,46,35,0,13,33
90,Fail,38,29,4,18,20
90,Fail,45,30,2,13,32
90,Fail,42,20,1,23,19
90,Fail,41,37,0,9,32
90,Fail,47,32,0,9,38
90,Fail,48,23,0,14,34
90,Fail,49,29,1,11,38
90,Fail,52,26,0,10,42
90,Fail,46,31,0,13,33
90,Fail,50,23,0,13,37
90,Fail,48,26,7,10,38
90,Fail,47,24,9,7,40
90,Fail,49,23,1,17,32
90,Fail,57,26,0,8,49
90,Fail,47,28,0,12,35
90,Fail,44,32,0,10,34
90,Fail,47,28,0,12,35
90,Fail,48,22,7,17,31
90,Fail,48,21,8,14,34
90,Fail,56,17,3,12,44
90,Fail,48,31,0,9,39
90,Fail,56,13,11,11,45
90,Fail,42,36,0,9,33
90,Fail,48,26,2,12,36
90,Fail,48,27,0,10,38
90,Fail,45,29,5,11,34
90,Fail,45,28,3,15,30
90,Fail,47,34,0,13,34
90,Fail,47,26,2,16,31
90,Fail,52,26,0,14,38
90,Fail,50,23,0,13,37
90,Fail,49,22,5,14,35
90,Fail,39,26,2,21,18
90,Fail,51,23,7,11,40
90,Fail,47,25,7,16,31
90,Fail,49,21,0,17,32
90,Fail,38,33,4,18,20
90,Fail,54,21,3,10,44
90,Fail,52,25,7,6,46
90,Fail,45,29,2,13,32
90,Fail,44,25,5,14,30
90,Fail,40,37,0,16,24
90,Fail,56,16,1,15,41
90,Fail,55,20,5,10,45
90,Fail,44,33,0,13,31
90,Fail,53,28,0,11,42
90,Fail,44,31,0,17,27
90,Fail,46,30,0,14,32
90,Fail,48,28,0,14,34
90,Fail,52,27,0,11,41
90,Fail,47,27,0,14,33
90,Fail,48,29,0,10,38
90,Fail,46,37,0,11,35
90,Fail,53,19,1,15,38
90,Fail,46,23,1,17,29
90,Fail,52,24,10,5,47
90,Fail,52,23,0,13,39
90,Fail,42,38,0,10,32
90,Fail,43,32,6,10,33
90,Fail,40,29,0,20,20
90,Fail,46,24,0,13,33
90,Fail,41,28,5,10,31
90,Fail,56,28,0,4,52
90,Fail,55,19,2,14,41
90,Fail,48,20,2,19,29
90,Fail,57,14,3,16,41
90,Fail,49,15,2,23,26
90,Fail,47,26,0,15,32
90,Fail,47,29,3,14,33
90,Fail,42,32,5,10,32
90,Fail,52,22,0,10,42
90,Fail,56,27,0,4,52
90,Fail,55,15,0,16,39
90,Fail,48,25,2,10,38
90,Fail,48,33,3,8,40
90,Fail,46,24,0,22,24
90,Fail,44,27,12,10,34
90,Fail,46,27,0,18,28
90,Fail,47,24,0,13,34
90,Fail,46,30,4,10,36
90,Fail,41,30,5,15,26
90,Fail,52,23,2,12,40
90,Fail,43,35,0,14,29
90,Fail,49,36,0,8,41
90,Fail,50,26,0,13,37
90,Fail,39,31,4,15,24
90,Fail,49,24,0,13,36
90,Fail,45,28,1,11,34
90,Fail,43,36,0,10,33
90,Fail,53,23,0,10,43
90,Fail,52,18,3,13,39
90,Fail,45,37,0,7,38
90,Fail,55,21,4,10,45
90,Fail,49,22,0,14,35
90,Fail,49,23,2,14,35
90,Fail,46,27,4,11,35
90,Fail,55,23,3,11,44
90,Fail,45,33,0,15,30
90,Fail,44,25,10,9,35
90,Fail,46,27,0,12,34
90,Fail,45,30,0,15,30
90,Fail,49,26,3,9,40
90,Fail,52,26,2,8,44
90,Fail,45,22,2,21,24
90,Fail,50,22,2,14,36
90,Fail,42,32,0,14,28
90,Fail,46,27,3,14,32
90,Fail,48,24,8,13,35
90,Fail,51,20,3,15,36
90,Fail,56,23,0,7,49
90,Fail,47,28,2,13,34
90,Fail,51,29,0,10,41
90,Fail,49,35,0,8,41
90,Fail,44,34,0,13,31
90,Fail,54,22,0,13,41
90,Fail,53,23,2,12,41
90,Fail,50,35,0,8,42
90,Fail,50,29,0,11,39
90,Fail,53,25,0,11,42
90,Fail,49,25,7,11,38
90,Fail,48,32,0,11,37
90,Fail,40,29,1,17,23
90,Fail,44,19,11,16,28
90,Fail,52,23,0,16,36
90,Fail,47,31,0,11,36
90,Fail,44,36,0,11,33
90,Fail,57,17,0,11,46
90,Fail,53,27,0,11,42
90,Fail,49,26,0,14,35
90,Fail,44,28,4,12,32
90,Fail,46,25,2,11,35
90,Fail,47,31,0,15,32
90,Fail,50,25,0,17,33
90,Fail,46,24,7,13,33
90,Fail,52,30,0,9,43
90,Fail,44,32,0,12,32
90,Fail,53,19,0,16,37
90,Fail,43,32,0,12,31
90,Fail,40,33,4,10,30
90,Fail,48,27,2,11,37
90,Fail,43,29,3,13,30
90,Fail,50,26,6,8,42
90,Fail,53,24,2,9,44
90,Fail,44,26,11,12,32
90,Fail,50,29,0,12,38
90,Fail,48,29,6,9,39
90,Fail,54,18,0,14,40
90,Fail,42,31,4,12,30
90,Fail,51,32,0,9,42
90,Fail,49,31,2,12,37
90,Fail,43,27,3,18,25
90,Fail,49,27,9,8,41
90,Fail,47,22,4,16,31
90,Fail,43,29,1,15,28
90,Fail,55,18,4,12,43
90,Fail,54,21,4,11,43
90,Fail,42,31,0,12,30
90,Fail,47,29,0,12,35
90,Fail,44,28,5,12,32
90,Fail,49,31,0,9,40
90,Fail,52,23,0,11,41
90,Fail,52,22,3,11,41
90,Fail,50,25,2,7,43
90,Fail,47,27,5,11,36
90,Fail,42,28,7,8,34
90,Fail,52,26,0,9,43
90,Fail,50,23,0,17,33
90,Fail,46,31,5,10,36
90,Fail,54,18,3,12,42
90,Fail,39,23,14,14,25
90,Fail,47,24,2,14,33
90,Fail,48,29,0,14,34
90,Fail,49,26,2,13,36
90,Fail,57,18,0,11,46
90,Fail,48,17,5,18,30
90,Fail,56,19,0,14,42
90,Fail,47,31,2,11,36
90,Fail,50,19,10,9,41
90,Fail,49,22,2,12,37
90,Fail,47,31,0,14,33
90,Fail,44,39,0,10,34
90,Fail,48,27,0,15,33
90,Fail,54,25,0,10,44
90,Fail,48,19,4,21,27
90,Fail,51,31,0,6,45
90,Fail,38,31,0,23,15
90,Fail,47,23,7,13,34
90,Fail,47,35,0,12,35
90,Fail,49,22,4,11,38
90,Fail,48,30,2,8,40
90,Fail,44,38,0,12,32
90,Fail,47,24,1,18,29
90,Fail,42,26,4,17,25
90,Fail,59,19,0,13,46
90,Fail,46,37,0,8,38
90,Fail,51,34,0,4,47
90,Fail,53,24,0,12,41
90,Fail,42,27,5,18,24
90,Fail,43,33,0,16,27
90,Fail,49,27,3,11,38
90,Fail,40,27,8,14,26
90,Fail,43,36,0,10,33
90,Fail,45,27,0,17,28
90,Fail,47,26,0,17,30
90,Fail,49,30,4,7,42
90,Fail,43,25,8,13,30
90,Fail,46,30,5,9,37
90,Fail,51,22,7,7,44
90,Fail,50,24,3,12,38
90,Fail,39,31,3,17,22
90,Fail,48,33,0,11,37
90,Fail,47,32,0,12,35
90,Fail,44,36,0,7,37
90,Fail,47,19,1,19,28
90,Fail,55,25,0,11,44
90,Fail,51,20,2,17,34
90,Fail,48,36,0,11,37
90,Fail,46,27,0,13,33
90,Fail,48,31,0,8,40
90,Fail,48,25,1,15,33
90,Fail,51,21,4,15,36
90,Fail,54,19,3,13,41
90,Fail,52,27,0,7,45
90,Fail,52,24,3,6,46
90,Fail,48,29,0,11,37
90,Fail,50,21,5,13,37
90,Fail,38,36,0,17,21
90,Fail,48,23,3,15,33
90,Fail,42,27,7,16,26
90,Fail,51,28,0,12,39
90,Fail,50,29,4,8,42
90,Fail,52,21,3,14,38
90,Fail,51,21,0,19,32
90,Fail,46,21,9,16,30
90,Fail,47,31,0,13,34
90,Fail,52,24,0,16,36
90,Fail,50,24,0,13,37
90,Fail,47,38,0,9,38
90,Fail,49,35,0,4,45
90,Fail,50,26,0,13,37
90,Fail,50,22,0,17,33
90,Fail,53,27,1,8,45
90,Fail,43,28,5,15,28
90,Fail,43,24,4,18,25
90,Fail,48,21,3,16,32
90,Fail,48,26,6,12,36
90,Fail,46,28,0,10,36
90,Fail,45,36,0,12,33
90,Fail,47,22,0,17,30
90,Fail,46,32,2,10,36
90,Fail,49,19,0,18,31
90,Fail,49,31,0,11,38
90,Fail,47,21,8,9,38
90,Fail,53,21,1,11,42
90,Fail,46,33,0,12,34
90,Fail,49,26,0,12,37
90,Fail,47,30,0,15,32
90,Fail,36,36,7,15,21
90,Fail,47,31,0,12,35
90,Fail,55,19,1,12,43
90,Fail,56,21,0,10,46
90,Fail,37,41,0,16,21
90,Fail,45,25,0,21,24
90,Fail,47,32,0,9,38
90,Fail,50,28,0,13,37
90,Fail,40,30,0,22,18
90,Fail,52,22,2,12,40
90,Fail,46,20,1,15,31
90,Fail,46,28,0,15,31
90,Fail,49,31,0,8,41
90,Fail,43,27,3,19,24
90,Fail,49,27,3,14,35
90,Fail,40,36,0,12,28
90,Fail,47,27,4,13,34
90,Fail,47,32,3,8,39
90,Fail,52,32,1,5,47
90,Fail,57,18,0,11,46
90,Fail,52,30,0,6,46
90,Fail,49,28,0,16,33
90,Fail,52,23,1,11,41
90,Fail,53,15,1,12,41
90,Fail,57,18,0,12,45
90,Fail,46,30,0,15,31
90,Fail,49,27,0,17,32
90,Fail,44,31,0,13,31
90,Fail,43,28,2,13,30
90,Fail,50,31,1,7,43
90,Fail,47,28,6,10,37
90,Fail,45,30,1,11,34
90,Fail,55,26,0,9,46
90,Fail,45,27,0,17,28
90,Fail,50,21,3,13,37
90,Fail,54,27,0,4,50
90,Fail,53,24,2,10,43
90,Fail,53,19,1,15,38
90,Fail,52,27,0,14,38
90,Fail,60,17,3,10,50
90,Fail,47,32,0,13,34
90,Fail,52,24,2,10,42
90,Fail,57,17,4,10,47
90,Fail,47,28,1,8,39
90,Fail,44,32,0,13,31
90,Fail,47,27,6,15,32
90,Fail,44,32,0,14,30
90,Fail,55,18,0,16,39
90,Fail,52,23,1,10,42
90,Fail,46,29,1,13,33
90,Fail,53,25,2,10,43
90,Fail,51,20,6,12,39
90,Fail,53,20,0,12,41
90,Fail,52,23,1,9,43
90,Fail,48,29,3,7,41
90,Fail,57,28,0,7,50
90,Fail,47,32,0,11,36
90,Fail,46,25,2,17,29
90,Fail,53,24,0,10,43
90,Fail,53,15,8,11,42
90,Fail,48,27,0,15,33
90,Fail,39,34,0,19,20
90,Fail,52,20,2,16,36
90,Fail,43,29,3,16,27
90,Fail,50,24,0,12,38
90,Fail,52,23,0,15,37
90,Fail,50,20,7,15,35
90,Fail,49,28,3,11,38
90,Fail,49,25,0,12,37
90,Fail,47,23,4,15,32
90,Fail,53,28,0,10,43
90,Fail,41,33,0,15,26
90,Fail,46,29,0,17,29
90,Fail,45,24,4,16,29
90,Fail,57,21,3,8,49
90,Fail,50,21,5,13,37
90,Fail,46,32,0,10,36
90,Fail,46,30,0,13,33
90,Fail,53,23,0,10,43
90,Fail,46,34,0,8,38
90,Fail,41,34,5,11,30
90,Fail,50,32,0,7,43
90,Fail,49,29,7,8,41
90,Fail,49,29,0,16,33
90,Fail,45,26,0,15,30
90,Fail,42,31,0,19,23
90,Fail,52,26,0,14,38
90,Fail,44,26,3,14,30
90,Fail,44,22,6,17,27
90,Fail,43,30,0,20,23
90,Fail,41,29,8,12,29
90,Fail,52,26,2,8,44
90,Fail,47,23,2,16,31
90,Fail,47,25,1,17,30
90,Fail,49,19,8,15,34
90,Fail,56,13,7,14,42
90,Fail,48,29,1,13,35
90,Fail,48,34,0,12,36
90,Fail,43,26,3,15,28
90,Fail,47,20,8,13,34
90,Fail,54,25,0,9,45
90,Fail,44,36,2,11,33
90,Fail,39,27,3,21,18
90,Fail,46,25,3,13,33
90,Fail,52,22,8,8,44
90,Fail,42,30,10,9,33
90,Fail,47,19,0,18,29
90,Fail,46,23,11,12,34
90,Fail,48,20,3,19,29
90,Fail,50,23,4,13,37
90,Fail,56,20,4,8,48
90,Fail,47,33,0,15,32
90,Fail,45,30,0,15,30
90,Fail,49,27,0,10,39
90,Fail,49,26,0,10,39
90,Fail,47,28,1,14,33
90,Fail,53,20,0,13,40
90,Fail,56,24,0,10,46
90,Fail,44,28,0,17,27
90,Fail,45,31,5,9,36
90,Fail,48,27,3,10,38
90,Fail,45,28,0,15,30
90,Fail,43,26,0,20,23
90,Fail,48,26,6,15,33
90,Fail,49,31,0,12,37
90,Fail,51,23,0,16,35
90,Fail,46,28,0,14,32
90,Fail,50,28,0,10,40
90,Fail,48,25,7,13,35
90,Fail,44,27,5,13,31
90,Fail,44,25,9,12,32
90,Fail,48,35,0,6,42
90,Fail,47,26,0,13,34
90,Fail,52,18,1,14,38
90,Fail,48,26,1,15,33
90,Fail,47,26,0,14,33
90,Fail,50,30,0,7,43
90,Fail,46,34,0,9,37
90,Fail,45,22,3,18,27
90,Fail,43,31,3,15,28
90,Fail,39,43,0,13,26
90,Fail,54,16,11,10,44
90,Fail,46,27,3,15,31
90,Fail,45,24,3,14,31
90,Fail,50,31,0,11,39
90,Fail,41,32,0,16,25
90,Fail,50,28,0,8,42
90,Fail,56,21,2,10,46
90,Fail,52,21,3,13,39
90,Fail,46,26,16,9,37
90,Fail,56,28,0,9,47
90,Fail,48,29,0,11,37
90,Fail,48,24,0,18,30
90,Fail,49,26,3,11,38
90,Fail,45,23,1,18,27
90,Fail,59,20,0,7,52
90,Fail,45,33,0,13,32
90,Fail,42,33,0,15,27
90,Fail,52,25,5,9,43
90,Fail,46,36,0,9,37
90,Fail,49,32,1,10,39
90,Fail,45,26,10,11,34
90,Fail,54,20,2,14,40
90,Fail,52,17,0,17,35
90,Fail,45,38,0,10,35
90,Fail,48,24,6,13,35
90,Fail,48,28,0,14,34
90,Fail,60,18,3,10,50
90,Fail,44,31,3,11,33
90,Fail,46,31,0,14,32
90,Fail,55,19,3,12,43
90,Fail,51,33,0,8,43
90,Fail,53,21,1,13,40
90,Fail,51,21,5,14,37
90,Fail,52,26,1,11,41
90,Fail,41,23,9,12,29
90,Fail,48,22,8,17,31
90,Fail,44,29,0,16,28
90,Fail,48,25,0,17,31
90,Fail,45,28,6,10,35
90,Fail,47,24,1,15,32
90,Fail,46,27,0,17,29
90,Fail,46,28,0,17,29
90,Fail,52,28,2,7,45
90,Fail,49,23,9,9,40
90,Fail,41,33,3,15,26
90,Fail,51,25,6,9,42
90,Fail,44,26,0,20,24
90,Fail,46,29,1,10,36
90,Fail,42,27,10,15,27
90,Fail,49,31,0,13,36
90,Fail,49,33,0,5,44
90,Fail,53,24,4,6,47
90,Fail,41,28,8,13,28
90,Fail,46,25,0,15,31
90,Fail,46,21,6,17,29
90,Fail,47,22,3,18,29
90,Fail,39,37,0,12,27
90,Fail,45,22,3,15,30
90,Fail,49,23,4,15,34
90,Fail,45,25,3,14,31
90,Fail,49,26,0,15,34
90,Fail,41,33,0,12,29
90,Fail,48,25,1,10,38
90,Fail,43,34,0,12,31
90,Fail,47,27,6,12,35
90,Fail,40,28,0,19,21
90,Fail,53,20,5,11,42
90,Fail,55,29,0,7,48
90,Fail,43,39,0,7,36
90,Fail,46,28,6,13,33
90,Fail,45,25,0,18,27
90,Fail,50,28,2,14,36
90,Fail,44,36,0,12,32
90,Fail,47,25,0,17,30
90,Fail,53,23,0,15,38
90,Fail,52,24,3,11,41
90,Fail,42,20,4,18,24
90,Fail,49,34,0,6,43
90,Fail,43,30,1,17,26
90,Fail,51,22,8,11,40
90,Fail,48,24,2,13,35
90,Fail,45,26,10,15,30
90,Fail,47,35,0,9,38
90,Fail,53,26,0,10,43
90,Fail,59,20,0,9,50
90,Fail,42,32,0,14,28
90,Fail,49,25,2,11,38
90,Fail,49,24,2,12,37
90,Fail,51,29,0,8,43
90,Fail,47,33,0,6,41
90,Fail,45,25,9,12,33
90,Fail,47,33,0,9,38
90,Fail,55,24,3,9,46
90,Fail,46,29,0,13,33
90,Fail,55,20,2,10,45
90,Fail,53,27,0,7,46
90,Fail,45,26,0,18,27
90,Fail,42,28,2,17,25
90,Fail,48,26,0,18,30
90,Fail,47,25,1,15,32
90,Fail,51,23,6,10,41
90,Fail,45,19,9,13,32
90,Fail,56,17,0,18,38
90,Fail,50,31,2,6,44
90,Fail,51,32,0,8,43
90,Fail,44,23,12,11,33
90,Fail,56,23,1,9,47
90,Fail,44,39,0,13,31
90,Fail,52,26,3,7,45
90,Fail,53,17,1,16,37
90,Fail,55,26,0,12,43
90,Fail,47,31,0,14,33
90,Fail,45,35,0,10,35
90,Fail,46,30,0,13,33
90,Fail,50,21,0,13,37
90,Fail,48,23,0,18,30
90,Fail,56,26,0,9,47
90,Fail,51,24,2,14,37
90,Fail,54,20,2,8,46
90,Fail,46,29,7,10,36
90,Fail,45,30,0,18,27
90,Fail,48,20,3,12,36
90,Fail,48,30,0,12,36
90,Fail,51,29,0,11,40
90,Fail,47,30,3,11,36
90,Fail,48,23,9,11,37
90,Fail,52,21,0,15,37
90,Fail,45,27,3,15,30
90,Fail,43,33,2,10,33
90,Fail,53,26,0,9,44
90,Fail,48,38,0,9,39
90,Fail,50,23,0,17,33
90,Fail,42,36,0,14,28
90,Fail,56,20,0,13,43
90,Fail,49,29,0,11,38
90,Fail,43,33,2,9,34
90,Fail,53,28,1,9,44
90,Fail,45,30,0,15,30
90,Fail,50,24,1,13,37
90,Fail,46,28,1,12,34
90,Fail,48,21,1,16,32
90,Fail,45,37,0,10,35
90,Fail,48,21,3,15,33
90,Fail,54,24,4,5,49
90,Fail,43,38,0,12,31
90,Fail,49,22,1,16,33
90,Fail,52,23,3,13,39
90,Fail,49,36,0,8,41
90,Fail,47,32,0,11,36
90,Fail,52,29,0,10,42
90,Fail,47,26,9,12,35
90,Fail,52,19,2,18,34
90,Fail,52,21,9,12,40
90,Fail,43,34,0,15,28
90,Fail,44,32,0,13,31
90,Fail,49,24,7,12,37
90,Fail,47,29,0,12,35
90,Fail,48,26,0,14,34
90,Fail,43,21,8,21,22
90,Fail,52,24,0,14,38
90,Fail,47,21,3,16,31
90,Fail,52,23,4,8,44
90,Fail,52,17,4,17,35
90,Fail,39,35,0,18,21
90,Fail,48,26,3,14,34
90,Fail,41,31,3,15,26
90,Fail,44,29,7,10,34
90,Fail,50,27,5,12,38
90,Fail,45,27,1,16,29
90,Fail,49,29,0,14,35
90,Fail,53,20,0,14,39
90,Fail,49,23,4,15,34
90,Fail,52,20,2,13,39
90,Fail,44,29,9,7,37
90,Fail,52,20,8,8,44
90,Fail,47,31,1,9,38
90,Fail,52,26,0,11,41
90,Fail,47,23,0,14,33
90,Fail,51,27,0,12,39
90,Fail,53,19,2,13,40
90,Fail,42,29,0,13,29
90,Fail,50,23,0,15,35
90,Fail,47,20,10,14,33
90,Fail,56,24,0,9,47
90,Fail,40,30,2,14,26
90,Fail,50,27,4,9,41
90,Fail,43,32,4,14,29
90,Fail,50,31,0,6,44
90,Fail,56,23,1,8,48
90,Fail,52,29,0,9,43
90,Fail,48,29,0,11,37
90,Fail,40,27,5,21,19
90,Fail,42,27,2,19,23
90,Fail,54,28,1,6,48
90,Fail,49,25,0,14,35
90,Fail,42,27,4,17,25
90,Fail,49,34,0,9,40
90,Fail,56,18,0,16,40
90,Fail,49,27,0,11,38
90,Fail,49,30,3,10,39
90,Fail,48,29,0,13,35
90,Fail,47,24,4,13,34
90,Fail,50,27,0,14,36
90,Fail,33,47,0,10,23
90,Fail,49,28,0,11,38
90,Fail,54,24,0,7,47
90,Fail,50,30,0,12,38
90,Fail,45,32,0,10,35
90,Fail,50,25,0,14,36
90,Fail,47,27,0,14,33
90,Fail,49,27,0,10,39
90,Fail,52,25,0,10,42
90,Fail,50,26,0,14,36
90,Fail,54,29,0,8,46
90,Fail,49,26,0,13,36
90,Fail,41,46,0,6,35
90,Fail,52,18,4,15,37
90,Fail,49,28,0,11,38
90,Fail,42,31,0,13,29
90,Fail,46,20,1,22,24
90,Fail,49,30,0,11,38
90,Fail,54,26,3,2,52
90,Fail,37,24,6,20,17
90,Fail,49,30,0,7,42
90,Fail,48,25,1,17,31
90,Fail,45,29,0,13,32
90,Fail,54,20,2,9,45
90,Fail,58,20,2,9,49
90,Fail,48,31,4,9,39
90,Fail,40,35,0,12,28
90,Fail,47,24,6,15,32
90,Fail,43,30,10,10,33
90,Fail,43,29,2,14,29
90,Fail,47,30,0,12,35
90,Fail,52,27,0,9,43
90,Fail,52,30,0,10,42
90,Fail,52,25,1,8,44
90,Fail,55,30,0,6,49
90,Fail,49,22,7,14,35
90,Fail,45,25,9,14,31
90,Fail,49,23,0,17,32
90,Fail,57,24,0,9,48
90,Fail,45,27,2,14,31
90,Fail,49,28,6,11,38
90,Fail,53,20,0,15,38
90,Fail,50,21,0,15,35
90,Fail,44,23,10,13,31
90,Fail,53,24,3,10,43
90,Fail,43,33,7,12,31
90,Fail,48,28,0,12,36
90,Fail,45,28,2,14,31
90,Fail,50,29,6,8,42
90,Fail,47,29,0,12,35
90,Fail,46,20,7,17,29
90,Fail,46,34,0,11,35
90,Fail,50,21,4,15,35
90,Fail,52,25,1,13,39
90,Fail,48,24,3,17,31
90,Fail,48,32,0,12,36
90,Fail,52,27,4,8,44
90,Fail,48,23,5,14,34
90,Fail,48,28,0,12,36
90,Fail,52,21,0,14,38
90,Fail,43,34,0,15,28
90,Fail,50,25,0,12,38
90,Fail,49,27,0,16,33
90,Fail,47,34,0,8,39
90,Fail,50,26,0,9,41
90,Fail,56,21,0,13,43
90,Fail,49,32,0,11,38
90,Fail,52,23,3,13,39
90,Fail,50,28,0,11,39
90,Fail,50,23,0,14,36
90,Fail,52,24,7,9,43
90,Fail,50,25,0,15,35
90,Fail,49,28,0,13,36
90,Fail,48,32,0,10,38
90,Fail,47,27,0,11,36
90,Fail,38,26,6,19,19
90,Fail,54,27,2,8,46
90,Fail,53,21,0,13,40
90,Fail,45,32,0,14,31
90,Fail,48,25,4,13,35
90,Fail,60,19,0,13,47
90,Fail,46,36,0,12,34
90,Fail,52,19,5,13,39
90,Fail,48,27,3,13,35
90,Fail,45,26,1,15,30
90,Fail,44,34,0,13,31
90,Fail,46,33,0,13,33
90,Fail,42,39,0,10,32
90,Fail,48,31,0,10,38
90,Fail,47,25,7,15,32
90,Fail,50,27,4,9,41
90,Fail,48,28,0,9,39
90,Fail,52,27,0,12,40
90,Fail,46,27,2,13,33
90,Fail,50,28,0,9,41
90,Fail,49,33,0,11,38
90,Fail,52,28,0,8,44
90,Fail,54,19,4,12,42
90,Fail,51,28,0,11,40
90,Fail,49,26,9,5,44
90,Fail,36,42,0,13,23
90,Fail,50,24,0,16,34
90,Fail,49,24,0,13,36
90,Fail,54,15,3,13,41
90,Fail,48,32,0,10,38
90,Fail,45,26,3,10,35
90,Fail,48,28,5,9,39
90,Fail,40,29,2,20,20
90,Fail,50,26,0,11,39
90,Fail,45,30,0,12,33
90,Fail,51,31,0,8,43
90,Fail,50,35,0,7,43
90,Fail,49,27,5,12,37
90,Fail,46,35,0,8,38
90,Fail,50,29,0,13,37
90,Fail,45,37,0,8,37
90,Fail,51,31,0,10,41
90,Fail,56,26,0,8,48
90,Fail,43,27,6,15,28
90,Fail,49,26,0,11,38
90,Fail,55,28,0,6,49
90,Fail,42,29,7,13,29
90,Fail,45,29,2,15,30
90,Fail,44,37,0,9,35
90,Fail,50,22,0,15,35
90,Fail,51,26,0,8,43
90,Fail,47,29,0,13,34
90,Fail,36,39,0,14,22
90,Fail,48,18,3,15,33
90,Fail,52,28,0,12,40
90,Fail,42,24,5,20,22
90,Fail,47,33,0,10,37
90,Fail,50,30,0,9,41
90,Fail,46,23,8,12,34
90,Fail,42,36,0,12,30
90,Fail,52,23,1,10,42
90,Fail,49,26,3,13,36
90,Fail,56,23,1,8,48
90,Fail,47,32,0,12,35
90,Fail,45,27,6,14,31
90,Fail,44,28,8,12,32
90,Fail,45,19,6,18,27
90,Fail,52,25,3,9,43
90,Fail,59,18,0,12,47
90,Fail,48,35,0,7,41
90,Fail,45,33,0,10,35
90,Fail,50,28,1,8,42
90,Fail,48,34,0,9,39
90,Fail,48,26,8,10,38
90,Fail,49,24,0,19,30
90,Fail,51,28,0,11,40
90,Fail,47,25,3,9,38
90,Fail,47,30,2,9,38
90,Fail,56,20,2,12,44
90,Fail,48,20,1,16,32
90,Fail,50,25,2,11,39
90,Fail,44,35,0,14,30
90,Fail,51,23,2,17,34
90,Fail,46,31,0,13,33
90,Fail,48,27,0,9,39
90,Fail,41,37,0,13,28
90,Fail,54,26,0,9,45
90,Fail,51,27,0,12,39
90,Fail,50,21,6,9,41
90,Fail,48,27,0,13,35
90,Fail,50,21,12,9,41
90,Fail,54,23,0,12,42
90,Fail,55,19,0,14,41
90,Fail,48,26,0,13,35
90,Fail,51,23,5,11,40
90,Fail,51,26,2,8,43
90,Fail,46,31,3,9,37
90,Fail,50,24,0,17,33
90,Fail,44,22,0,20,24
90,Fail,42,33,5,13,29
90,Fail,46,30,2,10,36
90,Fail,53,25,0,14,39
90,Fail,46,31,0,12,34
90,Fail,47,28,0,16,31
90,Fail,47,29,0,15,32
90,Fail,47,24,0,18,29
90,Fail,47,30,0,15,32
90,Fail,53,25,9,6,47
90,Fail,51,32,0,6,45
90,Fail,40,33,1,11,29
90,Fail,64,13,1,12,52
90,Fail,56,18,0,12,44
90,Fail,47,21,0,19,28
90,Fail,55,14,4,15,40
90,Fail,48,24,5,12,36
90,Fail,44,30,0,16,28
90,Fail,51,25,0,12,39
90,Fail,54,28,0,11,43
90,Fail,48,26,3,12,36
90,Fail,44,25,7,14,30
90,Fail,54,22,3,11,43
90,Fail,44,31,2,11,33
90,Fail,50,22,2,16,34
90,Fail,51,27,0,9,42
90,Fail,57,24,4,10,47
90,Fail,53,19,3,16,37
90,Fail,53,15,1,16,37
90,Fail,42,23,14,11,31
90,Fail,52,26,5,7,45
90,Fail,42,26,0,22,20
90,Fail,50,30,0,12,38
90,Fail,51,18,5,14,37
90,Fail,54,19,0,13,41
90,Fail,40,42,0,11,29
90,Fail,52,22,2,13,39
90,Fail,41,30,0,18,23
90,Fail,54,32,0,7,47
90,Fail,43,29,3,15,28
90,Fail,56,19,4,10,46
90,Fail,56,20,0,12,44
90,Fail,48,33,0,11,37
90,Fail,48,29,0,14,34
90,Fail,43,30,0,20,23
90,Fail,51,24,0,16,35
90,Fail,56,22,0,12,44
90,Fail,51,21,5,16,35
90,Fail,49,24,3,12,37
90,Fail,36,40,0,17,19
90,Fail,50,20,4,14,36
90,Fail,50,29,0,8,42
90,Fail,52,29,0,9,43
90,Fail,52,23,8,9,43
90,Fail,46,29,4,10,36
90,Fail,50,22,0,17,33
90,Fail,45,23,9,11,34
90,Fail,50,27,0,15,35
90,Fail,54,22,0,12,42
90,Fail,54,20,0,12,42
90,Fail,45,25,6,15,30
90,Fail,49,30,0,9,40
90,Fail,48,26,1,12,36
90,Fail,38,41,0,15,23
90,Fail,49,25,5,12,37
90,Fail,46,30,3,11,35
90,Fail,43,36,0,16,27
90,Fail,57,17,0,15,42
90,Fail,51,27,0,12,39
90,Fail,49,28,0,10,39
90,Fail,46,30,0,11,35
90,Fail,47,25,0,20,27
90,Fail,42,26,0,21,21
90,Fail,42,28,5,14,28
90,Fail,53,19,0,13,40
90,Fail,50,28,0,9,41
90,Fail,48,28,0,9,39
90,Fail,50,26,0,14,36
90,Fail,51,20,0,16,35
90,Fail,52,26,1,10,42
90,Fail,46,22,5,18,28
90,Fail,54,19,1,16,38
90,Fail,60,24,3,2,58
90,Fail,54,27,0,6,48
90,Fail,53,25,0,15,38
90,Fail,40,36,7,11,29
90,Fail,43,23,3,19,24
90,Fail,47,32,0,15,32
90,Fail,51,26,0,10,41
90,Fail,47,26,4,12,35
90,Fail,55,16,0,15,40
90,Fail,46,36,0,8,38
90,Fail,48,28,0,10,38
90,Fail,49,23,7,12,37
90,Fail,44,35,0,10,34
90,Fail,58,18,0,14,44
90,Fail,51,30,0,10,41
90,Fail,50,32,0,12,38
90,Fail,51,28,0,12,39
90,Fail,49,22,10,9,40
90,Fail,48,31,5,11,37
90,Fail,49,26,0,17,32
90,Fail,47,29,0,14,33
90,Fail,43,27,5,20,23
90,Fail,51,26,1,15,36
90,Fail,54,23,1,11,43
90,Fail,50,28,2,6,44
90,Fail,43,41,0,10,33
90,Fail,52,22,0,14,38
90,Fail,41,27,7,17,24
90,Fail,47,35,0,9,38
90,Fail,52,19,0,14,38
90,Fail,49,23,6,12,37
90,Fail,52,28,0,9,43
90,Fail,42,31,0,16,26
90,Fail,50,22,3,14,36
90,Fail,46,20,9,15,31
90,Fail,50,38,0,9,41
90,Fail,47,33,0,11,36
90,Fail,47,34,0,9,38
90,Fail,42,27,0,20,22
90,Fail,49,18,0,20,29
90,Fail,47,32,0,15,32
90,Fail,47,30,0,15,32
90,Fail,41,23,7,18,23
90,Fail,53,22,0,13,40
90,Fail,46,27,2,14,32
90,Fail,46,31,0,15,31
90,Fail,48,27,0,12,36
90,Fail,40,28,0,18,22
90,Fail,47,36,0,10,37
90,Fail,31,38,10,10,21
90,Fail,54,23,0,11,43
90,Fail,52,23,0,15,37
90,Fail,47,26,2,13,34
90,Fail,54,24,0,11,43
90,Fail,52,17,10,11,41
90,Fail,41,37,0,12,29
90,Fail,47,26,0,17,30
90,Fail,56,23,0,9,47
90,Fail,44,28,4,13,31
90,Fail,53,23,0,9,44
90,Fail,49,23,3,14,35
90,Fail,44,28,3,15,29
90,Fail,45,33,0,11,34
90,Fail,56,26,0,5,51
90,Fail,50,25,4,8,42
90,Fail,44,32,0,14,30
90,Fail,40,29,0,20,20
90,Fail,53,27,0,12,41
90,Fail,46,26,0,18,28
90,Fail,46,35,0,9,37
90,Fail,53,26,1,6,47
90,Fail,43,29,1,18,25
90,Fail,56,26,0,13,43
90,Fail,54,26,4,7,47
90,Fail,59,19,4,5,54
90,Fail,47,28,0,13,34
90,Fail,50,27,2,10,40
90,Fail,43,32,3,11,32
90,Fail,47,28,3,10,37
90,Fail,46,31,1,11,35
90,Fail,48,37,0,5,43
90,Fail,51,21,0,15,36
90,Fail,49,25,3,11,38
90,Fail,48,33,0,11,37
90,Fail,49,28,0,10,39
90,Fail,48,26,4,13,35
90,Fail,54,21,0,12,42
90,Fail,39,33,0,21,18
90,Fail,46,28,7,9,37
90,Fail,46,36,0,9,37
90,Fail,48,31,0,10,38
90,Fail,49,24,3,13,36
90,Fail,46,35,0,11,35
90,Fail,39,31,10,11,28
90,Fail,50,26,2,11,39
90,Fail,39,27,8,17,22
90,Fail,47,30,2,10,37
90,Fail,46,31,0,12,34
90,Fail,46,21,0,16,30
90,Fail,43,25,6,19,24
90,Fail,40,24,6,17,23
90,Fail,53,28,0,11,42
90,Fail,55,20,0,15,40
90,Fail,49,29,3,10,39
90,Fail,49,23,3,15,34
90,Fail,48,28,0,10,38
90,Fail,54,23,2,10,44
90,Fail,46,20,4,19,27
90,Fail,56,31,0,4,52
90,Fail,47,23,5,14,33
90,Fail,44,36,0,13,31
90,Fail,43,34,0,13,30
90,Fail,46,27,12,6,40
90,Fail,48,26,0,14,34
90,Fail,45,23,7,10,35
90,Fail,40,25,9,17,23
90,Fail,53,23,5,11,42
90,Fail,52,30,3,5,47
90,Fail,46,30,3,12,34
90,Fail,60,20,2,8,52
90,Fail,59,20,0,8,51
90,Fail,51,27,0,11,40
90,Fail,50,32,0,9,41
90,Fail,51,21,0,14,37
90,Fail,48,23,5,13,35
90,Fail,59,15,1,11,48
90,Fail,47,25,1,16,31
90,Fail,42,38,0,12,30
90,Fail,40,32,0,16,24
90,Fail,49,26,0,11,38
90,Fail,44,33,0,12,32
90,Fail,50,24,0,14,36
90,Fail,52,27,0,14,38
90,Fail,54,22,3,11,43
90,Fail,43,27,0,18,25
90,Fail,43,35,0,14,29
90,Fail,47,29,0,11,36
90,Fail,51,30,0,8,43
90,Fail,47,26,4,12,35
90,Fail,45,27,0,17,28
90,Fail,46,33,0,11,35
90,Fail,46,32,0,13,33
90,Fail,43,35,0,14,29
90,Fail,39,36,0,16,23
90,Fail,46,29,0,14,32
90,Fail,52,27,0,11,41
90,Fail,42,36,0,11,31
90,Fail,46,27,1,12,34
90,Fail,54,25,0,10,44
90,Fail,55,25,4,7,48
90,Fail,55,13,3,16,39
90,Fail,52,28,0,8,44
90,Fail,55,22,0,9,46
90,Fail,48,28,0,14,34
90,Fail,43,37,0,7,36
90,Fail,51,26,6,8,43
90,Fail,45,28,1,13,32
90,Fail,40,34,0,16,24
90,Fail,57,18,2,12,45
90,Fail,52,23,10,8,44
90,Fail,52,24,3,12,40
90,Fail,57,24,2,9,48
90,Fail,42,31,9,7,35
90,Fail,49,24,7,11,38
90,Fail,53,24,0,11,42
90,Fail,48,28,0,12,36
90,Fail,39,21,8,21,18
90,Fail,43,33,0,13,30
90,Fail,46,34,0,11,35
90,Fail,57,21,0,11,46
90,Fail,45,31,0,14,31
90,Fail,39,24,8,16,23
90,Fail,44,30,7,9,35
90,Fail,48,28,5,10,38
90,Fail,60,17,0,8,52
90,Fail,41,29,11,16,25
90,Fail,42,29,8,13,29
90,Fail,45,33,0,8,37
90,Fail,47,25,0,14,33
90,Fail,45,29,5,14,31
90,Fail,50,25,0,9,41
90,Fail,44,28,3,16,28
90,Fail,44,30,3,10,34
90,Fail,46,26,0,15,31
90,Fail,47,30,0,14,33
90,Fail,48,28,0,12,36
90,Fail,43,28,1,15,28
90,Fail,42,24,4,16,26
90,Fail,46,31,2,11,35
90,Fail,45,33,0,12,33
90,Fail,49,32,0,8,41
90,Fail,46,40,0,5,41
90,Fail,46,28,5,15,31
90,Fail,53,20,5,7,46
90,Fail,44,25,5,17,27
90,Fail,46,35,0,12,34
90,Fail,43,37,2,10,33
90,Fail,43,32,1,10,33
90,Fail,42,32,0,14,28
90,Fail,48,26,1,15,33
90,Fail,52,24,2,11,41
90,Fail,47,23,3,15,32
90,Fail,45,24,5,14,31
90,Fail,42,29,3,15,27
90,Fail,42,27,6,17,25
90,Fail,43,24,8,16,27
90,Fail,52,30,0,8,44
90,Fail,44,38,0,8,36
90,Fail,56,19,0,13,43
90,Fail,48,29,1,11,37
90,Fail,44,29,0,13,31
90,Fail,50,24,0,15,35
90,Fail,48,23,0,15,33
90,Fail,51,28,0,9,42
90,Fail,51,21,0,13,38
90,Fail,54,24,1,8,46
90,Fail,43,29,5,16,27
90,Fail,56,26,0,12,44
90,Fail,48,32,0,10,38
90,Fail,41,34,0,16,25
90,Fail,50,26,3,12,38
90,Fail,52,26,0,9,43
90,Fail,52,29,3,11,41
90,Fail,48,40,0,6,42
90,Fail,51,21,3,10,41
90,Fail,47,23,4,14,33
90,Fail,55,22,0,11,44
90,Fail,43,33,0,9,34
90,Fail,50,27,0,11,39
90,Fail,54,29,0,8,46
90,Fail,37,34,0,14,23
90,Fail,49,28,2,11,38
90,Fail,44,30,0,14,30
90,Fail,52,21,5,12,40
90,Fail,49,24,2,17,32
90,Fail,46,26,2,17,29
90,Fail,60,16,0,13,47
90,Fail,48,28,0,13,35
90,Fail,45,19,6,19,26
90,Fail,47,29,0,14,33
90,Fail,51,28,0,12,39
90,Fail,52,27,0,11,41
90,Fail,37,37,0,12,25
90,Fail,44,35,0,11,33
90,Fail,53,23,2,10,43
90,Fail,46,29,7,9,37
90,Fail,47,25,1,14,33
90,Fail,54,25,0,11,43
90,Fail,40,31,8,12,28
90,Fail,51,27,0,7,44
90,Fail,55,24,0,8,47
90,Fail,47,20,5,17,30
90,Fail,48,27,1,13,35
90,Fail,55,19,4,11,44
90,Fail,48,34,0,10,38
90,Fail,55,22,0,10,45
90,Fail,50,28,6,6,44
90,Fail,44,35,0,10,34
90,Fail,50,26,5,6,44
90,Fail,51,26,5,9,42
90,Fail,50,20,2,11,39
90,Fail,48,25,3,13,35
90,Fail,41,39,0,11,30
90,Fail,46,25,0,16,30
90,Fail,54,24,1,7,47
90,Fail,51,26,0,9,42
90,Fail,46,28,6,12,34
90,Fail,53,16,3,15,38
90,Fail,43,32,0,14,29
90,Fail,41,30,10,13,28
90,Fail,53,17,4,10,43
90,Fail,45,24,6,15,30
90,Fail,54,20,0,15,39
90,Fail,51,26,2,12,39
90,Fail,41,33,0,20,21
90,Fail,48,30,0,11,37
90,Fail,53,20,1,13,40
90,Fail,50,23,1,17,33
90,Fail,51,23,5,12,39
90,Fail,51,27,2,8,43
90,Fail,48,31,0,11,37
90,Fail,50,35,0,6,44
90,Fail,46,27,2,11,35
90,Fail,45,33,0,16,29
90,Fail,51,28,1,6,45
90,Fail,45,32,0,11,34
90,Fail,44,23,4,19,25
90,Fail,45,36,0,11,34
90,Fail,38,30,6,13,25
90,Fail,43,35,0,14,29
90,Fail,46,32,0,10,36
90,Fail,53,22,1,12,41
90,Fail,48,25,3,11,37
90,Fail,44,33,0,14,30
90,Fail,46,30,0,11,35
90,Fail,52,23,2,12,40
90,Fail,47,33,0,14,33
90,Fail,47,30,0,15,32
90,Fail,48,31,0,7,41
90,Fail,47,24,1,15,32
90,Fail,45,28,5,12,33
90,Fail,53,19,0,14,39
90,Fail,49,25,7,11,38
90,Fail,48,27,0,13,35
90,Fail,51,25,0,14,37
90,Fail,47,34,0,8,39
90,Fail,47,23,7,12,35
90,Fail,45,36,10,3,42
90,Fail,51,24,3,12,39
90,Fail,46,29,0,12,34
90,Fail,57,21,0,11,46
90,Fail,40,29,0,15,25
90,Fail,41,27,9,16,25
90,Fail,47,25,4,13,34
90,Fail,50,30,0,9,41
90,Fail,46,27,5,12,34
90,Fail,49,34,0,11,38
90,Fail,51,27,1,8,43
90,Fail,47,29,0,16,31
90,Fail,48,28,1,10,38
90,Fail,54,23,0,10,44
90,Fail,52,19,2,17,35
90,Fail,47,36,0,9,38
90,Fail,52,27,2,11,41
90,Fail,47,34,0,8,39
90,Fail,41,30,11,12,29
90,Fail,47,24,3,17,30
90,Fail,43,32,0,18,25
90,Fail,50,25,1,15,35
90,Fail,49,26,0,13,36
90,Fail,47,36,0,10,37
90,Fail,42,33,3,14,28
90,Fail,48,35,0,8,40
90,Fail,47,32,5,9,38
90,Fail,45,24,4,16,29
90,Fail,54,23,0,13,41
90,Fail,48,29,0,12,36
90,Fail,54,21,3,9,45
90,Fail,49,20,7,16,33
90,Fail,44,34,0,8,36
90,Fail,47,21,4,17,30
90,Fail,49,20,2,17,32
90,Fail,59,16,0,12,47
90,Fail,49,24,0,14,35
90,Fail,40,35,0,14,26
90,Fail,42,26,11,11,31
90,Fail,53,25,4,7,46
90,Fail,47,22,7,16,31
90,Fail,40,32,3,15,25
90,Fail,54,30,0,5,49
90,Fail,45,37,0,10,35
90,Fail,51,24,0,13,38
90,Fail,45,26,0,20,25
90,Fail,52,23,1,14,38
90,Fail,41,31,6,11,30
90,Fail,47,22,8,14,33
90,Fail,41,27,6,19,22
90,Fail,47,33,0,12,35
90,Fail,49,20,1,19,30
90,Fail,53,18,2,17,36
90,Fail,40,34,2,18,22
90,Fail,55,18,3,13,42
90,Fail,48,28,1,15,33
90,Fail,42,36,0,13,29
90,Fail,53,18,7,9,44
90,Fail,49,24,6,12,37
90,Fail,48,28,2,15,33
90,Fail,50,29,0,7,43
90,Fail,50,23,0,16,34
90,Fail,47,19,13,13,34
90,Fail,49,26,4,11,38
90,Fail,54,18,4,14,40
90,Fail,50,29,0,9,41
90,Fail,42,24,4,15,27
90,Fail,50,28,0,12,38
90,Fail,45,31,0,14,31
90,Fail,46,32,0,15,31
90,Fail,48,26,0,11,37
90,Fail,47,29,0,14,33
90,Fail,45,32,0,12,33
90,Fail,58,28,0,6,52
90,Fail,51,32,0,10,41
90,Fail,40,33,2,18,22
90,Fail,53,25,0,12,41
90,Fail,47,29,2,12,35
90,Fail,51,28,0,10,41
90,Fail,55,20,4,13,42
90,Fail,41,26,3,23,18
90,Fail,48,31,0,11,37
90,Fail,49,27,0,13,36
90,Fail,48,27,0,13,35
90,Fail,45,36,0,11,34
90,Fail,45,30,0,15,30
90,Fail,45,33,0,12,33
90,Fail,45,32,1,12,33
90,Fail,56,20,2,8,48
90,Fail,41,31,0,19,22
90,Fail,48,26,5,10,38
90,Fail,42,22,16,11,31
90,Fail,58,21,0,8,50
90,Fail,50,21,0,14,36
90,Fail,47,28,1,15,32
90,Fail,44,24,6,18,26
90,Fail,46,25,10,14,32
90,Fail,42,30,0,20,22
90,Fail,50,22,0,17,33
90,Fail,54,21,5,11,43
90,Fail,49,27,0,16,33
90,Fail,48,28,8,8,40
90,Fail,43,29,1,17,26
90,Fail,52,24,0,11,41
90,Fail,45,36,0,12,33
90,Fail,53,34,0,2,51
90,Fail,50,22,3,17,33
90,Fail,50,32,6,5,45
90,Fail,52,20,6,11,41
90,Fail,53,21,0,12,41
90,Fail,51,24,0,12,39
90,Fail,51,25,0,12,39
90,Fail,50,26,7,11,39
90,Fail,51,26,5,13,38
90,Fail,52,22,0,17,35
90,Fail,47,34,0,9,38
90,Fail,58,19,0,11,47
90,Fail,55,24,0,13,42
90,Fail,44,33,1,14,30
90,Fail,41,27,7,12,29
90,Fail,48,27,0,14,34
90,Fail,54,23,0,11,43
90,Fail,53,25,0,11,42
90,Fail,47,23,3,14,33
90,Fail,45,24,4,16,29
90,Fail,52,17,1,15,37
90,Fail,47,30,0,12,35
90,Fail,38,42,0,11,27
90,Fail,48,27,4,8,40
90,Fail,44,25,1,18,26
90,Fail,52,23,1,10,42
90,Fail,47,22,11,10,37
90,Fail,40,23,9,17,23
90,Fail,56,26,0,9,47
90,Fail,51,25,4,10,41
90,Fail,44,36,0,10,34
90,Fail,40,37,0,18,22
90,Fail,50,26,0,14,36
90,Fail,54,23,1,9,45
90,Fail,46,26,6,14,32
90,Fail,41,31,0,18,23
90,Fail,44,29,0,16,28
90,Fail,46,35,0,8,38
90,Fail,50,37,0,6,44
90,Fail,48,27,8,8,40
90,Fail,49,27,2,10,39
90,Fail,51,23,5,8,43
90,Fail,49,31,0,13,36
90,Fail,45,39,0,10,35
90,Fail,40,33,9,12,28
90,Fail,44,28,2,11,33
90,Fail,54,25,0,11,43
90,Fail,43,27,4,12,31
90,Fail,42,31,0,20,22
90,Fail,58,18,1,11,47
90,Fail,47,28,3,12,35
90,Fail,53,25,0,10,43
90,Fail,47,31,0,11,36
90,Fail,52,32,0,10,42
90,Fail,53,24,0,11,42
90,Fail,46,34,0,11,35
90,Fail,46,23,3,20,26
90,Fail,52,25,6,7,45
90,Fail,48,31,0,8,40
90,Fail,52,21,0,19,33
90,Fail,51,25,0,14,37
90,Fail,54,20,5,11,43
90,Fail,45,31,5,8,37
90,Fail,46,31,0,11,35
90,Fail,38,34,0,21,17
90,Fail,51,25,3,11,40
90,Fail,49,23,0,12,37
90,Fail,48,31,0,12,36
90,Fail,55,23,0,13,42
90,Fail,59,18,1,13,46
90,Fail,36,35,0,19,17
90,Fail,44,34,2,10,34
90,Fail,37,45,0,11,26
90,Fail,47,29,0,11,36
90,Fail,45,31,4,9,36
90,Fail,50,23,1,16,34
90,Fail,54,27,3,5,49
90,Fail,40,31,4,14,26
90,Fail,56,18,1,13,43
90,Fail,43,31,5,14,29
90,Fail,47,19,5,18,29
90,Fail,42,34,3,13,29
90,Fail,48,28,1,13,35
90,Fail,49,30,0,10,39
90,Fail,57,21,0,11,46
90,Fail,46,27,3,17,29
90,Fail,50,15,9,18,32
90,Fail,42,24,4,20,22
90,Fail,50,26,0,14,36
90,Fail,53,24,2,8,45
90,Fail,43,33,1,10,33
90,Fail,49,25,6,10,39
90,Fail,58,22,4,7,51
90,Fail,49,29,2,8,41
90,Fail,47,22,0,19,28
90,Fail,49,25,0,17,32
90,Fail,45,31,6,9,36
90,Fail,37,30,0,24,13
90,Fail,43,34,0,15,28
90,Fail,58,20,1,7,51
90,Fail,56,14,3,13,43
90,Fail,50,26,0,14,36
90,Fail,47,20,4,18,29
90,Fail,51,21,3,11,40
90,Fail,48,25,1,14,34
90,Fail,44,30,7,8,36
90,Fail,46,37,0,12,34
90,Fail,48,24,9,10,38
90,Fail,51,25,0,11,40
90,Fail,35,28,9,18,17
90,Fail,47,29,0,18,29
90,Fail,46,26,6,8,38
90,Fail,48,27,0,16,32
90,Fail,49,30,0,6,43
90,Fail,43,25,11,17,26
90,Fail,47,34,0,12,35
90,Fail,49,26,0,13,36
90,Fail,53,22,0,13,40
90,Fail,48,28,0,16,32
90,Fail,47,29,0,11,36
90,Fail,51,19,6,12,39
90,Fail,55,19,4,12,43
90,Fail,46,27,1,15,31
90,Fail,45,27,0,16,29
90,Fail,49,26,0,12,37
90,Fail,46,26,2,16,30
90,Fail,45,31,0,10,35
90,Fail,45,24,0,21,24
90,Fail,43,31,1,12,31
90,Fail,48,32,0,9,39
90,Fail,50,21,0,16,34
90,Fail,47,32,0,10,37
90,Fail,45,31,0,15,30
90,Fail,55,23,3,10,45
90,Fail,49,30,0,12,37
90,Fail,51,29,3,8,43
90,Fail,42,30,3,16,26
90,Fail,47,30,6,8,39
90,Fail,51,26,1,12,39
90,Fail,52,26,0,15,37
90,Fail,51,22,0,16,35
90,Fail,43,28,5,18,25
90,Fail,52,20,7,13,39
90,Fail,48,24,5,16,32
90,Fail,43,27,0,18,25
90,Fail,41,32,0,16,25
90,Fail,51,27,0,11,40
90,Fail,55,22,2,7,48
90,Fail,47,29,0,12,35
90,Fail,49,34,0,7,42
90,Fail,55,22,2,11,44
90,Fail,56,20,1,12,44
90,Fail,50,30,0,11,39
90,Fail,47,21,2,19,28
90,Fail,50,24,8,9,41
90,Fail,47,32,0,12,35
90,Fail,52,27,0,8,44
90,Fail,51,26,3,6,45
90,Fail,46,30,5,9,37
90,Fail,40,30,4,16,24
90,Fail,44,33,0,16,28
90,Fail,46,25,7,10,36
90,Fail,56,25,0,11,45
90,Fail,46,32,0,7,39
90,Fail,36,32,4,17,19
90,Fail,47,19,5,16,31
90,Fail,49,17,8,19,30
90,Fail,49,31,1,9,40
90,Fail,54,20,0,11,43
90,Fail,50,22,0,17,33
90,Fail,49,24,4,11,38
90,Fail,49,22,7,16,33
90,Fail,50,28,0,12,38
90,Fail,58,18,0,12,46
90,Fail,43,31,0,20,23
90,Fail,44,25,10,11,33
90,Fail,49,24,0,12,37
90,Fail,51,28,0,12,39
90,Fail,48,26,0,17,31
90,Fail,56,24,0,12,44
90,Fail,38,28,13,14,24
90,Fail,41,33,2,14,27
90,Fail,46,28,0,16,30
90,Fail,53,23,0,8,45
90,Fail,49,29,0,11,38
90,Fail,44,27,4,15,29
90,Fail,49,25,1,13,36
90,Fail,50,18,4,17,33
90,Fail,42,33,9,9,33
90,Fail,48,33,0,12,36
90,Fail,50,20,1,15,35
90,Fail,55,31,0,7,48
90,Fail,52,17,0,19,33
90,Fail,43,34,0,12,31
90,Fail,47,20,2,17,30
90,Fail,42,36,0,14,28
90,Fail,52,21,2,11,41
90,Fail,45,31,0,17,28
90,Fail,55,21,0,14,41
90,Fail,47,28,0,13,34
90,Fail,43,25,0,19,24
90,Fail,49,24,4,12,37
90,Fail,42,35,3,15,27
90,Fail,45,25,7,14,31
90,Fail,51,27,0,15,36
90,Fail,41,34,3,10,31
90,Fail,43,28,2,17,26
90,Fail,45,30,5,12,33
90,Fail,48,24,7,10,38
90,Fail,50,24,0,14,36
90,Fail,44,35,0,13,31
90,Fail,44,22,15,13,31
90,Fail,38,37,0,11,27
90,Fail,47,25,0,14,33
90,Fail,54,22,2,10,44
90,Fail,44,25,0,15,29
90,Fail,56,20,1,11,45
90,Fail,48,25,11,11,37
90,Fail,47,26,0,18,29
90,Fail,44,29,3,14,30
90,Fail,51,23,0,12,39
90,Fail,46,29,0,10,36
90,Fail,48,27,6,12,36
90,Fail,50,25,8,8,42
90,Fail,57,21,1,11,46
90,Fail,51,22,0,10,41
90,Fail,57,17,2,12,45
90,Fail,50,21,1,15,35
90,Fail,47,28,6,12,35
90,Fail,49,28,0,11,38
90,Fail,46,30,0,13,33
90,Fail,44,38,0,12,32
90,Fail,46,18,7,15,31
90,Fail,58,20,2,9,49
90,Fail,42,32,3,14,28
90,Fail,43,32,0,9,34
90,Fail,44,30,0,16,28
90,Fail,49,27,1,13,36
90,Fail,52,23,6,9,43
90,Fail,53,22,0,16,37
90,Fail,48,25,5,13,35
90,Fail,44,28,0,14,30
90,Fail,49,24,6,10,39
90,Fail,42,28,6,15,27
90,Fail,50,19,2,16,34
90,Fail,41,29,8,14,27
90,Fail,56,13,2,15,41
90,Fail,54,28,0,11,43
90,Fail,43,28,0,16,27
90,Fail,47,35,0,8,39
90,Fail,50,30,1,8,42
90,Fail,49,26,0,16,33
90,Fail,41,38,0,11,30
90,Fail,44,27,3,12,32
90,Fail,52,18,0,15,37
90,Fail,49,25,5,9,40
90,Fail,43,29,0,20,23
90,Fail,52,28,0,11,41
90,Fail,52,28,0,10,42
90,Fail,49,28,2,13,36
90,Fail,44,31,0,13,31
90,Fail,43,32,0,16,27
90,Fail,45,28,0,15,30
90,Fail,48,34,0,12,36
90,Fail,48,33,0,10,38
90,Fail,44,25,11,12,32
90,Fail,43,30,7,12,31
90,Fail,47,21,4,20,27
90,Fail,51,23,0,13,38
90,Fail,47,35,0,14,33
90,Fail,43,21,11,14,29
90,Fail,53,21,0,14,39
90,Fail,52,31,0,7,45
90,Fail,39,32,0,20,19
90,Fail,56,21,0,17,39
90,Fail,40,28,10,16,24
90,Fail,40,28,9,17,23
90,Fail,45,27,1,16,29
90,Fail,56,23,0,10,46
90,Fail,48,28,0,15,33
90,Fail,53,26,0,13,40
90,Fail,53,22,3,12,41
90,Fail,49,27,0,13,36
90,Fail,49,24,3,12,37
90,Fail,41,25,6,21,20
90,Fail,50,15,11,14,36
90,Fail,46,29,0,14,32
90,Fail,43,28,4,17,26
90,Fail,47,27,2,14,33
90,Fail,46,31,7,8,38
90,Fail,52,26,0,8,44
90,Fail,42,35,0,12,30
90,Fail,51,28,0,12,39
90,Fail,40,35,0,13,27
90,Fail,48,32,0,10,38
90,Fail,50,28,2,13,37
90,Fail,45,34,0,11,34
90,Fail,42,31,0,13,29
90,Fail,51,24,0,13,38
90,Fail,41,25,8,15,26
90,Fail,46,32,0,14,32
90,Fail,51,27,0,11,40
90,Fail,49,30,0,10,39
90,Fail,49,30,1,10,39
90,Fail,45,24,6,14,31
90,Fail,41,31,0,18,23
90,Fail,51,32,0,9,42
90,Fail,51,22,1,14,37
90,Fail,42,28,0,17,25
90,Fail,48,29,0,15,33
90,Fail,52,22,0,12,40
90,Fail,60,24,0,8,52
90,Fail,50,33,0,6,44
90,Fail,53,19,0,20,33
90,Fail,51,18,4,16,35
90,Fail,39,42,0,15,24
90,Fail,56,23,0,9,47
90,Fail,49,23,5,13,36
90,Fail,49,25,3,12,37
90,Fail,44,25,15,13,31
90,Fail,48,32,0,10,38
90,Fail,51,26,0,12,39
90,Fail,42,28,5,14,28
90,Fail,44,22,5,20,24
90,Fail,50,19,0,18,32
90,Fail,44,31,0,16,28
90,Fail,48,28,2,10,38
90,Fail,50,25,0,14,36
90,Fail,45,27,4,17,28
90,Fail,47,20,1,18,29
90,Fail,49,26,5,10,39
90,Fail,46,20,1,21,25
90,Fail,48,21,10,13,35
90,Fail,41,40,0,15,26
90,Fail,49,34,1,6,43
90,Fail,46,24,7,14,32
90,Fail,49,28,1,12,37
90,Fail,54,22,0,8,46
90,Fail,48,23,5,15,33
90,Fail,49,22,3,15,34
90,Fail,45,29,0,12,33
90,Fail,45,35,1,9,36
90,Fail,50,26,0,13,37
90,Fail,41,33,1,13,28
90,Fail,51,31,0,10,41
90,Fail,37,38,0,11,26
90,Fail,55,22,0,8,47
90,Fail,49,29,0,14,35
90,Fail,56,20,1,11,45
90,Fail,47,29,0,14,33
90,Fail,42,28,3,15,27
90,Fail,47,30,0,13,34
90,Fail,53,23,5,8,45
90,Fail,51,28,0,10,41
90,Fail,44,30,0,16,28
90,Fail,54,21,0,11,43
90,Fail,47,27,0,16,31
90,Fail,41,36,0,12,29
90,Fail,44,28,8,9,35
90,Fail,48,20,3,15,33
90,Fail,47,32,2,13,34
90,Fail,41,29,5,12,29
90,Fail,50,35,0,7,43
90,Fail,50,27,0,11,39
90,Fail,37,26,11,16,21
90,Fail,44,32,4,11,33
90,Fail,49,23,6,14,35
90,Fail,41,30,2,18,23
90,Fail,47,25,10,10,37
90,Fail,44,25,2,15,29
90,Fail,47,29,0,12,35
90,Fail,38,35,0,17,21
90,Fail,52,28,0,9,43
90,Fail,43,40,0,8,35
90,Fail,50,25,0,12,38
90,Fail,35,29,4,18,17
90,Fail,49,24,5,11,38
90,Fail,47,28,0,15,32
90,Fail,53,19,4,11,42
90,Fail,51,29,0,10,41
90,Fail,50,30,0,8,42
90,Fail,40,34,1,12,28
90,Fail,45,26,4,13,32
90,Fail,55,21,1,12,43
90,Fail,45,23,9,13,32
90,Fail,52,24,0,13,39
90,Fail,44,36,0,10,34
90,Fail,53,21,2,11,42
90,Fail,47,27,4,14,33
90,Fail,48,22,7,17,31
90,Fail,51,26,0,15,36
90,Fail,48,28,3,11,37
90,Fail,45,28,0,14,31
90,Fail,52,21,7,10,42
90,Fail,39,25,12,15,24
90,Fail,52,23,3,11,41
90,Fail,58,18,0,12,46
90,Fail,45,31,1,10,35
90,Fail,53,30,0,9,44
90,Fail,52,22,0,12,40
90,Fail,46,30,0,15,31
90,Fail,46,18,2,20,26
90,Fail,52,23,5,10,42
90,Fail,47,32,0,14,33
90,Fail,45,32,0,14,31
90,Fail,50,22,7,13,37
90,Fail,45,29,0,14,31
90,Fail,47,24,9,13,34
90,Fail,38,35,4,12,26
90,Fail,50,28,0,12,38
90,Fail,47,26,2,14,33
90,Fail,51,22,5,15,36
90,Fail,41,28,6,18,23
90,Fail,43,27,4,15,28
90,Fail,45,32,0,13,32
90,Fail,39,32,0,21,18
90,Fail,44,38,0,12,32
90,Fail,52,21,0,14,38
90,Fail,45,19,9,19,26
90,Fail,49,22,3,20,29
90,Fail,50,26,1,9,41
90,Fail,39,41,0,12,27
90,Fail,44,34,0,13,31
90,Fail,45,32,1,11,34
90,Fail,51,27,0,15,36
90,Fail,50,22,4,10,40
90,Fail,54,24,1,7,47
90,Fail,54,21,0,10,44
90,Fail,48,27,2,11,37
90,Fail,45,34,4,12,33
90,Fail,51,20,0,19,32
90,Fail,52,23,1,15,37
90,Fail,49,22,6,11,38
90,Fail,47,30,0,17,30
90,Fail,48,23,0,16,32
90,Fail,35,44,0,17,18
90,Fail,50,20,4,15,35
90,Fail,54,21,1,13,41
90,Fail,51,32,0,8,43
90,Fail,45,33,0,11,34
90,Fail,41,28,0,19,22
90,Fail,50,23,0,18,32
90,Fail,43,27,7,13,30
90,Fail,46,34,0,9,37
90,Fail,49,24,0,16,33
90,Fail,44,31,1,13,31
90,Fail,46,36,0,14,32
90,Fail,48,23,0,12,36
90,Fail,49,36,0,9,40
90,Fail,50,27,0,9,41
90,Fail,45,27,0,14,31
90,Fail,39,43,0,11,28
90,Fail,48,22,7,16,32
90,Fail,56,20,0,8,48
90,Fail,43,41,0,9,34
90,Fail,35,27,15,17,18
90,Fail,51,30,0,8,43
90,Fail,61,19,0,5,56
90,Fail,48,22,5,14,34
90,Fail,48,26,3,13,35
90,Fail,38,35,0,19,19
90,Fail,47,31,0,12,35
90,Fail,58,18,3,11,47
90,Fail,48,27,0,10,38
90,Fail,46,24,0,18,28
90,Fail,47,36,0,11,36
90,Fail,49,28,0,11,38
90,Fail,51,31,0,9,42
90,Fail,56,18,2,12,44
90,Fail,47,34,0,8,39
90,Fail,45,30,3,13,32
90,Fail,53,24,1,6,47
90,Fail,43,33,6,11,32
90,Fail,53,22,4,16,37
90,Fail,45,25,3,17,28
90,Fail,51,20,6,11,40
90,Fail,48,27,0,10,38
90,Fail,50,25,5,9,41
90,Fail,53,22,1,8,45
90,Fail,52,24,0,10,42
90,Fail,51,22,0,15,36
90,Fail,50,33,0,12,38
90,Fail,51,26,0,14,37
90,Fail,50,24,0,14,36
90,Fail,53,18,5,14,39
90,Fail,55,31,0,5,50
90,Fail,50,24,3,10,40
90,Fail,42,37,0,14,28
90,Fail,49,22,2,14,35
90,Fail,58,22,1,9,49
90,Fail,40,38,0,15,25
90,Fail,40,35,0,18,22
90,Fail,42,27,3,15,27
90,Fail,42,30,4,18,24
90,Fail,45,24,10,12,33
90,Fail,48,29,6,11,37
90,Fail,48,24,0,12,36
90,Fail,49,24,2,14,35
90,Fail,53,22,1,14,39
90,Fail,54,19,0,15,39
90,Fail,47,24,0,17,30
90,Fail,43,32,0,11,32
90,Fail,51,33,0,8,43
90,Fail,55,37,0,5,50
90,Fail,44,27,0,16,28
90,Fail,39,28,10,18,21
90,Fail,56,19,0,10,46
90,Fail,50,23,1,14,36
90,Fail,45,37,0,14,31
90,Fail,41,38,0,14,27
90,Fail,51,22,2,14,37
90,Fail,52,21,0,15,37
90,Fail,49,30,0,9,40
90,Fail,43,28,0,16,27
90,Fail,52,24,0,14,38
90,Fail,42,34,2,13,29
90,Fail,45,32,1,11,34
90,Fail,58,21,3,9,49
90,Fail,48,24,7,16,32
90,Fail,46,29,0,13,33
90,Fail,50,22,0,16,34
90,Fail,47,31,0,11,36
90,Fail,51,31,0,8,43
90,Fail,46,36,0,7,39
90,Fail,42,29,5,12,30
90,Fail,47,29,0,13,34
90,Fail,63,18,0,7,56
90,Fail,50,24,7,13,37
90,Fail,53,19,5,11,42
90,Fail,53,27,0,11,42
90,Fail,50,27,0,12,38
90,Fail,48,27,5,11,37
90,Fail,42,26,0,20,22
90,Fail,44,35,0,12,32
90,Fail,46,29,3,12,34
90,Fail,50,29,0,14,36
90,Fail,54,22,4,8,46
90,Fail,44,29,5,15,29
90,Fail,53,29,0,7,46
90,Fail,47,36,0,8,39
90,Fail,44,23,7,19,25
90,Fail,54,18,0,14,40
90,Fail,51,28,1,8,43
90,Fail,45,26,6,14,31
90,Fail,41,31,6,12,29
90,Fail,44,33,0,12,32
90,Fail,43,27,4,15,28
90,Fail,48,29,0,12,36
90,Fail,38,37,7,8,30
90,Fail,46,27,0,15,31
90,Fail,46,23,0,18,28
90,Fail,46,33,0,9,37
90,Fail,46,23,11,12,34
90,Fail,52,30,0,8,44
90,Fail,56,26,0,7,49
90,Fail,48,24,2,14,34
90,Fail,49,27,0,12,37
90,Fail,50,28,1,12,38
90,Fail,47,25,5,13,34
90,Fail,43,25,2,17,26
90,Fail,55,20,1,9,46
90,Fail,50,27,0,9,41
90,Fail,40,30,9,15,25
90,Fail,46,25,5,16,30
90,Fail,43,33,0,13,30
90,Fail,46,34,0,12,34
90,Fail,45,32,0,12,33
90,Fail,44,32,0,12,32
90,Fail,47,27,0,15,32
90,Fail,53,26,0,11,42
90,Fail,45,34,0,13,32
90,Fail,54,22,2,10,44
90,Fail,43,37,0,16,27
90,Fail,52,28,0,13,39
90,Fail,46,24,8,14,32
90,Fail,51,33,0,7,44
90,Fail,51,29,0,11,40
90,Fail,46,32,2,9,37
90,Fail,51,23,3,13,38
90,Fail,43,38,0,12,31
90,Fail,53,16,6,12,41
90,Fail,49,31,0,8,41
90,Fail,48,34,0,12,36
90,Fail,47,24,2,12,35
90,Fail,51,26,0,11,40
90,Fail,45,26,0,17,28
90,Fail,53,25,2,8,45
90,Fail,50,32,0,12,38
90,Fail,53,15,1,17,36
90,Fail,50,31,0,8,42
90,Fail,47,24,4,15,32
90,Fail,43,38,0,10,33
90,Fail,48,26,0,18,30
90,Fail,45,18,3,21,24
90,Fail,51,26,0,10,41
90,Fail,44,38,0,6,38
90,Fail,48,26,0,12,36
90,Fail,43,28,0,17,26
90,Fail,52,22,1,15,37
90,Fail,51,26,0,9,42
90,Fail,53,29,0,10,43
90,Fail,55,22,0,11,44
90,Fail,52,31,0,7,45
90,Fail,49,27,0,13,36
90,Fail,45,34,1,9,36
90,Fail,49,25,0,15,34
90,Fail,49,27,1,13,36
90,Fail,49,25,0,13,36
90,Fail,51,27,3,9,42
90,Fail,48,32,0,10,38
90,Fail,50,24,0,16,34
90,Fail,50,27,0,13,37
90,Fail,53,30,0,10,43
90,Fail,44,25,8,9,35
90,Fail,48,20,6,15,33
90,Fail,54,17,0,16,38
90,Fail,54,20,0,10,44
90,Fail,45,30,5,11,34
90,Fail,49,37,0,8,41
90,Fail,49,31,0,10,39
90,Fail,46,38,0,8,38
90,Fail,46,29,0,16,30
90,Fail,53,27,0,12,41
90,Fail,53,18,7,12,41
90,Fail,50,22,0,16,34
90,Fail,46,25,0,17,29
90,Fail,61,19,0,10,51
90,Fail,55,26,0,9,46
90,Fail,44,33,0,14,30
90,Fail,58,16,4,11,47
90,Fail,50,18,6,18,32
90,Fail,55,20,5,12,43
90,Fail,36,39,0,15,21
90,Fail,57,19,1,10,47
90,Fail,56,30,0,4,52
90,Fail,41,35,5,9,32
90,Fail,50,27,0,13,37
90,Fail,45,35,0,12,33
90,Fail,47,31,0,13,34
90,Fail,51,29,0,12,39
90,Fail,44,33,0,15,29
90,Fail,51,26,3,12,39
90,Fail,42,30,0,15,27
90,Fail,57,27,0,9,48
90,Fail,41,36,0,13,28
90,Fail,51,26,6,8,43
90,Fail,54,30,0,4,50
90,Fail,43,34,0,14,29
90,Fail,50,24,3,13,37
90,Fail,43,29,1,13,30
90,Fail,50,28,0,11,39
90,Fail,48,32,1,12,36
90,Fail,53,25,3,5,48
90,Fail,43,34,0,12,31
90,Fail,56,23,0,14,42
90,Fail,51,23,0,14,37
90,Fail,46,30,0,12,34
90,Fail,50,34,0,11,39
90,Fail,47,27,1,14,33
90,Fail,51,24,2,8,43
90,Fail,43,27,0,17,26
90,Fail,45,31,0,12,33
90,Fail,53,22,0,11,42
90,Fail,51,22,1,14,37
90,Fail,44,22,6,18,26
90,Fail,48,20,9,13,35
90,Fail,44,36,0,12,32
90,Fail,54,29,0,5,49
90,Fail,51,23,0,14,37
90,Fail,46,27,1,13,33
90,Fail,52,23,0,11,41
90,Fail,53,19,2,16,37
90,Fail,52,21,1,12,40
90,Fail,47,32,0,10,37
90,Fail,45,34,0,10,35
90,Fail,50,25,2,11,39
90,Fail,53,22,0,13,40
90,Fail,42,26,5,17,25
90,Fail,50,20,10,13,37
90,Fail,53,24,0,11,42
90,Fail,42,24,10,13,29
90,Fail,50,29,0,10,40
90,Fail,50,34,0,7,43
90,Fail,47,29,0,16,31
90,Fail,46,24,0,17,29
90,Fail,54,25,5,9,45
90,Fail,49,19,11,15,34
90,Fail,37,32,5,18,19
90,Fail,52,22,7,11,41
90,Fail,47,33,1,7,40
90,Fail,49,21,6,15,34
90,Fail,51,30,0,11,40
90,Fail,45,27,3,14,31
90,Fail,45,28,3,15,30
90,Fail,50,28,1,5,45
90,Fail,55,19,1,9,46
90,Fail,50,29,0,11,39
90,Fail,42,26,1,17,25
90,Fail,53,24,0,9,44
90,Fail,34,43,0,18,16
90,Fail,50,31,0,8,42
90,Fail,53,17,0,16,37
90,Fail,42,29,2,15,27
90,Fail,50,29,0,10,40
90,Fail,54,23,0,9,45
90,Fail,43,31,6,14,29
90,Fail,48,21,1,15,33
90,Fail,49,19,0,23,26
90,Fail,52,26,0,7,45
90,Fail,51,23,0,11,40
90,Fail,45,31,1,11,34
90,Fail,47,31,2,11,36
90,Fail,47,33,0,10,37
90,Fail,48,26,9,12,36
90,Fail,47,24,2,15,32
90,Fail,44,23,5,14,30
90,Fail,47,18,4,16,31
90,Fail,47,34,0,12,35
90,Fail,52,26,0,8,44
90,Fail,51,24,0,12,39
90,Fail,51,26,3,15,36
90,Fail,42,27,6,15,27
90,Fail,52,21,0,14,38
90,Fail,48,29,0,12,36
90,Fail,44,31,0,17,27
90,Fail,51,25,2,15,36
90,Fail,45,37,0,11,34
90,Fail,48,21,0,14,34
90,Fail,43,24,9,17,26
90,Fail,46,27,8,11,35
90,Fail,57,22,0,11,46
90,Fail,48,29,2,14,34
90,Fail,52,22,0,14,38
90,Fail,56,16,3,14,42
90,Fail,52,21,5,16,36
90,Fail,52,23,4,9,43
90,Fail,47,29,5,10,37
90,Fail,48,28,0,15,33
90,Fail,47,29,0,11,36
90,Fail,43,26,10,12,31
90,Fail,50,24,0,14,36
90,Fail,54,24,0,8,46
90,Fail,39,33,10,14,25
90,Fail,47,22,5,17,30
90,Fail,45,33,0,11,34
90,Fail,50,23,0,17,33
90,Fail,48,30,0,11,37
90,Fail,49,36,0,5,44
90,Fail,45,28,0,19,26
90,Fail,47,24,0,21,26
90,Fail,41,30,3,12,29
90,Fail,54,18,0,13,41
90,Fail,49,38,0,7,42
90,Fail,52,22,1,14,38
90,Fail,45,26,7,14,31
90,Fail,46,30,0,15,31
90,Fail,42,24,11,13,29
90,Fail,45,28,0,16,29
90,Fail,42,32,0,19,23
90,Fail,54,25,0,9,45
90,Fail,44,31,2,12,32
90,Fail,47,34,0,10,37
90,Fail,44,27,2,15,29
90,Fail,46,19,4,21,25
90,Fail,49,25,0,15,34
90,Fail,46,32,2,10,36
90,Fail,43,23,6,21,22
90,Fail,50,27,2,12,38
90,Fail,53,28,0,8,45
90,Fail,60,19,0,9,51
90,Fail,44,31,0,12,32
90,Fail,53,24,3,9,44
90,Fail,49,30,0,11,38
90,Fail,44,35,0,12,32
90,Fail,47,29,0,18,29
90,Fail,51,27,1,10,41
90,Fail,50,21,0,16,34
90,Fail,44,31,0,15,29
90,Fail,51,28,4,8,43
90,Fail,41,31,0,18,23
90,Fail,38,35,0,15,23
90,Fail,49,29,3,9,40
90,Fail,51,22,0,15,36
90,Fail,51,25,1,9,42
90,Fail,44,33,2,14,30
90,Fail,38,41,0,13,25
90,Fail,55,17,4,13,42
90,Fail,44,30,5,13,31
90,Fail,45,24,12,11,34
90,Fail,53,29,2,10,43
90,Fail,43,28,7,15,28
90,Fail,45,25,2,17,28
90,Fail,40,29,2,15,25
90,Fail,49,33,0,14,35
90,Fail,38,29,9,15,23
90,Fail,48,29,0,9,39
90,Fail,53,21,6,11,42
90,Fail,48,20,7,14,34
90,Fail,43,34,0,12,31
90,Fail,47,30,0,12,35
90,Fail,42,29,5,11,31
90,Fail,52,21,0,17,35
90,Fail,46,32,1,14,32
90,Fail,46,32,0,13,33
90,Fail,46,30,1,10,36
90,Fail,42,30,0,18,24
90,Fail,44,41,0,8,36
90,Fail,50,22,8,15,35
90,Fail,49,33,0,9,40
90,Fail,50,24,1,10,40
90,Fail,48,31,0,9,39
90,Fail,46,37,0,10,36
90,Fail,49,26,2,9,40
90,Fail,47,34,0,11,36
90,Fail,41,33,1,13,28
90,Fail,54,24,0,11,43
90,Fail,50,29,0,12,38
90,Fail,41,40,0,13,28
90,Fail,43,28,4,15,28
90,Fail,51,26,3,12,39
90,Fail,49,28,0,13,36
90,Fail,49,23,7,11,38
90,Fail,44,30,0,12,32
90,Fail,44,35,0,12,32
90,Fail,57,20,1,10,47
90,Fail,53,22,0,12,41
90,Fail,48,28,0,15,33
90,Fail,53,25,0,12,41
90,Fail,50,25,0,14,36
90,Fail,47,31,0,11,36
90,Fail,48,33,0,10,38
90,Fail,53,29,0,6,47
90,Fail,47,24,4,12,35
90,Fail,49,26,0,13,36
90,Fail,45,26,0,13,32
90,Fail,50,24,0,12,38
90,Fail,47,31,5,11,36
90,Fail,43,28,1,15,28
90,Fail,45,25,4,13,32
90,Fail,45,25,3,14,31
90,Fail,43,30,5,11,32
90,Fail,52,25,7,4,48
90,Fail,51,30,0,10,41
90,Fail,47,27,0,14,33
90,Fail,41,41,0,12,29
90,Fail,58,25,0,8,50
90,Fail,45,30,4,12,33
90,Fail,56,19,1,11,45
90,Fail,43,31,3,14,29
90,Fail,52,26,4,10,42
90,Fail,49,28,7,8,41
90,Fail,55,21,1,12,43
90,Fail,47,29,0,14,33
90,Fail,51,26,0,9,42
90,Fail,44,26,0,19,25
90,Fail,46,29,6,11,35
90,Fail,44,32,2,12,32
90,Fail,49,32,0,11,38
90,Fail,53,30,0,5,48
90,Fail,40,41,0,10,30
90,Fail,49,21,6,13,36
90,Fail,41,27,10,16,25
90,Fail,52,30,0,9,43
90,Fail,42,35,0,18,24
90,Fail,48,28,4,8,40
90,Fail,43,32,0,14,29
90,Fail,52,28,1,8,44
90,Fail,49,27,0,10,39
90,Fail,44,32,0,12,32
90,Fail,49,28,0,11,38
90,Fail,45,25,0,19,26
90,Fail,56,20,2,10,46
90,Fail,45,23,5,13,32
90,Fail,47,26,3,8,39
90,Fail,49,30,0,14,35
90,Fail,46,30,0,15,31
90,Fail,38,31,5,14,24
90,Fail,50,24,5,9,41
90,Fail,54,26,8,9,45
90,Fail,44,36,0,13,31
90,Fail,53,24,0,13,40
90,Fail,51,19,6,13,38
90,Fail,49,24,7,10,39
90,Fail,52,23,0,11,41
90,Fail,47,27,0,11,36
90,Fail,54,17,2,17,37
90,Fail,53,22,2,9,44
90,Fail,55,23,0,14,41
90,Fail,45,26,6,14,31
90,Fail,60,20,0,9,51
90,Fail,44,32,0,12,32
90,Fail,44,29,0,17,27
90,Fail,52,25,0,13,39
90,Fail,53,20,1,13,40
90,Fail,53,25,0,11,42
90,Fail,49,29,0,12,37
90,Fail,49,24,3,13,36
90,Fail,51,30,0,10,41
90,Fail,56,16,0,17,39
90,Fail,52,28,0,8,44
90,Fail,48,28,0,12,36
90,Fail,51,25,0,9,42
90,Fail,46,24,6,17,29
90,Fail,45,36,0,7,38
90,Fail,48,38,0,6,42
90,Fail,48,24,1,16,32
90,Fail,47,28,0,12,35
90,Fail,47,22,8,15,32
90,Fail,50,29,3,10,40
90,Fail,53,22,4,12,41
90,Fail,51,17,0,19,32
90,Fail,44,23,7,20,24
90,Fail,47,33,0,10,37
90,Fail,56,18,4,10,46
90,Fail,53,23,1,13,40
90,Fail,41,46,0,9,32
90,Fail,43,36,0,11,32
90,Fail,48,28,0,15,33
90,Fail,49,29,6,10,39
90,Fail,48,34,0,7,41
90,Fail,49,25,5,9,40
90,Fail,55,25,0,9,46
90,Fail,47,23,1,19,28
90,Fail,48,24,2,14,34
90,Fail,44,36,0,14,30
90,Fail,47,30,0,12,35
90,Fail,52,24,1,12,40
90,Fail,50,29,0,12,38
90,Fail,48,30,0,15,33
90,Fail,50,27,0,15,35
90,Fail,48,31,0,12,36
90,Fail,47,29,7,6,41
90,Fail,51,18,4,14,37
90,Fail,52,25,5,13,39
90,Fail,49,20,0,15,34
90,Fail,40,38,2,8,32
90,Fail,40,33,11,14,26
90,Fail,47,29,0,18,29
90,Fail,47,19,3,18,29
90,Fail,41,42,0,12,29
90,Fail,56,20,0,13,43
90,Fail,47,28,0,14,33
90,Fail,49,27,0,13,36
90,Fail,46,30,2,9,37
90,Fail,55,22,0,12,43
90,Fail,52,25,0,12,40
90,Fail,48,29,0,14,34
90,Fail,45,28,6,12,33
90,Fail,46,34,0,13,33
90,Fail,45,22,4,15,30
90,Fail,42,30,0,17,25
90,Fail,56,18,3,12,44
90,Fail,51,27,0,14,37
90,Fail,42,28,6,13,29
90,Fail,52,33,0,7,45
90,Fail,46,21,6,15,31
90,Fail,49,27,0,18,31
90,Fail,49,25,0,13,36
90,Fail,47,24,3,17,30
90,Fail,54,20,2,8,46
90,Fail,53,15,5,14,39
90,Fail,43,32,0,17,26
90,Fail,53,25,1,9,44
90,Fail,49,27,3,10,39
90,Fail,46,25,6,12,34
90,Fail,48,23,4,15,33
90,Fail,48,25,0,17,31
90,Fail,45,27,1,12,33
90,Fail,50,27,2,7,43
90,Fail,47,25,2,14,33
90,Fail,54,26,3,10,44
90,Fail,47,27,5,13,34
90,Fail,43,25,0,23,20
90,Fail,50,23,1,14,36
90,Fail,53,16,5,16,37
90,Fail,50,32,0,11,39
90,Fail,49,25,5,9,40
90,Fail,45,32,0,11,34
90,Fail,47,25,2,15,32
90,Fail,52,21,6,10,42
90,Fail,37,33,2,17,20
90,Fail,47,26,0,13,34
90,Fail,49,24,6,12,37
90,Fail,51,21,1,10,41
90,Fail,43,37,0,10,33
90,Fail,43,35,0,13,30
90,Fail,53,24,0,13,40
90,Fail,44,26,1,16,28
90,Fail,46,34,0,12,34
90,Fail,41,31,7,15,26
90,Fail,44,25,0,15,29
90,Fail,47,23,10,11,36
90,Fail,46,24,0,15,31
90,Fail,46,26,0,20,26
90,Fail,44,34,0,15,29
90,Fail,45,29,2,15,30
90,Fail,44,25,7,15,29
90,Fail,52,24,5,6,46
90,Fail,54,25,0,9,45
90,Fail,42,28,0,19,23
90,Fail,45,33,0,11,34
90,Fail,42,31,6,12,30
90,Fail,51,23,0,18,33
90,Fail,50,28,0,8,42
90,Fail,53,21,0,14,39
90,Fail,46,25,8,11,35
90,Fail,53,23,5,10,43
90,Fail,44,25,0,20,24
90,Fail,54,21,3,11,43
90,Fail,47,15,3,22,25
90,Fail,43,32,3,9,34
90,Fail,62,18,0,5,57
90,Fail,44,31,0,14,30
90,Fail,47,29,6,8,39
90,Fail,46,33,2,11,35
90,Fail,49,30,0,11,38
90,Fail,52,16,9,15,37
90,Fail,44,23,3,15,29
90,Fail,47,28,7,8,39
90,Fail,47,26,1,10,37
90,Fail,57,21,0,11,46
90,Fail,51,21,0,16,35
90,Fail,54,22,0,11,43
90,Fail,44,38,0,10,34
90,Fail,55,26,1,9,46
90,Fail,45,36,0,10,35
90,Fail,46,29,0,12,34
90,Fail,49,23,3,11,38
90,Fail,47,30,0,12,35
90,Fail,46,36,0,8,38
90,Fail,54,19,2,10,44
90,Fail,55,28,0,8,47
90,Fail,51,27,1,12,39
90,Fail,46,35,0,8,38
90,Fail,48,28,0,13,35
90,Fail,49,30,0,9,40
90,Fail,47,32,0,15,32
90,Fail,49,22,9,11,38
90,Fail,53,26,0,10,43
90,Fail,48,29,1,13,35
90,Fail,39,34,0,19,20
90,Fail,53,26,3,7,46
90,Fail,45,31,0,13,32
90,Fail,47,24,6,11,36
90,Fail,52,24,6,3,49
90,Fail,54,19,3,17,37
90,Fail,43,33,9,9,34
90,Fail,38,35,3,14,24
90,Fail,49,25,2,9,40
90,Fail,42,33,0,18,24
90,Fail,58,16,0,11,47
90,Fail,53,21,5,10,43
90,Fail,44,31,0,14,30
90,Fail,42,34,0,13,29
90,Fail,48,24,8,14,34
90,Fail,45,28,6,14,31
90,Fail,49,22,0,14,35
90,Fail,47,28,0,13,34
90,Fail,48,28,2,15,33
90,Fail,40,31,0,15,25
90,Fail,56,18,0,11,45
90,Fail,46,33,0,12,34
90,Fail,42,35,0,13,29
90,Fail,44,25,7,15,29
90,Fail,44,28,0,16,28
90,Fail,42,36,0,14,28
90,Fail,49,32,0,12,37
90,Fail,53,20,2,11,42
90,Fail,51,30,0,8,43
90,Fail,54,21,2,13,41
90,Fail,41,29,0,17,24
90,Fail,44,34,0,11,33
90,Fail,39,41,0,15,24
90,Fail,43,27,0,21,22
90,Fail,47,26,0,15,32
90,Fail,46,20,3,19,27
90,Fail,54,22,0,14,40
90,Fail,53,20,0,18,35
90,Fail,41,30,0,12,29
90,Fail,48,29,1,13,35
90,Fail,37,32,5,14,23
90,Fail,44,37,0,8,36
90,Fail,39,42,0,10,29
90,Fail,46,23,0,19,27
90,Fail,46,24,2,15,31
90,Fail,54,16,2,15,39
90,Fail,45,29,0,15,30
90,Fail,46,27,0,17,29
90,Fail,49,29,0,9,40
90,Fail,49,32,0,10,39
90,Fail,50,26,0,13,37
90,Fail,43,31,0,15,28
90,Fail,43,27,7,16,27
90,Fail,47,22,0,20,27
90,Fail,49,18,0,21,28
90,Fail,49,25,5,13,36
90,Fail,47,24,6,12,35
90,Fail,46,23,3,18,28
90,Fail,39,40,0,17,22
90,Fail,45,29,0,18,27
90,Fail,44,37,0,13,31
90,Fail,44,30,6,10,34
90,Fail,41,31,11,12,29
90,Fail,41,35,0,17,24
90,Fail,52,24,5,11,41
90,Fail,49,27,0,11,38
90,Fail,42,33,2,10,32
90,Fail,48,27,0,14,34
90,Fail,48,23,10,12,36
90,Fail,46,35,0,12,34
90,Fail,61,22,0,7,54
90,Fail,43,30,3,17,26
90,Fail,47,28,0,15,32
90,Fail,52,30,0,8,44
90,Fail,49,33,0,9,40
90,Fail,51,23,0,18,33
90,Fail,45,25,4,12,33
90,Fail,53,20,0,14,39
90,Fail,43,27,7,16,27
90,Fail,54,23,3,11,43
90,Fail,49,28,0,13,36
90,Fail,48,28,2,13,35
90,Fail,43,34,0,13,30
90,Fail,41,35,0,14,27
90,Fail,46,28,0,10,36
90,Fail,42,34,0,12,30
90,Fail,43,27,1,14,29
90,Fail,48,27,0,13,35
90,Fail,41,29,4,17,24
90,Fail,47,31,0,12,35
90,Fail,54,22,1,13,41
90,Fail,44,31,6,8,36
90,Fail,45,32,0,13,32
90,Fail,45,29,0,11,34
90,Fail,49,24,2,13,36
90,Fail,51,22,0,10,41
90,Fail,45,26,3,15,30
90,Fail,42,33,5,10,32
90,Fail,50,22,0,16,34
90,Fail,49,18,7,16,33
90,Fail,47,30,0,13,34
90,Fail,49,27,0,13,36
90,Fail,53,23,0,12,41
90,Fail,49,27,1,11,38
90,Fail,37,36,4,15,22
90,Fail,44,26,5,15,29
90,Fail,47,26,0,12,35
90,Fail,41,28,4,16,25
90,Fail,46,26,5,11,35
90,Fail,51,23,0,9,42
90,Fail,51,22,3,13,38
90,Fail,55,28,0,6,49
90,Fail,50,24,3,12,38
90,Fail,54,23,2,7,47
90,Fail,51,22,8,10,41
90,Fail,42,23,9,19,23
90,Fail,43,27,5,17,26
90,Fail,48,26,2,14,34
90,Fail,45,29,0,12,33
90,Fail,47,28,0,12,35
90,Fail,42,36,1,13,29
90,Fail,53,19,3,14,39
90,Fail,46,23,5,17,29
90,Fail,51,22,7,6,45
90,Fail,38,39,0,11,27
90,Fail,44,24,10,14,30
90,Fail,42,30,5,15,27
90,Fail,55,20,1,9,46
90,Fail,48,34,0,10,38
90,Fail,46,27,0,15,31
90,Fail,47,32,0,11,36
90,Fail,52,19,7,15,37
90,Fail,49,29,0,11,38
90,Fail,46,32,4,8,38
90,Fail,48,20,0,19,29
90,Fail,51,30,0,8,43
90,Fail,45,24,0,18,27
90,Fail,48,27,2,11,37
90,Fail,46,25,0,16,30
90,Fail,36,46,0,12,24
90,Fail,48,25,8,7,41
90,Fail,50,31,0,12,38
90,Fail,44,33,1,10,34
90,Fail,49,28,0,14,35
90,Fail,48,30,0,11,37
90,Fail,50,23,0,12,38
90,Fail,47,25,7,11,36
90,Fail,51,35,0,4,47
90,Fail,49,27,0,10,39
90,Fail,50,24,2,16,34
90,Fail,42,34,0,10,32
90,Fail,45,29,1,13,32
90,Fail,43,31,0,14,29
90,Fail,52,19,1,15,37
90,Fail,47,25,3,14,33
90,Fail,44,36,0,10,34
90,Fail,50,20,6,14,36
90,Fail,45,23,0,23,22
90,Fail,54,23,0,11,43
90,Fail,49,30,0,10,39
90,Fail,54,24,2,8,46
90,Fail,55,20,5,8,47
90,Fail,50,22,0,16,34
90,Fail,46,29,0,16,30
90,Fail,43,33,0,16,27
90,Fail,47,29,0,15,32
90,Fail,44,35,0,11,33
90,Fail,48,27,0,15,33
90,Fail,49,20,5,8,41
90,Fail,47,30,0,16,31
90,Fail,44,36,0,13,31
90,Fail,42,33,0,11,31
90,Fail,51,21,0,13,38
90,Fail,43,30,0,17,26
90,Fail,51,20,1,17,34
90,Fail,52,24,0,13,39
90,Fail,48,24,7,12,36
90,Fail,47,26,8,12,35
90,Fail,48,30,0,10,38
90,Fail,49,27,0,11,38
90,Fail,43,34,0,14,29
90,Fail,51,26,0,13,38
90,Fail,47,24,3,13,34
90,Fail,48,30,0,10,38
90,Fail,53,22,0,14,39
90,Fail,51,22,0,15,36
90,Fail,51,22,9,10,41
90,Fail,52,23,5,12,40
90,Fail,50,32,0,9,41
90,Fail,50,29,0,11,39
90,Fail,54,20,1,13,41
90,Fail,47,31,0,9,38
90,Fail,49,29,0,13,36
90,Fail,47,28,0,15,32
90,Fail,42,30,0,17,25
90,Fail,46,28,5,11,35
90,Fail,44,30,4,11,33
90,Fail,40,39,0,11,29
90,Fail,52,24,0,13,39
90,Fail,48,33,0,13,35
90,Fail,47,38,0,5,42
90,Fail,51,20,5,10,41
90,Fail,54,25,0,12,42
90,Fail,50,25,0,16,34
90,Fail,51,30,1,9,42
90,Fail,49,30,4,6,43
90,Fail,54,25,4,7,47
90,Fail,46,27,2,13,33
90,Fail,47,34,0,8,39
90,Fail,44,25,4,18,26
90,Fail,53,26,3,8,45
90,Fail,46,24,4,14,32
90,Fail,49,24,0,14,35
90,Fail,52,25,5,11,41
90,Fail,44,28,3,15,29
90,Fail,46,34,3,6,40
90,Fail,49,29,5,8,41
90,Fail,48,36,0,7,41
90,Fail,49,20,0,18,31
90,Fail,58,18,0,10,48
90,Fail,45,30,6,12,33
90,Fail,56,27,0,7,49
90,Fail,46,25,4,14,32
90,Fail,46,36,0,10,36
90,Fail,46,25,0,15,31
90,Fail,48,26,4,13,35
90,Fail,52,20,2,12,40
90,Fail,45,29,1,12,33
90,Fail,53,27,0,10,43
90,Fail,49,27,3,12,37
90,Fail,54,27,0,10,44
90,Fail,42,36,0,15,27
90,Fail,47,27,0,11,36
90,Fail,53,21,2,12,41
90,Fail,54,20,1,10,44
90,Fail,50,23,3,14,36
90,Fail,50,24,9,11,39
90,Fail,49,18,1,19,30
90,Fail,45,32,0,11,34
90,Fail,40,35,0,16,24
90,Fail,52,17,11,14,38
90,Fail,46,28,3,14,32
90,Fail,47,32,0,8,39
90,Fail,44,28,4,12,32
90,Fail,44,21,9,12,32
90,Fail,49,23,0,11,38
90,Fail,51,23,4,12,39
90,Fail,46,30,3,10,36
90,Fail,48,24,6,14,34
90,Fail,50,25,0,12,38
90,Fail,47,37,0,7,40
90,Fail,45,31,1,13,32
90,Fail,42,29,10,12,30
90,Fail,49,29,0,11,38
90,Fail,56,14,1,17,39
90,Fail,54,30,0,4,50
90,Fail,50,30,0,10,40
90,Fail,51,22,1,11,40
90,Fail,48,29,1,13,35
90,Fail,50,27,0,17,33
90,Fail,47,33,0,9,38
90,Fail,47,27,0,15,32
90,Fail,44,26,3,15,29
90,Fail,51,35,0,8,43
90,Fail,48,26,1,14,34
90,Fail,56,23,0,8,48
90,Fail,38,34,8,14,24
90,Fail,50,20,6,14,36
90,Fail,54,24,0,14,40
90,Fail,45,21,8,15,30
90,Fail,44,27,6,15,29
90,Fail,54,18,0,14,40
90,Fail,44,28,3,16,28
90,Fail,48,30,0,8,40
90,Fail,50,27,0,8,42
90,Fail,37,37,1,11,26
90,Fail,52,24,0,12,40
90,Fail,37,39,0,14,23
90,Fail,44,32,4,10,34
90,Fail,42,31,0,12,30
90,Fail,48,24,4,17,31
90,Fail,48,31,0,8,40
90,Fail,48,27,4,9,39
90,Fail,49,30,0,11,38
90,Fail,46,25,8,9,37
90,Fail,51,23,0,12,39
90,Fail,49,27,0,15,34
90,Fail,47,29,1,11,36
90,Fail,48,28,0,11,37
90,Fail,49,28,0,8,41
90,Fail,45,27,0,17,28
90,Fail,44,33,0,13,31
90,Fail,52,19,7,16,36
90,Fail,44,24,8,17,27
90,Fail,42,26,5,14,28
90,Fail,57,23,0,11,46
90,Fail,44,30,0,14,30
90,Fail,46,38,0,4,42
90,Fail,48,35,0,9,39
90,Fail,53,24,0,16,37
90,Fail,45,37,0,11,34
90,Fail,50,23,4,12,38
90,Fail,51,28,0,14,37
90,Fail,49,31,0,7,42
90,Fail,44,28,4,15,29
90,Fail,41,37,0,12,29
90,Fail,37,29,11,15,22
90,Fail,50,23,5,14,36
90,Fail,53,22,4,13,40
90,Fail,55,20,2,14,41
90,Fail,44,30,0,15,29
90,Fail,40,31,2,15,25
90,Fail,50,21,13,8,42
90,Fail,43,33,0,11,32
90,Fail,52,29,0,9,43
90,Fail,52,25,1,10,42
90,Fail,54,27,0,9,45
90,Fail,47,31,0,13,34
90,Fail,43,27,6,14,29
90,Fail,51,25,3,8,43
90,Fail,52,26,0,10,42
90,Fail,44,23,7,15,29
90,Fail,54,22,0,11,43
90,Fail,56,24,0,9,47
90,Fail,41,35,0,13,28
90,Fail,40,37,0,12,28
90,Fail,42,38,0,10,32
90,Fail,47,33,0,10,37
90,Fail,50,17,11,12,38
90,Fail,47,34,0,14,33
90,Fail,40,29,3,17,23
90,Fail,43,28,2,16,27
90,Fail,53,19,2,11,42
90,Fail,47,27,0,15,32
90,Fail,54,29,0,9,45
90,Fail,46,33,0,10,36
90,Fail,51,24,0,13,38
90,Fail,51,25,1,10,41
90,Fail,46,25,11,9,37
90,Fail,50,26,0,13,37
90,Fail,50,18,3,20,30
90,Fail,46,36,0,9,37
90,Fail,45,27,0,13,32
90,Fail,46,30,6,12,34
90,Fail,45,30,0,11,34
90,Fail,46,20,4,18,28
90,Fail,45,33,0,13,32
90,Fail,50,34,0,8,42
90,Fail,43,29,1,16,27
90,Fail,58,19,5,6,52
90,Fail,42,37,0,14,28
90,Fail,54,24,0,9,45
90,Fail,49,30,0,11,38
90,Fail,45,22,14,10,35
90,Fail,46,25,4,14,32
90,Fail,44,32,1,12,32
90,Fail,48,25,3,14,34
90,Fail,39,36,0,16,23
90,Fail,47,32,0,11,36
90,Fail,51,23,4,14,37
90,Fail,47,29,1,12,35
90,Fail,56,18,8,11,45
90,Fail,53,19,0,15,38
90,Fail,46,25,3,17,29
90,Fail,48,31,0,13,35
90,Fail,48,23,0,17,31
90,Fail,47,28,0,14,33
90,Fail,48,24,3,14,34
90,Fail,49,24,0,17,32
90,Fail,48,28,2,12,36
90,Fail,40,29,2,18,22
90,Fail,44,29,6,10,34
90,Fail,47,26,6,17,30
90,Fail,55,18,0,14,41
90,Fail,43,27,0,16,27
90,Fail,48,30,4,9,39
90,Fail,54,22,10,7,47
90,Fail,39,37,0,15,24
90,Fail,50,29,0,8,42
90,Fail,43,30,4,17,26
90,Fail,50,29,0,10,40
90,Fail,44,36,0,11,33
90,Fail,47,31,1,10,37
90,Fail,52,27,0,10,42
90,Fail,50,27,0,11,39
90,Fail,36,38,0,20,16
90,Fail,49,24,0,14,35
90,Fail,50,27,0,13,37
90,Fail,48,29,0,9,39
90,Fail,46,26,0,19,27
90,Fail,50,28,0,13,37
90,Fail,56,23,0,10,46
90,Fail,41,20,7,24,17
90,Fail,52,28,1,8,44
90,Fail,45,26,0,14,31
90,Fail,51,25,6,8,43
90,Fail,49,22,0,17,32
90,Fail,36,27,15,14,22
90,Fail,49,24,3,14,35
90,Fail,42,30,0,13,29
90,Fail,49,31,0,12,37
90,Fail,50,29,0,14,36
90,Fail,46,32,0,13,33
90,Fail,54,26,0,8,46
90,Fail,41,28,11,12,29
90,Fail,42,31,3,12,30
90,Fail,47,27,6,13,34
90,Fail,42,30,0,20,22
90,Fail,49,22,5,14,35
90,Fail,54,29,0,6,48
90,Fail,37,25,11,18,19
90,Fail,50,24,0,11,39
90,Fail,43,30,10,11,32
90,Fail,51,26,6,7,44
90,Fail,49,31,0,13,36
90,Fail,46,26,7,13,33
90,Fail,58,19,2,9,49
90,Fail,50,27,0,9,41
90,Fail,38,32,5,14,24
90,Fail,43,35,0,17,26
90,Fail,44,29,0,17,27
90,Fail,50,30,0,10,40
90,Fail,45,31,3,12,33
90,Fail,46,27,0,12,34
90,Fail,51,25,0,10,41
90,Fail,45,26,0,13,32
90,Fail,51,24,1,13,38
90,Fail,47,36,0,9,38
90,Fail,49,19,9,17,32
90,Fail,48,26,0,17,31
90,Fail,43,39,0,10,33
90,Fail,52,25,0,10,42
90,Fail,44,40,0,8,36
90,Fail,47,31,0,12,35
90,Fail,47,28,7,9,38
90,Fail,51,19,3,16,35
90,Fail,44,32,0,12,32
90,Fail,50,28,0,11,39
90,Fail,47,28,0,14,33
90,Fail,55,17,5,10,45
90,Fail,47,23,2,12,35
90,Fail,55,21,4,7,48
90,Fail,49,27,3,13,36
90,Fail,50,24,0,14,36
90,Fail,49,30,0,14,35
90,Fail,54,25,0,7,47
90,Fail,42,35,0,14,28
90,Fail,48,26,6,11,37
90,Fail,44,21,8,16,28
90,Fail,45,21,5,17,28
90,Fail,44,25,8,10,34
90,Fail,41,35,0,12,29
90,Fail,59,15,0,12,47
90,Fail,55,19,3,11,44
90,Fail,57,21,0,12,45
90,Fail,53,30,0,8,45
90,Fail,53,27,6,7,46
90,Fail,50,32,0,9,41
90,Fail,52,22,0,14,38
90,Fail,51,21,4,11,40
90,Fail,44,32,0,12,32
90,Fail,49,30,0,14,35
90,Fail,54,27,0,9,45
90,Fail,54,22,0,11,43
90,Fail,42,31,0,19,23
90,Fail,56,22,2,11,45
90,Fail,60,22,0,8,52
90,Fail,50,25,2,12,38
90,Fail,45,32,0,11,34
90,Fail,47,30,0,15,32
90,Fail,50,25,0,14,36
90,Fail,51,20,0,19,32
90,Fail,49,29,0,10,39
90,Fail,49,25,5,12,37
90,Fail,51,22,6,11,40
90,Fail,53,26,0,11,42
90,Fail,49,28,0,10,39
90,Fail,45,30,0,13,32
90,Fail,51,23,2,12,39
90,Fail,52,23,0,13,39
90,Fail,46,33,3,10,36
90,Fail,51,33,0,7,44
90,Fail,48,26,0,14,34
90,Fail,49,28,0,15,34
90,Fail,54,17,1,14,40
90,Fail,41,34,0,18,23
90,Fail,40,26,11,16,24
90,Fail,46,19,6,22,24
90,Fail,54,29,0,8,46
90,Fail,51,27,0,13,38
90,Fail,52,25,0,11,41
90,Fail,50,30,0,10,40
90,Fail,45,30,3,17,28
90,Fail,51,24,3,15,36
90,Fail,53,19,0,16,37
90,Fail,47,34,0,11,36
90,Fail,44,24,3,17,27
90,Fail,53,26,0,11,42
90,Fail,42,33,0,18,24
90,Fail,45,29,0,13,32
90,Fail,56,24,0,8,48
90,Fail,46,30,0,16,30
90,Fail,54,26,0,12,42
90,Fail,48,29,0,13,35
90,Fail,48,31,0,13,35
90,Fail,44,33,0,14,30
90,Fail,48,26,0,15,33
90,Fail,49,22,0,17,32
90,Fail,46,28,3,12,34
90,Fail,52,24,0,12,40
90,Fail,49,29,1,13,36
90,Fail,44,36,0,11,33
90,Fail,56,21,1,13,43
90,Fail,46,30,4,12,34
90,Fail,45,39,0,11,34
90,Fail,45,28,1,16,29
90,Fail,35,40,0,15,20
90,Fail,45,36,0,8,37
90,Fail,42,27,11,11,31
90,Fail,52,24,0,7,45
90,Fail,45,29,0,14,31
90,Fail,50,25,8,10,40
90,Fail,44,31,0,15,29
90,Fail,38,25,8,18,20
90,Fail,48,27,3,14,34
90,Fail,46,27,0,14,32
90,Fail,45,29,4,12,33
90,Fail,40,23,13,13,27
90,Fail,46,33,0,14,32
90,Fail,46,28,4,11,35
90,Fail,51,26,1,9,42
90,Fail,44,35,0,8,36
90,Fail,49,31,0,12,37
90,Fail,43,29,5,16,27
90,Fail,43,29,5,15,28
90,Fail,44,21,17,11,33
90,Fail,45,17,9,18,27
90,Fail,56,21,0,10,46
90,Fail,54,31,0,6,48
90,Fail,50,28,4,6,44
90,Fail,51,30,0,10,41
90,Fail,47,31,0,10,37
90,Fail,48,22,0,14,34
90,Fail,45,27,10,12,33
90,Fail,44,26,7,13,31
90,Fail,50,26,5,8,42
90,Fail,47,27,3,12,35
90,Fail,50,28,0,10,40
90,Fail,44,30,0,15,29
90,Fail,56,25,0,9,47
90,Fail,40,33,0,17,23
90,Fail,59,15,2,11,48
90,Fail,45,30,5,10,35
90,Fail,52,31,0,7,45
90,Fail,48,26,3,13,35
90,Fail,47,31,3,12,35
90,Fail,49,27,0,12,37
90,Fail,39,31,8,16,23
90,Fail,40,27,3,21,19
90,Fail,50,30,0,8,42
90,Fail,44,26,7,15,29
90,Fail,45,34,0,11,34
90,Fail,51,23,2,9,42
90,Fail,46,26,5,10,36
90,Fail,49,28,3,8,41
90,Fail,48,26,2,14,34
90,Fail,38,31,4,18,20
90,Fail,50,31,0,9,41
90,Fail,46,24,0,21,25
90,Fail,47,32,0,12,35
90,Fail,46,23,0,20,26
90,Fail,61,19,0,11,50
90,Fail,44,26,1,16,28
90,Fail,47,27,4,13,34
90,Fail,42,36,0,11,31
90,Fail,50,22,0,17,33
90,Fail,51,21,2,13,38
90,Fail,57,21,1,10,47
90,Fail,46,26,6,14,32
90,Fail,44,28,0,13,31
90,Fail,48,29,2,10,38
90,Fail,50,28,0,10,40
90,Fail,51,30,0,10,41
90,Fail,51,29,0,13,38
90,Fail,54,20,0,11,43
90,Fail,40,27,1,19,21
90,Fail,48,28,0,13,35
90,Fail,46,27,3,13,33
90,Fail,46,24,9,11,35
90,Fail,49,27,0,11,38
90,Fail,49,33,1,7,42
90,Fail,51,24,0,12,39
90,Fail,49,26,1,11,38
90,Fail,48,20,0,13,35
90,Fail,51,23,7,10,41
90,Fail,43,26,7,11,32
90,Fail,46,26,2,14,32
90,Fail,43,36,0,12,31
90,Fail,47,29,0,13,34
90,Fail,47,25,1,16,31
90,Fail,49,31,3,8,41
90,Fail,48,30,0,13,35
90,Fail,43,28,2,14,29
90,Fail,54,19,0,15,39
90,Fail,46,26,2,16,30
90,Fail,53,23,0,11,42
90,Fail,46,27,8,11,35
90,Fail,49,27,4,8,41
90,Fail,48,18,9,14,34
90,Fail,48,29,8,8,40
90,Fail,51,18,0,14,37
90,Fail,46,29,7,7,39
90,Fail,49,23,0,19,30
90,Fail,47,24,7,18,29
90,Fail,49,31,2,10,39
90,Fail,47,34,0,11,36
90,Fail,44,41,0,7,37
90,Fail,50,38,0,8,42
90,Fail,46,29,0,16,30
90,Fail,41,29,7,13,28
90,Fail,47,24,5,15,32
90,Fail,45,24,3,15,30
90,Fail,42,39,0,9,33
90,Fail,49,27,0,13,36
90,Fail,45,26,1,15,30
90,Fail,43,28,2,15,28
90,Fail,42,25,3,15,27
90,Fail,44,33,0,12,32
90,Fail,40,30,5,14,26
90,Fail,48,29,1,11,37
90,Fail,41,25,8,15,26
90,Fail,46,28,0,13,33
90,Fail,57,22,0,12,45
90,Fail,42,31,0,17,25
90,Fail,48,26,0,13,35
90,Fail,44,38,0,8,36
90,Fail,42,32,0,15,27
90,Fail,45,31,0,12,33
90,Fail,48,23,6,11,37
90,Fail,45,35,0,13,32
90,Fail,49,26,1,8,41
90,Fail,51,24,2,13,38
90,Fail,50,29,0,9,41
90,Fail,47,20,1,16,31
90,Fail,52,20,0,15,37
90,Fail,49,25,3,15,34
90,Fail,51,23,3,13,38
90,Fail,54,25,0,10,44
90,Fail,49,24,0,14,35
90,Fail,50,31,0,10,40
90,Fail,48,29,0,17,31
90,Fail,49,26,0,15,34
90,Fail,45,28,0,17,28
90,Fail,61,20,0,10,51
90,Fail,44,25,0,16,28
90,Fail,47,25,8,13,34
90,Fail,58,15,3,14,44
90,Fail,43,35,0,14,29
90,Fail,47,31,0,8,39
90,Fail,43,25,1,15,28
90,Fail,49,33,0,7,42
90,Fail,52,22,2,13,39
90,Fail,56,18,0,16,40
90,Fail,61,17,0,11,50
90,Fail,47,22,5,11,36
90,Fail,62,15,1,8,54
90,Fail,47,29,0,17,30
90,Fail,47,35,0,11,36
90,Fail,46,25,5,11,35
90,Fail,48,29,0,10,38
90,Fail,52,30,0,9,43
90,Fail,52,20,3,12,40
90,Fail,48,28,0,14,34
90,Fail,43,37,0,15,28
90,Fail,49,25,0,14,35
90,Fail,46,28,9,11,35
90,Fail,42,33,9,9,33
90,Fail,46,28,0,13,33
90,Fail,50,22,5,13,37
90,Fail,47,25,0,15,32
90,Fail,53,19,1,15,38
90,Fail,48,25,0,11,37
90,Fail,46,34,0,9,37
90,Fail,53,26,0,14,39
90,Fail,46,32,0,12,34
90,Fail,48,20,5,15,33
90,Fail,54,28,0,6,48
90,Fail,48,21,5,16,32
90,Fail,51,26,1,14,37
90,Fail,50,28,0,10,40
90,Fail,53,20,4,12,41
90,Fail,45,34,0,12,33
90,Fail,51,23,0,13,38
90,Fail,48,26,3,14,34
90,Fail,45,35,0,11,34
90,Fail,51,25,0,15,36
90,Fail,43,31,0,16,27
90,Fail,46,26,1,12,34
90,Fail,47,29,0,14,33
90,Fail,48,21,4,16,32
90,Fail,50,18,0,18,32
90,Fail,49,22,2,17,32
90,Fail,44,32,3,8,36
90,Fail,41,42,0,11,30
90,Fail,36,44,0,16,20
90,Fail,43,32,0,14,29
90,Fail,45,22,5,14,31
90,Fail,43,35,0,14,29
90,Fail,44,25,1,17,27
90,Fail,45,22,12,14,31
90,Fail,41,26,2,19,22
90,Fail,49,23,7,12,37
90,Fail,50,27,0,12,38
90,Fail,56,20,0,16,40
90,Fail,43,40,0,7,36
90,Fail,50,24,12,11,39
90,Fail,36,39,1,15,21
90,Fail,54,20,7,11,43
90,Fail,51,25,1,10,41
90,Fail,49,26,4,11,38
90,Fail,47,21,9,16,31
90,Fail,48,30,0,14,34
90,Fail,46,27,7,12,34
90,Fail,51,27,0,12,39
90,Fail,53,24,1,10,43
90,Fail,40,35,0,12,28
90,Fail,53,26,1,10,43
90,Fail,47,31,0,12,35
90,Fail,51,30,0,8,43
90,Fail,50,21,2,16,34
90,Fail,45,32,1,12,33
90,Fail,53,18,2,14,39
90,Fail,53,19,1,16,37
90,Fail,51,27,0,10,41
90,Fail,46,36,0,10,36
90,Fail,49,33,0,8,41
90,Fail,53,24,3,9,44
90,Fail,52,21,0,12,40
90,Fail,48,27,0,15,33
90,Fail,40,41,0,11,29
90,Fail,44,31,0,11,33
90,Fail,54,19,4,11,43
90,Fail,51,26,0,9,42
90,Fail,47,29,0,16,31
90,Fail,50,27,0,11,39
90,Fail,46,26,0,16,30
90,Fail,48,20,0,16,32
90,Fail,46,26,0,18,28
90,Fail,46,28,2,10,36
90,Fail,38,42,0,12,26
90,Fail,50,20,0,17,33
90,Fail,47,32,0,12,35
90,Fail,52,23,0,11,41
90,Fail,51,21,3,11,40
90,Fail,45,32,9,4,41
90,Fail,52,25,0,10,42
90,Fail,44,31,0,14,30
90,Fail,41,27,3,16,25
90,Fail,47,24,4,13,34
90,Fail,45,35,0,12,33
90,Fail,40,39,7,7,33
90,Fail,44,18,2,21,23
90,Fail,47,22,1,19,28
90,Fail,53,23,0,14,39
90,Fail,45,26,4,15,30
90,Fail,55,21,7,11,44
90,Fail,62,17,0,6,56
90,Fail,49,25,0,18,31
90,Fail,43,29,6,13,30
90,Fail,46,24,7,13,33
90,Fail,48,27,4,13,35
90,Fail,49,28,0,8,41
90,Fail,48,25,4,14,34
90,Fail,44,33,4,7,37
90,Fail,50,25,0,16,34
90,Fail,51,24,0,11,40
90,Fail,44,29,5,13,31
90,Fail,57,17,2,7,50
90,Fail,53,24,0,11,42
90,Fail,50,29,6,8,42
90,Fail,49,28,0,12,37
90,Fail,52,20,0,18,34
90,Fail,42,34,0,15,27
90,Fail,53,23,4,9,44
90,Fail,41,33,5,11,30
90,Fail,56,24,0,13,43
90,Fail,53,25,2,10,43
90,Fail,55,24,0,8,47
90,Fail,51,27,2,11,40
90,Fail,46,21,9,14,32
90,Fail,48,23,3,15,33
90,Fail,49,24,0,15,34
90,Fail,46,26,0,16,30
90,Fail,50,23,4,13,37
90,Fail,53,22,1,12,41
90,Fail,45,28,0,15,30
90,Fail,45,31,0,13,32
90,Fail,48,31,0,15,33
90,Fail,44,31,6,11,33
90,Fail,42,34,2,15,27
90,Fail,55,19,2,12,43
90,Fail,46,28,5,11,35
90,Fail,51,31,0,11,40
90,Fail,50,24,5,8,42
90,Fail,49,23,0,15,34
90,Fail,53,22,0,15,38
90,Fail,53,24,10,6,47
90,Fail,50,18,6,12,38
90,Fail,48,36,0,9,39
90,Fail,45,26,0,19,26
90,Fail,51,30,0,12,39
90,Fail,54,24,0,13,41
90,Fail,50,29,0,10,40
90,Fail,46,29,3,12,34
90,Fail,49,29,0,11,38
90,Fail,56,13,0,18,38
90,Fail,56,17,4,8,48
90,Fail,43,24,9,13,30
90,Fail,47,29,2,11,36
90,Fail,51,26,3,8,43
90,Fail,45,22,4,18,27
90,Fail,53,23,0,16,37
90,Fail,45,31,0,13,32
90,Fail,50,22,1,12,38
90,Fail,47,23,5,13,34
90,Fail,41,36,0,14,27
90,Fail,58,23,5,9,49
90,Fail,40,43,0,10,30
90,Fail,47,28,0,11,36
90,Fail,45,26,3,12,33
90,Fail,53,20,0,15,38
90,Fail,48,17,2,20,28
90,Fail,47,33,0,10,37
90,Fail,52,23,4,13,39
90,Fail,40,30,0,18,22
90,Fail,45,25,1,17,28
90,Fail,48,32,1,8,40
90,Fail,49,23,1,14,35
90,Fail,50,28,0,11,39
90,Fail,43,30,4,10,33
90,Fail,48,30,0,11,37
90,Fail,52,21,7,11,41
90,Fail,54,23,1,8,46
90,Fail,50,24,0,12,38
90,Fail,52,23,0,13,39
90,Fail,46,30,7,7,39
90,Fail,46,28,0,16,30
90,Fail,46,30,2,13,33
90,Fail,47,27,2,12,35
90,Fail,45,31,0,14,31
90,Fail,53,28,1,5,48
90,Fail,49,36,0,9,40
90,Fail,58,15,4,10,48
90,Fail,47,30,6,9,38
90,Fail,53,22,1,13,40
90,Fail,41,23,8,20,21
90,Fail,41,33,5,13,28
90,Fail,46,25,5,14,32
90,Fail,50,26,2,13,37
90,Fail,43,32,0,17,26
90,Fail,43,30,6,15,28
90,Fail,52,22,2,13,39
90,Fail,50,30,1,7,43
90,Fail,48,32,0,9,39
90,Fail,48,18,13,9,39
90,Fail,46,38,0,10,36
90,Fail,50,27,0,8,42
90,Fail,50,27,4,8,42
90,Fail,46,28,0,14,32
90,Fail,52,24,4,8,44
90,Fail,55,21,0,13,42
90,Fail,47,33,0,11,36
90,Fail,48,27,4,6,42
90,Fail,40,29,5,16,24
90,Fail,47,32,0,12,35
90,Fail,42,40,0,10,32
90,Fail,49,23,0,14,35
90,Fail,46,33,3,10,36
90,Fail,39,36,0,9,30
90,Fail,54,25,0,7,47
90,Fail,42,38,0,13,29
90,Fail,47,27,0,13,34
90,Fail,47,24,2,14,33
90,Fail,48,32,0,9,39
90,Fail,43,23,10,18,25
90,Fail,44,35,0,12,32
90,Fail,57,25,0,8,49
90,Fail,52,29,0,9,43
90,Fail,38,39,0,15,23
90,Fail,52,31,0,6,46
90,Fail,47,26,2,10,37
90,Fail,48,27,0,15,33
90,Fail,50,27,1,16,34
90,Fail,47,24,4,15,32
90,Fail,50,31,0,9,41
90,Fail,49,30,0,13,36
90,Fail,47,36,0,7,40
90,Fail,46,28,0,12,34
90,Fail,56,23,3,8,48
90,Fail,47,27,0,12,35
90,Fail,47,24,1,16,31
90,Fail,52,20,2,13,39
90,Fail,46,30,0,10,36
90,Fail,60,21,0,4,56
90,Fail,50,19,4,13,37
90,Fail,43,39,0,9,34
90,Fail,44,33,0,16,28
90,Fail,47,22,5,14,33
90,Fail,49,26,1,13,36
90,Fail,54,22,0,10,44
90,Fail,54,25,0,6,48
90,Fail,48,22,2,13,35
90,Fail,46,29,0,13,33
90,Fail,43,31,8,10,33
90,Fail,43,36,0,11,32
90,Fail,48,35,0,8,40
90,Fail,44,33,6,8,36
90,Fail,45,35,0,14,31
90,Fail,43,30,0,17,26
90,Fail,48,28,0,16,32
90,Fail,44,25,11,13,31
90,Fail,57,23,0,9,48
90,Fail,51,26,1,8,43
90,Fail,43,37,0,11,32
90,Fail,41,32,0,15,26
90,Fail,45,24,1,20,25
90,Fail,52,26,1,9,43
90,Fail,50,21,5,13,37
90,Fail,50,24,0,13,37
90,Fail,52,26,0,11,41
90,Fail,54,25,3,12,42
90,Fail,53,21,1,12,41
90,Fail,47,27,0,14,33
90,Fail,42,31,0,15,27
90,Fail,47,25,8,9,38
90,Fail,52,33,0,7,45
90,Fail,48,25,3,13,35
90,Fail,50,32,0,8,42
90,Fail,51,21,7,13,38
90,Fail,49,32,0,14,35
90,Fail,50,25,0,16,34
90,Fail,50,28,2,9,41
90,Fail,40,24,8,16,24
90,Fail,47,24,1,13,34
90,Fail,46,24,0,17,29
90,Fail,42,32,0,20,22
90,Fail,49,22,1,15,34
90,Fail,54,17,3,12,42
90,Fail,53,18,10,8,45
90,Fail,55,19,2,14,41
90,Fail,49,22,0,20,29
90,Fail,52,27,0,14,38
90,Fail,52,21,3,10,42
90,Fail,50,26,1,12,38
90,Fail,49,23,4,16,33
90,Fail,50,21,7,13,37
90,Fail,42,31,0,17,25
90,Fail,48,30,3,10,38
90,Fail,53,17,2,15,38
90,Fail,52,20,9,7,45
90,Fail,59,19,3,5,54
90,Fail,48,28,0,11,37
90,Fail,47,30,0,12,35
90,Fail,52,22,0,13,39
90,Fail,46,28,3,10,36
90,Fail,45,25,7,9,36
90,Fail,47,26,0,14,33
90,Fail,52,26,0,10,42
90,Fail,47,30,0,11,36
90,Fail,47,27,0,14,33
90,Fail,49,24,0,13,36
90,Fail,43,32,4,12,31
90,Fail,47,29,0,15,32
90,Fail,50,26,1,12,38
90,Fail,62,18,0,9,53
90,Fail,39,28,14,11,28
90,Fail,49,30,3,8,41
90,Fail,41,33,0,17,24
90,Fail,48,23,0,19,29
90,Fail,46,27,1,16,30
90,Fail,45,31,0,15,30
90,Fail,54,19,3,9,45
90,Fail,48,31,0,11,37
90,Fail,45,33,0,15,30
90,Fail,45,24,2,16,29
90,Fail,51,27,3,8,43
90,Fail,49,27,0,12,37
90,Fail,46,40,0,7,39
90,Fail,43,27,2,17,26
90,Fail,50,26,3,13,37
90,Fail,44,28,2,14,30
90,Fail,32,37,6,14,18
90,Fail,46,30,2,12,34
90,Fail,49,27,0,11,38
90,Fail,42,30,0,14,28
90,Fail,49,23,2,13,36
90,Fail,49,22,1,18,31
90,Fail,48,27,0,16,32
90,Fail,41,35,0,17,24
90,Fail,47,32,0,13,34
90,Fail,52,20,1,15,37
90,Fail,52,20,0,17,35
90,Fail,47,28,0,14,33
90,Fail,51,19,0,18,33
90,Fail,50,22,3,15,35
90,Fail,45,32,2,12,33
90,Fail,48,22,5,15,33
90,Fail,43,38,0,8,35
90,Fail,48,30,0,11,37
90,Fail,49,28,0,11,38
90,Fail,50,33,0,10,40
90,Fail,39,25,5,16,23
90,Fail,50,30,4,9,41
90,Fail,42,25,11,13,29
90,Fail,53,23,1,11,42
90,Fail,51,27,2,11,40
90,Fail,46,30,0,15,31
90,Fail,51,25,0,13,38
90,Fail,49,25,0,14,35
90,Fail,45,34,0,12,33
90,Fail,41,31,6,15,26
90,Fail,47,31,0,11,36
90,Fail,40,30,0,19,21
90,Fail,52,23,6,12,40
90,Fail,45,30,0,18,27
90,Fail,36,41,0,13,23
90,Fail,51,25,0,12,39
90,Fail,44,33,5,7,37
90,Fail,45,39,0,8,37
90,Fail,46,36,0,11,35
90,Fail,42,31,10,10,32
90,Fail,45,29,0,15,30
90,Fail,45,39,0,10,35
90,Fail,41,27,14,13,28
90,Fail,41,31,5,13,28
90,Fail,45,26,0,15,30
90,Fail,41,21,11,19,22
90,Fail,39,30,10,14,25
90,Fail,38,30,4,19,19
90,Fail,48,29,2,11,37
90,Fail,54,24,0,13,41
90,Fail,46,28,3,10,36
90,Fail,40,37,0,13,27
90,Fail,48,25,0,16,32
90,Fail,48,26,0,14,34
90,Fail,49,29,0,12,37
90,Fail,49,25,0,15,34
90,Fail,53,29,1,4,49
90,Fail,43,34,3,13,30
90,Fail,43,38,0,12,31
90,Fail,47,29,0,12,35
90,Fail,53,22,0,14,39
90,Fail,51,21,4,10,41
90,Fail,44,32,0,15,29
90,Fail,49,30,0,11,38
90,Fail,49,28,0,11,38
90,Fail,41,33,7,8,33
90,Fail,46,32,0,14,32
90,Fail,48,22,2,15,33
90,Fail,44,38,0,9,35
90,Fail,48,32,0,9,39
90,Fail,50,23,0,15,35
90,Fail,46,35,0,9,37
90,Fail,59,13,3,10,49
90,Fail,57,17,2,13,44
90,Fail,49,24,0,13,36
90,Fail,46,23,0,17,29
90,Fail,46,29,8,11,35
90,Fail,41,40,0,12,29
90,Fail,51,28,0,11,40
90,Fail,52,19,3,19,33
90,Fail,46,20,6,15,31
90,Fail,50,29,0,14,36
90,Fail,46,23,1,16,30
90,Fail,44,39,0,11,33
90,Fail,46,31,0,11,35
90,Fail,50,29,0,15,35
90,Fail,53,23,5,8,45
90,Fail,46,33,0,10,36
90,Fail,45,23,4,15,30
90,Fail,53,20,1,11,42
90,Fail,59,16,0,13,46
90,Fail,45,27,0,15,30
90,Fail,55,19,0,11,44
90,Fail,45,33,1,11,34
90,Fail,52,24,0,12,40
90,Fail,49,34,0,7,42
90,Fail,45,25,5,12,33
90,Fail,50,30,0,9,41
90,Fail,44,25,3,15,29
90,Fail,50,29,0,13,37
90,Fail,50,20,3,16,34
90,Fail,47,29,8,11,36
90,Fail,48,29,1,13,35
90,Fail,56,27,0,5,51
90,Fail,38,28,2,18,20
90,Fail,49,25,3,14,35
90,Fail,48,25,0,14,34
90,Fail,52,23,0,13,39
90,Fail,54,18,1,17,37
90,Fail,46,34,0,10,36
90,Fail,46,30,6,10,36
90,Fail,47,22,9,11,36
90,Fail,40,33,0,18,22
90,Fail,44,30,0,16,28
90,Fail,52,19,1,15,37
90,Fail,46,33,0,14,32
90,Fail,51,22,3,13,38
90,Fail,51,24,0,13,38
90,Fail,51,33,0,6,45
90,Fail,50,26,6,11,39
90,Fail,48,24,5,14,34
90,Fail,52,20,3,9,43
90,Fail,49,22,5,15,34
90,Fail,47,33,4,7,40
90,Fail,54,23,1,9,45
90,Fail,53,25,1,11,42
90,Fail,48,31,0,9,39
90,Fail,45,31,3,11,34
90,Fail,47,27,0,15,32
90,Fail,49,27,0,15,34
90,Fail,50,23,1,14,36
90,Fail,54,19,0,14,40
90,Fail,57,22,3,5,52
90,Fail,49,25,6,11,38
90,Fail,47,36,0,8,39
90,Fail,53,21,0,17,36
90,Fail,47,32,0,15,32
90,Fail,41,39,2,11,30
90,Fail,50,27,0,12,38
90,Fail,42,32,8,15,27
90,Fail,51,20,6,14,37
90,Fail,57,20,0,12,45
90,Fail,53,27,0,10,43
90,Fail,45,32,8,11,34
90,Fail,37,34,0,17,20
90,Fail,53,23,1,10,43
90,Fail,42,29,1,18,24
90,Fail,46,27,0,21,25
90,Fail,47,25,0,18,29
90,Fail,47,18,7,14,33
90,Fail,58,22,0,8,50
90,Fail,52,27,0,12,40
90,Fail,53,26,0,10,43
90,Fail,47,27,5,11,36
90,Fail,45,27,2,17,28
90,Fail,44,42,0,6,38
90,Fail,45,26,4,13,32
90,Fail,52,21,0,15,37
90,Fail,45,24,4,17,28
90,Fail,45,33,0,13,32
90,Fail,39,39,0,9,30
90,Fail,57,17,5,11,46
90,Fail,47,24,0,19,28
90,Fail,48,31,5,8,40
90,Fail,35,41,0,19,16
90,Fail,50,31,3,8,42
90,Fail,42,26,3,20,22
90,Fail,50,31,0,10,40
90,Fail,43,35,0,11,32
90,Fail,53,24,0,10,43
90,Fail,45,34,0,13,32
90,Fail,51,30,0,7,44
90,Fail,55,21,0,12,43
90,Fail,39,34,0,18,21
90,Fail,50,23,0,16,34
90,Fail,52,19,3,16,36
90,Fail,51,22,1,10,41
90,Fail,45,27,1,16,29
90,Fail,44,25,13,11,33
90,Fail,41,24,10,19,22
90,Fail,52,28,3,11,41
90,Fail,51,29,0,7,44
90,Fail,44,27,5,15,29
90,Fail,55,17,4,13,42
90,Fail,50,27,0,12,38
90,Fail,43,28,6,12,31
90,Fail,44,22,14,15,29
90,Fail,51,27,0,11,40
90,Fail,46,27,1,11,35
90,Fail,46,28,6,10,36
90,Fail,50,26,6,7,43
90,Fail,51,28,4,8,43
90,Fail,51,28,2,6,45
90,Fail,54,19,4,11,43
90,Fail,47,31,0,11,36
90,Fail,49,27,0,12,37
90,Fail,57,16,4,7,50
90,Fail,55,19,2,14,41
90,Fail,53,22,4,11,42
90,Fail,37,29,12,8,29
90,Fail,55,26,0,11,44
90,Fail,53,25,0,8,45
90,Fail,53,27,0,10,43
90,Fail,54,22,0,13,41
90,Fail,52,17,3,17,35
90,Fail,43,33,0,12,31
90,Fail,46,30,0,13,33
90,Fail,42,25,4,12,30
90,Fail,48,27,0,11,37
90,Fail,42,36,0,14,28
90,Fail,48,23,7,13,35
90,Fail,46,22,8,11,35
90,Fail,47,31,0,14,33
90,Fail,52,23,0,10,42
90,Fail,48,22,5,15,33
90,Fail,49,24,0,14,35
90,Fail,45,30,5,12,33
90,Fail,57,13,2,14,43
90,Fail,45,23,6,13,32
90,Fail,46,26,11,7,39
90,Fail,49,24,6,14,35
90,Fail,45,26,6,13,32
90,Fail,57,14,6,13,44
90,Fail,62,19,3,6,56
90,Fail,53,27,0,10,43
90,Fail,47,23,5,15,32
90,Fail,44,28,2,16,28
90,Fail,43,23,12,15,28
90,Fail,48,22,8,12,36
90,Fail,44,36,0,8,36
90,Fail,47,24,0,21,26
90,Fail,51,22,4,16,35
90,Fail,49,27,0,11,38
90,Fail,48,26,0,10,38
90,Fail,46,34,0,7,39
90,Fail,51,22,6,11,40
90,Fail,49,24,0,12,37
90,Fail,50,22,7,11,39
90,Fail,50,23,0,18,32
90,Fail,54,27,0,11,43
90,Fail,48,25,0,15,33
90,Fail,40,38,0,14,26
90,Fail,45,33,0,14,31
90,Fail,49,24,0,14,35
90,Fail,51,28,1,9,42
90,Fail,52,30,0,7,45
90,Fail,43,29,0,16,27
90,Fail,50,23,4,9,41
90,Fail,51,27,0,11,40
90,Fail,55,21,4,10,45
90,Fail,50,26,0,12,38
90,Fail,53,24,0,12,41
90,Fail,48,26,5,14,34
90,Fail,49,30,7,8,41
90,Fail,44,27,6,13,31
90,Fail,50,27,0,9,41
90,Fail,48,23,9,12,36
90,Fail,45,27,5,10,35
90,Fail,51,19,6,11,40
90,Fail,51,29,0,6,45
90,Fail,52,28,0,10,42
90,Fail,42,37,0,14,28
90,Fail,49,28,0,13,36
90,Fail,43,27,7,11,32
90,Fail,46,23,9,15,31
90,Fail,42,31,2,13,29
90,Fail,46,35,0,7,39
90,Fail,41,27,6,16,25
90,Fail,49,29,0,8,41
90,Fail,50,30,0,9,41
90,Fail,45,32,0,18,27
90,Fail,46,26,1,10,36
90,Fail,49,23,0,17,32
90,Fail,39,32,0,14,25
90,Fail,60,18,0,11,49
90,Fail,53,25,0,11,42
90,Fail,56,18,0,12,44
90,Fail,44,25,2,15,29
90,Fail,47,28,4,7,40
90,Fail,50,21,0,16,34
90,Fail,43,39,0,9,34
90,Fail,46,25,7,15,31
90,Fail,54,25,0,9,45
90,Fail,42,30,0,19,23
90,Fail,51,18,1,18,33
90,Fail,49,25,2,15,34
90,Fail,41,28,5,15,26
90,Fail,47,30,0,10,37
90,Fail,47,29,1,12,35
90,Fail,42,34,0,12,30
90,Fail,52,28,0,11,41
90,Fail,53,22,2,14,39
90,Fail,52,22,0,14,38
90,Fail,46,27,7,12,34
90,Fail,47,26,5,8,39
90,Fail,46,30,3,11,35
90,Fail,48,30,0,10,38
90,Fail,45,28,2,11,34
90,Fail,50,24,4,9,41
90,Fail,50,25,0,11,39
90,Fail,45,31,0,15,30
90,Fail,42,26,12,11,31
90,Fail,60,20,2,8,52
90,Fail,47,35,0,9,38
90,Fail,55,23,3,9,46
90,Fail,55,24,0,8,47
90,Fail,47,27,2,15,32
90,Fail,53,29,0,10,43
90,Fail,38,36,0,14,24
90,Fail,49,22,1,15,34
90,Fail,43,30,0,16,27
90,Fail,48,22,6,13,35
90,Fail,48,29,0,12,36
90,Fail,50,21,6,12,38
90,Fail,42,32,3,15,27
90,Fail,47,32,0,10,37
90,Fail,54,21,0,13,41
90,Fail,48,34,0,6,42
90,Fail,50,21,0,15,35
90,Fail,41,42,0,9,32
90,Fail,50,26,0,15,35
90,Fail,40,30,9,13,27
90,Fail,50,26,6,10,40
90,Fail,50,24,5,9,41
90,Fail,46,28,0,12,34
90,Fail,47,27,6,9,38
90,Fail,39,35,0,16,23
90,Fail,41,29,9,13,28
90,Fail,47,30,0,15,32
90,Fail,56,22,0,11,45
90,Fail,51,28,0,9,42
90,Fail,47,32,7,8,39
90,Fail,43,38,0,12,31
90,Fail,42,38,0,11,31
90,Fail,47,34,0,7,40
90,Fail,50,26,0,10,40
90,Fail,56,24,1,6,50
90,Fail,52,24,0,14,38
90,Fail,38,33,6,15,23
90,Fail,41,29,7,13,28
90,Fail,51,21,0,15,36
90,Fail,61,19,4,7,54
90,Fail,48,33,0,9,39
90,Fail,49,25,0,11,38
90,Fail,48,20,0,17,31
90,Fail,44,24,3,19,25
90,Fail,56,22,3,10,46
90,Fail,47,28,0,14,33
90,Fail,48,28,0,14,34
90,Fail,50,27,0,16,34
90,Fail,42,23,6,22,20
90,Fail,46,29,0,14,32
90,Fail,50,27,3,12,38
90,Fail,52,32,0,6,46
90,Fail,55,23,2,13,42
90,Fail,48,23,3,16,32
90,Fail,53,22,0,9,44
90,Fail,44,39,0,9,35
90,Fail,46,25,8,13,33
90,Fail,41,32,9,12,29
90,Fail,46,31,6,6,40
90,Fail,48,29,0,13,35
90,Fail,54,20,9,9,45
90,Fail,51,27,0,11,40
90,Fail,57,28,0,9,48
90,Fail,56,23,1,7,49
90,Fail,47,28,4,13,34
90,Fail,49,28,4,12,37
90,Fail,47,18,10,16,31
90,Fail,46,28,1,13,33
90,Fail,54,23,0,8,46
90,Fail,50,20,6,12,38
90,Fail,43,27,8,13,30
90,Fail,44,31,0,14,30
90,Fail,48,24,5,8,40
90,Fail,58,13,4,13,45
90,Fail,48,30,0,9,39
90,Fail,39,39,0,15,24
90,Fail,49,33,0,10,39
90,Fail,46,31,1,13,33
90,Fail,47,25,1,15,32
90,Fail,50,25,0,13,37
90,Fail,47,27,0,14,33
90,Fail,47,30,0,12,35
90,Fail,48,36,0,8,40
90,Fail,47,23,0,20,27
90,Fail,52,21,0,14,38
90,Fail,55,16,2,18,37
90,Fail,50,27,0,10,40
90,Fail,51,26,1,11,40
90,Fail,48,28,0,9,39
90,Fail,49,29,0,12,37
90,Fail,51,21,0,17,34
90,Fail,48,29,0,9,39
90,Fail,41,30,0,12,29
90,Fail,45,27,5,12,33
90,Fail,47,30,3,11,36
90,Fail,52,26,0,11,41
90,Fail,49,24,2,10,39
90,Fail,47,21,9,15,32
90,Fail,43,33,0,16,27
90,Fail,51,20,0,12,39
90,Fail,52,26,0,14,38
90,Fail,52,33,0,8,44
90,Fail,48,23,4,13,35
90,Fail,47,25,0,18,29
90,Fail,51,24,0,12,39
90,Fail,44,31,0,9,35
90,Fail,44,39,0,6,38
90,Fail,37,33,6,10,27
90,Fail,49,24,0,12,37
90,Fail,52,23,0,13,39
90,Fail,56,25,0,10,46
90,Fail,46,31,0,11,35
90,Fail,49,23,3,13,36
90,Fail,51,31,0,9,42
90,Fail,48,23,0,14,34
90,Fail,53,24,0,9,44
90,Fail,42,25,2,17,25
90,Fail,44,30,8,10,34
90,Fail,49,20,3,14,35
90,Fail,47,31,0,10,37
90,Fail,41,26,6,20,21
90,Fail,43,32,0,15,28
90,Fail,59,20,4,6,53
90,Fail,48,35,0,11,37
90,Fail,48,31,0,11,37
90,Fail,50,29,1,9,41
90,Fail,49,30,0,14,35
90,Fail,46,25,7,13,33
90,Fail,43,26,4,17,26
90,Fail,48,31,0,11,37
90,Fail,51,23,1,15,36
90,Fail,46,31,5,9,37
90,Fail,51,18,3,17,34
90,Fail,44,31,0,15,29
90,Fail,50,22,1,16,34
90,Fail,40,33,2,16,24
90,Fail,40,34,0,14,26
90,Fail,49,32,0,12,37
90,Fail,45,26,3,12,33
90,Fail,45,33,0,10,35
90,Fail,52,22,4,8,44
90,Fail,52,23,1,10,42
90,Fail,49,23,8,11,38
90,Fail,47,27,6,13,34
90,Fail,47,20,6,17,30
90,Fail,49,29,2,8,41
90,Fail,51,25,0,9,42
90,Fail,50,30,0,9,41
90,Fail,51,24,6,10,41
90,Fail,46,33,0,10,36
90,Fail,50,23,6,10,40
90,Fail,44,30,0,13,31
90,Fail,46,29,4,14,32
90,Fail,49,26,3,11,38
90,Fail,43,36,4,9,34
90,Fail,46,24,5,19,27
90,Fail,49,22,8,8,41
90,Fail,47,27,0,16,31
90,Fail,49,29,0,11,38
90,Fail,47,32,0,13,34
90,Fail,43,41,0,7,36
90,Fail,48,27,0,14,34
90,Fail,48,25,3,11,37
90,Fail,49,28,0,7,42
90,Fail,49,29,0,8,41
90,Fail,50,19,1,15,35
90,Fail,56,23,1,7,49
90,Fail,46,32,0,14,32
90,Fail,46,25,5,13,33
90,Fail,53,19,6,13,40
90,Fail,51,27,0,9,42
90,Fail,48,23,5,14,34
90,Fail,49,23,1,11,38
90,Fail,47,27,0,12,35
90,Fail,49,30,0,11,38
90,Fail,45,27,0,16,29
90,Fail,49,29,2,9,40
90,Fail,52,29,0,11,41
90,Fail,49,24,7,13,36
90,Fail,57,22,0,7,50
90,Fail,50,23,0,14,36
90,Fail,51,26,5,5,46
90,Fail,46,32,0,11,35
90,Fail,48,23,2,14,34
90,Fail,46,31,4,10,36
90,Fail,41,26,14,13,28
90,Fail,52,30,0,12,40
90,Fail,52,29,3,3,49
90,Fail,55,25,0,12,43
90,Fail,51,21,0,12,39
90,Fail,49,27,0,13,36
90,Fail,54,14,1,21,33
90,Fail,41,31,6,13,28
90,Fail,53,27,0,9,44
90,Fail,47,30,0,11,36
90,Fail,52,23,0,14,38
90,Fail,51,22,0,14,37
90,Fail,47,30,0,11,36
90,Fail,43,30,0,17,26
90,Fail,45,35,0,10,35
90,Fail,46,27,2,18,28
90,Fail,45,35,0,5,40
90,Fail,54,21,0,12,42
90,Fail,48,20,5,19,29
90,Fail,54,23,1,11,43
90,Fail,46,33,0,10,36
90,Fail,48,30,6,7,41
90,Fail,47,26,5,13,34
90,Fail,51,26,1,9,42
90,Fail,50,23,1,10,40
90,Fail,37,29,2,21,16
90,Fail,44,27,0,18,26
90,Fail,57,24,0,8,49
90,Fail,46,38,0,11,35
90,Fail,48,27,2,11,37
90,Fail,44,30,0,17,27
90,Fail,50,28,2,14,36
90,Fail,46,31,0,12,34
90,Fail,50,27,0,9,41
90,Fail,48,18,2,21,27
90,Fail,44,30,0,18,26
90,Fail,54,22,1,10,44
90,Fail,51,24,4,12,39
90,Fail,51,24,1,17,34
90,Fail,50,20,9,14,36
90,Fail,48,30,8,7,41
90,Fail,53,27,0,9,44
90,Fail,42,34,0,13,29
90,Fail,46,26,0,14,32
90,Fail,50,28,2,8,42
90,Fail,40,32,0,17,23
90,Fail,42,30,6,13,29
90,Fail,53,27,0,10,43
90,Fail,40,24,1,22,18
90,Fail,56,20,0,13,43
90,Fail,50,27,0,9,41
90,Fail,41,36,4,11,30
90,Fail,54,16,4,18,36
90,Fail,44,41,0,7,37
90,Fail,53,30,0,7,46
90,Fail,49,29,2,9,40
90,Fail,46,27,10,8,38
90,Fail,45,19,8,14,31
90,Fail,49,28,0,9,40
90,Fail,52,22,8,11,41
90,Fail,43,35,0,14,29
90,Fail,43,31,2,12,31
90,Fail,47,29,1,9,38
90,Fail,48,27,5,15,33
90,Fail,48,30,0,9,39
90,Fail,50,23,7,13,37
90,Fail,51,30,0,9,42
90,Fail,48,17,9,15,33
90,Fail,47,27,1,9,38
90,Fail,48,30,1,10,38
90,Fail,40,34,0,15,25
90,Fail,43,32,1,15,28
90,Fail,51,31,0,9,42
90,Fail,45,30,0,15,30
90,Fail,49,24,1,11,38
90,Fail,48,33,0,14,34
90,Fail,48,33,0,7,41
90,Fail,50,28,0,7,43
90,Fail,43,32,1,15,28
90,Fail,50,26,1,11,39
90,Fail,46,25,10,11,35
90,Fail,49,26,0,11,38
90,Fail,46,32,5,6,40
90,Fail,50,32,0,6,44
90,Fail,42,26,10,14,28
90,Fail,52,24,0,12,40
90,Fail,57,21,2,8,49
90,Fail,47,27,0,10,37
90,Fail,53,26,0,11,42
90,Fail,44,33,3,8,36
90,Fail,51,28,0,8,43
90,Fail,43,29,2,15,28
90,Fail,48,26,0,11,37
90,Fail,52,28,0,6,46
90,Fail,54,21,0,11,43
90,Fail,50,27,5,12,38
90,Fail,53,27,0,12,41
90,Fail,44,27,3,11,33
90,Fail,50,31,0,12,38
90,Fail,56,18,0,13,43
90,Fail,48,30,0,13,35
90,Fail,47,26,0,16,31
90,Fail,42,32,0,13,29
90,Fail,48,32,0,10,38
90,Fail,54,17,1,13,41
90,Fail,47,28,0,14,33
90,Fail,49,31,0,10,39
90,Fail,53,17,0,18,35
90,Fail,48,34,0,10,38
90,Fail,48,29,0,12,36
90,Fail,54,28,0,7,47
90,Fail,44,29,4,14,30
90,Fail,46,30,9,7,39
90,Fail,42,36,0,11,31
90,Fail,46,26,0,13,33
90,Fail,42,36,0,15,27
90,Fail,48,32,0,12,36
90,Fail,39,33,0,16,23
90,Fail,45,29,0,13,32
90,Fail,44,30,0,20,24
90,Fail,47,22,9,15,32
90,Fail,45,29,0,13,32
90,Fail,45,27,6,14,31
90,Fail,41,31,8,10,31
90,Fail,48,37,0,8,40
90,Fail,52,26,0,15,37
90,Fail,52,26,0,7,45
90,Fail,45,30,5,12,33
90,Fail,54,25,4,10,44
90,Fail,53,26,1,10,43
90,Fail,48,23,7,11,37
90,Fail,57,15,4,11,46
90,Fail,45,32,0,13,32
90,Fail,49,30,1,12,37
90,Fail,50,26,0,13,37
90,Fail,39,38,0,11,28
90,Fail,56,21,2,11,45
90,Fail,51,28,4,13,38
90,Fail,51,18,12,10,41
90,Fail,51,34,0,10,41
90,Fail,48,30,0,11,37
90,Fail,52,21,5,11,41
90,Fail,44,38,0,9,35
90,Fail,37,39,0,14,23
90,Fail,48,25,7,13,35
90,Fail,53,27,0,9,44
90,Fail,52,22,0,15,37
90,Fail,43,31,0,14,29
90,Fail,50,25,3,7,43
90,Fail,45,35,0,8,37
90,Fail,45,27,1,18,27
90,Fail,41,28,9,12,29
90,Fail,52,26,0,10,42
90,Fail,44,29,0,15,29
90,Fail,46,27,7,10,36
90,Fail,50,31,0,12,38
90,Fail,48,26,5,13,35
90,Fail,47,23,5,16,31
90,Fail,41,32,0,17,24
90,Fail,45,28,0,16,29
90,Fail,42,34,2,14,28
90,Fail,44,30,0,13,31
90,Fail,46,26,4,13,33
90,Fail,44,29,2,12,32
90,Fail,39,28,8,11,28
90,Fail,52,23,3,11,41
90,Fail,40,27,4,16,24
90,Fail,38,32,7,14,24
90,Fail,46,30,1,9,37
90,Fail,51,27,3,10,41
90,Fail,49,27,0,12,37
90,Fail,45,29,0,14,31
90,Fail,48,23,5,17,31
90,Fail,55,20,2,12,43
90,Fail,45,32,0,12,33
90,Fail,55,19,1,13,42
90,Fail,46,28,0,16,30
90,Fail,40,34,0,13,27
90,Fail,50,24,0,16,34
90,Fail,46,28,3,11,35
90,Fail,45,32,0,16,29
90,Fail,45,31,0,13,32
90,Fail,45,25,6,14,31
90,Fail,57,21,6,5,52
90,Fail,48,21,3,15,33
90,Fail,55,24,0,7,48
90,Fail,53,26,0,10,43
90,Fail,45,31,0,16,29
90,Fail,44,37,0,10,34
90,Fail,43,30,3,15,28
90,Fail,53,23,6,10,43
90,Fail,56,19,1,13,43
90,Fail,46,30,2,12,34
90,Fail,58,19,1,8,50
90,Fail,46,36,0,14,32
90,Fail,52,28,0,9,43
90,Fail,51,20,2,13,38
90,Fail,54,24,0,12,42
90,Fail,46,25,0,16,30
90,Fail,45,27,6,10,35
90,Fail,50,25,0,14,36
90,Fail,42,29,7,12,30
90,Fail,56,17,3,13,43
90,Fail,51,35,0,6,45
90,Fail,49,28,0,7,42
90,Fail,45,33,0,11,34
90,Fail,46,26,1,16,30
90,Fail,44,35,0,13,31
90,Fail,46,24,2,15,31
90,Fail,47,22,0,22,25
90,Fail,54,24,6,10,44
90,Fail,51,29,0,11,40
90,Fail,46,27,0,11,35
90,Fail,55,18,12,7,48
90,Fail,51,31,0,8,43
90,Fail,51,25,0,9,42
90,Fail,50,33,0,12,38
90,Fail,47,30,0,11,36
90,Fail,50,24,3,9,41
90,Fail,56,18,0,10,46
90,Fail,36,41,0,17,19
90,Fail,45,23,6,13,32
90,Fail,54,24,0,8,46
90,Fail,57,24,3,6,51
90,Fail,50,29,2,7,43
90,Fail,48,28,0,10,38
90,Fail,52,18,0,16,36
90,Fail,53,19,12,8,45
90,Fail,49,23,0,18,31
90,Fail,45,23,2,20,25
90,Fail,58,16,6,10,48
90,Fail,46,36,0,13,33
90,Fail,52,24,0,13,39
90,Fail,42,37,0,9,33
90,Fail,58,20,2,10,48
90,Fail,47,22,12,13,34
90,Fail,51,25,2,10,41
90,Fail,49,24,0,14,35
90,Fail,56,29,0,8,48
90,Fail,42,35,0,12,30
90,Fail,47,23,4,21,26
90,Fail,53,26,0,9,44
90,Fail,52,21,0,18,34
90,Fail,45,24,10,12,33
90,Fail,46,26,0,16,30
90,Fail,56,19,4,9,47
90,Fail,46,27,10,4,42
90,Fail,52,17,5,13,39
90,Fail,42,34,0,14,28
90,Fail,43,35,1,10,33
90,Fail,55,21,0,15,40
90,Fail,52,29,0,9,43
90,Fail,45,33,0,12,33
90,Fail,50,20,3,12,38
90,Fail,48,17,1,18,30
90,Fail,44,24,11,13,31
90,Fail,43,29,4,10,33
90,Fail,56,18,6,11,45
90,Fail,62,18,0,5,57
90,Fail,48,29,4,10,38
90,Fail,55,18,2,16,39
90,Fail,51,26,1,11,40
90,Fail,49,26,6,10,39
90,Fail,48,23,2,16,32
90,Fail,45,38,0,12,33
90,Fail,41,28,13,10,31
90,Fail,43,33,8,8,35
90,Fail,50,26,1,14,36
90,Fail,50,22,0,13,37
90,Fail,43,33,0,12,31
90,Fail,44,27,4,12,32
90,Fail,53,23,2,12,41
90,Fail,53,22,0,13,40
90,Fail,45,29,0,8,37
90,Fail,48,32,0,10,38
90,Fail,47,21,0,21,26
90,Fail,47,31,0,13,34
90,Fail,46,31,0,15,31
90,Fail,47,29,0,10,37
90,Fail,47,25,5,16,31
90,Fail,42,24,1,18,24
90,Fail,45,24,7,13,32
90,Fail,48,32,0,8,40
90,Fail,48,32,0,10,38
90,Fail,52,21,0,12,40
90,Fail,49,25,0,12,37
90,Fail,52,14,8,14,38
90,Fail,45,32,0,16,29
90,Fail,46,22,2,18,28
90,Fail,42,23,3,16,26
90,Fail,47,31,0,14,33
90,Fail,49,31,0,11,38
90,Fail,44,24,4,18,26
90,Fail,41,31,0,17,24
90,Fail,43,25,2,18,25
90,Fail,47,30,0,12,35
90,Fail,42,38,0,14,28
90,Fail,48,23,0,11,37
90,Fail,49,23,3,11,38
90,Fail,45,28,0,16,29
90,Fail,49,28,0,12,37
90,Fail,44,29,0,17,27
90,Fail,49,24,0,18,31
90,Fail,38,36,0,16,22
90,Fail,48,29,0,12,36
90,Fail,44,26,11,15,29
90,Fail,47,24,0,18,29
90,Fail,45,25,8,16,29
90,Fail,47,24,1,13,34
90,Fail,43,41,0,9,34
90,Fail,45,23,13,11,34
90,Fail,47,28,0,16,31
90,Fail,43,30,0,13,30
90,Fail,40,36,5,9,31
90,Fail,52,22,5,11,41
90,Fail,46,29,0,14,32
90,Fail,51,31,0,9,42
90,Fail,52,23,2,10,42
90,Fail,45,27,5,14,31
90,Fail,47,27,0,13,34
90,Fail,49,27,1,15,34
90,Fail,50,21,7,9,41
90,Fail,52,23,4,11,41
90,Fail,53,19,0,14,39
90,Fail,46,32,0,11,35
90,Fail,53,23,0,12,41
90,Fail,49,29,0,13,36
90,Fail,56,21,0,10,46
90,Fail,52,18,0,17,35
90,Fail,48,27,0,9,39
90,Fail,45,30,1,12,33
90,Fail,48,30,0,10,38
90,Fail,56,22,0,6,50
90,Fail,44,35,0,10,34
90,Fail,49,26,0,11,38
90,Fail,51,22,5,13,38
90,Fail,57,21,2,7,50
90,Fail,46,34,3,9,37
90,Fail,42,32,1,16,26
90,Fail,46,36,0,7,39
90,Fail,42,31,6,15,27
90,Fail,49,32,0,10,39
90,Fail,53,24,0,9,44
90,Fail,50,22,0,15,35
90,Fail,50,30,0,12,38
90,Fail,46,27,10,7,39
90,Fail,51,28,0,11,40
90,Fail,43,34,5,8,35
90,Fail,54,20,0,13,41
90,Fail,50,21,1,15,35
90,Fail,46,25,6,11,35
90,Fail,46,28,5,11,35
90,Fail,59,24,0,8,51
90,Fail,51,32,0,6,45
90,Fail,45,32,0,13,32
90,Fail,46,23,2,17,29
90,Fail,50,24,0,13,37
90,Fail,38,29,15,8,30
90,Fail,48,27,0,15,33
90,Fail,48,35,0,11,37
90,Fail,51,28,0,10,41
90,Fail,44,30,0,14,30
90,Fail,46,27,0,21,25
90,Fail,53,27,1,11,42
90,Fail,50,32,0,7,43
90,Fail,51,26,1,13,38
90,Fail,53,26,0,9,44
90,Fail,53,26,2,8,45
90,Fail,53,19,9,12,41
90,Fail,54,25,0,10,44
90,Fail,50,30,0,11,39
90,Fail,48,30,0,11,37
90,Fail,52,26,0,10,42
90,Fail,42,26,3,19,23
90,Fail,39,32,0,18,21
90,Fail,46,38,0,8,38
90,Fail,52,26,2,9,43
90,Fail,53,20,6,14,39
90,Fail,54,21,5,9,45
90,Fail,57,20,0,9,48
90,Fail,55,22,2,12,43
90,Fail,53,26,0,7,46
90,Fail,45,32,0,10,35
90,Fail,43,37,0,12,31
90,Fail,35,31,8,20,15
90,Fail,53,19,0,14,39
90,Fail,40,33,0,15,25
90,Fail,43,43,0,8,35
90,Fail,37,41,0,15,22
90,Fail,44,29,0,17,27
90,Fail,49,24,0,13,36
90,Fail,56,28,0,9,47
90,Fail,46,22,9,14,32
90,Fail,44,30,0,11,33
90,Fail,60,21,0,10,50
90,Fail,48,25,0,13,35
90,Fail,52,21,1,14,38
90,Fail,52,26,2,8,44
90,Fail,49,28,2,11,38
90,Fail,36,36,0,14,22
90,Fail,48,23,9,14,34
90,Fail,45,30,0,14,31
90,Fail,50,29,1,13,37
90,Fail,39,42,0,12,27
90,Fail,42,32,6,13,29
90,Fail,49,21,7,13,36
90,Fail,49,25,0,16,33
90,Fail,57,24,0,7,50
90,Fail,42,39,0,13,29
90,Fail,51,30,0,9,42
90,Fail,50,27,0,11,39
90,Fail,43,25,8,13,30
90,Fail,52,21,0,12,40
90,Fail,51,22,1,14,37
90,Fail,36,50,0,7,29
90,Fail,52,27,1,7,45
90,Fail,45,19,6,16,29
90,Fail,43,38,0,13,30
90,Fail,50,29,0,10,40
90,Fail,48,27,0,15,33
90,Fail,41,30,0,16,25
90,Fail,47,25,4,10,37
90,Fail,45,23,4,18,27
90,Fail,46,27,0,17,29
90,Fail,45,26,4,17,28
90,Fail,44,33,0,12,32
90,Fail,41,35,0,16,25
90,Fail,57,26,0,7,50
90,Fail,50,22,0,13,37
90,Fail,53,16,7,13,40
90,Fail,57,23,0,7,50
90,Fail,59,19,5,10,49
90,Fail,39,33,4,13,26
90,Fail,49,31,0,7,42
90,Fail,46,28,12,6,40
90,Fail,48,32,0,12,36
90,Fail,47,35,0,9,38
90,Fail,43,34,0,14,29
90,Fail,51,26,0,11,40
90,Fail,44,23,5,15,29
90,Fail,45,22,0,21,24
90,Fail,45,25,4,16,29
90,Fail,50,23,0,15,35
90,Fail,43,27,0,16,27
90,Fail,46,35,0,8,38
90,Fail,47,28,1,11,36
90,Fail,42,34,0,13,29
90,Fail,45,30,0,16,29
90,Fail,49,28,0,11,38
90,Fail,51,24,0,15,36
90,Fail,42,31,0,16,26
90,Fail,42,31,0,16,26
90,Fail,52,29,0,7,45
90,Fail,53,27,0,10,43
90,Fail,50,27,2,8,42
90,Fail,52,17,9,10,42
90,Fail,57,22,3,8,49
90,Fail,57,20,3,9,48
90,Fail,45,22,6,13,32
90,Fail,50,25,1,10,40
90,Fail,50,21,0,13,37
90,Fail,54,24,0,13,41
90,Fail,47,22,3,14,33
90,Fail,54,22,3,12,42
90,Fail,52,27,0,9,43
90,Fail,53,30,0,9,44
90,Fail,44,28,7,14,30
90,Fail,45,43,0,7,38
90,Fail,55,20,2,9,46
90,Fail,46,20,5,17,29
90,Fail,50,26,0,13,37
90,Fail,46,40,0,9,37
90,Fail,47,31,0,14,33
90,Fail,50,24,4,9,41
90,Fail,53,17,0,14,39
90,Fail,48,32,0,10,38
90,Fail,52,25,7,10,42
90,Fail,46,31,3,13,33
90,Fail,46,26,2,15,31
90,Fail,51,26,2,10,41
90,Fail,51,22,3,12,39
90,Fail,48,30,0,10,38
90,Fail,53,25,0,8,45
90,Fail,51,27,5,6,45
90,Fail,59,17,0,13,46
90,Fail,45,31,0,13,32
90,Fail,51,20,5,11,40
90,Fail,48,28,0,12,36
90,Fail,52,30,0,9,43
90,Fail,49,26,2,11,38
90,Fail,57,15,5,12,45
90,Fail,47,29,0,10,37
90,Fail,52,27,0,7,45
90,Fail,46,27,11,7,39
90,Fail,49,30,0,11,38
90,Fail,49,33,0,5,44
90,Fail,46,26,2,15,31
90,Fail,43,29,1,14,29
90,Fail,43,34,6,12,31
90,Fail,45,28,0,16,29
90,Fail,50,21,5,16,34
90,Fail,40,30,6,16,24
90,Fail,51,26,0,14,37
90,Fail,48,24,0,16,32
90,Fail,56,21,5,4,52
90,Fail,58,23,0,11,47
90,Fail,49,29,1,11,38
90,Fail,44,29,2,13,31
90,Fail,54,17,2,15,39
90,Fail,51,21,0,13,38
90,Fail,44,28,0,18,26
90,Fail,50,31,0,13,37
90,Fail,45,33,0,12,33
90,Fail,47,30,2,6,41
90,Fail,48,21,0,15,33
90,Fail,35,39,0,16,19
90,Fail,48,33,1,12,36
90,Fail,41,38,0,11,30
90,Fail,46,34,0,9,37
90,Fail,49,29,0,10,39
90,Fail,42,29,2,18,24
90,Fail,43,28,1,17,26
90,Fail,48,18,4,15,33
90,Fail,43,30,0,14,29
90,Fail,48,25,0,13,35
90,Fail,56,22,0,7,49
90,Fail,44,25,6,18,26
90,Fail,48,27,0,12,36
90,Fail,40,32,5,15,25
90,Fail,44,27,1,15,29
90,Fail,55,23,0,8,47
90,Fail,46,24,1,17,29
90,Fail,48,26,0,16,32
90,Fail,51,15,8,18,33
90,Fail,44,24,5,17,27
90,Fail,46,20,5,20,26
90,Fail,44,25,0,19,25
90,Fail,44,25,8,13,31
90,Fail,49,22,2,17,32
90,Fail,48,27,0,13,35
90,Fail,57,20,0,11,46
90,Fail,51,28,0,11,40
90,Fail,40,29,10,12,28
90,Fail,56,19,0,10,46
90,Fail,49,29,0,12,37
90,Fail,56,23,0,10,46
90,Fail,53,23,0,11,42
90,Fail,43,27,7,12,31
90,Fail,47,29,0,14,33
90,Fail,56,25,0,8,48
90,Fail,50,24,0,13,37
90,Fail,54,18,2,15,39
90,Fail,48,23,0,18,30
90,Fail,46,31,0,11,35
90,Fail,42,36,0,15,27
90,Fail,34,38,8,15,19
90,Fail,43,25,9,16,27
90,Fail,47,29,4,14,33
90,Fail,45,31,0,19,26
90,Fail,56,22,2,5,51
90,Fail,44,26,0,16,28
90,Fail,54,24,0,9,45
90,Fail,51,22,3,12,39
90,Fail,44,28,0,21,23
90,Fail,54,19,0,19,35
90,Fail,47,24,0,11,36
90,Fail,45,20,8,16,29
90,Fail,55,21,1,12,43
90,Fail,54,23,2,8,46
90,Fail,43,27,11,14,29
90,Fail,50,26,0,13,37
90,Fail,49,27,0,12,37
90,Fail,54,25,0,12,42
90,Fail,47,24,5,11,36
90,Fail,42,35,6,9,33
90,Fail,43,36,6,9,34
90,Fail,48,34,0,8,40
90,Fail,57,19,5,9,48
90,Fail,54,29,1,7,47
90,Fail,45,29,0,14,31
90,Fail,48,28,10,6,42
90,Fail,48,27,0,10,38
90,Fail,44,28,4,12,32
90,Fail,46,23,8,13,33
90,Fail,50,24,0,15,35
90,Fail,49,22,1,15,34
90,Fail,53,28,0,10,43
90,Fail,55,20,2,10,45
90,Fail,46,33,0,14,32
90,Fail,49,22,0,16,33
90,Fail,53,23,0,15,38
90,Fail,50,21,4,13,37
90,Fail,47,32,0,10,37
90,Fail,52,26,0,10,42
90,Fail,49,22,4,15,34
90,Fail,44,34,0,13,31
90,Fail,40,27,2,20,20
90,Fail,46,32,2,11,35
90,Fail,53,24,0,8,45
90,Fail,57,27,0,8,49
90,Fail,49,24,0,16,33
90,Fail,43,31,7,5,38
90,Fail,48,22,7,13,35
90,Fail,46,36,0,11,35
90,Fail,54,25,0,9,45
90,Fail,47,34,0,9,38
90,Fail,43,33,0,13,30
90,Fail,53,21,6,11,42
90,Fail,48,27,0,13,35
90,Fail,55,17,0,18,37
90,Fail,53,25,0,13,40
90,Fail,42,42,0,10,32
90,Fail,42,39,0,10,32
90,Fail,52,22,5,9,43
90,Fail,51,21,0,18,33
90,Fail,47,26,7,11,36
90,Fail,43,30,0,18,25
90,Fail,52,27,4,4,48
90,Fail,43,31,0,16,27
90,Fail,49,16,10,17,32
90,Fail,44,24,0,16,28
90,Fail,47,23,2,17,30
90,Fail,53,24,0,11,42
90,Fail,52,24,0,10,42
90,Fail,53,29,0,8,45
90,Fail,46,36,0,10,36
90,Fail,44,29,0,13,31
90,Fail,48,28,0,13,35
90,Fail,43,33,0,15,28
90,Fail,44,24,4,14,30
90,Fail,43,31,1,19,24
90,Fail,40,25,10,13,27
90,Fail,45,36,0,12,33
90,Fail,42,33,0,18,24
90,Fail,55,25,1,10,45
90,Fail,44,28,8,11,33
90,Fail,50,28,4,9,41
90,Fail,51,30,0,12,39
90,Fail,49,25,2,15,34
90,Fail,55,27,0,7,48
90,Fail,45,30,0,10,35
90,Fail,40,31,1,18,22
90,Fail,45,34,1,9,36
90,Fail,50,24,0,14,36
90,Fail,49,29,0,12,37
90,Fail,52,19,3,14,38
90,Fail,50,19,1,15,35
90,Fail,43,34,0,16,27
90,Fail,44,31,0,12,32
90,Fail,43,34,0,12,31
90,Fail,37,36,1,15,22
90,Fail,47,25,5,18,29
90,Fail,52,19,2,15,37
90,Fail,43,36,0,12,31
90,Fail,48,28,7,8,40
90,Fail,42,27,6,16,26
90,Fail,54,21,2,15,39
90,Fail,42,37,0,16,26
90,Fail,49,28,4,11,38
90,Fail,53,18,6,11,42
90,Fail,46,29,0,12,34
90,Fail,49,29,0,12,37
90,Fail,36,29,12,16,20
90,Fail,51,30,0,10,41
90,Fail,48,30,0,11,37
90,Fail,52,25,0,10,42
90,Fail,43,30,0,16,27
90,Fail,42,24,4,18,24
90,Fail,48,24,7,10,38
90,Fail,49,28,5,10,39
90,Fail,46,27,1,13,33
90,Fail,48,20,4,17,31
90,Fail,55,22,0,12,43
90,Fail,50,21,4,12,38
90,Fail,43,26,2,22,21
90,Fail,42,34,7,11,31
90,Fail,52,17,3,17,35
90,Fail,49,25,1,13,36
90,Fail,51,26,0,11,40
90,Fail,50,26,5,12,38
90,Fail,46,31,0,16,30
90,Fail,42,38,0,14,28
90,Fail,57,22,0,7,50
90,Fail,44,34,0,13,31
90,Fail,50,32,0,7,43
90,Fail,50,23,6,11,39
90,Fail,55,28,0,8,47
90,Fail,40,34,0,16,24
90,Fail,38,28,4,19,19
90,Fail,44,32,0,12,32
90,Fail,49,31,0,6,43
90,Fail,51,28,0,10,41
90,Fail,41,28,8,12,29
90,Fail,53,25,0,11,42
90,Fail,37,35,0,21,16
90,Fail,47,25,6,12,35
90,Fail,51,25,1,16,35
90,Fail,44,31,9,7,37
90,Fail,39,35,0,14,25
90,Fail,57,20,0,12,45
90,Fail,51,28,0,7,44
90,Fail,45,24,1,15,30
90,Fail,50,21,0,15,35
90,Fail,45,32,0,11,34
90,Fail,47,31,2,11,36
90,Fail,48,28,4,9,39
90,Fail,51,24,2,11,40
90,Fail,37,35,0,19,18
90,Fail,47,34,0,11,36
90,Fail,43,29,4,11,32
90,Fail,47,34,0,9,38
90,Fail,51,26,0,12,39
90,Fail,47,22,0,15,32
90,Fail,39,37,0,14,25
90,Fail,43,24,3,17,26
90,Fail,49,24,5,12,37
90,Fail,44,37,0,11,33
90,Fail,48,33,0,11,37
90,Fail,39,31,2,17,22
90,Fail,45,25,8,12,33
90,Fail,50,21,5,13,37
90,Fail,51,23,4,12,39
90,Fail,40,39,0,13,27
90,Fail,46,23,6,11,35
90,Fail,37,30,13,11,26
90,Fail,42,30,0,18,24
90,Fail,48,25,5,12,36
90,Fail,47,29,2,14,33
90,Fail,51,23,0,16,35
90,Fail,44,29,2,10,34
90,Fail,46,29,0,17,29
90,Fail,48,23,5,13,35
90,Fail,45,29,0,14,31
90,Fail,48,30,0,12,36
90,Fail,54,27,0,13,41
90,Fail,47,25,6,13,34
90,Fail,48,24,4,12,36
90,Fail,55,28,0,5,50
90,Fail,42,39,0,10,32
90,Fail,48,23,5,13,35
90,Fail,51,21,3,13,38
90,Fail,51,27,0,13,38
90,Fail,56,24,0,11,45
90,Fail,58,21,0,8,50
90,Fail,46,32,0,7,39
90,Fail,53,25,0,13,40
90,Fail,51,33,0,10,41
90,Fail,49,33,0,9,40
90,Fail,42,37,0,15,27
90,Fail,55,23,1,12,43
90,Fail,51,25,7,9,42
90,Fail,47,25,0,15,32
90,Fail,54,25,0,14,40
90,Fail,51,18,5,13,38
90,Fail,47,31,0,10,37
90,Fail,48,26,3,11,37
90,Fail,39,38,0,18,21
90,Fail,48,33,0,10,38
90,Fail,48,28,0,12,36
90,Fail,47,32,0,13,34
90,Fail,53,20,10,12,41
90,Fail,52,18,1,15,37
90,Fail,46,28,0,17,29
90,Fail,41,31,3,14,27
90,Fail,46,29,0,16,30
90,Fail,51,28,2,12,39
90,Fail,49,26,2,14,35
90,Fail,49,23,0,13,36
90,Fail,49,33,0,10,39
90,Fail,61,20,0,8,53
90,Fail,54,23,4,9,45
90,Fail,54,20,1,11,43
90,Fail,45,24,7,14,31
90,Fail,43,34,0,15,28
90,Fail,49,25,3,12,37
90,Fail,53,28,0,8,45
90,Fail,47,29,0,12,35
90,Fail,47,21,8,14,33
90,Fail,43,32,0,14,29
90,Fail,49,24,0,15,34
90,Fail,47,27,0,16,31
90,Fail,48,22,0,16,32
90,Fail,52,23,4,12,40
90,Fail,53,22,7,11,42
90,Fail,51,21,2,17,34
90,Fail,50,27,3,6,44
90,Fail,51,20,2,16,35
90,Fail,58,17,0,11,47
90,Fail,45,30,0,16,29
90,Fail,40,29,6,13,27
90,Fail,52,28,0,11,41
90,Fail,54,21,0,12,42
90,Fail,42,22,6,19,23
90,Fail,46,23,5,16,30
90,Fail,46,31,0,14,32
90,Fail,54,19,0,15,39
90,Fail,47,30,0,10,37
90,Fail,54,21,1,15,39
90,Fail,49,24,0,13,36
90,Fail,47,18,11,12,35
90,Fail,55,20,0,12,43
90,Fail,58,23,0,6,52
90,Fail,44,36,0,14,30
90,Fail,52,31,0,9,43
90,Fail,52,24,2,15,37
90,Fail,53,29,2,7,46
90,Fail,45,28,6,10,35
90,Fail,57,27,0,5,52
90,Fail,46,32,0,12,34
90,Fail,46,22,9,15,31
90,Fail,48,25,2,15,33
90,Fail,45,37,0,8,37
90,Fail,43,32,8,8,35
90,Fail,46,34,0,12,34
90,Fail,37,34,3,19,18
90,Fail,50,31,0,10,40
90,Fail,45,28,0,15,30
90,Fail,37,40,0,13,24
90,Fail,43,26,1,16,27
90,Fail,45,30,0,15,30
90,Fail,49,32,0,7,42
90,Fail,48,19,3,14,34
90,Fail,43,19,5,19,24
90,Fail,48,27,0,16,32
90,Fail,35,42,0,17,18
90,Fail,48,23,1,14,34
90,Fail,37,32,0,22,15
90,Fail,43,33,0,13,30
90,Fail,54,23,4,11,43
90,Fail,57,15,3,11,46
90,Fail,47,25,3,16,31
90,Fail,46,27,3,13,33
90,Fail,41,41,0,12,29
90,Fail,47,21,2,18,29
90,Fail,48,22,0,13,35
90,Fail,45,27,9,14,31
90,Fail,49,27,2,11,38
90,Fail,49,25,0,12,37
90,Fail,43,34,7,10,33
90,Fail,46,25,0,20,26
90,Fail,45,29,6,11,34
90,Fail,46,29,0,12,34
90,Fail,48,24,5,13,35
90,Fail,52,20,11,8,44
90,Fail,45,22,2,20,25
90,Fail,46,35,0,11,35
90,Fail,42,28,0,18,24
90,Fail,52,22,1,12,40
90,Fail,48,23,3,12,36
90,Fail,44,33,0,15,29
90,Fail,44,32,0,15,29
90,Fail,49,21,3,12,37
90,Fail,48,26,0,11,37
90,Fail,48,27,0,13,35
90,Fail,51,30,5,7,44
90,Fail,51,17,0,18,33
90,Fail,55,24,0,8,47
90,Fail,49,33,0,13,36
90,Fail,43,27,0,17,26
90,Fail,45,25,4,19,26
90,Fail,45,34,0,13,32
90,Fail,57,23,0,10,47
90,Fail,51,24,2,10,41
90,Fail,49,29,0,10,39
90,Fail,50,23,4,16,34
90,Fail,51,25,0,14,37
90,Fail,46,30,0,11,35
90,Fail,46,27,6,9,37
90,Fail,44,24,3,15,29
90,Fail,42,34,0,12,30
90,Fail,46,30,5,7,39
90,Fail,45,27,3,13,32
90,Fail,47,34,0,9,38
90,Fail,44,28,6,13,31
90,Fail,52,20,0,15,37
90,Fail,48,22,8,8,40
90,Fail,44,35,0,11,33
90,Fail,58,22,0,10,48
90,Fail,39,26,4,20,19
90,Fail,51,31,0,11,40
90,Fail,56,27,0,6,50
90,Fail,56,20,4,8,48
90,Fail,49,20,0,17,32
90,Fail,45,24,2,16,29
90,Fail,50,32,0,13,37
90,Fail,42,31,9,12,30
90,Fail,44,26,1,18,26
90,Fail,50,25,0,13,37
90,Fail,55,18,4,9,46
90,Fail,48,30,0,13,35
90,Fail,51,28,0,12,39
90,Fail,44,29,0,14,30
90,Fail,52,25,0,12,40
90,Fail,49,36,0,10,39
90,Fail,52,29,0,10,42
90,Fail,47,22,0,18,29
90,Fail,50,27,0,8,42
90,Fail,50,22,0,14,36
90,Fail,45,34,0,12,33
90,Fail,47,31,0,14,33
90,Fail,49,24,2,16,33
90,Fail,47,28,3,11,36
90,Fail,49,25,6,7,42
90,Fail,53,21,2,12,41
90,Fail,47,34,0,10,37
90,Fail,47,25,0,15,32
90,Fail,49,32,0,8,41
90,Fail,40,27,0,22,18
90,Fail,58,22,0,11,47
90,Fail,49,30,0,11,38
90,Fail,50,27,0,11,39
90,Fail,54,28,0,10,44
90,Fail,41,29,3,17,24
90,Fail,47,31,0,12,35
90,Fail,49,26,3,11,38
90,Fail,46,34,0,10,36
90,Fail,45,26,8,13,32
90,Fail,50,21,0,13,37
90,Fail,49,24,5,12,37
90,Fail,48,31,4,10,38
90,Fail,48,27,0,9,39
90,Fail,42,32,0,12,30
90,Fail,46,30,0,15,31
90,Fail,45,28,0,17,28
90,Fail,37,34,2,15,22
90,Fail,42,36,0,13,29
90,Fail,41,35,0,13,28
90,Fail,49,31,0,13,36
90,Fail,45,28,7,12,33
90,Fail,46,20,3,18,28
90,Fail,47,28,0,8,39
90,Fail,43,34,0,13,30
90,Fail,53,22,0,11,42
90,Fail,48,19,9,15,33
90,Fail,51,26,0,12,39
90,Fail,51,24,0,6,45
90,Fail,41,39,0,12,29
90,Fail,44,31,10,10,34
90,Fail,55,25,1,8,47
90,Fail,46,30,0,16,30
90,Fail,45,29,0,17,28
90,Fail,45,29,3,12,33
90,Fail,51,25,0,13,38
90,Fail,43,28,8,12,31
90,Fail,39,38,0,13,26
90,Fail,53,29,0,7,46
90,Fail,48,29,0,14,34
90,Fail,47,24,5,14,33
90,Fail,50,26,10,6,44
90,Fail,53,27,0,12,41
90,Fail,47,20,4,16,31
90,Fail,45,30,0,13,32
90,Fail,43,33,0,14,29
90,Fail,50,28,0,14,36
90,Fail,52,23,7,8,44
90,Fail,46,21,7,16,30
90,Fail,45,28,3,13,32
90,Fail,53,22,6,8,45
90,Fail,60,16,0,13,47
90,Fail,50,23,5,11,39
90,Fail,56,24,3,6,50
100,Fail,44,28,13,11,33
100,Fail,46,23,11,13,33
100,Fail,45,25,4,18,27
100,Fail,46,29,1,13,33
100,Fail,41,42,0,10,31
100,Fail,59,16,0,12,47
100,Fail,39,36,0,18,21
100,Fail,50,26,0,14,36
100,Fail,48,30,0,12,36
100,Fail,50,24,1,12,38
100,Fail,47,23,0,18,29
100,Fail,44,30,0,17,27
100,Fail,46,34,0,13,33
100,Fail,48,17,6,20,28
100,Fail,54,24,0,9,45
100,Fail,40,34,0,11,29
100,Fail,48,26,1,10,38
100,Fail,47,27,4,14,33
100,Fail,57,19,0,8,49
100,Fail,51,25,2,9,42
100,Fail,51,18,1,16,35
100,Fail,48,25,0,14,34
100,Fail,45,29,0,14,31
100,Fail,43,31,0,18,25
100,Fail,38,29,11,16,22
100,Fail,50,23,5,13,37
100,Fail,53,28,2,7,46
100,Fail,53,21,8,9,44
100,Fail,40,37,0,11,29
100,Fail,48,24,10,9,39
100,Fail,51,27,0,11,40
100,Fail,47,25,0,17,30
100,Fail,40,28,4,16,24
100,Fail,45,33,0,11,34
100,Fail,44,28,5,14,30
100,Fail,43,23,6,16,27
100,Fail,50,28,0,11,39
100,Fail,50,28,0,11,39
100,Fail,43,32,8,9,34
100,Fail,42,29,0,16,26
100,Fail,54,27,0,10,44
100,Fail,54,21,0,15,39
100,Fail,51,28,0,13,38
100,Fail,50,25,2,7,43
100,Fail,51,28,3,9,42
100,Fail,55,27,0,9,46
100,Fail,42,34,4,11,31
100,Fail,51,25,0,10,41
100,Fail,41,34,8,12,29
100,Fail,48,25,0,17,31
100,Fail,63,22,0,8,55
100,Fail,35,40,0,16,19
100,Fail,44,26,10,11,33
100,Fail,43,21,10,19,24
100,Fail,51,24,8,9,42
100,Fail,56,22,1,12,44
100,Fail,52,14,11,15,37
100,Fail,43,30,0,15,28
100,Fail,45,33,0,13,32
100,Fail,48,30,0,10,38
100,Fail,42,29,0,15,27
100,Fail,45,27,0,16,29
100,Fail,53,22,3,12,41
100,Fail,41,30,6,12,29
100,Fail,46,28,2,14,32
100,Fail,48,30,0,12,36
100,Fail,47,27,3,15,32
100,Fail,41,33,7,10,31
100,Fail,52,23,1,11,41
100,Fail,51,26,3,8,43
100,Fail,47,24,0,18,29
100,Fail,44,27,0,17,27
100,Fail,52,29,0,6,46
100,Fail,44,34,0,14,30
100,Fail,51,29,0,10,41
100,Fail,49,27,0,11,38
100,Fail,49,29,0,14,35
100,Fail,50,28,0,12,38
100,Fail,52,25,2,12,40
100,Fail,50,24,1,7,43
100,Fail,51,25,0,11,40
100,Fail,45,33,0,12,33
100,Fail,49,23,6,12,37
100,Fail,50,28,0,12,38
100,Fail,47,33,0,9,38
100,Fail,42,27,0,21,21
100,Fail,39,39,0,12,27
100,Fail,52,25,0,13,39
100,Fail,52,20,4,13,39
100,Fail,56,24,0,9,47
100,Fail,43,25,5,14,29
100,Fail,43,21,7,17,26
100,Fail,44,26,0,19,25
100,Fail,46,23,9,12,34
100,Fail,50,24,0,15,35
100,Fail,46,25,0,15,31
100,Fail,39,38,3,9,30
100,Fail,51,21,7,11,40
100,Fail,42,34,0,12,30
100,Fail,42,29,0,19,23
100,Fail,40,28,7,16,24
100,Fail,52,32,0,6,46
100,Fail,47,29,1,10,37
100,Fail,52,20,8,6,46
100,Fail,51,28,0,10,41
100,Fail,45,30,4,12,33
100,Fail,41,38,0,12,29
100,Fail,51,24,0,13,38
100,Fail,48,20,3,19,29
100,Fail,55,22,0,11,44
100,Fail,52,25,8,6,46
100,Fail,46,34,0,10,36
100,Fail,44,28,2,16,28
100,Fail,53,21,3,12,41
100,Fail,43,35,0,14,29
100,Fail,51,25,0,12,39
100,Fail,52,18,0,18,34
100,Fail,51,28,0,12,39
100,Fail,46,35,0,12,34
100,Fail,41,38,0,10,31
100,Fail,50,23,3,17,33
100,Fail,45,24,8,11,34
100,Fail,49,20,2,17,32
100,Fail,46,31,0,13,33
100,Fail,55,20,0,15,40
100,Fail,42,34,1,10,32
100,Fail,41,35,0,15,26
100,Fail,45,20,13,14,31
100,Fail,44,27,6,15,29
100,Fail,43,30,0,16,27
100,Fail,42,27,6,14,28
100,Fail,43,29,3,16,27
100,Fail,51,26,0,7,44
100,Fail,42,29,3,16,26
100,Fail,49,29,2,10,39
100,Fail,45,38,0,9,36
100,Fail,54,26,1,11,43
100,Fail,53,25,1,11,42
100,Fail,41,33,1,13,28
100,Fail,46,26,5,14,32
100,Fail,53,28,0,10,43
100,Fail,50,27,0,12,38
100,Fail,46,27,5,11,35
100,Fail,42,27,6,17,25
100,Fail,44,29,3,14,30
100,Fail,51,20,6,12,39
100,Fail,50,22,0,14,36
100,Fail,47,25,4,14,33
100,Fail,59,19,3,8,51
100,Fail,56,19,0,12,44
100,Fail,47,27,2,14,33
100,Fail,41,42,0,8,33
100,Fail,46,22,4,17,29
100,Fail,53,21,0,14,39
100,Fail,51,29,0,10,41
100,Fail,42,39,0,10,32
100,Fail,40,38,0,14,26
100,Fail,57,15,1,11,46
100,Fail,38,38,0,16,22
100,Fail,48,27,6,9,39
100,Fail,48,28,5,8,40
100,Fail,43,25,0,17,26
100,Fail,52,32,0,9,43
100,Fail,49,22,0,13,36
100,Fail,46,24,9,12,34
100,Fail,55,25,0,10,45
100,Fail,55,18,3,10,45
100,Fail,51,25,3,11,40
100,Fail,32,32,7,22,10
100,Fail,55,27,0,8,47
100,Fail,47,32,0,13,34
100,Fail,45,23,0,17,28
100,Fail,49,23,4,15,34
100,Fail,42,34,0,9,33
100,Fail,51,22,0,15,36
100,Fail,50,22,4,15,35
100,Fail,54,23,3,12,42
100,Fail,55,23,0,10,45
100,Fail,48,32,0,10,38
100,Fail,43,34,1,13,30
100,Fail,37,34,0,18,19
100,Fail,49,33,0,6,43
100,Fail,57,15,4,14,43
100,Fail,48,31,2,12,36
100,Fail,38,26,15,14,24
100,Fail,45,26,5,15,30
100,Fail,51,28,1,10,41
100,Fail,50,29,0,8,42
100,Fail,49,25,1,15,34
100,Fail,40,37,0,12,28
100,Fail,47,22,9,13,34
100,Fail,46,31,0,12,34
100,Fail,42,33,3,14,28
100,Fail,48,23,7,16,32
100,Fail,50,24,2,11,39
100,Fail,43,33,0,19,24
100,Fail,54,21,7,8,46
100,Fail,47,25,6,14,33
100,Fail,51,26,0,9,42
100,Fail,51,22,0,16,35
100,Fail,48,30,0,11,37
100,Fail,48,23,6,13,35
100,Fail,43,43,0,6,37
100,Fail,52,28,0,12,40
100,Fail,46,32,4,8,38
100,Fail,44,31,4,12,32
100,Fail,47,24,0,17,30
100,Fail,45,30,5,15,30
100,Fail,51,30,0,9,42
100,Fail,45,27,5,14,31
100,Fail,42,29,4,11,31
100,Fail,48,29,3,12,36
100,Fail,45,29,6,9,36
100,Fail,55,21,0,9,46
100,Fail,47,23,0,12,35
100,Fail,50,24,0,13,37
100,Fail,40,36,0,18,22
100,Fail,50,20,7,13,37
100,Fail,47,28,4,14,33
100,Fail,46,28,0,13,33
100,Fail,51,35,0,7,44
100,Fail,42,32,1,17,25
100,Fail,48,25,8,10,38
100,Fail,47,23,4,13,34
100,Fail,57,23,0,11,46
100,Fail,52,22,5,10,42
100,Fail,45,36,0,7,38
100,Fail,41,34,0,17,24
100,Fail,49,21,1,16,33
100,Fail,44,28,0,17,27
100,Fail,37,30,10,13,24
100,Fail,50,29,0,9,41
100,Fail,48,34,0,10,38
100,Fail,47,27,0,15,32
100,Fail,51,27,0,8,43
100,Fail,48,24,9,13,35
100,Fail,51,24,4,10,41
100,Fail,49,20,0,18,31
100,Fail,40,30,7,16,24
100,Fail,46,30,2,11,35
100,Fail,50,25,2,10,40
100,Fail,44,29,5,12,32
100,Fail,45,25,1,17,28
100,Fail,52,20,0,10,42
100,Fail,42,31,3,14,28
100,Fail,46,26,0,18,28
100,Fail,53,24,0,13,40
100,Fail,43,27,6,15,28
100,Fail,46,31,0,10,36
100,Fail,48,29,0,8,40
100,Fail,50,36,0,7,43
100,Fail,50,25,3,8,42
100,Fail,47,28,3,14,33
100,Fail,49,26,0,15,34
100,Fail,43,31,5,12,31
100,Fail,53,20,0,12,41
100,Fail,51,25,2,14,37
100,Fail,40,37,0,14,26
100,Fail,49,29,0,14,35
100,Fail,56,24,0,10,46
100,Fail,41,34,0,11,30
100,Fail,51,23,3,12,39
100,Fail,43,39,0,12,31
100,Fail,48,27,2,13,35
100,Fail,47,32,0,7,40
100,Fail,44,39,0,9,35
100,Fail,37,39,0,12,25
100,Fail,55,18,3,10,45
100,Fail,47,29,0,15,32
100,Fail,52,26,4,9,43
100,Fail,50,22,5,12,38
100,Fail,57,24,3,8,49
100,Fail,50,22,3,13,37
100,Fail,42,29,2,13,29
100,Fail,51,20,2,12,39
100,Fail,44,31,0,11,33
100,Fail,51,28,0,12,39
100,Fail,46,27,0,14,32
100,Fail,43,30,1,11,32
100,Fail,47,29,0,13,34
100,Fail,48,32,0,8,40
100,Fail,43,39,0,10,33
100,Fail,45,29,5,14,31
100,Fail,45,34,0,11,34
100,Fail,50,23,1,13,37
100,Fail,55,23,2,12,43
100,Fail,51,19,0,19,32
100,Fail,46,31,0,13,33
100,Fail,43,30,7,14,29
100,Fail,49,23,1,18,31
100,Fail,43,30,3,14,29
100,Fail,58,22,0,11,47
100,Fail,52,28,1,7,45
100,Fail,54,18,0,13,41
100,Fail,45,31,0,15,30
100,Fail,61,23,0,6,55
100,Fail,46,35,0,12,34
100,Fail,49,29,0,9,40
100,Fail,53,30,1,6,47
100,Fail,52,22,1,12,40
100,Fail,53,24,0,12,41
100,Fail,47,36,0,10,37
100,Fail,41,33,1,13,28
100,Fail,50,21,0,15,35
100,Fail,41,29,7,13,28
100,Fail,47,26,0,12,35
100,Fail,50,28,0,9,41
100,Fail,47,25,3,12,35
100,Fail,47,25,3,13,34
100,Fail,47,27,0,13,34
100,Fail,42,23,4,19,23
100,Fail,56,21,1,14,42
100,Fail,49,30,0,9,40
100,Fail,52,29,2,8,44
100,Fail,50,26,0,13,37
100,Fail,49,23,2,14,35
100,Fail,45,30,0,14,31
100,Fail,49,27,0,11,38
100,Fail,55,22,0,12,43
100,Fail,50,23,3,14,36
100,Fail,57,24,0,9,48
100,Fail,39,33,0,18,21
100,Fail,45,35,0,12,33
100,Fail,46,20,13,13,33
100,Fail,40,29,3,16,24
100,Fail,49,26,6,12,37
100,Fail,42,27,8,14,28
100,Fail,46,34,3,11,35
100,Fail,48,37,0,6,42
100,Fail,46,34,0,8,38
100,Fail,42,28,3,18,24
100,Fail,50,29,0,11,39
100,Fail,44,40,0,6,38
100,Fail,50,31,0,7,43
100,Fail,43,35,2,8,35
100,Fail,54,27,0,9,45
100,Fail,48,30,0,12,36
100,Fail,43,28,0,14,29
100,Fail,47,30,0,12,35
100,Fail,42,34,7,7,35
100,Fail,49,23,0,12,37
100,Fail,44,27,0,17,27
100,Fail,47,29,5,8,39
100,Fail,51,24,6,10,41
100,Fail,55,19,0,15,40
100,Fail,48,29,1,12,36
100,Fail,48,24,4,13,35
100,Fail,48,29,0,13,35
100,Fail,53,26,0,11,42
100,Fail,50,21,0,15,35
100,Fail,46,26,2,13,33
100,Fail,54,21,2,10,44
100,Fail,44,30,0,18,26
100,Fail,52,22,0,10,42
100,Fail,50,27,0,9,41
100,Fail,40,41,0,8,32
100,Fail,54,24,0,10,44
100,Fail,58,22,1,9,49
100,Fail,38,23,17,14,24
100,Fail,50,23,3,16,34
100,Fail,59,21,0,8,51
100,Fail,46,35,0,12,34
100,Fail,57,18,3,13,44
100,Fail,42,38,0,15,27
100,Fail,43,32,5,14,29
100,Fail,39,41,0,13,26
100,Fail,50,24,4,9,41
100,Fail,37,37,5,13,24
100,Fail,42,35,3,12,30
100,Fail,40,34,0,12,28
100,Fail,47,25,3,14,33
100,Fail,42,32,0,16,26
100,Fail,50,26,1,13,37
100,Fail,45,39,0,6,39
100,Fail,38,32,3,18,20
100,Fail,52,26,0,13,39
100,Fail,53,22,2,11,42
100,Fail,53,26,0,12,41
100,Fail,50,27,2,10,40
100,Fail,43,27,0,21,22
100,Fail,44,26,7,14,30
100,Fail,45,27,0,17,28
100,Fail,47,22,5,13,34
100,Fail,47,25,7,17,30
100,Fail,45,40,0,8,37
100,Fail,52,29,0,10,42
100,Fail,53,34,0,5,48
100,Fail,53,20,4,9,44
100,Fail,52,24,1,9,43
100,Fail,47,28,0,13,34
100,Fail,45,25,9,13,32
100,Fail,51,22,2,13,38
100,Fail,46,26,0,17,29
100,Fail,46,29,4,9,37
100,Fail,60,20,4,6,54
100,Fail,48,24,2,15,33
100,Fail,58,22,0,10,48
100,Fail,54,28,0,9,45
100,Fail,55,24,0,9,46
100,Fail,55,26,0,8,47
100,Fail,54,21,0,14,40
100,Fail,49,28,4,11,38
100,Fail,55,22,0,11,44
100,Fail,47,29,3,13,34
100,Fail,41,40,0,10,31
100,Fail,49,33,0,12,37
100,Fail,37,32,5,14,23
100,Fail,49,23,4,14,35
100,Fail,56,19,3,11,45
100,Fail,49,28,0,8,41
100,Fail,39,34,5,11,28
100,Fail,42,34,6,6,36
100,Fail,44,23,6,18,26
100,Fail,43,27,0,19,24
100,Fail,50,26,0,12,38
100,Fail,46,32,0,12,34
100,Fail,51,20,7,14,37
100,Fail,45,34,0,13,32
100,Fail,41,38,0,13,28
100,Fail,41,38,5,8,33
100,Fail,48,27,0,14,34
100,Fail,52,21,3,16,36
100,Fail,54,21,2,15,39
100,Fail,53,32,0,5,48
100,Fail,49,21,0,14,35
100,Fail,48,35,0,8,40
100,Fail,41,29,7,15,26
100,Fail,48,24,11,10,38
100,Fail,50,23,0,17,33
100,Fail,54,22,0,12,42
100,Fail,43,36,0,7,36
100,Fail,54,23,0,12,42
100,Fail,40,27,2,17,23
100,Fail,52,20,0,13,39
100,Fail,46,25,4,15,31
100,Fail,51,23,0,19,32
100,Fail,47,30,0,14,33
100,Fail,46,20,5,17,29
100,Fail,52,29,0,8,44
100,Fail,41,30,4,14,27
100,Fail,53,21,0,17,36
100,Fail,48,27,4,7,41
100,Fail,52,23,1,11,41
100,Fail,43,28,10,9,34
100,Fail,54,28,0,13,41
100,Fail,47,29,0,14,33
100,Fail,46,29,3,9,37
100,Fail,43,29,4,14,29
100,Fail,41,37,0,18,23
100,Fail,49,23,0,15,34
100,Fail,55,26,0,9,46
100,Fail,45,38,0,9,36
100,Fail,50,23,0,14,36
100,Fail,48,29,0,14,34
100,Fail,42,32,2,15,27
100,Fail,48,25,2,16,32
100,Fail,52,30,0,9,43
100,Fail,52,21,5,6,46
100,Fail,45,29,0,14,31
100,Fail,50,23,0,15,35
100,Fail,36,42,0,14,22
100,Fail,42,29,4,11,31
100,Fail,45,33,0,13,32
100,Fail,44,25,6,15,29
100,Fail,50,23,0,14,36
100,Fail,50,20,0,17,33
100,Fail,42,33,0,18,24
100,Fail,48,23,4,15,33
100,Fail,50,32,2,8,42
100,Fail,53,24,3,11,42
100,Fail,51,28,0,7,44
100,Fail,51,13,3,18,33
100,Fail,43,21,9,14,29
100,Fail,52,28,0,10,42
100,Fail,51,32,0,8,43
100,Fail,49,26,1,12,37
100,Fail,52,15,3,22,30
100,Fail,52,24,0,14,38
100,Fail,44,25,0,15,29
100,Fail,47,27,0,17,30
100,Fail,49,30,5,10,39
100,Fail,57,19,0,18,39
100,Fail,46,30,0,11,35
100,Fail,55,22,6,8,47
100,Fail,49,33,0,9,40
100,Fail,56,19,2,13,43
100,Fail,47,19,5,14,33
100,Fail,50,31,0,11,39
100,Fail,45,38,0,5,40
100,Fail,44,28,0,16,28
100,Fail,46,22,7,11,35
100,Fail,46,31,0,14,32
100,Fail,49,26,3,10,39
100,Fail,45,27,8,14,31
100,Fail,45,26,7,14,31
100,Fail,54,19,2,12,42
100,Fail,44,33,0,14,30
100,Fail,34,34,9,12,22
100,Fail,47,28,0,17,30
100,Fail,49,28,1,9,40
100,Fail,51,24,0,12,39
100,Fail,47,30,0,8,39
100,Fail,56,26,0,8,48
100,Fail,39,32,10,14,25
100,Fail,51,24,6,9,42
100,Fail,42,24,8,13,29
100,Fail,45,24,0,16,29
100,Fail,53,29,0,8,45
100,Fail,51,24,0,11,40
100,Fail,47,33,0,12,35
100,Fail,42,28,0,18,24
100,Fail,48,35,0,9,39
100,Fail,43,32,0,18,25
100,Fail,45,32,9,9,36
100,Fail,45,23,3,12,33
100,Fail,46,31,2,10,36
100,Fail,46,31,5,11,35
100,Fail,39,35,7,13,26
100,Fail,51,23,4,14,37
100,Fail,39,31,0,20,19
100,Fail,49,32,0,11,38
100,Fail,41,32,4,11,30
100,Fail,42,42,0,9,33
100,Fail,41,31,3,15,26
100,Fail,47,29,0,13,34
100,Fail,44,28,5,16,28
100,Fail,49,30,0,9,40
100,Fail,43,25,5,19,24
100,Fail,43,32,0,16,27
100,Fail,44,36,0,13,31
100,Fail,49,30,0,14,35
100,Fail,51,24,0,13,38
100,Fail,51,20,3,11,40
100,Fail,51,30,0,9,42
100,Fail,48,38,0,9,39
100,Fail,50,31,0,8,42
100,Fail,56,26,0,9,47
100,Fail,41,34,0,17,24
100,Fail,50,21,0,16,34
100,Fail,47,29,2,12,35
100,Fail,44,30,3,15,29
100,Fail,43,33,0,12,31
100,Fail,55,24,0,11,44
100,Fail,50,33,0,7,43
100,Fail,43,36,0,7,36
100,Fail,43,36,2,10,33
100,Fail,48,30,0,14,34
100,Fail,48,33,0,11,37
100,Fail,52,28,0,12,40
100,Fail,50,31,4,7,43
100,Fail,63,12,0,12,51
100,Fail,40,31,2,16,24
100,Fail,40,37,0,15,25
100,Fail,43,30,3,16,27
100,Fail,54,26,2,8,46
100,Fail,48,28,0,15,33
100,Fail,53,26,0,9,44
100,Fail,53,25,1,10,43
100,Fail,41,29,5,14,27
100,Fail,44,21,6,18,26
100,Fail,49,23,10,8,41
100,Fail,48,27,8,8,40
100,Fail,48,31,0,11,37
100,Fail,39,37,0,15,24
100,Fail,53,17,2,14,39
100,Fail,48,29,0,13,35
100,Fail,49,23,5,9,40
100,Fail,49,23,6,15,34
100,Fail,52,21,0,15,37
100,Fail,49,33,0,12,37
100,Fail,47,29,2,12,35
100,Fail,57,23,3,10,47
100,Fail,46,30,3,9,37
100,Fail,51,24,2,9,42
100,Fail,41,24,5,22,19
100,Fail,47,27,0,17,30
100,Fail,50,27,0,12,38
100,Fail,51,30,0,8,43
100,Fail,54,27,0,6,48
100,Fail,47,24,5,12,35
100,Fail,48,29,5,11,37
100,Fail,43,31,0,15,28
100,Fail,53,24,4,10,43
100,Fail,56,22,0,6,50
100,Fail,49,24,0,20,29
100,Fail,50,29,0,10,40
100,Fail,50,28,1,11,39
100,Fail,55,21,1,10,45
100,Fail,49,21,4,15,34
100,Fail,47,28,5,11,36
100,Fail,47,29,0,16,31
100,Fail,47,27,4,10,37
100,Fail,48,30,0,11,37
100,Fail,48,28,0,13,35
100,Fail,44,33,0,11,33
100,Fail,50,25,0,13,37
100,Fail,41,25,9,15,26
100,Fail,46,31,0,13,33
100,Fail,49,26,0,14,35
100,Fail,51,29,2,9,42
100,Fail,47,23,1,19,28
100,Fail,47,32,0,12,35
100,Fail,47,31,0,11,36
100,Fail,49,19,9,16,33
100,Fail,51,23,1,10,41
100,Fail,49,23,2,14,35
100,Fail,45,29,0,13,32
100,Fail,40,31,0,14,26
100,Fail,46,23,0,20,26
100,Fail,49,28,0,12,37
100,Fail,49,27,6,11,38
100,Fail,52,31,0,8,44
100,Fail,48,21,2,15,33
100,Fail,48,26,0,16,32
100,Fail,57,24,0,9,48
100,Fail,45,31,5,11,34
100,Fail,41,29,6,13,28
100,Fail,48,25,7,13,35
100,Fail,43,33,0,18,25
100,Fail,51,19,1,11,40
100,Fail,51,19,5,17,34
100,Fail,38,43,0,10,28
100,Fail,51,31,0,9,42
100,Fail,43,24,0,22,21
100,Fail,44,22,3,20,24
100,Fail,56,21,7,7,49
100,Fail,46,29,0,16,30
100,Fail,47,32,0,9,38
100,Fail,51,26,0,10,41
100,Fail,53,23,0,13,40
100,Fail,51,22,3,9,42
100,Fail,52,22,2,11,41
100,Fail,44,24,0,16,28
100,Fail,51,31,2,5,46
100,Fail,45,29,4,10,35
100,Fail,55,27,0,4,51
100,Fail,57,24,0,12,45
100,Fail,45,25,5,18,27
100,Fail,54,21,4,12,42
100,Fail,53,25,0,11,42
100,Fail,35,29,9,18,17
100,Fail,44,27,4,13,31
100,Fail,46,29,0,15,31
100,Fail,49,29,0,14,35
100,Fail,37,40,0,12,25
100,Fail,49,28,0,16,33
100,Fail,55,20,4,10,45
100,Fail,55,21,0,12,43
100,Fail,48,21,3,18,30
100,Fail,54,21,0,15,39
100,Fail,49,25,5,11,38
100,Fail,49,22,9,10,39
100,Fail,42,35,0,13,29
100,Fail,45,25,3,15,30
100,Fail,48,27,0,11,37
100,Fail,52,32,0,8,44
100,Fail,48,26,1,14,34
100,Fail,54,23,3,12,42
100,Fail,55,14,4,12,43
100,Fail,50,26,0,13,37
100,Fail,44,23,6,16,28
100,Fail,48,24,0,16,32
100,Fail,51,28,0,16,35
100,Fail,45,31,3,10,35
100,Fail,50,24,1,14,36
100,Fail,41,37,0,15,26
100,Fail,46,39,0,6,40
100,Fail,44,29,0,13,31
100,Fail,52,22,0,14,38
100,Fail,43,25,2,18,25
100,Fail,48,23,2,15,33
100,Fail,48,26,0,14,34
100,Fail,51,24,2,10,41
100,Fail,53,22,0,15,38
100,Fail,45,30,0,16,29
100,Fail,50,25,0,15,35
100,Fail,50,33,0,6,44
100,Fail,44,29,0,14,30
100,Fail,45,27,1,12,33
100,Fail,51,20,1,14,37
100,Fail,54,22,0,9,45
100,Fail,47,29,3,10,37
100,Fail,47,26,0,12,35
100,Fail,57,16,4,14,43
100,Fail,49,21,3,16,33
100,Fail,49,19,3,16,33
100,Fail,51,27,0,11,40
100,Fail,39,28,5,18,21
100,Fail,43,22,3,21,22
100,Fail,53,22,6,12,41
100,Fail,48,29,4,9,39
100,Fail,47,29,3,11,36
100,Fail,40,31,0,17,23
100,Fail,40,35,6,11,29
100,Fail,52,17,3,16,36
100,Fail,50,22,4,14,36
100,Fail,48,33,0,8,40
100,Fail,53,26,0,12,41
100,Fail,43,32,9,12,31
100,Fail,48,31,1,8,40
100,Fail,44,30,0,13,31
100,Fail,51,25,0,15,36
100,Fail,50,30,2,7,43
100,Fail,51,26,1,9,42
100,Fail,50,19,5,14,36
100,Fail,52,24,0,10,42
100,Fail,45,18,12,17,28
100,Fail,38,34,15,10,28
100,Fail,43,22,1,20,23
100,Fail,49,30,0,10,39
100,Fail,49,16,6,15,34
100,Fail,44,33,0,12,32
100,Fail,48,25,0,13,35
100,Fail,53,26,0,10,43
100,Fail,45,31,1,11,34
100,Fail,40,36,0,16,24
100,Fail,45,31,0,13,32
100,Fail,46,22,0,18,28
100,Fail,50,21,0,14,36
100,Fail,48,29,3,9,39
100,Fail,47,30,0,13,34
100,Fail,49,30,0,12,37
100,Fail,57,19,3,11,46
100,Fail,49,29,0,11,38
100,Fail,45,29,0,17,28
100,Fail,51,21,0,12,39
100,Fail,48,25,5,8,40
100,Fail,38,44,0,10,28
100,Fail,44,29,9,8,36
100,Fail,47,25,0,15,32
100,Fail,49,20,3,16,33
100,Fail,50,32,0,10,40
100,Fail,45,33,0,9,36
100,Fail,45,25,2,13,32
100,Fail,51,24,0,15,36
100,Fail,51,23,6,11,40
100,Fail,54,24,0,11,43
100,Fail,43,25,1,14,29
100,Fail,57,18,0,9,48
100,Fail,52,20,5,13,39
100,Fail,42,24,10,16,26
100,Fail,42,27,5,17,25
100,Fail,47,31,0,12,35
100,Fail,56,15,2,14,42
100,Fail,50,24,1,11,39
100,Fail,50,28,0,11,39
100,Fail,49,26,0,15,34
100,Fail,36,46,0,12,24
100,Fail,53,24,0,11,42
100,Fail,47,33,4,7,40
100,Fail,46,33,0,11,35
100,Fail,53,21,0,13,40
100,Fail,51,31,0,8,43
100,Fail,46,29,0,19,27
100,Fail,50,30,0,13,37
100,Fail,45,31,1,12,33
100,Fail,46,28,0,15,31
100,Fail,45,33,0,12,33
100,Fail,46,28,0,15,31
100,Fail,51,25,1,14,37
100,Fail,47,35,0,10,37
100,Fail,42,25,9,14,28
100,Fail,49,26,5,9,40
100,Fail,47,25,0,19,28
100,Fail,56,21,3,11,45
100,Fail,35,32,10,13,22
100,Fail,43,31,1,14,29
100,Fail,50,26,0,14,36
100,Fail,48,22,3,13,35
100,Fail,45,31,1,11,34
100,Fail,49,27,0,11,38
100,Fail,51,20,4,11,40
100,Fail,49,23,3,15,34
100,Fail,43,29,0,17,26
100,Fail,46,21,0,21,25
100,Fail,51,24,0,14,37
100,Fail,43,24,0,22,21
100,Fail,50,30,0,9,41
100,Fail,58,17,5,9,49
100,Fail,46,24,7,17,29
100,Fail,52,26,8,7,45
100,Fail,58,15,0,12,46
100,Fail,50,26,1,11,39
100,Fail,38,39,0,16,22
100,Fail,43,27,1,15,28
100,Fail,43,27,0,19,24
100,Fail,48,26,1,14,34
100,Fail,55,23,0,12,43
100,Fail,45,18,9,17,28
100,Fail,57,27,0,6,51
100,Fail,55,24,4,9,46
100,Fail,39,34,0,20,19
100,Fail,56,23,1,9,47
100,Fail,49,35,0,10,39
100,Fail,52,22,0,15,37
100,Fail,51,23,2,16,35
100,Fail,50,25,1,11,39
100,Fail,39,30,10,17,22
100,Fail,53,28,1,6,47
100,Fail,50,31,0,10,40
100,Fail,46,30,5,12,34
100,Fail,58,23,0,12,46
100,Fail,47,36,0,12,35
100,Fail,49,28,0,11,38
100,Fail,60,15,5,14,46
100,Fail,53,29,1,7,46
100,Fail,46,28,0,16,30
100,Fail,49,23,0,19,30
100,Fail,45,39,0,7,38
100,Fail,49,34,0,8,41
100,Fail,55,22,0,10,45
100,Fail,52,27,2,10,42
100,Fail,56,24,0,11,45
100,Fail,48,27,0,11,37
100,Fail,51,26,0,10,41
100,Fail,53,26,0,8,45
100,Fail,48,22,5,10,38
100,Fail,43,30,4,15,28
100,Fail,55,27,0,8,47
100,Fail,42,37,0,15,27
100,Fail,51,29,0,9,42
100,Fail,45,27,0,16,29
100,Fail,50,33,0,4,46
100,Fail,54,23,0,9,45
100,Fail,53,19,0,15,38
100,Fail,50,29,1,10,40
100,Fail,49,18,9,19,30
100,Fail,51,19,4,16,35
100,Fail,59,18,4,8,51
100,Fail,56,21,0,10,46
100,Fail,50,24,5,10,40
100,Fail,49,22,11,9,40
100,Fail,46,27,0,17,29
100,Fail,40,38,0,14,26
100,Fail,50,23,4,17,33
100,Fail,46,28,0,14,32
100,Fail,52,19,0,15,37
100,Fail,49,22,3,12,37
100,Fail,44,22,2,21,23
100,Fail,49,31,0,11,38
100,Fail,57,27,0,5,52
100,Fail,45,32,0,13,32
100,Fail,40,39,0,17,23
100,Fail,44,40,0,7,37
100,Fail,51,25,7,9,42
100,Fail,44,29,0,17,27
100,Fail,47,26,0,14,33
100,Fail,50,25,4,10,40
100,Fail,48,34,0,6,42
100,Fail,49,33,0,11,38
100,Fail,55,19,4,13,42
100,Fail,48,32,0,11,37
100,Fail,47,29,1,13,34
100,Fail,50,29,0,10,40
100,Fail,45,28,0,16,29
100,Fail,46,28,0,11,35
100,Fail,51,36,0,5,46
100,Fail,49,33,0,9,40
100,Fail,49,24,2,10,39
100,Fail,47,36,0,12,35
100,Fail,51,25,2,12,39
100,Fail,53,20,0,14,39
100,Fail,48,27,5,9,39
100,Fail,47,26,8,13,34
100,Fail,45,33,5,9,36
100,Fail,52,19,10,10,42
100,Fail,51,30,0,8,43
100,Fail,51,31,0,5,46
100,Fail,38,30,0,17,21
100,Fail,56,21,0,11,45
100,Fail,47,24,3,18,29
100,Fail,43,29,2,13,30
100,Fail,56,24,0,6,50
100,Fail,43,28,5,14,29
100,Fail,50,19,8,14,36
100,Fail,53,26,1,10,43
100,Fail,48,26,1,15,33
100,Fail,46,30,2,9,37
100,Fail,50,28,0,14,36
100,Fail,51,33,0,10,41
100,Fail,41,32,6,15,26
100,Fail,58,23,0,8,50
100,Fail,45,31,0,17,28
100,Fail,45,31,0,15,30
100,Fail,51,26,0,11,40
100,Fail,58,18,1,10,48
100,Fail,44,28,4,13,31
100,Fail,42,29,8,11,31
100,Fail,58,23,5,6,52
100,Fail,44,36,0,13,31
100,Fail,47,31,0,14,33
100,Fail,47,25,3,13,34
100,Fail,43,29,4,14,29
100,Fail,49,19,0,17,32
100,Fail,43,23,8,18,25
100,Fail,50,20,4,18,32
100,Fail,40,32,0,13,27
100,Fail,47,27,5,14,33
100,Fail,46,25,3,16,30
100,Fail,43,30,10,8,35
100,Fail,52,26,0,14,38
100,Fail,55,22,0,11,44
100,Fail,44,25,3,18,26
100,Fail,54,21,5,6,48
100,Fail,45,29,0,17,28
100,Fail,52,27,0,11,41
100,Fail,45,25,5,14,31
100,Fail,48,38,0,10,38
100,Fail,49,31,0,12,37
100,Fail,46,28,4,12,34
100,Fail,52,22,1,15,37
100,Fail,46,33,0,11,35
100,Fail,50,30,0,12,38
100,Fail,44,35,0,12,32
100,Fail,45,23,4,19,26
100,Fail,48,24,7,11,37
100,Fail,42,23,0,24,18
100,Fail,51,31,0,8,43
100,Fail,50,21,3,13,37
100,Fail,45,21,7,17,28
100,Fail,43,33,3,9,34
100,Fail,42,28,14,12,30
100,Fail,39,39,0,15,24
100,Fail,49,21,6,12,37
100,Fail,50,28,0,13,37
100,Fail,45,27,4,14,31
100,Fail,42,27,8,13,29
100,Fail,45,30,2,13,32
100,Fail,40,39,0,9,31
100,Fail,48,28,1,10,38
100,Fail,45,32,3,10,35
100,Fail,44,28,0,17,27
100,Fail,50,29,0,10,40
100,Fail,48,24,4,13,35
100,Fail,45,31,6,8,37
100,Fail,45,28,4,12,33
100,Fail,48,24,8,12,36
100,Fail,53,20,8,12,41
100,Fail,56,24,0,9,47
100,Fail,48,25,6,14,34
100,Fail,44,28,0,16,28
100,Fail,49,26,1,10,39
100,Fail,47,23,9,14,33
100,Fail,46,26,7,14,32
100,Fail,53,27,3,10,43
100,Fail,48,27,0,11,37
100,Fail,45,35,0,11,34
100,Fail,49,18,10,11,38
100,Fail,43,28,6,12,31
100,Fail,47,34,4,9,38
100,Fail,39,38,0,15,24
100,Fail,48,25,0,19,29
100,Fail,51,26,1,10,41
100,Fail,41,30,2,14,27
100,Fail,43,29,4,13,30
100,Fail,56,28,0,9,47
100,Fail,46,22,5,11,35
100,Fail,53,21,0,13,40
100,Fail,46,31,0,12,34
100,Fail,55,28,0,6,49
100,Fail,56,24,0,10,46
100,Fail,46,27,0,14,32
100,Fail,56,17,2,13,43
100,Fail,55,22,2,12,43
100,Fail,53,22,1,17,36
100,Fail,42,26,0,18,24
100,Fail,41,31,1,18,23
100,Fail,47,25,4,13,34
100,Fail,43,34,0,13,30
100,Fail,51,37,0,5,46
100,Fail,53,29,0,8,45
100,Fail,44,42,0,11,33
100,Fail,47,22,0,17,30
100,Fail,49,25,0,13,36
100,Fail,44,34,0,10,34
100,Fail,48,28,0,14,34
100,Fail,44,33,0,14,30
100,Fail,49,16,2,18,31
100,Fail,50,18,10,10,40
100,Fail,49,27,0,13,36
100,Fail,51,22,2,13,38
100,Fail,52,19,1,15,37
100,Fail,50,28,0,12,38
100,Fail,55,20,4,10,45
100,Fail,49,33,0,9,40
100,Fail,50,21,0,13,37
100,Fail,49,26,4,10,39
100,Fail,60,20,0,9,51
100,Fail,45,33,0,12,33
100,Fail,48,22,8,14,34
100,Fail,42,29,5,13,29
100,Fail,43,24,14,10,33
100,Fail,56,25,0,7,49
100,Fail,40,40,0,10,30
100,Fail,47,23,6,14,33
100,Fail,45,31,0,13,32
100,Fail,40,23,13,17,23
100,Fail,48,23,0,16,32
100,Fail,52,20,0,17,35
100,Fail,45,30,10,6,39
100,Fail,46,23,4,17,29
100,Fail,50,27,4,11,39
100,Fail,46,23,10,11,35
100,Fail,47,25,1,16,31
100,Fail,56,27,0,8,48
100,Fail,53,21,7,7,46
100,Fail,51,24,1,12,39
100,Fail,54,26,0,9,45
100,Fail,44,32,4,8,36
100,Fail,47,28,0,13,34
100,Fail,43,35,0,13,30
100,Fail,53,22,0,7,46
100,Fail,50,30,0,12,38
100,Fail,47,26,1,16,31
100,Fail,48,29,0,13,35
100,Fail,42,31,4,10,32
100,Fail,49,26,0,14,35
100,Fail,52,30,0,12,40
100,Fail,49,24,0,15,34
100,Fail,50,25,1,10,40
100,Fail,45,30,2,13,32
100,Fail,41,31,3,13,28
100,Fail,47,15,8,19,28
100,Fail,51,28,2,7,44
100,Fail,46,24,5,14,32
100,Fail,46,23,8,14,32
100,Fail,49,26,0,12,37
100,Fail,43,28,3,15,28
100,Fail,46,26,1,15,31
100,Fail,47,25,2,12,35
100,Fail,46,28,3,10,36
100,Fail,52,22,0,15,37
100,Fail,46,35,0,12,34
100,Fail,46,25,0,15,31
100,Fail,55,15,2,11,44
100,Fail,50,26,0,11,39
100,Fail,44,35,0,6,38
100,Fail,50,22,1,18,32
100,Fail,47,34,0,12,35
100,Fail,45,28,0,15,30
100,Fail,50,31,0,10,40
100,Fail,46,33,0,11,35
100,Fail,43,27,7,12,31
100,Fail,53,22,1,11,42
100,Fail,53,23,0,15,38
100,Fail,59,15,0,14,45
100,Fail,46,31,4,11,35
100,Fail,47,27,0,14,33
100,Fail,49,28,0,9,40
100,Fail,41,29,10,11,30
100,Fail,46,30,0,12,34
100,Fail,53,30,0,6,47
100,Fail,46,29,0,8,38
100,Fail,50,34,4,5,45
100,Fail,50,25,0,14,36
100,Fail,49,27,0,12,37
100,Fail,45,33,3,10,35
100,Fail,52,27,1,8,44
100,Fail,48,28,0,14,34
100,Fail,56,21,1,12,44
100,Fail,44,34,0,11,33
100,Fail,46,34,0,12,34
100,Fail,48,22,7,12,36
100,Fail,48,31,0,11,37
100,Fail,50,26,1,10,40
100,Fail,44,25,1,15,29
100,Fail,51,28,0,12,39
100,Fail,44,28,0,13,31
100,Fail,48,27,8,6,42
100,Fail,49,22,2,12,37
100,Fail,47,27,5,13,34
100,Fail,46,29,0,10,36
100,Fail,49,30,0,12,37
100,Fail,48,32,0,13,35
100,Fail,46,28,2,15,31
100,Fail,46,30,0,13,33
100,Fail,49,26,4,11,38
100,Fail,41,33,0,12,29
100,Fail,51,17,6,16,35
100,Fail,49,28,3,8,41
100,Fail,48,27,0,14,34
100,Fail,43,37,0,9,34
100,Fail,55,21,2,13,42
100,Fail,46,27,1,16,30
100,Fail,55,21,0,14,41
100,Fail,46,31,0,14,32
100,Fail,56,21,0,8,48
100,Fail,48,31,0,8,40
100,Fail,42,35,0,15,27
100,Fail,50,25,0,12,38
100,Fail,49,22,1,15,34
100,Fail,40,27,0,15,25
100,Fail,48,29,6,8,40
100,Fail,47,19,0,21,26
100,Fail,47,27,0,9,38
100,Fail,44,32,3,11,33
100,Fail,52,25,0,12,40
100,Fail,42,30,0,15,27
100,Fail,40,35,6,9,31
100,Fail,55,24,0,10,45
100,Fail,46,18,12,18,28
100,Fail,48,24,0,18,30
100,Fail,38,29,9,19,19
100,Fail,47,29,2,15,32
100,Fail,42,34,0,13,29
100,Fail,46,29,0,11,35
100,Fail,46,28,0,16,30
100,Fail,49,19,0,19,30
100,Fail,48,25,0,13,35
100,Fail,52,26,0,9,43
100,Fail,50,23,0,12,38
100,Fail,48,27,0,11,37
100,Fail,53,26,6,9,44
100,Fail,53,25,0,11,42
100,Fail,51,29,0,13,38
100,Fail,46,24,0,18,28
100,Fail,46,26,0,14,32
100,Fail,41,42,0,8,33
100,Fail,40,31,0,22,18
100,Fail,44,19,14,14,30
100,Fail,50,23,9,13,37
100,Fail,46,25,0,14,32
100,Fail,51,30,0,9,42
100,Fail,49,25,5,9,40
100,Fail,51,21,4,17,34
100,Fail,47,23,2,15,32
100,Fail,53,18,5,11,42
100,Fail,54,17,4,10,44
100,Fail,42,30,0,17,25
100,Fail,46,28,4,12,34
100,Fail,45,34,0,9,36
100,Fail,51,24,5,15,36
100,Fail,45,25,9,13,32
100,Fail,44,28,7,8,36
100,Fail,45,21,9,19,26
100,Fail,59,16,3,10,49
100,Fail,45,26,4,15,30
100,Fail,52,23,0,9,43
100,Fail,50,19,1,15,35
100,Fail,52,18,6,11,41
100,Fail,52,29,0,9,43
100,Fail,51,21,3,16,35
100,Fail,48,27,0,11,37
100,Fail,48,25,0,14,34
100,Fail,42,32,0,17,25
100,Fail,52,24,3,12,40
100,Fail,48,26,0,17,31
100,Fail,54,26,0,10,44
100,Fail,51,23,0,14,37
100,Fail,41,39,0,14,27
100,Fail,51,29,0,13,38
100,Fail,43,36,3,11,32
100,Fail,49,23,0,16,33
100,Fail,41,36,6,12,29
100,Fail,54,20,4,12,42
100,Fail,59,18,0,13,46
100,Fail,48,27,0,16,32
100,Fail,47,26,1,16,31
100,Fail,48,29,4,11,37
100,Fail,45,28,6,13,32
100,Fail,49,23,5,10,39
100,Fail,51,23,0,12,39
100,Fail,45,23,6,15,30
100,Fail,43,25,4,15,28
100,Fail,47,26,3,11,36
100,Fail,43,18,4,22,21
100,Fail,45,39,0,9,36
100,Fail,54,24,0,9,45
100,Fail,46,23,3,15,31
100,Fail,47,31,2,8,39
100,Fail,47,21,6,15,32
100,Fail,43,33,0,18,25
100,Fail,48,35,0,8,40
100,Fail,49,29,5,8,41
100,Fail,60,19,0,10,50
100,Fail,54,22,0,11,43
100,Fail,48,29,5,7,41
100,Fail,48,24,4,12,36
100,Fail,43,22,9,18,25
100,Fail,45,33,4,12,33
100,Fail,55,18,6,13,42
100,Fail,47,23,6,18,29
100,Fail,46,30,6,11,35
100,Fail,52,26,3,5,47
100,Fail,48,30,0,12,36
100,Fail,42,25,6,14,28
100,Fail,46,25,4,11,35
100,Fail,50,31,0,7,43
100,Fail,46,31,0,13,33
100,Fail,49,26,2,12,37
100,Fail,44,36,0,9,35
100,Fail,52,26,3,12,40
100,Fail,56,19,1,9,47
100,Fail,47,29,0,18,29
100,Fail,51,23,0,14,37
100,Fail,47,30,1,11,36
100,Fail,47,24,5,11,36
100,Fail,47,33,0,8,39
100,Fail,50,31,0,10,40
100,Fail,45,26,4,16,29
100,Fail,47,30,0,12,35
100,Fail,52,26,0,9,43
100,Fail,47,29,0,12,35
100,Fail,41,35,0,13,28
100,Fail,47,22,5,17,30
100,Fail,43,29,7,12,31
100,Fail,44,28,10,11,33
100,Fail,63,17,0,7,56
100,Fail,52,27,0,9,43
100,Fail,45,28,2,10,35
100,Fail,50,33,0,10,40
100,Fail,45,27,0,15,30
100,Fail,53,27,0,9,44
100,Fail,57,21,0,11,46
100,Fail,48,31,0,11,37
100,Fail,47,29,3,11,36
100,Fail,53,25,2,10,43
100,Fail,51,21,1,16,35
100,Fail,50,23,6,12,38
100,Fail,48,23,6,14,34
100,Fail,48,28,2,13,35
100,Fail,41,33,3,16,25
100,Fail,42,28,6,15,27
100,Fail,54,19,3,12,42
100,Fail,44,29,7,10,34
100,Fail,62,19,0,9,53
100,Fail,46,18,9,14,32
100,Fail,54,20,0,17,37
100,Fail,41,24,0,24,17
100,Fail,45,29,4,13,32
100,Fail,49,24,3,11,38
100,Fail,51,19,3,16,35
100,Fail,49,26,0,15,34
100,Fail,46,31,0,12,34
100,Fail,52,24,0,13,39
100,Fail,45,35,3,8,37
100,Fail,45,32,0,11,34
100,Fail,55,24,0,10,45
100,Fail,49,29,0,13,36
100,Fail,54,27,0,12,42
100,Fail,54,23,0,10,44
100,Fail,44,33,2,11,33
100,Fail,51,24,0,16,35
100,Fail,52,22,2,16,36
100,Fail,51,21,6,10,41
100,Fail,34,33,12,15,19
100,Fail,48,30,0,10,38
100,Fail,43,28,4,12,31
100,Fail,57,22,0,11,46
100,Fail,49,27,2,13,36
100,Fail,37,29,0,22,15
100,Fail,51,25,0,12,39
100,Fail,52,23,0,16,36
100,Fail,47,26,3,12,35
100,Fail,52,24,0,14,38
100,Fail,46,23,0,16,30
100,Fail,51,24,0,14,37
100,Fail,50,31,0,12,38
100,Fail,56,17,3,10,46
100,Fail,50,31,0,11,39
100,Fail,47,28,0,15,32
100,Fail,44,27,3,14,30
100,Fail,39,36,0,18,21
100,Fail,43,29,6,15,28
100,Fail,48,31,1,8,40
100,Fail,43,34,0,14,29
100,Fail,53,28,0,10,43
100,Fail,43,26,0,22,21
100,Fail,45,29,0,14,31
100,Fail,45,31,0,19,26
100,Fail,55,19,1,10,45
100,Fail,46,29,1,12,34
100,Fail,50,26,0,12,38
100,Fail,49,25,0,16,33
100,Fail,47,25,1,14,33
100,Fail,45,28,6,12,33
100,Fail,43,35,0,12,31
100,Fail,48,30,0,12,36
100,Fail,39,35,5,11,28
100,Fail,53,27,0,8,45
100,Fail,48,31,0,9,39
100,Fail,52,26,0,12,40
100,Fail,51,31,0,6,45
100,Fail,50,25,0,13,37
100,Fail,52,28,0,9,43
100,Fail,50,31,0,12,38
100,Fail,45,29,0,13,32
100,Fail,47,29,0,15,32
100,Fail,53,30,0,7,46
100,Fail,42,30,3,13,29
100,Fail,54,21,5,12,42
100,Fail,42,34,2,13,29
100,Fail,55,22,2,12,43
100,Fail,40,30,0,20,20
100,Fail,52,16,3,18,34
100,Fail,49,27,0,12,37
100,Fail,41,43,0,12,29
100,Fail,42,31,5,15,27
100,Fail,54,30,0,7,47
100,Fail,50,19,2,15,35
100,Fail,45,27,1,15,30
100,Fail,41,36,0,15,26
100,Fail,43,35,0,14,29
100,Fail,54,22,1,11,43
100,Fail,45,35,0,8,37
100,Fail,39,46,0,10,29
100,Fail,54,17,0,18,36
100,Fail,46,27,0,18,28
100,Fail,45,32,0,15,30
100,Fail,52,24,0,14,38
100,Fail,44,23,13,14,30
100,Fail,43,31,1,11,32
100,Fail,50,18,6,14,36
100,Fail,51,26,0,14,37
100,Fail,57,24,0,9,48
100,Fail,51,23,0,12,39
100,Fail,49,21,3,18,31
100,Fail,53,21,1,16,37
100,Fail,51,27,0,13,38
100,Fail,46,31,0,11,35
100,Fail,48,28,2,11,37
100,Fail,52,22,11,8,44
100,Fail,38,37,0,19,19
100,Fail,44,28,8,15,29
100,Fail,54,16,2,16,38
100,Fail,51,20,3,12,39
100,Fail,59,23,0,7,52
100,Fail,50,23,3,11,39
100,Fail,41,38,3,11,30
100,Fail,47,27,5,14,33
100,Fail,41,34,0,18,23
100,Fail,55,17,0,14,41
100,Fail,44,32,0,16,28
100,Fail,49,25,1,13,36
100,Fail,59,16,4,10,49
100,Fail,45,27,2,16,29
100,Fail,54,20,8,7,47
100,Fail,49,26,8,8,41
100,Fail,44,35,0,14,30
100,Fail,47,23,2,16,31
100,Fail,45,35,0,12,33
100,Fail,54,23,2,8,46
100,Fail,46,24,3,17,29
100,Fail,53,19,1,15,38
100,Fail,52,34,0,7,45
100,Fail,53,28,1,11,42
100,Fail,49,28,0,12,37
100,Fail,44,37,0,8,36
100,Fail,54,21,0,15,39
100,Fail,52,18,6,14,38
100,Fail,46,26,2,13,33
100,Fail,59,24,0,4,55
100,Fail,51,25,6,13,38
100,Fail,43,35,0,17,26
100,Fail,45,31,0,16,29
100,Fail,53,26,0,10,43
100,Fail,45,32,0,15,30
100,Fail,48,22,0,15,33
100,Fail,50,28,0,9,41
100,Fail,53,20,2,16,37
100,Fail,48,23,0,14,34
100,Fail,43,22,6,20,23
100,Fail,51,30,0,9,42
100,Fail,41,31,2,16,25
100,Fail,48,28,0,12,36
100,Fail,43,23,7,15,28
100,Fail,48,33,0,9,39
100,Fail,51,24,3,10,41
100,Fail,46,24,1,17,29
100,Fail,43,30,0,16,27
100,Fail,52,23,4,13,39
100,Fail,42,33,1,13,29
100,Fail,42,27,9,14,28
100,Fail,55,22,3,11,44
100,Fail,50,23,6,14,36
100,Fail,41,34,0,16,25
100,Fail,52,30,0,8,44
100,Fail,54,21,1,11,43
100,Fail,37,28,2,20,17
100,Fail,55,16,1,10,45
100,Fail,50,31,0,10,40
100,Fail,56,19,1,12,44
100,Fail,55,25,0,11,44
100,Fail,46,32,0,13,33
100,Fail,46,28,0,15,31
100,Fail,49,23,0,12,37
100,Fail,48,27,0,13,35
100,Fail,48,25,3,13,35
100,Fail,47,23,0,15,32
100,Fail,51,30,4,8,43
100,Fail,42,32,5,13,29
100,Fail,52,18,6,11,41
100,Fail,47,31,0,13,34
100,Fail,41,29,11,11,30
100,Fail,41,35,0,15,26
100,Fail,42,29,6,12,30
100,Fail,47,23,6,15,32
100,Fail,46,31,0,13,33
100,Fail,58,19,0,9,49
100,Fail,47,27,4,12,35
100,Fail,43,23,11,13,30
100,Fail,52,26,0,11,41
100,Fail,47,23,2,16,31
100,Fail,44,29,5,13,31
100,Fail,40,32,0,18,22
100,Fail,51,25,3,12,39
100,Fail,52,29,0,10,42
100,Fail,52,29,0,11,41
100,Fail,52,25,0,12,40
100,Fail,45,23,6,16,29
100,Fail,52,32,0,8,44
100,Fail,48,20,11,12,36
100,Fail,45,24,7,15,30
100,Fail,49,24,3,15,34
100,Fail,48,30,0,12,36
100,Fail,57,19,2,10,47
100,Fail,43,30,0,15,28
100,Fail,40,27,13,11,29
100,Fail,49,29,1,12,37
100,Fail,45,28,5,11,34
100,Fail,51,25,4,11,40
100,Fail,50,23,0,14,36
100,Fail,48,24,7,13,35
100,Fail,44,26,4,17,27
100,Fail,47,38,0,7,40
100,Fail,47,25,6,14,33
100,Fail,50,29,0,9,41
100,Fail,46,25,0,21,25
100,Fail,52,20,2,12,40
100,Fail,52,22,2,9,43
100,Fail,45,30,0,14,31
100,Fail,47,33,0,14,33
100,Fail,42,35,0,10,32
100,Fail,47,24,0,15,32
100,Fail,48,26,0,10,38
100,Fail,50,27,0,14,36
100,Fail,45,30,1,14,31
100,Fail,50,28,0,9,41
100,Fail,51,25,1,12,39
100,Fail,46,29,0,15,31
100,Fail,37,37,0,15,22
100,Fail,45,30,0,11,34
100,Fail,52,23,6,9,43
100,Fail,40,40,0,10,30
100,Fail,45,29,0,13,32
100,Fail,42,36,0,16,26
100,Fail,52,22,3,12,40
100,Fail,39,42,0,13,26
100,Fail,54,26,0,10,44
100,Fail,42,33,2,16,26
100,Fail,41,36,0,12,29
100,Fail,45,22,3,15,30
100,Fail,50,29,0,9,41
100,Fail,52,24,0,11,41
100,Fail,44,28,0,17,27
100,Fail,43,34,0,13,30
100,Fail,46,27,2,11,35
100,Fail,44,24,5,17,27
100,Fail,49,32,0,13,36
100,Fail,38,32,0,20,18
100,Fail,47,29,0,12,35
100,Fail,52,25,0,11,41
100,Fail,59,20,0,11,48
100,Fail,55,23,0,10,45
100,Fail,49,27,0,11,38
100,Fail,47,26,0,16,31
100,Fail,48,26,0,14,34
100,Fail,44,30,0,17,27
100,Fail,44,27,3,15,29
100,Fail,49,30,0,14,35
100,Fail,57,23,0,10,47
100,Fail,50,17,4,17,33
100,Fail,45,23,1,17,28
100,Fail,42,30,9,11,31
100,Fail,43,31,1,16,27
100,Fail,52,26,0,10,42
100,Fail,48,33,0,7,41
100,Fail,54,26,0,10,44
100,Fail,46,25,2,19,27
100,Fail,48,29,0,11,37
100,Fail,45,34,0,12,33
100,Fail,56,17,2,12,44
100,Fail,47,29,0,12,35
100,Fail,42,31,2,14,28
100,Fail,51,21,6,15,36
100,Fail,47,28,0,12,35
100,Fail,50,26,0,14,36
100,Fail,50,25,4,12,38
100,Fail,50,20,0,16,34
100,Fail,44,27,9,12,32
100,Fail,47,27,1,16,31
100,Fail,41,25,9,14,27
100,Fail,47,33,0,12,35
100,Fail,49,30,1,10,39
100,Fail,49,22,6,14,35
100,Fail,51,24,0,14,37
100,Fail,55,21,0,11,44
100,Fail,47,29,0,15,32
100,Fail,46,33,0,10,36
100,Fail,48,27,4,9,39
100,Fail,50,30,5,11,39
100,Fail,55,22,0,10,45
100,Fail,49,30,0,12,37
100,Fail,52,29,2,7,45
100,Fail,45,21,1,22,23
100,Fail,45,33,1,9,36
100,Fail,51,24,0,13,38
100,Fail,45,27,1,14,31
100,Fail,57,19,0,13,44
100,Fail,55,24,3,9,46
100,Fail,50,25,8,11,39
100,Fail,47,27,7,10,37
100,Fail,52,17,5,16,36
100,Fail,49,25,2,13,36
100,Fail,46,25,7,10,36
100,Fail,43,35,0,12,31
100,Fail,52,27,0,12,40
100,Fail,51,25,6,13,38
100,Fail,51,20,3,10,41
100,Fail,48,35,0,8,40
100,Fail,50,24,0,8,42
100,Fail,52,28,0,9,43
100,Fail,48,25,0,17,31
100,Fail,53,17,5,13,40
100,Fail,43,29,0,16,27
100,Fail,49,27,0,13,36
100,Fail,50,34,0,10,40
100,Fail,51,23,6,12,39
100,Fail,49,26,8,12,37
100,Fail,45,28,3,11,34
100,Fail,49,28,0,14,35
100,Fail,50,27,4,13,37
100,Fail,45,24,5,12,33
100,Fail,52,21,0,12,40
100,Fail,39,33,3,16,23
100,Fail,40,25,14,16,24
100,Fail,43,33,0,13,30
100,Fail,52,27,6,9,43
100,Fail,54,20,0,12,42
100,Fail,51,29,0,7,44
100,Fail,60,19,0,11,49
100,Fail,44,30,0,14,30
100,Fail,51,23,4,11,40
100,Fail,44,32,0,14,30
100,Fail,44,26,5,17,27
100,Fail,47,20,7,13,34
100,Fail,43,24,3,18,25
100,Fail,47,30,0,13,34
100,Fail,39,31,12,12,27
100,Fail,53,23,3,12,41
100,Fail,44,24,1,19,25
100,Fail,48,26,8,11,37
100,Fail,50,23,3,12,38
100,Fail,57,23,0,10,47
100,Fail,43,31,2,13,30
100,Fail,50,22,5,13,37
100,Fail,48,27,8,10,38
100,Fail,51,23,10,7,44
100,Fail,41,28,6,13,28
100,Fail,46,35,1,8,38
100,Fail,48,40,0,6,42
100,Fail,49,30,1,10,39
100,Fail,46,33,0,12,34
100,Fail,51,36,0,5,46
100,Fail,50,30,2,10,40
100,Fail,39,35,0,16,23
100,Fail,49,26,0,13,36
100,Fail,48,21,4,14,34
100,Fail,43,31,0,14,29
100,Fail,47,28,2,17,30
100,Fail,41,33,0,16,25
100,Fail,50,25,0,11,39
100,Fail,42,30,2,15,27
100,Fail,43,31,0,17,26
100,Fail,49,31,0,10,39
100,Fail,55,20,5,7,48
100,Fail,51,19,4,17,34
100,Fail,47,23,3,11,36
100,Fail,47,31,0,12,35
100,Fail,45,28,5,10,35
100,Fail,43,23,7,15,28
100,Fail,48,25,0,18,30
100,Fail,39,30,2,15,24
100,Fail,52,22,1,12,40
100,Fail,49,32,0,11,38
100,Fail,44,25,6,15,29
100,Fail,46,27,0,17,29
100,Fail,51,21,1,18,33
100,Fail,51,25,0,13,38
100,Fail,49,32,0,7,42
100,Fail,54,29,0,8,46
100,Fail,49,25,0,14,35
100,Fail,43,27,6,14,29
100,Fail,43,23,7,17,26
100,Fail,55,20,0,14,41
100,Fail,46,28,0,19,27
100,Fail,50,30,0,9,41
100,Fail,43,37,0,13,30
100,Fail,40,38,0,14,26
100,Fail,49,22,4,12,37
100,Fail,45,26,7,12,33
100,Fail,45,31,8,10,35
100,Fail,54,20,0,16,38
100,Fail,56,22,6,9,47
100,Fail,44,29,4,10,34
100,Fail,50,28,3,11,39
100,Fail,55,22,0,10,45
100,Fail,49,22,0,19,30
100,Fail,49,28,0,10,39
100,Fail,53,22,3,9,44
100,Fail,52,35,0,8,44
100,Fail,50,27,1,11,39
100,Fail,41,36,0,14,27
100,Fail,49,27,0,15,34
100,Fail,46,32,0,13,33
100,Fail,51,20,0,17,34
100,Fail,56,20,0,13,43
100,Fail,42,28,0,15,27
100,Fail,51,24,0,11,40
100,Fail,38,33,4,12,26
100,Fail,55,21,0,11,44
100,Fail,53,21,0,12,41
100,Fail,43,25,4,18,25
100,Fail,43,38,0,11,32
100,Fail,45,28,0,16,29
100,Fail,51,22,8,9,42
100,Fail,50,27,0,12,38
100,Fail,50,19,6,11,39
100,Fail,50,31,0,12,38
100,Fail,55,19,3,10,45
100,Fail,44,22,5,17,27
100,Fail,41,37,0,11,30
100,Fail,53,24,0,10,43
100,Fail,52,15,0,17,35
100,Fail,43,30,2,13,30
100,Fail,46,34,0,16,30
100,Fail,45,33,4,11,34
100,Fail,41,35,0,11,30
100,Fail,45,29,3,12,33
100,Fail,58,14,4,12,46
100,Fail,47,37,1,7,40
100,Fail,46,25,8,12,34
100,Fail,44,26,3,15,29
100,Fail,53,22,0,12,41
100,Fail,48,28,0,11,37
100,Fail,41,30,3,19,22
100,Fail,44,32,0,12,32
100,Fail,41,21,13,14,27
100,Fail,52,24,1,12,40
100,Fail,39,29,4,18,21
100,Fail,37,42,0,12,25
100,Fail,46,32,0,11,35
100,Fail,50,28,0,13,37
100,Fail,48,17,8,15,33
100,Fail,36,33,0,22,14
100,Fail,45,31,8,9,36
100,Fail,50,22,0,16,34
100,Fail,42,34,1,11,31
100,Fail,48,20,5,18,30
100,Fail,42,31,0,15,27
100,Fail,54,27,0,6,48
100,Fail,46,25,1,11,35
100,Fail,46,38,0,9,37
100,Fail,50,21,0,13,37
100,Fail,48,26,0,15,33
100,Fail,47,34,2,7,40
100,Fail,49,24,4,11,38
100,Fail,43,30,9,8,35
100,Fail,45,23,8,16,29
100,Fail,49,28,0,10,39
100,Fail,44,28,2,17,27
100,Fail,49,28,0,13,36
100,Fail,47,29,5,9,38
100,Fail,50,27,0,17,33
100,Fail,46,33,0,13,33
100,Fail,52,23,0,16,36
100,Fail,49,29,5,9,40
100,Fail,46,27,4,17,29
100,Fail,39,34,0,19,20
100,Fail,49,24,2,12,37
100,Fail,45,22,10,13,32
100,Fail,50,19,2,19,31
100,Fail,47,24,9,13,34
100,Fail,49,31,0,11,38
100,Fail,44,26,3,11,33
100,Fail,51,24,3,11,40
100,Fail,42,30,3,16,26
100,Fail,50,29,5,6,44
100,Fail,36,40,0,17,19
100,Fail,52,18,6,13,39
100,Fail,50,24,0,14,36
100,Fail,48,29,0,15,33
100,Fail,49,28,1,7,42
100,Fail,46,32,0,13,33
100,Fail,49,21,3,17,32
100,Fail,42,17,2,22,20
100,Fail,48,27,0,11,37
100,Fail,52,28,0,9,43
100,Fail,50,23,6,9,41
100,Fail,43,30,0,14,29
100,Fail,42,32,0,16,26
100,Fail,55,21,3,10,45
100,Fail,38,34,0,18,20
100,Fail,45,35,0,10,35
100,Fail,47,28,2,13,34
100,Fail,57,12,6,15,42
100,Fail,50,27,1,9,41
100,Fail,45,26,0,14,31
100,Fail,43,29,4,12,31
100,Fail,48,32,1,10,38
100,Fail,46,22,2,18,28
100,Fail,54,21,3,13,41
100,Fail,53,26,0,7,46
100,Fail,57,19,2,8,49
100,Fail,45,30,6,11,34
100,Fail,48,30,0,13,35
100,Fail,53,18,1,8,45
100,Fail,52,24,0,11,41
100,Fail,45,29,1,14,31
100,Fail,55,22,0,16,39
100,Fail,37,32,7,15,22
100,Fail,48,27,1,13,35
100,Fail,50,27,0,8,42
100,Fail,48,27,0,16,32
100,Fail,52,25,0,14,38
100,Fail,46,32,0,13,33
100,Fail,46,21,6,16,30
100,Fail,45,32,1,16,29
100,Fail,45,27,7,9,36
100,Fail,46,32,0,12,34
100,Fail,49,26,11,6,43
100,Fail,39,34,0,20,19
100,Fail,53,19,0,17,36
100,Fail,46,27,8,13,33
100,Fail,46,32,6,10,36
100,Fail,48,24,1,12,36
100,Fail,44,33,0,13,31
100,Fail,44,29,1,13,31
100,Fail,41,28,3,15,26
100,Fail,52,22,0,13,39
100,Fail,45,32,0,11,34
100,Fail,46,34,0,12,34
100,Fail,53,27,4,7,46
100,Fail,46,31,5,10,36
100,Fail,50,32,0,9,41
100,Fail,53,24,2,9,44
100,Fail,50,28,0,14,36
100,Fail,50,25,0,16,34
100,Fail,55,23,4,6,49
100,Fail,53,22,0,14,39
100,Fail,46,35,0,8,38
100,Fail,51,32,0,11,40
100,Fail,52,26,1,7,45
100,Fail,47,29,4,10,37
100,Fail,55,15,6,14,41
100,Fail,49,26,5,11,38
100,Fail,56,25,0,10,46
100,Fail,39,32,9,12,27
100,Fail,40,37,0,13,27
100,Fail,51,26,7,6,45
100,Fail,56,21,0,10,46
100,Fail,50,20,6,18,32
100,Fail,53,25,0,10,43
100,Fail,46,28,3,13,33
100,Fail,50,26,0,13,37
100,Fail,47,32,0,7,40
100,Fail,44,25,11,12,32
100,Fail,43,33,7,12,31
100,Fail,45,19,6,21,24
100,Fail,52,27,0,11,41
100,Fail,47,26,1,13,34
100,Fail,36,38,0,16,20
100,Fail,36,18,13,22,14
100,Fail,51,23,0,13,38
100,Fail,49,32,0,9,40
100,Fail,39,34,8,14,25
100,Fail,47,31,0,11,36
100,Fail,41,30,0,13,28
100,Fail,59,16,2,14,45
100,Fail,48,29,0,12,36
100,Fail,56,13,3,17,39
100,Fail,48,21,5,14,34
100,Fail,46,35,0,12,34
100,Fail,51,21,0,17,34
100,Fail,47,33,0,12,35
100,Fail,50,32,0,8,42
100,Fail,48,25,0,10,38
100,Fail,55,26,0,12,43
100,Fail,46,35,0,8,38
100,Fail,52,24,4,12,40
100,Fail,46,38,0,7,39
100,Fail,49,23,0,15,34
100,Fail,49,21,8,11,38
100,Fail,54,29,0,7,47
100,Fail,47,25,7,12,35
100,Fail,38,34,4,13,25
100,Fail,51,22,0,14,37
100,Fail,46,30,0,12,34
100,Fail,56,24,0,12,44
100,Fail,42,35,0,16,26
100,Fail,41,37,0,17,24
100,Fail,47,26,0,15,32
100,Fail,52,30,0,13,39
100,Fail,48,32,0,10,38
100,Fail,38,46,0,10,28
100,Fail,52,29,0,10,42
100,Fail,53,23,0,12,41
100,Fail,50,22,1,13,37
100,Fail,49,28,0,11,38
100,Fail,47,23,0,20,27
100,Fail,45,31,0,14,31
100,Fail,45,31,0,13,32
100,Fail,50,30,1,7,43
100,Fail,39,39,0,13,26
100,Fail,49,23,1,13,36
100,Fail,50,23,4,10,40
100,Fail,55,19,5,8,47
100,Fail,48,25,7,11,37
100,Fail,53,18,3,11,42
100,Fail,52,26,6,8,44
100,Fail,44,22,2,18,26
100,Fail,50,27,3,10,40
100,Fail,41,31,1,15,26
100,Fail,40,34,0,15,25
100,Fail,51,27,0,13,38
100,Fail,52,25,0,10,42
100,Fail,50,21,1,12,38
100,Fail,51,18,3,15,36
100,Fail,53,29,0,9,44
100,Fail,44,27,0,13,31
100,Fail,39,37,0,13,26
100,Fail,38,35,8,13,25
100,Fail,40,29,6,15,25
100,Fail,50,34,0,5,45
100,Fail,52,20,5,13,39
100,Fail,51,28,1,10,41
100,Fail,50,24,2,15,35
100,Fail,51,26,0,11,40
100,Fail,57,20,1,9,48
100,Fail,52,28,0,10,42
100,Fail,47,24,0,13,34
100,Fail,43,24,7,12,31
100,Fail,46,36,0,13,33
100,Fail,52,25,0,9,43
100,Fail,51,19,9,9,42
100,Fail,51,25,3,10,41
100,Fail,47,32,0,14,33
100,Fail,49,19,1,18,31
100,Fail,47,29,10,9,38
100,Fail,43,35,0,10,33
100,Fail,50,27,0,10,40
100,Fail,42,27,0,17,25
100,Fail,49,32,0,9,40
100,Fail,51,25,2,8,43
100,Fail,41,31,0,20,21
100,Fail,37,23,6,23,14
100,Fail,49,23,6,13,36
100,Fail,47,29,0,14,33
100,Fail,50,23,2,13,37
100,Fail,47,29,5,12,35
100,Fail,57,20,0,12,45
100,Fail,51,23,3,12,39
100,Fail,50,27,0,12,38
100,Fail,52,29,0,7,45
100,Fail,51,32,3,5,46
100,Fail,50,22,0,13,37
100,Fail,45,29,7,11,34
100,Fail,48,26,9,8,40
100,Fail,50,18,9,14,36
100,Fail,49,28,0,14,35
100,Fail,52,23,0,12,40
100,Fail,44,25,7,15,29
100,Fail,46,36,0,10,36
100,Fail,44,35,0,12,32
100,Fail,43,37,0,10,33
100,Fail,51,17,0,20,31
100,Fail,39,22,6,22,17
100,Fail,50,23,0,15,35
100,Fail,49,29,0,13,36
100,Fail,47,20,13,13,34
100,Fail,54,25,0,12,42
100,Fail,45,27,0,16,29
100,Fail,55,25,0,10,45
100,Fail,40,37,0,15,25
100,Fail,50,26,0,15,35
100,Fail,49,27,0,14,35
100,Fail,50,28,0,14,36
100,Fail,44,30,4,12,32
100,Fail,49,27,0,12,37
100,Fail,46,30,0,14,32
100,Fail,56,26,0,7,49
100,Fail,40,37,0,20,20
100,Fail,49,35,0,6,43
100,Fail,59,13,0,14,45
100,Fail,49,22,5,8,41
100,Fail,42,33,0,14,28
100,Fail,39,33,3,14,25
100,Fail,47,23,5,15,32
100,Fail,49,26,0,14,35
100,Fail,42,39,0,11,31
100,Fail,48,20,5,17,31
100,Fail,55,23,0,10,45
100,Fail,52,24,0,14,38
100,Fail,45,29,0,15,30
100,Fail,45,29,2,14,31
100,Fail,54,23,0,14,40
100,Fail,47,32,5,9,38
100,Fail,45,27,0,15,30
100,Fail,49,30,0,11,38
100,Fail,54,22,5,7,47
100,Fail,41,36,0,12,29
100,Fail,56,29,0,4,52
100,Fail,42,30,8,11,31
100,Fail,52,25,0,11,41
100,Fail,50,31,0,10,40
100,Fail,42,30,2,14,28
100,Fail,49,24,6,11,38
100,Fail,41,37,0,14,27
100,Fail,41,32,0,16,25
100,Fail,50,26,0,13,37
100,Fail,45,27,3,15,30
100,Fail,45,30,0,15,30
100,Fail,45,26,4,14,31
100,Fail,49,21,4,11,38
100,Fail,48,32,0,11,37
100,Fail,43,25,8,14,29
100,Fail,52,26,0,12,40
100,Fail,50,21,3,13,37
100,Fail,44,27,0,16,28
100,Fail,51,25,0,10,41
100,Fail,52,31,0,8,44
100,Fail,50,27,0,13,37
100,Fail,41,29,4,14,27
100,Fail,48,27,0,16,32
100,Fail,56,28,0,4,52
100,Fail,38,31,8,16,22
100,Fail,47,29,2,14,33
100,Fail,39,37,0,12,27
100,Fail,49,26,0,14,35
100,Fail,56,23,0,9,47
100,Fail,41,27,7,11,30
100,Fail,41,36,0,12,29
100,Fail,46,29,2,12,34
100,Fail,44,25,7,17,27
100,Fail,48,25,0,14,34
100,Fail,42,26,2,21,21
100,Fail,43,44,0,6,37
100,Fail,56,18,2,12,44
100,Fail,56,21,0,11,45
100,Fail,49,29,0,10,39
100,Fail,49,21,5,15,34
100,Fail,48,26,0,17,31
100,Fail,43,25,1,20,23
100,Fail,51,30,0,11,40
100,Fail,54,23,0,11,43
100,Fail,47,31,0,9,38
100,Fail,49,25,0,15,34
100,Fail,43,30,0,17,26
100,Fail,48,29,0,12,36
100,Fail,50,21,2,13,37
100,Fail,48,31,0,12,36
100,Fail,45,32,6,10,35
100,Fail,48,29,0,11,37
100,Fail,52,21,6,10,42
100,Fail,38,28,6,17,21
100,Fail,44,24,7,18,26
100,Fail,42,27,8,16,26
100,Fail,44,25,2,15,29
100,Fail,42,35,0,15,27
100,Fail,40,36,5,13,27
100,Fail,48,25,0,12,36
100,Fail,45,26,3,15,30
100,Fail,50,22,4,9,41
100,Fail,47,31,1,9,38
100,Fail,48,29,0,11,37
100,Fail,43,32,0,14,29
100,Fail,43,19,8,18,25
100,Fail,47,21,2,18,29
100,Fail,44,30,0,11,33
100,Fail,40,31,1,14,26
100,Fail,42,24,8,17,25
100,Fail,46,22,6,16,30
100,Fail,47,26,4,11,36
100,Fail,49,27,0,15,34
100,Fail,50,28,4,9,41
100,Fail,51,23,2,12,39
100,Fail,52,25,0,11,41
100,Fail,55,20,1,10,45
100,Fail,46,32,1,10,36
100,Fail,43,33,4,11,32
100,Fail,49,18,2,11,38
100,Fail,45,31,0,11,34
100,Fail,50,32,0,9,41
100,Fail,49,30,0,13,36
100,Fail,50,30,2,10,40
100,Fail,50,26,1,9,41
100,Fail,45,27,4,14,31
100,Fail,51,28,0,15,36
100,Fail,40,35,0,13,27
100,Fail,47,27,4,13,34
100,Fail,52,25,3,10,42
100,Fail,52,25,0,8,44
100,Fail,45,33,0,13,32
100,Fail,49,22,0,14,35
100,Fail,49,26,0,14,35
100,Fail,52,29,0,13,39
100,Fail,62,19,0,10,52
100,Fail,42,26,13,11,31
100,Fail,43,28,0,19,24
100,Fail,50,20,1,16,34
100,Fail,44,25,0,19,25
100,Fail,47,36,0,8,39
100,Fail,41,34,6,6,35
100,Fail,42,31,6,13,29
100,Fail,47,33,0,9,38
100,Fail,52,25,0,9,43
100,Fail,41,31,0,21,20
100,Fail,47,29,0,9,38
100,Fail,40,36,0,16,24
100,Fail,52,28,2,9,43
100,Fail,49,29,0,8,41
100,Fail,45,33,0,11,34
100,Fail,47,27,0,13,34
100,Fail,44,43,0,8,36
100,Fail,48,24,4,14,34
100,Fail,49,28,2,12,37
100,Fail,38,30,8,15,23
100,Fail,53,25,1,10,43
100,Fail,41,28,3,19,22
100,Fail,50,24,0,12,38
100,Fail,48,28,3,11,37
100,Fail,45,31,0,11,34
100,Fail,47,29,3,9,38
100,Fail,50,29,2,10,40
100,Fail,51,29,1,10,41
100,Fail,41,31,7,15,26
100,Fail,43,30,0,15,28
100,Fail,42,25,5,18,24
100,Fail,46,19,14,12,34
100,Fail,45,28,0,14,31
100,Fail,38,36,0,16,22
100,Fail,46,31,0,15,31
100,Fail,47,24,13,10,37
100,Fail,45,33,2,10,35
100,Fail,47,29,0,10,37
100,Fail,41,39,0,10,31
100,Fail,50,22,1,15,35
100,Fail,41,33,0,16,25
100,Fail,52,29,0,9,43
100,Fail,52,26,0,12,40
100,Fail,52,22,1,11,41
100,Fail,46,29,7,10,36
100,Fail,46,34,1,8,38
100,Fail,45,24,9,16,29
100,Fail,43,23,6,18,25
100,Fail,40,33,0,17,23
100,Fail,48,25,2,12,36
100,Fail,44,29,0,15,29
100,Fail,47,30,0,18,29
100,Fail,40,34,0,15,25
100,Fail,44,28,7,12,32
100,Fail,50,26,0,13,37
100,Fail,50,29,0,13,37
100,Fail,39,29,8,14,25
100,Fail,44,23,2,18,26
100,Fail,44,30,6,9,35
100,Fail,50,27,0,13,37
100,Fail,48,31,0,12,36
100,Fail,49,24,4,11,38
100,Fail,46,26,0,15,31
100,Fail,41,34,1,12,29
100,Fail,49,21,0,15,34
100,Fail,46,31,0,12,34
100,Fail,56,20,0,13,43
100,Fail,43,28,5,15,28
100,Fail,59,20,0,12,47
100,Fail,47,23,0,17,30
100,Fail,48,32,0,9,39
100,Fail,41,31,0,13,28
100,Fail,46,26,11,10,36
100,Fail,49,23,4,15,34
100,Fail,49,24,2,17,32
100,Fail,45,24,0,19,26
100,Fail,40,26,8,15,25
100,Fail,50,30,0,10,40
100,Fail,43,27,0,19,24
100,Fail,43,38,0,7,36
100,Fail,50,25,6,11,39
100,Fail,48,29,0,13,35
100,Fail,48,25,3,13,35
100,Fail,48,24,4,16,32
100,Fail,57,23,0,9,48
100,Fail,42,42,0,10,32
100,Fail,52,13,10,14,38
100,Fail,47,29,0,16,31
100,Fail,51,28,0,9,42
100,Fail,48,31,0,11,37
100,Fail,49,28,0,14,35
100,Fail,47,27,0,14,33
100,Fail,50,17,1,16,34
100,Fail,52,21,6,11,41
100,Fail,54,22,0,11,43
100,Fail,42,27,0,19,23
100,Fail,43,29,0,15,28
100,Fail,47,25,2,19,28
100,Fail,45,25,0,14,31
100,Fail,44,26,0,17,27
100,Fail,55,27,0,12,43
100,Fail,50,26,0,11,39
100,Fail,49,23,1,14,35
100,Fail,53,19,8,9,44
100,Fail,45,32,7,9,36
100,Fail,45,35,0,10,35
100,Fail,44,25,10,11,33
100,Fail,47,33,0,12,35
100,Fail,55,20,2,11,44
100,Fail,49,25,1,12,37
100,Fail,40,27,0,19,21
100,Fail,38,33,0,19,19
100,Fail,45,25,7,15,30
100,Fail,42,33,0,15,27
100,Fail,42,30,4,14,28
100,Fail,51,26,6,10,41
100,Fail,52,20,4,15,37
100,Fail,47,33,0,7,40
100,Fail,54,23,4,8,46
100,Fail,44,29,0,13,31
100,Fail,47,27,0,16,31
100,Fail,43,32,3,10,33
100,Fail,46,25,7,15,31
100,Fail,42,35,0,11,31
100,Fail,39,48,0,9,30
100,Fail,48,30,0,12,36
100,Fail,41,37,0,15,26
100,Fail,50,26,1,9,41
100,Fail,48,29,0,15,33
100,Fail,53,28,0,7,46
100,Fail,50,29,0,11,39
100,Fail,40,31,9,9,31
100,Fail,43,36,0,12,31
100,Fail,43,27,0,17,26
100,Fail,51,19,2,17,34
100,Fail,46,36,0,6,40
100,Fail,49,32,0,9,40
100,Fail,41,34,0,15,26
100,Fail,46,27,2,12,34
100,Fail,46,35,0,11,35
100,Fail,43,36,0,12,31
100,Fail,50,24,3,12,38
100,Fail,42,30,6,14,28
100,Fail,49,26,0,14,35
100,Fail,50,28,0,10,40
100,Fail,53,29,0,7,46
100,Fail,52,28,0,8,44
100,Fail,53,19,7,10,43
100,Fail,56,22,2,11,45
100,Fail,44,28,15,6,38
100,Fail,49,22,3,13,36
100,Fail,48,28,0,12,36
100,Fail,53,24,0,10,43
100,Fail,52,22,0,13,39
100,Fail,56,17,3,12,44
100,Fail,50,27,0,9,41
100,Fail,53,26,4,9,44
100,Fail,44,29,6,11,33
100,Fail,48,27,4,8,40
100,Fail,53,26,1,7,46
100,Fail,53,23,3,11,42
100,Fail,40,32,0,19,21
100,Fail,59,24,0,8,51
100,Fail,49,28,0,14,35
100,Fail,46,35,0,10,36
100,Fail,38,28,6,14,24
100,Fail,46,24,4,14,32
100,Fail,56,28,0,8,48
100,Fail,55,25,0,10,45
100,Fail,45,38,0,8,37
100,Fail,51,28,0,11,40
100,Fail,43,26,1,20,23
100,Fail,53,25,0,11,42
100,Fail,45,30,0,14,31
100,Fail,47,23,5,14,33
100,Fail,44,24,5,21,23
100,Fail,43,36,0,12,31
100,Fail,50,28,4,6,44
100,Fail,56,18,0,17,39
100,Fail,52,32,0,7,45
100,Fail,52,28,0,11,41
100,Fail,57,23,0,6,51
100,Fail,47,26,0,14,33
100,Fail,44,34,0,14,30
100,Fail,42,27,7,16,26
100,Fail,40,22,8,25,15
100,Fail,50,26,1,14,36
100,Fail,47,28,7,11,36
100,Fail,53,27,0,6,47
100,Fail,51,25,1,9,42
100,Fail,47,21,0,20,27
100,Fail,48,25,0,15,33
100,Fail,45,32,0,11,34
100,Fail,41,36,0,10,31
100,Fail,49,24,3,14,35
100,Fail,57,19,0,14,43
100,Fail,42,26,8,10,32
100,Fail,55,18,4,12,43
100,Fail,48,27,0,14,34
100,Fail,49,24,5,10,39
100,Fail,49,27,3,11,38
100,Fail,45,22,11,9,36
100,Fail,47,25,0,14,33
100,Fail,42,32,6,10,32
100,Fail,52,26,0,11,41
100,Fail,49,25,3,16,33
100,Fail,45,28,0,15,30
100,Fail,52,20,0,10,42
100,Fail,47,28,9,9,38
100,Fail,36,32,8,13,23
100,Fail,43,30,0,18,25
100,Fail,55,20,3,10,45
100,Fail,50,22,0,18,32
100,Fail,46,26,3,14,32
100,Fail,51,21,5,13,38
100,Fail,43,33,2,11,32
100,Fail,39,30,4,13,26
100,Fail,51,27,0,14,37
100,Fail,46,30,0,10,36
100,Fail,48,24,4,14,34
100,Fail,50,27,12,7,43
100,Fail,37,26,10,21,16
100,Fail,45,33,0,15,30
100,Fail,47,32,0,10,37
100,Fail,49,16,13,11,38
100,Fail,50,23,0,16,34
100,Fail,45,35,0,11,34
100,Fail,50,25,0,16,34
100,Fail,45,27,5,16,29
100,Fail,51,24,0,13,38
100,Fail,52,28,0,8,44
100,Fail,53,25,0,13,40
100,Fail,55,22,2,9,46
100,Fail,45,31,0,13,32
100,Fail,46,34,0,11,35
100,Fail,43,30,5,14,29
100,Fail,55,31,0,6,49
100,Fail,49,29,0,12,37
100,Fail,46,34,0,14,32
100,Fail,47,24,0,16,31
100,Fail,46,32,0,11,35
100,Fail,55,24,0,8,47
100,Fail,48,32,2,9,39
100,Fail,49,23,0,17,32
100,Fail,49,24,5,11,38
100,Fail,49,29,0,11,38
100,Fail,51,21,0,13,38
100,Fail,50,28,0,8,42
100,Fail,47,27,0,14,33
100,Fail,49,21,4,17,32
100,Fail,45,32,7,9,36
100,Fail,56,25,0,5,51
100,Fail,41,28,0,22,19
100,Fail,43,28,0,15,28
100,Fail,59,21,2,8,51
100,Fail,35,38,0,19,16
100,Fail,54,21,1,11,43
100,Fail,55,24,0,7,48
100,Fail,46,30,0,15,31
100,Fail,47,22,7,16,31
100,Fail,47,33,0,9,38
100,Fail,45,33,3,7,38
100,Fail,49,29,2,7,42
100,Fail,51,31,0,7,44
100,Fail,42,40,0,7,35
100,Fail,56,23,0,11,45
100,Fail,46,25,0,17,29
100,Fail,42,31,0,16,26
100,Fail,52,24,2,15,37
100,Fail,47,24,0,18,29
100,Fail,49,26,0,14,35
100,Fail,48,31,2,10,38
100,Fail,49,19,3,18,31
100,Fail,45,23,3,19,26
100,Fail,52,23,0,13,39
100,Fail,43,28,6,11,32
100,Fail,49,22,5,13,36
100,Fail,53,21,0,11,42
100,Fail,50,28,0,14,36
100,Fail,61,22,0,6,55
100,Fail,52,29,4,5,47
100,Fail,50,29,0,10,40
100,Fail,45,32,0,13,32
100,Fail,49,24,4,12,37
100,Fail,53,26,0,8,45
100,Fail,47,32,0,10,37
100,Fail,58,22,0,14,44
100,Fail,55,18,4,11,44
100,Fail,48,20,6,16,32
100,Fail,46,27,0,15,31
100,Fail,49,18,5,15,34
100,Fail,45,31,0,16,29
100,Fail,48,26,5,11,37
100,Fail,53,18,2,16,37
100,Fail,50,21,3,15,35
100,Fail,53,21,1,11,42
100,Fail,48,27,0,15,33
100,Fail,47,23,7,8,39
100,Fail,42,28,7,13,29
100,Fail,51,24,3,9,42
100,Fail,53,25,0,12,41
100,Fail,51,20,0,18,33
100,Fail,56,16,0,13,43
100,Fail,49,31,0,10,39
100,Fail,51,24,8,7,44
100,Fail,43,29,0,16,27
100,Fail,45,30,0,15,30
100,Fail,45,32,0,14,31
100,Fail,44,36,0,15,29
100,Fail,52,22,1,11,41
100,Fail,45,30,6,11,34
100,Fail,50,28,0,9,41
100,Fail,46,28,0,16,30
100,Fail,57,27,0,5,52
100,Fail,47,27,0,10,37
100,Fail,48,29,4,9,39
100,Fail,50,22,0,18,32
100,Fail,47,30,1,10,37
100,Fail,50,19,5,15,35
100,Fail,46,27,6,12,34
100,Fail,42,26,9,15,27
100,Fail,53,31,0,10,43
100,Fail,47,25,2,20,27
100,Fail,49,20,3,15,34
100,Fail,50,22,0,15,35
100,Fail,48,19,0,20,28
100,Fail,44,36,0,10,34
100,Fail,47,32,0,11,36
100,Fail,50,20,3,14,36
100,Fail,54,20,1,14,40
100,Fail,51,28,1,9,42
100,Fail,43,30,2,12,31
100,Fail,45,35,0,11,34
100,Fail,52,29,0,8,44
100,Fail,45,21,3,20,25
100,Fail,49,32,0,8,41
100,Fail,53,22,0,12,41
100,Fail,39,34,0,20,19
100,Fail,49,27,0,14,35
100,Fail,58,27,0,7,51
100,Fail,43,26,9,12,31
100,Fail,48,25,4,14,34
100,Fail,53,29,0,9,44
100,Fail,56,24,1,8,48
100,Fail,39,39,4,7,32
100,Fail,51,28,0,12,39
100,Fail,51,29,0,12,39
100,Fail,52,17,10,10,42
100,Fail,52,26,1,8,44
100,Fail,39,30,0,19,20
100,Fail,43,32,2,12,31
100,Fail,49,26,0,15,34
100,Fail,47,34,0,12,35
100,Fail,45,31,0,17,28
100,Fail,48,26,1,11,37
100,Fail,59,18,0,9,50
100,Fail,45,29,0,13,32
100,Fail,57,24,0,10,47
100,Fail,47,29,1,10,37
100,Fail,46,31,0,11,35
100,Fail,38,36,0,17,21
100,Fail,40,22,8,21,19
100,Fail,51,25,0,15,36
100,Fail,54,25,0,9,45
100,Fail,52,17,7,11,41
100,Fail,46,25,0,16,30
100,Fail,44,30,0,14,30
100,Fail,55,17,0,18,37
100,Fail,47,30,0,15,32
100,Fail,37,29,11,14,23
100,Fail,53,27,0,10,43
100,Fail,51,27,0,13,38
100,Fail,48,28,0,13,35
100,Fail,38,39,0,14,24
100,Fail,48,23,2,14,34
100,Fail,48,28,0,13,35
100,Fail,49,31,0,9,40
100,Fail,47,28,4,14,33
100,Fail,52,20,9,10,42
100,Fail,53,22,4,9,44
100,Fail,48,29,0,13,35
100,Fail,50,22,0,15,35
100,Fail,46,26,2,17,29
100,Fail,51,24,0,12,39
100,Fail,54,26,0,9,45
100,Fail,41,26,9,16,25
100,Fail,49,33,0,11,38
100,Fail,42,32,11,11,31
100,Fail,57,22,0,7,50
100,Fail,45,25,0,17,28
100,Fail,57,18,0,12,45
100,Fail,41,33,2,14,27
100,Fail,43,37,0,12,31
100,Fail,40,29,2,19,21
100,Fail,52,22,3,12,40
100,Fail,47,29,1,12,35
100,Fail,57,17,1,11,46
100,Fail,51,26,0,11,40
100,Fail,48,23,7,12,36
100,Fail,55,15,1,12,43
100,Fail,49,22,5,14,35
100,Fail,49,27,7,10,39
100,Fail,41,32,0,19,22
100,Fail,53,26,0,9,44
100,Fail,50,25,3,12,38
100,Fail,46,33,0,13,33
100,Fail,63,19,0,7,56
100,Fail,48,19,4,19,29
100,Fail,48,20,2,20,28
100,Fail,55,27,0,7,48
100,Fail,47,31,0,12,35
100,Fail,50,22,0,13,37
100,Fail,46,24,6,15,31
100,Fail,41,32,0,15,26
100,Fail,48,23,2,13,35
100,Fail,43,25,5,15,28
100,Fail,56,15,3,12,44
100,Fail,57,18,2,12,45
100,Fail,42,23,3,21,21
100,Fail,49,31,0,12,37
100,Fail,50,22,6,12,38
100,Fail,56,16,1,10,46
100,Fail,46,24,3,9,37
100,Fail,38,30,4,17,21
100,Fail,51,28,0,9,42
100,Fail,50,35,0,6,44
100,Fail,50,30,2,8,42
100,Fail,42,33,3,12,30
100,Fail,42,22,4,23,19
100,Fail,46,28,2,12,34
100,Fail,54,23,1,10,44
100,Fail,50,24,1,13,37
100,Fail,47,24,0,17,30
100,Fail,46,25,0,19,27
100,Fail,52,27,0,9,43
100,Fail,52,25,2,13,39
100,Fail,47,20,16,12,35
100,Fail,46,23,9,11,35
100,Fail,51,23,4,9,42
100,Fail,52,20,0,12,40
100,Fail,50,24,8,9,41
100,Fail,48,34,0,11,37
100,Fail,49,29,0,14,35
100,Fail,46,27,4,11,35
100,Fail,46,33,0,12,34
100,Fail,45,29,0,14,31
100,Fail,40,36,0,18,22
100,Fail,47,29,2,13,34
100,Fail,58,21,0,10,48
100,Fail,47,33,0,10,37
100,Fail,53,23,2,11,42
100,Fail,47,31,0,12,35
100,Fail,60,15,0,10,50
100,Fail,41,29,11,11,30
100,Fail,55,29,0,8,47
100,Fail,42,30,0,16,26
100,Fail,54,19,0,16,38
100,Fail,47,31,0,11,36
100,Fail,46,20,7,13,33
100,Fail,46,27,3,12,34
100,Fail,51,20,0,17,34
100,Fail,48,25,3,10,38
100,Fail,46,22,8,14,32
100,Fail,43,31,0,18,25
100,Fail,50,21,0,15,35
100,Fail,55,17,1,15,40
100,Fail,57,23,0,7,50
100,Fail,58,19,0,8,50
100,Fail,46,25,0,18,28
100,Fail,47,25,5,8,39
100,Fail,53,24,0,12,41
100,Fail,45,34,0,10,35
100,Fail,50,24,1,11,39
100,Fail,58,20,0,12,46
100,Fail,43,32,0,18,25
100,Fail,43,28,0,18,25
100,Fail,41,37,0,12,29
100,Fail,56,26,0,8,48
100,Fail,46,35,0,9,37
100,Fail,54,27,0,10,44
100,Fail,45,28,5,11,34
100,Fail,50,28,0,11,39
100,Fail,55,21,3,7,48
100,Fail,40,25,0,22,18
100,Fail,50,31,0,9,41
100,Fail,47,24,6,13,34
100,Fail,42,39,0,12,30
100,Fail,46,29,2,12,34
100,Fail,48,23,1,14,34
100,Fail,56,23,0,13,43
100,Fail,56,21,3,8,48
100,Fail,42,36,0,16,26
100,Fail,49,33,0,9,40
100,Fail,46,28,0,14,32
100,Fail,49,23,0,12,37
100,Fail,50,25,0,10,40
100,Fail,54,25,0,8,46
100,Fail,51,27,0,11,40
100,Fail,44,34,0,14,30
100,Fail,50,23,0,16,34
100,Fail,53,21,2,12,41
100,Fail,43,38,0,8,35
100,Fail,49,23,0,14,35
100,Fail,55,25,0,11,44
100,Fail,46,34,0,11,35
100,Fail,51,28,1,10,41
100,Fail,60,14,1,10,50
100,Fail,57,20,0,13,44
100,Fail,46,27,0,21,25
100,Fail,40,40,0,9,31
100,Fail,43,33,3,13,30
100,Fail,48,34,0,9,39
100,Fail,46,34,4,10,36
100,Fail,52,32,0,7,45
100,Fail,52,26,0,11,41
100,Fail,45,33,0,9,36
100,Fail,48,31,0,14,34
100,Fail,53,26,0,8,45
100,Fail,47,27,5,12,35
100,Fail,52,21,6,9,43
100,Fail,51,22,0,14,37
100,Fail,45,34,0,8,37
100,Fail,51,18,5,14,37
100,Fail,53,20,0,13,40
100,Fail,48,20,8,17,31
100,Fail,50,21,0,17,33
100,Fail,53,25,3,7,46
100,Fail,47,32,0,8,39
100,Fail,51,25,6,8,43
100,Fail,49,27,6,8,41
100,Fail,54,24,0,14,40
100,Fail,43,31,7,10,33
100,Fail,44,27,0,15,29
100,Fail,45,32,0,14,31
100,Fail,52,25,2,8,44
100,Fail,49,27,0,18,31
100,Fail,45,29,8,8,37
100,Fail,58,22,2,10,48
100,Fail,50,24,0,17,33
100,Fail,44,25,10,14,30
100,Fail,43,27,7,13,30
100,Fail,39,29,0,20,19
100,Fail,43,35,0,11,32
100,Fail,48,27,0,12,36
100,Fail,53,20,1,12,41
100,Fail,52,21,1,14,38
100,Fail,51,24,6,8,43
100,Fail,49,32,0,11,38
100,Fail,44,26,3,14,30
100,Fail,53,26,0,9,44
100,Fail,52,21,0,17,35
100,Fail,41,30,0,18,23
100,Fail,48,27,0,17,31
100,Fail,46,32,0,10,36
100,Fail,46,28,0,16,30
100,Fail,43,36,0,9,34
100,Fail,46,27,5,12,34
100,Fail,55,22,4,9,46
100,Fail,45,30,0,14,31
100,Fail,53,23,0,9,44
100,Fail,53,30,0,6,47
100,Fail,48,27,0,16,32
100,Fail,51,22,3,14,37
100,Fail,49,27,0,12,37
100,Fail,46,23,3,17,29
100,Fail,51,23,0,11,40
100,Fail,50,22,0,13,37
100,Fail,43,23,13,16,27
100,Fail,44,34,0,11,33
100,Fail,55,20,1,12,43
100,Fail,53,20,0,17,36
100,Fail,53,24,1,11,42
100,Fail,56,18,1,13,43
100,Fail,50,21,0,13,37
100,Fail,51,26,7,8,43
100,Fail,45,30,0,12,33
100,Fail,49,22,0,15,34
100,Fail,44,24,2,23,21
100,Fail,44,26,4,12,32
100,Fail,48,26,4,12,36
100,Fail,53,27,4,11,42
100,Fail,53,26,0,10,43
100,Fail,49,30,1,9,40
100,Fail,48,31,0,10,38
100,Fail,56,16,4,12,44
100,Fail,56,22,0,10,46
100,Fail,46,40,0,10,36
100,Fail,51,26,0,15,36
100,Fail,47,27,0,12,35
100,Fail,53,23,0,11,42
100,Fail,44,26,0,16,28
100,Fail,47,32,0,10,37
100,Fail,52,23,2,10,42
100,Fail,46,26,0,14,32
100,Fail,46,23,1,17,29
100,Fail,52,29,0,10,42
100,Fail,53,22,4,10,43
100,Fail,51,25,5,11,40
100,Fail,43,23,15,11,32
100,Fail,46,29,0,17,29
100,Fail,50,23,0,14,36
100,Fail,48,24,3,11,37
100,Fail,51,26,0,12,39
100,Fail,55,15,3,12,43
100,Fail,50,33,0,9,41
100,Fail,45,27,8,15,30
100,Fail,41,44,0,12,29
100,Fail,45,27,4,12,33
100,Fail,45,29,0,15,30
100,Fail,47,27,0,16,31
100,Fail,51,24,3,12,39
100,Fail,48,26,0,11,37
100,Fail,50,22,0,13,37
100,Fail,48,25,1,10,38
100,Fail,44,32,0,13,31
100,Fail,43,40,0,11,32
100,Fail,56,23,0,9,47
100,Fail,45,24,1,17,28
100,Fail,55,26,4,5,50
100,Fail,47,32,0,13,34
100,Fail,47,27,1,12,35
100,Fail,54,21,0,12,42
100,Fail,47,30,1,8,39
100,Fail,44,27,11,9,35
100,Fail,54,26,0,11,43
100,Fail,42,24,0,20,22
100,Fail,44,28,0,15,29
100,Fail,52,22,8,9,43
100,Fail,42,35,0,16,26
100,Fail,42,32,0,16,26
100,Fail,50,21,1,13,37
100,Fail,46,28,0,12,34
100,Fail,45,30,6,11,34
100,Fail,43,32,0,14,29
100,Fail,52,21,0,14,38
100,Fail,51,23,2,12,39
100,Fail,48,28,4,12,36
100,Fail,50,21,1,17,33
100,Fail,51,34,0,10,41
100,Fail,58,20,0,6,52
100,Fail,50,22,1,17,33
100,Fail,49,25,3,14,35
100,Fail,51,25,3,9,42
100,Fail,36,37,0,19,17
100,Fail,44,28,4,12,32
100,Fail,46,31,0,12,34
100,Fail,49,25,5,7,42
100,Fail,45,26,6,13,32
100,Fail,51,20,3,13,38
100,Fail,50,26,0,14,36
100,Fail,49,26,3,10,39
100,Fail,43,31,0,15,28
100,Fail,45,25,0,16,29
100,Fail,47,29,7,8,39
100,Fail,55,27,0,10,45
100,Fail,54,25,0,11,43
100,Fail,41,29,5,11,30
100,Fail,42,30,3,11,31
100,Fail,38,29,6,18,20
100,Fail,49,30,5,8,41
100,Fail,46,30,0,15,31
100,Fail,46,24,10,12,34
100,Fail,48,27,0,19,29
100,Fail,54,25,0,11,43
100,Fail,53,32,0,6,47
100,Fail,51,27,0,13,38
100,Fail,55,29,0,7,48
100,Fail,46,32,3,11,35
100,Fail,46,31,0,11,35
100,Fail,36,35,0,16,20
100,Fail,50,32,0,10,40
100,Fail,52,22,0,8,44
100,Fail,44,28,3,11,33
100,Fail,53,25,1,10,43
100,Fail,46,39,0,8,38
100,Fail,47,25,0,15,32
100,Fail,46,31,0,16,30
100,Fail,52,23,0,13,39
100,Fail,45,30,0,15,30
100,Fail,46,20,0,17,29
100,Fail,42,38,0,11,31
100,Fail,52,23,2,9,43
100,Fail,52,25,0,12,40
100,Fail,46,24,5,14,32
100,Fail,45,25,4,14,31
100,Fail,40,39,0,15,25
100,Fail,50,30,0,7,43
100,Fail,43,31,13,7,36
100,Fail,42,27,8,17,25
100,Fail,52,24,3,10,42
100,Fail,48,31,4,9,39
100,Fail,53,26,0,9,44
100,Fail,52,30,0,10,42
100,Fail,48,33,1,7,41
100,Fail,50,25,0,11,39
100,Fail,49,30,0,12,37
100,Fail,48,31,0,13,35
100,Fail,46,26,3,14,32
100,Fail,50,30,0,12,38
100,Fail,49,27,0,12,37
100,Fail,51,19,1,14,37
100,Fail,48,33,2,7,41
100,Fail,52,24,1,9,43
100,Fail,43,29,0,14,29
100,Fail,49,23,7,9,40
100,Fail,40,34,0,19,21
100,Fail,46,32,0,10,36
100,Fail,46,26,3,15,31
100,Fail,59,21,0,7,52
100,Fail,50,25,0,16,34
100,Fail,43,36,0,10,33
100,Fail,47,22,6,14,33
100,Fail,44,30,5,11,33
100,Fail,47,33,6,4,43
100,Fail,54,25,1,9,45
100,Fail,56,14,2,16,40
100,Fail,44,33,6,9,35
100,Fail,50,25,0,14,36
100,Fail,44,30,6,13,31
100,Fail,44,35,0,6,38
100,Fail,53,20,8,10,43
100,Fail,44,26,5,17,27
100,Fail,49,25,0,14,35
100,Fail,48,30,0,10,38
100,Fail,45,30,4,10,35
100,Fail,42,29,8,10,32
100,Fail,50,25,0,15,35
100,Fail,47,24,3,18,29
100,Fail,48,29,2,7,41
100,Fail,44,38,0,10,34
100,Fail,44,37,0,11,33
100,Fail,49,34,0,8,41
100,Fail,51,21,7,12,39
100,Fail,52,21,6,9,43
100,Fail,54,20,1,12,42
100,Fail,52,21,4,15,37
100,Fail,44,36,0,11,33
100,Fail,47,29,6,9,38
100,Fail,46,35,0,11,35
100,Fail,58,20,0,10,48
100,Fail,47,22,9,12,35
100,Fail,47,28,2,16,31
100,Fail,47,29,4,12,35
100,Fail,40,33,0,20,20
100,Fail,51,30,0,8,43
100,Fail,51,19,2,16,35
100,Fail,38,39,0,13,25
100,Fail,42,32,0,14,28
100,Fail,49,26,0,13,36
100,Fail,55,25,0,8,47
100,Fail,53,18,8,14,39
100,Fail,50,26,2,10,40
100,Fail,50,21,10,8,42
100,Fail,54,22,0,16,38
100,Fail,47,34,0,11,36
100,Fail,51,22,1,10,41
100,Fail,56,22,0,10,46
100,Fail,42,40,0,11,31
100,Fail,50,22,5,10,40
100,Fail,44,35,0,12,32
100,Fail,42,34,0,13,29
100,Fail,52,27,0,9,43
100,Fail,49,24,1,12,37
100,Fail,56,22,0,10,46
100,Fail,51,15,1,15,36
100,Fail,41,31,0,14,27
100,Fail,54,23,2,8,46
100,Fail,44,34,0,12,32
100,Fail,58,19,0,13,45
100,Fail,46,28,0,14,32
100,Fail,57,14,4,13,44
100,Fail,43,33,0,15,28
100,Fail,44,19,10,18,26
100,Fail,44,26,2,16,28
100,Fail,50,30,0,12,38
100,Fail,43,27,6,17,26
100,Fail,39,38,0,17,22
100,Fail,48,26,0,16,32
100,Fail,45,32,4,11,34
100,Fail,51,29,0,6,45
100,Fail,44,31,0,15,29
100,Fail,53,15,7,13,40
100,Fail,44,29,6,15,29
100,Fail,54,23,0,13,41
100,Fail,41,28,4,18,23
100,Fail,49,23,7,13,36
100,Fail,41,27,7,15,26
100,Fail,41,38,0,12,29
100,Fail,45,29,0,12,33
100,Fail,44,33,3,9,35
100,Fail,48,35,0,9,39
100,Fail,40,33,0,16,24
100,Fail,56,18,0,12,44
100,Fail,44,32,7,9,35
100,Fail,53,26,0,11,42
100,Fail,45,26,8,13,32
100,Fail,44,33,2,12,32
100,Fail,47,34,0,7,40
100,Fail,38,36,0,18,20
100,Fail,48,34,0,10,38
100,Fail,56,20,0,15,41
100,Fail,48,35,0,9,39
100,Fail,49,24,0,16,33
100,Fail,47,29,0,12,35
100,Fail,46,25,0,16,30
100,Fail,47,29,3,10,37
100,Fail,43,29,0,15,28
100,Fail,55,26,0,9,46
100,Fail,42,30,0,17,25
100,Fail,46,25,7,11,35
100,Fail,48,29,0,10,38
100,Fail,51,25,0,15,36
100,Fail,50,25,0,15,35
100,Fail,53,24,0,13,40
100,Fail,49,31,0,12,37
100,Fail,56,25,0,10,46
100,Fail,48,25,0,11,37
100,Fail,47,21,1,17,30
100,Fail,53,18,3,15,38
100,Fail,56,20,0,10,46
100,Fail,40,30,3,16,24
100,Fail,45,23,7,16,29
100,Fail,52,29,0,8,44
100,Fail,53,24,0,13,40
100,Fail,43,30,5,14,29
100,Fail,48,33,0,9,39
100,Fail,47,22,1,17,30
100,Fail,54,35,0,6,48
100,Fail,43,26,0,21,22
100,Fail,45,30,0,12,33
100,Fail,46,29,4,13,33
100,Fail,49,25,0,12,37
100,Fail,49,27,3,13,36
100,Fail,41,23,6,20,21
100,Fail,48,28,1,14,34
100,Fail,48,23,2,13,35
100,Fail,43,32,10,9,34
100,Fail,47,30,0,16,31
100,Fail,45,29,0,15,30
100,Fail,49,19,0,15,34
100,Fail,51,27,0,10,41
100,Fail,41,31,5,17,24
100,Fail,57,20,2,11,46
100,Fail,43,34,0,13,30
100,Fail,45,33,0,13,32
100,Fail,49,24,3,13,36
100,Fail,46,30,0,13,33
100,Fail,40,22,3,17,23
100,Fail,52,27,0,11,41
100,Fail,58,16,1,15,43
100,Fail,40,28,11,15,25
100,Fail,43,28,7,15,28
100,Fail,42,26,1,19,23
100,Fail,54,21,0,15,39
100,Fail,49,30,2,7,42
100,Fail,49,27,0,13,36
100,Fail,47,34,0,9,38
100,Fail,50,24,0,13,37
100,Fail,48,22,3,15,33
100,Fail,45,26,5,16,29
100,Fail,45,25,8,13,32
100,Fail,47,32,0,16,31
100,Fail,48,27,2,12,36
100,Fail,44,35,0,16,28
100,Fail,46,22,3,18,28
100,Fail,44,34,4,6,38
100,Fail,46,30,0,15,31
100,Fail,53,25,0,11,42
100,Fail,47,26,0,17,30
100,Fail,43,25,0,17,26
100,Fail,51,32,1,8,43
100,Fail,52,24,8,5,47
100,Fail,59,19,0,14,45
100,Fail,47,26,8,9,38
100,Fail,44,30,3,11,33
100,Fail,48,27,0,13,35
100,Fail,52,29,0,8,44
100,Fail,55,25,3,9,46
100,Fail,52,24,1,10,42
100,Fail,49,26,0,7,42
100,Fail,54,24,3,5,49
100,Fail,49,19,5,16,33
100,Fail,50,27,7,8,42
100,Fail,37,34,6,14,23
100,Fail,48,30,0,8,40
100,Fail,46,32,0,9,37
100,Fail,47,24,8,9,38
100,Fail,46,31,0,13,33
100,Fail,47,33,0,10,37
100,Fail,48,25,3,16,32
100,Fail,44,38,0,7,37
100,Fail,46,24,0,13,33
100,Fail,52,25,0,10,42
100,Fail,45,31,0,18,27
100,Fail,49,24,2,16,33
100,Fail,34,25,7,24,10
100,Fail,46,26,3,15,31
100,Fail,46,33,0,10,36
100,Fail,49,27,0,12,37
100,Fail,50,30,0,12,38
100,Fail,39,37,5,11,28
100,Fail,44,33,3,12,32
100,Fail,45,29,1,15,30
100,Fail,49,24,0,18,31
100,Fail,44,27,5,12,32
100,Fail,51,29,1,10,41
100,Fail,47,25,1,15,32
100,Fail,48,18,2,18,30
100,Fail,46,29,0,10,36
100,Fail,40,27,7,17,23
100,Fail,50,29,3,9,41
100,Fail,48,23,4,15,33
100,Fail,46,30,1,16,30
100,Fail,56,16,4,7,49
100,Fail,49,30,0,14,35
100,Fail,42,36,0,16,26
100,Fail,42,37,0,8,34
100,Fail,49,25,4,10,39
100,Fail,51,30,4,8,43
100,Fail,37,27,6,20,17
100,Fail,42,27,2,17,25
100,Fail,52,24,3,11,41
100,Fail,50,21,1,16,34
100,Fail,51,25,9,9,42
100,Fail,48,27,5,12,36
100,Fail,40,26,17,14,26
100,Fail,48,29,0,13,35
100,Fail,45,27,0,17,28
100,Fail,50,26,1,12,38
100,Fail,57,21,0,13,44
100,Fail,43,31,6,11,32
100,Fail,45,27,5,12,33
100,Fail,45,30,1,9,36
100,Fail,60,19,1,12,48
100,Fail,43,26,4,14,29
100,Fail,51,31,0,11,40
100,Fail,56,21,1,8,48
100,Fail,54,19,1,12,42
100,Fail,46,28,0,11,35
100,Fail,49,29,0,10,39
100,Fail,48,27,2,10,38
100,Fail,49,25,3,13,36
100,Fail,44,35,0,11,33
100,Fail,46,36,0,9,37
100,Fail,52,24,0,13,39
100,Fail,51,29,0,14,37
100,Fail,50,22,3,10,40
100,Fail,42,31,0,20,22
100,Fail,55,28,0,9,46
100,Fail,55,24,0,9,46
100,Fail,44,28,0,18,26
100,Fail,37,38,0,17,20
100,Fail,41,38,0,12,29
100,Fail,49,24,6,12,37
100,Fail,50,21,9,12,38
100,Fail,52,23,0,13,39
100,Fail,50,21,4,11,39
100,Fail,51,17,4,12,39
100,Fail,44,28,0,17,27
100,Fail,41,36,0,14,27
100,Fail,51,27,0,9,42
100,Fail,40,32,5,12,28
100,Fail,38,33,13,11,27
100,Fail,48,29,1,11,37
100,Fail,49,25,4,10,39
100,Fail,48,33,0,11,37
100,Fail,45,27,0,20,25
100,Fail,46,33,0,9,37
100,Fail,48,26,0,14,34
100,Fail,40,28,0,20,20
100,Fail,46,21,2,20,26
100,Fail,48,26,6,7,41
100,Fail,47,33,0,8,39
100,Fail,50,28,0,11,39
100,Fail,45,31,0,14,31
100,Fail,50,29,0,14,36
100,Fail,43,31,0,13,30
100,Fail,46,33,0,10,36
100,Fail,54,29,0,5,49
100,Fail,45,28,4,10,35
100,Fail,50,22,4,9,41
100,Fail,54,22,3,8,46
100,Fail,43,28,8,13,30
100,Fail,50,25,4,9,41
100,Fail,52,27,0,9,43
100,Fail,44,30,10,12,32
100,Fail,52,26,0,7,45
100,Fail,48,27,0,13,35
100,Fail,41,35,0,11,30
100,Fail,46,36,1,10,36
100,Fail,54,27,0,5,49
100,Fail,50,26,0,11,39
100,Fail,57,27,0,9,48
100,Fail,41,30,0,19,22
100,Fail,46,26,4,13,33
100,Fail,44,29,0,13,31
100,Fail,54,25,0,7,47
100,Fail,53,25,0,12,41
100,Fail,46,26,8,13,33
100,Fail,49,30,0,11,38
100,Fail,56,21,2,11,45
100,Fail,51,30,0,9,42
100,Fail,54,24,0,11,43
100,Fail,43,36,0,9,34
100,Fail,50,29,0,11,39
100,Fail,44,37,0,11,33
100,Fail,61,14,0,14,47
100,Fail,46,29,0,18,28
100,Fail,48,28,1,14,34
100,Fail,53,30,3,7,46
100,Fail,44,33,0,14,30
100,Fail,52,28,3,8,44
100,Fail,49,24,0,17,32
100,Fail,56,24,0,11,45
100,Fail,45,27,5,14,31
100,Fail,47,31,4,12,35
100,Fail,51,22,1,18,33
100,Fail,49,27,2,12,37
100,Fail,39,39,0,12,27
100,Fail,51,17,2,17,34
100,Fail,50,22,1,15,35
100,Fail,44,30,0,12,32
100,Fail,51,22,7,12,39
100,Fail,47,32,0,12,35
100,Fail,46,27,0,17,29
100,Fail,48,31,0,9,39
100,Fail,54,22,2,10,44
100,Fail,54,29,0,9,45
100,Fail,50,27,0,13,37
100,Fail,44,22,6,16,28
100,Fail,56,22,0,11,45
100,Fail,39,18,16,18,21
100,Fail,46,26,0,14,32
100,Fail,58,23,0,7,51
100,Fail,49,29,0,9,40
100,Fail,50,28,4,8,42
100,Fail,55,25,0,8,47
100,Fail,55,27,1,8,47
100,Fail,38,31,3,18,20
100,Fail,56,12,1,22,34
100,Fail,51,21,5,14,37
100,Fail,43,39,0,10,33
100,Fail,55,25,0,10,45
100,Fail,51,25,0,12,39
100,Fail,44,27,9,12,32
100,Fail,51,29,1,8,43
100,Fail,54,23,0,9,45
100,Fail,54,29,0,7,47
100,Fail,45,28,9,8,37
100,Fail,49,28,0,10,39
100,Fail,52,27,0,8,44
100,Fail,48,27,9,7,41
100,Fail,51,25,1,13,38
100,Fail,49,30,0,8,41
100,Fail,49,22,6,14,35
100,Fail,45,33,0,13,32
100,Fail,52,23,1,12,40
100,Fail,47,28,0,13,34
100,Fail,30,44,0,18,12
100,Fail,52,24,5,10,42
100,Fail,53,26,1,8,45
100,Fail,35,43,0,15,20
100,Fail,43,30,2,12,31
100,Fail,46,31,1,9,37
100,Fail,38,31,0,18,20
100,Fail,51,28,0,11,40
100,Fail,50,25,7,9,41
100,Fail,38,41,0,12,26
100,Fail,52,23,2,11,41
100,Fail,44,30,0,17,27
100,Fail,43,29,3,14,29
100,Fail,48,24,0,16,32
100,Fail,51,20,2,13,38
100,Fail,50,28,0,10,40
100,Fail,46,29,0,13,33
100,Fail,50,20,0,12,38
100,Fail,49,26,0,16,33
100,Fail,45,26,8,14,31
100,Fail,47,31,0,14,33
100,Fail,49,19,7,14,35
100,Fail,51,32,0,8,43
100,Fail,50,22,12,10,40
100,Fail,45,26,0,14,31
100,Fail,53,20,2,14,39
100,Fail,42,35,0,14,28
100,Fail,44,27,0,17,27
100,Fail,50,30,0,7,43
100,Fail,49,33,5,6,43
100,Fail,48,29,4,8,40
100,Fail,41,30,0,15,26
100,Fail,50,20,3,18,32
100,Fail,53,24,0,12,41
100,Fail,45,34,0,12,33
100,Fail,49,27,0,9,40
100,Fail,49,31,0,13,36
100,Fail,48,34,0,8,40
100,Fail,46,27,0,12,34
100,Fail,42,29,4,12,30
100,Fail,52,23,0,11,41
100,Fail,46,32,0,14,32
100,Fail,40,33,0,18,22
100,Fail,46,25,5,14,32
100,Fail,45,28,2,17,28
100,Fail,44,35,0,14,30
100,Fail,49,36,0,9,40
100,Fail,41,25,5,19,22
100,Fail,48,23,8,14,34
100,Fail,56,19,1,15,41
100,Fail,45,30,0,11,34
100,Fail,44,27,3,17,27
100,Fail,49,25,0,14,35
100,Fail,59,21,0,9,50
100,Fail,53,18,1,18,35
100,Fail,49,15,7,20,29
100,Fail,51,29,0,9,42
100,Fail,57,19,4,10,47
100,Fail,53,22,4,10,43
100,Fail,47,26,5,11,36
100,Fail,49,22,7,10,39
100,Fail,51,27,0,12,39
100,Fail,57,14,1,14,43
100,Fail,48,34,0,10,38
100,Fail,50,30,0,7,43
100,Fail,46,27,1,13,33
100,Fail,42,33,0,12,30
100,Fail,56,20,5,10,46
100,Fail,55,21,1,11,44
100,Fail,45,30,0,14,31
100,Fail,56,21,3,14,42
100,Fail,44,25,5,16,28
100,Fail,42,33,0,17,25
100,Fail,46,32,0,18,28
100,Fail,57,23,0,11,46
100,Fail,41,28,3,16,25
100,Fail,43,31,2,15,28
100,Fail,54,22,0,14,40
100,Fail,49,26,0,14,35
100,Fail,55,24,3,6,49
100,Fail,42,30,0,16,26
100,Fail,54,26,0,10,44
100,Fail,47,27,2,14,33
100,Fail,44,35,0,9,35
100,Fail,45,28,0,14,31
100,Fail,55,21,0,8,47
100,Fail,51,26,0,10,41
100,Fail,46,33,0,13,33
100,Fail,50,25,0,14,36
100,Fail,55,17,1,15,40
100,Fail,54,25,0,12,42
100,Fail,39,41,0,14,25
100,Fail,47,30,0,14,33
100,Fail,33,39,0,19,14
100,Fail,56,28,0,7,49
100,Fail,48,32,0,10,38
100,Fail,50,26,0,11,39
100,Fail,50,25,0,15,35
100,Fail,38,38,0,13,25
100,Fail,46,28,0,14,32
100,Fail,55,26,1,6,49
100,Fail,46,26,1,12,34
100,Fail,40,35,0,13,27
100,Fail,55,22,0,10,45
100,Fail,61,14,0,12,49
100,Fail,55,22,0,10,45
100,Fail,39,34,2,13,26
100,Fail,48,31,0,12,36
100,Fail,51,28,3,11,40
100,Fail,44,24,3,18,26
100,Fail,54,26,0,10,44
100,Fail,46,30,0,14,32
100,Fail,54,21,5,10,44
100,Fail,48,26,0,13,35
100,Fail,47,29,0,16,31
100,Fail,46,26,9,10,36
100,Fail,55,20,2,9,46
100,Fail,53,23,0,11,42
100,Fail,50,26,6,6,44
100,Fail,54,22,1,9,45
100,Fail,57,21,1,7,50
100,Fail,42,31,7,10,32
100,Fail,47,29,5,13,34
100,Fail,49,24,0,18,31
100,Fail,49,22,0,18,31
100,Fail,40,33,3,11,29
100,Fail,47,31,0,14,33
100,Fail,53,22,0,15,38
100,Fail,45,29,2,10,35
100,Fail,46,28,2,13,33
100,Fail,49,30,0,9,40
100,Fail,49,27,4,10,39
100,Fail,40,35,0,19,21
100,Fail,51,24,7,8,43
100,Fail,44,30,0,13,31
100,Fail,50,23,6,10,40
100,Fail,48,29,0,12,36
100,Fail,50,22,5,12,38
100,Fail,57,24,0,6,51
100,Fail,55,19,1,13,42
100,Fail,50,28,1,14,36
100,Fail,46,26,2,13,33
100,Fail,44,27,2,17,27
100,Fail,46,23,4,14,32
100,Fail,41,27,9,14,27
100,Fail,49,20,9,11,38
100,Fail,41,33,0,17,24
100,Fail,44,32,13,7,37
100,Fail,48,34,0,10,38
100,Fail,59,24,0,6,53
100,Fail,43,38,0,15,28
100,Fail,54,23,0,13,41
100,Fail,37,26,12,20,17
100,Fail,42,26,5,17,25
100,Fail,48,34,0,12,36
100,Fail,50,27,0,13,37
100,Fail,49,29,0,12,37
100,Fail,53,26,0,11,42
100,Fail,40,38,0,13,27
100,Fail,58,20,1,9,49
100,Fail,48,30,0,11,37
100,Fail,55,24,1,7,48
100,Fail,46,33,0,15,31
100,Fail,42,28,13,9,33
100,Fail,43,29,1,12,31
100,Fail,47,35,0,10,37
100,Fail,50,33,0,10,40
100,Fail,45,35,0,12,33
100,Fail,43,36,0,10,33
100,Fail,49,28,1,8,41
100,Fail,56,27,1,9,47
100,Fail,41,22,4,25,16
100,Fail,49,21,5,16,33
100,Fail,44,29,0,14,30
100,Fail,52,25,0,11,41
100,Fail,47,31,0,10,37
100,Fail,56,23,0,13,43
100,Fail,47,26,0,16,31
100,Fail,44,27,1,17,27
100,Fail,49,26,4,11,38
100,Fail,44,32,0,15,29
100,Fail,54,23,0,8,46
100,Fail,46,28,0,18,28
100,Fail,42,28,5,14,28
100,Fail,44,32,0,15,29
100,Fail,55,29,0,7,48
100,Fail,46,21,10,16,30
100,Fail,50,19,8,15,35
100,Fail,51,30,0,9,42
100,Fail,49,35,0,6,43
100,Fail,44,27,3,16,28
100,Fail,49,25,5,13,36
100,Fail,51,32,0,7,44
100,Fail,50,23,0,13,37
100,Fail,47,29,1,13,34
100,Fail,50,28,0,12,38
100,Fail,52,20,7,13,39
100,Fail,48,28,2,13,35
100,Fail,51,26,0,14,37
100,Fail,47,27,0,13,34
100,Fail,42,37,2,11,31
100,Fail,53,19,0,16,37
100,Fail,53,28,3,7,46
100,Fail,44,24,5,16,28
100,Fail,41,42,0,8,33
100,Fail,41,33,0,17,24
100,Fail,54,21,1,12,42
100,Fail,54,25,0,9,45
100,Fail,47,32,0,12,35
100,Fail,52,21,4,13,39
100,Fail,52,26,0,11,41
100,Fail,44,26,0,18,26
100,Fail,45,25,6,15,30
100,Fail,50,23,0,13,37
100,Fail,46,34,0,10,36
100,Fail,48,28,0,14,34
100,Fail,49,25,0,12,37
100,Fail,50,29,0,12,38
100,Fail,48,31,0,13,35
100,Fail,50,29,0,11,39
100,Fail,47,31,0,11,36
100,Fail,45,24,3,18,27
100,Fail,41,27,0,20,21
100,Fail,49,21,6,15,34
100,Fail,45,24,8,12,33
100,Fail,50,19,2,16,34
100,Fail,45,33,0,10,35
100,Fail,50,30,0,9,41
100,Fail,46,28,5,11,35
100,Fail,47,30,2,10,37
100,Fail,46,21,2,21,25
100,Fail,55,18,3,8,47
100,Fail,44,33,0,16,28
100,Fail,49,24,8,8,41
100,Fail,51,28,0,9,42
100,Fail,51,22,1,12,39
100,Fail,39,37,0,16,23
100,Fail,49,24,0,15,34
100,Fail,49,30,0,13,36
100,Fail,54,27,4,6,48
100,Fail,49,24,3,14,35
100,Fail,60,19,2,9,51
100,Fail,42,40,0,8,34
100,Fail,43,28,0,18,25
100,Fail,50,28,0,13,37
100,Fail,55,26,1,8,47
100,Fail,56,23,5,8,48
100,Fail,36,43,0,13,23
100,Fail,44,33,0,14,30
100,Fail,46,25,0,17,29
100,Fail,44,23,9,15,29
100,Fail,50,22,0,14,36
100,Fail,51,26,4,11,40
100,Fail,44,37,0,9,35
100,Fail,45,25,4,19,26
100,Fail,40,35,0,15,25
100,Fail,39,38,0,13,26
100,Fail,44,32,0,13,31
100,Fail,45,37,0,11,34
100,Fail,43,25,11,14,29
100,Fail,51,20,5,10,41
100,Fail,47,21,6,19,28
100,Fail,47,31,2,12,35
100,Fail,48,20,9,17,31
100,Fail,48,24,0,18,30
100,Fail,45,32,0,10,35
100,Fail,48,21,8,11,37
100,Fail,47,27,4,15,32
100,Fail,51,23,0,13,38
100,Fail,51,23,2,15,36
100,Fail,50,27,1,10,40
100,Fail,48,23,6,15,33
100,Fail,48,31,0,11,37
100,Fail,43,23,5,17,26
100,Fail,47,29,0,16,31
100,Fail,49,29,0,10,39
100,Fail,51,32,0,10,41
100,Fail,49,28,3,10,39
100,Fail,44,31,0,13,31
100,Fail,46,25,7,12,34
100,Fail,53,23,0,11,42
100,Fail,48,33,0,11,37
100,Fail,45,24,0,18,27
100,Fail,49,31,0,10,39
100,Fail,52,20,7,14,38
100,Fail,47,29,0,13,34
100,Fail,45,30,0,11,34
100,Fail,50,18,8,12,38
100,Fail,53,28,0,9,44
100,Fail,47,25,0,17,30
100,Fail,52,17,0,19,33
100,Fail,54,30,1,6,48
100,Fail,54,25,0,11,43
100,Fail,49,20,5,15,34
100,Fail,51,22,0,15,36
100,Fail,49,26,2,15,34
100,Fail,51,32,0,10,41
100,Fail,54,24,0,12,42
100,Fail,54,22,0,14,40
100,Fail,51,29,0,12,39
100,Fail,50,28,0,9,41
100,Fail,53,23,0,9,44
100,Fail,48,29,2,15,33
100,Fail,46,27,4,12,34
100,Fail,55,17,4,11,44
100,Fail,44,31,0,13,31
100,Fail,52,23,0,12,40
100,Fail,47,34,0,13,34
100,Fail,47,28,3,11,36
100,Fail,46,30,2,11,35
100,Fail,50,25,0,15,35
100,Fail,49,16,1,21,28
100,Fail,37,35,4,15,22
100,Fail,53,22,0,13,40
100,Fail,39,31,11,11,28
100,Fail,39,37,0,15,24
100,Fail,45,30,3,12,33
100,Fail,51,26,4,10,41
100,Fail,46,29,0,14,32
100,Fail,45,28,11,11,34
100,Fail,45,26,0,16,29
100,Fail,48,22,5,13,35
100,Fail,53,30,0,9,44
100,Fail,51,22,3,7,44
100,Fail,46,28,0,16,30
100,Fail,54,17,1,13,41
100,Fail,47,28,0,14,33
100,Fail,52,28,0,12,40
100,Fail,53,22,0,17,36
100,Fail,44,27,1,16,28
100,Fail,54,27,0,8,46
100,Fail,52,23,0,14,38
100,Fail,44,29,3,13,31
100,Fail,53,21,2,12,41
100,Fail,53,23,0,17,36
100,Fail,51,25,2,12,39
100,Fail,49,27,3,13,36
100,Fail,53,24,3,9,44
100,Fail,58,15,1,12,46
100,Fail,43,33,4,10,33
100,Fail,48,28,3,6,42
100,Fail,46,25,3,14,32
100,Fail,41,30,9,10,31
100,Fail,51,34,0,6,45
100,Fail,49,28,0,13,36
100,Fail,47,31,0,11,36
100,Fail,45,25,7,16,29
100,Fail,46,30,0,13,33
100,Fail,50,19,1,18,32
100,Fail,51,23,0,17,34
100,Fail,52,32,3,8,44
100,Fail,49,18,1,19,30
100,Fail,39,33,4,14,25
100,Fail,47,26,0,14,33
100,Fail,48,18,9,17,31
100,Fail,51,30,2,2,49
100,Fail,45,24,0,23,22
100,Fail,45,24,0,15,30
100,Fail,45,30,0,14,31
100,Fail,42,29,3,15,27
100,Fail,48,24,3,15,33
100,Fail,52,22,5,9,43
100,Fail,56,23,0,6,50
100,Fail,53,24,0,14,39
100,Fail,46,25,0,11,35
100,Fail,44,30,3,10,34
100,Fail,45,30,5,12,33
100,Fail,54,26,0,10,44
100,Fail,43,31,0,15,28
100,Fail,43,28,6,14,29
100,Fail,49,29,0,9,40
100,Fail,41,40,0,15,26
100,Fail,52,30,0,12,40
100,Fail,44,22,2,19,25
100,Fail,50,21,3,18,32
100,Fail,43,28,6,11,32
100,Fail,45,23,3,22,23
100,Fail,53,29,0,8,45
100,Fail,40,28,8,11,29
100,Fail,49,30,0,8,41
100,Fail,42,33,0,17,25
100,Fail,54,26,0,11,43
100,Fail,53,22,2,9,44
100,Fail,47,25,0,18,29
100,Fail,39,25,10,16,23
100,Fail,46,24,4,11,35
100,Fail,46,34,0,12,34
100,Fail,46,31,2,8,38
100,Fail,45,33,0,8,37
100,Fail,44,30,0,14,30
100,Fail,43,36,0,9,34
100,Fail,55,21,1,12,43
100,Fail,47,36,0,7,40
100,Fail,40,29,6,17,23
100,Fail,53,21,0,12,41
100,Fail,50,23,1,12,38
100,Fail,56,26,0,8,48
100,Fail,44,30,4,14,30
100,Fail,49,21,4,17,32
100,Fail,47,23,6,17,30
100,Fail,49,28,4,9,40
100,Fail,52,28,0,10,42
100,Fail,46,23,4,13,33
100,Fail,46,34,0,13,33
100,Fail,54,26,3,9,45
100,Fail,47,33,0,16,31
100,Fail,45,26,4,15,30
100,Fail,55,20,3,12,43
100,Fail,49,28,0,15,34
100,Fail,44,27,0,19,25
100,Fail,56,20,0,10,46
100,Fail,47,30,0,11,36
100,Fail,49,24,0,15,34
100,Fail,53,18,5,13,40
100,Fail,53,24,0,12,41
100,Fail,43,31,0,16,27
100,Fail,49,25,6,9,40
100,Fail,43,32,0,17,26
100,Fail,39,38,0,14,25
100,Fail,52,26,2,8,44
100,Fail,47,27,7,10,37
100,Fail,41,26,15,11,30
100,Fail,48,30,0,13,35
100,Fail,47,30,0,16,31
100,Fail,46,22,7,14,32
100,Fail,50,26,0,15,35
100,Fail,52,28,0,12,40
100,Fail,50,27,0,13,37
100,Fail,47,29,0,14,33
100,Fail,58,23,1,6,52
100,Fail,45,35,0,13,32
100,Fail,52,28,0,11,41
100,Fail,44,29,0,17,27
100,Fail,56,24,0,5,51
100,Fail,52,24,1,9,43
100,Fail,46,25,6,14,32
100,Fail,55,24,0,11,44
100,Fail,41,30,8,11,30
100,Fail,58,23,0,11,47
100,Fail,50,23,3,14,36
100,Fail,48,28,1,12,36
100,Fail,47,30,2,11,36
100,Fail,47,31,1,12,35
100,Fail,46,25,6,11,35
100,Fail,51,24,0,14,37
100,Fail,46,29,1,14,32
100,Fail,51,22,2,18,33
100,Fail,42,32,5,10,32
100,Fail,48,30,0,12,36
100,Fail,43,32,1,15,28
100,Fail,46,33,3,8,38
100,Fail,49,20,0,14,35
100,Fail,50,29,0,7,43
100,Fail,47,28,0,12,35
100,Fail,56,21,0,12,44
100,Fail,46,28,0,14,32
100,Fail,57,24,0,10,47
100,Fail,48,24,0,16,32
100,Fail,41,38,0,12,29
100,Fail,49,30,0,10,39
100,Fail,46,26,0,15,31
100,Fail,42,29,0,17,25
100,Fail,50,16,1,17,33
100,Fail,40,36,4,10,30
100,Fail,49,27,0,13,36
100,Fail,50,31,0,14,36
100,Fail,46,35,0,9,37
100,Fail,50,19,3,14,36
100,Fail,53,26,0,11,42
100,Fail,46,26,4,14,32
100,Fail,42,40,0,13,29
100,Fail,45,23,7,12,33
100,Fail,47,28,4,10,37
100,Fail,51,26,3,11,40
100,Fail,44,32,0,14,30
100,Fail,44,30,0,15,29
100,Fail,48,24,2,14,34
100,Fail,54,25,2,9,45
100,Fail,47,30,0,15,32
100,Fail,58,24,0,8,50
100,Fail,37,35,0,20,17
100,Fail,47,32,0,12,35
100,Fail,53,25,0,9,44
100,Fail,43,34,2,10,33
100,Fail,52,19,2,14,38
100,Fail,51,27,2,8,43
100,Fail,51,23,4,12,39
100,Fail,57,23,0,8,49
100,Fail,54,25,0,10,44
100,Fail,45,33,0,10,35
100,Fail,55,24,3,9,46
100,Fail,44,31,5,13,31
100,Fail,53,29,0,5,48
100,Fail,59,19,0,9,50
100,Fail,47,31,0,13,34
100,Fail,49,27,1,11,38
100,Fail,44,30,7,11,33
100,Fail,53,23,6,7,46
100,Fail,42,39,0,10,32
100,Fail,51,25,3,8,43
100,Fail,51,32,0,8,43
100,Fail,49,32,0,7,42
100,Fail,39,39,0,13,26
100,Fail,51,23,7,11,40
100,Fail,50,23,6,11,39
100,Fail,50,33,0,7,43
100,Fail,47,22,1,17,30
100,Fail,45,23,5,17,28
100,Fail,45,32,0,10,35
100,Fail,52,21,6,11,41
100,Fail,44,34,0,11,33
100,Fail,55,21,0,12,43
100,Fail,46,27,6,12,34
100,Fail,62,19,1,10,52
100,Fail,42,35,0,14,28
100,Fail,55,25,0,9,46
100,Fail,50,27,0,11,39
100,Fail,47,34,0,7,40
100,Fail,47,31,0,6,41
100,Fail,43,26,11,13,30
100,Fail,58,17,0,9,49
100,Fail,51,26,0,12,39
100,Fail,46,30,8,12,34
100,Fail,41,30,7,12,29
100,Fail,53,23,5,8,45
100,Fail,46,38,0,9,37
100,Fail,48,23,0,12,36
100,Fail,51,22,2,9,42
100,Fail,56,22,0,10,46
100,Fail,57,23,0,8,49
100,Fail,52,29,0,9,43
100,Fail,46,30,3,10,36
100,Fail,44,30,0,15,29
100,Fail,45,32,0,12,33
100,Fail,58,17,2,12,46
100,Fail,44,35,0,9,35
100,Fail,51,21,2,16,35
100,Fail,51,24,6,12,39
100,Fail,42,35,0,12,30
100,Fail,48,20,0,16,32
100,Fail,44,34,0,10,34
100,Fail,54,20,3,14,40
100,Fail,45,30,6,12,33
100,Fail,48,28,0,14,34
100,Fail,43,32,0,12,31
100,Fail,48,28,7,10,38
100,Fail,49,24,3,14,35
100,Fail,50,25,1,11,39
100,Fail,49,27,2,11,38
100,Fail,42,35,0,12,30
100,Fail,49,26,3,10,39
100,Fail,47,23,3,17,30
100,Fail,41,37,0,11,30
100,Fail,42,29,0,20,22
100,Fail,49,29,0,13,36
100,Fail,49,30,0,8,41
100,Fail,44,38,0,10,34
100,Fail,44,31,0,15,29
100,Fail,38,35,0,19,19
100,Fail,40,28,2,18,22
100,Fail,47,29,0,12,35
100,Fail,47,25,2,16,31
100,Fail,43,23,19,7,36
100,Fail,49,34,0,7,42
100,Fail,43,26,0,21,22
100,Fail,45,30,2,8,37
100,Fail,44,30,6,8,36
100,Fail,47,35,0,11,36
100,Fail,46,31,0,14,32
100,Fail,51,27,1,10,41
100,Fail,56,16,2,14,42
100,Fail,43,34,0,10,33
100,Fail,60,24,0,4,56
100,Fail,49,20,5,12,37
100,Fail,48,31,0,12,36
100,Fail,58,22,3,6,52
100,Fail,42,33,0,16,26
100,Fail,41,37,0,13,28
100,Fail,35,39,0,16,19
100,Fail,41,31,8,14,27
100,Fail,38,28,10,18,20
100,Fail,51,30,0,8,43
100,Fail,45,24,7,13,32
100,Fail,39,29,8,14,25
100,Fail,42,34,1,14,28
100,Fail,49,16,8,18,31
100,Fail,48,29,3,11,37
100,Fail,58,17,6,10,48
100,Fail,50,24,0,14,36
100,Fail,48,20,11,11,37
100,Fail,50,27,2,12,38
100,Fail,48,28,0,17,31
100,Fail,48,29,0,14,34
100,Fail,50,25,1,13,37
100,Fail,51,30,0,12,39
100,Fail,43,24,5,17,26
100,Fail,45,30,0,13,32
100,Fail,49,28,0,13,36
100,Fail,46,26,11,11,35
100,Fail,56,20,1,12,44
100,Fail,47,28,2,12,35
100,Fail,47,20,8,12,35
100,Fail,54,20,5,13,41
100,Fail,53,22,0,9,44
100,Fail,40,32,3,11,29
100,Fail,57,23,1,6,51
100,Fail,44,30,4,13,31
100,Fail,45,31,3,12,33
100,Fail,52,31,0,4,48
100,Fail,47,28,6,9,38
100,Fail,53,25,0,9,44
100,Fail,49,29,0,12,37
100,Fail,34,51,0,9,25
100,Fail,43,29,3,14,29
100,Fail,59,18,0,10,49
100,Fail,38,34,0,19,19
100,Fail,48,25,6,12,36
100,Fail,52,25,2,11,41
100,Fail,53,26,0,12,41
100,Fail,54,20,0,14,40
100,Fail,37,36,0,22,15
100,Fail,49,24,0,12,37
100,Fail,43,32,0,14,29
100,Fail,44,24,2,15,29
100,Fail,42,37,0,11,31
100,Fail,50,33,0,8,42
100,Fail,50,29,0,10,40
100,Fail,48,24,4,15,33
100,Fail,56,23,0,5,51
100,Fail,52,16,3,17,35
100,Fail,43,26,0,19,24
100,Fail,48,35,0,6,42
100,Fail,58,17,0,14,44
100,Fail,50,28,0,10,40
100,Fail,54,24,0,11,43
100,Fail,47,22,8,16,31
100,Fail,52,26,0,12,40
100,Fail,40,42,0,11,29
100,Fail,49,21,3,16,33
100,Fail,52,22,4,9,43
100,Fail,55,25,3,7,48
100,Fail,48,32,0,12,36
100,Fail,51,23,0,9,42
100,Fail,54,27,0,8,46
100,Fail,43,30,0,15,28
100,Fail,41,28,7,18,23
100,Fail,46,24,4,14,32
100,Fail,49,24,4,15,34
100,Fail,53,24,0,12,41
100,Fail,49,29,5,9,40
100,Fail,51,20,8,10,41
100,Fail,42,39,0,10,32
100,Fail,42,36,0,14,28
100,Fail,35,30,12,18,17
100,Fail,43,27,6,13,30
100,Fail,46,31,0,15,31
100,Fail,48,24,3,16,32
100,Fail,53,19,5,13,40
100,Fail,41,32,6,13,28
100,Fail,50,28,0,7,43
100,Fail,40,44,0,13,27
100,Fail,44,28,2,15,29
100,Fail,41,37,0,13,28
100,Fail,55,23,0,10,45
100,Fail,51,21,2,13,38
100,Fail,47,35,0,11,36
100,Fail,57,17,2,12,45
100,Fail,33,39,3,14,19
100,Fail,55,26,0,11,44
100,Fail,48,26,0,16,32
100,Fail,53,17,1,11,42
100,Fail,46,30,0,12,34
100,Fail,49,30,0,9,40
100,Fail,50,31,0,9,41
100,Fail,56,19,0,9,47
100,Fail,54,21,1,13,41
100,Fail,43,28,8,14,29
100,Fail,47,26,5,11,36
100,Fail,40,32,5,15,25
100,Fail,49,29,2,9,40
100,Fail,45,27,0,18,27
100,Fail,42,33,0,15,27
100,Fail,45,25,3,16,29
100,Fail,46,33,0,14,32
100,Fail,53,26,0,11,42
100,Fail,54,23,0,14,40
100,Fail,41,30,9,12,29
100,Fail,42,33,2,10,32
100,Fail,52,21,0,16,36
100,Fail,51,23,0,14,37
100,Fail,55,25,0,11,44
100,Fail,50,29,0,16,34
100,Fail,53,27,0,12,41
100,Fail,44,33,0,11,33
100,Fail,54,21,0,16,38
100,Fail,44,33,0,14,30
100,Fail,42,37,0,15,27
100,Fail,47,24,8,14,33
100,Fail,46,34,0,13,33
100,Fail,46,26,8,13,33
100,Fail,43,31,0,14,29
100,Fail,43,32,0,13,30
100,Fail,50,18,6,19,31
100,Fail,48,21,1,16,32
100,Fail,43,34,0,15,28
100,Fail,55,22,0,14,41
100,Fail,47,25,0,14,33
100,Fail,47,25,0,18,29
100,Fail,52,26,2,11,41
100,Fail,45,24,4,12,33
100,Fail,41,32,0,17,24
100,Fail,44,35,0,15,29
100,Fail,43,28,2,16,27
100,Fail,36,39,0,19,17
100,Fail,47,22,2,17,30
100,Fail,46,28,0,12,34
100,Fail,56,23,0,7,49
100,Fail,45,20,4,15,30
100,Fail,45,36,0,13,32
100,Fail,51,25,2,10,41
100,Fail,47,32,0,11,36
100,Fail,54,19,0,15,39
100,Fail,43,29,4,15,28
100,Fail,34,34,8,14,20
100,Fail,45,30,0,13,32
100,Fail,48,23,3,15,33
100,Fail,42,32,0,17,25
100,Fail,49,37,0,9,40
100,Fail,46,23,6,16,30
100,Fail,55,16,9,13,42
100,Fail,52,27,0,10,42
100,Fail,37,34,6,17,20
100,Fail,48,25,0,12,36
100,Fail,53,29,0,8,45
100,Fail,45,25,7,14,31
100,Fail,47,28,2,11,36
100,Fail,47,28,1,12,35
100,Fail,52,20,8,10,42
100,Fail,49,29,3,9,40
100,Fail,50,20,10,15,35
100,Fail,51,23,3,14,37
100,Fail,46,26,0,16,30
100,Fail,49,28,0,12,37
100,Fail,41,42,0,5,36
100,Fail,52,20,4,13,39
100,Fail,49,26,0,13,36
100,Fail,48,24,1,13,35
100,Fail,48,26,0,13,35
100,Fail,49,22,1,16,33
100,Fail,43,27,6,15,28
100,Fail,51,25,0,11,40
100,Fail,43,30,6,10,33
100,Fail,44,22,6,16,28
100,Fail,59,22,2,6,53
100,Fail,60,18,3,9,51
100,Fail,50,26,4,13,37
100,Fail,61,20,4,8,53
100,Fail,45,39,0,10,35
100,Fail,46,24,10,11,35
100,Fail,51,20,2,12,39
100,Fail,50,25,1,11,39
100,Fail,54,29,0,9,45
100,Fail,51,27,0,12,39
100,Fail,52,21,2,10,42
100,Fail,52,17,7,14,38
100,Fail,46,39,0,7,39
100,Fail,40,42,0,11,29
100,Fail,47,23,2,14,33
100,Fail,48,34,0,10,38
100,Fail,48,25,0,16,32
100,Fail,54,29,0,3,51
100,Fail,37,32,7,17,20
100,Fail,47,30,0,10,37
100,Fail,43,26,0,17,26
100,Fail,56,27,0,8,48
100,Fail,47,34,0,12,35
100,Fail,52,28,3,6,46
100,Fail,45,31,2,8,37
100,Fail,47,28,2,12,35
100,Fail,40,27,8,18,22
100,Fail,56,28,0,6,50
100,Fail,43,32,0,14,29
100,Fail,49,27,1,9,40
100,Fail,51,18,2,17,34
100,Fail,42,26,8,13,29
100,Fail,44,33,0,13,31
100,Fail,44,30,1,11,33
100,Fail,46,29,2,14,32
100,Fail,42,28,5,15,27
100,Fail,49,25,0,15,34
100,Fail,53,21,3,8,45
100,Fail,39,28,10,17,22
100,Fail,51,26,0,11,40
100,Fail,48,21,6,18,30
100,Fail,48,29,0,9,39
100,Fail,42,34,0,14,28
100,Fail,38,39,4,10,28
100,Fail,46,34,0,7,39
100,Fail,45,26,0,16,29
100,Fail,44,30,0,15,29
100,Fail,47,25,6,13,34
100,Fail,49,29,0,9,40
100,Fail,44,25,4,12,32
100,Fail,53,28,0,10,43
100,Fail,54,23,10,6,48
100,Fail,44,30,0,14,30
100,Fail,54,22,0,12,42
100,Fail,51,25,2,10,41
100,Fail,56,23,0,13,43
100,Fail,46,30,0,16,30
100,Fail,57,20,1,11,46
100,Fail,48,27,0,15,33
100,Fail,55,16,0,16,39
100,Fail,46,30,0,15,31
100,Fail,45,23,4,16,29
100,Fail,43,35,0,13,30
100,Fail,54,21,0,14,40
100,Fail,47,28,0,14,33
100,Fail,56,17,1,17,39
100,Fail,52,22,3,15,37
100,Fail,44,27,7,15,29
100,Fail,51,25,4,12,39
100,Fail,45,35,0,11,34
100,Fail,51,26,0,13,38
100,Fail,52,16,5,17,35
100,Fail,51,25,0,10,41
100,Fail,49,31,1,10,39
100,Fail,54,26,0,9,45
100,Fail,48,24,1,16,32
100,Fail,40,38,0,15,25
100,Fail,51,26,5,7,44
100,Fail,52,23,0,11,41
100,Fail,39,31,4,14,25
100,Fail,52,25,1,11,41
100,Fail,44,24,7,13,31
100,Fail,47,27,6,12,35
100,Fail,46,27,0,16,30
100,Fail,46,27,2,15,31
100,Fail,45,30,2,13,32
100,Fail,46,26,3,16,30
100,Fail,49,31,0,12,37
100,Fail,52,21,0,15,37
100,Fail,36,40,0,15,21
100,Fail,55,21,3,11,44
100,Fail,52,21,7,11,41
100,Fail,48,25,7,13,35
100,Fail,53,20,0,14,39
100,Fail,46,29,4,11,35
100,Fail,54,24,0,11,43
100,Fail,49,25,2,14,35
100,Fail,57,27,0,7,50
100,Fail,53,23,0,10,43
100,Fail,50,24,4,14,36
100,Fail,42,39,0,10,32
100,Fail,44,32,0,15,29
100,Fail,47,23,11,13,34
100,Fail,45,27,0,13,32
100,Fail,51,25,6,7,44
100,Fail,52,24,1,12,40
100,Fail,50,28,0,12,38
100,Fail,46,30,0,14,32
100,Fail,53,22,2,14,39
100,Fail,43,32,2,13,30
100,Fail,46,31,1,14,32
100,Fail,47,19,4,16,31
100,Fail,53,22,3,13,40
100,Fail,48,25,1,9,39
100,Fail,42,37,0,10,32
100,Fail,50,27,0,12,38
100,Fail,49,31,0,10,39
100,Fail,45,23,9,14,31
100,Fail,45,18,9,12,33
100,Fail,55,20,0,16,39
100,Fail,44,27,9,12,32
100,Fail,45,30,0,16,29
100,Fail,52,23,2,13,39
100,Fail,52,21,4,13,39
100,Fail,45,25,3,15,30
100,Fail,39,36,0,14,25
100,Fail,44,33,0,11,33
100,Fail,49,21,6,14,35
100,Fail,49,29,0,15,34
100,Fail,37,41,0,15,22
100,Fail,42,31,3,14,28
100,Fail,40,27,9,17,23
100,Fail,51,31,0,9,42
100,Fail,47,28,0,14,33
100,Fail,58,20,0,12,46
100,Fail,47,22,0,17,30
100,Fail,47,27,7,10,37
100,Fail,48,28,0,16,32
100,Fail,46,31,0,11,35
100,Fail,46,26,5,13,33
100,Fail,50,24,7,11,39
100,Fail,50,29,0,8,42
100,Fail,58,23,0,8,50
100,Fail,47,33,0,11,36
100,Fail,54,23,2,11,43
100,Fail,45,25,7,15,30
100,Fail,44,29,0,14,30
100,Fail,41,38,0,15,26
100,Fail,49,25,3,12,37
100,Fail,49,19,6,15,34
100,Fail,50,22,3,14,36
100,Fail,44,38,0,10,34
100,Fail,48,24,1,17,31
100,Fail,51,17,8,9,42
100,Fail,44,30,0,13,31
100,Fail,54,20,2,9,45
100,Fail,48,20,7,16,32
100,Fail,41,29,1,18,23
100,Fail,56,13,0,15,41
100,Fail,40,26,8,16,24
100,Fail,48,23,7,13,35
100,Fail,44,40,0,8,36
100,Fail,41,36,0,10,31
100,Fail,43,23,7,16,27
100,Fail,44,29,1,15,29
100,Fail,50,27,0,8,42
100,Fail,43,35,5,11,32
100,Fail,43,28,5,15,28
100,Fail,39,40,0,12,27
100,Fail,42,35,0,12,30
100,Fail,45,26,7,12,33
100,Fail,51,28,0,11,40
100,Fail,50,22,0,14,36
100,Fail,52,24,7,9,43
100,Fail,43,28,10,12,31
100,Fail,40,37,0,10,30
100,Fail,41,29,4,16,25
100,Fail,53,23,1,10,43
100,Fail,49,26,0,15,34
100,Fail,52,26,0,12,40
100,Fail,41,30,4,15,26
100,Fail,47,30,0,15,32
100,Fail,48,29,0,13,35
100,Fail,51,28,0,14,37
100,Fail,55,20,0,14,41
100,Fail,41,32,1,13,28
100,Fail,52,24,5,8,44
100,Fail,48,28,2,10,38
100,Fail,50,28,1,9,41
100,Fail,47,23,9,14,33
100,Fail,47,25,0,13,34
100,Fail,46,24,9,15,31
100,Fail,48,29,0,10,38
100,Fail,39,37,2,12,27
100,Fail,56,19,7,12,44
100,Fail,43,22,10,18,25
100,Fail,47,25,4,12,35
100,Fail,53,27,2,7,46
100,Fail,50,26,5,13,37
100,Fail,44,28,0,16,28
100,Fail,48,32,0,10,38
100,Fail,52,26,0,8,44
100,Fail,45,26,5,11,34
100,Fail,51,21,1,14,37
100,Fail,56,25,0,10,46
100,Fail,54,20,3,10,44
100,Fail,50,25,1,16,34
100,Fail,48,31,0,12,36
100,Fail,48,25,0,18,30
100,Fail,45,31,0,16,29
100,Fail,49,31,0,7,42
100,Fail,53,19,0,14,39
100,Fail,48,24,0,14,34
100,Fail,41,32,6,14,27
100,Fail,56,29,0,6,50
100,Fail,46,23,5,16,30
100,Fail,49,30,0,13,36
100,Fail,45,32,1,13,32
100,Fail,46,31,0,11,35
100,Fail,46,25,0,13,33
100,Fail,43,30,4,12,31
100,Fail,51,26,0,12,39
100,Fail,53,21,0,13,40
100,Fail,50,24,0,16,34
100,Fail,46,32,0,14,32
100,Fail,43,29,2,15,28
100,Fail,58,23,0,7,51
100,Fail,52,23,1,13,39
100,Fail,50,26,0,11,39
100,Fail,56,17,0,11,45
100,Fail,48,27,5,10,38
100,Fail,49,25,13,8,41
100,Fail,47,31,0,13,34
100,Fail,50,35,0,8,42
100,Fail,44,27,1,16,28
100,Fail,47,28,7,11,36
100,Fail,50,23,2,12,38
100,Fail,44,39,0,12,32
100,Fail,49,27,0,10,39
100,Fail,43,22,4,20,23
100,Fail,50,23,4,10,40
100,Fail,51,28,0,14,37
100,Fail,44,30,0,12,32
100,Fail,57,27,0,6,51
100,Fail,53,26,0,10,43
100,Fail,48,23,5,13,35
100,Fail,45,30,0,15,30
100,Fail,51,20,3,14,37
100,Fail,50,32,0,10,40
100,Fail,52,21,4,13,39
100,Fail,43,38,5,5,38
100,Fail,48,22,12,11,37
100,Fail,51,26,0,15,36
100,Fail,44,26,0,24,20
100,Fail,50,24,6,9,41
100,Fail,51,19,0,14,37
100,Fail,51,23,5,12,39
100,Fail,49,25,0,13,36
100,Fail,61,19,0,9,52
100,Fail,51,25,3,9,42
100,Fail,55,25,0,9,46
100,Fail,45,26,3,18,27
100,Fail,54,24,0,10,44
100,Fail,43,36,0,11,32
100,Fail,48,32,0,11,37
100,Fail,53,24,0,5,48
100,Fail,48,24,0,19,29
100,Fail,43,38,0,14,29
100,Fail,50,18,5,11,39
100,Fail,43,31,0,17,26
100,Fail,47,31,0,16,31
100,Fail,44,33,0,12,32
100,Fail,55,19,1,10,45
100,Fail,54,23,2,8,46
100,Fail,51,22,0,14,37
100,Fail,49,36,0,10,39
100,Fail,47,24,5,11,36
100,Fail,44,30,0,16,28
100,Fail,49,28,4,9,40
100,Fail,54,24,4,6,48
100,Fail,47,29,0,10,37
100,Fail,54,24,0,14,40
100,Fail,42,20,0,21,21
100,Fail,50,30,0,13,37
100,Fail,46,30,0,15,31
100,Fail,49,23,1,15,34
100,Fail,48,27,1,15,33
100,Fail,42,28,2,19,23
100,Fail,43,27,0,15,28
100,Fail,50,30,0,10,40
100,Fail,46,28,3,13,33
100,Fail,49,19,2,13,36
100,Fail,51,25,0,11,40
100,Fail,44,34,0,15,29
100,Fail,49,26,2,14,35
100,Fail,52,23,0,17,35
100,Fail,49,23,0,16,33
100,Fail,48,21,4,16,32
100,Fail,52,21,0,12,40
100,Fail,45,27,8,12,33
100,Fail,45,30,4,10,35
100,Fail,44,28,6,12,32
100,Fail,51,26,0,7,44
100,Fail,49,29,0,10,39
100,Fail,43,34,0,15,28
100,Fail,44,34,0,11,33
100,Fail,39,25,9,16,23
100,Fail,48,26,2,13,35
100,Fail,54,25,3,8,46
100,Fail,46,33,0,8,38
100,Fail,46,29,0,16,30
100,Fail,46,34,0,7,39
100,Fail,47,30,0,15,32
100,Fail,51,29,0,14,37
100,Fail,55,21,0,11,44
100,Fail,41,26,2,18,23
100,Fail,53,20,6,11,42
100,Fail,46,27,5,13,33
100,Fail,48,28,0,12,36
100,Fail,51,27,4,10,41
100,Fail,57,26,0,7,50
100,Fail,37,39,6,12,25
100,Fail,54,22,2,12,42
100,Fail,48,29,0,12,36
100,Fail,53,24,2,6,47
100,Fail,48,29,0,11,37
100,Fail,48,25,7,13,35
100,Fail,47,21,12,6,41
100,Fail,52,25,0,12,40
100,Fail,48,28,0,14,34
100,Fail,48,26,5,16,32
100,Fail,53,26,0,11,42
100,Fail,49,26,3,14,35
100,Fail,57,20,0,9,48
100,Fail,48,27,0,10,38
100,Fail,46,30,0,13,33
100,Fail,45,23,10,16,29
100,Fail,50,29,0,11,39
100,Fail,41,38,0,9,32
100,Fail,47,26,0,17,30
100,Fail,39,30,12,11,28
100,Fail,41,33,0,17,24
100,Fail,48,26,3,14,34
100,Fail,53,24,9,3,50
100,Fail,50,35,0,8,42
100,Fail,48,21,7,15,33
100,Fail,43,24,3,16,27
100,Fail,46,26,4,13,33
100,Fail,47,22,13,11,36
100,Fail,50,29,0,9,41
100,Fail,48,29,0,11,37
100,Fail,47,36,0,5,42
100,Fail,48,24,2,14,34
100,Fail,55,21,0,13,42
100,Fail,46,33,0,11,35
100,Fail,49,27,5,13,36
100,Fail,41,28,2,18,23
100,Fail,55,20,4,11,44
100,Fail,48,29,4,11,37
100,Fail,48,28,0,15,33
100,Fail,47,25,0,14,33
100,Fail,43,41,0,8,35
100,Fail,44,38,0,10,34
100,Fail,57,19,1,11,46
100,Fail,52,21,1,11,41
100,Fail,47,26,0,16,31
100,Fail,44,36,0,13,31
100,Fail,54,14,4,17,37
100,Fail,50,26,2,14,36
100,Fail,44,31,0,14,30
100,Fail,49,33,1,8,41
100,Fail,46,24,7,15,31
100,Fail,44,25,6,13,31
100,Fail,48,35,0,8,40
100,Fail,47,21,9,9,38
100,Fail,52,30,0,11,41
100,Fail,53,26,0,10,43
100,Fail,51,29,0,9,42
100,Fail,40,23,11,17,23
100,Fail,53,31,0,8,45
100,Fail,45,31,2,11,34
100,Fail,51,28,0,9,42
100,Fail,46,34,0,9,37
100,Fail,39,36,0,13,26
100,Fail,43,41,0,10,33
100,Fail,50,27,0,14,36
100,Fail,49,27,0,13,36
100,Fail,48,28,5,8,40
100,Fail,56,24,0,8,48
100,Fail,48,25,2,18,30
100,Fail,45,28,0,16,29
100,Fail,47,26,3,11,36
100,Fail,49,25,2,14,35
100,Fail,41,27,8,13,28
100,Fail,44,29,0,15,29
100,Fail,42,27,3,18,24
100,Fail,46,27,7,12,34
100,Fail,48,25,4,14,34
100,Fail,50,30,0,7,43
100,Fail,46,28,0,15,31
100,Fail,56,27,0,9,47
100,Fail,41,37,0,11,30
100,Fail,50,27,0,11,39
100,Fail,51,26,0,15,36
100,Fail,48,27,0,17,31
100,Fail,50,19,15,9,41
100,Fail,44,35,0,15,29
100,Fail,47,26,8,10,37
100,Fail,39,29,8,19,20
100,Fail,48,25,0,11,37
100,Fail,53,27,1,8,45
100,Fail,48,25,5,11,37
100,Fail,48,29,0,15,33
100,Fail,39,34,0,18,21
100,Fail,48,24,0,15,33
100,Fail,47,23,9,13,34
100,Fail,49,30,4,8,41
100,Fail,45,28,9,11,34
100,Fail,53,21,3,12,41
100,Fail,46,32,0,12,34
100,Fail,46,26,0,17,29
100,Fail,53,24,1,6,47
100,Fail,52,27,0,10,42
100,Fail,43,39,0,10,33
100,Fail,48,25,2,12,36
100,Fail,45,28,0,15,30
100,Fail,48,32,0,15,33
100,Fail,41,28,8,13,28
100,Fail,46,24,0,22,24
100,Fail,52,25,4,12,40
100,Fail,39,30,3,19,20
100,Fail,55,26,0,8,47
100,Fail,43,28,5,13,30
100,Fail,53,24,3,10,43
100,Fail,47,35,0,11,36
100,Fail,47,31,0,9,38
100,Fail,45,33,0,15,30
100,Fail,47,30,0,13,34
100,Fail,42,30,3,16,26
100,Fail,41,38,0,10,31
100,Fail,36,39,7,11,25
100,Fail,47,30,0,10,37
100,Fail,60,19,7,8,52
100,Fail,51,22,1,12,39
100,Fail,58,18,0,14,44
100,Fail,51,32,0,9,42
100,Fail,51,26,0,12,39
100,Fail,53,23,1,14,39
100,Fail,43,33,0,13,30
100,Fail,43,34,0,11,32
100,Fail,51,28,0,12,39
100,Fail,50,25,9,8,42
100,Fail,44,40,0,9,35
100,Fail,51,33,0,9,42
100,Fail,44,32,0,17,27
100,Fail,54,21,5,11,43
100,Fail,52,25,0,10,42
100,Fail,47,29,4,10,37
100,Fail,47,23,3,15,32
100,Fail,55,18,0,12,43
100,Fail,47,33,0,9,38
100,Fail,47,32,0,11,36
100,Fail,50,23,1,11,39
100,Fail,37,42,0,14,23
100,Fail,44,33,0,13,31
100,Fail,51,17,2,11,40
100,Fail,45,27,3,13,32
100,Fail,43,30,1,17,26
100,Fail,38,35,9,11,27
100,Fail,46,26,7,15,31
100,Fail,52,21,1,14,38
100,Fail,53,21,2,14,39
100,Fail,54,27,0,7,47
100,Fail,37,35,0,17,20
100,Fail,48,20,6,17,31
100,Fail,46,22,8,15,31
100,Fail,47,34,0,13,34
100,Fail,46,23,10,13,33
100,Fail,45,29,0,11,34
100,Fail,49,28,3,11,38
100,Fail,50,25,4,11,39
100,Fail,48,31,0,14,34
100,Fail,47,27,4,11,36
100,Fail,49,27,0,17,32
100,Fail,45,29,2,15,30
100,Fail,58,19,0,12,46
100,Fail,49,31,0,12,37
100,Fail,51,36,0,7,44
100,Fail,43,38,0,7,36
100,Fail,46,30,6,9,37
100,Fail,50,19,15,10,40
100,Fail,49,23,6,12,37
100,Fail,48,35,0,9,39
100,Fail,48,30,0,13,35
100,Fail,42,28,2,15,27
100,Fail,54,25,0,7,47
100,Fail,51,25,0,15,36
100,Fail,53,24,0,11,42
100,Fail,50,35,0,9,41
100,Fail,50,24,4,11,39
100,Fail,44,34,2,14,30
100,Fail,50,26,0,13,37
100,Fail,43,29,0,15,28
100,Fail,49,30,0,12,37
100,Fail,49,27,0,14,35
100,Fail,56,26,0,8,48
100,Fail,49,31,0,6,43
100,Fail,54,27,0,9,45
100,Fail,49,26,0,10,39
100,Fail,46,29,0,13,33
100,Fail,42,30,5,14,28
100,Fail,52,26,4,9,43
100,Fail,46,25,5,14,32
100,Fail,56,16,0,12,44
100,Fail,50,29,0,9,41
100,Fail,56,24,3,4,52
100,Fail,49,28,0,13,36
100,Fail,45,31,0,12,33
100,Fail,47,28,0,17,30
100,Fail,47,34,0,8,39
100,Fail,52,24,0,13,39
100,Fail,52,23,5,7,45
100,Fail,53,24,0,13,40
100,Fail,54,17,5,13,41
100,Fail,44,29,1,15,29
100,Fail,50,25,0,11,39
100,Fail,46,21,6,17,29
100,Fail,53,23,2,9,44
100,Fail,51,25,2,7,44
100,Fail,47,28,6,5,42
100,Fail,55,20,5,10,45
100,Fail,42,29,0,19,23
100,Fail,50,24,0,16,34
100,Fail,51,26,0,10,41
100,Fail,42,30,0,17,25
100,Fail,44,31,0,16,28
100,Fail,52,24,0,13,39
100,Fail,49,30,0,14,35
100,Fail,49,26,1,12,37
100,Fail,40,26,7,14,26
100,Fail,52,25,2,13,39
100,Fail,54,20,0,14,40
100,Fail,55,32,0,7,48
100,Fail,46,30,0,12,34
100,Fail,49,22,0,15,34
100,Fail,44,35,3,12,32
100,Fail,45,31,2,11,34
100,Fail,57,16,5,12,45
100,Fail,39,36,1,11,28
100,Fail,43,28,6,13,30
100,Fail,44,31,5,12,32
100,Fail,50,30,0,12,38
100,Fail,46,35,0,9,37
100,Fail,41,31,0,15,26
100,Fail,60,22,0,7,53
100,Fail,37,32,4,14,23
100,Fail,49,24,5,15,34
100,Fail,49,32,0,6,43
100,Fail,52,24,1,13,39
100,Fail,52,22,0,9,43
100,Fail,36,45,0,9,27
100,Fail,45,25,6,13,32
100,Fail,47,26,1,15,32
100,Fail,47,24,6,11,36
100,Fail,48,19,7,15,33
100,Fail,52,24,0,14,38
100,Fail,53,30,1,8,45
100,Fail,48,36,0,9,39
100,Fail,37,39,5,11,26
100,Fail,44,24,8,17,27
100,Fail,50,29,3,6,44
100,Fail,47,33,0,15,32
100,Fail,51,27,0,12,39
100,Fail,45,29,7,12,33
100,Fail,46,40,0,7,39
100,Fail,52,28,0,6,46
100,Fail,39,35,0,14,25
100,Fail,43,29,0,17,26
100,Fail,51,26,0,10,41
100,Fail,46,33,0,12,34
100,Fail,57,18,0,11,46
100,Fail,55,17,2,12,43
100,Fail,52,22,2,12,40
100,Fail,50,27,7,6,44
100,Fail,50,26,0,12,38
100,Fail,43,26,9,13,30
100,Fail,44,31,2,12,32
100,Fail,38,26,13,16,22
100,Fail,50,29,0,12,38
100,Fail,54,23,3,12,42
100,Fail,43,31,2,14,29
100,Fail,41,29,1,16,25
100,Fail,44,38,0,10,34
100,Fail,39,42,0,9,30
100,Fail,48,30,1,7,41
100,Fail,49,28,2,10,39
100,Fail,52,27,0,10,42
100,Fail,48,27,0,14,34
100,Fail,48,22,6,15,33
100,Fail,44,29,0,18,26
100,Fail,50,23,0,17,33
100,Fail,45,31,3,11,34
100,Fail,48,24,7,13,35
100,Fail,50,27,4,12,38
100,Fail,50,23,0,15,35
100,Fail,45,26,0,18,27
100,Fail,52,26,0,13,39
100,Fail,54,23,0,11,43
100,Fail,46,25,6,17,29
100,Fail,55,21,0,10,45
100,Fail,44,24,14,11,33
100,Fail,45,31,2,16,29
100,Fail,44,25,8,15,29
100,Fail,46,30,0,17,29
100,Fail,41,29,3,15,26
100,Fail,42,28,0,16,26
100,Fail,50,18,7,13,37
100,Fail,52,26,0,12,40
100,Fail,46,23,3,15,31
100,Fail,46,25,0,16,30
100,Fail,42,31,4,13,29
100,Fail,54,19,4,12,42
100,Fail,44,25,8,16,28
100,Fail,47,24,6,13,34
100,Fail,38,30,13,11,27
100,Fail,49,26,0,13,36
100,Fail,44,25,10,14,30
100,Fail,47,30,0,15,32
100,Fail,54,15,5,14,40
100,Fail,51,21,2,13,38
100,Fail,53,24,0,9,44
100,Fail,50,24,2,8,42
100,Fail,51,24,0,10,41
100,Fail,55,19,3,10,45
100,Fail,55,20,0,9,46
100,Fail,42,27,3,17,25
100,Fail,49,26,5,9,40
100,Fail,56,18,9,6,50
100,Fail,48,27,7,8,40
100,Fail,54,19,0,15,39
100,Fail,55,24,3,11,44
100,Fail,52,22,3,13,39
100,Fail,52,23,0,11,41
100,Fail,46,31,3,9,37
100,Fail,51,20,6,13,38
100,Fail,44,38,0,4,40
100,Fail,47,29,0,12,35
100,Fail,42,31,0,16,26
100,Fail,50,24,0,15,35
100,Fail,48,27,0,15,33
100,Fail,53,19,4,14,39
100,Fail,45,32,0,13,32
100,Fail,49,22,0,17,32
100,Fail,50,25,0,15,35
100,Fail,48,23,4,15,33
100,Fail,46,22,10,15,31
100,Fail,55,25,0,9,46
100,Fail,50,30,0,10,40
100,Fail,48,29,3,8,40
100,Fail,44,23,5,15,29
100,Fail,39,34,0,13,26
100,Fail,53,28,0,11,42
100,Fail,41,34,4,10,31
100,Fail,45,23,7,17,28
100,Fail,45,28,0,13,32
100,Fail,40,34,2,16,24
100,Fail,52,23,7,10,42
100,Fail,47,25,7,13,34
100,Fail,51,19,3,13,38
100,Fail,50,21,2,16,34
100,Fail,45,26,0,16,29
100,Fail,45,26,0,16,29
100,Fail,49,18,5,20,29
100,Fail,49,21,2,17,32
100,Fail,51,25,0,13,38
100,Fail,57,22,0,12,45
100,Fail,49,34,0,7,42
100,Fail,52,27,0,10,42
100,Fail,53,22,0,12,41
100,Fail,45,31,0,14,31
100,Fail,52,23,0,15,37
100,Fail,50,21,0,15,35
100,Fail,52,18,2,13,39
100,Fail,56,22,0,9,47
100,Fail,55,25,0,6,49
100,Fail,45,35,0,10,35
100,Fail,48,28,3,13,35
100,Fail,44,26,6,20,24
100,Fail,45,33,0,15,30
100,Fail,50,26,0,12,38
100,Fail,41,33,0,12,29
100,Fail,41,27,4,19,22
100,Fail,51,27,8,7,44
100,Fail,51,24,2,11,40
100,Fail,52,23,3,9,43
100,Fail,44,22,4,17,27
100,Fail,50,20,4,13,37
100,Fail,47,27,0,13,34
100,Fail,48,25,3,13,35
100,Fail,58,16,0,13,45
100,Fail,50,28,1,10,40
100,Fail,51,23,1,12,39
100,Fail,42,28,13,15,27
100,Fail,51,23,2,15,36
100,Fail,50,29,0,12,38
100,Fail,50,26,0,15,35
100,Fail,52,22,7,8,44
100,Fail,46,23,3,16,30
100,Fail,50,20,1,17,33
100,Fail,49,20,1,14,35
100,Fail,43,40,0,12,31
100,Fail,37,28,7,19,18
100,Fail,49,20,1,15,34
100,Fail,43,22,11,16,27
100,Fail,43,36,0,16,27
100,Fail,50,20,6,13,37
100,Fail,48,20,3,18,30
100,Fail,48,23,0,16,32
100,Fail,52,27,0,14,38
100,Fail,49,29,0,13,36
100,Fail,48,23,1,19,29
100,Fail,46,17,0,19,27
100,Fail,48,24,7,12,36
100,Fail,42,34,2,11,31
100,Fail,55,24,0,11,44
100,Fail,45,25,0,11,34
100,Fail,50,27,0,13,37
100,Fail,48,30,5,10,38
100,Fail,48,24,8,10,38
100,Fail,45,37,0,8,37
100,Fail,43,31,0,20,23
100,Fail,47,27,0,15,32
100,Fail,41,27,5,17,24
100,Fail,48,29,0,15,33
100,Fail,53,23,0,13,40
100,Fail,49,28,0,12,37
100,Fail,48,33,0,9,39
100,Fail,56,18,2,11,45
100,Fail,50,24,0,10,40
100,Fail,48,27,6,9,39
100,Fail,50,27,0,12,38
100,Fail,45,17,14,15,30
100,Fail,53,23,1,13,40
100,Fail,51,21,0,13,38
100,Fail,45,30,0,14,31
100,Fail,48,24,3,17,31
100,Fail,48,33,2,10,38
100,Fail,47,23,5,12,35
100,Fail,60,17,3,9,51
100,Fail,54,27,0,5,49
100,Fail,45,24,1,19,26
100,Fail,47,37,0,9,38
100,Fail,44,27,6,13,31
100,Fail,45,28,3,19,26
100,Fail,49,21,4,13,36
100,Fail,51,28,0,11,40
100,Fail,52,18,1,15,37
100,Fail,44,23,10,16,28
100,Fail,44,30,0,18,26
100,Fail,48,25,0,12,36
100,Fail,53,26,0,11,42
100,Fail,42,33,0,14,28
100,Fail,50,31,0,10,40
100,Fail,41,28,6,18,23
100,Fail,53,22,7,9,44
100,Fail,54,25,0,9,45
100,Fail,45,31,2,13,32
100,Fail,54,26,0,13,41
100,Fail,51,20,5,13,38
100,Fail,51,24,2,11,40
100,Fail,46,26,8,9,37
100,Fail,40,35,0,17,23
100,Fail,47,24,5,9,38
100,Fail,45,26,4,14,31
100,Fail,37,27,9,17,20
100,Fail,52,18,0,18,34
100,Fail,49,23,0,15,34
100,Fail,45,30,0,14,31
100,Fail,40,28,0,19,21
100,Fail,49,30,0,9,40
100,Fail,42,26,3,13,29
100,Fail,52,27,0,8,44
100,Fail,43,29,0,13,30
100,Fail,47,31,3,11,36
100,Fail,43,21,11,16,27
100,Fail,53,19,0,14,39
100,Fail,55,25,0,11,44
100,Fail,48,23,6,11,37
100,Fail,44,34,0,14,30
100,Fail,46,30,0,14,32
100,Fail,43,31,0,14,29
100,Fail,53,31,0,8,45
100,Fail,48,29,0,11,37
100,Fail,53,18,8,13,40
100,Fail,56,18,3,12,44
100,Fail,46,24,4,13,33
100,Fail,48,27,0,14,34
100,Fail,55,23,2,10,45
100,Fail,47,34,0,9,38
100,Fail,44,25,7,14,30
100,Fail,49,24,0,12,37
100,Fail,48,25,4,13,35
100,Fail,47,30,0,10,37
100,Fail,50,25,1,9,41
100,Fail,47,24,2,15,32
100,Fail,56,22,0,11,45
100,Fail,41,29,3,18,23
100,Fail,51,20,5,10,41
100,Fail,48,24,6,14,34
100,Fail,44,26,1,18,26
100,Fail,46,32,0,14,32
100,Fail,50,25,4,10,40
100,Fail,56,20,0,11,45
100,Fail,47,34,0,9,38
100,Fail,51,23,3,12,39
100,Fail,55,23,2,8,47
100,Fail,44,21,6,19,25
100,Fail,49,26,0,14,35
100,Fail,57,23,0,11,46
100,Fail,52,29,0,9,43
100,Fail,54,18,0,18,36
100,Fail,44,36,0,9,35
100,Fail,42,29,0,12,30
100,Fail,49,17,1,19,30
100,Fail,55,22,3,13,42
100,Fail,49,25,2,14,35
100,Fail,54,24,0,11,43
100,Fail,43,28,11,14,29
100,Fail,43,34,0,12,31
100,Fail,48,32,0,13,35
100,Fail,46,25,0,18,28
100,Fail,43,34,0,16,27
100,Fail,50,31,0,10,40
100,Fail,52,30,0,8,44
100,Fail,47,32,0,11,36
100,Fail,44,26,0,20,24
100,Fail,47,23,0,14,33
100,Fail,48,36,0,7,41
100,Fail,51,25,0,12,39
100,Fail,42,34,0,16,26
100,Fail,46,32,6,9,37
100,Fail,51,27,0,10,41
100,Fail,55,19,1,13,42
100,Fail,47,27,6,10,37
100,Fail,59,18,1,7,52
100,Fail,51,22,0,13,38
100,Fail,47,30,5,9,38
100,Fail,48,30,0,16,32
100,Fail,45,25,0,15,30
100,Fail,50,26,0,13,37
100,Fail,52,27,0,9,43
100,Fail,38,35,8,13,25
100,Fail,49,33,0,11,38
100,Fail,40,40,0,13,27
100,Fail,50,21,9,9,41
100,Fail,53,28,3,9,44
100,Fail,51,26,0,14,37
100,Fail,55,23,0,12,43
100,Fail,47,28,5,9,38
100,Fail,47,31,0,9,38
100,Fail,48,27,5,15,33
100,Fail,48,24,0,11,37
100,Fail,44,30,0,18,26
100,Fail,44,30,2,11,33
100,Fail,57,27,0,5,52
100,Fail,45,39,0,6,39
100,Fail,50,27,0,13,37
100,Fail,56,22,0,11,45
100,Fail,55,25,0,13,42
100,Fail,51,26,0,9,42
100,Fail,47,31,0,14,33
100,Fail,53,21,5,12,41
100,Fail,44,30,0,11,33
100,Fail,48,25,6,12,36
100,Fail,50,21,13,10,40
100,Fail,55,24,2,9,46
100,Fail,50,17,12,12,38
100,Fail,48,24,0,16,32
100,Fail,50,31,0,10,40
100,Fail,52,18,3,14,38
100,Fail,50,20,9,11,39
100,Fail,40,37,0,14,26
100,Fail,54,17,3,13,41
100,Fail,50,21,0,17,33
100,Fail,49,25,2,12,37
100,Fail,45,27,3,11,34
100,Fail,42,35,3,12,30
100,Fail,42,30,6,13,29
100,Fail,44,31,0,13,31
100,Fail,56,20,0,8,48
100,Fail,48,28,0,14,34
100,Fail,42,24,5,19,23
100,Fail,49,29,2,11,38
100,Fail,50,31,0,13,37
100,Fail,41,42,0,9,32
100,Fail,51,20,0,18,33
100,Fail,53,21,1,10,43
100,Fail,50,25,1,13,37
100,Fail,49,33,0,6,43
100,Fail,49,35,0,13,36
100,Fail,46,32,3,8,38
100,Fail,46,28,4,10,36
100,Fail,45,28,0,16,29
100,Fail,44,33,0,12,32
100,Fail,52,18,7,12,40
100,Fail,48,29,0,12,36
100,Fail,40,31,0,15,25
100,Fail,53,25,0,11,42
100,Fail,45,29,0,17,28
100,Fail,48,33,0,7,41
100,Fail,47,24,0,19,28
100,Fail,44,31,0,13,31
100,Fail,48,24,1,13,35
100,Fail,49,25,0,13,36
100,Fail,50,28,0,10,40
100,Fail,41,28,5,18,23
100,Fail,44,25,0,14,30
100,Fail,40,36,5,10,30
100,Fail,45,20,5,17,28
100,Fail,37,47,0,9,28
100,Fail,39,35,2,17,22
100,Fail,47,36,0,9,38
100,Fail,54,27,0,9,45
100,Fail,38,37,0,19,19
100,Fail,43,32,2,13,30
100,Fail,41,34,0,15,26
100,Fail,50,26,0,12,38
100,Fail,49,16,2,14,35
100,Fail,38,41,0,16,22
100,Fail,52,31,0,7,45
100,Fail,53,20,1,11,42
100,Fail,40,31,0,19,21
100,Fail,57,27,1,5,52
100,Fail,47,33,0,9,38
100,Fail,42,37,0,14,28
100,Fail,49,30,0,12,37
100,Fail,47,24,6,11,36
100,Fail,48,35,0,11,37
100,Fail,48,24,1,13,35
100,Fail,45,25,3,17,28
100,Fail,40,39,3,9,31
100,Fail,49,24,2,14,35
100,Fail,48,21,0,17,31
100,Fail,54,26,0,11,43
100,Fail,57,15,2,12,45
100,Fail,51,29,0,10,41
100,Fail,44,26,1,14,30
100,Fail,46,32,0,12,34
100,Fail,46,30,0,12,34
100,Fail,53,22,2,8,45
100,Fail,39,38,0,12,27
100,Fail,53,22,1,10,43
100,Fail,48,31,0,11,37
100,Fail,53,23,1,12,41
100,Fail,46,27,0,19,27
100,Fail,47,34,0,10,37
100,Fail,47,22,0,14,33
100,Fail,46,25,7,12,34
100,Fail,47,29,0,13,34
100,Fail,47,30,0,13,34
100,Fail,56,20,1,11,45
100,Fail,42,31,1,15,27
100,Fail,56,24,0,10,46
100,Fail,43,28,6,12,31
100,Fail,45,33,0,15,30
100,Fail,42,35,0,16,26
100,Fail,47,32,0,10,37
100,Fail,40,33,8,11,29
100,Fail,37,36,0,17,20
100,Fail,43,28,2,14,29
100,Fail,49,27,0,15,34
100,Fail,50,28,1,10,40
100,Fail,57,25,0,7,50
100,Fail,44,24,7,15,29
100,Fail,50,24,0,14,36
100,Fail,46,21,0,20,26
100,Fail,46,27,8,10,36
100,Fail,52,27,0,9,43
100,Fail,48,33,0,11,37
100,Fail,44,34,0,15,29
100,Fail,49,28,0,8,41
100,Fail,48,30,0,11,37
100,Fail,51,30,4,3,48
100,Fail,52,21,3,17,35
100,Fail,46,29,4,11,35
100,Fail,43,34,5,9,34
100,Fail,44,31,0,17,27
100,Fail,41,27,5,19,22
100,Fail,58,16,4,11,47
100,Fail,39,28,9,13,26
100,Fail,41,28,7,17,24
100,Fail,56,21,4,13,43
100,Fail,45,25,4,16,29
100,Fail,41,27,2,17,24
100,Fail,47,21,0,18,29
100,Fail,46,23,8,15,31
100,Fail,49,22,5,13,36
100,Fail,48,28,0,11,37
100,Fail,52,21,0,13,39
100,Fail,47,26,0,15,32
100,Fail,53,18,9,10,43
100,Fail,45,23,3,15,30
100,Fail,51,23,5,8,43
100,Fail,47,30,0,13,34
100,Fail,46,30,0,13,33
100,Fail,39,38,0,13,26
100,Fail,48,32,0,14,34
100,Fail,52,27,0,9,43
100,Fail,52,34,0,6,46
100,Fail,50,26,1,15,35
100,Fail,43,35,0,11,32
100,Fail,50,18,3,16,34
100,Fail,47,30,0,10,37
100,Fail,41,28,8,18,23
100,Fail,45,35,0,10,35
100,Fail,45,26,6,13,32
100,Fail,49,24,0,16,33
100,Fail,49,27,3,15,34
100,Fail,48,21,5,16,32
100,Fail,57,15,0,13,44
100,Fail,47,22,0,19,28
100,Fail,53,21,1,14,39
100,Fail,52,25,2,8,44
100,Fail,43,36,0,8,35
100,Fail,44,35,0,14,30
100,Fail,41,37,0,14,27
100,Fail,53,24,0,10,43
100,Fail,53,20,9,10,43
100,Fail,52,23,1,10,42
100,Fail,60,16,0,13,47
100,Fail,45,22,3,19,26
100,Fail,53,23,7,9,44
100,Fail,46,30,1,11,35
100,Fail,46,29,2,9,37
100,Fail,52,20,5,13,39
100,Fail,47,24,2,16,31
100,Fail,48,19,8,15,33
100,Fail,52,25,0,14,38
100,Fail,51,24,2,18,33
100,Fail,40,37,0,11,29
100,Fail,49,22,4,11,38
100,Fail,45,34,0,11,34
100,Fail,54,25,0,9,45
100,Fail,33,33,10,19,14
100,Fail,50,36,0,5,45
100,Fail,43,36,0,9,34
100,Fail,45,29,0,14,31
100,Fail,43,31,1,16,27
100,Fail,49,21,0,19,30
100,Fail,47,23,3,15,32
100,Fail,44,30,2,13,31
100,Fail,45,28,0,16,29
100,Fail,48,35,0,9,39
100,Fail,41,32,10,10,31
100,Fail,54,24,0,8,46
100,Fail,50,19,7,13,37
100,Fail,54,21,5,11,43
100,Fail,47,36,0,8,39
100,Fail,47,28,1,13,34
100,Fail,39,40,0,13,26
100,Fail,49,23,3,15,34
100,Fail,59,17,0,12,47
100,Fail,47,26,4,17,30
100,Fail,42,28,0,15,27
100,Fail,50,18,2,18,32
100,Fail,46,25,4,15,31
100,Fail,44,28,9,13,31
100,Fail,47,18,1,21,26
100,Fail,50,20,3,14,36
100,Fail,56,21,1,7,49
100,Fail,53,25,3,9,44
100,Fail,58,23,0,10,48
100,Fail,46,24,5,14,32
100,Fail,49,32,0,5,44
100,Fail,42,31,5,13,29
100,Fail,53,25,0,9,44
100,Fail,43,27,0,20,23
100,Fail,45,33,0,15,30
100,Fail,51,23,4,10,41
100,Fail,48,24,7,13,35
100,Fail,51,28,0,10,41
100,Fail,50,25,6,9,41
100,Fail,47,33,0,13,34
100,Fail,43,29,0,15,28
100,Fail,56,19,2,10,46
100,Fail,59,23,0,8,51
100,Fail,59,22,1,7,52
100,Fail,48,31,0,12,36
100,Fail,41,31,8,13,28
100,Fail,46,30,1,14,32
100,Fail,56,19,0,11,45
100,Fail,48,30,0,11,37
100,Fail,47,24,0,18,29
100,Fail,49,26,3,12,37
100,Fail,47,28,6,10,37
100,Fail,56,21,0,12,44
100,Fail,48,29,5,11,37
100,Fail,53,25,0,9,44
100,Fail,42,39,0,12,30
100,Fail,45,28,1,12,33
100,Fail,53,23,0,14,39
100,Fail,50,18,3,15,35
100,Fail,52,27,0,11,41
100,Fail,44,26,10,12,32
100,Fail,52,18,5,17,35
100,Fail,57,25,0,8,49
100,Fail,52,26,0,3,49
100,Fail,46,39,0,7,39
100,Fail,54,23,0,12,42
100,Fail,41,32,0,19,22
100,Fail,50,29,0,14,36
100,Fail,44,35,0,12,32
100,Fail,48,25,1,15,33
100,Fail,52,23,6,12,40
100,Fail,48,32,0,10,38
100,Fail,50,30,0,8,42
100,Fail,45,24,0,20,25
100,Fail,44,30,2,11,33
100,Fail,45,29,0,17,28
100,Fail,46,31,7,7,39
100,Fail,37,41,0,15,22
100,Fail,50,29,0,11,39
100,Fail,52,29,0,8,44
100,Fail,41,36,0,15,26
100,Fail,48,24,6,11,37
100,Fail,40,30,7,17,23
100,Fail,52,28,0,11,41
100,Fail,51,20,6,10,41
100,Fail,45,23,6,15,30
100,Fail,49,37,0,8,41
100,Fail,47,30,0,15,32
100,Fail,41,35,3,9,32
100,Fail,41,36,0,14,27
100,Fail,61,18,0,9,52
100,Fail,43,32,0,12,31
100,Fail,47,26,6,12,35
100,Fail,48,34,0,11,37
100,Fail,57,18,1,12,45
100,Fail,48,33,0,9,39
100,Fail,46,36,0,12,34
100,Fail,45,25,0,15,30
100,Fail,46,29,0,14,32
100,Fail,51,24,3,14,37
100,Fail,51,22,3,13,38
100,Fail,53,25,8,10,43
100,Fail,50,26,0,14,36
100,Fail,52,25,2,8,44
100,Fail,42,33,3,10,32
100,Fail,43,30,6,10,33
100,Fail,49,24,0,15,34
100,Fail,48,28,0,10,38
100,Fail,47,28,4,15,32
100,Fail,43,34,0,15,28
100,Fail,45,24,0,19,26
100,Fail,48,21,0,16,32
100,Fail,42,30,4,13,29
100,Fail,47,32,0,12,35
100,Fail,44,27,0,17,27
100,Fail,51,27,8,8,43
100,Fail,43,33,0,11,32
100,Fail,49,26,0,12,37
100,Fail,44,35,0,17,27
100,Fail,50,27,0,12,38
100,Fail,54,18,11,12,42
100,Fail,57,19,4,11,46
100,Fail,54,28,0,9,45
100,Fail,47,31,0,9,38
100,Fail,53,22,4,10,43
100,Fail,45,28,2,11,34
100,Fail,43,34,6,9,34
100,Fail,49,33,0,7,42
100,Fail,49,24,6,11,38
100,Fail,52,30,2,7,45
100,Fail,45,22,6,16,29
100,Fail,59,19,0,13,46
100,Fail,42,31,2,17,25
100,Fail,48,26,0,13,35
100,Fail,50,31,0,9,41
100,Fail,41,21,4,21,20
100,Fail,47,29,0,12,35
100,Fail,57,19,0,12,45
100,Fail,46,31,0,14,32
100,Fail,49,32,0,7,42
100,Fail,47,29,0,13,34
100,Fail,39,32,1,16,23
100,Fail,54,16,5,11,43
100,Fail,50,22,7,10,40
100,Fail,51,30,0,6,45
100,Fail,49,31,0,9,40
100,Fail,49,23,0,16,33
100,Fail,46,23,2,18,28
100,Fail,47,31,1,9,38
100,Fail,50,30,0,11,39
100,Fail,48,33,0,14,34
100,Fail,50,25,0,14,36
100,Fail,41,28,2,19,22
100,Fail,58,21,0,5,53
100,Fail,46,23,0,20,26
100,Fail,45,30,1,11,34
100,Fail,51,21,9,9,42
100,Fail,44,23,5,18,26
100,Fail,42,38,0,10,32
100,Fail,57,22,3,8,49
100,Fail,48,24,9,9,39
100,Fail,52,26,3,9,43
100,Fail,52,23,6,13,39
100,Fail,51,27,2,10,41
100,Fail,52,25,0,13,39
100,Fail,51,22,2,9,42
100,Fail,49,21,4,13,36
100,Fail,52,20,0,17,35
100,Fail,45,30,0,15,30
100,Fail,47,28,0,15,32
100,Fail,41,36,0,13,28
100,Fail,44,29,0,15,29
100,Fail,44,26,0,16,28
100,Fail,45,31,0,16,29
100,Fail,40,30,0,19,21
100,Fail,50,27,6,8,42
100,Fail,52,26,0,7,45
100,Fail,45,28,0,20,25
100,Fail,58,25,0,9,49
100,Fail,44,27,0,16,28
100,Fail,51,32,0,7,44
100,Fail,57,21,0,10,47
100,Fail,57,15,0,9,48
100,Fail,48,27,0,10,38
100,Fail,42,33,0,16,26
100,Fail,39,29,8,16,23
100,Fail,60,16,1,9,51
100,Fail,50,22,1,12,38
100,Fail,51,25,0,12,39
100,Fail,38,25,1,23,15
100,Fail,49,30,0,8,41
100,Fail,41,38,0,11,30
100,Fail,46,30,0,13,33
100,Fail,49,21,0,19,30
100,Fail,52,26,7,6,46
100,Fail,47,26,0,13,34
100,Fail,49,30,2,8,41
100,Fail,49,27,4,9,40
100,Fail,53,20,0,15,38
100,Fail,52,22,0,12,40
100,Fail,41,33,0,15,26
100,Fail,49,24,0,14,35
100,Fail,44,38,0,10,34
100,Fail,46,26,0,16,30
100,Fail,38,38,0,16,22
100,Fail,45,23,5,15,30
100,Fail,45,33,2,11,34
100,Fail,50,31,0,9,41
100,Fail,50,31,2,7,43
100,Fail,46,23,2,16,30
100,Fail,46,29,0,14,32
100,Fail,47,24,0,18,29
100,Fail,51,22,3,13,38
100,Fail,49,31,0,9,40
100,Fail,46,28,0,14,32
100,Fail,48,22,5,8,40
100,Fail,46,39,2,6,40
100,Fail,52,29,0,13,39
100,Fail,55,27,0,9,46
100,Fail,50,27,1,5,45
100,Fail,51,23,0,12,39
100,Fail,61,19,0,7,54
100,Fail,49,29,0,11,38
100,Fail,55,27,1,5,50
100,Fail,52,22,0,13,39
100,Fail,44,27,1,16,28
100,Fail,58,19,3,10,48
100,Fail,49,21,3,16,33
100,Fail,52,23,0,14,38
100,Fail,55,23,0,13,42
100,Fail,45,30,0,13,32
100,Fail,58,16,0,12,46
100,Fail,43,31,2,9,34
100,Fail,47,31,0,10,37
100,Fail,48,34,0,11,37
100,Fail,56,20,0,12,44
100,Fail,40,25,6,19,21
100,Fail,41,34,0,11,30
100,Fail,51,26,6,10,41
100,Fail,50,29,0,12,38
100,Fail,52,16,11,14,38
100,Fail,47,26,0,16,31
100,Fail,41,33,0,16,25
100,Fail,56,21,1,11,45
100,Fail,49,19,3,14,35
100,Fail,45,30,0,14,31
100,Fail,45,26,4,12,33
100,Fail,45,26,3,15,30
100,Fail,48,28,0,15,33
100,Fail,50,20,8,13,37
100,Fail,55,29,0,7,48
100,Fail,53,20,0,12,41
100,Fail,49,30,0,9,40
100,Fail,49,31,0,12,37
100,Fail,44,32,0,12,32
100,Fail,41,35,0,15,26
100,Fail,48,31,0,13,35
100,Fail,51,22,0,15,36
100,Fail,42,37,0,14,28
100,Fail,52,24,0,12,40
100,Fail,44,34,2,9,35
100,Fail,37,35,0,19,18
100,Fail,45,30,0,13,32
100,Fail,53,20,0,16,37
100,Fail,48,28,1,14,34
100,Fail,49,23,2,15,34
100,Fail,48,28,2,11,37
100,Fail,54,24,0,8,46
100,Fail,44,32,0,13,31
100,Fail,54,20,4,10,44
100,Fail,41,32,0,17,24
100,Fail,42,22,3,20,22
100,Fail,48,24,6,14,34
100,Fail,56,21,1,7,49
100,Fail,45,31,0,11,34
100,Fail,46,38,0,9,37
100,Fail,53,21,5,9,44
100,Fail,48,31,0,13,35
100,Fail,54,22,3,11,43
100,Fail,51,24,0,12,39
100,Fail,54,14,0,18,36
100,Fail,57,19,0,12,45
100,Fail,44,28,0,16,28
100,Fail,47,26,2,12,35
100,Fail,47,28,0,13,34
100,Fail,47,30,0,11,36
100,Fail,48,24,0,20,28
100,Fail,56,24,0,7,49
100,Fail,48,22,2,19,29
100,Fail,42,24,5,20,22
100,Fail,48,26,0,14,34
100,Fail,51,32,0,5,46
100,Fail,49,25,1,10,39
100,Fail,52,23,0,13,39
100,Fail,48,24,0,13,35
100,Fail,42,21,12,14,28
100,Fail,45,28,2,14,31
100,Fail,47,28,3,11,36
100,Fail,51,24,6,11,40
100,Fail,53,23,1,13,40
100,Fail,48,25,1,14,34
100,Fail,45,29,5,14,31
100,Fail,55,25,0,7,48
100,Fail,50,26,0,15,35
100,Fail,45,24,0,14,31
100,Fail,47,34,0,10,37
100,Fail,50,27,0,14,36
100,Fail,47,27,5,13,34
100,Fail,47,35,0,9,38
100,Fail,48,27,0,16,32
100,Fail,41,32,5,12,29
100,Fail,57,19,0,12,45
100,Fail,51,29,0,8,43
100,Fail,39,36,0,16,23
100,Fail,48,28,0,13,35
100,Fail,50,27,0,14,36
100,Fail,54,20,1,10,44
100,Fail,48,24,0,17,31
100,Fail,49,31,7,8,41
100,Fail,45,24,0,20,25
100,Fail,45,35,0,14,31
100,Fail,43,21,9,16,27
100,Fail,50,25,0,13,37
100,Fail,43,32,0,14,29
100,Fail,57,24,0,10,47
100,Fail,51,21,3,13,38
100,Fail,48,21,4,15,33
100,Fail,39,22,1,23,16
100,Fail,41,26,9,15,26
100,Fail,55,22,0,14,41
100,Fail,46,20,5,19,27
100,Fail,47,22,9,8,39
100,Fail,46,29,0,12,34
100,Fail,49,30,0,9,40
100,Fail,53,19,2,16,37
100,Fail,51,23,0,13,38
100,Fail,53,20,3,13,40
100,Fail,48,30,0,10,38
100,Fail,49,31,4,6,43
100,Fail,42,32,3,15,27
100,Fail,48,26,6,15,33
100,Fail,41,35,6,8,33
100,Fail,50,26,1,11,39
100,Fail,44,31,0,13,31
100,Fail,48,25,4,16,32
100,Fail,52,23,0,15,37
100,Fail,43,38,0,13,30
100,Fail,50,26,2,10,40
100,Fail,45,31,0,16,29
100,Fail,43,31,0,12,31
100,Fail,43,26,8,17,26
100,Fail,48,32,0,7,41
100,Fail,54,24,0,12,42
100,Fail,50,22,0,16,34
100,Fail,49,25,4,12,37
100,Fail,44,28,0,17,27
100,Fail,44,33,0,10,34
100,Fail,50,30,0,8,42
100,Fail,53,25,2,11,42
100,Fail,46,27,2,17,29
100,Fail,46,28,7,12,34
100,Fail,46,29,4,11,35
100,Fail,52,23,2,11,41
100,Fail,47,20,3,15,32
100,Fail,48,28,0,11,37
100,Fail,51,21,5,16,35
100,Fail,43,39,0,8,35
100,Fail,38,35,1,17,21
100,Fail,54,23,3,8,46
100,Fail,49,33,0,6,43
100,Fail,45,29,8,10,35
100,Fail,58,19,1,7,51
100,Fail,41,26,5,17,24
100,Fail,47,32,0,13,34
100,Fail,46,26,2,18,28
100,Fail,45,25,8,14,31
100,Fail,54,23,1,11,43
100,Fail,48,27,0,13,35
100,Fail,44,28,0,13,31
100,Fail,46,29,2,11,35
100,Fail,53,21,0,13,40
100,Fail,48,26,13,8,40
100,Fail,53,26,0,15,38
100,Fail,48,27,0,16,32
100,Fail,46,26,1,14,32
100,Fail,47,27,0,17,30
100,Fail,54,25,4,9,45
100,Fail,48,32,0,9,39
100,Fail,48,22,9,12,36
100,Fail,55,26,3,5,50
100,Fail,44,30,0,15,29
100,Fail,49,25,0,13,36
100,Fail,48,26,7,9,39
100,Fail,44,35,0,13,31
100,Fail,47,34,0,11,36
100,Fail,52,23,0,16,36
100,Fail,55,14,11,9,46
100,Fail,49,30,2,9,40
100,Fail,48,23,1,15,33
100,Fail,58,18,1,11,47
100,Fail,52,20,0,18,34
100,Fail,50,23,0,13,37
100,Fail,52,31,0,9,43
100,Fail,59,18,0,10,49
100,Fail,48,26,0,8,40
100,Fail,47,27,11,8,39
100,Fail,50,23,0,14,36
100,Fail,49,25,0,16,33
100,Fail,51,27,3,8,43
100,Fail,45,27,0,15,30
100,Fail,47,31,0,13,34
100,Fail,55,25,0,8,47
100,Fail,48,27,4,11,37
100,Fail,43,34,0,13,30
100,Fail,48,21,4,17,31
100,Fail,41,29,8,13,28
100,Fail,41,40,0,13,28
100,Fail,55,15,3,15,40
100,Fail,54,28,2,10,44
100,Fail,48,22,6,12,36
100,Fail,49,26,7,6,43
100,Fail,43,34,0,12,31
100,Fail,54,22,7,10,44
100,Fail,49,21,2,18,31
100,Fail,50,28,5,9,41
100,Fail,48,24,0,14,34
100,Fail,42,27,3,17,25
100,Fail,37,26,15,14,23
100,Fail,55,19,1,11,44
100,Fail,50,20,5,12,38
100,Fail,55,23,0,10,45
100,Fail,42,27,9,14,28
100,Fail,47,26,0,14,33
100,Fail,44,27,4,14,30
100,Fail,45,30,0,16,29
100,Fail,46,28,6,9,37
100,Fail,55,22,0,10,45
100,Fail,54,25,3,5,49
100,Fail,58,25,0,5,53
100,Fail,48,20,5,17,31
100,Fail,48,28,3,15,33
100,Fail,48,30,0,12,36
100,Fail,45,31,1,13,32
100,Fail,59,22,1,7,52
100,Fail,44,35,0,11,33
100,Fail,51,30,0,11,40
100,Fail,50,34,0,8,42
100,Fail,46,24,7,14,32
100,Fail,46,27,0,17,29
100,Fail,50,24,2,10,40
100,Fail,53,22,1,14,39
100,Fail,53,26,3,9,44
100,Fail,51,23,0,16,35
100,Fail,56,24,0,8,48
100,Fail,48,29,0,10,38
100,Fail,45,29,2,11,34
100,Fail,48,27,0,14,34
100,Fail,51,28,0,10,41
100,Fail,49,24,0,19,30
100,Fail,46,33,0,9,37
100,Fail,51,25,1,9,42
100,Fail,46,33,0,14,32
100,Fail,54,20,0,16,38
100,Fail,42,37,0,15,27
100,Fail,54,22,7,10,44
100,Fail,48,27,4,10,38
100,Fail,55,24,0,11,44
100,Fail,46,25,0,17,29
100,Fail,42,27,4,16,26
100,Fail,47,28,4,9,38
100,Fail,43,30,0,18,25
100,Fail,44,27,1,13,31
100,Fail,49,29,0,10,39
100,Fail,46,33,0,12,34
100,Fail,42,31,0,15,27
100,Fail,44,34,0,13,31
100,Fail,57,25,1,10,47
100,Fail,40,40,0,10,30
100,Fail,50,20,1,15,35
100,Fail,40,36,2,12,28
100,Fail,52,27,0,12,40
100,Fail,50,26,0,14,36
100,Fail,47,25,0,15,32
100,Fail,45,36,0,10,35
100,Fail,40,33,5,14,26
100,Fail,47,33,0,12,35
100,Fail,48,27,7,10,38
100,Fail,43,41,0,10,33
100,Fail,47,29,1,11,36
100,Fail,40,28,4,17,23
100,Fail,52,29,3,7,45
100,Fail,53,21,0,12,41
100,Fail,50,22,7,12,38
100,Fail,47,28,2,9,38
100,Fail,46,28,0,13,33
100,Fail,46,26,0,15,31
100,Fail,46,31,3,10,36
100,Fail,51,24,0,15,36
100,Fail,41,27,10,18,23
100,Fail,44,26,6,14,30
100,Fail,43,32,0,10,33
100,Fail,49,34,0,7,42
100,Fail,48,24,8,10,38
100,Fail,52,24,0,12,40
100,Fail,43,26,0,17,26
100,Fail,50,26,0,13,37
100,Fail,43,39,0,8,35
100,Fail,53,23,2,13,40
100,Fail,36,41,0,14,22
100,Fail,54,25,0,10,44
100,Fail,47,21,4,16,31
100,Fail,52,27,5,9,43
100,Fail,56,18,0,16,40
100,Fail,53,26,0,10,43
100,Fail,52,25,1,13,39
100,Fail,47,28,1,13,34
100,Fail,45,30,0,14,31
100,Fail,47,30,0,13,34
100,Fail,41,32,0,13,28
100,Fail,40,34,0,16,24
100,Fail,40,29,0,17,23
100,Fail,54,26,0,8,46
100,Fail,44,32,0,11,33
100,Fail,48,28,3,12,36
100,Fail,54,18,11,10,44
100,Fail,49,30,0,14,35
100,Fail,52,27,1,10,42
100,Fail,50,26,2,9,41
100,Fail,43,29,3,16,27
100,Fail,45,25,4,14,31
100,Fail,45,28,0,12,33
100,Fail,52,21,1,13,39
100,Fail,51,24,6,11,40
100,Fail,49,21,0,14,35
100,Fail,48,29,0,11,37
100,Fail,51,30,0,7,44
100,Fail,47,23,6,11,36
100,Fail,48,21,0,15,33
100,Fail,39,40,0,13,26
100,Fail,50,28,0,14,36
100,Fail,49,28,0,12,37
100,Fail,48,20,5,17,31
100,Fail,43,34,0,11,32
100,Fail,50,31,0,10,40
100,Fail,55,24,1,10,45
100,Fail,52,25,0,14,38
100,Fail,48,30,0,10,38
100,Fail,46,25,5,11,35
100,Fail,54,20,0,12,42
100,Fail,57,20,0,10,47
100,Fail,46,29,0,13,33
100,Fail,51,20,7,13,38
100,Fail,47,34,0,7,40
100,Fail,55,21,2,13,42
100,Fail,57,22,0,9,48
100,Fail,46,36,0,8,38
100,Fail,46,34,0,9,37
100,Fail,45,32,0,13,32
100,Fail,51,26,0,14,37
100,Fail,53,22,0,15,38
100,Fail,48,33,0,9,39
100,Fail,55,30,0,7,48
100,Fail,44,23,5,17,27
100,Fail,48,25,10,10,38
100,Fail,52,29,0,10,42
100,Fail,45,24,2,16,29
100,Fail,58,15,0,12,46
100,Fail,47,33,0,10,37
100,Fail,50,22,3,15,35
100,Fail,55,26,0,8,47
100,Fail,47,29,0,15,32
100,Fail,49,30,0,13,36
100,Fail,47,28,3,12,35
100,Fail,43,29,0,16,27
100,Fail,47,22,1,17,30
100,Fail,47,37,0,8,39
100,Fail,48,28,5,10,38
100,Fail,51,32,0,7,44
100,Fail,42,25,10,11,31
100,Fail,39,31,0,21,18
100,Fail,41,39,0,18,23
100,Fail,48,25,0,15,33
100,Fail,48,21,8,12,36
100,Fail,60,13,6,12,48
100,Fail,54,20,3,14,40
100,Fail,46,32,0,15,31
100,Fail,50,28,0,12,38
100,Fail,49,30,0,11,38
100,Fail,51,19,4,17,34
100,Fail,46,30,5,9,37
100,Fail,46,29,0,16,30
100,Fail,51,27,0,12,39
100,Fail,45,31,0,10,35
100,Fail,48,28,0,10,38
100,Fail,43,37,0,13,30
100,Fail,52,22,0,11,41
100,Fail,40,34,0,15,25
100,Fail,45,33,0,15,30
100,Fail,52,24,1,12,40
100,Fail,42,38,4,9,33
100,Fail,53,26,0,11,42
100,Fail,50,25,0,11,39
100,Fail,50,25,2,14,36
100,Fail,45,27,0,18,27
100,Fail,44,31,0,15,29
100,Fail,53,27,0,13,40
100,Fail,57,27,0,10,47
100,Fail,56,26,0,8,48
100,Fail,43,30,0,16,27
100,Fail,43,27,0,19,24
100,Fail,46,27,4,10,36
100,Fail,57,23,0,10,47
100,Fail,56,23,1,6,50
100,Fail,43,31,8,10,33
100,Fail,51,27,0,9,42
100,Fail,47,23,0,20,27
100,Fail,41,23,11,18,23
100,Fail,50,32,0,10,40
100,Fail,37,24,2,26,11
100,Fail,56,20,5,12,44
100,Fail,47,31,0,14,33
100,Fail,57,22,0,12,45
100,Fail,51,22,3,11,40
100,Fail,60,17,0,9,51
100,Fail,44,27,2,16,28
100,Fail,46,22,6,16,30
100,Fail,46,31,0,12,34
100,Fail,47,31,0,14,33
100,Fail,54,20,2,10,44
100,Fail,49,28,0,9,40
100,Fail,57,19,1,10,47
100,Fail,47,19,6,18,29
100,Fail,55,19,7,12,43
100,Fail,59,16,5,11,48
100,Fail,46,24,0,18,28
100,Fail,52,30,0,12,40
100,Fail,48,27,0,10,38
100,Fail,49,25,8,9,40
100,Fail,41,40,0,11,30
100,Fail,47,27,3,15,32
100,Fail,54,27,2,9,45
100,Fail,50,25,0,9,41
100,Fail,41,35,0,15,26
100,Fail,52,23,3,12,40
100,Fail,43,27,4,18,25
100,Fail,54,21,0,11,43
100,Fail,44,19,13,16,28
100,Fail,48,26,8,10,38
100,Fail,50,26,0,14,36
100,Fail,47,20,2,19,28
100,Fail,42,35,0,13,29
100,Fail,57,27,0,6,51
100,Fail,50,27,2,13,37
100,Fail,49,24,3,10,39
100,Fail,56,25,4,6,50
100,Fail,54,18,0,14,40
100,Fail,47,25,0,16,31
100,Fail,48,35,0,14,34
100,Fail,42,34,0,15,27
100,Fail,51,24,5,10,41
100,Fail,36,29,11,15,21
100,Fail,48,22,6,12,36
100,Fail,56,23,0,7,49
100,Fail,50,26,4,11,39
100,Fail,50,21,0,15,35
100,Fail,50,22,1,14,36
100,Fail,41,28,12,12,29
100,Fail,48,23,3,11,37
100,Fail,52,23,0,17,35
100,Fail,43,35,0,8,35
100,Fail,50,26,6,9,41
100,Fail,49,24,6,8,41
100,Fail,44,29,0,18,26
100,Fail,51,25,0,11,40
100,Fail,52,23,0,14,38
100,Fail,47,31,0,11,36
100,Fail,51,24,0,15,36
100,Fail,45,29,2,16,29
100,Fail,53,23,0,13,40
100,Fail,51,26,2,14,37
100,Fail,42,35,0,15,27
100,Fail,48,21,0,14,34
100,Fail,47,27,0,12,35
100,Fail,53,22,0,14,39
100,Fail,43,35,0,18,25
100,Fail,42,36,4,7,35
100,Fail,47,29,0,12,35
100,Fail,43,36,0,14,29
100,Fail,40,37,0,16,24
100,Fail,43,29,1,16,27
100,Fail,46,27,3,13,33
100,Fail,46,30,0,10,36
100,Fail,42,33,0,15,27
100,Fail,53,23,2,12,41
100,Fail,44,23,5,17,27
100,Fail,54,24,0,10,44
100,Fail,42,36,0,10,32
100,Fail,49,26,7,12,37
100,Fail,49,26,1,12,37
100,Fail,44,27,2,14,30
100,Fail,41,36,0,15,26
100,Fail,52,26,0,13,39
100,Fail,43,40,0,9,34
100,Fail,51,24,6,8,43
100,Fail,48,32,0,6,42
100,Fail,46,28,2,10,36
100,Fail,45,39,0,5,40
100,Fail,55,24,3,9,46
100,Fail,49,21,4,15,34
100,Fail,45,27,1,14,31
100,Fail,49,27,0,14,35
100,Fail,46,29,0,13,33
100,Fail,46,23,8,14,32
100,Fail,49,24,4,14,35
100,Fail,51,28,0,10,41
100,Fail,54,17,7,11,43
100,Fail,44,28,3,16,28
100,Fail,53,23,0,15,38
100,Fail,38,41,0,15,23
100,Fail,38,40,0,13,25
100,Fail,42,33,0,10,32
100,Fail,44,34,0,15,29
100,Fail,50,21,2,17,33
100,Fail,53,25,1,9,44
100,Fail,46,37,0,8,38
100,Fail,43,24,3,18,25
100,Fail,49,23,6,12,37
100,Fail,58,17,4,12,46
100,Fail,41,33,3,15,26
100,Fail,54,18,0,14,40
100,Fail,35,34,0,17,18
100,Fail,43,38,7,7,36
100,Fail,51,29,0,10,41
100,Fail,48,24,5,13,35
100,Fail,55,28,0,6,49
100,Fail,54,24,3,9,45
100,Fail,45,28,0,18,27
100,Fail,50,29,2,6,44
100,Fail,47,29,0,13,34
100,Fail,53,24,0,12,41
100,Fail,51,24,0,14,37
100,Fail,44,33,1,11,33
100,Fail,48,21,6,13,35
100,Fail,47,21,0,17,30
100,Fail,52,26,0,11,41
100,Fail,51,21,11,9,42
100,Fail,54,23,2,9,45
100,Fail,52,22,3,16,36
100,Fail,51,26,0,15,36
100,Fail,47,28,0,13,34
100,Fail,51,27,0,13,38
100,Fail,48,34,0,9,39
100,Fail,45,31,2,10,35
100,Fail,45,26,2,16,29
100,Fail,46,25,9,9,37
100,Fail,45,33,0,12,33
100,Fail,47,35,0,10,37
100,Fail,44,27,6,15,29
100,Fail,45,31,0,13,32
100,Fail,51,24,0,11,40
100,Fail,50,23,7,12,38
100,Fail,43,37,0,13,30
100,Fail,51,24,0,8,43
100,Fail,55,26,1,6,49
100,Fail,53,25,4,10,43
100,Fail,45,25,5,14,31
100,Fail,58,15,1,11,47
100,Fail,43,33,6,10,33
100,Fail,44,26,0,20,24
100,Fail,38,36,4,13,25
100,Fail,42,35,0,11,31
100,Fail,48,33,0,7,41
100,Fail,51,28,0,11,40
100,Fail,50,26,0,13,37
100,Fail,46,32,6,9,37
100,Fail,47,29,0,14,33
100,Fail,57,22,1,9,48
100,Fail,43,32,0,14,29
100,Fail,50,18,7,16,34
100,Fail,52,25,2,12,40
100,Fail,54,22,0,10,44
100,Fail,51,22,5,12,39
100,Fail,52,21,0,12,40
100,Fail,52,35,0,8,44
100,Fail,55,23,9,8,47
100,Fail,51,20,2,14,37
100,Fail,41,26,4,20,21
100,Fail,43,33,4,10,33
100,Fail,48,29,0,14,34
100,Fail,51,24,7,10,41
100,Fail,49,25,0,16,33
100,Fail,40,25,10,16,24
100,Fail,44,28,3,16,28
100,Fail,50,24,0,14,36
100,Fail,40,37,0,13,27
100,Fail,53,21,0,13,40
100,Fail,46,27,1,15,31
100,Fail,47,28,0,12,35
100,Fail,42,35,7,9,33
100,Fail,43,31,0,17,26
100,Fail,49,27,0,13,36
100,Fail,49,29,0,13,36
100,Fail,54,25,0,8,46
100,Fail,50,26,0,13,37
100,Fail,46,27,1,13,33
100,Fail,54,24,1,8,46
100,Fail,40,40,0,17,23
100,Fail,53,24,0,10,43
100,Fail,49,18,12,9,40
100,Fail,47,26,13,10,37
100,Fail,56,19,1,7,49
100,Fail,48,25,0,14,34
100,Fail,52,24,0,15,37
100,Fail,45,27,10,7,38
100,Fail,54,26,7,8,46
100,Fail,39,32,1,16,23
100,Fail,45,28,0,14,31
100,Fail,44,29,0,14,30
100,Fail,47,28,3,13,34
100,Fail,51,23,0,16,35
100,Fail,50,22,2,14,36
100,Fail,53,17,0,18,35
100,Fail,49,21,2,15,34
100,Fail,44,32,4,9,35
100,Fail,46,32,5,9,37
100,Fail,46,25,4,14,32
100,Fail,50,24,8,12,38
100,Fail,50,24,6,13,37
100,Fail,48,29,4,8,40
100,Fail,53,27,0,11,42
100,Fail,49,29,0,14,35
100,Fail,43,36,0,9,34
100,Fail,53,22,0,11,42
100,Fail,49,24,4,13,36
100,Fail,49,21,0,12,37
100,Fail,42,28,2,18,24
100,Fail,46,27,3,11,35
100,Fail,51,22,0,18,33
100,Fail,52,26,0,9,43
100,Fail,50,22,5,14,36
100,Fail,53,26,0,12,41
100,Fail,56,20,1,9,47
100,Fail,50,23,0,16,34
100,Fail,58,21,2,9,49
100,Fail,50,33,0,11,39
100,Fail,45,33,0,11,34
100,Fail,53,22,3,8,45
100,Fail,54,24,0,13,41
100,Fail,41,35,0,15,26
100,Fail,47,31,0,12,35
100,Fail,46,32,0,15,31
100,Fail,44,24,5,16,28
100,Fail,49,21,7,13,36
100,Fail,46,19,2,18,28
100,Fail,47,30,0,11,36
100,Fail,46,30,0,12,34
100,Fail,57,16,3,10,47
100,Fail,56,18,3,16,40
100,Fail,46,33,0,15,31
100,Fail,45,28,0,19,26
100,Fail,55,24,0,11,44
100,Fail,54,22,1,9,45
100,Fail,44,27,7,13,31
100,Fail,48,26,5,12,36
100,Fail,48,22,2,14,34
100,Fail,52,28,0,11,41
100,Fail,54,20,3,13,41
100,Fail,43,24,10,14,29
100,Fail,53,24,0,9,44
100,Fail,39,37,0,15,24
100,Fail,42,25,2,19,23
100,Fail,41,32,2,15,26
100,Fail,46,29,0,15,31
100,Fail,38,33,0,17,21
100,Fail,46,28,4,12,34
100,Fail,47,23,0,17,30
100,Fail,40,35,3,15,25
100,Fail,46,28,7,9,37
100,Fail,54,31,0,6,48
100,Fail,49,32,0,9,40
100,Fail,47,34,0,10,37
100,Fail,51,27,0,10,41
100,Fail,42,32,0,15,27
100,Fail,43,28,0,15,28
100,Fail,44,33,0,18,26
100,Fail,52,29,0,9,43
100,Fail,48,24,0,18,30
100,Fail,54,28,0,8,46
100,Fail,57,21,2,13,44
100,Fail,45,24,0,18,27
100,Fail,50,20,1,15,35
100,Fail,47,22,5,13,34
100,Fail,56,21,2,7,49
100,Fail,47,30,0,13,34
100,Fail,44,36,0,14,30
100,Fail,51,26,0,11,40
100,Fail,59,23,0,7,52
100,Fail,53,27,1,8,45
100,Fail,43,31,0,17,26
100,Fail,42,41,0,11,31
100,Fail,41,30,3,16,25
100,Fail,51,25,4,9,42
100,Fail,48,22,0,14,34
100,Fail,50,28,0,11,39
100,Fail,41,38,0,11,30
100,Fail,57,21,0,9,48
100,Fail,56,13,0,17,39
100,Fail,52,28,0,11,41
100,Fail,46,27,10,8,38
100,Fail,43,30,0,20,23
100,Fail,53,25,0,12,41
100,Fail,53,22,1,15,38
100,Fail,43,33,0,16,27
100,Fail,50,21,0,11,39
100,Fail,46,22,0,20,26
100,Fail,49,34,0,15,34
100,Fail,54,19,0,12,42
100,Fail,44,32,0,15,29
100,Fail,40,32,0,17,23
100,Fail,44,28,0,15,29
100,Fail,49,31,0,12,37
100,Fail,46,31,0,12,34
100,Fail,38,34,1,15,23
100,Fail,48,24,8,11,37
100,Fail,41,28,3,18,23
100,Fail,46,37,0,9,37
100,Fail,50,18,0,17,33
100,Fail,50,24,4,16,34
100,Fail,47,30,0,12,35
100,Fail,48,28,0,13,35
100,Fail,43,34,2,12,31
100,Fail,50,25,0,13,37
100,Fail,60,22,0,8,52
100,Fail,49,26,0,12,37
100,Fail,54,22,0,8,46
100,Fail,46,24,1,17,29
100,Fail,48,24,0,15,33
100,Fail,49,29,1,13,36
100,Fail,42,37,0,11,31
100,Fail,49,21,5,13,36
100,Fail,47,28,0,14,33
100,Fail,55,23,0,9,46
100,Fail,48,28,5,11,37
100,Fail,48,24,1,14,34
100,Fail,46,25,0,19,27
100,Fail,47,34,0,12,35
100,Fail,47,30,5,11,36
100,Fail,44,27,1,16,28
100,Fail,47,30,3,9,38
100,Fail,56,23,0,12,44
100,Fail,49,28,0,11,38
100,Fail,48,26,4,14,34
100,Fail,48,24,1,14,34
100,Fail,43,34,0,14,29
100,Fail,51,25,1,14,37
100,Fail,54,18,0,10,44
100,Fail,50,26,0,14,36
100,Fail,55,24,0,7,48
100,Fail,52,20,1,15,37
100,Fail,39,43,0,12,27
100,Fail,43,29,0,18,25
100,Fail,47,29,0,12,35
100,Fail,55,22,3,8,47
100,Fail,48,24,0,17,31
100,Fail,44,37,0,9,35
100,Fail,41,24,0,22,19
100,Fail,54,23,2,12,42
100,Fail,47,24,1,14,33
100,Fail,42,22,4,21,21
100,Fail,51,27,0,13,38
100,Fail,54,14,7,14,40
100,Fail,53,21,1,16,37
100,Fail,41,34,0,16,25
100,Fail,51,27,0,12,39
100,Fail,50,28,4,12,38
100,Fail,51,27,2,9,42
100,Fail,45,34,0,12,33
100,Fail,56,25,0,11,45
100,Fail,47,29,0,13,34
100,Fail,48,24,6,14,34
100,Fail,58,23,0,5,53
100,Fail,51,21,5,14,37
100,Fail,45,29,6,10,35
100,Fail,52,18,0,16,36
100,Fail,47,32,0,14,33
100,Fail,47,27,0,14,33
100,Fail,47,26,3,13,34
100,Fail,53,26,0,11,42
100,Fail,48,27,0,7,41
100,Fail,41,26,6,23,18
100,Fail,48,21,2,18,30
100,Fail,47,27,5,11,36
100,Fail,46,34,0,13,33
100,Fail,47,28,9,7,40
100,Fail,52,22,2,16,36
100,Fail,44,30,6,7,37
100,Fail,46,29,0,11,35
100,Fail,54,12,8,13,41
100,Fail,39,31,2,19,20
100,Fail,44,33,0,14,30
100,Fail,54,27,0,12,42
100,Fail,50,23,0,13,37
100,Fail,62,22,0,5,57
100,Fail,54,28,0,10,44
100,Fail,44,27,5,11,33
100,Fail,60,18,0,8,52
100,Fail,49,22,3,15,34
100,Fail,36,28,1,23,13
100,Fail,44,32,0,14,30
100,Fail,44,36,0,12,32
100,Fail,45,30,5,12,33
100,Fail,48,25,0,14,34
100,Fail,49,30,1,10,39
100,Fail,55,24,0,12,43
100,Fail,47,29,0,14,33
100,Fail,45,28,0,16,29
100,Fail,40,47,0,9,31
100,Fail,45,31,2,15,30
100,Fail,48,28,0,15,33
100,Fail,42,31,0,17,25
100,Fail,48,27,0,12,36
100,Fail,47,25,5,11,36
100,Fail,43,28,0,17,26
100,Fail,55,22,3,9,46
100,Fail,56,15,1,11,45
100,Fail,48,27,3,10,38
100,Fail,39,35,1,17,22
100,Fail,42,26,2,19,23
100,Fail,52,23,0,15,37
100,Fail,48,34,0,10,38
100,Fail,37,34,6,13,24
100,Fail,48,29,0,7,41
100,Fail,49,30,0,11,38
100,Fail,49,21,6,16,33
100,Fail,56,18,1,11,45
100,Fail,46,27,4,12,34
100,Fail,54,20,1,14,40
100,Fail,37,42,0,12,25
100,Fail,50,24,4,12,38
100,Fail,47,30,0,14,33
100,Fail,47,22,9,13,34
100,Fail,39,32,0,19,20
100,Fail,49,26,0,11,38
100,Fail,53,18,2,14,39
100,Fail,44,33,4,7,37
100,Fail,51,27,0,11,40
100,Fail,43,27,0,16,27
100,Fail,55,26,0,9,46
100,Fail,50,24,12,7,43
100,Fail,48,25,4,13,35
100,Fail,42,37,0,13,29
100,Fail,47,31,3,12,35
100,Fail,45,28,0,11,34
100,Fail,48,26,3,12,36
100,Fail,52,22,4,12,40
100,Fail,44,28,1,14,30
100,Fail,55,20,0,16,39
100,Fail,51,18,0,19,32
100,Fail,45,22,1,21,24
100,Fail,50,25,0,15,35
100,Fail,54,21,0,16,38
100,Fail,51,22,1,12,39
100,Fail,52,22,0,14,38
100,Fail,53,27,0,11,42
100,Fail,48,30,0,14,34
100,Fail,58,19,2,7,51
100,Fail,41,28,6,13,28
100,Fail,43,25,0,20,23
100,Fail,49,31,0,9,40
100,Fail,45,21,8,13,32
100,Fail,47,21,0,18,29
100,Fail,49,34,0,10,39
100,Fail,49,28,0,11,38
100,Fail,56,25,2,7,49
100,Fail,43,27,6,15,28
100,Fail,51,29,3,10,41
100,Fail,50,26,0,10,40
100,Fail,45,29,0,14,31
100,Fail,50,23,0,18,32
100,Fail,51,22,0,13,38
100,Fail,46,24,5,13,33
100,Fail,48,27,0,19,29
100,Fail,50,21,7,9,41
100,Fail,53,22,5,11,42
100,Fail,51,21,1,14,37
100,Fail,50,21,0,15,35
100,Fail,52,19,0,15,37
100,Fail,50,29,4,10,40
100,Fail,53,16,6,15,38
100,Fail,43,29,8,11,32
100,Fail,44,26,0,16,28
100,Fail,42,28,0,19,23
100,Fail,47,29,0,13,34
100,Fail,49,29,0,13,36
100,Fail,43,35,0,14,29
100,Fail,53,21,5,7,46
100,Fail,43,31,4,13,30
100,Fail,52,25,0,7,45
100,Fail,49,23,0,11,38
100,Fail,40,23,18,13,27
100,Fail,48,21,7,12,36
100,Fail,49,33,0,7,42
100,Fail,53,27,0,10,43
100,Fail,48,23,2,15,33
100,Fail,48,28,0,12,36
100,Fail,42,30,7,13,29
100,Fail,60,18,2,13,47
100,Fail,48,29,2,12,36
100,Fail,46,26,5,14,32
100,Fail,50,31,0,11,39
100,Fail,47,25,3,10,37
100,Fail,42,38,1,8,34
100,Fail,43,24,9,15,28
100,Fail,47,25,2,14,33
100,Fail,52,19,0,15,37
100,Fail,51,27,0,11,40
100,Fail,45,25,0,17,28
100,Fail,46,24,6,12,34
100,Fail,44,22,7,13,31
100,Fail,54,20,0,15,39
100,Fail,49,24,2,12,37
100,Fail,50,23,0,17,33
100,Fail,42,30,7,13,29
100,Fail,46,31,0,13,33
100,Fail,54,20,1,15,39
100,Fail,46,24,0,16,30
100,Fail,53,19,0,13,40
100,Fail,48,25,0,13,35
100,Fail,47,29,0,14,33
100,Fail,40,26,15,10,30
100,Fail,54,18,7,13,41
100,Fail,49,22,0,16,33
100,Fail,43,30,2,14,29
100,Fail,55,23,2,9,46
100,Fail,48,26,1,12,36
100,Fail,51,23,3,13,38
100,Fail,40,27,7,16,24
100,Fail,51,25,0,11,40
100,Fail,51,33,0,8,43
100,Fail,50,30,0,9,41
100,Fail,44,30,3,13,31
100,Fail,50,25,0,14,36
100,Fail,48,21,12,12,36
100,Fail,47,25,6,13,34
100,Fail,46,28,3,10,36
100,Fail,44,26,4,17,27
100,Fail,45,32,0,11,34
100,Fail,55,21,5,9,46
100,Fail,53,18,3,17,36
100,Fail,44,26,6,13,31
100,Fail,42,31,4,9,33
100,Fail,53,25,0,12,41
100,Fail,43,37,2,11,32
100,Fail,39,26,7,17,22
100,Fail,49,31,0,11,38
100,Fail,45,23,8,18,27
100,Fail,50,21,3,17,33
100,Fail,49,28,2,8,41
100,Fail,46,32,0,13,33
100,Fail,44,24,5,18,26
100,Fail,52,31,0,9,43
100,Fail,48,20,9,15,33
100,Fail,46,29,0,15,31
100,Fail,46,34,0,8,38
100,Fail,45,24,10,12,33
100,Fail,50,24,0,13,37
100,Fail,51,23,0,15,36
100,Fail,57,25,0,11,46
100,Fail,52,21,0,15,37
100,Fail,52,30,0,8,44
100,Fail,45,25,2,18,27
100,Fail,49,21,6,18,31
100,Fail,47,26,0,11,36
100,Fail,46,40,0,5,41
100,Fail,41,28,13,10,31
100,Fail,42,31,0,18,24
100,Fail,41,35,5,10,31
100,Fail,50,26,5,11,39
100,Fail,46,29,6,9,37
100,Fail,46,20,7,17,29
100,Fail,49,32,0,13,36
100,Fail,51,24,1,13,38
100,Fail,49,26,5,9,40
100,Fail,46,35,0,8,38
100,Fail,41,34,0,13,28
100,Fail,48,30,2,10,38
100,Fail,47,26,2,12,35
100,Fail,42,31,0,15,27
100,Fail,46,39,0,13,33
100,Fail,44,28,0,16,28
100,Fail,51,32,0,7,44
100,Fail,52,25,8,7,45
100,Fail,49,24,3,14,35
100,Fail,50,31,0,13,37
100,Fail,49,22,3,15,34
100,Fail,49,23,9,9,40
100,Fail,44,27,5,17,27
100,Fail,48,31,4,7,41
100,Fail,47,25,6,13,34
100,Fail,48,29,0,12,36
100,Fail,49,28,4,10,39
100,Fail,49,28,1,11,38
100,Fail,40,26,0,25,15
100,Fail,49,25,3,11,38
100,Fail,54,27,0,9,45
100,Fail,49,33,0,9,40
100,Fail,47,22,3,19,28
100,Fail,49,28,0,13,36
100,Fail,58,15,0,12,46
100,Fail,47,25,0,17,30
100,Fail,51,24,6,10,41
100,Fail,49,27,0,15,34
100,Fail,52,26,8,11,41
100,Fail,52,20,2,11,41
100,Fail,59,17,0,9,50
100,Fail,44,26,4,13,31
100,Fail,52,32,0,7,45
100,Fail,38,38,0,15,23
100,Fail,49,27,0,11,38
100,Fail,46,29,5,9,37
100,Fail,48,32,0,12,36
100,Fail,44,36,0,12,32
100,Fail,49,27,0,9,40
100,Fail,52,23,1,12,40
100,Fail,43,31,0,17,26
100,Fail,42,31,8,15,27
100,Fail,49,26,0,9,40
100,Fail,53,22,0,12,41
100,Fail,44,21,8,14,30
100,Fail,52,25,2,9,43
100,Fail,50,25,5,12,38
100,Fail,46,25,0,20,26
100,Fail,54,24,0,10,44
100,Fail,50,20,1,16,34
100,Fail,53,18,1,17,36
100,Fail,48,26,0,15,33
100,Fail,48,24,6,14,34
100,Fail,56,20,0,13,43
100,Fail,44,35,0,12,32
100,Fail,46,34,0,12,34
100,Fail,53,21,2,13,40
100,Fail,46,20,6,14,32
100,Fail,49,30,1,7,42
100,Fail,48,33,1,9,39
100,Fail,52,25,0,13,39
100,Fail,48,30,0,13,35
100,Fail,42,30,6,11,31
100,Fail,47,38,0,7,40
100,Fail,53,23,1,11,42
100,Fail,42,30,0,16,26
100,Fail,40,34,0,15,25
100,Fail,54,21,0,13,41
100,Fail,46,26,0,14,32
100,Fail,60,18,2,10,50
100,Fail,45,24,0,14,31
100,Fail,42,33,1,11,31
100,Fail,47,34,0,9,38
100,Fail,43,21,0,22,21
100,Fail,45,34,0,10,35
100,Fail,49,31,0,9,40
100,Fail,49,27,0,11,38
100,Fail,51,25,0,12,39
100,Fail,51,31,0,10,41
100,Fail,53,24,7,8,45
100,Fail,47,26,8,8,39
100,Fail,53,29,0,7,46
100,Fail,45,32,0,12,33
100,Fail,55,22,0,11,44
100,Fail,45,31,3,10,35
100,Fail,44,29,0,19,25
100,Fail,47,19,3,19,28
100,Fail,46,23,0,19,27
100,Fail,46,22,0,17,29
100,Fail,49,29,1,11,38
100,Fail,56,30,0,6,50
100,Fail,47,30,0,15,32
100,Fail,48,26,2,12,36
100,Fail,39,38,0,17,22
100,Fail,56,27,0,8,48
100,Fail,49,28,4,8,41
100,Fail,51,23,6,9,42
100,Fail,50,25,0,15,35
100,Fail,56,22,0,7,49
100,Fail,47,33,0,11,36
100,Fail,49,38,0,7,42
100,Fail,47,37,2,6,41
100,Fail,43,28,5,13,30
100,Fail,47,32,0,14,33
100,Fail,56,16,2,15,41
100,Fail,42,30,2,11,31
100,Fail,45,25,2,15,30
100,Fail,56,23,0,7,49
100,Fail,49,22,4,17,32
100,Fail,55,18,0,15,40
100,Fail,49,22,3,14,35
100,Fail,51,21,3,13,38
100,Fail,50,25,0,10,40
100,Fail,50,38,0,5,45
100,Fail,53,23,0,13,40
100,Fail,47,24,1,14,33
100,Fail,40,42,0,10,30
100,Fail,52,20,0,13,39
100,Fail,39,34,1,14,25
100,Fail,54,24,1,14,40
100,Fail,49,26,0,14,35
100,Fail,48,35,0,10,38
100,Fail,53,22,0,11,42
100,Fail,44,29,0,15,29
100,Fail,48,24,4,10,38
100,Fail,49,24,2,15,34
100,Fail,51,24,1,14,37
100,Fail,45,22,11,13,32
100,Fail,47,27,2,10,37
100,Fail,54,21,0,6,48
100,Fail,44,29,0,15,29
100,Fail,45,25,3,14,31
100,Fail,48,24,4,13,35
100,Fail,50,22,0,16,34
100,Fail,59,18,0,12,47
100,Fail,49,26,0,16,33
100,Fail,46,30,0,13,33
100,Fail,48,21,2,15,33
100,Fail,53,24,3,9,44
100,Fail,47,33,0,9,38
100,Fail,47,37,0,7,40
100,Fail,42,28,0,19,23
100,Fail,47,32,0,11,36
100,Fail,48,32,0,10,38
100,Fail,46,27,0,13,33
100,Fail,57,20,1,8,49
100,Fail,57,22,1,8,49
100,Fail,51,28,0,13,38
100,Fail,50,28,0,12,38
100,Fail,45,28,0,14,31
100,Fail,47,36,0,10,37
100,Fail,45,33,0,10,35
100,Fail,44,27,0,17,27
100,Fail,45,30,0,15,30
100,Fail,44,29,2,13,31
100,Fail,56,20,1,11,45
100,Fail,45,30,0,16,29
100,Fail,57,20,0,12,45
100,Fail,47,30,0,12,35
100,Fail,46,30,0,12,34
100,Fail,42,36,0,15,27
100,Fail,44,31,0,18,26
100,Fail,47,32,0,11,36
100,Fail,54,19,8,10,44
100,Fail,49,30,0,15,34
100,Fail,43,31,2,14,29
100,Fail,54,24,2,11,43
100,Fail,46,34,6,9,37
100,Fail,46,28,0,15,31
100,Fail,43,28,12,10,33
100,Fail,50,22,2,14,36
100,Fail,50,23,0,13,37
100,Fail,53,26,0,10,43
100,Fail,45,31,0,10,35
100,Fail,46,25,0,14,32
100,Fail,48,30,0,10,38
100,Fail,44,25,12,7,37
100,Fail,49,23,0,17,32
100,Fail,49,33,0,13,36
100,Fail,51,22,7,8,43
100,Fail,47,25,6,12,35
100,Fail,43,31,0,14,29
100,Fail,48,23,8,10,38
100,Fail,49,31,0,9,40
100,Fail,58,23,0,8,50
100,Fail,56,28,0,3,53
100,Fail,48,23,5,16,32
100,Fail,50,37,0,7,43
100,Fail,40,33,0,16,24
100,Fail,50,26,1,11,39
100,Fail,49,24,0,14,35
100,Fail,47,30,0,13,34
100,Fail,50,30,0,10,40
100,Fail,40,35,0,15,25
100,Fail,48,28,0,11,37
100,Fail,52,22,2,8,44
100,Fail,52,20,4,12,40
100,Fail,54,21,2,13,41
100,Fail,46,26,1,15,31
100,Fail,53,22,3,11,42
100,Fail,51,23,0,12,39
100,Fail,45,33,0,11,34
100,Fail,46,36,0,10,36
100,Fail,44,27,6,9,35
100,Fail,56,22,1,9,47
100,Fail,45,37,0,9,36
100,Fail,41,25,4,14,27
100,Fail,49,29,0,10,39
100,Fail,42,24,12,14,28
100,Fail,50,22,9,8,42
100,Fail,46,34,0,15,31
100,Fail,54,21,1,11,43
100,Fail,50,32,0,8,42
100,Fail,54,22,13,7,47
100,Fail,53,25,1,6,47
100,Fail,46,31,6,11,35
100,Fail,43,33,0,15,28
100,Fail,45,23,7,16,29
100,Fail,46,29,5,9,37
100,Fail,49,29,4,10,39
100,Fail,43,38,0,12,31
100,Fail,54,22,8,8,46
100,Fail,48,25,1,17,31
100,Fail,45,29,0,16,29
100,Fail,54,22,0,15,39
100,Fail,44,23,1,20,24
100,Fail,45,25,10,12,33
100,Fail,50,30,0,11,39
100,Fail,47,22,7,15,32
100,Fail,49,23,0,14,35
100,Fail,48,34,0,6,42
100,Fail,52,30,0,8,44
100,Fail,50,28,0,9,41
100,Fail,42,25,8,15,27
100,Fail,52,27,0,10,42
100,Fail,42,28,2,20,22
100,Fail,55,28,0,9,46
100,Fail,46,33,0,11,35
100,Fail,51,26,7,7,44
100,Fail,46,22,8,16,30
100,Fail,39,35,0,14,25
100,Fail,44,28,3,17,27
100,Fail,43,34,0,17,26
100,Fail,48,24,2,13,35
100,Fail,55,22,0,11,44
100,Fail,51,24,0,10,41
100,Fail,41,42,0,9,32
100,Fail,46,27,3,11,35
100,Fail,60,22,0,7,53
100,Fail,48,30,0,13,35
100,Fail,55,24,1,8,47
100,Fail,48,24,4,13,35
100,Fail,50,26,0,12,38
100,Fail,47,30,0,12,35
100,Fail,50,31,0,8,42
100,Fail,44,20,0,24,20
100,Fail,55,21,1,11,44
100,Fail,50,31,0,10,40
100,Fail,44,37,0,8,36
100,Fail,37,39,0,17,20
100,Fail,50,26,0,16,34
100,Fail,48,25,1,16,32
100,Fail,40,38,0,14,26
100,Fail,41,27,4,21,20
100,Fail,43,29,8,11,32
100,Fail,60,19,0,11,49
100,Fail,38,30,4,20,18
100,Fail,52,23,2,12,40
100,Fail,42,29,8,12,30
100,Fail,45,30,7,10,35
100,Fail,56,22,0,12,44
100,Fail,53,17,3,15,38
100,Fail,47,24,6,14,33
100,Fail,45,31,0,13,32
100,Fail,53,29,0,9,44
100,Fail,40,39,0,13,27
100,Fail,45,32,0,12,33
100,Fail,50,26,0,14,36
100,Fail,41,27,11,13,28
100,Fail,48,27,1,10,38
100,Fail,48,22,0,19,29
100,Fail,50,24,0,15,35
100,Fail,46,31,0,9,37
100,Fail,43,29,0,17,26
100,Fail,52,25,0,9,43
100,Fail,48,33,0,10,38
100,Fail,48,32,0,8,40
100,Fail,45,32,0,11,34
100,Fail,55,17,1,14,41
100,Fail,43,31,5,9,34
100,Fail,50,19,1,18,32
100,Fail,55,22,2,8,47
100,Fail,43,38,0,13,30
100,Fail,45,39,0,13,32
100,Fail,47,22,7,15,32
100,Fail,50,22,2,17,33
100,Fail,51,25,0,16,35
100,Fail,52,30,0,9,43
100,Fail,47,24,8,11,36
100,Fail,43,29,8,8,35
100,Fail,51,27,0,11,40
100,Fail,41,21,14,16,25
100,Fail,53,24,0,10,43
100,Fail,48,33,0,9,39
100,Fail,43,33,0,14,29
100,Fail,56,21,3,10,46
100,Fail,39,44,0,11,28
100,Fail,46,31,3,10,36
100,Fail,41,32,7,10,31
100,Fail,42,31,0,18,24
100,Fail,55,19,0,17,38
100,Fail,47,20,10,17,30
100,Fail,46,28,0,14,32
100,Fail,50,27,0,10,40
100,Fail,45,24,4,13,32
100,Fail,48,29,0,9,39
100,Fail,43,30,0,18,25
100,Fail,45,29,0,17,28
100,Fail,43,41,0,8,35
100,Fail,43,27,6,12,31
100,Fail,48,32,0,13,35
100,Fail,47,38,0,6,41
100,Fail,46,29,0,17,29
100,Fail,59,15,9,11,48
100,Fail,43,23,10,16,27
100,Fail,46,27,0,17,29
100,Fail,49,24,0,16,33
100,Fail,51,25,0,11,40
100,Fail,51,30,0,10,41
100,Fail,45,38,0,11,34
100,Fail,47,37,0,11,36
100,Fail,49,26,0,14,35
100,Fail,48,28,2,13,35
100,Fail,47,24,0,13,34
100,Fail,54,23,0,10,44
100,Fail,47,33,0,11,36
100,Fail,47,24,5,14,33
100,Fail,55,28,0,5,50
100,Fail,48,33,2,4,44
100,Fail,55,28,0,5,50
100,Fail,56,24,0,8,48
100,Fail,49,24,3,10,39
100,Fail,53,28,0,6,47
100,Fail,47,30,0,10,37
100,Fail,43,32,0,14,29
100,Fail,52,27,0,11,41
100,Fail,52,23,1,13,39
100,Fail,48,24,3,13,35
100,Fail,42,30,0,17,25
100,Fail,50,26,4,13,37
100,Fail,49,36,0,11,38
100,Fail,48,29,0,12,36
100,Fail,50,27,7,10,40
100,Fail,52,18,1,15,37
100,Fail,55,26,0,11,44
100,Fail,45,37,2,8,37
100,Fail,47,31,0,11,36
100,Fail,56,23,0,10,46
100,Fail,36,31,6,16,20
100,Fail,49,30,0,15,34
100,Fail,51,27,0,10,41
100,Fail,48,24,4,14,34
100,Fail,46,27,0,14,32
100,Fail,45,26,4,18,27
100,Fail,48,27,0,16,32
100,Fail,53,27,0,9,44
100,Fail,44,27,3,18,26
100,Fail,43,34,0,12,31
100,Fail,56,21,3,4,52
100,Fail,46,24,1,17,29
100,Fail,44,25,0,16,28
100,Fail,49,28,2,11,38
100,Fail,49,25,4,15,34
100,Fail,45,30,3,11,34
100,Fail,48,28,5,10,38
100,Fail,40,33,0,14,26
100,Fail,48,26,0,13,35
100,Fail,42,32,1,13,29
100,Fail,46,29,0,14,32
100,Fail,43,25,11,14,29
100,Fail,45,32,3,10,35
100,Fail,54,26,1,7,47
100,Fail,49,27,1,10,39
100,Fail,48,25,2,16,32
100,Fail,48,30,0,11,37
100,Fail,54,18,4,9,45
100,Fail,39,43,0,14,25
100,Fail,51,28,0,8,43
100,Fail,43,28,0,16,27
100,Fail,54,22,2,9,45
100,Fail,49,25,3,12,37
100,Fail,48,31,4,8,40
100,Fail,43,31,3,12,31
100,Fail,51,31,0,10,41
100,Fail,53,26,0,10,43
100,Fail,52,27,0,10,42
100,Fail,40,30,3,17,23
100,Fail,41,27,1,15,26
100,Fail,50,23,3,11,39
100,Fail,47,24,0,18,29
100,Fail,40,38,0,12,28
100,Fail,45,27,7,14,31
100,Fail,39,24,1,25,14
100,Fail,49,29,2,10,39
100,Fail,44,27,5,11,33
100,Fail,56,22,3,10,46
100,Fail,43,43,0,8,35
100,Fail,55,20,0,11,44
100,Fail,56,25,0,9,47
100,Fail,49,22,0,14,35
100,Fail,50,23,0,13,37
100,Fail,48,21,6,15,33
100,Fail,50,26,3,13,37
100,Fail,55,19,0,15,40
100,Fail,46,28,6,14,32
100,Fail,51,24,2,10,41
100,Fail,43,32,0,14,29
100,Fail,44,35,0,13,31
100,Fail,49,23,3,13,36
100,Fail,42,38,0,11,31
100,Fail,44,37,0,16,28
100,Fail,51,28,0,9,42
100,Fail,50,20,6,14,36
100,Fail,47,23,0,20,27
100,Fail,50,23,2,13,37
100,Fail,44,31,1,16,28
100,Fail,50,26,3,10,40
100,Fail,56,17,7,13,43
100,Fail,54,24,2,6,48
100,Fail,45,34,0,12,33
100,Fail,39,27,0,17,22
100,Fail,48,26,0,16,32
100,Fail,46,19,10,12,34
100,Fail,50,26,7,8,42
100,Fail,49,25,0,14,35
100,Fail,45,28,4,14,31
100,Fail,54,22,0,11,43
100,Fail,50,23,0,14,36
100,Fail,46,27,3,15,31
100,Fail,49,24,3,13,36
100,Fail,53,21,0,12,41
100,Fail,48,21,6,13,35
100,Fail,39,28,12,13,26
100,Fail,37,40,0,15,22
100,Fail,40,30,0,18,22
100,Fail,52,24,0,9,43
100,Fail,55,29,0,4,51
100,Fail,46,34,0,10,36
100,Fail,47,30,0,13,34
100,Fail,38,34,4,11,27
100,Fail,57,21,0,11,46
100,Fail,40,33,0,19,21
100,Fail,48,24,8,13,35
100,Fail,43,29,3,18,25
100,Fail,45,32,0,14,31
100,Fail,45,28,2,13,32
100,Fail,52,26,4,8,44
100,Fail,38,35,4,13,25
100,Fail,54,28,2,5,49
100,Fail,51,28,0,9,42
100,Fail,49,18,10,10,39
100,Fail,48,23,0,18,30
100,Fail,48,29,0,15,33
100,Fail,46,20,0,24,22
100,Fail,50,23,2,13,37
100,Fail,42,24,7,16,26
100,Fail,40,29,5,13,27
100,Fail,48,24,6,13,35
100,Fail,46,26,0,15,31
100,Fail,51,23,0,15,36
100,Fail,46,35,3,6,40
100,Fail,51,24,0,14,37
100,Fail,46,33,0,11,35
100,Fail,53,20,0,15,38
100,Fail,57,19,0,14,43
100,Fail,47,29,0,10,37
100,Fail,40,32,0,16,24
100,Fail,55,17,3,10,45
100,Fail,46,27,10,8,38
100,Fail,48,29,2,8,40
100,Fail,46,34,0,11,35
100,Fail,43,27,4,17,26
100,Fail,48,28,0,13,35
100,Fail,54,23,1,13,41
100,Fail,49,30,0,13,36
100,Fail,49,22,6,10,39
100,Fail,49,24,10,9,40
100,Fail,38,33,0,17,21
100,Fail,45,33,0,16,29
100,Fail,46,19,11,16,30
100,Fail,53,18,5,17,36
100,Fail,50,26,2,14,36
100,Fail,50,27,0,12,38
100,Fail,53,24,0,12,41
100,Fail,47,29,0,12,35
100,Fail,49,23,0,14,35
100,Fail,45,34,0,9,36
100,Fail,52,31,0,10,42
100,Fail,41,34,9,8,33
100,Fail,51,26,0,11,40
100,Fail,57,22,0,11,46
100,Fail,49,28,2,5,44
100,Fail,46,29,8,8,38
100,Fail,49,29,0,13,36
100,Fail,41,41,0,9,32
100,Fail,55,24,0,12,43
100,Fail,49,28,0,14,35
100,Fail,47,25,6,11,36
100,Fail,48,19,8,18,30
100,Fail,50,22,9,11,39
100,Fail,57,24,0,7,50
100,Fail,43,24,8,17,26
100,Fail,39,43,0,11,28
100,Fail,45,43,0,7,38
100,Fail,50,22,3,12,38
100,Fail,54,25,0,8,46
100,Fail,52,21,0,15,37
100,Fail,50,30,0,9,41
100,Fail,50,22,1,16,34
100,Fail,46,26,4,13,33
100,Fail,45,27,2,15,30
100,Fail,47,22,8,15,32
100,Fail,51,24,5,12,39
100,Fail,44,30,0,18,26
100,Fail,51,24,0,16,35
100,Fail,49,23,3,14,35
100,Fail,50,25,1,10,40
100,Fail,46,30,1,14,32
100,Fail,50,29,1,10,40
100,Fail,43,29,4,14,29
100,Fail,49,31,0,8,41
100,Fail,51,22,1,18,33
100,Fail,51,26,0,16,35
100,Fail,47,33,0,14,33
100,Fail,40,32,0,16,24
100,Fail,44,36,0,12,32
100,Fail,40,35,2,10,30
100,Fail,50,19,11,10,40
100,Fail,49,29,0,13,36
100,Fail,46,28,4,13,33
100,Fail,44,30,0,19,25
100,Fail,47,19,4,17,30
100,Fail,48,34,0,12,36
100,Fail,56,25,0,10,46
100,Fail,51,25,0,11,40
100,Fail,51,24,0,15,36
100,Fail,51,29,4,10,41
100,Fail,51,25,0,14,37
100,Fail,45,16,3,24,21
100,Fail,48,27,6,12,36
100,Fail,49,22,6,13,36
100,Fail,44,33,0,15,29
100,Fail,46,28,7,8,38
100,Fail,49,29,0,14,35
100,Fail,48,21,7,12,36
100,Fail,46,23,5,14,32
100,Fail,56,22,0,9,47
100,Fail,48,27,1,13,35
100,Fail,49,27,5,8,41
100,Fail,53,20,3,15,38
100,Fail,51,26,5,9,42
100,Fail,42,39,0,14,28
100,Fail,52,20,8,14,38
100,Fail,38,39,0,15,23
100,Fail,52,30,0,9,43
100,Fail,50,23,3,11,39
100,Fail,46,26,1,16,30
100,Fail,45,26,0,14,31
100,Fail,54,16,4,15,39
100,Fail,51,26,0,13,38
100,Fail,52,20,1,11,41
100,Fail,51,27,0,8,43
100,Fail,49,24,1,13,36
100,Fail,41,30,3,15,26
100,Fail,41,34,0,17,24
100,Fail,52,18,0,14,38
100,Fail,44,28,0,17,27
100,Fail,54,23,3,8,46
100,Fail,49,29,0,12,37
100,Fail,52,21,3,13,39
100,Fail,42,26,4,13,29
100,Fail,47,26,3,16,31
100,Fail,43,25,3,17,26
100,Fail,48,24,0,16,32
100,Fail,55,29,0,6,49
100,Fail,53,22,2,13,40
100,Fail,52,27,0,10,42
100,Fail,49,21,1,14,35
100,Fail,47,33,0,11,36
100,Fail,46,21,5,18,28
100,Fail,53,25,0,11,42
100,Fail,42,26,0,18,24
100,Fail,40,34,0,12,28
100,Fail,56,22,0,11,45
100,Fail,37,29,11,17,20
100,Fail,46,28,3,11,35
100,Fail,51,21,0,14,37
100,Fail,52,23,3,11,41
100,Fail,49,24,2,14,35
100,Fail,49,19,1,15,34
100,Fail,36,37,5,11,25
100,Fail,49,30,0,11,38
100,Fail,52,23,0,11,41
100,Fail,47,35,0,11,36
100,Fail,54,28,0,11,43
100,Fail,47,25,2,12,35
100,Fail,50,28,0,14,36
100,Fail,47,31,0,8,39
100,Fail,39,33,2,17,22
100,Fail,53,27,3,5,48
100,Fail,54,26,0,7,47
100,Fail,48,27,3,14,34
100,Fail,53,21,5,13,40
100,Fail,54,25,0,11,43
100,Fail,55,24,2,10,45
100,Fail,47,28,0,17,30
100,Fail,53,22,0,11,42
100,Fail,48,27,0,14,34
100,Fail,37,27,10,19,18
100,Fail,48,31,0,10,38
100,Fail,46,31,1,13,33
100,Fail,51,24,0,12,39
100,Fail,45,30,0,16,29
100,Fail,54,18,0,14,40
100,Fail,45,30,0,17,28
100,Fail,44,37,0,9,35
100,Fail,45,23,7,17,28
100,Fail,44,36,0,11,33
100,Fail,55,25,0,7,48
100,Fail,48,23,1,17,31
100,Fail,45,33,0,14,31
100,Fail,43,30,0,15,28
100,Fail,49,26,0,15,34
100,Fail,55,21,0,10,45
100,Fail,45,25,1,20,25
100,Fail,43,28,1,16,27
100,Fail,52,19,5,12,40
100,Fail,57,18,1,11,46
100,Fail,50,25,4,8,42
100,Fail,50,25,1,8,42
100,Fail,44,23,5,20,24
100,Fail,45,29,9,11,34
100,Fail,50,25,2,13,37
100,Fail,45,30,0,17,28
100,Fail,50,28,0,11,39
100,Fail,36,43,0,14,22
100,Fail,48,28,1,12,36
100,Fail,51,27,0,11,40
100,Fail,42,39,0,10,32
100,Fail,48,20,9,12,36
100,Fail,50,27,3,8,42
100,Fail,44,28,4,17,27
100,Fail,51,23,4,14,37
100,Fail,45,37,0,10,35
100,Fail,42,35,0,16,26
100,Fail,51,24,5,10,41
100,Fail,51,23,0,16,35
100,Fail,48,31,0,9,39
100,Fail,43,22,5,16,27
100,Fail,48,21,0,18,30
100,Fail,44,26,3,15,29
100,Fail,48,26,4,14,34
100,Fail,49,31,0,10,39
100,Fail,54,22,0,11,43
100,Fail,47,35,0,11,36
100,Fail,39,30,0,22,17
100,Fail,50,22,3,13,37
100,Fail,53,23,2,12,41
100,Fail,50,29,0,10,40
100,Fail,49,19,3,15,34
100,Fail,41,27,8,16,25
100,Fail,37,33,8,10,27
100,Fail,45,33,0,11,34
100,Fail,44,30,0,13,31
100,Fail,50,22,5,13,37
100,Fail,48,27,0,17,31
100,Fail,40,40,0,12,28
100,Fail,43,32,0,16,27
100,Fail,47,27,3,12,35
100,Fail,43,33,0,15,28
100,Fail,47,24,6,11,36
100,Fail,47,27,4,13,34
100,Fail,48,23,0,15,33
100,Fail,46,37,0,7,39
100,Fail,48,25,0,15,33
100,Fail,59,16,0,14,45
100,Fail,48,33,0,10,38
100,Fail,46,29,0,13,33
100,Fail,53,22,1,12,41
100,Fail,49,27,0,10,39
100,Fail,51,27,0,15,36
100,Fail,42,31,8,9,33
100,Fail,52,25,8,8,44
100,Fail,41,31,6,12,29
100,Fail,43,27,2,17,26
100,Fail,44,24,0,19,25
100,Fail,46,30,0,15,31
100,Fail,46,28,1,13,33
100,Fail,47,22,7,17,30
100,Fail,51,29,0,9,42
100,Fail,44,28,0,14,30
100,Fail,43,29,3,10,33
100,Fail,50,27,0,14,36
100,Fail,39,39,0,13,26
100,Fail,46,26,0,13,33
100,Fail,48,22,0,15,33
100,Fail,45,32,0,11,34
100,Fail,54,21,3,10,44
100,Fail,45,32,0,13,32
100,Fail,50,28,0,15,35
100,Fail,55,24,0,10,45
100,Fail,43,32,0,14,29
100,Fail,50,25,0,13,37
100,Fail,40,40,0,10,30
100,Fail,51,30,0,10,41
100,Fail,49,26,0,17,32
100,Fail,50,29,0,10,40
100,Fail,45,29,0,13,32
100,Fail,41,39,0,11,30
100,Fail,41,25,11,17,24
100,Fail,49,30,0,14,35
100,Fail,53,24,1,7,46
100,Fail,56,23,1,1,55
100,Fail,48,26,0,15,33
100,Fail,46,32,0,16,30
100,Fail,43,29,5,12,31
100,Fail,50,19,0,15,35
100,Fail,48,34,0,9,39
100,Fail,48,36,0,8,40
100,Fail,48,22,6,10,38
100,Fail,41,22,0,22,19
100,Fail,50,25,0,16,34
100,Fail,48,23,0,16,32
100,Fail,49,20,4,17,32
100,Fail,45,27,0,13,32
100,Fail,52,23,0,12,40
100,Fail,40,29,0,23,17
100,Fail,46,27,4,13,33
100,Fail,45,31,0,12,33
100,Fail,51,21,0,11,40
100,Fail,44,37,0,10,34
100,Fail,56,22,0,9,47
100,Fail,56,18,0,16,40
100,Fail,42,34,3,12,30
100,Fail,44,38,0,5,39
100,Fail,44,27,0,18,26
100,Fail,53,24,0,11,42
100,Fail,48,27,0,15,33
100,Fail,52,26,1,11,41
100,Fail,47,27,0,17,30
100,Fail,50,22,3,10,40
100,Fail,50,22,4,15,35
100,Fail,52,20,0,11,41
100,Fail,42,30,0,15,27
100,Fail,42,28,4,12,30
100,Fail,46,29,0,14,32
100,Fail,46,27,1,12,34
100,Fail,52,26,0,11,41
100,Fail,52,25,5,6,46
100,Fail,53,22,0,10,43
100,Fail,51,25,0,15,36
100,Fail,53,24,0,12,41
100,Fail,43,23,13,15,28
100,Fail,50,27,0,10,40
100,Fail,44,32,0,12,32
100,Fail,49,30,0,11,38
100,Fail,54,21,0,14,40
100,Fail,56,21,0,7,49
100,Fail,46,31,2,9,37
100,Fail,44,25,2,17,27
100,Fail,52,18,0,12,40
100,Fail,54,23,0,11,43
100,Fail,50,24,0,15,35
100,Fail,55,25,1,12,43
100,Fail,42,40,0,11,31
100,Fail,45,22,2,18,27
100,Fail,43,31,6,14,29
100,Fail,54,27,2,8,46
100,Fail,48,28,5,9,39
100,Fail,42,38,0,9,33
100,Fail,47,32,0,11,36
100,Fail,51,29,0,11,40
100,Fail,47,27,3,13,34
100,Fail,51,25,0,12,39
100,Fail,35,29,14,16,19
100,Fail,54,23,0,11,43
100,Fail,48,26,2,11,37
100,Fail,46,33,0,10,36
100,Fail,45,36,0,11,34
100,Fail,57,27,0,9,48
100,Fail,47,34,0,12,35
100,Fail,51,21,0,18,33
100,Fail,47,25,3,15,32
100,Fail,53,26,0,11,42
100,Fail,45,30,0,12,33
100,Fail,44,32,0,15,29
100,Fail,40,33,9,12,28
100,Fail,41,29,4,16,25
100,Fail,45,40,0,11,34
100,Fail,49,27,3,12,37
100,Fail,59,18,0,5,54
100,Fail,50,32,0,11,39
100,Fail,54,21,0,13,41
100,Fail,48,20,7,10,38
100,Fail,48,29,0,10,38
100,Fail,48,30,0,12,36
100,Fail,44,31,0,10,34
100,Fail,47,29,5,12,35
100,Fail,44,41,0,9,35
100,Fail,46,36,0,10,36
100,Fail,45,23,4,17,28
100,Fail,49,26,0,12,37
100,Fail,44,36,0,10,34
100,Fail,50,27,0,13,37
100,Fail,51,24,8,8,43
100,Fail,47,21,0,17,30
100,Fail,39,30,3,17,22
100,Fail,38,30,2,19,19
100,Fail,59,21,0,11,48
100,Fail,54,22,5,10,44
100,Fail,50,25,1,13,37
100,Fail,40,28,9,17,23
100,Fail,46,29,7,13,33
100,Fail,50,25,8,8,42
100,Fail,47,32,0,13,34
100,Fail,49,29,0,15,34
100,Fail,39,31,9,12,27
100,Fail,47,30,0,14,33
100,Fail,43,27,2,16,27
100,Fail,43,35,0,13,30
100,Fail,41,32,0,15,26
100,Fail,56,23,0,11,45
100,Fail,42,27,2,18,24
100,Fail,58,22,0,11,47
100,Fail,41,40,4,3,38
100,Fail,45,30,0,12,33
100,Fail,50,27,0,13,37
100,Fail,43,34,0,9,34
100,Fail,43,29,0,14,29
100,Fail,45,36,0,10,35
100,Fail,46,26,4,15,31
100,Fail,48,23,3,11,37
100,Fail,41,27,4,15,26
100,Fail,51,22,0,16,35
100,Fail,54,22,2,8,46
100,Fail,52,25,3,10,42
100,Fail,53,21,0,12,41
100,Fail,49,20,9,8,41
100,Fail,52,22,0,14,38
100,Fail,50,23,0,13,37
100,Fail,54,28,1,6,48
100,Fail,48,20,0,22,26
100,Fail,52,23,1,14,38
100,Fail,46,23,7,15,31
100,Fail,45,27,13,12,33
100,Fail,43,31,0,17,26
100,Fail,47,26,4,10,37
100,Fail,49,28,7,10,39
100,Fail,49,25,0,17,32
100,Fail,44,27,2,12,32
100,Fail,47,22,7,15,32
100,Fail,53,22,5,12,41
100,Fail,44,30,0,11,33
100,Fail,43,30,2,11,32
100,Fail,39,36,1,15,24
100,Fail,45,25,8,13,32
100,Fail,45,23,3,17,28
100,Fail,45,34,0,11,34
100,Fail,48,20,7,13,35
100,Fail,48,29,0,14,34
100,Fail,50,24,0,12,38
100,Fail,50,28,0,10,40
100,Fail,48,25,2,13,35
100,Fail,51,22,6,12,39
100,Fail,51,27,0,11,40
100,Fail,47,28,2,11,36
100,Fail,44,21,11,15,29
100,Fail,56,21,0,10,46
100,Fail,37,27,9,19,18
100,Fail,47,23,9,14,33
100,Fail,50,19,7,13,37
100,Fail,52,25,3,10,42
100,Fail,46,29,4,13,33
100,Fail,46,25,0,20,26
100,Fail,48,24,4,11,37
100,Fail,37,32,9,13,24
100,Fail,48,27,0,19,29
100,Fail,47,29,0,11,36
100,Fail,54,22,4,13,41
100,Fail,50,20,1,17,33
100,Fail,47,27,0,14,33
100,Fail,48,33,2,8,40
100,Fail,43,31,3,13,30
100,Fail,48,25,0,13,35
100,Fail,48,35,0,9,39
100,Fail,47,32,0,9,38
100,Fail,46,26,0,15,31
100,Fail,43,33,0,16,27
100,Fail,49,19,3,19,30
100,Fail,45,28,0,14,31
100,Fail,45,37,0,12,33
100,Fail,50,29,0,11,39
100,Fail,39,37,0,13,26
100,Fail,55,25,2,11,44
100,Fail,41,30,6,15,26
100,Fail,49,20,3,17,32
100,Fail,46,23,4,18,28
100,Fail,52,32,0,7,45
100,Fail,51,25,2,11,40
100,Fail,45,29,1,18,27
100,Fail,46,23,5,15,31
100,Fail,52,27,2,9,43
100,Fail,51,34,0,9,42
100,Fail,49,26,6,10,39
100,Fail,53,28,0,9,44
100,Fail,53,25,6,5,48
100,Fail,48,30,0,14,34
100,Fail,45,31,4,11,34
100,Fail,47,34,0,12,35
100,Fail,50,21,0,14,36
100,Fail,34,35,2,18,16
100,Fail,44,25,8,14,30
100,Fail,50,28,0,12,38
100,Fail,53,14,1,19,34
100,Fail,49,26,2,13,36
100,Fail,45,31,1,10,35
100,Fail,57,22,0,8,49
100,Fail,52,20,0,15,37
100,Fail,46,24,5,14,32
100,Fail,48,29,0,11,37
100,Fail,50,22,3,12,38
100,Fail,44,28,4,13,31
100,Fail,58,21,0,11,47
100,Fail,40,26,5,14,26
100,Fail,48,27,0,14,34
100,Fail,49,25,0,18,31
100,Fail,45,27,2,15,30
100,Fail,52,25,2,12,40
100,Fail,47,26,0,16,31
100,Fail,44,35,0,11,33
100,Fail,52,26,0,8,44
100,Fail,48,25,2,16,32
100,Fail,51,23,0,14,37
100,Fail,48,26,0,16,32
100,Fail,52,25,0,11,41
100,Fail,38,35,0,14,24
100,Fail,49,22,4,11,38
100,Fail,37,35,0,13,24
100,Fail,49,25,9,9,40
100,Fail,47,29,0,12,35
100,Fail,53,23,1,12,41
100,Fail,37,34,7,13,24
100,Fail,45,37,0,7,38
100,Fail,42,39,0,12,30
100,Fail,54,21,0,14,40
100,Fail,44,24,8,15,29
100,Fail,47,29,1,13,34
100,Fail,42,33,1,10,32
100,Fail,53,21,4,13,40
100,Fail,45,29,4,9,36
100,Fail,43,27,2,16,27
100,Fail,52,27,0,7,45
100,Fail,50,25,0,8,42
100,Fail,53,21,0,12,41
100,Fail,44,32,0,17,27
100,Fail,50,30,0,11,39
100,Fail,50,28,3,11,39
100,Fail,46,20,8,18,28
100,Fail,43,21,6,17,26
100,Fail,52,17,10,19,33
100,Fail,55,17,4,11,44
100,Fail,49,30,0,11,38
100,Fail,43,35,0,13,30
100,Fail,52,24,1,13,39
100,Fail,43,32,0,15,28
100,Fail,46,23,5,16,30
100,Fail,56,22,1,10,46
100,Fail,46,35,0,6,40
100,Fail,55,16,3,16,39
100,Fail,44,33,0,14,30
100,Fail,51,32,0,9,42
100,Fail,46,35,0,9,37
100,Fail,54,23,0,9,45
100,Fail,42,30,8,9,33
100,Fail,48,23,8,10,38
100,Fail,46,23,5,16,30
100,Fail,49,24,0,17,32
100,Fail,57,18,0,10,47
100,Fail,50,30,0,11,39
100,Fail,44,23,10,14,30
100,Fail,37,38,0,14,23
100,Fail,40,36,0,14,26
100,Fail,52,26,3,10,42
100,Fail,41,33,0,16,25
100,Fail,48,23,2,15,33
100,Fail,49,27,0,15,34
100,Fail,45,27,7,11,34
100,Fail,52,22,7,11,41
100,Fail,47,26,3,13,34
100,Fail,47,29,4,11,36
100,Fail,46,32,0,13,33
100,Fail,52,15,8,13,39
100,Fail,42,37,0,11,31
100,Fail,44,32,0,14,30
100,Fail,47,30,4,9,38
100,Fail,41,27,7,18,23
100,Fail,54,24,4,9,45
100,Fail,59,19,0,12,47
100,Fail,51,21,3,11,40
100,Fail,47,27,0,13,34
100,Fail,46,22,2,15,31
100,Fail,53,27,0,11,42
100,Fail,49,31,0,14,35
100,Fail,49,24,4,11,38
100,Fail,46,23,8,13,33
100,Fail,42,29,0,16,26
100,Fail,48,24,5,17,31
100,Fail,50,23,0,15,35
100,Fail,44,21,7,17,27
100,Fail,49,28,0,12,37
100,Fail,42,30,0,15,27
100,Fail,54,19,3,13,41
100,Fail,42,30,3,16,26
100,Fail,47,26,0,15,32
100,Fail,45,27,2,11,34
100,Fail,54,23,2,9,45
100,Fail,44,23,0,19,25
100,Fail,47,26,0,15,32
100,Fail,49,19,5,15,34
100,Fail,48,32,0,7,41
100,Fail,46,18,5,18,28
100,Fail,47,25,6,9,38
100,Fail,43,27,0,18,25
100,Fail,45,31,0,14,31
100,Fail,47,25,5,15,32
100,Fail,50,28,0,11,39
100,Fail,57,24,0,10,47
100,Fail,51,25,4,9,42
100,Fail,37,36,0,20,17
100,Fail,52,24,2,13,39
100,Fail,50,28,5,7,43
100,Fail,50,22,0,16,34
100,Fail,50,19,4,14,36
100,Fail,48,29,1,12,36
100,Fail,42,30,0,18,24
100,Fail,48,26,5,12,36
100,Fail,48,30,0,10,38
100,Fail,47,30,0,14,33
100,Fail,51,16,6,15,36
100,Fail,51,22,4,11,40
100,Fail,43,30,0,16,27
100,Fail,42,30,0,17,25
100,Fail,45,28,0,16,29
100,Fail,59,25,0,5,54
100,Fail,50,27,0,7,43
100,Fail,54,19,0,13,41
100,Fail,55,26,0,11,44
100,Fail,45,38,0,11,34
100,Fail,54,23,1,8,46
100,Fail,45,28,2,15,30
100,Fail,51,23,4,7,44
100,Fail,51,23,1,15,36
100,Fail,50,32,0,13,37
100,Fail,48,27,0,13,35
100,Fail,39,29,2,19,20
100,Fail,48,24,0,15,33
100,Fail,48,35,0,11,37
100,Fail,43,35,3,9,34
100,Fail,47,30,0,12,35
100,Fail,42,31,2,12,30
100,Fail,47,29,0,11,36
100,Fail,38,31,6,15,23
100,Fail,50,31,0,11,39
100,Fail,48,31,0,14,34
100,Fail,39,38,0,11,28
100,Fail,52,23,5,11,41
100,Fail,51,28,0,8,43
100,Fail,46,31,0,13,33
100,Fail,46,38,0,9,37
100,Fail,35,45,0,9,26
100,Fail,49,25,9,9,40
100,Fail,53,18,0,15,38
100,Fail,42,35,4,11,31
100,Fail,54,18,4,14,40
100,Fail,53,27,0,8,45
100,Fail,46,23,0,18,28
100,Fail,50,18,5,14,36
100,Fail,47,27,1,10,37
100,Fail,44,35,0,15,29
100,Fail,46,27,7,12,34
100,Fail,41,32,0,17,24
100,Fail,50,29,0,11,39
100,Fail,49,28,0,9,40
100,Fail,56,22,0,8,48
100,Fail,52,25,4,9,43
100,Fail,52,25,0,12,40
100,Fail,48,24,2,9,39
100,Fail,50,22,5,14,36
100,Fail,49,31,0,9,40
100,Fail,50,23,3,10,40
100,Fail,40,31,7,12,28
100,Fail,45,24,3,15,30
100,Fail,48,25,2,16,32
100,Fail,46,30,0,13,33
100,Fail,48,33,0,7,41
100,Fail,49,25,0,16,33
100,Fail,45,24,1,17,28
100,Fail,45,25,0,17,28
100,Fail,55,23,0,11,44
100,Fail,43,31,5,14,29
100,Fail,47,37,0,8,39
100,Fail,47,32,0,9,38
100,Fail,44,29,6,13,31
100,Fail,48,34,0,8,40
100,Fail,49,27,2,10,39
100,Fail,59,24,1,8,51
100,Fail,42,31,0,19,23
100,Fail,48,27,0,16,32
100,Fail,51,25,1,13,38
100,Fail,54,24,0,10,44
100,Fail,47,26,2,10,37
100,Fail,51,22,0,14,37
100,Fail,43,30,0,14,29
100,Fail,48,22,5,11,37
100,Fail,53,19,0,15,38
100,Fail,42,26,10,16,26
100,Fail,43,27,3,16,27
100,Fail,59,23,3,5,54
100,Fail,51,22,0,15,36
100,Fail,41,33,0,16,25
100,Fail,43,35,0,12,31
100,Fail,47,29,7,10,37
100,Fail,39,33,0,16,23
100,Fail,51,22,8,12,39
100,Fail,52,20,5,14,38
100,Fail,45,30,0,16,29
100,Fail,50,20,2,17,33
100,Fail,42,38,0,12,30
100,Fail,48,24,9,11,37
100,Fail,49,28,3,12,37
100,Fail,52,25,1,9,43
100,Fail,54,24,0,9,45
100,Fail,42,34,0,14,28
100,Fail,54,26,2,7,47
100,Fail,50,25,0,16,34
100,Fail,54,27,0,8,46
100,Fail,57,20,3,6,51
100,Fail,47,26,0,17,30
100,Fail,37,35,0,17,20
100,Fail,50,26,6,13,37
100,Fail,36,34,0,21,15
100,Fail,48,33,3,7,41
100,Fail,52,28,0,14,38
100,Fail,47,21,8,15,32
100,Fail,51,20,1,15,36
100,Fail,53,22,0,10,43
100,Fail,52,29,0,9,43
100,Fail,43,28,6,13,30
100,Fail,50,23,0,15,35
100,Fail,53,20,0,15,38
100,Fail,38,35,0,14,24
100,Fail,51,17,2,16,35
100,Fail,38,41,0,13,25
100,Fail,47,30,0,13,34
100,Fail,50,21,5,10,40
100,Fail,55,21,0,13,42
100,Fail,48,25,1,11,37
100,Fail,49,30,0,10,39
100,Fail,48,27,0,14,34
100,Fail,48,24,2,14,34
100,Fail,43,32,0,12,31
100,Fail,46,18,7,15,31
100,Fail,50,22,3,16,34
100,Fail,48,28,0,11,37
100,Fail,44,37,0,11,33
100,Fail,53,19,6,15,38
100,Fail,49,30,3,6,43
100,Fail,47,22,7,16,31
100,Fail,49,25,0,15,34
100,Fail,50,22,0,16,34
100,Fail,50,29,0,13,37
100,Fail,46,30,0,16,30
100,Fail,53,26,5,5,48
100,Fail,49,27,6,10,39
100,Fail,52,27,4,11,41
100,Fail,52,29,3,6,46
100,Fail,50,28,0,9,41
100,Fail,46,28,3,11,35
100,Fail,47,30,0,12,35
100,Fail,44,27,2,16,28
100,Fail,52,25,11,6,46
100,Fail,54,29,0,7,47
100,Fail,49,23,1,15,34
100,Fail,51,24,0,12,39
100,Fail,43,27,7,11,32
100,Fail,44,33,2,13,31
100,Fail,56,29,0,5,51
100,Fail,46,25,5,17,29
100,Fail,52,21,0,16,36
100,Fail,43,33,0,14,29
100,Fail,40,30,8,14,26
100,Fail,50,26,0,13,37
100,Fail,46,23,4,12,34
100,Fail,44,35,0,10,34
100,Fail,37,36,2,13,24
100,Fail,50,26,0,10,40
100,Fail,50,26,0,13,37
100,Fail,49,29,0,12,37
100,Fail,44,37,0,11,33
100,Fail,40,26,5,19,21
100,Fail,49,20,7,19,30
100,Fail,43,34,0,13,30
100,Fail,50,28,0,12,38
100,Fail,53,21,2,14,39
100,Fail,58,15,3,9,49
100,Fail,47,26,3,16,31
100,Fail,47,27,0,12,35
100,Fail,35,34,5,15,20
100,Fail,54,23,0,13,41
100,Fail,42,28,9,13,29
100,Fail,47,32,0,9,38
100,Fail,43,29,7,9,34
100,Fail,46,32,0,13,33
100,Fail,49,26,0,16,33
100,Fail,48,24,0,15,33
100,Fail,42,28,10,12,30
100,Fail,53,21,0,9,44
100,Fail,43,25,6,16,27
100,Fail,43,40,0,6,37
100,Fail,50,24,0,12,38
100,Fail,49,27,0,12,37
100,Fail,48,25,2,10,38
100,Fail,45,25,1,14,31
100,Fail,52,25,0,9,43
100,Fail,51,23,0,17,34
100,Fail,55,21,1,12,43
100,Fail,47,24,11,9,38
100,Fail,52,26,3,10,42
100,Fail,57,14,0,14,43
100,Fail,48,27,3,14,34
100,Fail,52,33,0,10,42
100,Fail,53,27,0,12,41
100,Fail,46,29,0,16,30
100,Fail,50,22,1,13,37
100,Fail,44,29,6,12,32
100,Fail,52,22,5,13,39
100,Fail,47,27,8,9,38
100,Fail,54,22,0,7,47
100,Fail,40,36,0,14,26
100,Fail,52,29,0,8,44
100,Fail,48,26,0,15,33
100,Fail,48,24,1,13,35
100,Fail,52,25,0,14,38
100,Fail,49,22,4,17,32
100,Fail,37,39,2,11,26
100,Fail,40,30,2,17,23
100,Fail,47,25,5,14,33
100,Fail,53,25,5,12,41
100,Fail,62,21,0,7,55
100,Fail,52,20,3,13,39
100,Fail,45,28,3,14,31
100,Fail,44,24,9,14,30
100,Fail,50,25,0,10,40
100,Fail,38,40,0,12,26
100,Fail,48,27,0,14,34
100,Fail,46,25,3,14,32
100,Fail,41,34,0,18,23
100,Fail,52,29,0,9,43
100,Fail,46,29,0,11,35
100,Fail,51,32,1,10,41
100,Fail,49,22,4,14,35
100,Fail,59,22,0,8,51
100,Fail,52,25,0,14,38
100,Fail,52,20,0,15,37
100,Fail,43,25,4,15,28
100,Fail,49,24,0,8,41
100,Fail,55,26,0,8,47
100,Fail,50,22,0,19,31
100,Fail,55,24,0,10,45
100,Fail,48,27,0,14,34
100,Fail,50,29,0,11,39
100,Fail,49,22,0,19,30
100,Fail,55,13,2,17,38
100,Fail,45,23,2,20,25
100,Fail,50,26,0,13,37
100,Fail,54,30,0,2,52
100,Fail,52,20,0,17,35
100,Fail,56,19,2,11,45
100,Fail,40,35,0,16,24
100,Fail,45,33,0,13,32
100,Fail,50,28,3,9,41
100,Fail,44,25,4,14,30
100,Fail,42,27,2,16,26
100,Fail,42,29,0,17,25
100,Fail,53,24,2,11,42
100,Fail,46,29,0,10,36
100,Fail,52,26,0,10,42
100,Fail,47,27,5,12,35
100,Fail,54,24,2,9,45
100,Fail,57,20,0,14,43
100,Fail,51,26,0,14,37
100,Fail,40,40,0,12,28
100,Fail,54,17,7,10,44
100,Fail,45,30,2,13,32
100,Fail,45,25,0,17,28
100,Fail,50,23,5,13,37
100,Fail,47,29,0,11,36
100,Fail,48,30,2,9,39
100,Fail,50,26,5,12,38
100,Fail,47,32,0,11,36
100,Fail,47,31,0,11,36
100,Fail,49,29,0,10,39
100,Fail,48,25,4,13,35
100,Fail,43,34,0,12,31
100,Fail,46,33,0,10,36
100,Fail,44,28,3,14,30
100,Fail,43,27,9,15,28
100,Fail,40,34,0,17,23
100,Fail,55,23,0,9,46
100,Fail,47,21,0,18,29
100,Fail,57,27,0,3,54
100,Fail,43,30,0,16,27
100,Fail,45,28,0,16,29
100,Fail,53,26,0,11,42
100,Fail,52,23,2,11,41
100,Fail,50,22,0,18,32
100,Fail,45,36,0,10,35
100,Fail,48,24,2,17,31
100,Fail,45,30,1,11,34
100,Fail,49,23,3,16,33
100,Fail,50,30,1,12,38
100,Fail,42,36,0,13,29
100,Fail,44,30,7,12,32
100,Fail,55,20,4,11,44
100,Fail,45,25,0,23,22
100,Fail,56,17,0,10,46
100,Fail,43,34,0,17,26
100,Fail,47,28,2,13,34
100,Fail,45,28,0,17,28
100,Fail,56,19,0,13,43
100,Fail,46,34,0,10,36
100,Fail,50,21,2,11,39
100,Fail,43,35,0,13,30
100,Fail,50,24,0,15,35
100,Fail,47,27,0,15,32
100,Fail,48,30,0,10,38
100,Fail,46,27,5,13,33
100,Fail,53,18,0,18,35
100,Fail,45,25,0,14,31
100,Fail,52,24,0,11,41
100,Fail,52,29,0,9,43
100,Fail,54,23,2,10,44
100,Fail,55,24,0,7,48
100,Fail,40,24,1,23,17
100,Fail,41,34,0,20,21
100,Fail,50,27,0,11,39
100,Fail,54,24,1,8,46
100,Fail,49,20,0,20,29
100,Fail,47,27,6,12,35
100,Fail,42,34,0,14,28
100,Fail,48,27,4,11,37
100,Fail,49,23,5,14,35
100,Fail,43,30,2,15,28
100,Fail,57,16,2,10,47
100,Fail,43,32,0,15,28
100,Fail,50,30,0,11,39
100,Fail,53,26,0,11,42
100,Fail,57,22,0,10,47
100,Fail,47,28,0,16,31
100,Fail,37,30,11,13,24
100,Fail,44,25,7,13,31
100,Fail,47,22,5,12,35
100,Fail,45,23,7,16,29
100,Fail,44,34,0,12,32
100,Fail,46,38,0,10,36
100,Fail,49,25,0,17,32
100,Fail,46,27,5,11,35
100,Fail,49,24,0,15,34
100,Fail,42,28,7,13,29
100,Fail,53,21,0,15,38
100,Fail,46,26,0,17,29
100,Fail,47,30,0,10,37
100,Fail,51,33,0,6,45
100,Fail,47,27,0,13,34
100,Fail,47,28,1,13,34
100,Fail,49,24,0,10,39
100,Fail,41,35,0,13,28
100,Fail,43,31,0,15,28
100,Fail,48,21,0,16,32
100,Fail,42,29,6,16,26
100,Fail,49,23,4,11,38
100,Fail,46,23,9,14,32
100,Fail,46,23,6,14,32
100,Fail,44,36,6,6,38
100,Fail,52,21,0,19,33
100,Fail,52,22,2,14,38
100,Fail,51,22,0,16,35
100,Fail,50,22,2,16,34
100,Fail,46,35,0,10,36
100,Fail,44,35,0,11,33
100,Fail,52,29,0,7,45
100,Fail,43,36,0,13,30
100,Fail,51,21,0,14,37
100,Fail,48,25,2,13,35
100,Fail,45,31,9,8,37
100,Fail,43,33,0,14,29
100,Fail,43,26,5,14,29
100,Fail,44,33,0,12,32
100,Fail,45,29,3,10,35
100,Fail,55,25,0,8,47
100,Fail,47,27,0,12,35
100,Fail,43,29,6,13,30
100,Fail,43,35,0,14,29
100,Fail,48,24,4,16,32
100,Fail,49,33,0,7,42
100,Fail,48,31,0,12,36
100,Fail,50,21,1,15,35
100,Fail,43,24,8,18,25
100,Fail,46,25,1,15,31
100,Fail,47,28,0,18,29
100,Fail,51,21,2,14,37
100,Fail,51,21,0,12,39
100,Fail,50,24,3,12,38
100,Fail,36,31,13,12,24
100,Fail,47,27,1,16,31
100,Fail,51,29,0,7,44
100,Fail,47,26,5,9,38
100,Fail,53,25,0,7,46
100,Fail,53,23,0,12,41
100,Fail,47,25,4,13,34
100,Fail,49,30,0,11,38
100,Fail,49,27,1,12,37
100,Fail,44,26,0,18,26
100,Fail,51,27,9,9,42
100,Fail,58,21,0,10,48
100,Fail,40,25,13,17,23
100,Fail,50,25,0,14,36
100,Fail,46,34,0,11,35
100,Fail,43,29,0,16,27
100,Fail,47,28,0,15,32
100,Fail,46,31,0,11,35
100,Fail,47,19,5,15,32
100,Fail,48,25,4,14,34
100,Fail,43,31,0,16,27
100,Fail,45,26,0,11,34
100,Fail,48,28,4,11,37
100,Fail,53,24,2,12,41
100,Fail,48,22,4,15,33
100,Fail,54,27,0,6,48
100,Fail,46,30,0,14,32
100,Fail,46,29,0,17,29
100,Fail,47,18,11,15,32
100,Fail,52,19,1,20,32
100,Fail,49,24,1,15,34
100,Fail,58,21,1,10,48
100,Fail,48,29,0,12,36
100,Fail,47,32,0,9,38
100,Fail,46,25,0,14,32
100,Fail,42,34,0,12,30
100,Fail,52,29,0,9,43
100,Fail,48,18,0,23,25
100,Fail,51,20,12,13,38
100,Fail,47,27,6,12,35
100,Fail,46,22,5,17,29
100,Fail,52,22,2,12,40
100,Fail,46,26,10,15,31
100,Fail,49,24,0,15,34
100,Fail,44,33,8,8,36
100,Fail,52,19,1,15,37
100,Fail,52,25,5,8,44
100,Fail,44,28,2,14,30
100,Fail,52,20,6,11,41
100,Fail,46,28,10,10,36
100,Fail,51,18,2,15,36
100,Fail,46,21,0,19,27
100,Fail,56,22,0,11,45
100,Fail,45,23,4,15,30
100,Fail,50,21,1,15,35
100,Fail,44,32,0,11,33
100,Fail,46,39,0,8,38
100,Fail,51,23,5,10,41
100,Fail,48,22,5,15,33
100,Fail,55,23,1,8,47
100,Fail,47,25,0,13,34
100,Fail,47,23,1,13,34
100,Fail,52,22,4,10,42
100,Fail,45,34,0,10,35
100,Fail,50,29,0,11,39
100,Fail,48,27,2,11,37
100,Fail,44,31,5,13,31
100,Fail,55,20,0,15,40
100,Fail,46,22,14,11,35
100,Fail,51,30,0,8,43
100,Fail,51,23,0,17,34
100,Fail,49,22,3,12,37
100,Fail,40,35,0,14,26
100,Fail,44,29,0,17,27
100,Fail,50,25,1,12,38
100,Fail,45,33,0,16,29
100,Fail,44,34,0,13,31
100,Fail,54,26,0,11,43
100,Fail,51,21,2,12,39
100,Fail,47,25,2,16,31
100,Fail,48,25,6,11,37
100,Fail,54,27,0,10,44
100,Fail,42,28,0,17,25
100,Fail,43,38,0,11,32
100,Fail,50,25,0,11,39
100,Fail,50,25,0,13,37
100,Fail,46,24,1,19,27
100,Fail,53,21,4,10,43
100,Fail,53,21,0,15,38
100,Fail,56,24,3,3,53
100,Fail,46,28,1,14,32
100,Fail,47,26,2,13,34
100,Fail,48,33,0,10,38
100,Fail,54,27,0,11,43
100,Fail,57,22,0,11,46
100,Fail,55,22,0,12,43
100,Fail,44,27,0,17,27
100,Fail,59,16,2,13,46
100,Fail,42,32,2,12,30
100,Fail,50,22,7,13,37
100,Fail,44,38,0,14,30
100,Fail,46,19,9,16,30
100,Fail,43,30,0,18,25
100,Fail,47,27,0,17,30
100,Fail,49,26,0,12,37
100,Fail,49,24,3,10,39
100,Fail,47,32,0,10,37
100,Fail,55,24,0,10,45
100,Fail,53,22,3,10,43
100,Fail,46,28,4,15,31
100,Fail,56,24,0,8,48
100,Fail,50,22,3,12,38
100,Fail,52,22,0,16,36
100,Fail,50,31,3,8,42
100,Fail,50,19,10,14,36
100,Fail,52,28,1,8,44
100,Fail,49,25,5,8,41
100,Fail,38,32,9,11,27
100,Fail,37,35,0,21,16
100,Fail,52,25,0,12,40
100,Fail,47,33,0,11,36
100,Fail,49,21,3,14,35
100,Fail,43,28,6,14,29
100,Fail,51,18,3,13,38
100,Fail,50,24,6,10,40
100,Fail,50,26,7,8,42
100,Fail,46,28,0,14,32
100,Fail,50,30,0,9,41
100,Fail,42,29,0,15,27
100,Fail,48,20,5,14,34
100,Fail,51,21,2,16,35
100,Fail,43,32,0,14,29
100,Fail,42,26,6,19,23
100,Fail,47,29,0,13,34
100,Fail,50,27,0,13,37
100,Fail,43,34,0,16,27
100,Fail,46,26,4,12,34
100,Fail,50,31,0,11,39
100,Fail,49,32,0,7,42
100,Fail,45,29,3,12,33
100,Fail,51,25,5,12,39
100,Fail,48,24,1,12,36
100,Fail,46,30,4,10,36
100,Fail,42,37,0,12,30
100,Fail,44,29,3,13,31
100,Fail,43,28,0,20,23
100,Fail,36,26,15,17,19
100,Fail,53,24,0,11,42
100,Fail,43,34,0,11,32
100,Fail,44,28,5,12,32
100,Fail,45,26,0,19,26
100,Fail,43,29,5,13,30
100,Fail,47,32,0,11,36
100,Fail,53,22,0,11,42
100,Fail,54,18,0,11,43
100,Fail,57,24,0,9,48
100,Fail,52,29,0,12,40
100,Fail,45,34,0,11,34
100,Fail,55,18,2,14,41
100,Fail,52,21,1,13,39
100,Fail,52,22,0,13,39
100,Fail,52,27,0,11,41
100,Fail,48,28,0,13,35
100,Fail,49,21,3,14,35
100,Fail,52,18,0,17,35
100,Fail,46,32,0,14,32
100,Fail,42,32,0,16,26
100,Fail,46,28,0,16,30
100,Fail,44,30,10,6,38
100,Fail,48,29,0,11,37
100,Fail,51,17,10,15,36
100,Fail,50,21,2,17,33
100,Fail,44,29,2,12,32
100,Fail,49,22,5,11,38
100,Fail,43,30,7,11,32
100,Fail,49,29,0,12,37
100,Fail,50,28,1,9,41
100,Fail,50,22,0,19,31
100,Fail,50,21,4,13,37
100,Fail,40,41,0,12,28
100,Fail,51,31,0,9,42
100,Fail,54,20,3,13,41
100,Fail,42,28,1,18,24
100,Fail,45,32,2,10,35
100,Fail,47,29,0,13,34
100,Fail,46,32,0,13,33
100,Fail,46,32,0,13,33
100,Fail,51,23,0,14,37
100,Fail,48,30,0,14,34
100,Fail,53,23,0,13,40
100,Fail,48,29,0,14,34
100,Fail,49,26,0,17,32
100,Fail,49,27,0,14,35
100,Fail,61,19,0,12,49
100,Fail,53,22,1,12,41
100,Fail,45,30,1,13,32
100,Fail,51,20,1,16,35
100,Fail,50,25,2,11,39
100,Fail,52,18,5,14,38
100,Fail,44,19,12,15,29
100,Fail,60,21,0,10,50
100,Fail,40,35,7,12,28
100,Fail,47,24,4,12,35
100,Fail,47,30,1,10,37
100,Fail,51,29,0,7,44
100,Fail,50,32,0,9,41
100,Fail,59,17,2,12,47
100,Fail,50,21,0,17,33
100,Fail,48,27,0,14,34
100,Fail,46,25,9,11,35
100,Fail,47,22,3,17,30
100,Fail,47,32,0,11,36
100,Fail,45,35,0,8,37
100,Fail,45,26,2,15,30
100,Fail,46,35,0,13,33
100,Fail,51,26,1,14,37
100,Fail,36,36,0,21,15
100,Fail,43,25,0,22,21
100,Fail,38,28,17,11,27
100,Fail,42,37,0,13,29
100,Fail,47,33,0,12,35
100,Fail,48,28,0,12,36
100,Fail,45,30,6,13,32
100,Fail,50,21,7,11,39
100,Fail,43,24,13,13,30
100,Fail,49,27,0,11,38
100,Fail,41,28,11,13,28
100,Fail,48,19,5,16,32
100,Fail,48,27,6,10,38
100,Fail,45,29,3,9,36
100,Fail,54,23,0,13,41
100,Fail,51,23,2,12,39
100,Fail,49,18,3,15,34
100,Fail,47,26,0,10,37
100,Fail,44,38,0,7,37
100,Fail,48,30,2,7,41
100,Fail,47,19,5,16,31
100,Fail,58,17,0,12,46
100,Fail,47,31,0,14,33
100,Fail,40,29,15,9,31
100,Fail,49,32,0,12,37
100,Fail,51,26,0,13,38
100,Fail,39,36,10,9,30
100,Fail,47,28,6,9,38
100,Fail,55,26,0,9,46
100,Fail,41,32,2,12,29
100,Fail,55,19,5,11,44
100,Fail,53,23,0,13,40
100,Fail,46,26,0,17,29
100,Fail,54,20,1,14,40
100,Fail,47,27,3,14,33
100,Fail,56,20,5,8,48
100,Fail,47,23,0,14,33
100,Fail,56,21,0,13,43
100,Fail,52,27,0,9,43
100,Fail,48,31,0,8,40
100,Fail,52,27,0,13,39
100,Fail,50,19,0,17,33
100,Fail,45,29,0,12,33
100,Fail,45,29,0,15,30
100,Fail,46,26,4,13,33
100,Fail,45,32,3,10,35
100,Fail,48,22,0,14,34
100,Fail,50,24,0,16,34
100,Fail,47,29,5,8,39
100,Fail,60,25,0,5,55
100,Fail,55,24,0,5,50
100,Fail,51,24,6,13,38
100,Fail,54,13,7,15,39
100,Fail,42,36,0,8,34
100,Fail,53,19,0,14,39
100,Fail,41,38,0,9,32
100,Fail,52,24,0,9,43
100,Fail,48,33,0,9,39
100,Fail,55,22,0,15,40
100,Fail,47,22,8,8,39
100,Fail,45,25,2,12,33
100,Fail,44,26,6,15,29
100,Fail,48,30,0,9,39
100,Fail,58,20,6,9,49
100,Fail,53,24,0,11,42
100,Fail,53,26,0,9,44
100,Fail,50,18,5,16,34
100,Fail,50,23,10,8,42
100,Fail,49,30,0,8,41
100,Fail,50,18,8,12,38
100,Fail,47,25,0,21,26
100,Fail,54,18,4,13,41
100,Fail,47,28,4,12,35
100,Fail,46,35,0,10,36
100,Fail,41,33,0,20,21
100,Fail,41,27,9,14,27
100,Fail,50,21,1,19,31
100,Fail,53,27,0,10,43
100,Fail,54,22,1,7,47
100,Fail,44,34,0,10,34
100,Fail,44,29,7,10,34
100,Fail,51,26,0,14,37
100,Fail,52,31,0,10,42
100,Fail,41,26,0,25,16
100,Fail,52,25,2,9,43
100,Fail,41,30,0,18,23
100,Fail,38,28,4,19,19
100,Fail,43,35,4,6,37
100,Fail,53,23,0,12,41
100,Fail,52,28,0,13,39
100,Fail,47,25,10,12,35
100,Fail,48,25,2,14,34
100,Fail,53,24,0,11,42
100,Fail,45,30,4,11,34
100,Fail,48,21,6,10,38
100,Fail,47,26,0,15,32
100,Fail,46,34,0,11,35
100,Fail,48,26,0,13,35
100,Fail,49,30,4,9,40
100,Fail,59,25,0,8,51
100,Fail,47,27,6,11,36
100,Fail,41,28,7,15,26
100,Fail,51,24,0,9,42
100,Fail,52,23,0,15,37
100,Fail,45,25,9,14,31
100,Fail,40,35,5,8,32
100,Fail,50,29,0,12,38
100,Fail,45,32,0,13,32
100,Fail,37,40,0,12,25
100,Fail,49,28,0,14,35
100,Fail,49,18,2,16,33
100,Fail,44,23,8,15,29
100,Fail,41,33,0,17,24
100,Fail,44,25,2,16,28
100,Fail,51,23,1,13,38
100,Fail,49,24,6,10,39
100,Fail,41,28,8,12,29
100,Fail,52,20,1,13,39
100,Fail,50,32,0,7,43
100,Fail,51,31,0,5,46
100,Fail,52,37,0,6,46
100,Fail,50,29,0,10,40
100,Fail,46,32,0,11,35
100,Fail,44,32,0,13,31
100,Fail,43,35,0,9,34
100,Fail,49,29,0,14,35
100,Fail,51,25,0,16,35
100,Fail,44,36,0,11,33
100,Fail,42,32,0,15,27
100,Fail,45,35,0,12,33
100,Fail,52,28,0,8,44
100,Fail,47,19,3,19,28
100,Fail,49,18,3,22,27
100,Fail,52,25,4,9,43
100,Fail,43,26,6,17,26
100,Fail,55,29,0,9,46
100,Fail,47,27,2,15,32
100,Fail,43,32,0,17,26
100,Fail,46,35,1,10,36
100,Fail,46,29,1,14,32
100,Fail,49,31,3,6,43
100,Fail,37,44,0,13,24
100,Fail,48,29,0,12,36
100,Fail,46,26,0,18,28
100,Fail,48,23,1,14,34
100,Fail,38,34,0,19,19
100,Fail,51,22,0,18,33
100,Fail,39,33,0,15,24
100,Fail,46,30,0,15,31
100,Fail,32,31,16,17,15
100,Fail,45,41,0,7,38
100,Fail,46,30,4,12,34
100,Fail,45,31,0,11,34
100,Fail,53,17,1,17,36
100,Fail,47,24,3,17,30
100,Fail,51,29,0,11,40
100,Fail,44,23,6,18,26
100,Fail,53,30,0,9,44
100,Fail,42,37,0,14,28
100,Fail,57,19,2,12,45
100,Fail,48,29,6,6,42
100,Fail,50,20,1,20,30
100,Fail,43,33,8,6,37
100,Fail,34,37,8,12,22
100,Fail,51,25,1,12,39
100,Fail,45,36,0,9,36
100,Fail,50,25,7,9,41
100,Fail,48,20,0,21,27
100,Fail,43,31,1,18,25
100,Fail,39,37,0,13,26
100,Fail,36,41,0,17,19
100,Fail,41,40,0,10,31
100,Fail,43,25,11,13,30
100,Fail,52,23,0,14,38
100,Fail,47,21,2,18,29
100,Fail,53,20,2,11,42
100,Fail,46,23,4,16,30
100,Fail,45,23,7,17,28
100,Fail,49,22,6,14,35
100,Fail,46,25,0,17,29
100,Fail,54,19,2,12,42
100,Fail,47,25,0,15,32
100,Fail,49,25,1,15,34
100,Fail,50,28,0,8,42
100,Fail,47,22,10,15,32
100,Fail,49,23,1,14,35
100,Fail,51,30,1,9,42
100,Fail,49,23,0,16,33
100,Fail,52,27,0,13,39
100,Fail,57,20,0,15,42
100,Fail,43,23,7,18,25
100,Fail,52,19,7,9,43
100,Fail,48,15,9,13,35
100,Fail,46,32,0,9,37
100,Fail,43,29,0,11,32
100,Fail,55,18,1,17,38
100,Fail,50,25,0,14,36
100,Fail,49,24,0,18,31
100,Fail,50,27,0,17,33
100,Fail,46,24,13,9,37
100,Fail,54,27,0,8,46
100,Fail,52,26,1,8,44
100,Fail,48,24,0,13,35
100,Fail,41,28,4,18,23
100,Fail,57,25,4,6,51
100,Fail,43,30,8,10,33
100,Fail,44,27,7,15,29
100,Fail,55,22,3,8,47
100,Fail,49,30,0,14,35
100,Fail,48,36,0,10,38
100,Fail,47,28,0,14,33
100,Fail,61,22,0,8,53
100,Fail,51,27,4,10,41
100,Fail,56,17,0,16,40
100,Fail,55,21,0,10,45
100,Fail,52,25,3,8,44
100,Fail,50,24,0,17,33
100,Fail,50,27,0,11,39
100,Fail,44,32,0,17,27
100,Fail,40,38,0,12,28
100,Fail,50,27,0,15,35
100,Fail,49,20,3,17,32
100,Fail,43,31,0,17,26
100,Fail,45,26,5,12,33
100,Fail,58,21,0,9,49
100,Fail,51,19,1,15,36
100,Fail,50,28,0,13,37
100,Fail,51,24,1,12,39
100,Fail,42,26,9,18,24
100,Fail,51,21,4,9,42
100,Fail,43,31,0,17,26
100,Fail,48,23,3,17,31
100,Fail,47,20,3,16,31
100,Fail,46,27,5,11,35
100,Fail,45,32,0,14,31
100,Fail,53,23,1,13,40
100,Fail,50,23,1,14,36
100,Fail,54,30,1,5,49
100,Fail,44,27,0,17,27
100,Fail,48,34,0,8,40
100,Fail,51,28,0,9,42
100,Fail,36,39,0,15,21
100,Fail,47,26,5,12,35
100,Fail,49,27,3,10,39
100,Fail,46,38,0,9,37
100,Fail,53,27,0,10,43
100,Fail,55,20,1,13,42
100,Fail,47,29,1,12,35
100,Fail,50,20,6,18,32
100,Fail,49,31,0,10,39
100,Fail,48,26,0,12,36
100,Fail,51,28,0,9,42
100,Fail,45,27,5,15,30
100,Fail,48,29,0,14,34
100,Fail,48,32,0,10,38
100,Fail,43,28,0,20,23
100,Fail,51,22,1,13,38
100,Fail,45,23,3,16,29
100,Fail,56,23,0,10,46
100,Fail,50,28,2,11,39
100,Fail,48,23,2,16,32
100,Fail,52,24,3,9,43
100,Fail,46,22,0,20,26
100,Fail,52,20,0,16,36
100,Fail,44,24,6,14,30
100,Fail,41,28,3,18,23
100,Fail,52,24,0,13,39
100,Fail,51,26,3,9,42
100,Fail,46,23,3,17,29
100,Fail,50,24,6,13,37
100,Fail,46,29,0,17,29
100,Fail,46,30,4,13,33
100,Fail,52,23,3,11,41
100,Fail,46,31,0,16,30
100,Fail,39,27,10,16,23
100,Fail,48,28,2,5,43
100,Fail,52,26,0,13,39
100,Fail,51,29,0,6,45
100,Fail,48,25,10,7,41
100,Fail,46,25,3,17,29
100,Fail,53,20,1,15,38
100,Fail,44,28,14,7,37
100,Fail,51,20,5,12,39
100,Fail,45,26,0,14,31
100,Fail,46,26,1,11,35
100,Fail,58,21,0,10,48
100,Fail,47,39,0,8,39
100,Fail,47,33,0,12,35
100,Fail,44,28,6,13,31
100,Fail,53,23,0,14,39
100,Fail,56,20,0,8,48
100,Fail,53,21,6,11,42
100,Fail,50,22,6,10,40
100,Fail,50,20,2,18,32
100,Fail,48,36,0,8,40
100,Fail,49,27,0,16,33
100,Fail,51,26,0,12,39
100,Fail,50,29,4,9,41
100,Fail,48,25,0,17,31
100,Fail,48,25,0,14,34
100,Fail,54,26,0,10,44
100,Fail,38,33,9,15,23
100,Fail,47,26,0,16,31
100,Fail,49,35,0,9,40
100,Fail,47,32,0,14,33
100,Fail,56,22,0,6,50
100,Fail,49,29,2,12,37
100,Fail,42,33,0,16,26
100,Fail,49,29,0,13,36
100,Fail,44,35,0,9,35
100,Fail,46,27,0,14,32
100,Fail,52,26,2,10,42
100,Fail,45,19,8,18,27
100,Fail,58,21,3,9,49
100,Fail,52,33,0,6,46
100,Fail,48,28,0,12,36
100,Fail,50,22,2,15,35
100,Fail,48,24,2,15,33
100,Fail,46,28,0,15,31
100,Fail,46,35,0,11,35
100,Fail,44,32,0,16,28
100,Fail,50,25,1,11,39
100,Fail,45,32,0,15,30
100,Fail,48,31,0,11,37
100,Fail,53,26,0,12,41
100,Fail,48,32,0,8,40
100,Fail,50,27,3,9,41
100,Fail,46,34,0,12,34
100,Fail,38,32,8,18,20
100,Fail,40,24,0,23,17
100,Fail,36,37,4,14,22
100,Fail,54,22,1,13,41
100,Fail,49,31,0,11,38
100,Fail,53,21,0,14,39
100,Fail,54,22,3,11,43
100,Fail,36,31,9,18,18
100,Fail,43,31,0,13,30
100,Fail,52,25,2,12,40
100,Fail,52,23,3,10,42
100,Fail,45,24,0,19,26
100,Fail,56,22,0,9,47
100,Fail,48,28,0,14,34
100,Fail,55,20,1,11,44
100,Fail,44,33,7,12,32
100,Fail,49,24,7,11,38
100,Fail,46,27,0,14,32
100,Fail,52,20,8,12,40
100,Fail,44,25,7,13,31
100,Fail,46,19,0,18,28
100,Fail,49,20,2,15,34
100,Fail,44,31,0,19,25
100,Fail,53,30,0,6,47
100,Fail,38,33,0,15,23
100,Fail,41,32,4,15,26
100,Fail,48,27,1,15,33
100,Fail,50,26,0,15,35
100,Fail,45,38,0,10,35
100,Fail,50,28,0,11,39
100,Fail,57,17,2,11,46
100,Fail,51,30,0,9,42
100,Fail,53,28,0,10,43
100,Fail,52,17,8,12,40
100,Fail,49,24,3,13,36
100,Fail,52,23,0,13,39
100,Fail,49,20,5,17,32
100,Fail,54,28,0,10,44
100,Fail,46,35,0,13,33
100,Fail,46,29,6,10,36
100,Fail,47,27,10,12,35
100,Fail,47,27,0,13,34
100,Fail,51,24,3,9,42
100,Fail,45,35,0,13,32
100,Fail,50,19,6,17,33
100,Fail,51,24,1,16,35
100,Fail,47,30,0,10,37
100,Fail,61,20,0,10,51
100,Fail,54,17,1,13,41
100,Fail,53,22,1,11,42
100,Fail,50,35,0,10,40
100,Fail,48,28,1,10,38
100,Fail,43,33,0,12,31
100,Fail,45,28,0,18,27
100,Fail,59,22,0,5,54
100,Fail,48,18,0,23,25
100,Fail,46,33,0,13,33
100,Fail,44,31,0,14,30
100,Fail,48,28,2,14,34
100,Fail,40,37,0,13,27
100,Fail,56,23,0,8,48
100,Fail,49,36,0,6,43
100,Fail,50,27,0,9,41
100,Fail,48,31,0,13,35
100,Fail,45,34,0,13,32
100,Fail,41,35,7,11,30
100,Fail,43,31,2,15,28
100,Fail,45,34,0,10,35
100,Fail,50,20,0,17,33
100,Fail,41,33,0,15,26
100,Fail,53,21,0,14,39
100,Fail,52,24,0,11,41
100,Fail,49,27,0,14,35
100,Fail,48,32,0,12,36
100,Fail,44,33,0,10,34
100,Fail,48,27,4,10,38
100,Fail,49,30,6,8,41
100,Fail,46,36,0,7,39
100,Fail,41,33,10,13,28
100,Fail,47,29,0,11,36
100,Fail,51,24,0,15,36
100,Fail,48,29,2,12,36
100,Fail,49,28,1,11,38
100,Fail,47,37,0,7,40
100,Fail,51,26,0,15,36
100,Fail,54,27,0,8,46
100,Fail,52,24,7,11,41
100,Fail,48,29,1,9,39
100,Fail,47,27,0,15,32
100,Fail,43,32,1,12,31
100,Fail,41,33,0,18,23
100,Fail,42,29,3,13,29
100,Fail,40,34,0,17,23
100,Fail,48,31,0,10,38
100,Fail,53,22,6,8,45
100,Fail,46,25,4,14,32
100,Fail,51,26,0,10,41
100,Fail,37,33,7,16,21
100,Fail,46,23,6,16,30
100,Fail,47,36,0,11,36
100,Fail,49,20,5,14,35
100,Fail,47,28,0,16,31
100,Fail,51,21,2,13,38
100,Fail,48,28,0,15,33
100,Fail,58,20,0,9,49
100,Fail,47,26,1,14,33
100,Fail,54,26,1,8,46
100,Fail,50,23,0,15,35
100,Fail,49,28,6,6,43
100,Fail,53,24,0,13,40
100,Fail,54,26,0,8,46
100,Fail,55,25,2,9,46
100,Fail,52,22,2,14,38
100,Fail,39,31,4,15,24
100,Fail,50,26,0,12,38
100,Fail,59,15,3,11,48
100,Fail,44,38,0,10,34
100,Fail,45,30,3,15,30
100,Fail,49,31,0,11,38
100,Fail,54,22,1,15,39
100,Fail,50,25,0,11,39
100,Fail,49,25,5,11,38
100,Fail,45,29,0,17,28
100,Fail,46,30,1,11,35
100,Fail,43,22,6,18,25
100,Fail,40,35,6,8,32
100,Fail,50,20,0,17,33
100,Fail,53,21,0,10,43
100,Fail,52,22,0,15,37
100,Fail,60,15,1,11,49
100,Fail,56,26,3,8,48
100,Fail,51,30,4,10,41
100,Fail,59,17,6,10,49
100,Fail,46,33,0,13,33
100,Fail,48,29,0,11,37
100,Fail,50,25,0,13,37
100,Fail,45,30,0,11,34
100,Fail,46,29,0,12,34
100,Fail,51,28,0,9,42
100,Fail,50,24,0,18,32
100,Fail,45,23,3,17,28
100,Fail,57,18,0,9,48
100,Fail,51,23,5,11,40
100,Fail,47,24,8,14,33
100,Fail,51,21,2,12,39
100,Fail,44,34,0,15,29
100,Fail,48,24,2,13,35
100,Fail,52,19,0,15,37
100,Fail,51,25,3,13,38
100,Fail,50,21,7,15,35
100,Fail,51,28,0,14,37
100,Fail,41,36,0,13,28
100,Fail,50,28,1,9,41
100,Fail,43,30,2,14,29
100,Fail,43,28,0,17,26
100,Fail,38,34,0,14,24
100,Fail,45,29,0,14,31
100,Fail,41,24,13,11,30
100,Fail,51,21,1,16,35
100,Fail,42,31,0,15,27
100,Fail,50,23,0,15,35
100,Fail,58,16,4,11,47
100,Fail,49,25,6,12,37
100,Fail,41,34,0,12,29
100,Fail,53,24,0,10,43
100,Fail,50,24,0,16,34
100,Fail,47,31,0,12,35
100,Fail,57,19,1,13,44
100,Fail,49,29,3,10,39
100,Fail,39,28,10,14,25
100,Fail,48,38,0,11,37
100,Fail,49,28,2,12,37
100,Fail,52,20,0,15,37
100,Fail,53,23,3,9,44
100,Fail,51,28,0,10,41
100,Fail,48,25,2,13,35
100,Fail,43,29,2,15,28
100,Fail,47,29,3,12,35
100,Fail,54,14,7,12,42
100,Fail,47,33,0,12,35
100,Fail,51,19,5,13,38
100,Fail,47,23,3,18,29
100,Fail,47,31,0,11,36
100,Fail,45,28,7,12,33
100,Fail,48,22,2,15,33
100,Fail,44,27,6,13,31
100,Fail,55,14,5,19,36
100,Fail,41,34,1,14,27
100,Fail,60,20,0,8,52
100,Fail,53,19,2,14,39
100,Fail,53,27,0,10,43
100,Fail,48,28,0,15,33
100,Fail,48,32,0,12,36
100,Fail,45,34,0,11,34
100,Fail,53,20,1,11,42
100,Fail,50,21,0,13,37
100,Fail,45,32,4,14,31
100,Fail,50,28,1,9,41
100,Fail,42,36,0,12,30
100,Fail,54,24,0,9,45
100,Fail,37,36,5,9,28
100,Fail,48,34,0,11,37
100,Fail,49,23,0,15,34
100,Fail,45,29,4,11,34
100,Fail,44,31,0,17,27
100,Fail,41,38,0,13,28
100,Fail,42,33,4,16,26
100,Fail,53,22,7,10,43
100,Fail,57,21,0,10,47
100,Fail,52,26,0,9,43
100,Fail,40,29,6,18,22
100,Fail,47,31,0,12,35
100,Fail,48,27,5,11,37
100,Fail,51,28,0,9,42
100,Fail,51,24,0,12,39
100,Fail,42,23,9,17,25
100,Fail,46,24,9,11,35
100,Fail,45,26,9,9,36
100,Fail,50,24,4,12,38
100,Fail,50,30,2,8,42
100,Fail,48,29,0,12,36
100,Fail,45,26,0,19,26
100,Fail,43,27,7,16,27
100,Fail,42,25,7,15,27
100,Fail,47,28,0,21,26
100,Fail,48,27,2,13,35
100,Fail,50,33,0,11,39
100,Fail,57,23,0,8,49
100,Fail,47,31,2,7,40
100,Fail,41,27,3,19,22
100,Fail,47,24,4,14,33
100,Fail,54,21,0,12,42
100,Fail,49,26,2,13,36
100,Fail,48,29,0,12,36
100,Fail,45,24,10,16,29
100,Fail,47,25,4,15,32
100,Fail,50,27,3,9,41
100,Fail,56,20,1,9,47
100,Fail,53,22,0,10,43
100,Fail,48,27,0,16,32
100,Fail,53,22,4,10,43
100,Fail,46,30,0,16,30
100,Fail,35,47,0,9,26
100,Fail,42,26,0,17,25
100,Fail,52,30,0,10,42
100,Fail,53,26,0,14,39
100,Fail,45,23,9,13,32
100,Fail,46,30,1,9,37
100,Fail,50,25,0,11,39
100,Fail,43,27,14,8,35
100,Fail,44,28,0,14,30
100,Fail,47,23,0,18,29
100,Fail,46,24,5,13,33
100,Fail,45,27,0,16,29
100,Fail,46,27,3,12,34
100,Fail,50,28,0,8,42
100,Fail,43,31,0,12,31
100,Fail,51,24,2,10,41
100,Fail,49,24,0,15,34
100,Fail,43,30,0,14,29
100,Fail,48,24,4,10,38
100,Fail,49,25,0,17,32
100,Fail,41,39,0,12,29
100,Fail,53,21,5,12,41
100,Fail,53,17,0,18,35
100,Fail,48,28,0,13,35
100,Fail,50,24,1,13,37
100,Fail,44,37,0,10,34
100,Fail,53,25,1,11,42
100,Fail,49,31,0,10,39
100,Fail,48,29,0,11,37
100,Fail,44,33,0,13,31
100,Fail,48,31,0,14,34
100,Fail,37,29,10,14,23
100,Fail,44,25,7,17,27
100,Fail,39,26,17,10,29
100,Fail,48,30,0,14,34
100,Fail,44,32,0,16,28
100,Fail,48,29,3,9,39
100,Fail,50,22,0,14,36
100,Fail,42,34,0,15,27
100,Fail,46,31,0,14,32
100,Fail,47,28,0,14,33
100,Fail,46,23,5,14,32
100,Fail,51,24,0,11,40
100,Fail,49,28,4,10,39
100,Fail,48,21,6,16,32
100,Fail,44,33,0,13,31
100,Fail,49,24,1,15,34
100,Fail,45,26,8,15,30
100,Fail,45,23,8,11,34
100,Fail,53,21,0,15,38
100,Fail,40,20,0,25,15
100,Fail,58,21,0,10,48
100,Fail,49,25,1,11,38
100,Fail,40,29,0,22,18
100,Fail,53,19,0,16,37
100,Fail,43,34,0,14,29
100,Fail,53,23,2,13,40
100,Fail,40,29,0,19,21
100,Fail,51,29,1,11,40
100,Fail,45,27,3,11,34
100,Fail,52,23,4,10,42
100,Fail,58,21,2,5,53
100,Fail,47,27,2,12,35
100,Fail,46,27,0,17,29
100,Fail,44,24,1,20,24
100,Fail,53,19,0,14,39
100,Fail,45,33,0,11,34
100,Fail,53,26,0,10,43
100,Fail,52,18,2,13,39
100,Fail,46,30,6,11,35
100,Fail,60,13,1,12,48
100,Fail,45,24,0,22,23
100,Fail,49,25,0,16,33
100,Fail,52,29,0,10,42
100,Fail,53,26,0,11,42
100,Fail,48,22,1,13,35
100,Fail,51,19,7,14,37
100,Fail,45,27,5,13,32
100,Fail,43,30,4,13,30
100,Fail,49,26,1,12,37
100,Fail,45,25,7,18,27
100,Fail,45,20,3,20,25
100,Fail,52,28,2,7,45
100,Fail,49,29,0,12,37
100,Fail,45,27,0,18,27
100,Fail,53,26,0,7,46
100,Fail,53,21,1,15,38
100,Fail,48,27,0,12,36
100,Fail,50,28,0,13,37
100,Fail,57,19,0,14,43
100,Fail,44,30,2,12,32
100,Fail,49,28,1,9,40
100,Fail,44,35,0,12,32
100,Fail,47,26,0,12,35
100,Fail,47,22,10,13,34
100,Fail,49,24,6,12,37
100,Fail,50,28,3,12,38
100,Fail,47,21,9,12,35
100,Fail,43,30,5,14,29
100,Fail,42,40,0,11,31
100,Fail,53,23,1,12,41
100,Fail,43,32,0,16,27
100,Fail,41,31,1,15,26
100,Fail,46,28,6,12,34
100,Fail,51,26,0,11,40
100,Fail,44,23,8,17,27
100,Fail,50,33,0,8,42
100,Fail,44,19,2,17,27
100,Fail,51,23,0,12,39
100,Fail,43,28,0,15,28
100,Fail,46,26,4,16,30
100,Fail,50,24,5,11,39
100,Fail,46,19,3,19,27
100,Fail,48,21,6,12,36
100,Fail,46,24,7,14,32
100,Fail,44,29,0,18,26
100,Fail,48,28,0,7,41
100,Fail,54,25,2,9,45
100,Fail,48,18,7,17,31
100,Fail,52,22,1,12,40
100,Fail,49,28,0,10,39
100,Fail,45,31,0,15,30
100,Fail,47,28,2,11,36
100,Fail,51,27,0,12,39
100,Fail,47,27,0,10,37
100,Fail,49,25,1,13,36
100,Fail,53,24,0,14,39
100,Fail,50,28,1,10,40
100,Fail,36,30,16,12,24
100,Fail,40,33,0,15,25
100,Fail,42,29,5,12,30
100,Fail,45,27,5,16,29
100,Fail,43,39,0,12,31
100,Fail,55,23,1,9,46
100,Fail,40,32,5,17,23
100,Fail,51,30,0,6,45
100,Fail,47,20,7,14,33
100,Fail,43,26,7,13,30
100,Fail,56,22,4,12,44
100,Fail,40,33,0,14,26
100,Fail,53,24,0,14,39
100,Fail,46,25,2,15,31
100,Fail,44,19,6,23,21
100,Fail,47,30,0,14,33
100,Fail,37,38,2,12,25
100,Fail,47,23,0,17,30
100,Fail,44,26,0,17,27
100,Fail,41,26,6,16,25
100,Fail,51,16,6,15,36
100,Fail,48,25,0,14,34
100,Fail,44,32,0,12,32
100,Fail,47,27,2,11,36
100,Fail,54,17,0,15,39
100,Fail,44,30,7,14,30
100,Fail,54,24,0,11,43
100,Fail,43,23,8,17,26
100,Fail,49,24,0,16,33
100,Fail,52,24,0,10,42
100,Fail,45,25,10,14,31
100,Fail,50,18,4,17,33
100,Fail,42,27,2,14,28
100,Fail,52,22,2,11,41
100,Fail,52,26,0,11,41
100,Fail,48,22,0,14,34
100,Fail,48,27,0,10,38
100,Fail,56,26,0,10,46
100,Fail,51,25,0,13,38
100,Fail,52,23,0,12,40
100,Fail,46,31,0,10,36
100,Fail,40,44,0,8,32
100,Fail,54,25,0,7,47
100,Fail,47,26,3,11,36
100,Fail,53,25,0,11,42
100,Fail,52,23,2,12,40
100,Fail,51,19,1,19,32
100,Fail,45,32,3,12,33
100,Fail,44,24,7,18,26
100,Fail,46,25,8,12,34
100,Fail,50,29,0,13,37
100,Fail,41,39,0,11,30
100,Fail,47,27,2,12,35
100,Fail,49,29,0,10,39
100,Fail,51,21,3,10,41
100,Fail,48,29,3,8,40
100,Fail,50,29,0,8,42
100,Fail,47,28,0,13,34
100,Fail,52,25,0,9,43
100,Fail,59,25,0,10,49
100,Fail,50,22,3,14,36
100,Fail,49,30,0,8,41
100,Fail,50,23,1,13,37
100,Fail,46,30,4,8,38
100,Fail,51,29,0,11,40
100,Fail,45,36,0,11,34
100,Fail,43,33,0,14,29
100,Fail,49,14,8,18,31
100,Fail,51,19,3,14,37
100,Fail,44,34,0,8,36
100,Fail,54,18,0,18,36
100,Fail,53,29,0,9,44
100,Fail,43,27,9,11,32
100,Fail,48,24,4,14,34
100,Fail,52,25,1,8,44
100,Fail,47,26,0,17,30
100,Fail,45,29,10,10,35
100,Fail,49,28,0,9,40
100,Fail,49,24,3,14,35
100,Fail,50,24,1,12,38
100,Fail,52,20,5,14,38
100,Fail,48,31,0,11,37
100,Fail,57,18,0,12,45
100,Fail,53,33,0,6,47
100,Fail,42,32,0,15,27
100,Fail,51,22,6,10,41
100,Fail,41,33,0,12,29
100,Fail,53,21,3,12,41
100,Fail,48,33,0,8,40
100,Fail,55,14,3,17,38
100,Fail,56,19,0,15,41
100,Fail,48,23,7,15,33
100,Fail,47,30,0,14,33
100,Fail,53,20,1,12,41
100,Fail,48,19,8,14,34
100,Fail,57,20,3,9,48
100,Fail,44,28,0,15,29
100,Fail,50,28,0,7,43
100,Fail,52,22,7,12,40
100,Fail,40,29,6,14,26
100,Fail,43,32,0,14,29
100,Fail,42,31,5,14,28
100,Fail,41,35,0,13,28
100,Fail,51,25,2,12,39
100,Fail,48,26,0,15,33
100,Fail,54,26,0,13,41
100,Fail,49,28,0,12,37
100,Fail,49,20,2,14,35
100,Fail,50,27,5,11,39
100,Fail,52,22,3,13,39
100,Fail,45,39,0,8,37
100,Fail,55,25,5,8,47
100,Fail,51,18,0,16,35
100,Fail,41,32,0,14,27
100,Fail,45,25,9,14,31
100,Fail,49,29,2,8,41
100,Fail,50,24,2,14,36
100,Fail,48,24,4,10,38
100,Fail,44,19,15,16,28
100,Fail,47,30,0,10,37
100,Fail,45,27,7,13,32
100,Fail,45,31,5,9,36
100,Fail,46,21,3,18,28
100,Fail,56,24,0,10,46
100,Fail,44,21,9,12,32
100,Fail,49,23,2,18,31
100,Fail,51,21,5,13,38
100,Fail,53,34,0,4,49
100,Fail,49,24,0,13,36
100,Fail,38,38,0,15,23
100,Fail,47,26,4,13,34
100,Fail,41,29,7,11,30
100,Fail,48,27,0,16,32
100,Fail,48,34,0,9,39
100,Fail,46,31,0,14,32
100,Fail,44,29,3,15,29
100,Fail,53,25,0,10,43
100,Fail,42,27,8,12,30
100,Fail,53,24,0,12,41
100,Fail,49,35,0,7,42
100,Fail,44,31,0,18,26
100,Fail,45,25,3,17,28
100,Fail,47,31,1,9,38
100,Fail,41,28,0,22,19
100,Fail,53,26,0,14,39
100,Fail,39,36,0,17,22
100,Fail,50,24,0,18,32
100,Fail,51,28,3,7,44
100,Fail,38,30,9,15,23
100,Fail,44,28,0,15,29
100,Fail,43,30,5,17,26
100,Fail,46,26,7,13,33
100,Fail,51,27,0,9,42
100,Fail,49,23,5,11,38
100,Fail,47,27,0,16,31
100,Fail,45,30,0,13,32
100,Fail,44,35,0,10,34
100,Fail,40,39,0,13,27
100,Fail,44,19,8,20,24
100,Fail,45,32,0,16,29
100,Fail,54,22,0,12,42
100,Fail,46,31,0,9,37
100,Fail,40,33,0,19,21
100,Fail,51,20,5,14,37
100,Fail,50,22,2,13,37
100,Fail,45,36,0,13,32
100,Fail,44,32,0,16,28
100,Fail,54,27,0,6,48
100,Fail,53,24,0,11,42
100,Fail,53,21,0,12,41
100,Fail,47,28,0,14,33
100,Fail,51,28,0,15,36
100,Fail,44,33,0,14,30
100,Fail,44,29,0,19,25
100,Fail,46,30,0,14,32
100,Fail,49,22,0,14,35
100,Fail,48,22,2,14,34
100,Fail,39,35,5,14,25
100,Fail,46,25,0,14,32
100,Fail,52,29,0,8,44
100,Fail,51,29,3,7,44
100,Fail,47,16,1,23,24
100,Fail,50,29,0,10,40
100,Fail,42,37,0,12,30
100,Fail,42,26,5,15,27
100,Fail,51,26,4,9,42
100,Fail,59,18,0,7,52
100,Fail,50,21,6,13,37
100,Fail,57,27,0,8,49
100,Fail,61,17,0,12,49
100,Fail,44,29,0,17,27
100,Fail,44,31,2,14,30
100,Fail,48,34,0,10,38
100,Fail,39,34,3,14,25
100,Fail,48,27,0,13,35
100,Fail,60,19,0,9,51
100,Fail,47,33,0,12,35
100,Fail,45,23,12,9,36
100,Fail,44,34,0,10,34
100,Fail,51,24,0,13,38
100,Fail,52,35,0,4,48
100,Fail,48,25,0,13,35
100,Fail,46,29,0,14,32
100,Fail,46,26,0,15,31
100,Fail,51,19,4,15,36
100,Fail,50,22,0,12,38
100,Fail,56,21,0,9,47
100,Fail,55,24,0,11,44
100,Fail,49,20,2,18,31
100,Fail,51,25,2,14,37
100,Fail,48,21,3,17,31
100,Fail,46,26,1,17,29
100,Fail,50,28,0,12,38
100,Fail,46,32,0,16,30
100,Fail,49,26,7,11,38
100,Fail,50,29,0,12,38
100,Fail,49,31,0,11,38
100,Fail,54,17,4,11,43
100,Fail,53,24,0,12,41
100,Fail,51,24,0,13,38
100,Fail,38,31,5,16,22
100,Fail,48,33,0,11,37
100,Fail,50,28,0,10,40
100,Fail,57,24,1,7,50
100,Fail,46,20,1,17,29
100,Fail,45,30,1,13,32
100,Fail,42,35,0,19,23
100,Fail,46,33,0,10,36
100,Fail,45,24,0,20,25
100,Fail,48,27,0,17,31
100,Fail,46,31,0,10,36
100,Fail,44,28,3,15,29
100,Fail,45,34,0,12,33
100,Fail,49,24,0,13,36
100,Fail,40,35,0,14,26
100,Fail,40,29,3,16,24
100,Fail,51,20,6,10,41
100,Fail,47,23,9,12,35
100,Fail,53,23,0,14,39
100,Fail,44,38,0,14,30
100,Fail,49,29,7,12,37
100,Fail,42,30,0,18,24
100,Fail,48,23,4,13,35
100,Fail,53,29,2,6,47
100,Fail,52,25,0,13,39
100,Fail,44,25,4,18,26
100,Fail,43,28,4,17,26
100,Fail,51,22,3,13,38
100,Fail,45,18,9,19,26
100,Fail,50,19,7,11,39
100,Fail,48,22,3,14,34
100,Fail,55,26,0,9,46
100,Fail,46,23,11,13,33
100,Fail,49,18,0,19,30
100,Fail,52,22,4,13,39
100,Fail,46,28,8,10,36
100,Fail,43,31,3,9,34
100,Fail,48,32,0,11,37
100,Fail,51,29,0,13,38
100,Fail,43,34,0,11,32
100,Fail,46,27,2,14,32
100,Fail,57,25,1,7,50
100,Fail,47,35,0,9,38
100,Fail,51,20,1,12,39
100,Fail,44,26,0,18,26
100,Fail,51,26,1,9,42
100,Fail,46,29,0,11,35
100,Fail,53,21,0,12,41
100,Fail,43,33,0,15,28
100,Fail,38,41,0,17,21
100,Fail,56,26,0,6,50
100,Fail,51,24,0,11,40
100,Fail,56,18,4,14,42
100,Fail,52,23,0,13,39
100,Fail,44,32,6,10,34
100,Fail,49,25,5,9,40
100,Fail,44,19,7,20,24
100,Fail,48,24,0,18,30
100,Fail,48,27,4,11,37
100,Fail,48,34,0,9,39
100,Fail,48,33,0,9,39
100,Fail,49,27,6,10,39
100,Fail,49,21,6,14,35
100,Fail,48,32,1,7,41
100,Fail,55,18,3,8,47
100,Fail,51,32,0,8,43
100,Fail,47,30,0,15,32
100,Fail,45,34,0,14,31
100,Fail,47,28,0,12,35
100,Fail,39,31,4,15,24
100,Fail,58,22,0,9,49
100,Fail,44,30,4,15,29
100,Fail,60,21,0,8,52
100,Fail,52,31,0,7,45
100,Fail,55,19,1,12,43
100,Fail,45,25,5,16,29
100,Fail,47,30,0,12,35
100,Fail,46,30,8,9,37
100,Fail,41,25,2,21,20
100,Fail,53,25,1,10,43
100,Fail,54,20,2,12,42
100,Fail,42,28,3,16,26
100,Fail,52,26,1,11,41
100,Fail,49,22,0,12,37
100,Fail,54,21,3,11,43
100,Fail,54,31,0,6,48
100,Fail,43,32,0,18,25
100,Fail,44,34,0,12,32
100,Fail,44,32,0,14,30
100,Fail,46,30,0,14,32
100,Fail,52,23,3,12,40
100,Fail,48,23,1,18,30
100,Fail,56,21,0,11,45
100,Fail,46,28,1,15,31
100,Fail,47,30,0,12,35
100,Fail,49,24,5,9,40
100,Fail,45,23,7,15,30
100,Fail,50,28,1,10,40
100,Fail,47,24,4,18,29
100,Fail,42,31,3,16,26
100,Fail,44,37,0,9,35
100,Fail,47,29,0,13,34
100,Fail,49,26,2,12,37
100,Fail,44,28,0,19,25
100,Fail,50,32,0,8,42
100,Fail,50,28,0,10,40
100,Fail,42,28,1,18,24
100,Fail,42,34,0,14,28
100,Fail,51,26,1,12,39
100,Fail,46,23,8,13,33
100,Fail,52,25,0,13,39
100,Fail,38,36,10,8,30
100,Fail,46,26,0,12,34
100,Fail,45,24,7,15,30
100,Fail,48,30,0,8,40
100,Fail,50,28,6,9,41
100,Fail,44,30,0,14,30
100,Fail,52,25,0,16,36
100,Fail,50,28,2,11,39
100,Fail,49,23,9,8,41
100,Fail,41,28,0,17,24
100,Fail,43,24,4,17,26
100,Fail,52,20,0,16,36
100,Fail,49,24,0,16,33
100,Fail,49,27,4,9,40
100,Fail,53,19,5,14,39
100,Fail,40,37,0,13,27
100,Fail,45,37,3,8,37
100,Fail,49,20,1,16,33
100,Fail,53,20,5,10,43
100,Fail,53,31,0,7,46
100,Fail,51,22,0,14,37
100,Fail,46,28,0,16,30
100,Fail,45,31,0,12,33
100,Fail,43,22,0,21,22
100,Fail,43,27,15,10,33
100,Fail,48,26,3,7,41
100,Fail,47,29,2,9,38
100,Fail,49,23,0,14,35
100,Fail,44,29,1,13,31
100,Fail,46,26,5,12,34
100,Fail,52,22,4,10,42
100,Fail,47,18,12,14,33
100,Fail,45,33,0,13,32
100,Fail,48,24,2,15,33
100,Fail,39,30,0,21,18
100,Fail,49,23,8,10,39
100,Fail,54,19,3,11,43
100,Fail,53,31,0,10,43
100,Fail,49,34,0,11,38
100,Fail,45,29,0,11,34
100,Fail,38,34,0,17,21
100,Fail,47,24,0,16,31
100,Fail,48,21,0,17,31
100,Fail,53,25,2,11,42
100,Fail,52,26,3,6,46
100,Fail,54,22,0,10,44
100,Fail,48,28,1,13,35
100,Fail,48,30,0,12,36
100,Fail,44,32,0,16,28
100,Fail,46,23,0,18,28
100,Fail,52,26,0,11,41
100,Fail,43,34,0,13,30
100,Fail,42,29,0,14,28
100,Fail,46,34,0,15,31
100,Fail,53,27,3,9,44
100,Fail,38,30,8,14,24
100,Fail,48,31,0,12,36
100,Fail,50,23,0,15,35
100,Fail,51,29,6,8,43
100,Fail,46,31,0,14,32
100,Fail,49,20,1,20,29
100,Fail,54,20,0,15,39
100,Fail,55,21,0,10,45
100,Fail,48,22,8,15,33
100,Fail,50,20,10,10,40
100,Fail,53,25,0,12,41
100,Fail,42,36,2,10,32
100,Fail,47,15,4,24,23
100,Fail,50,24,3,11,39
100,Fail,55,20,0,12,43
100,Fail,51,20,3,14,37
100,Fail,54,25,0,13,41
100,Fail,49,28,0,14,35
100,Fail,40,33,0,14,26
100,Fail,49,26,3,14,35
100,Fail,59,21,0,12,47
100,Fail,47,23,5,15,32
100,Fail,44,31,0,18,26
100,Fail,47,31,0,13,34
100,Fail,47,25,0,17,30
100,Fail,56,29,0,2,54
100,Fail,49,28,0,12,37
100,Fail,35,34,0,26,9
100,Fail,49,26,4,10,39
100,Fail,57,14,0,15,42
100,Fail,48,28,0,13,35
100,Fail,48,33,0,11,37
100,Fail,44,31,0,12,32
100,Fail,50,24,5,9,41
100,Fail,59,18,0,12,47
100,Fail,54,22,7,10,44
100,Fail,55,21,1,12,43
100,Fail,51,29,0,9,42
100,Fail,49,30,0,12,37
100,Fail,50,30,0,12,38
100,Fail,49,26,0,14,35
100,Fail,42,24,12,14,28
100,Fail,49,28,6,7,42
100,Fail,47,32,0,12,35
100,Fail,44,31,5,12,32
100,Fail,47,28,7,12,35
100,Fail,50,31,0,9,41
100,Fail,49,27,0,10,39
100,Fail,45,30,0,15,30
100,Fail,53,24,0,10,43
100,Fail,47,26,0,14,33
100,Fail,48,28,1,9,39
100,Fail,48,33,0,13,35
100,Fail,44,28,4,12,32
100,Fail,47,23,4,14,33
100,Fail,46,33,0,14,32
100,Fail,50,31,0,9,41
100,Fail,39,30,3,14,25
100,Fail,53,24,0,15,38
100,Fail,52,22,0,17,35
100,Fail,40,35,0,16,24
100,Fail,45,26,0,20,25
100,Fail,55,21,0,12,43
100,Fail,54,21,4,8,46
100,Fail,44,32,0,11,33
100,Fail,56,22,0,8,48
100,Fail,45,30,0,16,29
100,Fail,53,19,0,14,39
100,Fail,44,27,8,11,33
100,Fail,42,36,0,16,26
100,Fail,47,29,0,11,36
100,Fail,45,30,0,12,33
100,Fail,42,32,0,11,31
100,Fail,58,20,1,8,50
100,Fail,57,25,0,8,49
100,Fail,46,26,1,12,34
100,Fail,55,26,1,8,47
100,Fail,40,31,2,16,24
100,Fail,50,33,1,7,43
100,Fail,59,17,1,7,52
100,Fail,55,26,0,5,50
100,Fail,46,29,5,11,35
100,Fail,40,24,17,14,26
100,Fail,47,32,0,11,36
100,Fail,49,28,0,16,33
100,Fail,50,22,2,16,34
100,Fail,44,36,0,9,35
100,Fail,53,28,0,10,43
100,Fail,51,29,0,12,39
100,Fail,51,21,1,15,36
100,Fail,54,26,0,11,43
100,Fail,63,17,2,6,57
100,Fail,41,32,0,16,25
100,Fail,42,32,5,11,31
100,Fail,46,28,11,11,35
100,Fail,41,29,3,14,27
100,Fail,55,16,6,12,43
100,Fail,50,22,0,16,34
100,Fail,52,17,4,16,36
100,Fail,50,20,0,16,34
100,Fail,50,25,4,12,38
100,Fail,50,26,0,12,38
100,Fail,44,25,8,15,29
100,Fail,44,26,2,17,27
100,Fail,43,33,0,12,31
100,Fail,50,26,0,12,38
100,Fail,51,22,3,11,40
100,Fail,50,26,2,12,38
100,Fail,55,17,5,14,41
100,Fail,42,39,0,8,34
100,Fail,46,35,0,13,33
100,Fail,51,20,0,16,35
100,Fail,47,28,1,12,35
100,Fail,47,27,0,16,31
100,Fail,47,30,0,12,35
100,Fail,48,19,0,20,28
100,Fail,43,29,1,16,27
100,Fail,46,29,0,15,31
100,Fail,52,18,8,13,39
100,Fail,49,22,0,15,34
100,Fail,51,26,0,10,41
100,Fail,38,40,0,10,28
100,Fail,39,30,1,21,18
100,Fail,50,19,7,14,36
100,Fail,52,27,3,9,43
100,Fail,56,17,3,13,43
100,Fail,54,22,0,13,41
100,Fail,54,16,4,13,41
100,Fail,41,36,0,12,29
100,Fail,50,30,0,10,40
100,Fail,60,20,0,9,51
100,Fail,45,38,0,8,37
100,Fail,53,21,0,14,39
100,Fail,47,23,9,12,35
100,Fail,51,24,0,11,40
100,Fail,50,28,0,13,37
100,Fail,51,24,2,13,38
100,Fail,45,31,5,10,35
100,Fail,57,12,2,13,44
100,Fail,48,33,0,12,36
100,Fail,49,30,0,7,42
100,Fail,49,22,0,15,34
100,Fail,48,23,6,14,34
100,Fail,49,21,7,12,37
100,Fail,49,23,2,15,34
100,Fail,47,25,7,16,31
100,Fail,52,28,0,8,44
100,Fail,45,38,0,10,35
100,Fail,59,17,3,12,47
100,Fail,45,28,0,14,31
100,Fail,48,29,1,10,38
100,Fail,42,28,6,15,27
100,Fail,46,25,3,15,31
100,Fail,48,22,7,12,36
100,Fail,53,25,0,11,42
100,Fail,43,33,4,14,29
100,Fail,46,30,0,12,34
100,Fail,45,32,0,12,33
100,Fail,43,28,5,15,28
100,Fail,44,24,3,16,28
100,Fail,43,34,1,11,32
100,Fail,47,25,0,15,32
100,Fail,42,34,0,11,31
100,Fail,44,38,0,10,34
100,Fail,50,24,3,14,36
100,Fail,41,38,0,10,31
100,Fail,46,26,0,17,29
100,Fail,50,23,0,12,38
100,Fail,44,28,3,15,29
100,Fail,50,22,0,18,32
100,Fail,40,28,0,19,21
100,Fail,44,38,0,10,34
100,Fail,56,17,2,14,42
100,Fail,48,30,0,8,40
100,Fail,49,23,6,12,37
100,Fail,52,22,6,9,43
100,Fail,47,29,0,10,37
100,Fail,45,25,4,14,31
100,Fail,54,31,0,9,45
100,Fail,50,30,0,12,38
100,Fail,43,38,0,9,34
100,Fail,58,16,0,10,48
100,Fail,53,31,0,9,44
100,Fail,55,23,4,8,47
100,Fail,54,27,0,7,47
100,Fail,53,24,0,11,42
100,Fail,48,23,5,15,33
100,Fail,51,25,0,13,38
100,Fail,46,25,8,15,31
100,Fail,51,35,0,5,46
100,Fail,45,28,0,17,28
100,Fail,45,26,1,17,28
100,Fail,49,31,0,7,42
100,Fail,40,28,0,23,17
100,Fail,46,26,3,15,31
100,Fail,50,28,1,7,43
100,Fail,48,32,0,12,36
100,Fail,49,30,0,12,37
100,Fail,52,18,1,20,32
100,Fail,47,30,3,12,35
100,Fail,40,26,13,14,26
100,Fail,49,21,7,12,37
100,Fail,49,33,0,10,39
100,Fail,57,27,0,10,47
100,Fail,55,20,0,9,46
100,Fail,51,29,0,9,42
100,Fail,41,37,0,12,29
100,Fail,51,26,0,13,38
100,Fail,58,16,1,13,45
100,Fail,45,30,0,11,34
100,Fail,40,32,0,19,21
100,Fail,49,25,1,13,36
100,Fail,47,32,2,8,39
100,Fail,46,31,0,14,32
100,Fail,47,28,1,11,36
100,Fail,45,32,1,16,29
100,Fail,45,33,0,14,31
100,Fail,55,24,0,13,42
100,Fail,54,20,1,14,40
100,Fail,48,34,0,10,38
100,Fail,47,28,0,12,35
100,Fail,48,33,0,11,37
100,Fail,43,27,0,21,22
100,Fail,47,32,0,11,36
100,Fail,54,23,0,10,44
100,Fail,44,38,0,10,34
100,Fail,44,27,0,16,28
100,Fail,50,24,2,12,38
100,Fail,51,21,10,9,42
100,Fail,54,21,0,11,43
100,Fail,51,24,6,14,37
100,Fail,45,21,4,22,23
100,Fail,48,24,0,18,30
100,Fail,41,26,0,21,20
100,Fail,49,27,6,11,38
100,Fail,42,29,0,17,25
100,Fail,50,24,4,9,41
100,Fail,40,33,6,11,29
100,Fail,45,31,0,14,31
100,Fail,50,27,0,14,36
100,Fail,44,31,0,15,29
100,Fail,50,26,3,12,38
100,Fail,45,29,0,12,33
100,Fail,51,25,7,11,40
100,Fail,51,33,0,9,42
100,Fail,49,18,11,11,38
100,Fail,46,27,0,12,34
100,Fail,51,21,1,14,37
100,Fail,50,30,0,13,37
100,Fail,47,24,0,12,35
100,Fail,40,36,0,10,30
100,Fail,57,21,1,7,50
100,Fail,46,28,0,16,30
100,Fail,49,27,2,11,38
100,Fail,59,19,1,7,52
100,Fail,48,35,0,9,39
100,Fail,44,26,5,12,32
100,Fail,45,31,0,16,29
100,Fail,55,20,1,12,43
100,Fail,44,24,6,19,25
100,Fail,49,22,4,16,33
100,Fail,54,21,1,13,41
100,Fail,47,27,4,9,38
100,Fail,46,23,9,11,35
100,Fail,47,18,10,12,35
100,Fail,48,29,0,11,37
100,Fail,56,21,0,11,45
100,Fail,43,32,0,17,26
100,Fail,41,30,1,17,24
100,Fail,45,26,5,16,29
100,Fail,52,21,4,12,40
100,Fail,50,25,0,13,37
100,Fail,46,32,0,12,34
100,Fail,39,37,0,16,23
100,Fail,57,25,0,9,48
100,Fail,48,27,0,12,36
100,Fail,42,24,4,14,28
100,Fail,43,25,0,21,22
100,Fail,46,32,0,11,35
100,Fail,45,38,0,10,35
100,Fail,49,30,0,10,39
100,Fail,45,31,0,11,34
100,Fail,44,28,0,19,25
100,Fail,44,26,12,9,35
100,Fail,55,22,4,10,45
100,Fail,50,25,1,7,43
100,Fail,51,28,0,11,40
100,Fail,54,20,1,13,41
100,Fail,45,26,4,12,33
100,Fail,46,27,0,16,30
100,Fail,50,26,3,12,38
100,Fail,44,21,10,17,27
100,Fail,45,36,0,12,33
100,Fail,52,22,2,13,39
100,Fail,48,22,0,19,29
100,Fail,43,21,6,21,22
100,Fail,51,32,0,8,43
100,Fail,46,29,0,14,32
100,Fail,47,30,6,9,38
100,Fail,44,30,2,13,31
100,Fail,54,20,0,13,41
100,Fail,54,26,0,12,42
100,Fail,50,28,2,9,41
100,Fail,43,37,0,14,29
100,Fail,41,34,1,10,31
100,Fail,47,26,0,17,30
100,Fail,47,28,0,16,31
100,Fail,55,29,0,8,47
100,Fail,48,31,0,11,37
100,Fail,49,22,2,13,36
100,Fail,50,32,0,7,43
100,Fail,52,24,0,11,41
100,Fail,52,21,0,16,36
100,Fail,46,38,0,8,38
100,Fail,44,36,0,9,35
100,Fail,42,31,0,18,24
100,Fail,49,20,0,17,32
100,Fail,44,33,0,13,31
100,Fail,47,26,4,9,38
100,Fail,49,23,4,14,35
100,Fail,44,31,3,11,33
100,Fail,48,26,0,17,31
100,Fail,50,25,0,13,37
100,Fail,40,45,0,7,33
100,Fail,43,24,9,15,28
100,Fail,44,22,11,12,32
100,Fail,51,23,3,11,40
100,Fail,42,27,6,16,26
100,Fail,56,19,0,13,43
100,Fail,43,26,7,18,25
100,Fail,52,23,1,11,41
100,Fail,52,25,2,10,42
100,Fail,43,33,0,17,26
100,Fail,47,35,0,15,32
100,Fail,56,20,0,13,43
100,Fail,39,46,0,8,31
100,Fail,46,23,1,13,33
100,Fail,47,25,9,13,34
100,Fail,49,21,1,13,36
100,Fail,55,17,2,13,42
100,Fail,51,30,0,9,42
100,Fail,43,37,0,13,30
100,Fail,53,25,1,9,44
100,Fail,43,32,0,12,31
100,Fail,48,25,1,14,34
100,Fail,52,23,4,14,38
100,Fail,50,27,1,12,38
100,Fail,49,15,8,15,34
100,Fail,44,28,7,16,28
100,Fail,40,39,0,12,28
100,Fail,45,25,8,11,34
100,Fail,46,30,0,12,34
100,Fail,44,26,7,14,30
100,Fail,47,24,0,16,31
100,Fail,54,29,0,5,49
100,Fail,58,19,3,4,54
100,Fail,54,25,1,10,44
100,Fail,49,31,0,11,38
100,Fail,41,29,0,17,24
100,Fail,50,28,0,15,35
100,Fail,57,20,7,6,51
100,Fail,44,30,0,15,29
100,Fail,49,31,2,9,40
100,Fail,47,24,1,15,32
100,Fail,44,30,0,16,28
100,Fail,51,26,0,14,37
100,Fail,48,22,1,12,36
100,Fail,44,27,3,15,29
100,Fail,48,37,0,9,39
100,Fail,52,24,0,13,39
100,Fail,46,27,4,12,34
100,Fail,48,25,7,13,35
100,Fail,54,23,0,14,40
100,Fail,46,28,2,13,33
100,Fail,50,17,5,14,36
100,Fail,43,29,3,14,29
100,Fail,41,30,7,15,26
100,Fail,45,24,5,15,30
100,Fail,48,30,0,12,36
100,Fail,48,24,5,11,37
100,Fail,48,27,0,16,32
100,Fail,44,35,0,12,32
100,Fail,49,29,4,7,42
100,Fail,47,23,5,15,32
100,Fail,46,32,0,7,39
100,Fail,46,31,0,11,35
100,Fail,54,23,0,11,43
100,Fail,51,29,0,10,41
100,Fail,48,29,0,12,36
100,Fail,51,30,0,10,41
100,Fail,52,23,0,13,39
100,Fail,51,26,0,9,42
100,Fail,44,26,0,19,25
100,Fail,48,34,0,6,42
100,Fail,41,31,0,15,26
100,Fail,44,29,2,13,31
100,Fail,44,30,8,13,31
100,Fail,49,23,0,13,36
100,Fail,49,14,4,23,26
100,Fail,57,21,0,12,45
100,Fail,42,39,0,11,31
100,Fail,57,24,0,7,50
100,Fail,52,21,0,13,39
100,Fail,45,26,3,17,28
100,Fail,50,27,2,13,37
100,Fail,46,34,0,10,36
100,Fail,49,24,9,11,38
100,Fail,55,21,2,11,44
100,Fail,51,25,0,10,41
100,Fail,51,21,5,12,39
100,Fail,53,17,9,13,40
100,Fail,43,31,0,15,28
100,Fail,50,33,5,4,46
100,Fail,47,23,4,16,31
100,Fail,43,25,8,13,30
100,Fail,42,36,0,8,34
100,Fail,44,31,0,13,31
100,Fail,41,36,0,16,25
100,Fail,43,27,2,15,28
100,Fail,52,26,1,10,42
100,Fail,47,29,0,12,35
100,Fail,42,33,5,11,31
100,Fail,43,32,0,14,29
100,Fail,44,27,0,16,28
100,Fail,40,41,0,13,27
100,Fail,41,35,0,13,28
100,Fail,52,25,3,9,43
100,Fail,52,24,0,15,37
100,Fail,53,21,1,11,42
100,Fail,59,18,0,13,46
100,Fail,45,30,0,14,31
100,Fail,50,20,6,13,37
100,Fail,59,22,1,9,50
100,Fail,41,31,0,18,23
100,Fail,50,28,0,14,36
100,Fail,49,23,1,15,34
100,Fail,44,24,8,15,29
100,Fail,40,28,6,18,22
100,Fail,55,21,0,9,46
100,Fail,55,21,0,16,39
100,Fail,43,29,5,11,32
100,Fail,48,32,0,10,38
100,Fail,50,30,0,10,40
100,Fail,53,20,4,16,37
100,Fail,51,19,4,14,37
100,Fail,50,24,0,17,33
100,Fail,46,30,2,13,33
100,Fail,40,34,0,18,22
100,Fail,52,24,2,10,42
100,Fail,55,24,3,9,46
100,Fail,49,23,5,16,33
100,Fail,42,36,0,11,31
100,Fail,42,28,9,14,28
100,Fail,52,23,2,8,44
100,Fail,50,23,0,15,35
100,Fail,47,24,6,13,34
100,Fail,49,19,9,16,33
100,Fail,45,23,2,16,29
100,Fail,56,20,0,10,46
100,Fail,51,25,0,8,43
100,Fail,41,30,0,18,23
100,Fail,54,22,0,11,43
100,Fail,45,28,0,19,26
100,Fail,45,39,0,8,37
100,Fail,47,19,4,18,29
100,Fail,47,27,3,13,34
100,Fail,51,25,1,16,35
100,Fail,52,18,1,13,39
100,Fail,49,20,0,18,31
100,Fail,49,25,0,14,35
100,Fail,41,29,0,22,19
100,Fail,51,24,4,15,36
100,Fail,41,22,6,21,20
100,Fail,36,32,16,10,26
100,Fail,49,27,0,17,32
100,Fail,54,25,1,11,43
100,Fail,46,25,2,15,31
100,Fail,47,19,1,18,29
100,Fail,45,26,0,17,28
100,Fail,49,25,0,14,35
100,Fail,60,20,0,6,54
100,Fail,49,27,6,7,42
100,Fail,41,31,0,17,24
100,Fail,50,28,2,8,42
100,Fail,57,18,4,12,45
100,Fail,46,20,7,19,27
100,Fail,54,18,0,19,35
100,Fail,51,21,1,15,36
100,Fail,47,31,2,7,40
100,Fail,52,21,0,17,35
100,Fail,46,30,0,10,36
100,Fail,51,28,0,6,45
100,Fail,53,20,0,17,36
100,Fail,51,26,0,12,39
100,Fail,51,24,0,15,36
100,Fail,48,34,0,6,42
100,Fail,49,29,0,14,35
100,Fail,48,27,0,12,36
100,Fail,59,27,0,7,52
100,Fail,43,27,0,15,28
100,Fail,47,23,0,18,29
100,Fail,49,28,0,16,33
100,Fail,51,24,0,10,41
100,Fail,48,24,0,19,29
100,Fail,47,33,0,13,34
100,Fail,48,28,0,13,35
100,Fail,47,26,6,9,38
100,Fail,47,33,0,10,37
100,Fail,51,30,1,8,43
100,Fail,53,26,0,8,45
100,Fail,47,27,2,14,33
100,Fail,40,34,0,15,25
100,Fail,45,32,0,12,33
100,Fail,53,31,0,7,46
100,Fail,50,30,0,14,36
100,Fail,50,23,3,12,38
100,Fail,48,27,0,13,35
100,Fail,45,28,4,15,30
100,Fail,45,29,0,17,28
100,Fail,48,27,1,14,34
100,Fail,48,28,0,14,34
100,Fail,53,24,3,13,40
100,Fail,49,25,0,15,34
100,Fail,45,22,7,13,32
100,Fail,52,25,0,14,38
100,Fail,49,26,0,16,33
100,Fail,51,23,0,15,36
100,Fail,51,28,2,9,42
100,Fail,51,27,1,10,41
100,Fail,42,25,5,18,24
100,Fail,54,28,0,9,45
100,Fail,44,33,0,10,34
100,Fail,52,24,5,12,40
100,Fail,50,25,3,11,39
100,Fail,57,20,0,12,45
100,Fail,48,21,0,19,29
100,Fail,56,25,0,7,49
100,Fail,51,28,0,9,42
100,Fail,49,27,0,13,36
100,Fail,54,24,0,13,41
100,Fail,54,25,0,6,48
100,Fail,46,24,1,15,31
100,Fail,51,28,0,11,40
100,Fail,48,24,2,16,32
100,Fail,37,38,0,15,22
100,Fail,48,27,1,11,37
100,Fail,57,17,0,14,43
100,Fail,42,24,10,16,26
100,Fail,47,28,5,10,37
100,Fail,48,31,0,11,37
100,Fail,42,26,6,12,30
100,Fail,46,31,2,12,34
100,Fail,47,28,0,11,36
100,Fail,42,39,0,9,33
100,Fail,46,26,4,14,32
100,Fail,47,33,0,8,39
100,Fail,49,27,3,13,36
100,Fail,45,27,0,16,29
100,Fail,57,22,0,10,47
100,Fail,48,30,2,11,37
100,Fail,47,36,3,7,40
100,Fail,49,29,0,10,39
100,Fail,43,34,0,11,32
100,Fail,49,27,0,13,36
100,Fail,57,20,6,6,51
100,Fail,52,26,1,10,42
100,Fail,44,36,0,11,33
100,Fail,50,27,0,12,38
100,Fail,51,17,1,14,37
100,Fail,40,35,0,16,24
100,Fail,53,27,0,8,45
100,Fail,46,31,0,14,32
100,Fail,49,26,2,11,38
100,Fail,54,17,0,16,38
100,Fail,43,31,0,13,30
100,Fail,55,21,1,12,43
100,Fail,44,25,7,15,29
100,Fail,53,21,0,13,40
100,Fail,47,21,0,12,35
100,Fail,50,26,0,17,33
100,Fail,48,30,0,13,35
100,Fail,47,34,0,12,35
100,Fail,49,29,0,14,35
100,Fail,47,27,0,9,38
100,Fail,47,28,0,11,36
100,Fail,46,36,0,9,37
100,Fail,60,21,0,6,54
100,Fail,45,30,0,17,28
100,Fail,44,34,0,12,32
100,Fail,54,24,5,9,45
100,Fail,51,21,4,13,38
100,Fail,43,21,5,22,21
100,Fail,46,38,0,10,36
100,Fail,49,27,0,13,36
100,Fail,56,26,0,9,47
100,Fail,41,34,0,15,26
100,Fail,40,36,0,17,23
100,Fail,43,29,9,10,33
100,Fail,48,25,5,14,34
100,Fail,50,33,3,4,46
100,Fail,50,24,3,11,39
100,Fail,52,23,7,8,44
100,Fail,52,26,4,8,44
100,Fail,48,33,0,7,41
100,Fail,53,28,0,10,43
100,Fail,50,21,0,16,34
100,Fail,47,30,0,13,34
100,Fail,48,28,0,13,35
100,Fail,55,25,0,9,46
100,Fail,47,33,0,11,36
100,Fail,38,33,4,20,18
100,Fail,52,28,0,10,42
100,Fail,51,28,0,11,40
100,Fail,48,26,0,12,36
100,Fail,44,35,0,12,32
100,Fail,47,21,3,19,28
100,Fail,51,29,0,9,42
100,Fail,55,31,0,3,52
100,Fail,41,34,0,15,26
100,Fail,47,27,0,16,31
100,Fail,46,41,0,7,39
100,Fail,49,28,0,12,37
100,Fail,48,30,1,11,37
100,Fail,42,30,5,15,27
100,Fail,54,24,0,12,42
100,Fail,46,25,4,13,33
100,Fail,55,29,0,11,44
100,Fail,38,25,11,20,18
100,Fail,49,23,3,14,35
100,Fail,52,20,1,14,38
100,Fail,47,28,0,13,34
100,Fail,49,28,0,13,36
100,Fail,54,19,0,17,37
100,Fail,44,25,5,14,30
100,Fail,54,25,1,7,47
100,Fail,51,22,0,13,38
100,Fail,42,26,0,18,24
100,Fail,45,25,5,15,30
100,Fail,38,41,0,17,21
100,Fail,56,21,5,9,47
100,Fail,39,32,1,16,23
100,Fail,49,23,8,9,40
100,Fail,41,36,0,13,28
100,Fail,44,30,0,15,29
100,Fail,57,22,0,10,47
100,Fail,52,21,0,14,38
100,Fail,54,20,0,11,43
100,Fail,49,32,0,10,39
100,Fail,49,21,4,14,35
100,Fail,45,27,6,14,31
100,Fail,49,24,0,16,33
100,Fail,43,30,0,18,25
100,Fail,51,24,0,15,36
100,Fail,49,27,0,15,34
100,Fail,40,36,0,13,27
100,Fail,54,22,0,11,43
100,Fail,47,20,8,14,33
100,Fail,49,33,0,10,39
100,Fail,37,40,0,13,24
100,Fail,57,16,5,11,46
100,Fail,51,25,1,11,40
100,Fail,42,32,0,16,26
100,Fail,45,27,2,13,32
100,Fail,42,27,0,18,24
100,Fail,51,26,0,14,37
100,Fail,55,29,0,6,49
100,Fail,53,23,0,14,39
100,Fail,50,19,1,17,33
100,Fail,55,25,3,7,48
100,Fail,48,23,8,10,38
100,Fail,48,29,0,13,35
100,Fail,48,26,0,15,33
100,Fail,50,21,4,14,36
100,Fail,46,29,8,10,36
100,Fail,43,32,0,18,25
100,Fail,43,30,0,18,25
100,Fail,52,26,5,9,43
100,Fail,50,29,0,10,40
100,Fail,51,20,1,16,35
100,Fail,49,23,1,14,35
100,Fail,47,21,2,19,28
100,Fail,57,19,0,11,46
100,Fail,41,33,2,14,27
100,Fail,53,23,0,10,43
100,Fail,45,32,0,14,31
100,Fail,52,24,3,12,40
100,Fail,49,23,3,15,34
100,Fail,52,25,6,6,46
100,Fail,41,27,1,20,21
100,Fail,46,28,0,13,33
100,Fail,47,24,0,16,31
100,Fail,42,38,0,9,33
100,Fail,54,16,2,15,39
100,Fail,47,37,0,7,40
100,Fail,53,26,0,10,43
100,Fail,51,25,0,12,39
100,Fail,46,23,4,18,28
100,Fail,46,26,2,15,31
100,Fail,41,36,1,12,29
100,Fail,49,26,3,12,37
100,Fail,43,30,0,17,26
100,Fail,44,30,5,12,32
100,Fail,47,31,0,12,35
100,Fail,48,26,2,14,34
100,Fail,57,26,1,4,53
100,Fail,49,27,0,16,33
100,Fail,46,27,5,13,33
100,Fail,44,29,0,15,29
100,Fail,44,35,0,12,32
100,Fail,47,23,7,15,32
100,Fail,56,27,4,6,50
100,Fail,42,36,0,12,30
100,Fail,44,36,0,12,32
100,Fail,45,19,17,16,29
100,Fail,55,22,7,7,48
100,Fail,49,25,4,12,37
100,Fail,58,19,0,8,50
100,Fail,46,14,3,24,22
100,Fail,53,22,0,12,41
100,Fail,42,37,0,13,29
100,Fail,56,24,0,8,48
100,Fail,45,33,1,13,32
100,Fail,53,24,0,12,41
100,Fail,51,21,0,18,33
100,Fail,54,26,3,8,46
100,Fail,39,28,11,21,18
100,Fail,42,22,2,18,24
100,Fail,44,24,5,18,26
100,Fail,47,30,0,14,33
100,Fail,49,22,1,18,31
100,Fail,47,28,0,17,30
100,Fail,53,27,0,12,41
100,Fail,53,19,3,10,43
100,Fail,47,27,4,11,36
100,Fail,37,41,0,12,25
100,Fail,44,27,0,16,28
100,Fail,46,26,4,14,32
100,Fail,53,26,0,7,46
100,Fail,54,24,0,8,46
100,Fail,48,24,1,14,34
100,Fail,50,24,5,11,39
100,Fail,49,26,0,11,38
100,Fail,38,26,4,21,17
100,Fail,42,26,6,15,27
100,Fail,50,26,0,10,40
100,Fail,49,27,6,11,38
100,Fail,40,37,0,15,25
100,Fail,53,21,5,8,45
100,Fail,44,30,3,15,29
100,Fail,44,29,3,14,30
100,Fail,49,28,0,10,39
100,Fail,52,18,2,16,36
100,Fail,47,29,5,9,38
100,Fail,47,24,5,13,34
100,Fail,47,28,0,12,35
100,Fail,45,41,0,10,35
100,Fail,47,23,0,17,30
100,Fail,40,36,0,15,25
100,Fail,52,24,0,13,39
100,Fail,55,19,1,11,44
100,Fail,41,32,0,19,22
100,Fail,43,19,13,17,26
100,Fail,40,34,0,18,22
100,Fail,48,25,1,13,35
100,Fail,55,19,0,12,43
100,Fail,45,30,0,15,30
100,Fail,51,25,0,15,36
100,Fail,48,27,0,12,36
100,Fail,56,22,1,11,45
100,Fail,39,40,0,17,22
100,Fail,44,23,8,15,29
100,Fail,45,29,2,11,34
100,Fail,44,27,0,16,28
100,Fail,45,29,0,19,26
100,Fail,56,21,0,10,46
100,Fail,50,26,0,13,37
100,Fail,44,39,0,7,37
100,Fail,43,30,5,16,27
100,Fail,48,29,0,14,34
100,Fail,46,22,4,15,31
100,Fail,43,37,0,9,34
100,Fail,53,25,0,10,43
100,Fail,48,28,0,11,37
100,Fail,48,25,0,13,35
100,Fail,46,33,0,13,33
100,Fail,51,24,0,11,40
100,Fail,39,27,0,21,18
100,Fail,53,20,0,13,40
100,Fail,48,23,0,17,31
100,Fail,53,23,4,10,43
100,Fail,52,21,0,13,39
100,Fail,47,29,3,12,35
100,Fail,48,26,0,15,33
100,Fail,38,31,7,14,24
100,Fail,56,24,2,11,45
100,Fail,41,31,8,11,30
100,Fail,45,28,2,15,30
100,Fail,45,27,3,12,33
100,Fail,50,22,2,15,35
100,Fail,42,27,8,11,31
100,Fail,58,21,6,10,48
100,Fail,52,23,0,13,39
100,Fail,46,28,0,16,30
100,Fail,42,32,0,15,27
100,Fail,48,22,7,16,32
100,Fail,45,30,2,11,34
100,Fail,51,26,2,11,40
100,Fail,53,23,5,9,44
100,Fail,48,21,6,16,32
100,Fail,41,36,0,11,30
100,Fail,46,25,0,15,31
100,Fail,52,25,0,10,42
100,Fail,48,30,0,13,35
100,Fail,57,18,0,12,45
100,Fail,48,32,0,10,38
100,Fail,54,24,0,12,42
100,Fail,48,26,0,13,35
100,Fail,51,21,6,13,38
100,Fail,45,30,0,14,31
100,Fail,50,26,9,6,44
100,Fail,51,28,0,11,40
100,Fail,47,34,0,13,34
100,Fail,46,32,0,10,36
100,Fail,49,19,8,14,35
100,Fail,55,30,0,9,46
100,Fail,54,26,0,8,46
100,Fail,47,27,0,15,32
100,Fail,50,32,0,13,37
100,Fail,56,24,2,2,54
100,Fail,53,22,0,14,39
100,Fail,44,25,9,12,32
100,Fail,56,23,1,12,44
100,Fail,53,26,0,8,45
100,Fail,47,27,2,11,36
100,Fail,42,32,1,15,27
100,Fail,46,29,1,11,35
100,Fail,43,35,2,11,32
100,Fail,50,24,4,15,35
100,Fail,53,18,1,10,43
100,Fail,44,36,0,13,31
100,Fail,50,24,1,10,40
100,Fail,49,24,3,10,39
100,Fail,49,26,0,12,37
100,Fail,48,23,0,12,36
100,Fail,55,22,7,7,48
100,Fail,43,28,0,12,31
100,Fail,46,31,0,14,32
100,Fail,48,24,0,16,32
100,Fail,48,26,0,15,33
100,Fail,51,23,0,14,37
100,Fail,47,27,0,15,32
100,Fail,52,26,5,9,43
100,Fail,54,28,0,10,44
100,Fail,47,34,0,10,37
100,Fail,47,36,0,11,36
100,Fail,59,19,0,11,48
100,Fail,42,28,0,17,25
100,Fail,47,29,0,11,36
100,Fail,48,28,5,10,38
100,Fail,53,20,0,12,41
100,Fail,46,32,0,7,39
100,Fail,54,20,1,13,41
100,Fail,51,25,1,15,36
100,Fail,46,22,10,12,34
100,Fail,51,24,7,11,40
100,Fail,42,33,0,15,27
100,Fail,42,36,0,15,27
100,Fail,51,30,0,8,43
100,Fail,52,26,4,12,40
100,Fail,45,32,0,12,33
100,Fail,50,35,0,8,42
100,Fail,47,22,5,17,30
100,Fail,42,35,0,15,27
100,Fail,53,18,0,12,41
100,Fail,44,27,0,16,28
100,Fail,48,24,0,16,32
100,Fail,42,38,0,15,27
100,Fail,39,31,11,12,27
100,Fail,47,32,0,11,36
100,Fail,45,28,6,11,34
100,Fail,49,27,0,10,39
100,Fail,59,22,4,6,53
100,Fail,46,28,0,8,38
100,Fail,46,30,6,10,36
100,Fail,52,29,0,7,45
100,Fail,43,39,0,11,32
100,Fail,51,23,4,8,43
100,Fail,52,21,0,15,37
100,Fail,43,37,0,13,30
100,Fail,54,20,5,13,41
100,Fail,53,23,0,12,41
100,Fail,45,31,0,14,31
100,Fail,43,36,0,13,30
100,Fail,41,29,12,11,30
100,Fail,47,25,0,16,31
100,Fail,44,28,7,9,35
100,Fail,55,24,0,9,46
100,Fail,48,21,4,14,34
100,Fail,46,23,1,14,32
100,Fail,46,28,0,14,32
100,Fail,49,25,0,14,35
100,Fail,48,27,0,13,35
100,Fail,50,33,0,10,40
100,Fail,41,32,0,19,22
100,Fail,49,31,0,10,39
100,Fail,53,28,0,8,45
100,Fail,48,26,2,16,32
100,Fail,48,25,2,11,37
100,Fail,38,35,0,19,19
100,Fail,49,32,0,10,39
100,Fail,55,28,0,7,48
100,Fail,50,24,8,13,37
100,Fail,49,28,0,11,38
100,Fail,43,33,4,13,30
100,Fail,48,25,4,14,34
100,Fail,45,30,0,18,27
100,Fail,42,30,0,16,26
100,Fail,52,29,0,8,44
100,Fail,47,27,2,11,36
100,Fail,48,28,0,15,33
100,Fail,53,20,1,14,39
100,Fail,45,32,0,14,31
100,Fail,49,29,0,15,34
100,Fail,46,28,1,13,33
100,Fail,52,28,0,11,41
100,Fail,48,31,0,11,37
100,Fail,48,28,0,12,36
100,Fail,46,32,1,9,37
100,Fail,47,28,0,13,34
100,Fail,51,31,0,9,42
100,Fail,52,28,2,8,44
100,Fail,44,31,2,12,32
100,Fail,50,25,0,12,38
100,Fail,44,29,2,16,28
100,Fail,54,14,7,12,42
100,Fail,46,35,0,12,34
100,Fail,47,27,3,13,34
100,Fail,49,26,3,9,40
100,Fail,52,20,10,12,40
100,Fail,49,28,0,9,40
100,Fail,54,19,0,15,39
100,Fail,48,30,0,13,35
100,Fail,48,26,0,15,33
100,Fail,45,34,0,13,32
100,Fail,50,23,1,12,38
100,Fail,57,17,3,11,46
100,Fail,50,24,0,14,36
100,Fail,50,24,6,9,41
100,Fail,52,26,0,12,40
100,Fail,46,40,0,8,38
100,Fail,50,29,1,8,42
100,Fail,44,28,0,20,24
100,Fail,43,28,1,21,22
100,Fail,55,24,0,7,48
100,Fail,46,21,0,19,27
100,Fail,52,25,0,11,41
100,Fail,47,26,1,17,30
100,Fail,51,29,0,8,43
100,Fail,44,32,0,13,31
100,Fail,52,18,2,14,38
100,Fail,45,32,0,12,33
100,Fail,43,30,4,14,29
100,Fail,51,21,0,13,38
100,Fail,48,26,4,11,37
100,Fail,50,22,7,9,41
100,Fail,50,24,3,8,42
100,Fail,49,29,1,7,42
100,Fail,51,25,0,14,37
100,Fail,48,29,1,13,35
100,Fail,51,21,2,9,42
100,Fail,49,21,2,16,33
100,Fail,57,20,1,10,47
100,Fail,50,25,0,15,35
100,Fail,40,35,0,14,26
100,Fail,43,31,0,15,28
100,Fail,54,23,0,11,43
100,Fail,53,26,0,10,43
100,Fail,45,27,5,15,30
100,Fail,50,25,0,15,35
100,Fail,43,36,0,11,32
100,Fail,44,25,10,11,33
100,Fail,40,37,0,14,26
100,Fail,47,29,0,17,30
100,Fail,50,20,5,12,38
100,Fail,52,20,0,11,41
100,Fail,47,28,9,9,38
100,Fail,52,25,5,8,44
100,Fail,51,26,6,8,43
100,Fail,54,25,0,10,44
100,Fail,45,24,0,21,24
100,Fail,53,21,4,11,42
100,Fail,48,29,6,10,38
100,Fail,41,31,6,15,26
100,Fail,51,31,0,11,40
100,Fail,51,26,4,10,41
100,Fail,44,27,8,12,32
100,Fail,43,28,2,17,26
100,Fail,49,20,1,17,32
100,Fail,50,34,0,5,45
100,Fail,43,36,0,13,30
100,Fail,51,26,1,7,44
100,Fail,48,29,0,14,34
100,Fail,46,30,0,12,34
100,Fail,43,29,0,14,29
100,Fail,56,19,2,13,43
100,Fail,43,26,9,15,28
100,Fail,50,26,0,10,40
100,Fail,47,30,1,12,35
100,Fail,51,25,0,14,37
100,Fail,52,27,0,7,45
100,Fail,45,25,4,16,29
100,Fail,44,31,0,14,30
100,Fail,47,30,4,11,36
100,Fail,51,27,1,10,41
100,Fail,44,33,0,14,30
100,Fail,44,34,5,12,32
100,Fail,46,28,6,13,33
100,Fail,49,25,3,6,43
100,Fail,51,20,9,14,37
100,Fail,48,20,0,20,28
100,Fail,45,32,0,10,35
100,Fail,50,23,0,15,35
100,Fail,53,21,2,10,43
100,Fail,40,36,0,14,26
100,Fail,44,29,7,12,32
100,Fail,49,29,0,10,39
100,Fail,55,23,5,7,48
100,Fail,47,23,7,10,37
100,Fail,46,25,0,16,30
100,Fail,55,22,0,11,44
100,Fail,48,23,5,13,35
100,Fail,41,29,0,22,19
100,Fail,46,31,2,9,37
100,Fail,50,26,0,13,37
100,Fail,48,29,0,13,35
100,Fail,51,25,0,15,36
100,Fail,43,27,0,12,31
100,Fail,54,18,1,14,40
100,Fail,45,28,0,17,28
100,Fail,46,29,5,10,36
100,Fail,50,26,6,8,42
100,Fail,47,35,0,11,36
100,Fail,44,29,0,13,31
100,Fail,50,31,0,10,40
100,Fail,44,34,0,12,32
100,Fail,44,33,0,14,30
100,Fail,51,27,6,10,41
100,Fail,47,32,3,12,35
100,Fail,51,24,0,13,38
100,Fail,47,30,0,11,36
100,Fail,46,25,0,15,31
100,Fail,36,30,12,15,21
100,Fail,50,29,4,9,41
100,Fail,45,32,0,15,30
100,Fail,45,30,3,12,33
100,Fail,58,22,0,11,47
100,Fail,50,29,3,8,42
100,Fail,48,34,0,9,39
100,Fail,50,17,2,20,30
100,Fail,47,23,7,10,37
100,Fail,51,28,1,7,44
100,Fail,47,25,8,10,37
100,Fail,48,24,0,14,34
100,Fail,53,28,1,8,45
100,Fail,40,41,0,9,31
100,Fail,44,29,3,12,32
100,Fail,37,43,0,14,23
100,Fail,47,26,5,15,32
100,Fail,48,29,0,13,35
100,Fail,44,33,0,13,31
100,Fail,42,28,2,17,25
100,Fail,45,24,7,18,27
100,Fail,45,32,0,14,31
100,Fail,53,28,0,10,43
100,Fail,52,17,8,14,38
100,Fail,32,35,12,14,18
100,Fail,48,29,0,9,39
100,Fail,54,28,0,11,43
100,Fail,55,24,2,9,46
100,Fail,54,23,2,13,41
100,Fail,48,29,0,12,36
100,Fail,44,25,0,18,26
100,Fail,48,23,1,16,32
100,Fail,51,19,7,11,40
100,Fail,49,27,1,11,38
100,Fail,56,27,0,8,48
100,Fail,55,16,0,12,43
100,Fail,45,33,4,8,37
100,Fail,42,31,5,12,30
100,Fail,44,25,9,11,33
100,Fail,55,23,0,10,45
100,Fail,47,19,3,19,28
100,Fail,56,21,2,11,45
100,Fail,54,22,5,13,41
100,Fail,41,29,8,11,30
100,Fail,55,24,0,9,46
100,Fail,48,27,1,15,33
100,Fail,54,21,0,13,41
100,Fail,49,28,9,7,42
100,Fail,44,35,8,5,39
100,Fail,40,43,0,11,29
100,Fail,52,23,7,11,41
100,Fail,51,23,2,13,38
100,Fail,51,30,0,10,41
100,Fail,54,19,1,17,37
100,Fail,53,22,8,9,44
100,Fail,48,28,0,12,36
100,Fail,43,34,0,14,29
100,Fail,51,27,0,8,43
100,Fail,46,28,2,11,35
100,Fail,48,34,0,5,43
100,Fail,39,33,5,16,23
100,Fail,56,16,2,11,45
100,Fail,50,24,0,17,33
100,Fail,48,33,0,10,38
100,Fail,51,30,0,13,38
100,Fail,43,37,0,12,31
100,Fail,54,29,0,6,48
100,Fail,52,21,4,15,37
100,Fail,48,25,3,11,37
100,Fail,53,21,0,12,41
100,Fail,47,33,0,7,40
100,Fail,51,24,0,13,38
100,Fail,49,21,2,18,31
100,Fail,48,26,3,10,38
100,Fail,59,20,2,9,50
100,Fail,41,36,0,11,30
100,Fail,51,25,0,10,41
100,Fail,44,30,0,15,29
100,Fail,50,32,0,9,41
100,Fail,50,27,4,9,41
100,Fail,53,23,0,8,45
100,Fail,46,26,5,12,34
100,Fail,47,39,0,6,41
100,Fail,42,40,0,8,34
100,Fail,49,29,0,11,38
100,Fail,48,25,4,12,36
100,Fail,41,39,0,14,27
100,Fail,46,22,0,17,29
100,Fail,43,27,0,19,24
100,Fail,44,37,0,9,35
100,Fail,46,29,0,15,31
100,Fail,45,26,5,14,31
100,Fail,49,33,0,10,39
100,Fail,48,28,2,11,37
100,Fail,42,34,0,15,27
100,Fail,45,33,5,10,35
100,Fail,43,30,0,14,29
100,Fail,49,28,0,15,34
100,Fail,50,26,2,12,38
100,Fail,47,27,11,11,36
100,Fail,44,32,0,11,33
100,Fail,41,22,7,20,21
100,Fail,51,23,0,14,37
100,Fail,49,30,0,7,42
100,Fail,52,28,1,9,43
100,Fail,49,23,1,17,32
100,Fail,47,37,0,9,38
100,Fail,46,35,0,9,37
100,Fail,44,31,6,11,33
100,Fail,51,27,0,11,40
100,Fail,52,24,3,11,41
100,Fail,48,32,0,10,38
100,Fail,37,38,0,14,23
100,Fail,50,28,0,13,37
100,Fail,50,27,0,11,39
100,Fail,46,22,15,11,35
100,Fail,45,37,0,5,40
100,Fail,48,18,8,17,31
100,Fail,40,35,4,14,26
100,Fail,49,33,0,11,38
100,Fail,40,32,0,16,24
100,Fail,46,27,5,12,34
100,Fail,55,21,5,9,46
100,Fail,55,27,0,7,48
100,Fail,41,30,5,15,26
100,Fail,50,27,1,8,42
100,Fail,49,31,0,12,37
100,Fail,50,28,5,5,45
100,Fail,52,33,0,6,46
100,Fail,50,26,7,12,38
100,Fail,49,25,6,11,38
100,Fail,54,22,4,9,45
100,Fail,46,32,0,11,35
100,Fail,49,23,4,15,34
100,Fail,48,29,4,6,42
100,Fail,48,29,0,13,35
100,Fail,40,33,3,14,26
100,Fail,47,35,0,11,36
100,Fail,55,29,0,5,50
100,Fail,53,25,0,12,41
100,Fail,40,28,0,19,21
100,Fail,52,21,0,14,38
100,Fail,43,23,9,17,26
100,Fail,48,31,0,15,33
100,Fail,50,23,5,13,37
100,Fail,53,30,0,9,44
100,Fail,44,37,1,10,34
100,Fail,48,19,3,14,34
100,Fail,49,26,6,10,39
100,Fail,47,22,1,16,31
100,Fail,46,29,4,12,34
100,Fail,53,25,0,7,46
100,Fail,50,32,0,9,41
100,Fail,49,30,3,7,42
100,Fail,43,33,0,15,28
100,Fail,44,27,7,11,33
100,Fail,59,20,5,4,55
100,Fail,46,34,0,15,31
100,Fail,37,36,0,14,23
100,Fail,49,26,0,16,33
100,Fail,44,35,0,13,31
100,Fail,50,26,3,8,42
100,Fail,44,37,0,11,33
100,Fail,53,25,4,8,45
100,Fail,47,32,0,11,36
100,Fail,44,29,0,17,27
100,Fail,46,28,8,11,35
100,Fail,42,25,6,20,22
100,Fail,50,28,0,12,38
100,Fail,48,35,0,7,41
100,Fail,47,30,0,14,33
100,Fail,48,25,1,15,33
100,Fail,56,26,0,9,47
100,Fail,41,36,7,11,30
100,Fail,54,30,0,5,49
100,Fail,41,30,7,13,28
100,Fail,50,27,0,10,40
100,Fail,46,26,0,17,29
100,Fail,48,32,0,10,38
100,Fail,46,27,0,14,32
100,Fail,51,20,3,19,32