Threshold,Mob_Result,Act_Counter,Withdraw_Counter,Power_Exchange_Counter,Act_Against_Counter,Participation_Rate
10,Success,53,35,6,6,47
10,Success,48,34,6,12,36
10,Success,48,39,0,12,36
10,Success,46,35,0,14,32
10,Success,52,36,3,9,43
10,Success,39,44,0,11,28
10,Success,45,43,0,12,33
10,Success,53,28,2,17,36
10,Success,40,35,0,17,23
10,Success,47,42,3,8,39
10,Success,46,39,5,10,36
10,Success,47,37,2,14,33
10,Success,56,29,0,10,46
10,Success,51,32,0,11,40
10,Success,48,33,0,16,32
10,Success,47,30,0,16,31
10,Success,45,45,1,9,36
10,Success,44,35,0,12,32
10,Success,53,29,0,13,40
10,Success,53,36,0,11,42
10,Success,51,35,2,12,39
10,Success,40,34,0,13,27
10,Success,40,48,3,9,31
10,Success,41,39,0,18,23
10,Success,48,37,0,15,33
10,Success,45,35,0,10,35
10,Success,50,34,0,10,40
10,Success,45,34,0,12,33
10,Success,45,39,0,8,37
10,Success,43,39,0,12,31
10,Success,42,31,13,14,28
10,Success,49,36,0,13,36
10,Success,52,32,0,14,38
10,Success,52,27,6,15,37
10,Success,36,35,0,17,19
10,Success,48,35,0,16,32
10,Success,44,34,6,16,28
10,Success,49,32,0,17,32
10,Success,37,40,0,13,24
10,Success,51,30,2,17,34
10,Success,48,36,6,10,38
10,Success,45,41,1,13,32
10,Success,55,25,0,19,36
10,Success,48,36,4,12,36
10,Success,58,32,1,9,49
10,Success,49,32,1,18,31
10,Success,55,24,7,14,41
10,Success,46,37,0,14,32
10,Success,44,36,0,14,30
10,Success,46,41,1,12,34
10,Success,49,39,2,10,39
10,Success,54,35,1,10,44
10,Success,55,34,1,10,45
10,Success,40,44,3,13,27
10,Success,44,42,4,10,34
10,Success,50,38,0,10,40
10,Success,53,34,2,11,42
10,Success,46,33,4,17,29
10,Success,51,35,0,11,40
10,Success,47,43,0,10,37
10,Success,56,31,1,12,44
10,Success,43,38,0,15,28
10,Success,47,40,0,11,36
10,Success,46,37,0,15,31
10,Success,45,34,6,15,30
10,Success,54,30,7,9,45
10,Success,45,36,4,15,30
10,Success,44,41,0,12,32
10,Success,52,28,3,17,35
10,Success,54,31,0,14,40
10,Success,42,43,2,13,29
10,Success,39,40,0,10,29
10,Success,56,33,0,9,47
10,Success,51,40,3,6,45
10,Success,46,40,0,11,35
10,Success,53,30,0,8,45
10,Success,48,35,0,13,35
10,Success,44,38,0,12,32
10,Success,49,38,0,8,41
10,Success,50,32,2,16,34
10,Success,50,33,0,13,37
10,Success,44,34,0,19,25
10,Success,56,37,0,6,50
10,Success,46,43,2,9,37
10,Success,39,33,0,20,19
10,Success,50,28,0,18,32
10,Success,56,32,0,11,45
10,Success,52,32,0,16,36
10,Success,48,36,3,13,35
10,Success,46,40,5,9,37
10,Success,41,33,0,17,24
10,Success,49,31,0,19,30
10,Success,48,43,0,9,39
10,Success,53,33,2,12,41
10,Success,53,33,0,11,42
10,Success,52,31,0,15,37
10,Success,58,32,0,7,51
10,Success,49,35,0,13,36
10,Success,51,36,2,11,40
10,Success,37,43,0,17,20
10,Success,47,42,1,10,37
10,Success,52,33,0,14,38
10,Success,51,32,4,13,38
10,Success,51,34,0,12,39
10,Success,45,32,0,14,31
10,Success,48,37,0,7,41
10,Success,43,37,0,16,27
10,Success,46,38,4,12,34
10,Success,44,35,0,8,36
10,Success,36,45,4,15,21
10,Success,43,37,3,17,26
10,Success,53,33,3,11,42
10,Success,48,29,0,18,30
10,Success,56,34,0,9,47
10,Success,45,35,6,14,31
10,Success,48,40,0,8,40
10,Success,47,32,11,10,37
10,Success,51,35,0,14,37
10,Success,53,34,0,7,46
10,Success,51,38,0,10,41
10,Success,51,38,1,10,41
10,Success,41,39,0,20,21
10,Success,47,42,1,10,37
10,Success,41,40,1,18,23
10,Success,52,25,8,15,37
10,Success,58,38,1,3,55
10,Success,50,39,0,11,39
10,Success,48,32,0,16,32
10,Success,51,35,0,10,41
10,Success,45,35,8,12,33
10,Success,46,40,0,14,32
10,Success,44,37,5,14,30
10,Success,38,44,0,13,25
10,Success,47,39,1,13,34
10,Success,42,36,5,17,25
10,Success,53,31,0,13,40
10,Success,47,41,2,10,37
10,Success,51,32,0,10,41
10,Success,52,29,10,9,43
10,Success,51,37,0,12,39
10,Success,53,33,3,11,42
10,Success,40,40,4,16,24
10,Success,46,29,7,18,28
10,Success,58,27,0,11,47
10,Success,55,32,0,10,45
10,Success,51,37,4,8,43
10,Success,53,33,2,12,41
10,Success,52,37,0,10,42
10,Success,40,36,11,13,27
10,Success,47,30,0,20,27
10,Success,45,47,1,7,38
10,Success,46,28,0,11,35
10,Success,53,35,2,10,43
10,Success,49,31,0,19,30
10,Success,52,30,6,12,40
10,Success,47,35,4,14,33
10,Success,48,44,0,7,41
10,Success,47,39,1,13,34
10,Success,48,34,0,14,34
10,Success,46,34,3,17,29
10,Success,48,32,0,16,32
10,Success,42,39,0,12,30
10,Success,36,42,4,18,18
10,Success,52,26,0,16,36
10,Success,48,41,0,11,37
10,Success,45,39,0,16,29
10,Success,47,37,5,11,36
10,Success,51,36,4,9,42
10,Success,53,31,2,14,39
10,Success,54,30,0,14,40
10,Success,52,33,3,12,40
10,Success,41,37,0,14,27
10,Success,52,34,2,12,40
10,Success,51,30,3,16,35
10,Success,42,43,0,12,30
10,Success,56,36,0,5,51
10,Success,51,31,2,16,35
10,Success,44,36,0,13,31
10,Success,39,44,0,11,28
10,Success,41,31,0,16,25
10,Success,40,41,3,16,24
10,Success,51,29,0,14,37
10,Success,47,36,7,10,37
10,Success,46,39,0,15,31
10,Success,49,32,0,15,34
10,Success,42,39,4,15,27
10,Success,49,40,0,11,38
10,Success,42,37,0,17,25
10,Success,46,34,0,13,33
10,Success,51,31,0,15,36
10,Success,50,38,1,11,39
10,Success,54,36,2,8,46
10,Success,44,31,12,13,31
10,Success,43,40,0,17,26
10,Success,42,41,0,12,30
10,Success,57,26,0,17,40
10,Success,44,36,0,13,31
10,Success,47,39,0,12,35
10,Success,53,32,3,12,41
10,Success,51,34,0,11,40
10,Success,49,36,1,14,35
10,Success,52,35,0,13,39
10,Success,48,37,3,12,36
10,Success,49,32,0,13,36
10,Success,50,37,0,12,38
10,Success,52,38,0,10,42
10,Success,49,35,3,13,36
10,Success,37,41,4,18,19
10,Success,46,37,6,11,35
10,Success,44,39,1,16,28
10,Success,51,35,0,14,37
10,Success,50,28,0,15,35
10,Success,48,41,0,11,37
10,Success,42,37,7,14,28
10,Success,49,35,2,14,35
10,Success,51,35,3,11,40
10,Success,47,37,5,11,36
10,Success,52,34,0,12,40
10,Success,44,41,0,14,30
10,Success,57,33,0,7,50
10,Success,44,34,9,13,31
10,Success,53,26,5,16,37
10,Success,48,42,0,9,39
10,Success,45,32,12,11,34
10,Success,41,40,0,13,28
10,Success,47,40,0,9,38
10,Success,58,28,0,12,46
10,Success,48,32,8,12,36
10,Success,48,39,2,11,37
10,Success,49,40,0,11,38
10,Success,49,35,0,16,33
10,Success,50,36,3,11,39
10,Success,50,34,0,13,37
10,Success,36,40,0,14,22
10,Success,46,37,0,14,32
10,Success,48,42,1,9,39
10,Success,46,39,0,8,38
10,Success,41,48,1,10,31
10,Success,47,40,2,11,36
10,Success,46,36,5,13,33
10,Success,46,35,6,13,33
10,Success,43,36,1,20,23
10,Success,46,38,2,14,32
10,Success,49,40,0,8,41
10,Success,44,43,2,11,33
10,Success,43,38,9,10,33
10,Success,45,42,2,11,34
10,Success,42,36,9,13,29
10,Success,44,33,0,13,31
10,Success,52,33,0,11,41
10,Success,53,33,0,4,49
10,Success,42,28,0,20,22
10,Success,51,36,0,13,38
10,Success,55,37,0,8,47
10,Success,52,39,0,7,45
10,Success,48,41,0,11,37
10,Success,44,40,3,13,31
10,Success,47,44,1,8,39
10,Success,49,31,0,12,37
10,Success,44,38,6,12,32
10,Success,54,33,1,12,42
10,Success,54,30,0,14,40
10,Success,54,26,0,11,43
10,Success,48,33,0,12,36
10,Success,51,32,7,10,41
10,Success,48,34,0,16,32
10,Success,48,28,7,17,31
10,Success,38,46,0,8,30
10,Success,41,38,0,14,27
10,Success,54,34,3,9,45
10,Success,42,40,5,13,29
10,Success,51,33,3,13,38
10,Success,41,32,9,18,23
10,Success,49,42,0,8,41
10,Success,45,38,0,14,31
10,Success,44,33,0,15,29
10,Success,53,39,0,7,46
10,Success,47,36,5,12,35
10,Success,56,29,2,13,43
10,Success,55,32,3,10,45
10,Success,50,32,0,15,35
10,Success,51,33,0,14,37
10,Success,49,37,0,12,37
10,Success,52,35,0,12,40
10,Success,53,29,0,13,40
10,Success,47,33,6,14,33
10,Success,42,34,0,14,28
10,Success,52,33,4,11,41
10,Success,36,44,9,11,25
10,Success,41,36,0,16,25
10,Success,43,41,0,13,30
10,Success,44,37,3,16,28
10,Success,51,41,1,7,44
10,Success,50,26,0,16,34
10,Success,49,33,6,12,37
10,Success,48,35,0,11,37
10,Success,43,38,7,12,31
10,Success,55,34,3,8,47
10,Success,44,32,7,17,27
10,Success,52,36,2,10,42
10,Success,54,35,1,10,44
10,Success,48,38,0,13,35
10,Success,48,29,0,13,35
10,Success,52,30,0,10,42
10,Success,53,31,0,12,41
10,Success,52,35,0,12,40
10,Success,38,27,0,26,12
10,Success,53,37,1,9,44
10,Success,47,46,0,6,41
10,Success,43,46,1,10,33
10,Success,50,33,8,9,41
10,Success,47,40,6,7,40
10,Success,49,37,3,11,38
10,Success,48,40,0,10,38
10,Success,43,37,0,13,30
10,Success,53,35,0,12,41
10,Success,49,34,0,14,35
10,Success,40,43,0,16,24
10,Success,53,33,3,11,42
10,Success,46,42,1,11,35
10,Success,47,43,1,9,38
10,Success,55,31,2,12,43
10,Success,39,34,11,16,23
10,Success,55,32,4,9,46
10,Success,45,36,6,13,32
10,Success,51,30,3,16,35
10,Success,47,37,0,14,33
10,Success,51,38,0,9,42
10,Success,50,30,0,15,35
10,Success,43,40,0,15,28
10,Success,45,39,0,12,33
10,Success,49,33,4,14,35
10,Success,48,29,0,22,26
10,Success,50,36,1,13,37
10,Success,53,35,0,11,42
10,Success,52,25,0,12,40
10,Success,57,31,0,11,46
10,Success,46,41,0,11,35
10,Success,49,41,3,7,42
10,Success,46,30,8,16,30
10,Success,51,33,5,11,40
10,Success,51,35,0,12,39
10,Success,46,40,1,13,33
10,Success,44,37,3,16,28
10,Success,55,34,0,9,46
10,Success,45,36,0,12,33
10,Success,48,31,3,18,30
10,Success,53,32,2,13,40
10,Success,38,46,0,15,23
10,Success,42,40,4,14,28
10,Success,53,33,6,8,45
10,Success,50,35,0,15,35
10,Success,49,38,2,11,38
10,Success,50,34,3,13,37
10,Success,48,29,6,17,31
10,Success,45,40,0,11,34
10,Success,45,38,0,9,36
10,Success,51,27,0,12,39
10,Success,46,39,5,10,36
10,Success,51,35,2,12,39
10,Success,51,35,1,13,38
10,Success,45,31,0,17,28
10,Success,49,36,0,15,34
10,Success,50,36,0,11,39
10,Success,54,32,0,14,40
10,Success,51,34,3,12,39
10,Success,51,34,7,8,43
10,Success,45,29,9,17,28
10,Success,48,38,0,9,39
10,Success,38,40,7,15,23
10,Success,48,35,2,15,33
10,Success,47,41,4,8,39
10,Success,52,36,0,7,45
10,Success,41,40,8,11,30
10,Success,47,37,3,13,34
10,Success,48,36,0,15,33
10,Success,43,36,11,10,33
10,Success,47,33,2,18,29
10,Success,44,39,8,9,35
10,Success,57,30,0,12,45
10,Success,56,31,4,9,47
10,Success,56,28,2,14,42
10,Success,45,32,0,17,28
10,Success,53,35,0,12,41
10,Success,43,34,0,17,26
10,Success,48,32,4,16,32
10,Success,52,33,4,11,41
10,Success,54,29,6,11,43
10,Success,43,40,0,10,33
10,Success,45,37,5,13,32
10,Success,52,33,2,13,39
10,Success,45,40,0,12,33
10,Success,50,40,0,9,41
10,Success,54,34,0,11,43
10,Success,39,46,2,13,26
10,Success,45,40,0,9,36
10,Success,51,34,5,10,41
10,Success,43,33,5,19,24
10,Success,50,38,0,10,40
10,Success,46,39,0,11,35
10,Success,44,31,0,12,32
10,Success,44,41,1,14,30
10,Success,53,34,2,11,42
10,Success,49,37,1,13,36
10,Success,48,42,1,9,39
10,Success,53,31,3,13,40
10,Success,39,42,5,14,25
10,Success,47,32,0,9,38
10,Success,47,48,2,3,44
10,Success,43,38,0,14,29
10,Success,45,39,6,10,35
10,Success,45,33,0,10,35
10,Success,51,35,0,10,41
10,Success,46,37,0,14,32
10,Success,54,38,1,7,47
10,Success,48,41,0,10,38
10,Success,52,31,0,16,36
10,Success,48,31,0,19,29
10,Success,63,29,1,7,56
10,Success,43,38,0,16,27
10,Success,50,35,1,14,36
10,Success,53,30,0,13,40
10,Success,45,44,2,9,36
10,Success,46,38,6,10,36
10,Success,40,34,0,16,24
10,Success,49,35,3,13,36
10,Success,54,29,3,14,40
10,Success,48,35,0,11,37
10,Success,41,41,3,15,26
10,Success,41,43,1,15,26
10,Success,50,39,2,9,41
10,Success,47,37,0,12,35
10,Success,52,30,0,11,41
10,Success,53,35,0,10,43
10,Success,59,34,0,7,52
10,Success,58,31,0,9,49
10,Success,42,35,0,15,27
10,Success,49,41,2,8,41
10,Success,51,32,5,12,39
10,Success,49,37,0,10,39
10,Success,45,36,8,11,34
10,Success,54,35,0,9,45
10,Success,47,37,0,13,34
10,Success,46,34,9,11,35
10,Success,45,35,0,15,30
10,Success,51,40,2,7,44
10,Success,54,30,0,14,40
10,Success,48,37,7,8,40
10,Success,49,36,0,13,36
10,Success,45,38,4,13,32
10,Success,51,33,5,11,40
10,Success,50,35,0,13,37
10,Success,41,37,10,12,29
10,Success,40,44,0,12,28
10,Success,43,45,0,11,32
10,Success,45,42,0,12,33
10,Success,51,29,6,14,37
10,Success,54,33,0,13,41
10,Success,46,37,0,11,35
10,Success,47,41,3,9,38
10,Success,51,41,0,8,43
10,Success,48,37,0,14,34
10,Success,40,34,5,21,19
10,Success,49,32,0,10,39
10,Success,43,34,6,17,26
10,Success,51,32,3,14,37
10,Success,54,32,1,13,41
10,Success,44,36,2,18,26
10,Success,45,34,3,18,27
10,Success,43,37,1,19,24
10,Success,51,30,9,10,41
10,Success,43,38,2,17,26
10,Success,47,29,8,16,31
10,Success,47,37,0,16,31
10,Success,41,37,4,18,23
10,Success,41,38,0,15,26
10,Success,48,40,3,9,39
10,Success,50,36,2,12,38
10,Success,49,37,0,11,38
10,Success,46,41,1,12,34
10,Success,51,37,2,10,41
10,Success,47,36,5,12,35
10,Success,38,40,0,11,27
10,Success,45,37,3,15,30
10,Success,48,38,2,12,36
10,Success,52,40,0,8,44
10,Success,47,36,4,13,34
10,Success,45,37,6,12,33
10,Success,50,34,4,12,38
10,Success,45,34,0,17,28
10,Success,49,38,1,12,37
10,Success,43,34,9,14,29
10,Success,52,29,9,10,42
10,Success,51,32,0,9,42
10,Success,45,36,0,17,28
10,Success,49,35,3,13,36
10,Success,53,37,1,9,44
10,Success,49,37,0,8,41
10,Success,44,39,0,17,27
10,Success,50,32,0,11,39
10,Success,46,39,3,12,34
10,Success,44,34,7,15,29
10,Success,49,34,0,9,40
10,Success,50,39,0,9,41
10,Success,44,42,7,7,37
10,Success,38,45,3,14,24
10,Success,43,39,0,16,27
10,Success,55,34,4,7,48
10,Success,37,38,0,16,21
10,Success,52,32,6,10,42
10,Success,47,34,6,13,34
10,Success,40,44,2,14,26
10,Success,39,42,0,14,25
10,Success,43,40,1,16,27
10,Success,52,30,8,10,42
10,Success,47,40,2,11,36
10,Success,47,41,0,8,39
10,Success,55,33,4,8,47
10,Success,56,30,3,11,45
10,Success,55,28,0,14,41
10,Success,54,33,0,12,42
10,Success,43,37,0,11,32
10,Success,54,34,1,11,43
10,Success,44,35,6,15,29
10,Success,59,28,0,11,48
10,Success,48,37,3,12,36
10,Success,54,35,0,11,43
10,Success,49,38,2,11,38
10,Success,54,30,0,13,41
10,Success,43,34,9,14,29
10,Success,58,30,0,10,48
10,Success,53,32,2,13,40
10,Success,43,42,0,14,29
10,Success,50,31,0,12,38
10,Success,58,27,5,10,48
10,Success,51,33,8,8,43
10,Success,56,30,0,11,45
10,Success,45,33,6,16,29
10,Success,52,31,0,12,40
10,Success,47,23,11,19,28
10,Success,42,33,7,18,24
10,Success,48,31,0,20,28
10,Success,41,43,0,15,26
10,Success,53,31,7,9,44
10,Success,43,41,2,14,29
10,Success,50,37,2,11,39
10,Success,37,44,0,13,24
10,Success,53,28,0,12,41
10,Success,51,39,0,7,44
10,Success,48,28,7,17,31
10,Success,51,35,0,9,42
10,Success,46,39,2,13,33
10,Success,43,47,2,8,35
10,Success,49,36,0,14,35
10,Success,45,40,0,13,32
10,Success,48,37,0,13,35
10,Success,51,33,6,10,41
10,Success,49,41,0,10,39
10,Success,46,38,7,9,37
10,Success,41,36,0,12,29
10,Success,47,38,2,13,34
10,Success,50,38,0,12,38
10,Success,51,38,2,9,42
10,Success,44,41,0,11,33
10,Success,47,33,0,15,32
10,Success,45,36,0,17,28
10,Success,63,27,0,10,53
10,Success,45,37,0,16,29
10,Success,46,33,0,19,27
10,Success,44,36,7,13,31
10,Success,44,33,0,19,25
10,Success,49,37,0,14,35
10,Success,48,29,0,19,29
10,Success,53,36,1,10,43
10,Success,53,34,0,13,40
10,Success,55,32,1,12,43
10,Success,49,35,2,14,35
10,Success,56,26,0,10,46
10,Success,48,34,1,17,31
10,Success,48,40,0,11,37
10,Success,44,36,7,13,31
10,Success,43,41,0,16,27
10,Success,50,30,0,14,36
10,Success,50,39,0,9,41
10,Success,50,33,0,13,37
10,Success,45,35,0,15,30
10,Success,50,36,3,11,39
10,Success,47,30,3,20,27
10,Success,40,42,0,12,28
10,Success,43,37,0,19,24
10,Success,49,39,4,8,41
10,Success,50,37,6,7,43
10,Success,51,37,3,9,42
10,Success,49,35,3,13,36
10,Success,43,38,4,15,28
10,Success,46,38,0,14,32
10,Success,53,32,2,13,40
10,Success,39,37,9,15,24
10,Success,39,39,0,10,29
10,Success,50,34,5,11,39
10,Success,48,34,0,9,39
10,Success,50,40,0,7,43
10,Success,56,29,5,10,46
10,Success,48,32,0,15,33
10,Success,59,31,0,9,50
10,Success,53,32,1,14,39
10,Success,55,36,1,8,47
10,Success,47,39,0,12,35
10,Success,44,42,0,13,31
10,Success,52,20,0,25,27
10,Success,48,35,0,14,34
10,Success,51,34,8,7,44
10,Success,47,43,0,10,37
10,Success,38,45,0,14,24
10,Success,49,38,3,10,39
10,Success,42,40,0,9,33
10,Success,52,36,0,9,43
10,Success,44,38,2,16,28
10,Success,49,33,0,12,37
10,Success,50,32,0,18,32
10,Success,42,30,9,19,23
10,Success,51,33,4,12,39
10,Success,46,38,0,15,31
10,Success,43,34,6,17,26
10,Success,46,42,0,8,38
10,Success,44,37,6,13,31
10,Success,53,29,0,12,41
10,Success,53,30,7,10,43
10,Success,47,38,5,10,37
10,Success,46,43,0,8,38
10,Success,51,35,5,9,42
10,Success,48,35,4,13,35
10,Success,44,41,0,5,39
10,Success,51,31,0,13,38
10,Success,48,42,1,9,39
10,Success,39,39,15,7,32
10,Success,51,30,0,15,36
10,Success,43,41,5,11,32
10,Success,42,43,0,12,30
10,Success,48,36,2,14,34
10,Success,51,28,0,13,38
10,Success,55,33,0,11,44
10,Success,48,34,0,16,32
10,Success,55,33,0,11,44
10,Success,42,37,7,14,28
10,Success,49,37,2,12,37
10,Success,50,36,0,13,37
10,Success,51,37,1,11,40
10,Success,46,33,8,13,33
10,Success,50,29,0,14,36
10,Success,50,31,6,13,37
10,Success,48,34,5,13,35
10,Success,49,39,2,10,39
10,Success,48,33,0,15,33
10,Success,49,32,1,18,31
10,Success,51,37,1,11,40
10,Success,46,40,4,10,36
10,Success,45,37,5,13,32
10,Success,44,37,0,16,28
10,Success,45,37,0,10,35
10,Success,53,32,0,14,39
10,Success,44,39,0,14,30
10,Success,56,30,3,11,45
10,Success,56,32,0,8,48
10,Success,52,28,0,17,35
10,Success,52,35,0,7,45
10,Success,54,31,2,13,41
10,Success,45,28,0,13,32
10,Success,45,35,6,14,31
10,Success,54,38,0,8,46
10,Success,49,40,3,8,41
10,Success,44,38,3,15,29
10,Success,46,43,0,9,37
10,Success,49,41,0,8,41
10,Success,50,34,2,14,36
10,Success,45,39,4,12,33
10,Success,48,35,0,11,37
10,Success,52,30,0,10,42
10,Success,38,44,6,12,26
10,Success,47,35,7,11,36
10,Success,38,33,0,16,22
10,Success,48,32,5,15,33
10,Success,52,32,6,10,42
10,Success,49,29,9,13,36
10,Success,52,33,0,15,37
10,Success,42,38,0,12,30
10,Success,42,36,2,20,22
10,Success,44,32,3,21,23
10,Success,48,34,2,16,32
10,Success,46,31,0,14,32
10,Success,50,37,1,12,38
10,Success,39,45,0,6,33
10,Success,49,32,4,15,34
10,Success,47,40,0,12,35
10,Success,48,40,0,12,36
10,Success,54,31,0,8,46
10,Success,51,41,0,8,43
10,Success,48,41,1,10,38
10,Success,50,35,0,15,35
10,Success,50,34,0,12,38
10,Success,54,36,2,8,46
10,Success,48,39,2,11,37
10,Success,38,35,14,13,25
10,Success,44,41,0,14,30
10,Success,48,40,2,10,38
10,Success,48,36,0,15,33
10,Success,48,32,0,16,32
10,Success,49,35,3,13,36
10,Success,41,36,0,21,20
10,Success,56,37,0,7,49
10,Success,50,35,0,15,35
10,Success,43,34,0,14,29
10,Success,43,41,1,15,28
10,Success,47,39,0,11,36
10,Success,50,42,0,6,44
10,Success,49,31,0,13,36
10,Success,42,41,6,11,31
10,Success,43,41,3,13,30
10,Success,48,37,4,11,37
10,Success,43,41,1,15,28
10,Success,46,27,7,20,26
10,Success,45,44,0,9,36
10,Success,49,32,4,15,34
10,Success,47,33,0,11,36
10,Success,51,39,0,8,43
10,Success,47,34,0,16,31
10,Success,50,33,6,11,39
10,Success,48,33,9,10,38
10,Success,49,33,6,12,37
10,Success,48,31,5,16,32
10,Success,48,37,1,14,34
10,Success,52,39,0,6,46
10,Success,44,34,0,19,25
10,Success,45,39,0,11,34
10,Success,55,24,9,12,43
10,Success,55,34,0,10,45
10,Success,44,43,0,11,33
10,Success,51,29,0,17,34
10,Success,56,37,0,7,49
10,Success,49,27,0,15,34
10,Success,49,44,0,7,42
10,Success,46,40,8,6,40
10,Success,45,39,2,14,31
10,Success,48,42,0,7,41
10,Success,44,37,8,11,33
10,Success,45,44,1,10,35
10,Success,48,42,0,10,38
10,Success,54,38,0,8,46
10,Success,48,42,1,9,39
10,Success,48,35,0,13,35
10,Success,47,43,0,9,38
10,Success,54,34,0,9,45
10,Success,52,37,0,9,43
10,Success,53,32,0,14,39
10,Success,44,41,0,8,36
10,Success,53,35,0,11,42
10,Success,46,36,0,13,33
10,Success,48,36,5,11,37
10,Success,47,40,0,10,37
10,Success,55,30,0,8,47
10,Success,43,42,4,11,32
10,Success,53,36,2,9,44
10,Success,48,39,6,7,41
10,Success,44,40,1,15,29
10,Success,45,34,0,14,31
10,Success,48,36,0,10,38
10,Success,47,36,5,12,35
10,Success,45,40,3,12,33
10,Success,47,31,10,12,35
10,Success,48,34,0,14,34
10,Success,47,36,4,13,34
10,Success,51,30,2,17,34
10,Success,54,35,0,11,43
10,Success,54,33,1,12,42
10,Success,55,32,2,11,44
10,Success,53,31,0,11,42
10,Success,49,39,1,11,38
10,Success,46,33,9,12,34
10,Success,43,37,3,17,26
10,Success,49,35,0,13,36
10,Success,55,32,0,10,45
10,Success,50,31,12,7,43
10,Success,47,27,8,18,29
10,Success,42,36,9,13,29
10,Success,44,34,0,16,28
10,Success,48,33,0,18,30
10,Success,48,41,0,10,38
10,Success,40,30,16,14,26
10,Success,38,36,0,14,24
10,Success,51,36,2,11,40
10,Success,46,38,2,14,32
10,Success,48,34,3,15,33
10,Success,47,31,0,14,33
10,Success,55,35,1,9,46
10,Success,43,40,0,8,35
10,Success,52,42,1,5,47
10,Success,49,34,0,11,38
10,Success,46,37,4,13,33
10,Success,45,32,6,17,28
10,Success,45,30,0,16,29
10,Success,48,42,0,10,38
10,Success,43,37,6,14,29
10,Success,52,30,5,13,39
10,Success,43,42,2,13,30
10,Success,44,40,1,15,29
10,Success,53,35,0,10,43
10,Success,44,44,5,7,37
10,Success,48,31,6,15,33
10,Success,55,34,0,7,48
10,Success,43,33,0,10,33
10,Success,51,32,1,16,35
10,Success,50,42,0,8,42
10,Success,36,41,0,15,21
10,Success,40,40,0,16,24
10,Success,44,37,5,14,30
10,Success,51,33,5,11,40
10,Success,44,37,0,18,26
10,Success,44,37,0,9,35
10,Success,45,39,4,12,33
10,Success,42,35,7,16,26
10,Success,46,37,0,13,33
10,Success,42,46,6,6,36
10,Success,47,39,0,14,33
10,Success,48,39,3,10,38
10,Success,53,22,0,16,37
10,Success,49,34,0,14,35
10,Success,51,41,0,6,45
10,Success,53,38,0,9,44
10,Success,48,42,3,7,41
10,Success,45,42,0,10,35
10,Success,50,27,0,20,30
10,Success,42,44,0,12,30
10,Success,41,39,0,17,24
10,Success,45,40,0,10,35
10,Success,46,37,0,15,31
10,Success,45,41,0,14,31
10,Success,46,37,4,13,33
10,Success,54,28,0,14,40
10,Success,57,25,0,14,43
10,Success,45,29,10,16,29
10,Success,51,28,11,10,41
10,Success,47,37,2,14,33
10,Success,46,36,0,13,33
10,Success,52,40,1,7,45
10,Success,44,39,0,16,28
10,Success,49,33,7,11,38
10,Success,52,35,3,10,42
10,Success,50,40,0,9,41
10,Success,48,39,0,12,36
10,Success,57,35,0,8,49
10,Success,45,43,2,10,35
10,Success,46,37,3,14,32
10,Success,49,34,0,12,37
10,Success,37,46,3,14,23
10,Success,44,36,0,15,29
10,Success,46,37,0,16,30
10,Success,50,33,5,12,38
10,Success,50,33,3,14,36
10,Success,39,38,0,20,19
10,Success,50,39,0,8,42
10,Success,53,29,6,12,41
10,Success,55,29,0,10,45
10,Success,47,39,0,14,33
10,Success,53,26,6,15,38
10,Success,49,28,4,19,30
10,Success,55,34,0,8,47
10,Success,50,40,0,9,41
10,Success,53,37,0,8,45
10,Success,49,40,2,9,40
10,Success,43,38,3,16,27
10,Success,56,31,0,12,44
10,Success,42,44,3,11,31
10,Success,50,32,0,10,40
10,Success,57,29,3,11,46
10,Success,43,39,8,10,33
10,Success,49,30,10,11,38
10,Success,50,34,0,8,42
10,Success,49,40,1,10,39
10,Success,42,44,0,11,31
10,Success,53,34,4,9,44
10,Success,49,35,5,11,38
10,Success,49,35,0,13,36
10,Success,50,37,3,10,40
10,Success,42,43,0,8,34
10,Success,51,33,4,12,39
10,Success,44,36,5,15,29
10,Success,55,29,0,9,46
10,Success,51,35,0,13,38
10,Success,50,34,0,14,36
10,Success,51,36,7,6,45
10,Success,44,39,0,12,32
10,Success,59,30,2,9,50
10,Success,53,33,0,14,39
10,Success,48,30,0,14,34
10,Success,42,35,0,20,22
10,Success,40,38,10,12,28
10,Success,42,35,8,15,27
10,Success,49,33,4,14,35
10,Success,49,38,0,12,37
10,Success,54,30,3,13,41
10,Success,45,32,3,20,25
10,Success,53,34,1,12,41
10,Success,46,32,10,12,34
10,Success,55,30,1,14,41
10,Success,46,33,0,17,29
10,Success,40,32,0,16,24
10,Success,47,33,5,15,32
10,Success,51,27,0,13,38
10,Success,47,37,0,12,35
10,Success,54,30,0,8,46
10,Success,55,29,1,15,40
10,Success,45,41,0,14,31
10,Success,50,31,10,9,41
10,Success,48,31,0,17,31
10,Success,54,34,1,11,43
10,Success,45,35,0,17,28
10,Success,50,36,2,12,38
10,Success,43,39,6,12,31
10,Success,44,30,0,17,27
10,Success,50,36,0,9,41
10,Success,44,41,2,13,31
10,Success,45,31,0,15,30
10,Success,53,36,0,11,42
10,Success,49,34,10,7,42
10,Success,50,33,0,12,38
10,Success,58,33,0,8,50
10,Success,53,31,2,14,39
10,Success,54,28,4,14,40
10,Success,45,32,10,13,32
10,Success,51,33,0,13,38
10,Success,47,39,0,14,33
10,Success,45,34,0,14,31
10,Success,43,30,7,20,23
10,Success,44,39,0,16,28
10,Success,59,38,0,3,56
10,Success,50,37,5,8,42
10,Success,53,36,0,10,43
10,Success,53,31,0,11,42
10,Success,44,35,0,13,31
10,Success,46,37,0,15,31
10,Success,44,39,3,14,30
10,Success,42,36,4,18,24
10,Success,50,35,5,10,40
10,Success,42,36,5,17,25
10,Success,48,33,0,11,37
10,Success,47,37,7,9,38
10,Success,52,33,0,13,39
10,Success,51,34,0,14,37
10,Success,40,41,0,19,21
10,Success,50,38,2,10,40
10,Success,48,35,5,12,36
10,Success,59,32,0,8,51
10,Success,49,36,0,10,39
10,Success,48,38,4,10,38
10,Success,52,42,0,6,46
10,Success,49,32,5,14,35
10,Success,48,37,0,9,39
10,Success,49,32,0,18,31
10,Success,42,43,6,9,33
10,Success,51,24,0,14,37
10,Success,45,28,8,19,26
10,Success,45,35,0,16,29
10,Success,48,36,0,12,36
10,Success,44,39,0,14,30
10,Success,44,40,0,15,29
10,Success,50,35,0,14,36
10,Success,43,39,3,15,28
10,Success,39,41,3,17,22
10,Success,48,35,0,17,31
10,Success,43,33,2,22,21
10,Success,51,32,0,17,34
10,Success,45,38,6,11,34
10,Success,43,34,0,14,29
10,Success,52,28,0,11,41
10,Success,51,30,0,13,38
10,Success,42,36,5,17,25
10,Success,52,37,0,9,43
10,Success,46,27,4,23,23
10,Success,45,32,0,22,23
10,Success,53,38,1,8,45
10,Success,42,35,5,18,24
10,Success,54,30,1,15,39
10,Success,46,38,0,12,34
10,Success,49,36,0,8,41
10,Success,43,36,3,18,25
10,Success,44,36,0,14,30
10,Success,44,42,0,14,30
10,Success,42,32,0,14,28
10,Success,47,41,0,12,35
10,Success,49,32,2,17,32
10,Success,43,38,0,18,25
10,Success,46,39,0,14,32
10,Success,52,34,2,12,40
10,Success,48,41,0,8,40
10,Success,40,48,0,11,29
10,Success,55,34,1,10,45
10,Success,44,35,0,20,24
10,Success,52,33,0,11,41
10,Success,42,38,5,15,27
10,Success,48,35,0,17,31
10,Success,45,35,0,14,31
10,Success,45,27,15,13,32
10,Success,51,26,3,20,31
10,Success,44,37,4,15,29
10,Success,51,31,3,15,36
10,Success,57,29,0,9,48
10,Success,54,33,2,11,43
10,Success,51,33,0,12,39
10,Success,52,33,0,15,37
10,Success,47,43,1,9,38
10,Success,44,31,10,15,29
10,Success,46,38,0,14,32
10,Success,55,29,0,9,46
10,Success,57,30,0,13,44
10,Success,44,33,0,16,28
10,Success,47,39,2,12,35
10,Success,49,37,7,7,42
10,Success,44,36,0,15,29
10,Success,43,39,0,12,31
10,Success,47,36,1,16,31
10,Success,57,27,0,11,46
10,Success,53,36,1,10,43
10,Success,47,31,0,14,33
10,Success,51,32,4,13,38
10,Success,46,34,0,11,35
10,Success,50,35,0,9,41
10,Success,50,40,2,8,42
10,Success,44,43,2,11,33
10,Success,47,33,0,14,33
10,Success,44,42,0,14,30
10,Success,48,33,0,13,35
10,Success,51,39,0,10,41
10,Success,53,30,0,7,46
10,Success,50,35,0,15,35
10,Success,54,31,0,13,41
10,Success,45,35,3,17,28
10,Success,50,34,0,14,36
10,Success,44,45,0,10,34
10,Success,48,36,0,8,40
10,Success,37,46,4,13,24
10,Success,55,30,0,14,41
10,Success,53,32,4,11,42
10,Success,50,40,0,7,43
10,Success,49,35,8,8,41
10,Success,49,36,3,12,37
10,Success,45,36,3,16,29
10,Success,45,40,0,15,30
10,Success,42,41,1,16,26
10,Success,54,33,2,11,43
10,Success,54,33,5,8,46
10,Success,45,34,0,16,29
10,Success,43,43,0,11,32
10,Success,51,37,1,11,40
10,Success,43,39,6,12,31
10,Success,45,33,8,14,31
10,Success,52,33,0,12,40
10,Success,51,27,0,15,36
10,Success,47,38,0,13,34
10,Success,48,40,0,12,36
10,Success,42,33,0,12,30
10,Success,39,40,0,17,22
10,Success,45,39,0,14,31
10,Success,45,35,0,13,32
10,Success,47,38,0,15,32
10,Success,45,35,0,15,30
10,Success,46,38,3,13,33
10,Success,48,40,3,9,39
10,Success,41,45,0,11,30
10,Success,47,37,0,11,36
10,Success,54,30,2,14,40
10,Success,43,37,2,18,25
10,Success,40,47,1,12,28
10,Success,50,37,0,12,38
10,Success,47,36,0,13,34
10,Success,50,34,1,15,35
10,Success,48,35,6,11,37
10,Success,54,34,0,9,45
10,Success,48,38,1,13,35
10,Success,47,36,4,13,34
10,Success,50,41,1,8,42
10,Success,45,42,0,10,35
10,Success,47,40,3,10,37
10,Success,45,38,0,13,32
10,Success,47,40,0,11,36
10,Success,53,35,2,10,43
10,Success,49,43,0,8,41
10,Success,46,33,0,13,33
10,Success,51,39,2,8,43
10,Success,46,38,0,8,38
10,Success,55,26,0,13,42
10,Success,47,38,0,15,32
10,Success,50,34,6,10,40
10,Success,53,29,1,17,36
10,Success,53,32,4,11,42
10,Success,45,37,0,17,28
10,Success,51,31,5,13,38
10,Success,45,34,5,16,29
10,Success,47,44,0,8,39
10,Success,48,37,0,15,33
10,Success,49,32,0,13,36
10,Success,51,42,1,6,45
10,Success,56,26,0,12,44
10,Success,52,30,0,14,38
10,Success,44,36,0,14,30
10,Success,44,40,1,15,29
10,Success,40,31,11,18,22
10,Success,41,38,3,18,23
10,Success,50,24,0,19,31
10,Success,48,34,0,15,33
10,Success,47,45,0,6,41
10,Success,42,39,0,14,28
10,Success,44,39,0,12,32
10,Success,43,33,0,14,29
10,Success,47,32,6,15,32
10,Success,44,33,8,15,29
10,Success,48,34,0,13,35
10,Success,49,32,3,16,33
10,Success,48,36,1,15,33
10,Success,52,29,10,9,43
10,Success,46,42,0,12,34
10,Success,56,30,4,10,46
10,Success,53,22,0,18,35
10,Success,48,39,3,10,38
10,Success,47,37,5,11,36
10,Success,51,31,7,11,40
10,Success,52,38,1,9,43
10,Success,45,37,4,14,31
10,Success,45,39,3,13,32
10,Success,46,31,9,14,32
10,Success,46,39,4,11,35
10,Success,45,40,1,14,31
10,Success,51,34,3,12,39
10,Success,50,34,7,9,41
10,Success,53,36,0,11,42
10,Success,42,40,0,14,28
10,Success,51,37,1,11,40
10,Success,45,43,4,8,37
10,Success,52,36,0,9,43
10,Success,54,31,5,10,44
10,Success,45,38,0,10,35
10,Success,56,30,0,12,44
10,Success,46,40,0,9,37
10,Success,49,40,2,9,40
10,Success,42,36,0,11,31
10,Success,53,32,2,13,40
10,Success,44,28,4,24,20
10,Success,43,41,5,11,32
10,Success,52,31,2,15,37
10,Success,52,40,1,7,45
10,Success,46,39,0,6,40
10,Success,51,36,4,9,42
10,Success,43,44,3,10,33
10,Success,52,32,0,12,40
10,Success,36,42,3,19,17
10,Success,49,33,0,15,34
10,Success,55,29,0,12,43
10,Success,53,36,3,8,45
10,Success,46,33,0,11,35
10,Success,48,31,0,15,33
10,Success,48,42,0,9,39
10,Success,48,38,0,14,34
10,Success,44,38,0,18,26
10,Success,46,34,0,13,33
10,Success,46,37,1,16,30
10,Success,49,37,0,13,36
10,Success,50,35,9,6,44
10,Success,49,34,0,14,35
10,Success,43,36,1,20,23
10,Success,49,29,10,12,37
10,Success,44,37,3,16,28
10,Success,49,30,0,20,29
10,Success,46,34,0,10,36
10,Success,35,36,0,21,14
10,Success,54,29,5,12,42
10,Success,51,33,2,14,37
10,Success,52,29,0,16,36
10,Success,53,33,1,13,40
10,Success,63,26,0,7,56
10,Success,43,40,0,9,34
10,Success,52,32,4,12,40
10,Success,50,35,3,12,38
10,Success,48,34,0,17,31
10,Success,46,36,5,13,33
10,Success,51,37,0,9,42
10,Success,43,43,5,9,34
10,Success,52,34,0,10,42
10,Success,51,32,0,17,34
10,Success,50,35,0,14,36
10,Success,52,38,3,7,45
10,Success,51,31,0,14,37
10,Success,47,34,0,12,35
10,Success,57,27,8,8,49
10,Success,45,35,6,14,31
10,Success,48,37,0,12,36
10,Success,61,33,0,5,56
10,Success,49,39,0,10,39
10,Success,43,28,0,22,21
10,Success,46,37,0,17,29
10,Success,46,44,3,7,39
10,Success,50,35,4,11,39
10,Success,53,41,0,6,47
10,Success,54,33,2,11,43
10,Success,43,45,0,11,32
10,Success,49,32,4,15,34
10,Success,45,33,0,17,28
10,Success,50,33,0,7,43
10,Success,50,37,0,11,39
10,Success,52,33,0,12,40
10,Success,45,34,5,16,29
10,Success,42,34,7,17,25
10,Success,49,40,0,11,38
10,Success,51,29,0,10,41
10,Success,48,39,0,10,38
10,Success,47,36,5,12,35
10,Success,50,32,5,13,37
10,Success,44,40,0,13,31
10,Success,52,32,3,13,39
10,Success,49,34,0,10,39
10,Success,52,34,0,14,38
10,Success,53,34,1,12,41
10,Success,50,33,9,8,42
10,Success,51,31,0,16,35
10,Success,52,31,0,17,35
10,Success,57,32,0,11,46
10,Success,44,35,6,15,29
10,Success,53,29,4,14,39
10,Success,49,40,0,8,41
10,Success,47,42,1,10,37
10,Success,48,34,0,15,33
10,Success,55,31,0,12,43
10,Success,47,43,0,8,39
10,Success,55,33,0,8,47
10,Success,44,35,0,16,28
10,Success,51,31,3,15,36
10,Success,49,41,3,7,42
10,Success,54,40,0,6,48
10,Success,56,23,0,18,38
10,Success,48,45,1,6,42
10,Success,52,40,0,8,44
10,Success,48,37,0,10,38
10,Success,36,35,11,18,18
10,Success,44,36,0,19,25
10,Success,47,35,0,18,29
10,Success,43,42,0,10,33
10,Success,55,35,0,8,47
10,Success,43,42,5,10,33
10,Success,54,29,0,12,42
10,Success,40,43,0,14,26
10,Success,51,38,0,11,40
10,Success,43,41,0,12,31
10,Success,49,31,10,10,39
10,Success,46,31,6,17,29
10,Success,51,41,3,5,46
10,Success,48,36,0,12,36
10,Success,40,35,10,15,25
10,Success,48,34,0,12,36
10,Success,47,33,10,10,37
10,Success,51,32,6,11,40
10,Success,50,32,6,12,38
10,Success,47,33,4,16,31
10,Success,50,35,1,14,36
10,Success,40,42,0,16,24
10,Success,51,32,0,13,38
10,Success,50,29,0,17,33
10,Success,49,38,1,12,37
10,Success,48,37,3,12,36
10,Success,46,35,0,17,29
10,Success,42,39,0,14,28
10,Success,43,43,3,11,32
10,Success,51,35,2,12,39
10,Success,41,38,0,18,23
10,Success,46,41,3,10,36
10,Success,52,35,0,9,43
10,Success,49,28,5,18,31
10,Success,50,36,0,14,36
10,Success,45,31,9,15,30
10,Success,59,30,0,11,48
10,Success,51,33,0,10,41
10,Success,45,27,12,16,29
10,Success,45,36,0,17,28
10,Success,52,34,1,13,39
10,Success,48,36,5,11,37
10,Success,48,39,0,13,35
10,Success,52,35,5,8,44
10,Success,50,34,0,16,34
10,Success,38,39,0,19,19
10,Success,43,35,0,15,28
10,Success,54,38,0,7,47
10,Success,43,37,0,12,31
10,Success,52,39,0,7,45
10,Success,47,31,0,13,34
10,Success,42,32,0,15,27
10,Success,47,36,1,16,31
10,Success,49,33,3,15,34
10,Success,52,30,0,13,39
10,Success,48,36,0,14,34
10,Success,50,34,4,12,38
10,Success,51,31,5,13,38
10,Success,44,38,0,12,32
10,Success,52,36,2,10,42
10,Success,46,42,1,11,35
10,Success,50,39,0,8,42
10,Success,43,43,0,11,32
10,Success,46,43,3,8,38
10,Success,48,36,1,15,33
10,Success,45,32,12,11,34
10,Success,52,34,0,11,41
10,Success,47,33,0,16,31
10,Success,42,43,2,13,29
10,Success,50,36,0,14,36
10,Success,49,36,0,12,37
10,Success,49,34,0,11,38
10,Success,51,33,0,16,35
10,Success,47,36,9,8,39
10,Success,48,33,0,15,33
10,Success,41,34,8,17,24
10,Success,48,39,0,8,40
10,Success,51,38,0,9,42
10,Success,48,40,0,7,41
10,Success,47,33,4,16,31
10,Success,51,35,0,10,41
10,Success,42,32,13,13,29
10,Success,49,41,0,8,41
10,Success,46,33,0,12,34
10,Success,44,32,0,13,31
10,Success,47,30,7,16,31
10,Success,56,36,0,6,50
10,Success,50,29,0,15,35
10,Success,51,30,0,16,35
10,Success,51,34,5,10,41
10,Success,47,41,0,12,35
10,Success,47,30,0,18,29
10,Success,41,42,0,11,30
10,Success,57,30,0,11,46
10,Success,45,33,7,15,30
10,Success,43,31,7,19,24
10,Success,42,43,5,10,32
10,Success,46,37,1,16,30
10,Success,50,30,0,19,31
10,Success,49,37,0,14,35
10,Success,45,32,4,19,26
10,Success,42,38,6,14,28
10,Success,53,35,1,11,42
10,Success,50,29,7,14,36
10,Success,49,31,7,13,36
10,Success,51,34,0,9,42
10,Success,43,34,8,15,28
10,Success,50,37,0,13,37
10,Success,47,32,0,18,29
10,Success,54,37,0,9,45
10,Success,55,31,0,14,41
10,Success,49,38,1,12,37
10,Success,53,37,0,10,43
10,Success,42,38,8,12,30
10,Success,55,27,0,11,44
10,Success,44,38,0,15,29
10,Success,53,38,2,7,46
10,Success,45,42,4,9,36
10,Success,51,28,4,17,34
10,Success,40,38,0,21,19
10,Success,58,32,0,8,50
10,Success,42,40,0,12,30
10,Success,41,43,0,15,26
10,Success,51,30,6,13,38
10,Success,46,38,5,11,35
10,Success,49,37,0,10,39
10,Success,51,27,0,15,36
10,Success,61,29,0,10,51
10,Success,53,34,2,11,42
10,Success,45,31,3,21,24
10,Success,50,38,0,8,42
10,Success,47,38,4,11,36
10,Success,48,32,10,10,38
10,Success,53,31,7,9,44
10,Success,51,41,0,8,43
10,Success,45,32,13,10,35
10,Success,55,27,0,13,42
10,Success,52,28,0,17,35
10,Success,47,42,1,10,37
10,Success,52,36,0,10,42
10,Success,51,37,1,11,40
10,Success,45,38,4,13,32
10,Success,52,31,0,17,35
10,Success,58,33,0,9,49
10,Success,52,35,3,10,42
10,Success,53,29,0,12,41
10,Success,50,33,0,15,35
10,Success,42,29,13,16,26
10,Success,56,33,0,10,46
10,Success,54,31,0,13,41
10,Success,44,39,5,12,32
10,Success,45,36,0,12,33
10,Success,47,35,0,16,31
10,Success,50,40,0,10,40
10,Success,55,32,0,9,46
10,Success,54,31,0,12,42
10,Success,47,37,0,13,34
10,Success,44,31,0,16,28
10,Success,39,36,0,21,18
10,Success,60,31,0,6,54
10,Success,46,33,9,12,34
10,Success,47,32,0,15,32
10,Success,52,29,4,15,37
10,Success,48,40,1,11,37
10,Success,56,31,2,11,45
10,Success,49,41,0,10,39
10,Success,55,33,1,11,44
10,Success,47,36,2,15,32
10,Success,50,36,0,12,38
10,Success,45,42,2,11,34
10,Success,44,32,0,17,27
10,Success,50,31,5,14,36
10,Success,51,37,0,11,40
10,Success,48,37,0,9,39
10,Success,53,38,0,9,44
10,Success,51,36,0,11,40
10,Success,56,35,0,8,48
10,Success,45,35,0,19,26
10,Success,50,36,0,12,38
10,Success,53,31,0,10,43
10,Success,53,42,0,5,48
10,Success,40,51,0,8,32
10,Success,55,35,0,9,46
10,Success,46,35,4,15,31
10,Success,52,33,0,9,43
10,Success,53,34,3,10,43
10,Success,53,38,1,8,45
10,Success,51,30,0,17,34
10,Success,42,35,9,14,28
10,Success,33,44,0,12,21
10,Success,52,31,0,16,36
10,Success,43,36,0,19,24
10,Success,45,37,0,16,29
10,Success,44,39,0,10,34
10,Success,53,37,2,8,45
10,Success,47,37,0,12,35
10,Success,50,35,0,12,38
10,Success,41,40,5,14,27
10,Success,51,37,2,10,41
10,Success,46,30,0,18,28
10,Success,49,31,5,15,34
10,Success,46,38,4,12,34
10,Success,49,36,0,12,37
10,Success,38,42,11,9,29
10,Success,41,31,6,22,19
10,Success,41,40,2,17,24
10,Success,51,41,0,8,43
10,Success,54,33,0,10,44
10,Success,51,34,0,9,42
10,Success,53,34,0,11,42
10,Success,47,40,0,7,40
10,Success,52,38,0,9,43
10,Success,54,37,0,8,46
10,Success,46,37,4,13,33
10,Success,48,35,4,13,35
10,Success,39,40,9,12,27
10,Success,44,37,3,16,28
10,Success,50,32,0,12,38
10,Success,49,31,0,15,34
10,Success,47,29,0,18,29
10,Success,46,37,2,15,31
10,Success,51,30,2,17,34
10,Success,45,34,9,12,33
10,Success,47,39,1,13,34
10,Success,56,31,0,10,46
10,Success,43,40,6,11,32
10,Success,47,41,2,10,37
10,Success,42,39,0,15,27
10,Success,47,29,7,17,30
10,Success,52,34,4,10,42
10,Success,54,26,9,11,43
10,Success,51,37,4,8,43
10,Success,42,38,0,12,30
10,Success,50,34,0,12,38
10,Success,41,40,0,14,27
10,Success,49,33,0,12,37
10,Success,44,40,2,14,30
10,Success,54,30,3,13,41
10,Success,47,42,0,9,38
10,Success,45,36,5,14,31
10,Success,51,36,0,12,39
10,Success,46,37,3,14,32
10,Success,57,31,0,11,46
10,Success,52,34,1,13,39
10,Success,44,38,7,11,33
10,Success,47,29,12,12,35
10,Success,48,39,0,13,35
10,Success,50,35,0,13,37
10,Success,53,36,0,9,44
10,Success,43,42,0,13,30
10,Success,44,34,0,16,28
10,Success,48,30,0,14,34
10,Success,51,31,5,13,38
10,Success,48,43,2,7,41
10,Success,52,24,7,17,35
10,Success,48,43,0,9,39
10,Success,47,29,9,15,32
10,Success,49,37,1,13,36
10,Success,52,36,0,11,41
10,Success,46,36,0,15,31
10,Success,49,34,7,10,39
10,Success,45,37,6,12,33
10,Success,44,37,5,14,30
10,Success,55,34,0,9,46
10,Success,48,33,2,17,31
10,Success,44,39,4,13,31
10,Success,54,35,0,10,44
10,Success,54,32,3,11,43
10,Success,45,36,0,14,31
10,Success,55,29,0,13,42
10,Success,40,35,0,14,26
10,Success,47,33,3,17,30
10,Success,45,33,6,16,29
10,Success,49,40,0,9,40
10,Success,46,42,0,9,37
10,Success,45,36,0,9,36
10,Success,43,44,0,10,33
10,Success,48,37,6,9,39
10,Success,46,42,2,10,36
10,Success,35,32,9,24,11
10,Success,53,24,0,21,32
10,Success,46,34,0,13,33
10,Success,44,36,5,15,29
10,Success,43,41,3,13,30
10,Success,55,35,1,9,46
10,Success,50,38,0,8,42
10,Success,44,30,0,20,24
10,Success,47,34,9,10,37
10,Success,59,31,0,8,51
10,Success,42,37,0,17,25
10,Success,47,30,0,12,35
10,Success,48,37,0,10,38
10,Success,49,39,5,7,42
10,Success,44,27,14,15,29
10,Success,45,39,0,15,30
10,Success,51,29,4,16,35
10,Success,46,35,4,15,31
10,Success,46,38,5,11,35
10,Success,43,38,6,13,30
10,Success,44,35,9,12,32
10,Success,49,36,5,10,39
10,Success,45,34,4,17,28
10,Success,50,41,0,9,41
10,Success,47,31,0,21,26
10,Success,48,38,0,13,35
10,Success,52,32,6,10,42
10,Success,58,30,1,11,47
10,Success,45,38,0,11,34
10,Success,45,42,0,11,34
10,Success,52,35,0,12,40
10,Success,48,32,0,17,31
10,Success,37,37,0,19,18
10,Success,42,31,9,18,24
10,Success,48,36,5,11,37
10,Success,48,29,0,20,28
10,Success,42,45,0,11,31
10,Success,49,31,0,12,37
10,Success,56,33,1,10,46
10,Success,45,39,0,14,31
10,Success,46,32,0,14,32
10,Success,42,46,0,9,33
10,Success,50,34,0,9,41
10,Success,55,30,0,13,42
10,Success,53,30,0,13,40
10,Success,49,35,0,11,38
10,Success,44,38,8,10,34
10,Success,48,39,2,11,37
10,Success,39,38,0,10,29
10,Success,52,33,0,14,38
10,Success,50,31,0,18,32
10,Success,46,43,0,9,37
10,Success,52,28,5,15,37
10,Success,48,38,0,14,34
10,Success,45,33,0,14,31
10,Success,51,35,3,11,40
10,Success,52,33,0,9,43
10,Success,59,29,1,11,48
10,Success,42,37,7,14,28
10,Success,53,32,0,11,42
10,Success,49,35,3,13,36
10,Success,55,28,4,13,42
10,Success,44,40,3,13,31
10,Success,38,38,12,12,26
10,Success,38,44,0,13,25
10,Success,57,33,2,8,49
10,Success,49,30,3,18,31
10,Success,50,29,0,15,35
10,Success,51,30,3,16,35
10,Success,51,38,3,8,43
10,Success,49,33,3,15,34
10,Success,43,31,0,22,21
10,Success,43,38,0,12,31
10,Success,51,32,0,13,38
10,Success,45,38,6,11,34
10,Success,52,31,7,10,42
10,Success,43,38,2,17,26
10,Success,45,32,0,18,27
10,Success,54,36,0,9,45
10,Success,39,44,2,15,24
10,Success,59,30,2,9,50
10,Success,46,37,4,13,33
10,Success,48,36,0,15,33
10,Success,53,30,0,16,37
10,Success,49,32,0,14,35
10,Success,47,39,0,12,35
10,Success,49,34,0,9,40
10,Success,51,30,0,18,33
10,Success,49,38,0,10,39
10,Success,49,45,0,6,43
10,Success,53,28,0,17,36
10,Success,48,33,7,12,36
10,Success,52,30,0,13,39
10,Success,52,34,2,12,40
10,Success,41,37,0,11,30
10,Success,46,38,6,10,36
10,Success,46,36,2,16,30
10,Success,39,43,10,8,31
10,Success,44,39,0,13,31
10,Success,51,34,0,10,41
10,Success,43,39,4,14,29
10,Success,39,41,6,14,25
10,Success,56,34,0,9,47
10,Success,54,29,0,11,43
10,Success,51,25,0,14,37
10,Success,45,39,0,5,40
10,Success,48,30,0,14,34
10,Success,51,35,3,11,40
10,Success,47,38,0,10,37
10,Success,48,35,4,13,35
10,Success,51,38,3,8,43
10,Success,44,30,10,16,28
10,Success,54,30,0,12,42
10,Success,48,44,0,8,40
10,Success,46,43,0,10,36
10,Success,50,36,4,10,40
10,Success,60,23,2,15,45
10,Success,52,35,0,12,40
10,Success,55,31,3,11,44
10,Success,41,38,0,18,23
10,Success,49,35,0,15,34
10,Success,39,44,4,13,26
10,Success,45,32,5,18,27
10,Success,53,33,0,12,41
10,Success,50,31,3,16,34
10,Success,47,37,0,13,34
10,Success,45,43,0,12,33
10,Success,53,34,0,13,40
10,Success,55,30,3,12,43
10,Success,48,32,0,15,33
10,Success,50,38,0,10,40
10,Success,39,28,16,17,22
10,Success,44,37,0,15,29
10,Success,51,34,2,13,38
10,Success,48,35,3,14,34
10,Success,38,39,9,14,24
10,Success,54,36,0,9,45
10,Success,41,40,5,14,27
10,Success,44,37,0,11,33
10,Success,46,41,1,12,34
10,Success,50,32,0,15,35
10,Success,48,37,0,15,33
10,Success,50,34,0,16,34
10,Success,39,38,11,12,27
10,Success,50,33,3,14,36
10,Success,44,39,6,11,33
10,Success,53,35,0,11,42
10,Success,43,40,1,16,27
10,Success,48,36,4,12,36
10,Success,42,36,0,20,22
10,Success,40,33,0,21,19
10,Success,45,42,1,12,33
10,Success,53,32,2,13,40
10,Success,50,32,2,16,34
10,Success,45,33,10,12,33
10,Success,51,34,0,14,37
10,Success,45,39,0,15,30
10,Success,48,42,2,8,40
10,Success,51,32,0,16,35
10,Success,48,37,0,15,33
10,Success,51,32,0,14,37
10,Success,38,35,4,23,15
10,Success,47,34,0,12,35
10,Success,47,36,4,13,34
10,Success,51,32,0,15,36
10,Success,51,39,4,6,45
10,Success,45,37,0,16,29
10,Success,61,26,3,10,51
10,Success,43,34,9,14,29
10,Success,57,30,0,12,45
10,Success,53,30,8,9,44
10,Success,49,36,0,11,38
10,Success,47,29,0,15,32
10,Success,46,38,1,15,31
10,Success,51,41,0,8,43
10,Success,47,35,2,16,31
10,Success,47,37,0,16,31
10,Success,43,34,12,11,32
10,Success,48,36,2,14,34
10,Success,51,37,0,12,39
10,Success,46,32,0,13,33
10,Success,43,32,0,16,27
10,Success,43,39,3,15,28
10,Success,50,30,0,14,36
10,Success,47,36,0,17,30
10,Success,53,37,1,9,44
10,Success,46,31,0,18,28
10,Success,46,35,0,19,27
10,Success,50,32,7,11,39
10,Success,51,36,0,12,39
10,Success,46,33,0,16,30
10,Success,50,31,8,11,39
10,Success,41,36,0,13,28
10,Success,48,39,0,11,37
10,Success,56,37,1,6,50
10,Success,44,38,1,17,27
10,Success,57,32,0,10,47
10,Success,50,40,0,8,42
10,Success,45,36,1,18,27
10,Success,58,24,4,14,44
10,Success,47,36,7,10,37
10,Success,40,33,11,16,24
10,Success,49,36,4,11,38
10,Success,45,42,2,11,34
10,Success,37,37,0,16,21
10,Success,48,37,3,12,36
10,Success,59,29,0,10,49
10,Success,43,47,0,8,35
10,Success,48,40,6,6,42
10,Success,48,37,5,10,38
10,Success,46,39,0,11,35
10,Success,44,37,0,17,27
10,Success,53,36,1,10,43
10,Success,49,37,0,13,36
10,Success,52,34,3,11,41
10,Success,48,35,3,14,34
10,Success,45,34,0,15,30
10,Success,42,43,3,12,30
10,Success,51,36,0,9,42
10,Success,42,39,3,16,26
10,Success,47,37,3,13,34
10,Success,41,43,0,15,26
10,Success,53,34,2,11,42
10,Success,40,42,0,14,26
10,Success,51,35,3,11,40
10,Success,46,30,0,24,22
10,Success,44,39,4,13,31
10,Success,49,40,0,11,38
10,Success,46,36,4,14,32
10,Success,46,32,0,17,29
10,Success,49,33,0,17,32
10,Success,50,33,10,7,43
10,Success,42,34,4,20,22
10,Success,49,38,0,10,39
10,Success,48,31,7,14,34
10,Success,46,41,5,8,38
10,Success,49,35,4,12,37
10,Success,38,43,0,12,26
10,Success,50,38,4,8,42
10,Success,50,35,1,14,36
10,Success,51,35,1,13,38
10,Success,48,38,0,14,34
10,Success,45,40,4,11,34
10,Success,56,35,1,8,48
10,Success,51,26,8,15,36
10,Success,42,41,5,12,30
10,Success,50,35,4,11,39
10,Success,53,34,1,12,41
10,Success,55,30,0,14,41
10,Success,41,37,8,14,27
10,Success,47,38,1,14,33
10,Success,49,31,7,13,36
10,Success,56,28,2,14,42
10,Success,43,42,1,14,29
10,Success,48,34,9,9,39
10,Success,49,38,2,11,38
10,Success,50,38,5,7,43
10,Success,48,39,2,11,37
10,Success,47,39,0,11,36
10,Success,46,38,4,12,34
10,Success,49,41,0,9,40
10,Success,48,26,6,20,28
10,Success,43,29,11,17,26
10,Success,53,29,0,12,41
10,Success,48,41,0,10,38
10,Success,50,28,0,14,36
10,Success,53,32,0,12,41
10,Success,46,36,3,15,31
10,Success,53,36,0,9,44
10,Success,50,31,0,13,37
10,Success,55,33,3,9,46
10,Success,49,37,0,12,37
10,Success,43,41,1,15,28
10,Success,39,42,0,12,27
10,Success,43,35,9,13,30
10,Success,50,35,2,13,37
10,Success,47,37,2,14,33
10,Success,45,36,2,17,28
10,Success,53,30,6,11,42
10,Success,43,44,0,13,30
10,Success,45,35,0,17,28
10,Success,43,38,0,15,28
10,Success,45,42,2,11,34
10,Success,55,34,0,8,47
10,Success,50,30,5,15,35
10,Success,52,36,0,9,43
10,Success,48,33,0,15,33
10,Success,47,43,2,8,39
10,Success,46,38,2,14,32
10,Success,42,38,7,13,29
10,Success,44,40,5,11,33
10,Success,53,35,1,11,42
10,Success,51,34,3,12,39
10,Success,42,42,0,12,30
10,Success,49,37,0,12,37
10,Success,40,39,0,17,23
10,Success,44,44,0,9,35
10,Success,51,38,0,10,41
10,Success,42,36,7,15,27
10,Success,47,31,0,14,33
10,Success,47,38,0,14,33
10,Success,47,29,0,15,32
10,Success,47,34,0,7,40
10,Success,43,36,6,15,28
10,Success,54,31,3,12,42
10,Success,43,40,0,16,27
10,Success,49,36,5,10,39
10,Success,43,41,0,11,32
10,Success,46,43,2,9,37
10,Success,50,34,0,13,37
10,Success,46,37,0,17,29
10,Success,45,41,1,13,32
10,Success,50,28,3,19,31
10,Success,43,34,0,18,25
10,Success,46,37,5,12,34
10,Success,44,31,0,13,31
10,Success,42,41,3,14,28
10,Success,50,39,3,8,42
10,Success,48,37,6,9,39
10,Success,45,33,7,15,30
10,Success,48,38,1,13,35
10,Success,37,41,0,15,22
10,Success,44,40,0,11,33
10,Success,36,42,0,19,17
10,Success,43,42,3,12,31
10,Success,44,36,10,10,34
10,Success,50,38,0,12,38
10,Success,48,35,7,10,38
10,Success,51,39,0,8,43
10,Success,50,37,0,11,39
10,Success,45,36,4,15,30
10,Success,44,35,0,15,29
10,Success,50,36,3,11,39
10,Success,52,32,1,15,37
10,Success,45,29,13,13,32
10,Success,50,32,3,15,35
10,Success,46,42,0,10,36
10,Success,48,27,9,16,32
10,Success,44,31,0,14,30
10,Success,47,39,0,14,33
10,Success,56,32,0,12,44
10,Success,53,38,3,6,47
10,Success,47,38,0,14,33
10,Success,41,42,0,14,27
10,Success,50,39,1,10,40
10,Success,41,42,4,13,28
10,Success,53,35,0,8,45
10,Success,49,30,8,13,36
10,Success,46,34,0,15,31
10,Success,50,30,0,15,35
10,Success,54,30,0,12,42
10,Success,45,32,0,13,32
10,Success,52,33,0,14,38
10,Success,42,42,0,11,31
10,Success,56,29,0,14,42
10,Success,49,32,0,15,34
10,Success,38,43,0,17,21
10,Success,50,36,2,12,38
10,Success,53,27,0,18,35
10,Success,51,38,0,9,42
10,Success,44,38,0,18,26
10,Success,45,29,0,14,31
10,Success,52,31,4,13,39
10,Success,50,40,1,9,41
10,Success,51,38,4,7,44
10,Success,48,44,1,7,41
10,Success,56,28,2,14,42
10,Success,47,43,0,10,37
10,Success,52,34,6,8,44
10,Success,51,33,3,13,38
10,Success,51,34,1,14,37
10,Success,53,34,3,10,43
10,Success,49,40,3,8,41
10,Success,41,36,0,19,22
10,Success,46,38,0,13,33
10,Success,50,28,7,15,35
10,Success,52,30,5,13,39
10,Success,45,38,1,16,29
10,Success,45,45,0,9,36
10,Success,49,38,1,12,37
10,Success,41,33,8,18,23
10,Success,49,37,0,9,40
10,Success,39,33,0,17,22
10,Success,46,27,6,21,25
10,Success,43,32,11,14,29
10,Success,48,33,4,15,33
10,Success,49,36,2,13,36
10,Success,53,29,0,14,39
10,Success,52,36,0,7,45
10,Success,57,28,6,9,48
10,Success,45,37,0,12,33
10,Success,39,32,0,18,21
10,Success,39,42,0,18,21
10,Success,44,40,5,11,33
10,Success,52,35,5,8,44
10,Success,45,39,8,8,37
10,Success,49,32,0,16,33
10,Success,43,40,6,11,32
10,Success,50,36,0,9,41
10,Success,50,34,0,16,34
10,Success,47,40,2,11,36
10,Success,45,44,2,9,36
10,Success,52,34,0,11,41
10,Success,50,35,3,12,38
10,Success,48,35,1,16,32
10,Success,55,28,3,14,41
10,Success,50,39,1,10,40
10,Success,42,34,8,16,26
10,Success,48,36,0,13,35
10,Success,54,33,0,13,41
10,Success,53,36,0,11,42
10,Success,51,37,0,10,41
10,Success,49,42,2,7,42
10,Success,43,33,7,17,26
10,Success,46,33,0,19,27
10,Success,47,39,0,14,33
10,Success,49,36,1,14,35
10,Success,52,35,0,10,42
10,Success,46,30,0,19,27
10,Success,50,30,0,15,35
10,Success,49,39,6,6,43
10,Success,49,37,0,12,37
10,Success,51,38,0,11,40
10,Success,40,36,10,14,26
10,Success,52,40,0,8,44
10,Success,41,32,11,16,25
10,Success,48,28,0,15,33
10,Success,52,42,1,5,47
10,Success,46,40,0,12,34
10,Success,44,42,3,11,33
10,Success,51,37,0,10,41
10,Success,49,39,0,12,37
10,Success,49,30,0,18,31
10,Success,48,44,0,8,40
10,Success,49,30,0,15,34
10,Success,49,34,1,16,33
10,Success,47,33,2,18,29
10,Success,41,43,0,12,29
10,Success,48,32,0,19,29
10,Success,38,40,4,18,20
10,Success,50,32,0,9,41
10,Success,50,33,0,11,39
10,Success,49,32,6,13,36
10,Success,49,40,2,9,40
10,Success,54,28,0,15,39
10,Success,49,36,0,11,38
10,Success,51,38,0,8,43
10,Success,46,32,8,14,32
10,Success,51,34,0,14,37
10,Success,45,39,7,9,36
10,Success,38,40,0,11,27
10,Success,45,41,0,12,33
10,Success,51,36,0,10,41
10,Success,51,34,0,15,36
10,Success,45,36,0,15,30
10,Success,38,41,9,12,26
10,Success,42,40,3,15,27
10,Success,45,41,2,12,33
10,Success,48,32,6,14,34
10,Success,54,32,0,10,44
10,Success,45,36,0,10,35
10,Success,52,33,0,13,39
10,Success,42,36,0,13,29
10,Success,41,38,0,14,27
10,Success,39,33,0,19,20
10,Success,59,30,0,11,48
10,Success,50,38,0,11,39
10,Success,47,37,2,14,33
10,Success,41,42,0,14,27
10,Success,56,30,3,11,45
10,Success,46,32,5,17,29
10,Success,46,29,0,13,33
10,Success,53,35,0,11,42
10,Success,45,40,0,14,31
10,Success,50,40,2,8,42
10,Success,42,36,6,16,26
10,Success,50,33,0,15,35
10,Success,45,30,0,23,22
10,Success,50,39,0,11,39
10,Success,50,34,0,13,37
10,Success,53,32,0,10,43
10,Success,52,31,6,11,41
10,Success,43,39,1,17,26
10,Success,40,39,7,14,26
10,Success,47,41,0,10,37
10,Success,49,36,5,10,39
10,Success,50,37,5,8,42
10,Success,47,39,0,11,36
10,Success,42,41,0,13,29
10,Success,54,32,0,11,43
10,Success,50,25,0,20,30
10,Success,50,31,0,11,39
10,Success,49,32,0,14,35
10,Success,49,31,0,12,37
10,Success,50,37,1,12,38
10,Success,51,39,3,7,44
10,Success,52,34,10,4,48
10,Success,53,33,0,10,43
10,Success,48,40,0,10,38
10,Success,49,39,0,8,41
10,Success,56,32,0,12,44
10,Success,47,31,11,11,36
10,Success,52,36,0,12,40
10,Success,47,38,0,10,37
10,Success,53,37,0,9,44
10,Success,47,40,0,13,34
10,Success,55,34,4,7,48
10,Success,44,37,6,13,31
10,Success,54,32,1,13,41
10,Success,42,40,6,12,30
10,Success,54,39,0,6,48
10,Success,58,29,6,7,51
10,Success,42,34,5,19,23
10,Success,45,35,4,16,29
10,Success,49,39,0,11,38
10,Success,49,35,5,11,38
10,Success,47,29,11,13,34
10,Success,50,30,0,15,35
10,Success,44,35,5,16,28
10,Success,44,42,5,9,35
10,Success,47,42,1,10,37
10,Success,46,35,4,15,31
10,Success,61,32,3,4,57
10,Success,41,31,13,15,26
10,Success,44,36,9,11,33
10,Success,49,34,4,13,36
10,Success,47,31,9,13,34
10,Success,50,30,7,13,37
10,Success,54,34,0,10,44
10,Success,51,36,1,12,39
10,Success,39,37,8,16,23
10,Success,40,42,0,14,26
10,Success,51,39,0,10,41
10,Success,46,33,0,16,30
10,Success,49,36,4,11,38
10,Success,53,32,4,11,42
10,Success,51,41,0,8,43
10,Success,48,31,6,15,33
10,Success,46,33,0,15,31
10,Success,52,36,6,6,46
10,Success,48,31,7,14,34
10,Success,52,34,3,11,41
10,Success,53,33,4,10,43
10,Success,48,34,0,9,39
10,Success,42,35,0,17,25
10,Success,49,35,2,14,35
10,Success,56,33,0,8,48
10,Success,51,34,0,13,38
10,Success,39,31,0,18,21
10,Success,50,32,4,14,36
10,Success,47,31,2,20,27
10,Success,57,33,0,10,47
10,Success,46,31,5,18,28
10,Success,50,31,3,16,34
10,Success,46,30,8,16,30
10,Success,50,35,4,11,39
10,Success,37,39,0,16,21
10,Success,52,35,0,9,43
10,Success,47,39,0,10,37
10,Success,44,46,3,7,37
10,Success,49,36,0,15,34
10,Success,49,31,13,7,42
10,Success,46,33,2,19,27
10,Success,55,29,1,15,40
10,Success,49,39,1,11,38
10,Success,51,32,0,15,36
10,Success,52,37,0,10,42
10,Success,47,40,2,11,36
10,Success,42,43,0,13,29
10,Success,45,38,5,12,33
10,Success,48,35,0,12,36
10,Success,55,34,1,10,45
10,Success,42,44,8,6,36
10,Success,48,43,0,9,39
10,Success,42,41,0,10,32
10,Success,48,32,7,13,35
10,Success,58,33,3,6,52
10,Success,46,40,4,10,36
10,Success,44,40,0,12,32
10,Success,49,36,0,14,35
10,Success,55,35,0,8,47
10,Success,51,36,1,12,39
10,Success,54,35,0,11,43
10,Success,40,45,0,14,26
10,Success,43,43,0,9,34
10,Success,46,37,0,15,31
10,Success,54,28,4,14,40
10,Success,50,38,0,11,39
10,Success,46,37,0,14,32
10,Success,39,40,0,11,28
10,Success,44,42,0,11,33
10,Success,44,40,0,16,28
10,Success,57,27,0,12,45
10,Success,37,42,0,15,22
10,Success,54,32,0,12,42
10,Success,46,36,9,9,37
10,Success,44,37,0,12,32
10,Success,59,30,2,9,50
10,Success,56,32,1,11,45
10,Success,48,28,0,19,29
10,Success,55,33,0,12,43
10,Success,47,29,0,15,32
10,Success,44,30,10,16,28
10,Success,53,32,1,14,39
10,Success,48,29,0,19,29
10,Success,40,41,8,11,29
10,Success,48,31,0,15,33
10,Success,52,35,0,8,44
10,Success,49,32,13,6,43
10,Success,35,41,2,22,13
10,Success,48,40,4,8,40
10,Success,51,30,0,16,35
10,Success,53,31,0,10,43
10,Success,52,30,1,17,35
10,Success,47,34,3,16,31
10,Success,53,30,1,16,37
10,Success,49,32,0,14,35
10,Success,50,32,0,13,37
10,Success,46,31,1,22,24
10,Success,48,39,0,12,36
10,Success,52,36,0,12,40
10,Success,48,35,3,14,34
10,Success,56,25,0,16,40
10,Success,41,36,0,18,23
10,Success,50,37,4,9,41
10,Success,48,37,0,13,35
10,Success,46,36,0,10,36
10,Success,48,38,3,11,37
10,Success,47,37,0,12,35
10,Success,53,36,1,10,43
10,Success,53,37,1,9,44
10,Success,49,39,0,11,38
10,Success,50,30,4,16,34
10,Success,49,33,0,17,32
10,Success,48,34,0,18,30
10,Success,55,33,1,11,44
10,Success,49,29,0,14,35
10,Success,53,31,2,14,39
10,Success,38,42,3,17,21
10,Success,47,31,2,20,27
10,Success,44,39,0,10,34
10,Success,53,30,0,14,39
10,Success,47,37,0,12,35
10,Success,50,36,0,14,36
10,Success,42,43,4,11,31
10,Success,52,28,10,10,42
10,Success,46,40,0,10,36
10,Success,47,37,1,15,32
10,Success,41,42,4,13,28
10,Success,43,38,4,15,28
10,Success,55,31,0,14,41
10,Success,47,32,0,16,31
10,Success,47,34,0,19,28
10,Success,46,29,0,9,37
10,Success,42,41,0,13,29
10,Success,53,38,3,6,47
10,Success,44,32,0,24,20
10,Success,43,36,6,15,28
10,Success,53,35,0,10,43
10,Success,43,40,4,13,30
10,Success,54,23,9,14,40
10,Success,44,37,2,17,27
10,Success,41,42,3,14,27
10,Success,43,36,5,16,27
10,Success,47,38,2,13,34
10,Success,45,41,2,12,33
10,Success,52,33,5,10,42
10,Success,52,35,0,7,45
10,Success,52,36,0,10,42
10,Success,53,38,4,5,48
10,Success,44,39,0,16,28
10,Success,41,33,9,17,24
10,Success,39,38,0,20,19
10,Success,48,40,0,10,38
10,Success,49,31,4,16,33
10,Success,46,36,6,12,34
10,Success,51,28,3,18,33
10,Success,51,35,0,14,37
10,Success,42,41,0,9,33
10,Success,49,37,0,13,36
10,Success,46,40,0,11,35
10,Success,38,39,0,17,21
10,Success,45,34,11,10,35
10,Success,52,31,6,11,41
10,Success,50,31,0,14,36
10,Success,49,37,5,9,40
10,Success,48,35,0,15,33
10,Success,42,43,1,14,28
10,Success,48,36,8,8,40
10,Success,54,25,8,13,41
10,Success,53,31,0,13,40
10,Success,47,39,2,12,35
10,Success,48,31,8,13,35
10,Success,49,34,0,12,37
10,Success,48,34,3,15,33
10,Success,53,32,0,13,40
10,Success,44,39,5,12,32
10,Success,47,32,0,16,31
10,Success,51,36,2,11,40
10,Success,50,25,0,20,30
10,Success,43,36,1,20,23
10,Success,39,46,0,9,30
10,Success,43,31,0,16,27
10,Success,46,38,0,13,33
10,Success,53,32,0,13,40
10,Success,46,36,0,15,31
10,Success,48,33,7,12,36
10,Success,44,33,8,15,29
10,Success,38,37,0,17,21
10,Success,37,42,4,17,20
10,Success,46,40,0,7,39
10,Success,53,25,6,16,37
10,Success,49,32,5,14,35
10,Success,45,34,0,16,29
10,Success,45,40,0,11,34
10,Success,47,33,5,15,32
10,Success,43,36,0,18,25
10,Success,45,23,0,22,23
10,Success,46,26,13,15,31
10,Success,43,32,0,17,26
10,Success,51,31,5,13,38
10,Success,42,35,5,18,24
10,Success,48,28,0,10,38
10,Success,48,33,6,13,35
10,Success,46,41,1,12,34
10,Success,54,32,0,10,44
10,Success,53,32,0,13,40
10,Success,45,35,0,15,30
10,Success,51,29,3,17,34
10,Success,49,34,2,15,34
10,Success,50,38,3,9,41
10,Success,52,39,2,7,45
10,Success,46,38,0,7,39
10,Success,53,36,0,9,44
10,Success,53,31,0,15,38
10,Success,49,32,6,13,36
10,Success,50,31,9,10,40
10,Success,45,37,0,13,32
10,Success,40,47,0,10,30
10,Success,50,37,0,12,38
10,Success,47,35,6,12,35
10,Success,42,41,0,12,30
10,Success,51,33,2,14,37
10,Success,55,31,4,10,45
10,Success,47,34,0,11,36
10,Success,49,35,0,14,35
10,Success,56,27,0,11,45
10,Success,38,40,7,15,23
10,Success,44,36,7,13,31
10,Success,55,33,0,11,44
10,Success,47,39,0,8,39
10,Success,48,34,0,15,33
10,Success,51,31,0,15,36
10,Success,48,36,0,14,34
10,Success,45,36,2,17,28
10,Success,47,41,3,9,38
10,Success,44,40,0,16,28
10,Success,42,37,6,15,27
10,Success,45,39,2,14,31
10,Success,45,38,7,10,35
10,Success,39,33,0,14,25
10,Success,43,32,0,14,29
10,Success,46,38,0,12,34
10,Success,56,35,0,7,49
10,Success,47,32,0,13,34
10,Success,47,33,8,12,35
10,Success,43,36,0,14,29
10,Success,43,37,8,12,31
10,Success,44,43,1,12,32
10,Success,47,42,1,10,37
10,Success,45,27,0,19,26
10,Success,46,37,4,13,33
10,Success,52,35,2,11,41
10,Success,45,37,7,11,34
10,Success,46,32,0,17,29
10,Success,47,34,1,18,29
10,Success,48,39,0,13,35
10,Success,48,34,0,14,34
10,Success,49,36,1,14,35
10,Success,47,33,0,17,30
10,Success,42,44,6,8,34
10,Success,38,44,3,15,23
10,Success,51,36,3,10,41
10,Success,54,37,0,8,46
10,Success,51,32,0,8,43
10,Success,51,39,0,5,46
10,Success,56,32,0,12,44
10,Success,50,31,0,14,36
10,Success,53,27,0,14,39
10,Success,58,31,0,7,51
10,Success,41,36,6,17,24
10,Success,48,39,3,10,38
10,Success,44,34,0,17,27
10,Success,55,34,0,10,45
10,Success,47,40,0,12,35
10,Success,49,36,2,13,36
10,Success,41,40,0,17,24
10,Success,49,42,0,9,40
10,Success,47,35,0,12,35
10,Success,53,33,0,11,42
10,Success,48,30,0,19,29
10,Success,51,30,0,19,32
10,Success,41,43,0,16,25
10,Success,49,36,7,8,41
10,Success,49,44,0,6,43
10,Success,53,32,0,12,41
10,Success,45,44,5,6,39
10,Success,48,39,6,7,41
10,Success,51,33,0,12,39
10,Success,55,33,0,11,44
10,Success,49,39,0,11,38
10,Success,47,44,2,7,40
10,Success,57,33,0,9,48
10,Success,54,34,0,11,43
10,Success,50,35,0,10,40
10,Success,55,36,1,8,47
10,Success,49,35,0,14,35
10,Success,47,36,2,15,32
10,Success,45,35,0,14,31
10,Success,39,43,5,13,26
10,Success,51,31,8,10,41
10,Success,48,30,5,17,31
10,Success,41,38,0,10,31
10,Success,53,33,0,7,46
10,Success,47,37,1,15,32
10,Success,43,42,0,14,29
10,Success,39,37,0,18,21
10,Success,61,29,0,7,54
10,Success,48,27,10,15,33
10,Success,44,34,0,9,35
10,Success,45,37,6,12,33
10,Success,57,31,2,10,47
10,Success,44,49,3,4,40
10,Success,54,33,1,12,42
10,Success,47,37,0,9,38
10,Success,55,34,2,9,46
10,Success,46,39,0,10,36
10,Success,45,37,0,12,33
10,Success,51,38,0,9,42
10,Success,46,36,0,12,34
10,Success,55,33,0,8,47
10,Success,51,39,0,10,41
10,Success,46,34,0,15,31
10,Success,45,37,0,9,36
10,Success,42,38,6,14,28
10,Success,51,30,0,16,35
10,Success,49,39,0,11,38
10,Success,47,34,4,15,32
10,Success,40,32,10,18,22
10,Success,52,36,0,10,42
10,Success,41,35,0,17,24
10,Success,48,33,3,16,32
10,Success,47,34,0,13,34
10,Success,43,41,0,13,30
10,Success,51,37,3,9,42
10,Success,41,38,0,12,29
10,Success,45,39,7,9,36
10,Success,55,33,0,11,44
10,Success,41,42,0,14,27
10,Success,51,37,0,10,41
10,Success,44,37,0,15,29
10,Success,55,31,5,9,46
10,Success,53,29,0,14,39
10,Success,46,36,2,16,30
10,Success,54,38,0,7,47
10,Success,44,44,0,12,32
10,Success,48,36,0,16,32
10,Success,50,36,2,12,38
10,Success,49,34,0,14,35
10,Success,49,33,2,16,33
10,Success,50,35,0,11,39
10,Success,45,37,0,11,34
10,Success,45,39,2,14,31
10,Success,38,43,0,15,23
10,Success,50,39,0,6,44
10,Success,52,31,7,10,42
10,Success,49,36,0,7,42
10,Success,49,38,7,6,43
10,Success,51,31,8,10,41
10,Success,44,41,0,14,30
10,Success,44,34,5,17,27
10,Success,46,38,0,15,31
10,Success,46,36,0,14,32
10,Success,46,36,5,13,33
10,Success,53,34,1,12,41
10,Success,52,34,3,11,41
10,Success,56,32,0,6,50
10,Success,44,37,2,17,27
10,Success,57,31,1,11,46
10,Success,51,29,1,19,32
10,Success,50,40,0,8,42
10,Success,48,30,0,14,34
10,Success,49,33,6,12,37
10,Success,38,44,0,18,20
10,Success,49,35,0,14,35
10,Success,50,35,0,6,44
10,Success,48,32,5,15,33
10,Success,54,33,1,12,42
10,Success,47,33,8,12,35
10,Success,50,33,4,13,37
10,Success,50,34,2,14,36
10,Success,48,42,0,6,42
10,Success,48,37,4,11,37
10,Success,43,36,0,19,24
10,Success,47,37,0,10,37
10,Success,49,27,2,22,27
10,Success,38,35,0,23,15
10,Success,42,39,0,17,25
10,Success,48,39,2,11,37
10,Success,52,38,2,8,44
10,Success,45,34,0,13,32
10,Success,48,35,0,10,38
10,Success,51,40,0,6,45
10,Success,40,43,0,13,27
10,Success,46,37,0,6,40
10,Success,47,34,0,18,29
10,Success,52,37,4,7,45
10,Success,49,34,1,16,33
10,Success,53,29,5,13,40
10,Success,55,34,0,11,44
10,Success,47,24,0,20,27
10,Success,47,39,0,12,35
10,Success,38,43,0,8,30
10,Success,48,36,0,15,33
10,Success,53,33,3,11,42
10,Success,50,40,1,9,41
10,Success,43,35,0,13,30
10,Success,53,37,1,9,44
10,Success,45,37,0,10,35
10,Success,44,38,2,16,28
10,Success,53,35,0,10,43
10,Success,53,30,1,16,37
10,Success,41,38,5,16,25
10,Success,56,30,3,11,45
10,Success,47,40,0,13,34
10,Success,44,41,7,8,36
10,Success,54,34,3,9,45
10,Success,57,33,3,7,50
10,Success,47,40,4,9,38
10,Success,47,39,0,13,34
10,Success,59,23,6,12,47
10,Success,49,36,0,11,38
10,Success,50,38,1,11,39
10,Success,48,30,4,18,30
10,Success,53,32,0,12,41
10,Success,48,32,0,11,37
10,Success,48,42,1,9,39
10,Success,46,34,0,15,31
10,Success,56,32,0,11,45
10,Success,51,32,6,11,40
10,Success,50,28,12,10,40
10,Success,46,43,2,9,37
10,Success,44,35,3,18,26
10,Success,46,39,5,10,36
10,Success,48,41,0,8,40
10,Success,55,30,2,13,42
10,Success,51,36,0,10,41
10,Success,48,33,0,13,35
10,Success,48,35,1,16,32
10,Success,44,42,1,13,31
10,Success,53,38,0,9,44
10,Success,42,42,4,12,30
10,Success,49,32,0,10,39
10,Success,48,28,12,12,36
10,Success,45,38,0,13,32
10,Success,47,31,11,11,36
10,Success,50,38,0,12,38
10,Success,42,38,7,13,29
10,Success,56,23,0,15,41
10,Success,45,36,3,16,29
10,Success,49,36,3,12,37
10,Success,46,41,3,10,36
10,Success,52,33,0,10,42
10,Success,41,40,9,10,31
10,Success,51,38,0,10,41
10,Success,52,32,2,14,38
10,Success,51,33,0,15,36
10,Success,49,42,1,8,41
10,Success,44,38,2,16,28
10,Success,49,40,1,10,39
10,Success,45,41,2,12,33
10,Success,53,27,0,17,36
10,Success,51,36,0,12,39
10,Success,51,29,0,14,37
10,Success,45,43,1,11,34
10,Success,47,38,0,10,37
10,Success,44,44,1,11,33
10,Success,44,39,0,17,27
10,Success,48,43,0,9,39
10,Success,45,27,13,15,30
10,Success,49,32,0,9,40
10,Success,49,28,9,14,35
10,Success,51,36,9,4,47
10,Success,49,33,3,15,34
10,Success,41,42,0,17,24
10,Success,49,37,1,13,36
10,Success,44,31,0,12,32
10,Success,48,31,0,14,34
10,Success,50,35,0,14,36
10,Success,38,36,5,21,17
10,Success,49,35,0,12,37
10,Fail,31,30,0,24,7
10,Success,42,34,4,20,22
10,Success,40,40,0,16,24
10,Success,42,39,0,15,27
10,Success,50,41,3,6,44
10,Success,44,36,0,11,33
10,Success,58,26,4,12,46
10,Success,49,28,11,12,37
10,Success,37,47,10,6,31
10,Success,44,40,7,9,35
10,Success,51,35,2,12,39
10,Success,51,34,2,13,38
10,Success,49,34,0,11,38
10,Success,50,35,2,13,37
10,Success,50,35,0,11,39
10,Success,47,31,0,14,33
10,Success,50,32,1,17,33
10,Success,49,40,0,11,38
10,Success,42,37,0,18,24
10,Success,49,38,1,12,37
10,Success,47,38,8,7,40
10,Success,49,31,3,17,32
10,Success,46,33,0,17,29
10,Success,53,31,0,12,41
10,Success,52,32,0,13,39
10,Success,52,34,6,8,44
10,Success,51,31,3,15,36
10,Success,46,34,3,17,29
10,Success,55,30,0,12,43
10,Success,41,36,8,15,26
10,Success,48,36,0,9,39
10,Success,37,45,0,6,31
10,Success,48,36,8,8,40
10,Success,49,35,4,12,37
10,Success,47,26,13,14,33
10,Success,48,32,0,14,34
10,Success,56,31,1,12,44
10,Success,50,35,2,13,37
10,Success,46,37,5,12,34
10,Success,53,28,1,18,35
10,Success,40,41,0,11,29
10,Success,47,40,1,12,35
10,Success,45,27,0,21,24
10,Success,52,36,0,11,41
10,Success,52,32,0,11,41
10,Success,46,37,0,17,29
10,Success,50,34,1,15,35
10,Success,50,37,9,4,46
10,Success,49,34,6,11,38
10,Success,48,34,0,13,35
10,Success,39,45,2,14,25
10,Success,38,41,9,12,26
10,Success,50,33,0,15,35
10,Success,51,35,0,12,39
10,Success,44,37,6,13,31
10,Success,54,35,0,11,43
10,Success,44,37,4,15,29
10,Success,59,26,0,15,44
10,Success,55,35,3,7,48
10,Success,51,30,0,14,37
10,Success,45,38,0,12,33
10,Success,53,38,0,8,45
10,Success,46,31,5,18,28
10,Success,61,32,0,7,54
10,Success,57,30,0,13,44
10,Success,47,35,0,13,34
10,Success,51,32,0,13,38
10,Success,49,36,5,10,39
10,Success,43,41,5,11,32
10,Success,50,32,2,16,34
10,Success,51,38,0,11,40
10,Success,54,32,1,13,41
10,Success,54,32,0,12,42
10,Success,51,40,1,8,43
10,Success,49,26,0,14,35
10,Success,47,37,4,12,35
10,Success,53,35,2,10,43
10,Success,49,35,2,14,35
10,Success,48,43,2,7,41
10,Success,53,31,7,9,44
10,Success,47,35,3,15,32
10,Success,49,35,0,15,34
10,Success,56,32,0,10,46
10,Success,56,34,0,10,46
10,Success,49,41,0,9,40
10,Success,54,32,3,11,43
10,Success,47,38,0,13,34
10,Success,51,37,3,9,42
10,Success,51,35,2,12,39
10,Success,51,29,0,14,37
10,Success,48,33,0,11,37
10,Success,45,33,6,16,29
10,Success,52,32,0,15,37
10,Success,48,41,0,9,39
10,Success,53,32,7,8,45
10,Success,42,37,9,12,30
10,Success,54,29,6,11,43
10,Success,54,36,0,9,45
10,Success,43,34,7,16,27
10,Success,47,35,8,10,37
10,Success,45,29,9,17,28
10,Success,50,34,1,15,35
10,Success,50,32,0,11,39
10,Success,48,37,0,14,34
10,Success,39,40,0,20,19
10,Success,47,33,5,15,32
10,Success,49,37,0,13,36
10,Success,44,42,0,14,30
10,Success,47,34,0,14,33
10,Success,50,39,0,10,40
10,Success,53,35,3,9,44
10,Success,49,39,2,10,39
10,Success,50,39,0,8,42
10,Success,44,38,0,14,30
10,Success,50,34,6,10,40
10,Success,51,35,0,14,37
10,Success,49,41,3,7,42
10,Success,49,36,0,15,34
10,Success,48,41,0,11,37
10,Success,55,38,0,5,50
10,Success,54,30,0,15,39
10,Success,42,40,3,15,27
10,Success,49,37,3,11,38
10,Success,42,36,0,16,26
10,Success,48,34,0,14,34
10,Success,49,38,1,12,37
10,Success,49,39,0,9,40
10,Success,46,34,0,19,27
10,Success,41,39,0,13,28
10,Success,52,42,0,6,46
10,Success,47,33,0,12,35
10,Success,46,39,9,6,40
10,Success,47,42,0,8,39
10,Success,50,40,2,8,42
10,Success,53,36,1,10,43
10,Success,51,34,6,9,42
10,Success,48,40,0,9,39
10,Success,38,31,13,18,20
10,Success,55,29,0,11,44
10,Success,48,36,1,15,33
10,Success,51,30,0,12,39
10,Success,48,33,6,13,35
10,Success,46,39,0,14,32
10,Success,42,39,4,15,27
10,Success,47,39,0,13,34
10,Success,45,33,12,10,35
10,Success,46,36,0,16,30
10,Success,41,46,0,12,29
10,Success,46,43,0,9,37
10,Success,40,43,4,13,27
10,Success,53,30,0,17,36
10,Success,43,33,14,10,33
10,Success,43,33,5,19,24
10,Success,50,37,0,9,41
10,Success,47,34,5,14,33
10,Success,48,43,0,8,40
10,Success,54,33,5,8,46
10,Success,51,38,0,11,40
10,Success,51,35,0,12,39
10,Success,45,40,1,14,31
10,Success,50,39,0,9,41
10,Success,38,44,0,17,21
10,Success,48,37,0,12,36
10,Success,52,33,0,15,37
10,Success,48,35,0,13,35
10,Success,49,34,0,15,34
10,Success,46,43,0,9,37
10,Success,44,37,4,15,29
10,Success,50,32,0,12,38
10,Success,58,27,0,7,51
10,Success,39,39,6,16,23
10,Success,54,29,6,11,43
10,Success,51,39,2,8,43
10,Success,57,36,3,4,53
10,Success,52,29,7,12,40
10,Success,44,40,0,15,29
10,Success,56,31,1,12,44
10,Success,51,37,3,9,42
10,Success,44,35,0,19,25
10,Success,46,41,0,12,34
10,Success,53,38,0,9,44
10,Success,47,37,7,9,38
10,Success,52,41,1,6,46
10,Success,55,34,1,10,45
10,Success,53,34,0,12,41
10,Success,54,37,2,7,47
10,Success,63,26,1,10,53
10,Success,40,42,0,17,23
10,Success,48,41,2,9,39
10,Success,54,34,1,11,43
10,Success,54,32,0,13,41
10,Success,45,36,0,14,31
10,Success,52,28,5,15,37
10,Success,55,38,0,7,48
10,Success,49,30,5,16,33
10,Success,40,40,0,13,27
10,Success,50,42,0,6,44
10,Success,56,33,4,7,49
10,Success,44,38,0,12,32
10,Success,47,38,3,12,35
10,Success,45,37,1,17,28
10,Success,49,39,2,10,39
10,Success,50,34,1,15,35
10,Success,48,38,1,13,35
10,Success,47,38,0,12,35
10,Success,49,39,0,12,37
10,Success,48,41,2,9,39
10,Success,46,36,0,15,31
10,Success,51,37,0,12,39
10,Success,50,34,5,11,39
10,Success,51,41,0,8,43
10,Success,44,42,7,7,37
10,Success,47,29,9,15,32
10,Success,50,32,6,12,38
10,Success,53,31,0,10,43
10,Success,36,46,0,11,25
10,Success,35,41,4,20,15
10,Success,51,33,5,11,40
10,Success,52,31,2,15,37
10,Success,46,31,0,20,26
10,Success,36,30,17,17,19
10,Success,51,35,1,13,38
10,Success,47,36,4,13,34
10,Success,42,38,3,17,25
10,Success,50,36,0,13,37
10,Success,41,37,0,18,23
10,Success,54,36,0,9,45
10,Success,57,36,1,6,51
10,Success,45,38,0,11,34
10,Success,47,39,0,14,33
10,Success,48,32,8,12,36
10,Success,50,37,0,11,39
10,Success,49,35,4,12,37
10,Success,46,31,0,18,28
10,Success,50,29,0,14,36
10,Success,43,40,3,14,29
10,Success,39,41,4,16,23
10,Success,51,36,0,11,40
10,Success,54,35,0,11,43
10,Success,48,36,0,14,34
10,Success,50,37,2,11,39
10,Success,49,34,1,16,33
10,Success,46,37,0,17,29
10,Success,47,38,2,13,34
10,Success,49,34,3,14,35
10,Success,47,36,0,15,32
10,Success,53,40,1,6,47
10,Success,55,29,6,10,45
10,Success,50,42,0,5,45
10,Success,50,31,3,16,34
10,Success,43,28,11,18,25
10,Success,42,43,0,6,36
10,Success,53,28,0,16,37
10,Success,49,31,3,17,32
10,Success,47,29,0,17,30
10,Success,49,38,0,4,45
10,Success,42,36,3,19,23
10,Success,48,29,0,18,30
10,Success,47,33,0,14,33
10,Success,46,31,6,17,29
10,Success,49,40,0,11,38
10,Success,53,32,0,12,41
10,Success,53,34,1,12,41
10,Success,52,33,0,10,42
10,Success,48,35,0,13,35
10,Success,46,38,0,15,31
10,Success,53,32,0,13,40
10,Success,50,35,0,11,39
10,Success,40,33,9,18,22
10,Success,44,35,3,18,26
10,Success,44,35,0,20,24
10,Success,50,35,0,15,35
10,Success,51,32,4,13,38
10,Success,42,35,0,20,22
10,Success,46,40,0,14,32
10,Success,44,30,15,11,33
10,Success,50,39,0,7,43
10,Success,45,36,0,13,32
10,Success,53,37,0,8,45
10,Success,53,34,2,11,42
10,Success,50,35,3,12,38
10,Success,57,31,0,7,50
10,Success,42,42,2,14,28
10,Success,50,35,4,11,39
10,Success,55,28,2,15,40
10,Success,42,37,5,16,26
10,Success,46,36,5,13,33
10,Success,41,35,1,23,18
10,Success,48,37,0,8,40
10,Success,52,32,4,12,40
10,Success,54,33,2,11,43
10,Success,49,30,0,14,35
10,Success,53,29,0,17,36
10,Success,50,28,7,15,35
10,Success,49,37,0,14,35
10,Success,54,37,1,8,46
10,Success,47,36,0,17,30
10,Success,52,32,0,13,39
10,Success,51,36,4,9,42
10,Success,47,32,0,16,31
10,Success,50,34,3,13,37
10,Success,45,30,9,16,29
10,Success,39,42,0,12,27
10,Success,49,35,4,12,37
10,Success,41,42,5,12,29
10,Success,44,34,0,14,30
10,Success,41,37,5,17,24
10,Success,50,41,2,7,43
10,Success,52,31,0,12,40
10,Success,47,40,4,9,38
10,Success,42,41,0,14,28
10,Success,40,33,9,18,22
10,Success,52,32,1,15,37
10,Success,49,29,0,18,31
10,Success,47,34,6,13,34
10,Success,47,35,0,16,31
10,Success,37,37,10,16,21
10,Success,49,40,0,11,38
10,Success,51,25,8,16,35
10,Success,47,35,0,17,30
10,Success,54,35,0,11,43
10,Success,54,27,7,12,42
10,Success,48,34,0,15,33
10,Success,54,32,0,10,44
10,Success,46,32,0,14,32
10,Success,43,32,14,11,32
10,Success,47,31,0,14,33
10,Success,36,36,0,15,21
10,Success,47,36,7,10,37
10,Success,43,37,8,12,31
10,Success,51,35,0,13,38
10,Success,46,33,3,18,28
10,Success,47,36,9,8,39
10,Success,46,44,0,10,36
10,Success,52,36,2,10,42
10,Success,47,34,8,11,36
10,Success,44,37,7,12,32
10,Success,44,44,0,12,32
10,Success,47,39,0,12,35
10,Success,38,44,2,16,22
10,Success,48,35,4,13,35
10,Success,44,33,0,20,24
10,Success,42,42,2,14,28
10,Success,54,35,2,9,45
10,Success,48,31,2,19,29
10,Success,40,42,0,13,27
10,Success,52,40,0,8,44
10,Success,56,31,0,10,46
10,Success,47,39,0,11,36
10,Success,40,47,0,12,28
10,Success,48,41,2,9,39
10,Success,49,25,5,21,28
10,Success,57,32,0,10,47
10,Success,44,39,1,16,28
10,Success,39,42,5,14,25
10,Success,46,34,0,19,27
10,Success,47,38,0,8,39
10,Success,42,43,5,10,32
10,Success,48,34,6,12,36
10,Success,53,33,0,9,44
10,Success,50,40,0,6,44
10,Success,47,37,5,11,36
10,Success,54,32,0,13,41
10,Success,43,34,0,19,24
10,Success,53,34,0,12,41
10,Success,46,37,4,13,33
10,Success,54,33,0,11,43
10,Success,47,36,0,10,37
10,Success,46,39,0,13,33
10,Success,43,35,10,12,31
10,Success,46,33,6,15,31
10,Success,45,40,0,12,33
10,Success,50,33,2,15,35
10,Success,45,30,9,16,29
10,Success,53,31,0,15,38
10,Success,49,39,0,10,39
10,Success,48,33,2,17,31
10,Success,47,34,3,16,31
10,Success,47,39,0,9,38
10,Success,46,25,0,17,29
10,Success,50,37,5,8,42
10,Success,45,37,4,14,31
10,Success,52,33,0,15,37
10,Success,41,43,0,11,30
10,Success,44,31,9,16,28
10,Success,49,36,1,14,35
10,Success,44,40,0,15,29
10,Success,46,35,0,14,32
10,Success,53,31,0,15,38
10,Success,46,39,2,13,33
10,Success,48,41,0,8,40
10,Success,44,38,0,15,29
10,Success,49,29,7,15,34
10,Success,46,35,0,17,29
10,Success,50,39,3,8,42
10,Success,50,39,3,8,42
10,Success,48,33,0,13,35
10,Success,48,38,0,14,34
10,Success,48,35,0,15,33
10,Success,53,33,0,13,40
10,Success,48,35,1,16,32
10,Success,51,41,2,6,45
10,Success,38,47,0,14,24
10,Success,61,26,0,9,52
10,Success,48,36,0,12,36
10,Success,43,43,5,9,34
10,Success,48,42,0,8,40
10,Success,46,38,1,15,31
10,Success,48,29,11,12,36
10,Success,48,36,0,14,34
10,Success,50,28,10,12,38
10,Success,51,35,0,13,38
10,Success,55,33,0,11,44
10,Success,37,34,0,19,18
10,Success,45,38,0,11,34
10,Success,47,37,0,14,33
10,Success,51,32,4,13,38
10,Success,47,35,0,15,32
10,Success,49,35,2,14,35
10,Success,47,34,3,16,31
10,Success,51,32,0,13,38
10,Success,50,32,8,10,40
10,Success,51,36,1,12,39
10,Success,52,34,3,11,41
10,Success,56,30,3,11,45
10,Success,46,41,1,12,34
10,Success,46,42,1,11,35
10,Success,47,34,0,15,32
10,Success,55,27,7,11,44
10,Success,42,38,0,11,31
10,Success,51,33,2,14,37
10,Success,45,30,0,16,29
10,Success,54,27,6,13,41
10,Success,54,32,0,12,42
10,Success,50,30,0,16,34
10,Success,47,36,6,11,36
10,Success,46,36,5,13,33
10,Success,47,40,0,10,37
10,Success,42,43,0,9,33
10,Success,58,28,0,13,45
10,Success,57,30,2,11,46
10,Success,46,38,0,14,32
10,Success,44,41,0,14,30
10,Success,42,37,0,16,26
10,Success,55,34,0,9,46
10,Success,54,33,1,12,42
10,Success,51,36,3,10,41
10,Success,59,19,6,16,43
10,Success,49,41,0,8,41
10,Success,57,30,0,13,44
10,Success,48,35,0,13,35
10,Success,54,32,0,9,45
10,Success,44,38,0,17,27
10,Success,44,39,0,13,31
10,Success,45,36,0,17,28
10,Success,51,33,0,16,35
10,Success,48,40,0,9,39
10,Success,59,31,0,10,49
10,Success,41,33,12,14,27
10,Success,46,34,6,14,32
10,Success,53,33,3,11,42
10,Success,49,32,0,17,32
10,Success,44,35,0,16,28
10,Success,49,39,1,11,38
10,Success,45,35,6,14,31
10,Success,53,38,2,7,46
10,Success,51,31,5,13,38
10,Success,47,41,0,9,38
10,Success,51,38,0,8,43
10,Success,44,29,0,19,25
10,Success,50,36,0,12,38
10,Success,44,33,3,20,24
10,Success,48,34,6,12,36
10,Success,35,44,0,15,20
10,Success,50,30,0,15,35
10,Success,43,35,0,21,22
10,Success,53,38,0,7,46
10,Success,46,39,6,9,37
10,Success,43,37,0,16,27
10,Success,40,34,11,15,25
10,Success,47,41,3,9,38
10,Success,43,38,0,18,25
10,Success,46,36,0,15,31
10,Success,50,23,0,16,34
10,Success,39,42,4,15,24
10,Success,42,42,5,11,31
10,Success,44,36,0,19,25
10,Success,42,37,10,11,31
10,Success,40,36,0,20,20
10,Success,54,32,0,10,44
10,Success,50,34,1,15,35
10,Success,39,40,0,11,28
10,Success,48,36,5,11,37
10,Success,51,34,0,14,37
10,Success,47,37,0,11,36
10,Success,49,37,6,8,41
10,Success,45,38,0,13,32
10,Success,55,36,0,8,47
10,Success,48,39,0,10,38
10,Success,56,36,4,4,52
10,Success,44,39,0,8,36
10,Success,49,25,11,15,34
10,Success,54,36,0,8,46
10,Success,52,31,0,14,38
10,Success,52,41,1,6,46
10,Success,51,37,0,12,39
10,Success,39,44,6,11,28
10,Success,38,41,6,15,23
10,Success,47,36,10,7,40
10,Success,42,43,4,11,31
10,Success,53,38,1,8,45
10,Success,53,32,7,8,45
10,Success,47,37,0,14,33
10,Success,47,41,0,11,36
10,Success,50,30,0,13,37
10,Success,45,44,0,11,34
10,Success,54,36,0,8,46
10,Success,50,39,0,6,44
10,Success,46,40,0,13,33
10,Success,47,33,5,15,32
10,Success,51,36,2,11,40
10,Success,46,46,0,7,39
10,Success,55,32,0,10,45
10,Success,43,34,6,17,26
10,Success,47,33,3,17,30
10,Success,42,46,0,10,32
10,Success,47,37,0,13,34
10,Success,40,42,0,12,28
10,Success,41,38,0,15,26
10,Success,52,37,0,10,42
10,Success,43,31,0,20,23
10,Success,52,38,0,9,43
10,Success,43,38,0,15,28
10,Success,43,38,0,12,31
10,Success,52,32,2,14,38
10,Success,54,37,0,8,46
10,Success,54,33,1,12,42
10,Success,47,32,7,14,33
10,Success,50,34,0,16,34
10,Success,46,36,2,16,30
10,Success,41,39,0,12,29
10,Success,54,23,9,14,40
10,Success,40,33,14,13,27
10,Success,46,35,0,17,29
10,Success,49,32,6,13,36
10,Success,48,32,7,13,35
10,Success,47,41,1,11,36
10,Success,57,32,3,8,49
10,Success,43,37,7,13,30
10,Success,52,33,2,13,39
10,Success,44,37,0,13,31
10,Success,46,41,0,13,33
10,Success,45,41,2,12,33
10,Success,48,41,2,9,39
10,Success,55,34,1,10,45
10,Success,49,35,4,12,37
10,Success,48,36,0,16,32
10,Success,44,41,2,13,31
10,Success,45,30,0,19,26
10,Success,46,35,5,14,32
10,Success,40,51,0,6,34
10,Success,42,31,0,19,23
10,Success,48,35,3,14,34
10,Success,45,39,0,13,32
10,Success,51,33,0,9,42
10,Success,51,37,3,9,42
10,Success,44,39,0,13,31
10,Success,39,39,7,15,24
10,Success,47,30,10,13,34
10,Success,45,37,0,16,29
10,Success,52,30,0,15,37
10,Success,52,36,0,8,44
10,Success,44,40,4,12,32
10,Success,52,33,0,11,41
10,Success,43,41,0,11,32
10,Success,50,37,0,7,43
10,Success,37,36,0,20,17
10,Success,49,34,2,15,34
10,Success,56,33,3,8,48
10,Success,47,39,0,13,34
10,Success,45,38,3,14,31
10,Success,56,29,0,7,49
10,Success,46,30,11,13,33
10,Success,52,36,6,6,46
10,Success,52,27,8,13,39
10,Success,55,29,2,14,41
10,Success,51,35,0,9,42
10,Success,46,41,0,12,34
10,Success,56,32,3,9,47
10,Success,53,33,5,9,44
10,Success,42,36,0,19,23
10,Success,44,36,0,16,28
10,Success,46,38,0,9,37
10,Success,49,34,0,10,39
10,Success,46,24,7,23,23
10,Success,43,41,2,14,29
10,Success,48,40,1,11,37
10,Success,46,37,0,15,31
10,Success,44,40,0,15,29
10,Success,48,40,2,10,38
10,Success,41,37,10,12,29
10,Success,46,35,7,12,34
10,Success,42,37,6,15,27
10,Success,52,30,0,13,39
10,Success,44,36,0,17,27
10,Success,50,30,0,12,38
10,Success,54,36,0,10,44
10,Success,47,34,0,12,35
10,Success,43,42,0,13,30
10,Success,49,37,2,12,37
10,Success,44,35,0,13,31
10,Success,52,30,0,15,37
10,Success,47,37,3,13,34
10,Success,46,28,0,13,33
10,Success,48,38,5,9,39
10,Success,49,36,0,14,35
10,Success,50,35,0,12,38
10,Success,48,42,0,8,40
10,Success,49,35,0,9,40
10,Success,48,39,4,9,39
10,Success,50,36,0,14,36
10,Success,42,37,9,12,30
10,Success,53,28,0,18,35
10,Success,50,33,0,15,35
10,Success,45,34,6,15,30
10,Success,53,34,0,11,42
10,Success,47,35,1,17,30
10,Success,54,33,0,13,41
10,Success,44,33,0,12,32
10,Success,53,39,0,6,47
10,Success,47,40,0,9,38
10,Success,50,30,0,13,37
10,Success,46,40,7,7,39
10,Success,39,38,6,17,22
10,Success,52,34,2,12,40
10,Success,41,39,0,13,28
10,Success,48,44,1,7,41
10,Success,47,34,0,16,31
10,Success,44,40,3,13,31
10,Success,52,38,0,9,43
10,Success,53,21,6,20,33
10,Success,47,36,2,15,32
10,Success,44,35,4,17,27
10,Success,55,36,0,7,48
10,Success,43,38,0,15,28
10,Success,42,42,1,15,27
10,Success,47,33,0,17,30
10,Success,51,32,0,16,35
10,Success,44,42,0,11,33
10,Success,50,37,3,10,40
10,Success,53,27,0,18,35
10,Success,51,32,4,13,38
10,Success,48,32,0,13,35
10,Success,48,39,0,11,37
10,Success,47,44,5,4,43
10,Success,36,41,0,17,19
10,Success,46,39,0,14,32
10,Success,52,35,0,8,44
10,Success,52,36,1,11,41
10,Success,49,31,0,17,32
10,Success,45,33,6,16,29
10,Success,44,37,0,13,31
10,Success,45,38,4,13,32
10,Success,45,35,2,18,27
10,Success,48,33,0,11,37
10,Success,43,38,0,12,31
10,Success,47,36,0,15,32
10,Success,50,38,0,12,38
10,Success,46,35,0,18,28
10,Success,52,30,0,13,39
10,Success,44,33,0,17,27
10,Success,47,34,0,19,28
10,Success,49,31,8,12,37
10,Success,46,41,0,12,34
10,Success,48,34,3,15,33
10,Success,38,42,6,14,24
10,Success,46,36,0,15,31
10,Success,54,34,0,7,47
10,Success,49,40,0,6,43
10,Success,48,35,0,15,33
10,Success,46,36,0,11,35
10,Success,56,30,0,11,45
10,Success,43,37,5,15,28
10,Success,41,33,0,15,26
10,Success,48,33,9,10,38
10,Success,49,33,0,13,36
10,Success,47,37,9,7,40
10,Success,45,32,10,13,32
10,Success,48,36,0,15,33
10,Success,51,32,0,16,35
10,Success,51,38,3,8,43
10,Success,52,25,0,12,40
10,Success,46,34,0,15,31
10,Success,46,39,0,15,31
10,Success,48,36,0,16,32
10,Success,40,41,0,17,23
10,Success,51,37,0,12,39
10,Success,54,32,0,13,41
10,Success,45,39,0,14,31
10,Success,49,35,0,8,41
10,Success,39,36,13,12,27
10,Success,50,42,1,7,43
10,Success,50,38,0,11,39
10,Success,57,31,2,10,47
10,Success,57,34,2,7,50
10,Success,49,42,0,9,40
10,Success,54,32,0,11,43
10,Success,51,35,0,9,42
10,Success,40,39,2,19,21
10,Success,36,40,10,14,22
10,Success,54,37,0,8,46
10,Success,51,39,0,9,42
10,Success,51,40,0,8,43
10,Success,49,32,5,14,35
10,Success,46,36,0,13,33
10,Success,51,34,0,11,40
10,Success,49,28,0,14,35
10,Success,54,34,0,5,49
10,Success,45,42,5,8,37
10,Success,43,39,0,18,25
10,Success,48,37,2,13,35
10,Success,48,39,0,12,36
10,Success,49,32,0,17,32
10,Success,46,37,0,17,29
10,Success,47,40,3,10,37
10,Success,51,31,0,8,43
10,Success,45,32,7,16,29
10,Success,44,31,6,19,25
10,Success,55,26,0,18,37
10,Success,48,37,1,14,34
10,Success,45,40,3,12,33
10,Success,50,37,1,12,38
10,Success,49,26,6,19,30
10,Success,47,37,0,13,34
10,Success,47,33,5,15,32
10,Success,53,34,0,13,40
10,Success,48,30,0,11,37
10,Success,57,29,0,11,46
10,Success,53,30,5,12,41
10,Success,49,31,3,17,32
10,Success,55,28,0,11,44
10,Success,44,37,6,13,31
10,Success,50,33,2,15,35
10,Success,47,33,0,15,32
10,Success,52,33,3,12,40
10,Success,48,39,2,11,37
10,Success,49,32,0,13,36
10,Success,42,36,6,16,26
10,Success,46,40,1,13,33
10,Success,58,34,1,7,51
10,Success,46,38,0,11,35
10,Success,52,33,2,13,39
10,Success,43,35,12,10,33
10,Success,50,34,6,10,40
10,Success,51,30,6,13,38
10,Success,59,31,2,8,51
10,Success,50,37,5,8,42
10,Success,47,40,1,12,35
10,Success,55,31,0,13,42
10,Success,45,34,7,14,31
10,Success,51,33,0,13,38
10,Success,47,32,8,13,34
10,Success,56,36,0,8,48
10,Success,44,36,0,16,28
10,Success,54,30,1,15,39
10,Success,42,35,6,17,25
10,Success,51,41,2,6,45
10,Success,57,33,1,9,48
10,Success,50,32,7,11,39
10,Success,44,38,0,15,29
10,Success,48,43,0,8,40
10,Success,43,38,0,11,32
10,Success,47,44,0,5,42
10,Success,49,41,1,9,40
10,Success,51,33,6,10,41
10,Success,48,32,8,12,36
10,Success,50,35,6,9,41
10,Success,56,31,1,12,44
10,Success,46,33,0,13,33
10,Success,55,28,7,10,45
10,Success,49,37,1,13,36
10,Success,51,28,6,15,36
10,Success,44,42,2,12,32
10,Success,44,41,0,14,30
10,Success,47,36,0,8,39
10,Success,53,34,0,8,45
10,Success,51,28,0,14,37
10,Success,52,36,0,8,44
10,Success,41,42,2,15,26
10,Success,52,35,1,12,40
10,Success,58,34,1,7,51
10,Success,48,37,0,14,34
10,Success,44,42,4,10,34
10,Success,54,28,3,15,39
10,Success,47,38,0,12,35
10,Success,47,42,0,11,36
10,Success,54,29,6,11,43
10,Success,51,26,7,16,35
10,Success,41,35,0,18,23
10,Success,49,38,0,8,41
10,Success,47,40,4,9,38
10,Success,45,43,0,10,35
10,Success,44,43,0,12,32
10,Success,44,32,0,20,24
10,Success,49,34,0,12,37
10,Success,47,37,0,15,32
10,Success,41,42,7,10,31
10,Success,51,30,0,14,37
10,Success,46,31,0,15,31
10,Success,48,29,5,18,30
10,Success,38,51,0,8,30
10,Success,50,41,2,7,43
10,Success,51,36,3,10,41
10,Success,44,42,2,12,32
10,Success,57,27,0,13,44
10,Success,52,34,1,13,39
10,Success,44,42,0,10,34
10,Success,45,38,7,10,35
10,Success,49,31,3,17,32
10,Success,42,43,4,11,31
10,Success,44,31,9,16,28
10,Success,49,30,6,15,34
10,Success,47,32,0,15,32
10,Success,46,40,0,12,34
10,Success,52,35,2,11,41
10,Success,57,29,0,10,47
10,Success,49,35,0,11,38
10,Success,49,38,0,13,36
10,Success,53,27,0,10,43
10,Success,51,30,0,10,41
10,Success,51,32,5,12,39
10,Success,50,30,5,15,35
10,Success,37,41,0,21,16
10,Success,49,34,0,14,35
10,Success,55,30,7,8,47
10,Success,43,43,0,13,30
10,Success,50,37,2,11,39
10,Success,53,33,0,11,42
10,Success,44,30,0,9,35
10,Success,48,35,0,14,34
10,Success,51,39,1,9,42
10,Success,49,27,8,16,33
10,Success,46,34,0,12,34
10,Success,40,40,0,14,26
10,Success,49,37,1,13,36
10,Success,43,30,9,18,25
10,Success,49,35,0,12,37
10,Success,49,41,1,9,40
10,Success,45,29,7,19,26
10,Success,56,36,0,8,48
10,Success,48,30,0,16,32
10,Success,55,34,1,10,45
10,Success,48,37,1,14,34
10,Success,57,29,0,13,44
10,Success,52,36,0,12,40
10,Success,41,42,0,16,25
10,Success,49,39,0,10,39
10,Success,46,40,0,13,33
10,Success,44,41,0,7,37
10,Success,52,35,1,12,40
10,Success,54,32,4,10,44
10,Success,46,38,4,12,34
10,Success,49,35,1,15,34
10,Success,55,36,1,8,47
10,Success,38,35,0,19,19
10,Success,58,32,2,8,50
10,Success,45,33,4,18,27
10,Success,45,41,0,13,32
10,Success,43,42,0,9,34
10,Success,45,39,0,13,32
10,Success,50,36,1,13,37
10,Success,49,38,0,8,41
10,Success,49,38,2,11,38
10,Success,51,36,2,11,40
10,Success,59,32,0,9,50
10,Success,48,37,0,12,36
10,Success,45,37,0,13,32
10,Success,52,29,7,12,40
10,Success,47,43,1,9,38
10,Success,43,37,4,16,27
10,Success,47,44,0,9,38
10,Success,53,35,0,8,45
10,Success,53,33,0,12,41
10,Success,54,27,0,15,39
10,Success,46,36,0,12,34
10,Success,51,31,0,14,37
10,Success,45,30,0,18,27
10,Success,47,38,0,13,34
10,Success,49,30,6,15,34
10,Success,48,31,3,18,30
10,Success,40,36,7,17,23
10,Success,54,36,0,10,44
10,Success,53,37,0,9,44
10,Success,50,34,0,16,34
10,Success,51,26,0,12,39
10,Success,46,31,0,17,29
10,Success,45,38,0,15,30
10,Success,52,33,0,9,43
10,Success,48,36,0,12,36
10,Success,45,36,0,18,27
10,Success,32,45,0,15,17
10,Success,41,36,0,16,25
10,Success,51,35,0,12,39
10,Success,50,33,7,10,40
10,Success,52,35,0,12,40
10,Success,47,39,0,14,33
10,Success,51,33,3,13,38
10,Success,46,34,0,11,35
10,Success,48,32,0,12,36
10,Success,49,36,5,10,39
10,Success,56,28,0,12,44
10,Success,43,35,0,12,31
10,Success,46,38,4,12,34
10,Success,43,38,2,17,26
10,Success,50,34,0,16,34
10,Success,52,38,0,10,42
10,Success,49,38,0,6,43
10,Success,57,30,0,13,44
10,Success,43,39,0,15,28
10,Success,56,34,0,7,49
10,Success,47,40,4,9,38
10,Success,47,34,8,11,36
10,Success,53,34,0,12,41
10,Success,50,37,0,9,41
10,Success,43,40,0,17,26
10,Success,50,36,0,13,37
10,Success,47,32,1,20,27
10,Success,55,29,0,13,42
10,Success,44,36,7,13,31
10,Success,50,32,0,17,33
10,Success,49,36,3,12,37
10,Success,49,36,0,13,36
10,Success,50,40,0,10,40
10,Success,45,38,7,10,35
10,Success,52,35,0,11,41
10,Success,50,25,9,16,34
10,Success,41,42,6,11,30
10,Success,41,36,4,19,22
10,Success,47,37,3,13,34
10,Success,53,39,0,8,45
10,Success,47,31,0,13,34
10,Success,53,29,0,10,43
10,Success,44,37,0,11,33
10,Success,47,34,0,15,32
10,Success,45,37,0,15,30
10,Success,54,28,0,15,39
10,Success,46,44,0,10,36
10,Success,53,33,0,14,39
10,Success,45,38,5,12,33
10,Success,44,30,0,14,30
10,Success,41,31,7,21,20
10,Success,45,33,1,21,24
10,Success,43,34,12,11,32
10,Success,45,35,0,13,32
10,Success,47,37,4,12,35
10,Success,44,34,0,14,30
10,Success,48,44,0,8,40
10,Success,49,30,8,13,36
10,Success,49,41,0,8,41
10,Success,40,44,2,14,26
10,Success,46,38,0,9,37
10,Success,45,30,11,14,31
10,Success,40,33,0,19,21
10,Success,50,36,0,12,38
10,Success,55,33,3,9,46
10,Success,56,29,1,14,42
10,Success,51,41,3,5,46
10,Success,55,28,6,11,44
10,Success,38,43,1,18,20
10,Success,43,37,6,14,29
10,Success,47,39,2,12,35
10,Success,44,36,3,17,27
10,Success,48,32,6,14,34
10,Success,44,37,0,13,31
10,Success,51,34,6,9,42
10,Success,42,35,0,16,26
10,Success,49,37,4,10,39
10,Success,37,39,8,16,21
10,Success,48,36,0,11,37
10,Success,54,30,0,14,40
10,Success,45,40,0,13,32
10,Success,43,38,2,17,26
10,Success,51,33,1,15,36
10,Success,43,40,7,10,33
10,Success,56,33,4,7,49
10,Success,52,39,0,8,44
10,Success,51,35,0,13,38
10,Success,49,36,0,12,37
10,Success,53,34,4,9,44
10,Success,47,37,0,12,35
10,Success,58,29,5,8,50
10,Success,53,40,1,6,47
10,Success,49,42,0,7,42
10,Success,41,41,0,14,27
10,Success,53,24,7,16,37
10,Success,50,36,1,13,37
10,Success,48,33,0,17,31
10,Success,44,37,0,12,32
10,Success,45,40,0,12,33
10,Success,46,38,0,15,31
10,Success,47,34,12,7,40
10,Success,45,40,0,14,31
10,Success,50,35,0,15,35
10,Success,46,30,5,19,27
10,Success,62,28,1,9,53
10,Success,49,38,1,12,37
10,Success,45,26,13,16,29
10,Success,50,40,0,7,43
10,Success,47,41,2,10,37
10,Success,44,39,0,17,27
10,Success,44,29,15,12,32
10,Success,48,39,0,12,36
10,Success,42,29,0,24,18
10,Success,43,40,5,12,31
10,Success,50,40,0,9,41
10,Success,48,40,4,8,40
10,Success,47,31,5,17,30
10,Success,41,33,0,16,25
10,Success,41,39,0,13,28
10,Success,47,36,0,13,34
10,Success,56,32,1,11,45
10,Success,52,35,3,10,42
10,Success,49,38,0,12,37
10,Success,52,32,4,12,40
10,Success,49,31,0,15,34
10,Success,48,24,0,19,29
10,Success,53,33,4,10,43
10,Success,58,34,0,8,50
10,Success,55,32,0,13,42
10,Success,49,34,3,14,35
10,Success,48,33,0,13,35
10,Success,54,41,1,4,50
10,Success,46,32,0,15,31
10,Success,49,35,1,15,34
10,Success,46,37,0,13,33
10,Success,40,39,2,19,21
10,Success,48,38,4,10,38
10,Success,53,34,0,8,45
10,Success,39,39,5,17,22
10,Success,46,35,4,15,31
10,Success,47,41,0,11,36
10,Success,51,34,3,12,39
10,Success,52,38,4,6,46
10,Success,42,48,0,10,32
10,Success,37,39,0,13,24
10,Success,44,38,3,15,29
10,Success,51,34,3,12,39
10,Success,56,34,0,6,50
10,Success,41,37,8,14,27
10,Success,53,30,0,10,43
10,Success,49,37,0,11,38
10,Success,42,38,0,12,30
10,Success,50,40,0,10,40
10,Success,44,45,0,7,37
10,Success,52,39,0,7,45
10,Success,48,41,1,10,38
10,Success,42,37,0,13,29
10,Success,48,36,4,12,36
10,Success,49,34,1,16,33
10,Success,46,40,1,13,33
10,Success,41,48,0,11,30
10,Success,54,39,1,6,48
10,Success,49,33,0,17,32
10,Success,53,30,0,14,39
10,Success,46,44,2,8,38
10,Success,48,38,0,12,36
10,Success,50,27,0,12,38
10,Success,39,33,0,14,25
10,Success,49,38,0,12,37
10,Success,50,29,0,13,37
10,Success,53,37,0,6,47
10,Success,50,31,6,13,37
10,Success,51,35,0,14,37
10,Success,53,34,1,12,41
10,Success,41,34,0,17,24
10,Success,48,40,2,10,38
10,Success,47,32,8,13,34
10,Success,46,37,5,12,34
10,Success,51,43,0,5,46
10,Success,42,49,0,7,35
10,Success,53,30,0,13,40
10,Success,46,32,8,14,32
10,Success,62,22,6,10,52
10,Success,43,41,5,11,32
10,Success,45,39,0,13,32
10,Success,51,41,0,6,45
10,Success,54,33,3,10,44
10,Success,45,34,0,18,27
10,Success,53,32,1,14,39
10,Success,51,40,1,8,43
10,Success,51,34,5,10,41
10,Success,53,33,0,12,41
10,Success,49,39,0,12,37
10,Success,49,36,7,8,41
10,Success,43,32,5,20,23
10,Success,49,38,0,13,36
10,Success,48,36,0,12,36
10,Success,56,33,0,9,47
10,Success,40,33,8,19,21
10,Success,44,35,0,16,28
10,Success,49,35,1,15,34
10,Success,44,40,0,14,30
10,Success,39,38,0,16,23
10,Success,51,21,0,17,34
10,Success,42,37,5,16,26
10,Success,44,42,0,11,33
10,Success,54,34,0,7,47
10,Success,45,40,0,13,32
10,Success,48,43,0,8,40
10,Success,47,32,5,16,31
10,Success,54,38,0,8,46
10,Success,50,38,0,10,40
10,Success,49,35,5,11,38
10,Success,51,39,3,7,44
10,Success,54,31,0,9,45
10,Success,51,34,0,14,37
10,Success,48,36,3,13,35
10,Success,50,34,4,12,38
10,Success,50,37,0,9,41
10,Success,40,39,0,14,26
10,Success,46,40,4,10,36
10,Success,42,35,7,16,26
10,Success,50,39,0,11,39
10,Success,43,31,0,18,25
10,Success,47,36,3,14,33
10,Success,48,30,0,16,32
10,Success,46,42,4,8,38
10,Success,47,39,4,10,37
10,Success,47,44,0,9,38
10,Success,41,36,3,20,21
10,Success,42,41,0,10,32
10,Success,43,32,0,15,28
10,Success,48,33,0,13,35
10,Success,55,36,0,7,48
10,Success,47,40,7,6,41
10,Success,45,39,0,14,31
10,Success,50,31,7,12,38
10,Success,52,31,0,16,36
10,Success,50,38,0,10,40
10,Success,37,40,8,15,22
10,Success,50,28,5,17,33
10,Success,50,36,1,13,37
10,Success,48,34,0,11,37
10,Success,49,33,6,12,37
10,Success,44,35,5,16,28
10,Success,54,32,1,13,41
10,Success,43,37,0,16,27
10,Success,46,29,11,14,32
10,Success,42,37,7,14,28
10,Success,45,41,3,11,34
10,Success,47,32,0,17,30
10,Success,48,37,0,11,37
10,Success,44,39,4,13,31
10,Success,49,32,3,16,33
10,Success,53,34,7,6,47
10,Success,44,38,0,13,31
10,Success,57,27,0,11,46
10,Success,44,35,1,20,24
10,Success,49,30,0,12,37
10,Success,43,32,8,17,26
10,Success,53,34,0,12,41
10,Success,45,31,0,17,28
10,Success,49,33,0,15,34
10,Success,48,35,0,17,31
10,Success,48,37,0,10,38
10,Success,51,30,6,13,38
10,Success,49,34,4,13,36
10,Success,40,37,0,12,28
10,Success,47,38,0,12,35
10,Success,45,34,0,15,30
10,Success,43,35,4,18,25
10,Success,50,28,0,14,36
10,Success,51,31,0,11,40
10,Success,49,34,0,11,38
10,Success,51,28,0,18,33
10,Success,51,32,0,14,37
10,Success,47,37,3,13,34
10,Success,52,35,0,12,40
10,Success,50,34,2,14,36
10,Success,41,44,1,14,27
10,Success,50,33,0,15,35
10,Success,50,33,0,13,37
10,Success,44,40,5,11,33
10,Success,53,37,1,9,44
10,Success,41,32,0,16,25
10,Success,46,39,5,10,36
10,Success,44,35,0,14,30
10,Success,56,31,0,11,45
10,Success,44,41,8,7,37
10,Success,46,37,4,13,33
10,Success,41,31,0,18,23
10,Success,49,36,1,14,35
10,Success,44,41,0,10,34
10,Success,43,33,0,17,26
10,Success,53,40,2,5,48
10,Success,50,29,0,15,35
10,Success,42,40,4,14,28
10,Success,54,31,0,12,42
10,Success,54,26,0,17,37
10,Success,50,41,0,6,44
10,Success,47,40,0,12,35
10,Success,49,33,0,15,34
10,Success,46,38,7,9,37
10,Success,49,32,0,17,32
10,Success,47,36,6,11,36
10,Success,42,35,6,17,25
10,Success,44,37,0,9,35
10,Success,47,42,1,10,37
10,Success,43,38,0,13,30
10,Success,37,34,15,14,23
10,Success,43,34,0,17,26
10,Success,53,30,0,13,40
10,Success,44,36,7,13,31
10,Success,48,34,1,17,31
10,Success,46,36,0,14,32
10,Success,43,36,4,17,26
10,Success,53,35,0,8,45
10,Success,54,33,0,13,41
10,Success,53,31,4,12,41
10,Success,45,42,2,11,34
10,Success,37,42,0,14,23
10,Success,51,25,11,13,38
10,Success,38,29,18,15,23
10,Success,51,29,0,11,40
10,Success,49,34,0,7,42
10,Success,48,31,4,17,31
10,Success,50,29,3,18,32
10,Success,48,37,4,11,37
10,Success,42,42,0,15,27
10,Success,44,39,0,15,29
10,Success,49,32,0,14,35
10,Success,53,33,1,13,40
10,Success,43,38,8,11,32
10,Success,47,37,3,13,34
10,Success,54,30,0,10,44
10,Success,51,36,0,12,39
10,Success,53,33,6,8,45
10,Success,54,37,0,6,48
10,Success,50,28,0,8,42
10,Success,40,41,4,15,25
10,Success,48,41,1,10,38
10,Success,49,32,0,13,36
10,Success,52,35,0,12,40
10,Success,52,39,0,8,44
10,Success,51,39,0,9,42
10,Success,56,33,5,6,50
10,Success,47,35,13,5,42
10,Success,49,38,0,10,39
10,Success,51,36,0,12,39
10,Success,51,27,0,15,36
10,Success,56,38,0,6,50
10,Success,52,34,3,11,41
10,Success,46,39,1,14,32
10,Success,54,33,2,11,43
10,Success,38,35,9,18,20
10,Success,43,46,0,10,33
10,Success,50,29,0,14,36
10,Success,53,36,0,7,46
10,Success,51,34,2,13,38
10,Success,53,40,0,5,48
10,Success,52,38,1,9,43
10,Success,50,38,0,11,39
10,Success,46,30,0,8,38
10,Success,47,33,4,16,31
10,Success,51,33,0,13,38
10,Success,54,28,6,12,42
10,Success,53,35,0,8,45
10,Success,43,32,11,14,29
10,Success,56,38,0,5,51
10,Success,54,30,1,15,39
10,Success,42,34,8,16,26
10,Success,49,34,8,9,40
10,Success,49,41,1,9,40
10,Success,45,39,0,16,29
10,Success,46,42,6,6,40
10,Success,45,30,0,19,26
10,Success,42,37,0,16,26
10,Success,59,29,0,12,47
10,Success,48,39,3,10,38
10,Success,52,26,12,10,42
10,Success,42,44,3,11,31
10,Success,45,41,5,9,36
10,Success,51,35,4,10,41
10,Success,43,35,0,12,31
10,Success,47,37,0,16,31
10,Success,51,37,2,10,41
10,Success,52,36,0,11,41
10,Success,51,31,0,12,39
10,Success,42,43,3,12,30
10,Success,40,41,0,15,25
10,Success,53,35,0,11,42
10,Success,41,37,0,8,33
10,Success,52,30,4,14,38
10,Success,43,40,0,15,28
10,Success,48,41,1,10,38
10,Success,56,27,0,11,45
10,Success,42,43,0,8,34
10,Success,53,40,0,7,46
10,Success,53,31,0,15,38
10,Success,48,38,0,13,35
10,Success,46,36,5,13,33
10,Success,46,42,0,10,36
10,Success,50,38,2,10,40
10,Success,49,38,4,9,40
10,Success,43,40,0,17,26
10,Success,55,29,2,14,41
10,Success,57,31,0,9,48
10,Success,45,34,0,16,29
10,Success,49,37,5,9,40
10,Success,49,34,5,12,37
10,Success,39,34,0,24,15
10,Success,48,35,1,16,32
10,Success,52,33,0,13,39
10,Success,53,34,1,12,41
10,Success,50,36,2,12,38
10,Success,46,33,4,17,29
10,Success,52,33,0,14,38
10,Success,44,38,6,12,32
10,Success,43,36,0,14,29
10,Success,52,38,2,8,44
10,Success,46,30,0,16,30
10,Success,36,44,0,15,21
10,Success,50,35,0,9,41
10,Success,59,24,0,12,47
10,Success,50,38,6,6,44
10,Success,51,34,5,10,41
10,Success,48,27,0,14,34
10,Success,50,34,2,14,36
10,Success,48,38,5,9,39
10,Success,51,29,0,14,37
10,Success,53,30,5,12,41
10,Success,51,30,7,12,39
10,Success,53,28,0,16,37
10,Success,46,44,0,9,37
10,Success,48,28,12,12,36
10,Success,45,35,0,17,28
10,Success,55,25,2,18,37
10,Success,47,31,0,20,27
10,Success,49,41,0,8,41
10,Success,54,33,0,13,41
10,Success,45,35,0,13,32
10,Success,51,36,0,13,38
10,Success,49,33,1,17,32
10,Success,49,36,5,10,39
10,Success,43,33,0,18,25
10,Success,52,34,2,12,40
10,Success,49,40,0,10,39
10,Success,43,40,0,16,27
10,Success,51,29,0,13,38
10,Success,45,37,1,17,28
10,Success,48,31,4,17,31
10,Success,42,38,0,13,29
10,Success,41,45,0,10,31
10,Success,50,29,0,10,40
10,Success,45,37,0,12,33
10,Success,51,34,3,12,39
10,Success,44,42,2,12,32
10,Success,45,41,0,11,34
10,Success,46,37,1,16,30
10,Success,55,30,7,8,47
10,Success,45,36,0,14,31
10,Success,50,34,2,14,36
10,Success,46,40,1,13,33
10,Success,47,34,5,14,33
10,Success,58,29,5,8,50
10,Success,55,32,2,11,44
10,Success,55,29,6,10,45
10,Success,43,40,6,11,32
10,Success,46,40,3,11,35
10,Success,50,27,0,16,34
10,Success,50,39,2,9,41
10,Success,51,39,0,10,41
10,Success,39,45,3,13,26
10,Success,45,35,0,11,34
10,Success,54,29,0,9,45
10,Success,51,31,5,13,38
10,Success,45,36,0,14,31
10,Success,46,40,1,13,33
10,Success,46,36,0,14,32
10,Success,47,31,3,19,28
10,Success,51,42,0,7,44
10,Success,51,35,0,10,41
10,Success,55,28,0,11,44
10,Success,57,33,0,10,47
10,Success,42,41,0,10,32
10,Success,38,39,7,16,22
10,Success,53,34,1,12,41
10,Success,44,36,0,16,28
10,Success,54,31,4,11,43
10,Success,41,43,0,14,27
10,Success,44,40,0,16,28
10,Success,55,38,1,6,49
10,Success,56,30,0,12,44
10,Success,55,30,0,14,41
10,Success,52,26,0,15,37
10,Success,45,35,5,15,30
10,Success,51,33,3,13,38
10,Success,49,30,3,18,31
10,Success,53,33,0,11,42
10,Success,44,42,0,13,31
10,Success,49,32,0,16,33
10,Success,58,29,0,13,45
10,Success,43,40,8,9,34
10,Success,40,36,13,11,29
10,Success,44,30,7,19,25
10,Success,48,35,4,13,35
10,Success,40,42,0,15,25
10,Success,51,38,1,10,41
10,Success,45,40,2,13,32
10,Success,57,34,2,7,50
10,Success,57,30,3,10,47
10,Success,49,37,5,9,40
10,Success,47,37,0,10,37
10,Success,49,39,0,10,39
10,Success,46,37,4,13,33
10,Success,51,36,3,10,41
10,Success,44,44,4,8,36
10,Success,49,38,6,7,42
10,Success,50,31,0,17,33
10,Success,49,35,0,13,36
10,Success,47,43,0,10,37
10,Success,45,41,0,12,33
10,Success,52,36,0,9,43
10,Success,56,30,4,10,46
10,Success,53,33,0,11,42
10,Success,49,32,0,13,36
10,Success,37,29,15,19,18
10,Success,53,38,0,8,45
10,Success,54,24,0,20,34
10,Success,49,36,4,11,38
10,Success,43,35,9,13,30
10,Success,47,41,0,12,35
10,Success,37,44,3,16,21
10,Success,52,34,7,7,45
10,Success,58,33,0,8,50
10,Success,49,40,0,9,40
10,Success,47,33,4,16,31
10,Success,55,37,0,5,50
10,Success,51,40,2,7,44
10,Success,43,37,5,15,28
10,Success,47,33,3,17,30
10,Success,54,36,2,8,46
10,Success,45,34,0,20,25
10,Success,39,41,5,15,24
10,Success,56,31,4,9,47
10,Success,51,35,0,13,38
10,Success,47,42,0,9,38
10,Success,49,36,7,8,41
10,Success,52,37,0,9,43
10,Success,57,36,0,7,50
10,Success,45,43,1,11,34
10,Success,47,30,0,18,29
10,Success,43,35,0,14,29
10,Success,52,43,0,5,47
10,Success,47,36,2,15,32
10,Success,47,39,2,12,35
10,Success,41,38,5,16,25
10,Success,47,32,8,13,34
10,Success,58,32,0,7,51
10,Success,44,35,0,17,27
10,Success,44,38,0,16,28
10,Success,57,26,1,16,41
10,Success,53,33,0,9,44
10,Success,49,38,4,9,40
10,Success,45,36,7,12,33
10,Success,55,29,7,9,46
10,Success,43,45,3,9,34
10,Success,48,32,0,12,36
10,Success,49,36,0,12,37
10,Success,48,33,7,12,36
10,Success,51,35,5,9,42
10,Success,48,30,6,16,32
10,Success,48,36,3,13,35
10,Success,50,39,2,9,41
10,Success,51,22,11,16,35
10,Success,44,34,0,17,27
10,Success,43,41,5,11,32
10,Success,45,38,0,17,28
10,Success,45,39,0,14,31
10,Success,44,29,0,18,26
10,Success,45,42,0,12,33
10,Success,45,40,2,13,32
10,Success,38,38,0,15,23
10,Success,42,34,0,18,24
10,Success,61,26,0,12,49
10,Success,50,39,2,9,41
10,Success,51,35,0,14,37
10,Success,49,30,3,18,31
10,Success,44,27,7,22,22
10,Success,44,37,2,17,27
10,Success,42,36,3,19,23
10,Success,51,29,0,11,40
10,Success,44,35,0,17,27
10,Success,52,41,0,7,45
10,Success,42,41,4,13,29
10,Success,50,33,0,12,38
10,Success,49,37,0,11,38
10,Success,37,33,0,19,18
10,Success,45,32,4,19,26
10,Success,51,31,4,14,37
10,Success,55,33,0,7,48
10,Success,48,42,4,6,42
10,Success,52,38,1,9,43
10,Success,51,35,0,13,38
10,Success,43,30,8,19,24
10,Success,52,37,0,11,41
10,Success,52,26,0,13,39
10,Success,52,38,0,9,43
10,Success,48,35,7,10,38
10,Success,42,31,0,18,24
10,Success,52,35,4,9,43
10,Success,46,37,0,11,35
10,Success,46,28,0,20,26
10,Success,47,31,0,14,33
10,Success,50,36,2,12,38
10,Success,51,35,6,8,43
10,Success,48,37,3,12,36
10,Success,42,40,1,17,25
10,Success,49,34,0,15,34
10,Success,50,38,1,11,39
10,Success,42,37,0,9,33
10,Success,47,30,4,19,28
10,Success,44,35,0,15,29
10,Success,42,41,0,16,26
10,Success,50,31,5,14,36
10,Success,52,42,0,6,46
10,Success,53,31,0,13,40
10,Success,53,31,0,14,39
10,Success,58,27,0,9,49
10,Success,43,39,0,14,29
10,Success,46,35,2,17,29
10,Success,43,35,6,16,27
10,Success,51,28,8,13,38
10,Success,48,37,0,11,37
10,Success,50,38,0,8,42
10,Success,45,44,0,8,37
10,Success,47,41,0,11,36
10,Success,56,36,0,8,48
10,Success,49,38,0,13,36
10,Success,42,34,8,16,26
10,Success,54,28,0,15,39
10,Success,52,38,2,8,44
10,Success,51,28,0,13,38
10,Success,44,34,3,19,25
10,Success,49,38,1,12,37
10,Success,45,39,0,13,32
10,Success,51,33,9,7,44
10,Success,43,41,0,11,32
10,Success,46,30,10,14,32
10,Success,45,43,0,12,33
10,Success,55,31,1,13,42
10,Success,45,37,0,13,32
10,Success,48,36,3,13,35
10,Success,49,31,0,10,39
10,Success,48,39,1,12,36
10,Success,55,29,4,12,43
10,Success,54,33,0,7,47
10,Success,51,33,0,13,38
10,Success,47,40,1,12,35
10,Success,51,35,0,13,38
10,Success,44,35,7,14,30
10,Success,51,29,0,9,42
10,Success,54,36,1,9,45
10,Success,42,35,0,17,25
10,Success,50,34,4,12,38
10,Success,47,33,1,19,28
10,Success,46,34,1,19,27
10,Success,37,46,0,14,23
10,Success,43,34,7,16,27
10,Success,45,34,3,18,27
10,Success,44,48,1,7,37
10,Success,49,37,3,11,38
10,Success,44,37,5,14,30
10,Success,43,30,8,19,24
10,Success,42,36,7,15,27
10,Success,43,43,4,10,33
10,Success,51,34,6,9,42
10,Success,47,36,5,12,35
10,Success,47,36,1,16,31
10,Success,48,37,0,15,33
10,Success,46,37,0,16,30
10,Success,50,38,1,11,39
10,Success,45,35,0,12,33
10,Success,55,26,3,16,39
10,Success,51,31,0,15,36
10,Success,42,41,3,14,28
10,Success,51,33,6,10,41
10,Success,44,38,8,10,34
10,Success,43,33,0,17,26
10,Success,46,42,1,11,35
10,Success,48,37,2,13,35
10,Success,51,36,0,9,42
10,Success,44,38,1,17,27
10,Success,53,29,0,17,36
10,Success,46,36,5,13,33
10,Success,50,29,7,14,36
10,Success,53,36,0,9,44
10,Success,49,35,0,13,36
10,Success,47,33,0,15,32
10,Success,40,40,0,16,24
10,Success,53,33,0,13,40
10,Success,40,45,1,14,26
10,Success,48,40,1,11,37
10,Success,51,34,0,13,38
10,Success,49,39,2,10,39
10,Success,51,42,0,7,44
10,Success,46,39,1,14,32
10,Success,53,36,0,11,42
10,Success,45,37,0,17,28
10,Success,48,31,0,11,37
10,Success,38,47,7,8,30
10,Success,44,40,7,9,35
10,Success,44,39,3,14,30
10,Success,55,33,3,9,46
10,Success,46,36,11,7,39
10,Success,38,42,5,15,23
10,Success,49,24,7,20,29
10,Success,42,33,0,14,28
10,Success,50,42,1,7,43
10,Success,46,29,3,22,24
10,Success,50,34,3,13,37
10,Success,53,38,0,9,44
10,Success,44,38,0,13,31
10,Success,42,39,0,14,28
10,Success,45,33,0,18,27
10,Success,44,35,3,18,26
10,Success,51,31,3,15,36
10,Success,47,35,4,14,33
10,Success,51,25,9,15,36
10,Success,53,34,3,10,43
10,Success,45,35,0,12,33
10,Success,43,39,6,12,31
10,Success,52,38,2,8,44
10,Success,44,41,1,14,30
10,Success,53,31,2,14,39
10,Success,45,36,5,14,31
10,Success,38,41,0,20,18
10,Success,55,35,0,10,45
10,Success,57,33,0,8,49
10,Success,49,37,0,13,36
10,Success,52,32,0,8,44
10,Success,59,29,6,6,53
10,Success,46,37,0,16,30
10,Success,52,31,2,15,37
10,Success,49,39,0,12,37
10,Success,47,33,3,17,30
10,Success,48,38,0,6,42
10,Success,50,34,0,14,36
10,Success,42,41,0,17,25
10,Success,48,37,1,14,34
10,Success,54,35,1,10,44
10,Success,42,40,6,12,30
10,Success,53,28,0,9,44
10,Success,46,36,0,16,30
10,Success,45,38,0,17,28
10,Success,50,32,0,11,39
10,Success,52,31,4,13,39
10,Success,52,32,0,12,40
10,Success,40,37,0,16,24
10,Success,48,33,0,16,32
10,Success,44,36,8,12,32
10,Success,49,37,0,12,37
10,Success,44,42,0,13,31
10,Success,50,38,2,10,40
10,Success,50,36,1,13,37
10,Success,55,37,0,7,48
10,Success,38,36,0,17,21
10,Success,45,35,0,13,32
10,Success,48,39,2,11,37
10,Success,50,37,1,12,38
10,Success,47,36,0,11,36
10,Success,38,51,0,9,29
10,Success,50,34,2,14,36
10,Success,51,39,1,9,42
10,Success,51,37,0,8,43
10,Success,41,39,9,11,30
10,Success,55,27,5,13,42
10,Success,45,34,0,15,30
10,Success,46,43,2,9,37
10,Success,50,36,0,12,38
10,Success,51,33,0,13,38
10,Success,50,43,0,6,44
10,Success,56,30,2,12,44
10,Success,44,35,4,17,27
10,Success,47,34,0,12,35
10,Success,50,36,0,9,41
10,Success,43,34,6,17,26
10,Success,48,36,3,13,35
10,Success,51,37,2,10,41
10,Success,54,33,0,9,45
10,Success,50,36,0,9,41
10,Success,50,34,7,9,41
10,Success,56,26,0,16,40
10,Success,49,35,8,8,41
10,Success,52,40,0,1,51
10,Success,52,36,0,9,43
10,Success,48,39,0,12,36
10,Success,50,31,0,12,38
10,Success,46,38,0,14,32
10,Success,48,38,1,13,35
10,Success,50,41,0,7,43
10,Success,47,35,0,17,30
10,Success,50,32,3,15,35
10,Success,51,25,12,12,39
10,Success,46,38,0,16,30
10,Success,48,36,8,8,40
10,Success,50,29,0,20,30
10,Success,50,36,2,12,38
10,Success,46,40,0,11,35
10,Success,55,25,10,10,45
10,Success,52,31,1,16,36
10,Success,40,40,0,16,24
10,Success,56,32,0,10,46
10,Success,47,39,5,9,38
10,Success,48,34,5,13,35
10,Success,52,32,1,15,37
10,Success,40,39,0,16,24
10,Success,51,33,4,12,39
10,Success,39,48,1,12,27
10,Success,49,38,0,11,38
10,Success,47,36,0,16,31
10,Success,56,26,0,11,45
10,Success,54,32,4,10,44
10,Success,50,40,0,8,42
10,Success,46,39,3,12,34
10,Success,55,37,1,7,48
10,Success,42,41,0,8,34
10,Success,50,41,0,6,44
10,Success,53,34,0,12,41
10,Success,43,36,6,15,28
10,Success,59,33,1,7,52
10,Success,46,39,0,15,31
10,Success,49,35,0,15,34
10,Success,46,30,10,14,32
10,Success,47,34,5,14,33
10,Success,50,37,0,11,39
10,Success,56,32,5,7,49
10,Success,54,30,0,12,42
10,Success,50,40,3,7,43
10,Success,43,36,0,17,26
10,Success,56,33,0,10,46
10,Success,44,36,6,14,30
10,Success,62,24,0,11,51
10,Success,48,25,0,16,32
10,Success,48,35,7,10,38
10,Success,53,29,0,16,37
10,Success,45,41,0,12,33
10,Success,46,31,8,15,31
10,Success,46,35,7,12,34
10,Success,44,38,3,15,29
10,Success,45,35,0,14,31
10,Success,39,38,5,18,21
10,Success,45,35,7,13,32
10,Success,46,35,6,13,33
10,Success,49,34,0,16,33
10,Success,52,30,0,14,38
10,Success,46,34,4,16,30
10,Success,49,35,0,13,36
10,Success,54,32,0,12,42
10,Success,47,35,5,13,34
10,Success,46,36,0,13,33
10,Success,49,42,0,6,43
10,Success,52,33,7,8,44
10,Success,58,34,3,5,53
10,Success,52,29,0,9,43
10,Success,52,34,2,12,40
10,Success,52,34,0,9,43
10,Success,52,38,3,7,45
10,Success,47,32,4,17,30
10,Success,50,31,7,12,38
10,Success,50,35,0,9,41
10,Success,54,33,3,10,44
10,Success,45,31,0,17,28
10,Success,52,30,0,16,36
10,Success,48,32,0,15,33
10,Success,45,36,6,13,32
10,Success,35,39,0,16,19
10,Success,53,35,2,10,43
10,Success,45,42,0,13,32
10,Success,47,33,7,13,34
10,Success,50,40,0,10,40
10,Success,39,36,0,19,20
10,Success,57,30,0,10,47
10,Success,52,36,0,8,44
10,Success,56,31,0,13,43
10,Success,48,44,0,8,40
10,Success,49,42,0,7,42
10,Success,51,32,0,13,38
10,Success,54,26,8,12,42
10,Success,51,34,0,15,36
10,Success,54,38,0,8,46
10,Success,36,40,12,12,24
10,Success,53,32,0,14,39
10,Success,43,36,0,12,31
10,Success,45,39,3,13,32
10,Success,54,32,0,13,41
10,Success,49,38,4,9,40
10,Success,43,40,3,14,29
10,Success,50,27,0,19,31
10,Success,44,34,0,17,27
10,Success,49,39,0,11,38
10,Success,50,35,0,15,35
10,Success,47,30,0,15,32
10,Success,46,36,2,16,30
10,Success,45,36,4,15,30
10,Success,56,33,0,9,47
10,Success,46,28,0,19,27
10,Success,44,35,4,17,27
10,Success,43,39,6,12,31
10,Success,43,44,0,11,32
10,Success,46,38,0,11,35
10,Success,50,40,1,9,41
10,Success,52,36,0,12,40
10,Success,44,41,0,11,33
10,Success,49,37,3,11,38
10,Success,46,39,1,14,32
10,Success,52,34,0,13,39
10,Success,47,30,0,21,26
10,Success,52,36,0,12,40
10,Success,49,38,1,12,37
10,Success,40,39,4,17,23
10,Success,43,35,0,16,27
10,Success,41,41,5,13,28
10,Success,49,32,0,15,34
10,Success,50,35,0,12,38
10,Success,48,41,1,10,38
10,Success,45,42,1,12,33
10,Success,48,34,0,11,37
10,Success,55,31,6,8,47
10,Success,51,35,0,10,41
10,Success,47,35,0,15,32
10,Success,47,32,9,12,35
10,Success,46,42,0,11,35
10,Success,46,40,0,10,36
10,Success,46,39,5,10,36
10,Success,53,32,2,13,40
10,Success,48,35,0,17,31
10,Success,40,32,0,19,21
10,Success,48,33,0,12,36
10,Success,43,38,0,11,32
10,Success,50,31,1,18,32
10,Success,45,41,5,9,36
10,Success,49,34,8,9,40
10,Success,51,30,0,19,32
10,Success,57,31,4,8,49
10,Success,46,37,3,14,32
10,Success,54,27,4,15,39
10,Success,54,31,0,12,42
10,Success,45,34,7,14,31
10,Success,43,42,1,14,29
10,Success,55,34,0,11,44
10,Success,51,28,7,14,37
10,Success,44,37,7,12,32
10,Success,52,37,2,9,43
10,Success,48,36,0,15,33
10,Success,48,36,0,13,35
10,Success,44,39,0,13,31
10,Success,43,37,11,9,34
10,Success,43,24,0,20,23
10,Success,41,40,6,13,28
10,Success,53,36,0,8,45
10,Success,46,38,4,12,34
10,Success,50,35,0,13,37
10,Success,53,31,7,9,44
10,Success,49,37,0,14,35
10,Success,45,37,6,12,33
10,Success,47,40,0,11,36
10,Success,48,35,0,7,41
10,Success,49,32,2,17,32
10,Success,59,33,0,8,51
10,Success,48,28,0,7,41
10,Success,44,39,0,12,32
10,Success,40,39,0,21,19
10,Success,49,35,3,13,36
10,Success,48,35,5,12,36
10,Success,42,43,0,13,29
10,Success,52,34,6,8,44
10,Success,41,51,0,8,33
10,Success,51,35,3,11,40
10,Success,50,31,0,19,31
10,Success,55,29,4,12,43
10,Success,43,40,1,16,27
10,Success,43,38,8,11,32
10,Success,48,31,0,16,32
10,Success,50,36,2,12,38
10,Success,52,38,0,10,42
10,Success,54,36,0,9,45
10,Success,56,35,0,7,49
10,Success,44,40,0,14,30
10,Success,52,28,0,15,37
10,Success,43,39,1,17,26
10,Success,45,34,0,12,33
10,Success,46,40,5,9,37
10,Success,48,35,5,12,36
10,Success,51,41,1,7,44
10,Success,49,33,0,14,35
10,Success,49,33,0,15,34
10,Success,59,32,2,7,52
10,Success,52,33,0,12,40
10,Success,40,36,0,16,24
10,Success,43,37,6,14,29
10,Success,49,36,0,12,37
10,Success,42,38,0,15,27
10,Success,53,30,9,8,45
10,Success,43,34,10,13,30
10,Success,52,40,0,7,45
10,Success,51,30,1,18,33
10,Success,46,42,0,10,36
10,Success,41,40,10,9,32
10,Success,55,34,2,9,46
10,Success,49,30,8,13,36
10,Success,43,40,6,11,32
10,Success,47,40,0,13,34
10,Success,46,41,0,9,37
10,Success,42,35,8,15,27
10,Success,41,41,7,11,30
10,Success,49,39,0,12,37
10,Success,48,32,0,12,36
10,Success,49,37,0,8,41
10,Success,49,35,0,9,40
10,Success,39,42,0,13,26
10,Success,45,31,0,15,30
10,Success,45,33,1,21,24
10,Success,42,38,10,10,32
10,Success,47,30,11,12,35
10,Success,50,30,7,13,37
10,Success,41,36,4,19,22
10,Success,49,39,0,12,37
10,Success,48,40,0,12,36
10,Success,48,33,2,17,31
10,Success,44,44,3,9,35
10,Success,52,34,2,12,40
10,Success,47,33,0,20,27
10,Success,52,33,0,11,41
10,Success,46,34,0,14,32
10,Success,50,34,0,9,41
10,Success,40,35,11,14,26
10,Success,48,31,5,16,32
10,Success,47,39,3,11,36
10,Success,55,31,0,13,42
10,Success,45,39,2,14,31
10,Success,47,42,0,8,39
10,Success,55,34,0,6,49
10,Success,51,32,0,13,38
10,Success,52,33,5,10,42
10,Success,50,32,0,12,38
10,Success,52,34,0,14,38
10,Success,57,34,0,7,50
10,Success,48,35,3,14,34
10,Success,42,38,0,16,26
10,Success,41,40,6,13,28
10,Success,50,36,0,11,39
10,Success,41,35,0,17,24
10,Success,43,39,1,17,26
10,Success,46,32,7,15,31
10,Success,52,30,0,15,37
10,Success,41,39,3,17,24
10,Success,49,31,0,15,34
10,Success,50,36,0,10,40
10,Success,50,33,9,8,42
10,Success,48,40,0,11,37
10,Success,45,36,2,17,28
10,Success,56,32,0,12,44
10,Success,43,44,0,10,33
10,Success,45,37,1,17,28
10,Success,56,29,2,13,43
10,Success,52,33,6,9,43
10,Success,41,39,2,18,23
10,Success,48,38,0,11,37
10,Success,46,44,1,9,37
10,Success,53,30,0,16,37
10,Success,53,37,1,9,44
10,Success,46,30,0,18,28
10,Success,49,31,0,13,36
10,Success,44,40,0,14,30
10,Success,53,33,0,14,39
10,Success,35,50,5,10,25
10,Success,50,31,7,12,38
10,Success,54,34,0,7,47
10,Success,42,36,5,17,25
10,Success,48,39,0,13,35
10,Success,40,38,0,15,25
10,Success,51,33,0,12,39
10,Success,40,41,3,16,24
10,Success,40,38,0,15,25
10,Success,52,34,5,9,43
10,Success,43,33,0,14,29
10,Success,48,38,0,14,34
10,Success,54,31,0,12,42
10,Success,44,31,0,19,25
10,Success,43,36,0,14,29
10,Success,37,35,0,20,17
10,Success,47,42,0,10,37
10,Success,48,27,7,18,30
10,Success,48,41,1,10,38
10,Success,50,34,0,16,34
10,Success,42,35,0,14,28
10,Success,38,33,9,20,18
10,Success,45,40,0,12,33
10,Success,45,44,0,8,37
10,Success,51,36,2,11,40
10,Success,43,38,4,15,28
10,Success,47,41,0,10,37
10,Success,42,46,1,11,31
10,Success,45,32,0,16,29
10,Success,53,32,0,14,39
10,Success,53,32,0,13,40
10,Success,46,38,0,12,34
10,Success,50,33,2,15,35
10,Success,41,36,0,17,24
10,Success,48,33,0,13,35
10,Success,44,36,0,12,32
10,Success,42,36,10,12,30
10,Success,49,34,2,15,34
10,Success,48,25,0,18,30
10,Success,53,36,0,9,44
10,Success,50,36,0,11,39
10,Success,50,39,0,10,40
10,Success,49,34,5,12,37
10,Success,46,38,0,11,35
10,Success,57,38,0,1,56
10,Success,50,36,5,9,41
10,Success,51,34,4,11,40
10,Success,44,39,0,11,33
10,Success,49,33,0,15,34
10,Success,43,38,9,10,33
10,Success,52,27,0,14,38
10,Success,48,36,2,14,34
10,Success,42,33,0,16,26
10,Success,42,40,0,13,29
10,Success,45,36,0,15,30
10,Success,47,38,0,9,38
10,Success,50,33,3,14,36
10,Success,51,32,0,14,37
10,Success,46,40,4,10,36
10,Success,46,31,4,19,27
10,Success,46,41,0,12,34
10,Success,41,41,1,17,24
10,Success,43,38,4,15,28
10,Success,56,32,5,7,49
10,Success,49,36,5,10,39
10,Success,43,35,0,13,30
10,Success,56,39,0,5,51
10,Success,52,33,0,10,42
10,Success,53,32,2,13,40
10,Success,47,37,0,10,37
10,Success,49,42,1,8,41
10,Success,46,42,0,11,35
10,Success,59,36,0,4,55
10,Success,52,37,0,8,44
10,Success,58,29,1,12,46
10,Success,43,41,7,9,34
10,Success,43,45,0,6,37
10,Success,48,33,5,14,34
10,Success,56,28,0,15,41
10,Success,46,30,8,16,30
10,Success,52,32,0,12,40
10,Success,50,33,0,17,33
10,Success,56,27,1,16,40
10,Success,55,33,1,11,44
10,Success,55,33,0,11,44
10,Success,48,38,1,13,35
10,Success,34,37,16,13,21
10,Success,47,35,8,10,37
10,Success,50,38,0,11,39
10,Success,40,42,7,11,29
10,Success,43,34,8,15,28
10,Success,48,36,5,11,37
10,Success,47,40,0,11,36
10,Success,47,35,6,12,35
10,Success,46,40,0,13,33
10,Success,41,33,0,20,21
10,Success,41,36,0,21,20
10,Success,57,28,3,12,45
10,Success,54,35,0,10,44
10,Success,48,33,7,12,36
10,Success,45,36,0,14,31
10,Success,44,40,3,13,31
10,Success,45,40,0,13,32
10,Success,49,34,0,15,34
10,Success,49,34,0,16,33
10,Success,51,40,0,9,42
10,Success,45,43,6,6,39
10,Success,53,33,0,12,41
10,Success,47,39,3,11,36
10,Success,52,31,0,11,41
10,Success,39,39,0,17,22
10,Success,47,40,3,10,37
10,Success,48,37,0,13,35
10,Success,52,40,2,6,46
10,Success,43,34,0,10,33
10,Success,41,34,0,14,27
10,Success,47,34,0,6,41
10,Success,56,33,0,10,46
10,Success,46,35,0,16,30
10,Success,51,32,0,8,43
10,Success,42,34,4,20,22
10,Success,56,32,0,9,47
10,Success,48,36,0,15,33
10,Success,44,38,0,11,33
10,Success,49,36,0,10,39
10,Success,50,32,0,16,34
10,Success,47,34,0,13,34
10,Success,43,45,0,11,32
10,Success,48,40,0,12,36
10,Success,55,35,3,7,48
10,Success,49,33,0,14,35
10,Success,49,36,8,7,42
10,Success,50,32,1,17,33
10,Success,43,38,7,12,31
10,Success,45,39,0,11,34
10,Success,46,33,0,16,30
10,Success,49,36,4,11,38
10,Success,45,36,1,18,27
10,Success,44,44,0,11,33
10,Success,45,31,0,18,27
10,Success,49,35,8,8,41
10,Success,44,39,5,12,32
10,Success,42,40,5,13,29
10,Success,50,31,0,16,34
10,Success,50,34,3,13,37
10,Success,49,35,0,12,37
10,Success,51,33,4,12,39
10,Success,50,40,1,9,41
10,Success,54,34,2,10,44
10,Success,44,43,2,11,33
10,Success,54,28,7,11,43
10,Success,53,34,0,10,43
10,Success,49,40,0,11,38
10,Success,45,33,2,20,25
10,Success,43,37,0,14,29
10,Success,42,34,0,15,27
10,Success,49,27,6,18,31
10,Success,52,29,3,16,36
10,Success,41,33,0,16,25
10,Success,47,37,0,15,32
10,Success,48,35,0,14,34
10,Success,46,39,0,13,33
10,Success,52,33,0,13,39
10,Success,51,35,0,14,37
10,Success,50,39,0,10,40
10,Success,46,41,2,11,35
10,Success,40,34,8,18,22
10,Success,52,38,0,7,45
10,Success,46,41,1,12,34
10,Success,49,33,0,15,34
10,Success,43,37,6,14,29
10,Success,39,39,0,18,21
10,Success,41,39,0,15,26
10,Success,46,38,2,14,32
10,Success,49,41,1,9,40
10,Success,45,38,3,14,31
10,Success,49,39,0,12,37
10,Success,43,44,0,8,35
10,Success,50,30,0,10,40
10,Success,46,32,6,16,30
10,Success,40,45,2,13,27
10,Success,38,49,0,10,28
10,Success,53,35,0,12,41
10,Success,45,36,6,13,32
10,Success,42,40,2,16,26
10,Success,52,31,1,16,36
10,Success,39,43,0,13,26
10,Success,49,38,0,12,37
10,Success,44,44,4,8,36
10,Success,53,35,0,10,43
10,Success,53,28,0,14,39
10,Success,54,31,0,12,42
10,Success,46,41,4,9,37
10,Success,44,41,0,11,33
10,Success,42,33,10,15,27
10,Success,59,28,1,12,47
10,Success,46,38,3,13,33
10,Success,42,44,0,12,30
10,Success,52,38,0,7,45
10,Success,46,39,0,15,31
10,Success,56,38,1,5,51
10,Success,43,39,10,8,35
10,Success,44,45,3,8,36
10,Success,43,36,0,17,26
10,Success,50,35,0,13,37
10,Success,45,31,9,15,30
10,Success,49,35,4,12,37
10,Success,46,30,7,17,29
10,Success,40,42,0,12,28
10,Success,46,35,2,17,29
10,Success,49,35,0,14,35
10,Success,49,39,0,9,40
10,Success,52,36,1,11,41
10,Success,47,38,0,13,34
10,Success,46,42,0,8,38
10,Success,54,36,0,5,49
10,Success,47,36,1,16,31
10,Success,47,38,0,14,33
10,Success,43,43,4,10,33
10,Success,50,28,0,15,35
10,Success,42,37,8,13,29
10,Success,44,40,3,13,31
10,Success,51,35,0,11,40
10,Success,52,31,7,10,42
10,Success,45,35,0,10,35
10,Success,51,30,6,13,38
10,Success,49,39,0,12,37
10,Success,44,36,7,13,31
10,Success,43,42,0,13,30
10,Success,51,40,0,9,42
10,Success,47,41,0,12,35
10,Success,41,40,6,13,28
10,Success,48,38,0,14,34
10,Success,52,32,1,15,37
10,Success,46,36,0,18,28
10,Success,43,41,0,16,27
10,Success,51,25,0,19,32
10,Success,52,37,3,8,44
10,Success,43,38,2,17,26
10,Success,46,39,0,11,35
10,Success,46,30,4,20,26
10,Success,52,39,0,7,45
10,Success,46,35,0,13,33
10,Success,50,29,3,18,32
10,Success,43,37,0,14,29
10,Success,42,33,7,18,24
10,Success,51,24,0,18,33
10,Success,42,26,12,20,22
10,Success,35,38,0,14,21
10,Success,44,38,0,14,30
10,Success,48,32,4,16,32
10,Success,49,35,3,13,36
10,Success,45,28,0,22,23
10,Success,54,33,0,10,44
10,Success,49,33,5,13,36
10,Success,50,33,5,12,38
10,Success,42,41,5,12,30
10,Success,48,36,0,11,37
10,Success,48,42,0,10,38
10,Success,49,37,0,14,35
10,Success,46,38,4,12,34
10,Success,45,43,0,10,35
10,Success,46,34,5,15,31
10,Success,54,30,8,8,46
10,Success,50,35,1,14,36
10,Success,48,42,1,9,39
10,Success,55,32,6,7,48
10,Success,47,35,3,15,32
10,Success,50,33,1,16,34
10,Success,38,38,9,15,23
10,Success,42,42,5,11,31
10,Success,50,28,8,14,36
10,Success,47,37,2,14,33
10,Success,43,29,0,18,25
10,Success,54,31,0,12,42
10,Success,46,40,1,13,33
10,Success,48,34,5,13,35
10,Success,50,40,0,10,40
10,Success,53,27,0,14,39
10,Success,42,46,0,9,33
10,Success,52,34,1,13,39
10,Success,47,30,8,15,32
10,Success,50,33,1,16,34
10,Success,51,32,0,12,39
10,Success,39,38,12,11,28
10,Success,40,43,1,16,24
10,Success,52,35,1,12,40
10,Success,50,36,0,11,39
10,Success,53,27,0,14,39
10,Success,47,34,5,14,33
10,Success,47,35,2,16,31
10,Success,53,36,0,9,44
10,Success,51,35,0,14,37
10,Success,49,32,0,15,34
10,Success,47,33,0,14,33
10,Success,42,32,10,16,26
10,Success,52,28,0,17,35
10,Success,51,39,0,8,43
10,Success,34,43,4,19,15
10,Success,44,38,2,16,28
10,Success,47,40,0,11,36
10,Success,49,43,0,8,41
10,Success,55,30,4,11,44
10,Success,51,35,2,12,39
10,Success,47,41,0,12,35
10,Success,49,40,0,11,38
10,Success,49,37,0,12,37
10,Success,58,25,4,13,45
10,Success,42,42,7,9,33
10,Success,49,36,0,13,36
10,Success,44,41,1,14,30
10,Success,50,35,0,15,35
10,Success,44,39,7,10,34
10,Success,49,33,0,13,36
10,Success,43,39,6,12,31
10,Success,44,42,0,9,35
10,Success,50,36,1,13,37
10,Success,43,39,4,14,29
10,Success,50,34,0,16,34
10,Success,49,32,6,13,36
10,Success,44,31,11,14,30
10,Success,50,37,0,10,40
10,Success,54,39,2,5,49
10,Success,48,34,8,10,38
10,Success,44,39,0,13,31
10,Success,50,32,5,13,37
10,Success,46,38,0,13,33
10,Success,45,34,0,13,32
10,Success,57,27,0,16,41
10,Success,56,29,0,12,44
10,Success,46,40,1,13,33
10,Success,53,31,0,10,43
10,Success,45,35,0,10,35
10,Success,44,39,0,15,29
10,Success,44,43,6,7,37
10,Success,46,30,10,14,32
10,Success,50,43,0,6,44
10,Success,49,26,0,15,34
10,Success,51,24,0,17,34
10,Success,53,35,0,11,42
10,Success,52,36,3,9,43
10,Success,50,37,0,11,39
10,Success,55,32,0,9,46
10,Success,43,39,3,15,28
10,Success,43,39,0,10,33
10,Success,48,33,0,15,33
10,Success,54,30,0,10,44
10,Success,48,36,0,10,38
10,Success,41,38,0,11,30
10,Success,48,41,1,10,38
10,Success,54,33,1,12,42
10,Success,47,35,0,13,34
10,Success,46,39,5,10,36
10,Success,46,38,1,15,31
10,Success,48,38,0,14,34
10,Success,57,31,0,9,48
10,Success,46,38,0,12,34
10,Success,53,30,4,13,40
10,Success,53,33,0,12,41
10,Success,49,36,0,15,34
10,Success,43,39,2,16,27
10,Success,47,35,0,11,36
10,Success,46,39,0,12,34
10,Success,42,38,0,10,32
10,Success,47,38,3,12,35
10,Success,37,26,0,17,20
10,Success,51,34,4,11,40
10,Success,53,36,3,8,45
10,Success,45,33,0,14,31
10,Success,53,30,0,9,44
10,Success,51,35,0,13,38
10,Success,47,34,0,12,35
10,Success,47,44,0,8,39
10,Success,50,32,0,11,39
10,Success,46,28,2,24,22
10,Success,53,34,0,9,44
10,Success,46,31,0,17,29
10,Success,51,34,0,9,42
10,Success,38,39,0,15,23
10,Success,47,34,9,10,37
10,Success,35,44,0,15,20
10,Success,47,25,0,19,28
10,Success,53,31,5,11,42
10,Success,51,35,3,11,40
10,Success,43,39,0,13,30
10,Success,51,31,0,13,38
10,Success,39,39,0,14,25
10,Success,41,45,0,11,30
10,Success,42,26,11,21,21
10,Success,53,32,0,11,42
10,Success,37,39,7,17,20
10,Success,49,40,0,9,40
10,Success,44,42,1,13,31
10,Success,53,27,0,10,43
10,Success,50,35,4,11,39
10,Success,44,41,0,12,32
10,Success,50,32,0,6,44
10,Success,49,36,4,11,38
10,Success,49,37,0,11,38
10,Success,55,33,0,10,45
10,Success,47,36,0,10,37
10,Success,60,28,2,10,50
10,Success,57,38,1,4,53
10,Success,50,34,2,14,36
10,Success,52,28,3,17,35
10,Success,52,40,0,7,45
10,Success,50,36,2,12,38
10,Success,50,33,0,10,40
10,Success,46,33,0,12,34
10,Success,44,39,5,12,32
10,Success,48,32,0,12,36
10,Success,53,30,0,17,36
10,Success,49,32,0,11,38
10,Success,46,34,6,14,32
10,Success,53,30,0,13,40
10,Success,53,37,0,9,44
10,Success,45,44,1,10,35
10,Success,47,36,1,16,31
10,Success,56,32,0,11,45
10,Success,46,41,0,12,34
10,Success,53,31,5,11,42
10,Success,51,38,0,11,40
10,Success,47,29,0,13,34
10,Success,44,34,6,16,28
10,Success,48,40,0,7,41
10,Success,52,36,1,11,41
10,Success,45,41,0,9,36
10,Success,48,29,7,16,32
10,Success,46,35,0,11,35
10,Success,48,39,1,12,36
10,Success,46,38,0,13,33
10,Success,44,36,4,16,28
10,Success,47,31,0,19,28
10,Success,45,41,0,13,32
10,Success,45,37,2,16,29
10,Success,42,37,0,12,30
10,Success,50,36,2,12,38
10,Success,41,38,0,13,28
10,Success,53,26,0,17,36
10,Success,46,41,2,11,35
10,Success,49,38,0,13,36
10,Success,45,29,0,14,31
10,Success,38,36,6,20,18
10,Success,52,26,5,17,35
10,Success,47,32,0,20,27
10,Success,52,30,0,16,36
10,Success,48,32,3,17,31
10,Success,42,38,0,16,26
10,Success,53,32,0,12,41
10,Success,53,30,4,13,40
10,Success,39,38,0,17,22
10,Success,48,31,0,16,32
10,Success,43,37,6,14,29
10,Success,54,24,7,15,39
10,Success,45,35,5,15,30
10,Success,54,34,0,11,43
10,Success,47,37,0,12,35
10,Success,48,37,0,12,36
10,Success,45,32,0,16,29
10,Success,39,47,2,12,27
10,Success,51,33,3,13,38
10,Success,50,36,6,8,42
10,Success,47,36,0,15,32
10,Success,59,26,0,9,50
10,Success,51,26,8,15,36
10,Success,41,36,8,15,26
10,Success,39,48,4,9,30
10,Success,53,31,0,14,39
10,Success,49,38,0,9,40
10,Success,53,29,0,16,37
10,Success,48,40,1,11,37
10,Success,54,31,5,10,44
10,Success,45,29,0,14,31
10,Success,47,35,8,10,37
10,Success,50,35,0,14,36
10,Success,50,38,0,9,41
10,Success,47,39,4,10,37
10,Success,51,30,10,9,42
10,Success,51,31,5,13,38
10,Success,50,38,3,9,41
10,Success,42,32,0,17,25
10,Success,52,27,0,13,39
10,Success,46,39,3,12,34
10,Success,51,34,0,11,40
10,Success,45,37,4,14,31
10,Success,52,32,0,15,37
10,Success,53,30,0,14,39
10,Success,50,28,8,14,36
10,Success,42,41,0,13,29
10,Success,46,42,3,9,37
10,Success,45,36,1,18,27
10,Success,41,44,0,14,27
10,Success,53,34,0,9,44
10,Success,57,33,3,7,50
10,Success,37,40,0,12,25
10,Success,50,28,0,13,37
10,Success,47,32,5,16,31
10,Success,52,37,3,8,44
10,Success,48,38,0,12,36
10,Success,49,35,0,14,35
10,Success,50,38,0,9,41
10,Success,53,30,4,13,40
10,Success,39,38,0,11,28
10,Success,46,33,0,11,35
10,Success,45,41,0,14,31
10,Success,43,31,11,15,28
10,Success,47,44,0,9,38
10,Success,49,38,1,12,37
10,Success,54,39,0,7,47
10,Success,48,34,0,14,34
10,Success,46,34,0,14,32
10,Success,47,41,5,7,40
10,Success,45,38,1,16,29
10,Success,51,35,1,13,38
10,Success,40,47,1,12,28
10,Success,44,33,7,16,28
10,Success,43,42,0,13,30
10,Success,47,41,0,10,37
10,Success,43,45,0,10,33
10,Success,51,32,2,15,36
10,Success,45,40,0,13,32
10,Success,52,37,0,11,41
10,Success,50,35,0,11,39
10,Success,46,39,0,8,38
10,Success,41,42,0,9,32
10,Success,54,35,0,9,45
10,Success,51,32,5,12,39
10,Success,47,37,1,15,32
10,Success,46,37,0,12,34
10,Success,56,32,0,10,46
10,Success,47,40,0,13,34
10,Success,45,40,8,7,38
10,Success,51,36,0,10,41
10,Success,44,32,8,16,28
10,Success,43,34,6,17,26
10,Success,47,32,0,15,32
10,Success,43,40,0,15,28
10,Success,52,32,2,14,38
10,Success,43,40,0,17,26
10,Success,51,35,0,14,37
10,Success,57,29,0,11,46
10,Success,55,28,5,12,43
10,Success,56,35,1,8,48
10,Success,46,44,0,5,41
10,Success,47,39,4,10,37
10,Success,47,36,3,14,33
10,Success,50,37,0,11,39
10,Success,52,35,0,13,39
10,Success,43,45,1,11,32
10,Success,49,38,2,11,38
10,Success,51,35,3,11,40
10,Success,48,31,0,18,30
10,Success,51,39,1,9,42
10,Success,49,35,5,11,38
10,Success,45,41,4,10,35
10,Success,45,38,0,7,38
10,Success,45,31,0,21,24
10,Success,44,39,9,8,36
10,Success,52,37,0,11,41
10,Success,49,34,0,16,33
10,Success,47,34,0,19,28
10,Success,49,38,0,11,38
10,Success,52,40,0,8,44
10,Success,49,38,0,9,40
10,Success,50,36,0,9,41
10,Success,41,42,0,17,24
10,Success,46,35,0,15,31
10,Success,54,30,4,12,42
10,Success,54,33,1,12,42
10,Success,49,33,3,15,34
10,Success,36,35,0,18,18
10,Success,46,44,0,10,36
10,Success,41,43,4,12,29
10,Success,48,36,0,14,34
10,Success,48,42,2,8,40
10,Success,47,38,5,10,37
10,Success,43,32,0,20,23
10,Success,42,40,6,12,30
10,Success,51,29,5,15,36
10,Success,49,28,6,17,32
10,Success,44,43,0,13,31
10,Success,46,32,0,13,33
10,Success,52,34,1,13,39
10,Success,41,33,11,15,26
10,Success,48,33,2,17,31
10,Success,53,40,0,7,46
10,Success,43,35,0,12,31
10,Success,47,36,0,12,35
10,Success,52,36,5,7,45
10,Success,42,34,0,15,27
10,Success,53,29,2,16,37
10,Success,51,34,0,15,36
10,Success,45,35,0,18,27
10,Success,42,36,6,16,26
10,Success,59,33,0,8,51
10,Success,50,30,6,14,36
10,Success,49,36,4,11,38
10,Success,49,31,4,16,33
10,Success,49,39,2,10,39
10,Success,41,36,12,11,30
10,Success,54,37,0,9,45
10,Success,45,42,0,10,35
10,Success,48,32,3,17,31
10,Success,52,35,0,12,40
10,Success,51,35,3,11,40
10,Success,52,34,1,13,39
10,Success,45,40,0,15,30
10,Success,39,33,9,19,20
10,Success,48,32,8,12,36
10,Success,43,36,6,15,28
10,Success,40,34,9,17,23
10,Success,47,35,6,12,35
10,Success,50,39,0,10,40
10,Success,42,40,0,14,28
10,Success,42,34,0,16,26
10,Success,48,34,0,14,34
10,Success,44,36,12,8,36
10,Success,49,33,5,13,36
10,Success,57,30,0,13,44
10,Success,39,34,6,21,18
10,Success,46,39,0,11,35
10,Success,53,41,0,6,47
10,Success,51,38,0,11,40
10,Success,46,45,3,6,40
10,Success,54,27,4,15,39
10,Success,43,41,0,13,30
10,Success,49,28,11,12,37
10,Success,50,29,11,10,40
10,Success,49,34,0,13,36
10,Success,52,36,2,10,42
10,Success,44,40,1,15,29
10,Success,49,36,0,11,38
10,Success,46,30,0,16,30
10,Success,53,25,12,10,43
10,Success,50,31,7,12,38
10,Success,48,37,4,11,37
10,Success,44,43,2,11,33
10,Success,51,31,0,17,34
10,Success,53,34,1,12,41
10,Success,48,37,0,15,33
10,Success,57,32,1,10,47
10,Success,43,44,4,9,34
10,Success,54,36,1,9,45
10,Success,61,26,0,12,49
10,Success,51,39,0,8,43
10,Success,42,39,0,14,28
10,Success,54,29,1,16,38
10,Success,56,30,0,9,47
10,Success,55,32,1,12,43
10,Success,48,39,3,10,38
10,Success,53,27,2,18,35
10,Success,55,30,3,12,43
10,Success,47,40,2,11,36
10,Success,44,40,0,13,31
10,Success,42,39,0,10,32
10,Success,49,36,3,12,37
10,Success,46,45,0,8,38
10,Success,40,42,0,15,25
10,Success,50,45,0,4,46
10,Success,50,34,0,9,41
10,Success,45,43,0,12,33
10,Success,45,41,0,14,31
10,Success,45,38,0,9,36
10,Success,51,29,11,9,42
10,Success,42,45,0,12,30
10,Success,50,29,0,18,32
10,Success,55,38,0,6,49
10,Success,46,37,2,15,31
10,Success,46,40,0,9,37
10,Success,42,42,0,15,27
10,Success,43,35,12,10,33
10,Success,48,36,0,16,32
10,Success,68,24,0,8,60
10,Success,47,36,4,13,34
10,Success,44,27,12,17,27
10,Success,46,37,0,9,37
10,Success,42,40,0,15,27
10,Success,42,42,3,13,29
10,Success,52,27,0,17,35
10,Success,46,28,11,15,31
10,Success,46,38,0,12,34
10,Success,48,40,0,10,38
10,Success,54,36,0,10,44
10,Success,56,29,0,11,45
10,Success,43,31,12,14,29
10,Success,49,33,5,13,36
10,Success,41,39,0,14,27
10,Success,41,37,0,17,24
10,Success,46,35,0,19,27
10,Success,44,38,5,13,31
10,Success,41,39,6,14,27
10,Success,42,35,0,14,28
10,Success,41,37,6,16,25
10,Success,46,39,0,12,34
10,Success,50,34,0,13,37
10,Success,48,35,2,15,33
10,Success,53,33,0,12,41
10,Success,50,33,6,11,39
10,Success,47,40,1,12,35
10,Success,46,40,1,13,33
10,Success,51,36,0,12,39
10,Success,50,34,4,12,38
10,Success,44,39,0,8,36
10,Success,47,35,2,16,31
10,Success,53,28,6,13,40
10,Success,51,34,0,10,41
10,Success,51,31,8,10,41
10,Success,53,36,2,9,44
10,Success,51,28,0,21,30
10,Success,57,27,0,9,48
10,Success,48,33,4,15,33
10,Success,56,31,3,10,46
10,Success,50,30,8,12,38
10,Success,47,38,0,11,36
10,Success,48,31,8,13,35
10,Success,48,38,0,10,38
10,Success,49,31,0,13,36
10,Success,47,36,0,11,36
10,Success,46,35,0,9,37
10,Success,53,31,2,14,39
10,Success,48,31,0,15,33
10,Success,48,32,2,18,30
10,Success,43,38,8,11,32
10,Success,53,34,0,13,40
10,Success,48,38,0,10,38
10,Success,39,45,0,16,23
10,Success,49,34,0,9,40
10,Success,41,39,1,19,22
10,Success,41,38,0,17,24
10,Success,48,38,1,13,35
10,Success,47,42,0,7,40
10,Success,53,37,1,9,44
10,Success,50,29,8,13,37
10,Success,45,36,0,13,32
10,Success,54,37,0,9,45
10,Success,44,32,3,21,23
10,Success,43,38,0,17,26
10,Success,46,35,4,15,31
10,Success,44,36,0,17,27
10,Success,45,33,9,13,32
10,Success,46,39,0,11,35
10,Success,56,28,0,10,46
10,Success,55,29,0,16,39
10,Success,52,32,5,11,41
10,Success,49,37,4,10,39
10,Success,46,41,1,12,34
10,Success,49,36,0,15,34
10,Success,44,36,7,13,31
10,Success,49,38,2,11,38
10,Success,43,37,1,19,24
10,Success,45,36,5,14,31
10,Success,55,36,0,7,48
10,Success,45,39,0,15,30
10,Success,35,43,4,18,17
10,Success,44,44,0,11,33
10,Success,47,40,0,12,35
10,Success,52,34,5,9,43
10,Success,46,36,0,12,34
10,Success,46,39,0,10,36
10,Success,47,44,0,8,39
10,Success,48,38,5,9,39
10,Success,57,29,1,13,44
10,Success,49,34,0,13,36
10,Success,55,37,0,6,49
10,Success,44,39,0,13,31
10,Success,43,35,0,12,31
10,Success,47,34,0,17,30
10,Success,54,27,0,14,40
10,Success,45,37,0,14,31
10,Success,45,38,0,12,33
10,Success,51,30,0,19,32
10,Success,44,38,6,12,32
10,Success,44,43,1,12,32
10,Success,43,44,0,10,33
10,Success,51,28,0,16,35
10,Success,50,30,0,16,34
10,Success,51,33,0,15,36
10,Success,42,42,0,15,27
10,Success,44,34,2,20,24
10,Success,53,31,5,11,42
10,Success,52,39,2,7,45
10,Success,48,40,0,7,41
10,Success,47,34,0,17,30
10,Success,47,38,0,13,34
10,Success,58,29,2,11,47
10,Success,47,34,10,9,38
10,Success,55,34,0,10,45
10,Success,51,34,5,10,41
10,Success,49,31,4,16,33
10,Success,43,40,3,14,29
10,Success,57,28,1,14,43
10,Success,48,42,1,9,39
10,Success,55,34,0,9,46
10,Success,55,34,0,11,44
10,Success,56,33,0,8,48
10,Success,55,30,0,9,46
10,Success,48,28,9,15,33
10,Success,49,31,8,12,37
10,Success,49,30,5,16,33
10,Success,55,32,3,10,45
10,Success,47,42,0,9,38
10,Success,45,26,11,18,27
10,Success,49,32,7,12,37
10,Success,45,33,0,20,25
10,Success,46,32,0,20,26
10,Success,48,40,3,9,39
10,Success,42,35,0,16,26
10,Success,41,37,0,9,32
10,Success,47,37,5,11,36
10,Success,51,37,3,9,42
10,Success,50,37,0,11,39
10,Success,51,36,0,13,38
10,Success,52,32,0,11,41
10,Success,48,32,7,13,35
10,Success,42,36,4,18,24
10,Success,50,35,0,11,39
10,Success,54,33,0,12,42
10,Success,47,34,0,19,28
10,Success,58,27,0,13,45
10,Success,44,36,0,13,31
10,Success,43,46,0,9,34
10,Success,47,36,0,11,36
10,Success,41,35,12,12,29
10,Success,44,36,0,16,28
10,Success,51,38,0,9,42
10,Success,41,36,11,12,29
10,Success,51,33,0,13,38
10,Success,48,37,3,12,36
10,Success,51,33,5,11,40
10,Success,50,34,0,15,35
10,Success,52,36,0,9,43
10,Success,48,35,5,12,36
10,Success,43,39,2,16,27
10,Success,37,40,0,13,24
10,Success,47,36,4,13,34
10,Success,43,38,2,17,26
10,Success,53,32,0,14,39
10,Success,46,31,2,21,25
10,Success,47,36,6,11,36
10,Success,50,33,0,12,38
10,Success,53,30,0,17,36
10,Success,46,37,0,12,34
10,Success,40,36,0,18,22
10,Success,48,33,0,13,35
10,Success,41,40,3,16,25
10,Success,41,32,12,15,26
10,Success,54,38,0,8,46
10,Success,52,32,2,14,38
10,Success,41,44,0,14,27
10,Success,47,34,0,17,30
10,Success,44,35,0,14,30
10,Success,42,43,3,12,30
10,Success,43,35,7,15,28
10,Success,52,38,0,10,42
10,Success,55,34,1,10,45
10,Success,45,38,0,15,30
10,Success,50,36,0,9,41
10,Success,46,42,1,11,35
10,Success,55,30,4,11,44
10,Success,47,34,3,16,31
10,Success,38,44,6,12,26
10,Success,48,40,3,9,39
10,Success,48,33,0,13,35
10,Success,41,39,0,13,28
10,Success,50,37,2,11,39
10,Success,51,34,0,12,39
10,Success,47,43,0,9,38
10,Success,45,35,0,14,31
10,Success,57,35,0,8,49
10,Success,52,35,3,10,42
10,Success,41,42,2,15,26
10,Success,40,32,7,21,19
10,Success,39,39,0,18,21
10,Success,34,41,0,14,20
10,Success,60,31,0,9,51
10,Success,52,33,1,14,38
10,Success,54,30,0,16,38
10,Success,50,38,1,11,39
10,Success,55,33,0,11,44
10,Success,48,37,5,10,38
10,Success,48,34,0,18,30
10,Success,52,27,0,14,38
10,Success,47,33,0,17,30
10,Success,57,32,0,10,47
10,Success,48,37,0,15,33
10,Success,56,33,0,9,47
10,Success,43,31,13,13,30
10,Success,50,32,4,14,36
10,Success,49,27,11,13,36
10,Success,52,35,1,12,40
10,Success,46,39,5,10,36
10,Success,46,29,0,19,27
10,Success,46,35,4,15,31
10,Success,49,35,0,11,38
10,Success,47,31,0,18,29
10,Success,46,36,0,15,31
10,Success,48,40,0,12,36
10,Success,53,34,2,11,42
10,Success,49,34,0,13,36
10,Success,51,35,0,8,43
10,Success,49,34,1,16,33
10,Success,42,40,0,16,26
10,Success,55,31,0,10,45
10,Success,47,39,0,11,36
10,Success,52,38,0,9,43
10,Success,57,34,0,9,48
10,Success,52,35,6,7,45
10,Success,55,26,0,12,43
10,Success,50,35,0,11,39
10,Success,51,37,8,4,47
10,Success,52,33,2,13,39
10,Success,51,34,0,15,36
10,Success,45,36,1,18,27
10,Success,51,30,7,12,39
10,Success,51,31,0,15,36
10,Success,47,35,7,11,36
10,Success,51,30,0,12,39
10,Success,46,35,8,11,35
10,Success,43,45,3,9,34
10,Success,52,37,0,10,42
10,Success,52,39,0,6,46
10,Success,46,41,0,12,34
10,Success,42,42,0,16,26
10,Success,50,37,6,7,43
10,Success,46,38,0,15,31
10,Success,47,35,0,16,31
10,Success,47,31,9,13,34
10,Success,49,26,8,17,32
10,Success,55,29,0,14,41
10,Success,50,37,3,10,40
10,Success,47,39,0,12,35
10,Success,46,31,7,16,30
10,Success,56,36,0,8,48
10,Success,47,38,4,11,36
10,Success,51,41,0,8,43
10,Success,55,30,0,14,41
10,Success,49,41,1,9,40
10,Success,48,41,1,10,38
10,Success,39,38,10,13,26
10,Success,54,35,3,8,46
10,Success,51,36,1,12,39
10,Success,53,35,0,10,43
10,Success,46,37,6,11,35
10,Success,48,35,2,15,33
10,Success,49,42,0,6,43
10,Success,47,35,10,8,39
10,Success,46,36,0,15,31
10,Success,51,37,0,12,39
10,Success,49,34,1,16,33
10,Success,50,35,3,12,38
10,Success,49,24,0,11,38
10,Success,38,32,0,19,19
10,Success,51,28,6,15,36
10,Success,55,30,0,15,40
10,Success,50,33,0,11,39
10,Success,54,38,0,7,47
10,Success,48,40,0,10,38
10,Success,55,36,3,6,49
10,Success,47,30,4,19,28
10,Success,49,40,1,10,39
10,Success,51,31,7,11,40
10,Success,50,33,0,8,42
10,Success,54,32,2,12,42
10,Success,50,28,3,19,31
10,Success,42,43,0,12,30
10,Success,47,39,1,13,34
10,Success,46,39,0,13,33
10,Success,52,31,2,15,37
10,Success,56,34,0,8,48
10,Success,50,33,0,13,37
10,Success,50,38,4,8,42
10,Success,48,35,0,17,31
10,Success,52,35,0,11,41
10,Success,55,31,0,12,43
10,Success,47,36,7,10,37
10,Success,51,36,0,13,38
10,Success,55,36,0,9,46
10,Success,57,33,0,9,48
10,Success,36,38,0,20,16
10,Success,42,38,0,12,30
10,Success,43,43,0,10,33
10,Success,47,34,0,16,31
10,Success,53,30,6,11,42
10,Success,49,38,0,12,37
10,Success,40,41,0,12,28
10,Success,50,34,3,13,37
10,Success,53,34,0,11,42
10,Success,51,40,0,9,42
10,Success,60,31,1,8,52
10,Success,55,30,1,14,41
10,Success,45,35,9,11,34
10,Success,49,32,0,14,35
10,Success,42,46,0,9,33
10,Success,54,35,0,11,43
10,Success,54,37,1,8,46
10,Success,43,34,8,15,28
10,Success,45,35,0,17,28
10,Success,40,38,0,14,26
10,Success,49,33,4,14,35
10,Success,39,36,0,20,19
10,Success,55,32,0,13,42
10,Success,49,31,0,10,39
10,Success,45,38,7,10,35
10,Success,42,32,6,20,22
10,Success,46,36,0,16,30
10,Success,44,35,6,15,29
10,Success,51,43,0,6,45
10,Success,45,28,7,20,25
10,Success,43,35,8,14,29
10,Success,54,30,3,13,41
10,Success,49,32,0,15,34
10,Success,48,36,0,12,36
10,Success,46,40,1,13,33
10,Success,47,38,5,10,37
10,Success,51,37,0,9,42
10,Success,46,43,1,10,36
10,Success,50,36,5,9,41
10,Success,49,40,0,10,39
10,Success,50,37,2,11,39
10,Success,48,39,0,8,40
10,Success,53,25,7,15,38
10,Success,46,39,2,13,33
10,Success,42,41,3,14,28
10,Success,48,35,0,13,35
10,Success,44,31,13,12,32
10,Success,53,33,0,9,44
10,Success,50,28,0,16,34
10,Success,49,36,0,13,36
10,Success,48,31,5,16,32
10,Success,53,35,0,10,43
10,Success,51,29,7,13,38
10,Success,51,35,0,13,38
10,Success,54,26,0,14,40
10,Success,50,40,2,8,42
10,Success,49,35,4,12,37
10,Success,51,32,5,12,39
10,Success,46,28,0,20,26
10,Success,51,36,0,11,40
10,Success,50,33,1,16,34
10,Success,50,37,5,8,42
10,Success,48,33,6,13,35
10,Success,45,35,7,13,32
10,Success,43,31,3,23,20
10,Success,45,37,7,11,34
10,Success,49,34,0,12,37
10,Success,49,40,0,9,40
10,Success,55,29,4,12,43
10,Success,48,35,0,12,36
10,Success,39,44,7,10,29
10,Success,41,42,0,14,27
10,Success,49,41,0,9,40
10,Success,47,44,3,6,41
10,Success,50,35,0,10,40
10,Success,44,40,0,16,28
10,Success,51,37,0,11,40
10,Success,46,35,0,17,29
10,Success,50,36,5,9,41
10,Success,57,27,0,13,44
10,Success,40,42,2,16,24
10,Success,53,26,0,11,42
10,Success,46,34,2,18,28
10,Success,49,38,3,10,39
10,Success,52,30,0,15,37
10,Success,52,33,3,12,40
10,Success,54,31,0,13,41
10,Success,48,33,0,15,33
10,Success,42,39,4,15,27
10,Success,51,36,0,12,39
10,Success,47,38,2,13,34
10,Success,41,32,13,14,27
10,Success,42,41,0,12,30
10,Success,48,33,4,15,33
10,Success,50,34,1,15,35
10,Success,46,41,2,11,35
10,Success,52,37,0,8,44
10,Success,49,35,1,15,34
10,Success,43,40,5,12,31
10,Success,46,28,4,22,24
10,Success,43,36,0,18,25
10,Success,48,41,0,10,38
10,Success,41,41,6,12,29
10,Success,46,31,11,12,34
10,Success,45,33,0,14,31
10,Success,42,43,3,12,30
10,Success,47,40,0,12,35
10,Success,49,34,4,13,36
10,Success,53,37,1,9,44
10,Success,47,40,0,10,37
10,Success,44,39,0,10,34
10,Success,50,28,0,17,33
10,Success,42,36,4,18,24
10,Success,44,40,6,10,34
10,Success,47,26,9,18,29
10,Success,50,36,0,11,39
10,Success,52,30,2,16,36
10,Success,43,42,0,9,34
10,Success,54,34,1,11,43
10,Success,44,39,0,13,31
10,Success,48,30,9,13,35
10,Success,45,37,0,11,34
10,Success,49,33,0,14,35
10,Success,52,36,0,11,41
10,Success,48,38,0,12,36
10,Success,52,32,2,14,38
10,Success,56,33,4,7,49
10,Success,46,40,0,14,32
10,Success,56,34,0,7,49
10,Success,44,36,0,16,28
10,Success,52,34,1,13,39
10,Success,49,36,0,14,35
10,Success,52,34,0,14,38
10,Success,39,42,7,12,27
10,Success,43,45,0,10,33
10,Success,59,31,0,10,49
10,Success,47,29,9,15,32
10,Success,48,33,0,15,33
10,Success,42,43,0,10,32
10,Success,44,31,0,18,26
10,Success,50,39,0,11,39
10,Success,45,37,2,16,29
10,Success,47,40,3,10,37
10,Success,53,29,0,14,39
10,Success,37,29,8,26,11
10,Success,51,25,0,10,41
10,Success,47,40,0,12,35
10,Success,48,31,5,16,32
10,Success,44,35,7,14,30
10,Success,41,39,0,13,28
10,Success,47,42,1,10,37
10,Success,50,33,0,14,36
10,Success,51,35,5,9,42
10,Success,51,35,0,12,39
10,Success,45,34,0,16,29
10,Success,52,29,8,11,41
10,Success,47,41,0,10,37
10,Success,50,30,11,9,41
10,Success,51,35,4,10,41
10,Success,55,28,2,15,40
10,Success,47,34,0,18,29
10,Success,50,32,0,13,37
10,Success,50,32,0,11,39
10,Success,51,30,5,14,37
10,Success,43,37,6,14,29
10,Success,48,35,0,15,33
10,Success,40,34,0,16,24
10,Success,42,33,0,17,25
10,Success,52,30,0,8,44
10,Success,52,35,0,9,43
10,Success,53,33,2,12,41
10,Success,58,30,0,9,49
10,Success,45,34,0,10,35
10,Success,39,41,0,18,21
10,Success,49,40,0,10,39
10,Success,42,46,0,10,32
10,Success,50,33,1,16,34
10,Success,53,36,4,7,46
10,Success,43,37,6,14,29
10,Success,46,37,2,15,31
10,Success,40,40,0,15,25
10,Success,49,32,7,12,37
10,Success,47,39,4,10,37
10,Success,46,29,9,16,30
10,Success,43,39,0,14,29
10,Success,47,31,0,16,31
10,Success,43,41,5,11,32
10,Success,41,33,0,14,27
10,Success,46,30,6,18,28
10,Success,49,33,0,7,42
10,Success,44,38,6,12,32
10,Success,51,37,0,12,39
10,Success,46,31,0,12,34
10,Success,45,40,0,13,32
10,Success,38,41,0,16,22
10,Success,46,33,0,11,35
10,Success,53,30,0,9,44
10,Success,47,40,2,11,36
10,Success,52,34,6,8,44
10,Success,55,28,9,8,47
10,Success,52,28,0,16,36
10,Success,42,35,2,21,21
10,Success,59,26,0,11,48
10,Success,43,36,8,13,30
10,Success,50,37,0,11,39
10,Success,54,31,1,14,40
10,Success,46,33,4,17,29
10,Success,40,44,0,16,24
10,Success,45,41,0,13,32
10,Success,51,38,4,7,44
10,Success,44,35,7,14,30
10,Success,42,39,0,14,28
10,Success,41,31,0,17,24
10,Success,45,39,1,15,30
10,Success,50,38,0,10,40
10,Success,56,34,1,9,47
10,Success,53,35,0,12,41
10,Success,42,37,0,16,26
10,Success,49,42,1,8,41
10,Success,44,43,2,11,33
10,Success,50,38,0,11,39
10,Success,43,29,11,17,26
10,Success,46,34,0,12,34
10,Success,46,32,0,17,29
10,Success,48,33,6,13,35
10,Success,41,44,0,10,31
10,Success,45,39,3,13,32
10,Success,51,40,0,9,42
10,Success,45,37,7,11,34
10,Success,47,35,0,13,34
10,Success,48,39,1,12,36
10,Success,55,28,2,15,40
10,Success,60,24,0,13,47
10,Success,52,33,2,13,39
10,Success,47,39,0,10,37
10,Success,45,37,0,14,31
10,Success,53,35,0,10,43
10,Success,41,39,0,18,23
10,Success,47,36,4,13,34
10,Success,44,39,0,6,38
10,Success,44,41,1,14,30
10,Success,49,31,0,13,36
10,Success,49,36,0,15,34
10,Success,50,27,0,14,36
10,Success,47,34,3,16,31
10,Success,46,41,0,9,37
10,Success,51,31,0,16,35
10,Success,48,34,0,11,37
10,Success,45,45,0,10,35
10,Success,48,35,0,13,35
10,Success,49,38,0,13,36
10,Success,49,30,0,16,33
10,Success,48,37,0,15,33
10,Success,48,40,0,8,40
10,Success,48,34,0,12,36
10,Success,42,39,0,10,32
10,Success,55,36,0,9,46
10,Success,48,35,1,16,32
10,Success,47,31,8,14,33
10,Success,49,31,11,9,40
10,Success,54,34,0,8,46
10,Success,43,35,7,15,28
10,Success,57,33,1,9,48
10,Success,45,36,3,16,29
10,Success,59,31,0,10,49
10,Success,44,37,0,12,32
10,Success,52,38,0,6,46
10,Success,50,30,0,14,36
10,Success,51,35,0,12,39
10,Success,47,40,3,10,37
10,Success,50,38,0,10,40
10,Success,55,33,0,12,43
10,Success,50,30,0,15,35
10,Success,45,25,12,18,27
10,Success,40,43,3,14,26
10,Success,53,33,0,13,40
10,Success,47,35,3,15,32
10,Success,50,35,0,11,39
10,Success,49,42,1,8,41
10,Success,50,36,0,10,40
10,Success,57,29,0,10,47
10,Success,44,40,1,15,29
10,Success,48,38,0,14,34
10,Success,48,34,0,14,34
10,Success,49,35,0,12,37
10,Success,40,45,0,12,28
10,Success,54,38,0,8,46
10,Success,49,34,0,17,32
10,Success,46,32,8,14,32
10,Success,51,37,0,9,42
10,Success,49,36,0,15,34
10,Success,48,38,2,12,36
10,Success,47,40,1,12,35
10,Success,45,33,0,16,29
10,Success,44,46,0,10,34
10,Success,47,33,5,15,32
10,Success,50,33,0,12,38
10,Success,46,32,0,11,35
10,Success,47,40,3,10,37
10,Success,48,38,3,11,37
10,Success,41,41,3,15,26
10,Success,48,35,0,13,35
10,Success,48,37,2,13,35
10,Success,48,30,0,14,34
10,Success,50,32,0,14,36
10,Success,48,37,0,13,35
10,Success,48,40,0,9,39
10,Success,48,30,0,18,30
10,Success,48,38,0,14,34
10,Success,46,37,0,13,33
10,Success,50,42,0,8,42
10,Success,50,42,1,7,43
10,Success,45,42,5,8,37
10,Success,49,33,0,11,38
10,Success,41,37,0,15,26
10,Success,44,33,0,13,31
10,Success,50,37,2,11,39
10,Success,45,32,0,16,29
10,Success,49,33,8,10,39
10,Success,45,45,0,9,36
10,Success,43,41,0,15,28
10,Success,53,35,0,10,43
10,Success,48,37,2,13,35
10,Success,56,32,1,11,45
10,Success,46,38,1,15,31
10,Success,50,32,0,17,33
10,Success,51,38,0,10,41
10,Success,56,32,3,9,47
10,Success,45,37,3,15,30
10,Success,41,38,0,18,23
10,Success,53,32,0,14,39
10,Success,44,41,3,12,32
10,Success,48,38,7,7,41
10,Success,44,38,0,16,28
10,Success,41,38,0,16,25
10,Success,46,34,0,16,30
10,Success,47,34,5,14,33
10,Success,45,35,0,17,28
10,Success,53,37,0,10,43
10,Success,45,37,6,12,33
10,Success,43,36,0,16,27
10,Success,54,28,0,12,42
10,Success,48,37,0,11,37
10,Success,48,32,6,14,34
10,Success,41,35,10,14,27
10,Success,43,36,0,16,27
10,Success,48,38,0,11,37
10,Success,55,31,0,11,44
10,Success,48,39,3,10,38
10,Success,53,31,0,9,44
10,Success,49,33,3,15,34
10,Success,43,40,0,9,34
10,Success,48,34,0,17,31
10,Success,41,43,0,11,30
10,Success,48,37,7,8,40
10,Success,45,31,8,16,29
10,Success,51,32,9,8,43
10,Success,59,33,2,6,53
10,Success,41,37,0,12,29
10,Success,49,34,0,8,41
10,Success,47,39,0,8,39
10,Success,50,34,1,15,35
10,Success,52,28,4,16,36
10,Success,49,34,0,12,37
10,Success,39,39,0,19,20
10,Success,46,32,0,10,36
10,Success,41,46,0,13,28
10,Success,38,48,0,13,25
10,Success,46,34,0,14,32
10,Success,52,29,1,18,34
10,Success,41,39,1,19,22
10,Success,48,36,5,11,37
10,Success,47,31,7,15,32
10,Success,49,30,6,15,34
10,Success,46,36,5,13,33
10,Success,51,39,0,10,41
10,Success,46,41,0,11,35
10,Success,46,38,0,11,35
10,Success,55,32,5,8,47
10,Success,44,30,0,17,27
10,Success,52,38,0,9,43
10,Success,44,35,5,16,28
10,Success,42,34,0,14,28
10,Success,52,36,0,12,40
10,Success,51,35,0,14,37
10,Success,45,43,0,8,37
10,Success,46,37,4,13,33
10,Success,58,31,2,9,49
10,Success,50,35,5,10,40
10,Success,57,31,2,10,47
10,Success,52,37,1,10,42
10,Success,50,36,2,12,38
10,Success,49,40,0,10,39
10,Success,48,38,0,11,37
10,Success,52,32,0,16,36
10,Success,50,36,0,10,40
10,Success,51,31,0,16,35
10,Success,45,38,0,15,30
10,Success,40,35,11,14,26
10,Success,49,32,11,8,41
10,Success,55,28,3,14,41
10,Success,41,37,10,12,29
10,Success,40,40,2,18,22
10,Success,49,33,0,16,33
10,Success,49,38,1,12,37
10,Success,42,43,0,13,29
10,Success,53,38,2,7,46
10,Success,48,27,6,19,29
10,Success,45,36,0,15,30
10,Success,35,35,9,21,14
10,Success,50,38,0,9,41
10,Success,47,33,3,17,30
10,Success,50,41,0,9,41
10,Success,44,38,0,11,33
10,Success,53,38,0,9,44
10,Success,56,31,0,11,45
10,Success,41,31,9,19,22
10,Success,43,34,3,20,23
10,Success,50,36,1,13,37
10,Success,47,31,9,13,34
10,Success,47,33,0,13,34
10,Success,43,40,0,12,31
10,Success,42,42,2,14,28
10,Success,43,36,4,17,26
10,Success,46,38,5,11,35
10,Success,50,27,5,18,32
10,Success,49,36,0,12,37
10,Success,45,36,0,11,34
10,Success,44,40,0,11,33
10,Success,48,36,6,10,38
10,Success,49,30,5,16,33
10,Success,44,32,12,12,32
10,Success,50,32,7,11,39
10,Success,44,39,5,12,32
10,Success,51,36,2,11,40
10,Success,49,36,0,14,35
10,Success,51,39,0,9,42
10,Success,49,37,0,11,38
10,Success,48,42,0,10,38
10,Success,40,40,0,15,25
10,Success,54,32,0,12,42
10,Success,49,22,13,16,33
10,Success,56,28,0,12,44
10,Success,54,33,0,13,41
10,Success,59,35,0,6,53
10,Success,51,31,0,13,38
10,Success,52,35,3,10,42
10,Success,51,42,5,2,49
10,Success,51,27,0,12,39
10,Success,52,34,0,13,39
10,Success,56,28,3,13,43
10,Success,49,32,0,10,39
10,Success,50,36,1,13,37
10,Success,51,32,6,11,40
10,Success,42,35,0,17,25
10,Success,49,37,3,11,38
10,Success,48,42,0,9,39
10,Success,46,35,0,13,33
10,Success,47,38,0,11,36
10,Success,46,35,5,14,32
10,Success,42,38,9,11,31
10,Success,53,36,6,5,48
10,Success,47,37,0,9,38
10,Success,53,32,0,14,39
10,Success,49,37,2,12,37
10,Success,51,33,0,4,47
10,Success,47,39,6,8,39
10,Success,48,38,4,10,38
10,Success,48,40,1,11,37
10,Success,50,40,0,9,41
10,Success,50,38,0,8,42
10,Success,44,38,3,15,29
10,Success,46,36,6,12,34
10,Success,51,37,0,8,43
10,Success,44,38,0,16,28
10,Success,50,34,2,14,36
10,Success,43,36,0,15,28
10,Success,51,35,0,13,38
10,Success,40,41,2,17,23
10,Success,50,29,0,10,40
10,Success,43,36,0,15,28
10,Success,45,35,0,16,29
10,Success,44,42,0,11,33
10,Success,47,42,0,8,39
10,Success,44,40,1,15,29
10,Success,35,36,13,16,19
10,Success,48,36,0,14,34
10,Success,50,38,3,9,41
10,Success,41,38,0,18,23
10,Success,45,39,0,16,29
10,Success,40,39,10,11,29
10,Success,52,30,0,18,34
10,Success,42,40,0,15,27
10,Success,42,34,0,24,18
10,Success,40,49,3,8,32
10,Success,51,35,4,10,41
10,Success,53,36,0,3,50
10,Success,38,45,1,16,22
10,Success,49,33,2,16,33
10,Success,44,43,2,11,33
10,Success,55,31,3,11,44
10,Success,53,35,2,10,43
10,Success,46,35,8,11,35
10,Success,39,31,0,20,19
10,Success,53,32,0,11,42
10,Success,38,34,0,21,17
10,Success,46,35,0,13,33
10,Success,46,34,0,13,33
10,Success,52,31,6,11,41
10,Success,47,39,0,13,34
10,Success,48,40,0,8,40
10,Success,46,42,4,8,38
10,Success,52,36,1,11,41
10,Success,50,34,4,12,38
10,Success,47,36,0,16,31
10,Success,49,30,0,15,34
10,Success,58,26,1,15,43
10,Success,53,35,0,12,41
10,Success,41,40,1,18,23
10,Success,44,35,11,10,34
10,Success,48,33,4,15,33
10,Success,50,40,0,8,42
10,Success,38,42,0,17,21
10,Success,57,33,0,9,48
10,Success,48,37,0,14,34
10,Success,42,43,0,13,29
10,Success,34,44,9,13,21
10,Success,38,42,0,13,25
10,Success,54,29,0,17,37
10,Success,50,33,1,16,34
10,Success,45,41,0,9,36
10,Success,41,44,0,14,27
10,Success,42,36,0,15,27
10,Success,51,31,10,8,43
10,Success,51,37,3,9,42
10,Success,45,39,0,13,32
10,Success,49,28,0,16,33
10,Success,50,35,0,14,36
10,Success,44,33,0,14,30
10,Success,44,35,4,17,27
10,Success,45,32,6,17,28
10,Success,48,34,0,13,35
10,Success,50,35,0,14,36
10,Success,48,38,2,12,36
10,Success,56,36,6,2,54
10,Success,45,37,8,10,35
10,Success,46,41,0,8,38
10,Success,57,31,3,9,48
10,Success,51,36,1,12,39
10,Success,53,32,4,11,42
10,Success,55,31,0,13,42
10,Success,53,32,3,12,41
10,Success,49,41,0,10,39
10,Success,50,36,3,11,39
10,Success,57,28,0,10,47
10,Success,50,40,3,7,43
10,Success,49,35,9,7,42
10,Success,61,27,3,9,52
10,Success,47,35,7,11,36
10,Success,46,39,3,12,34
10,Success,53,34,0,11,42
10,Success,36,34,7,23,13
10,Success,54,34,0,7,47
10,Success,46,40,0,12,34
10,Success,56,30,2,12,44
10,Success,39,37,6,18,21
10,Success,56,35,3,6,50
10,Success,41,36,8,15,26
10,Success,52,25,0,18,34
10,Success,51,36,2,11,40
10,Success,53,34,5,8,45
10,Success,51,33,7,9,42
10,Success,59,30,1,10,49
10,Success,45,42,1,12,33
10,Success,43,43,0,13,30
10,Success,53,32,0,10,43
10,Success,49,32,0,18,31
10,Success,50,32,5,13,37
10,Success,48,35,0,15,33
10,Success,57,25,5,13,44
10,Success,49,35,0,11,38
10,Success,48,37,0,9,39
10,Success,47,42,1,10,37
10,Success,54,32,0,9,45
10,Success,33,45,9,13,20
10,Success,44,29,0,13,31
10,Success,50,29,3,18,32
10,Success,50,36,4,10,40
10,Success,47,35,0,12,35
10,Success,48,29,10,13,35
10,Success,50,38,0,12,38
10,Success,57,31,0,10,47
10,Success,43,41,4,12,31
10,Success,54,29,0,15,39
10,Success,49,36,2,13,36
10,Success,48,36,7,9,39
10,Success,45,42,8,5,40
10,Success,42,38,2,18,24
10,Success,47,33,0,12,35
10,Success,43,40,4,13,30
10,Success,45,41,1,13,32
10,Success,53,31,2,14,39
10,Success,50,30,5,15,35
10,Success,48,38,3,11,37
10,Success,48,44,2,6,42
10,Success,50,34,0,9,41
10,Success,48,35,4,13,35
10,Success,59,31,0,6,53
10,Success,52,33,4,11,41
10,Success,49,34,5,12,37
10,Success,47,38,5,10,37
10,Success,55,33,0,10,45
10,Success,45,34,0,13,32
10,Success,48,39,0,8,40
10,Success,44,40,0,15,29
10,Success,43,39,4,14,29
10,Success,40,36,0,14,26
10,Success,50,36,0,10,40
10,Success,50,36,0,10,40
10,Success,47,36,2,15,32
10,Success,41,41,0,16,25
10,Success,50,35,3,12,38
10,Success,54,29,6,11,43
10,Success,40,34,0,22,18
10,Success,50,30,0,12,38
10,Success,45,38,2,15,30
10,Success,43,30,6,21,22
10,Success,48,42,0,8,40
10,Success,51,37,0,11,40
10,Success,46,34,5,15,31
10,Success,44,40,4,12,32
10,Success,46,43,3,8,38
10,Success,42,37,6,15,27
10,Success,45,44,3,8,37
10,Success,55,33,0,9,46
10,Success,52,34,0,11,41
10,Success,49,33,9,9,40
10,Success,48,43,1,8,40
10,Success,45,41,3,11,34
10,Success,47,36,3,14,33
10,Success,41,42,4,13,28
10,Success,39,37,0,19,20
10,Success,54,35,0,11,43
10,Success,41,44,1,14,27
10,Success,47,33,0,19,28
10,Success,41,39,0,15,26
10,Success,47,32,0,14,33
10,Success,48,32,0,13,35
10,Success,47,44,0,9,38
10,Success,52,32,0,13,39
10,Success,46,40,0,13,33
10,Success,55,34,0,9,46
10,Success,38,37,7,18,20
10,Success,44,35,4,17,27
10,Success,50,34,4,12,38
10,Success,48,29,5,18,30
10,Success,49,38,0,13,36
10,Success,53,35,0,12,41
10,Success,48,38,0,14,34
10,Success,55,32,3,10,45
10,Success,51,39,0,10,41
10,Success,43,47,0,10,33
10,Success,46,31,3,20,26
10,Success,50,38,0,10,40
10,Success,49,30,14,7,42
10,Success,49,37,5,9,40
10,Success,46,37,0,11,35
10,Success,47,40,3,10,37
10,Success,37,42,0,11,26
10,Success,45,38,3,14,31
10,Success,49,36,5,10,39
10,Success,36,39,0,10,26
10,Success,54,33,0,12,42
10,Success,51,34,0,10,41
10,Success,50,35,3,12,38
10,Success,47,40,3,10,37
10,Success,47,34,0,14,33
10,Success,54,30,4,12,42
10,Success,48,36,0,9,39
10,Success,47,31,4,18,29
10,Success,46,34,0,15,31
10,Success,49,28,0,16,33
10,Success,53,37,0,7,46
10,Success,43,49,0,8,35
10,Success,47,38,0,14,33
10,Success,49,33,7,11,38
10,Success,50,31,0,15,35
10,Success,42,40,0,15,27
10,Success,43,46,0,11,32
10,Success,52,35,6,7,45
10,Success,47,36,0,11,36
10,Success,49,36,5,10,39
10,Success,45,36,0,14,31
10,Success,47,32,5,16,31
10,Success,42,38,9,11,31
10,Success,39,44,3,14,25
10,Success,47,33,0,14,33
10,Success,52,34,8,6,46
10,Success,48,40,0,12,36
10,Success,46,38,5,11,35
10,Success,46,32,0,21,25
10,Success,46,31,9,14,32
10,Success,60,30,2,8,52
10,Success,53,27,7,13,40
10,Success,45,39,0,11,34
10,Success,46,36,0,12,34
10,Success,44,40,4,12,32
10,Success,51,40,2,7,44
10,Success,54,32,0,12,42
10,Success,43,37,0,14,29
10,Success,46,43,4,7,39
10,Success,54,31,0,8,46
10,Success,48,37,0,14,34
10,Success,47,39,3,11,36
10,Success,48,35,0,15,33
10,Success,53,33,4,10,43
10,Success,47,34,7,12,35
10,Success,52,36,2,10,42
10,Success,48,29,0,21,27
10,Success,46,38,0,11,35
10,Success,43,37,0,16,27
10,Success,49,31,3,17,32
10,Success,48,31,8,13,35
10,Success,47,39,4,10,37
10,Success,50,37,0,9,41
10,Success,48,40,0,12,36
10,Success,38,39,9,14,24
10,Success,46,33,0,15,31
10,Success,55,38,0,7,48
10,Success,52,31,0,8,44
10,Success,45,37,0,11,34
10,Success,50,31,3,16,34
10,Success,55,30,5,10,45
10,Success,51,33,5,11,40
10,Success,50,37,0,10,40
10,Success,51,31,0,14,37
10,Success,49,28,11,12,37
10,Success,47,34,0,14,33
10,Success,46,38,5,11,35
10,Success,52,41,1,6,46
10,Success,48,40,2,10,38
10,Success,54,33,0,10,44
10,Success,49,36,3,12,37
10,Success,57,32,0,10,47
10,Success,52,35,9,4,48
10,Success,44,35,0,13,31
10,Success,42,40,0,9,33
10,Success,49,35,0,13,36
10,Success,42,41,0,13,29
10,Success,56,34,0,10,46
10,Success,51,34,4,11,40
10,Success,47,34,0,12,35
10,Success,43,41,0,14,29
10,Success,48,35,0,14,34
10,Success,60,27,6,7,53
10,Success,53,38,1,8,45
10,Success,52,37,1,10,42
10,Success,46,35,0,13,33
10,Success,49,22,0,20,29
10,Success,46,36,8,10,36
10,Success,44,37,0,15,29
10,Success,48,35,6,11,37
10,Success,48,38,0,14,34
10,Success,48,35,3,14,34
10,Success,50,35,0,13,37
10,Success,53,33,0,13,40
10,Success,42,37,9,12,30
10,Success,53,33,0,10,43
10,Success,50,39,3,8,42
10,Success,45,34,9,12,33
10,Success,47,34,1,18,29
10,Success,48,32,4,16,32
10,Success,45,40,3,12,33
10,Success,50,35,2,13,37
10,Success,54,36,4,6,48
10,Success,47,32,0,15,32
10,Success,47,33,0,7,40
10,Success,46,34,5,15,31
10,Success,48,38,3,11,37
10,Success,44,34,12,10,34
10,Success,50,29,0,6,44
10,Success,50,34,3,13,37
10,Success,43,39,4,14,29
10,Success,52,36,0,11,41
10,Success,44,40,0,13,31
10,Success,54,30,2,14,40
10,Success,45,42,0,13,32
10,Success,49,39,2,10,39
10,Success,46,35,2,17,29
10,Success,49,31,10,10,39
10,Success,48,37,0,13,35
10,Success,45,36,8,11,34
10,Success,52,32,0,13,39
10,Success,48,31,10,11,37
10,Success,44,36,0,17,27
10,Success,42,38,0,12,30
10,Success,37,45,0,14,23
10,Success,55,34,4,7,48
10,Success,55,33,0,9,46
10,Success,42,34,0,18,24
10,Success,51,30,0,14,37
10,Success,39,35,0,14,25
10,Success,50,38,1,11,39
10,Success,51,35,0,11,40
10,Success,44,43,3,10,34
10,Success,44,34,0,14,30
10,Success,44,42,3,11,33
10,Success,47,32,6,15,32
10,Success,52,36,0,11,41
10,Success,55,35,0,10,45
10,Success,58,25,6,11,47
10,Success,48,35,6,11,37
10,Success,51,31,6,12,39
10,Success,54,33,0,12,42
10,Success,46,33,0,12,34
10,Success,46,37,0,11,35
10,Success,46,38,2,14,32
10,Success,58,36,0,6,52
10,Success,44,27,13,16,28
10,Success,50,35,0,14,36
10,Success,58,30,4,8,50
10,Success,53,38,0,5,48
10,Success,55,32,0,13,42
10,Success,54,31,0,15,39
10,Success,49,28,0,10,39
10,Success,48,41,0,9,39
10,Success,44,34,4,18,26
10,Success,44,35,0,14,30
10,Success,49,32,0,11,38
10,Success,44,38,0,14,30
10,Success,52,27,4,17,35
10,Success,46,35,6,13,33
10,Success,50,38,1,11,39
10,Success,52,30,1,17,35
10,Success,52,31,0,15,37
10,Success,51,32,0,12,39
10,Success,48,41,0,6,42
10,Success,45,38,3,14,31
10,Success,49,40,0,7,42
10,Success,50,37,0,12,38
10,Success,49,40,0,10,39
10,Success,50,30,0,17,33
10,Success,51,35,2,12,39
10,Success,41,42,0,12,29
10,Success,51,30,6,13,38
10,Success,52,30,7,11,41
10,Success,42,38,6,14,28
10,Success,49,34,5,12,37
10,Success,46,34,0,20,26
10,Success,51,32,5,12,39
10,Success,45,27,0,23,22
10,Success,50,31,0,16,34
10,Success,50,34,2,14,36
10,Success,47,40,5,8,39
10,Success,47,39,2,12,35
10,Success,55,30,0,12,43
10,Success,48,38,2,12,36
10,Success,50,38,0,12,38
10,Success,47,39,0,12,35
10,Success,39,40,0,15,24
10,Success,43,44,0,12,31
10,Success,57,30,0,9,48
10,Success,42,36,0,17,25
10,Success,58,27,1,14,44
10,Success,51,25,12,12,39
10,Success,48,40,0,11,37
10,Success,47,35,6,12,35
10,Success,50,37,0,12,38
10,Success,48,38,0,9,39
10,Success,52,34,0,9,43
10,Success,47,39,9,5,42
10,Success,51,38,1,10,41
10,Success,45,37,1,17,28
10,Success,43,35,0,16,27
10,Success,54,30,8,8,46
10,Success,47,39,0,14,33
10,Success,49,33,0,10,39
10,Success,48,37,0,10,38
10,Success,47,40,2,11,36
10,Success,54,27,6,13,41
10,Success,51,28,5,16,35
10,Success,42,45,0,11,31
10,Success,45,39,6,10,35
10,Success,48,30,6,16,32
10,Success,43,33,0,15,28
10,Success,43,45,1,11,32
10,Success,43,37,6,14,29
10,Success,51,39,2,8,43
10,Success,52,27,6,15,37
10,Success,42,37,10,11,31
10,Success,49,46,0,5,44
10,Success,56,37,0,5,51
10,Success,45,36,0,12,33
10,Success,43,37,3,17,26
10,Success,52,39,3,6,46
10,Success,40,31,0,18,22
10,Success,54,29,0,17,37
10,Success,44,43,1,12,32
10,Success,45,38,4,13,32
10,Success,45,33,0,13,32
10,Success,50,27,10,13,37
10,Success,44,38,0,12,32
10,Success,44,38,4,14,30
10,Success,53,27,9,11,42
10,Success,45,30,6,19,26
10,Success,36,47,0,16,20
10,Success,49,42,0,8,41
10,Success,48,40,0,12,36
10,Success,46,34,3,17,29
10,Success,48,30,0,13,35
10,Success,53,31,3,13,40
10,Success,46,40,2,12,34
10,Success,45,37,0,16,29
10,Success,44,45,1,10,34
10,Success,40,44,2,14,26
10,Success,46,36,0,10,36
10,Success,44,41,2,13,31
10,Success,43,36,5,16,27
10,Success,53,32,0,13,40
10,Success,42,31,0,16,26
10,Success,58,26,1,15,43
10,Success,58,30,3,9,49
10,Success,45,38,5,12,33
10,Success,43,38,0,12,31
10,Success,51,35,3,11,40
10,Success,50,35,1,14,36
10,Success,52,34,2,12,40
10,Success,42,37,12,9,33
10,Success,45,36,0,16,29
10,Success,44,42,0,10,34
10,Success,52,34,5,9,43
10,Success,44,40,0,12,32
10,Success,45,34,0,13,32
10,Success,51,33,0,10,41
10,Success,48,30,4,18,30
10,Success,49,41,0,5,44
10,Success,52,36,0,12,40
10,Success,55,33,0,9,46
10,Success,48,26,0,23,25
10,Success,46,38,2,14,32
10,Success,48,41,2,9,39
10,Success,49,40,5,6,43
10,Success,49,35,0,13,36
10,Success,42,39,0,12,30
10,Success,53,36,0,8,45
10,Success,45,42,5,8,37
10,Success,47,35,0,15,32
10,Success,42,32,8,18,24
10,Success,51,32,4,13,38
10,Success,51,33,5,11,40
10,Success,46,37,3,14,32
10,Success,59,31,0,9,50
10,Success,50,38,0,8,42
10,Success,44,37,0,11,33
10,Success,45,43,1,11,34
10,Success,43,45,1,11,32
10,Success,46,39,2,13,33
10,Success,51,36,0,10,41
10,Success,49,41,0,7,42
10,Success,47,44,3,6,41
10,Success,48,46,0,5,43
10,Success,53,38,3,6,47
10,Success,50,32,1,17,33
10,Success,47,37,0,15,32
10,Success,56,27,0,12,44
10,Success,41,42,0,12,29
10,Success,49,32,7,12,37
10,Success,44,37,0,14,30
10,Success,46,41,0,9,37
10,Success,50,29,0,16,34
10,Success,43,37,1,19,24
10,Success,48,35,4,13,35
10,Success,45,44,2,9,36
10,Success,47,38,5,10,37
10,Success,59,31,0,10,49
10,Success,46,32,9,13,33
10,Success,42,39,4,15,27
10,Success,50,40,0,9,41
10,Success,48,40,5,7,41
10,Success,46,41,0,13,33
10,Success,48,31,4,17,31
10,Success,44,27,3,26,18
10,Success,54,33,0,9,45
10,Success,45,38,2,15,30
10,Success,42,46,0,12,30
10,Success,47,40,0,10,37
10,Success,46,24,0,24,22
10,Success,44,38,0,14,30
10,Success,51,29,0,14,37
10,Success,45,39,0,11,34
10,Success,56,35,0,6,50
10,Success,44,41,0,10,34
10,Success,49,28,0,22,27
10,Success,36,33,0,16,20
10,Success,48,37,5,10,38
10,Success,42,35,0,12,30
10,Success,44,35,8,13,31
10,Success,46,34,4,16,30
10,Success,52,33,0,10,42
10,Success,40,36,5,19,21
10,Success,51,36,2,11,40
10,Success,48,34,0,17,31
10,Success,49,36,5,10,39
10,Success,41,36,9,14,27
10,Success,55,26,0,15,40
10,Success,47,33,0,17,30
10,Success,50,35,0,8,42
10,Success,49,36,1,14,35
10,Success,50,32,0,14,36
10,Success,47,37,4,12,35
10,Success,45,39,0,13,32
10,Success,40,39,4,17,23
10,Success,53,39,0,8,45
10,Success,46,43,0,9,37
10,Success,49,29,10,12,37
10,Success,49,37,0,14,35
10,Success,50,34,0,14,36
10,Success,53,37,2,8,45
10,Success,50,30,0,15,35
10,Success,48,36,0,9,39
10,Success,49,39,0,10,39
10,Success,53,31,0,13,40
10,Success,47,45,0,6,41
10,Success,45,44,0,6,39
10,Success,44,45,0,8,36
10,Success,47,28,10,15,32
10,Success,51,41,0,8,43
10,Success,54,31,0,12,42
10,Success,48,34,6,12,36
10,Success,40,46,0,13,27
10,Success,52,37,1,10,42
10,Success,42,36,0,17,25
10,Success,48,36,0,12,36
10,Success,52,30,0,11,41
10,Success,54,31,0,14,40
10,Success,45,44,3,8,37
10,Success,47,37,3,13,34
10,Success,53,30,0,12,41
10,Success,51,37,0,10,41
10,Success,46,38,0,13,33
10,Success,47,34,5,14,33
10,Success,51,35,0,13,38
10,Success,54,32,1,13,41
10,Success,44,41,0,11,33
10,Success,55,30,1,14,41
10,Success,42,35,12,11,31
10,Success,51,30,0,15,36
10,Success,55,31,1,13,42
10,Success,50,37,0,13,37
10,Success,48,33,7,12,36
10,Success,42,43,0,12,30
10,Success,48,36,0,11,37
10,Success,46,38,3,13,33
10,Success,45,33,0,19,26
10,Success,50,37,2,11,39
10,Success,52,27,0,11,41
10,Success,50,36,0,14,36
10,Success,36,38,0,11,25
10,Success,54,30,3,13,41
10,Success,53,36,0,11,42
10,Success,57,34,1,8,49
10,Success,37,41,10,12,25
10,Success,48,33,6,13,35
10,Success,50,35,0,12,38
10,Success,50,34,2,14,36
10,Success,42,45,4,9,33
10,Success,48,36,0,13,35
10,Success,53,40,1,6,47
10,Success,46,33,1,20,26
10,Success,53,24,0,13,40
10,Success,49,30,9,12,37
10,Success,48,41,0,8,40
10,Success,47,39,2,12,35
10,Success,40,40,9,11,29
10,Success,42,35,7,16,26
10,Success,53,34,0,10,43
10,Success,46,38,3,13,33
10,Success,47,37,0,11,36
10,Success,49,32,2,17,32
10,Success,51,39,0,8,43
10,Success,42,39,0,16,26
10,Success,51,28,0,18,33
10,Success,42,36,0,13,29
10,Success,47,40,0,11,36
10,Success,49,34,1,16,33
10,Success,55,35,1,9,46
10,Success,45,39,2,14,31
10,Success,53,29,4,14,39
10,Success,44,36,0,16,28
10,Success,48,35,0,15,33
10,Success,46,37,0,16,30
10,Success,43,42,3,12,31
10,Success,48,35,0,16,32
10,Success,47,34,5,14,33
10,Success,45,39,5,11,34
10,Success,51,34,2,13,38
10,Success,51,33,0,12,39
10,Success,49,39,1,11,38
10,Success,42,38,5,15,27
10,Success,52,37,0,9,43
10,Success,54,35,5,6,48
10,Success,41,31,10,18,23
10,Success,47,36,0,12,35
10,Success,51,39,0,10,41
10,Success,48,38,3,11,37
10,Success,54,31,0,15,39
10,Success,55,30,0,14,41
10,Success,53,30,6,11,42
10,Success,46,41,0,12,34
10,Success,46,41,1,12,34
10,Success,45,38,2,15,30
10,Success,47,34,8,11,36
10,Success,50,34,0,16,34
10,Success,50,29,12,9,41
10,Success,51,37,2,10,41
10,Success,36,33,0,14,22
10,Success,50,38,0,10,40
10,Success,52,37,3,8,44
10,Success,47,40,0,11,36
10,Success,44,42,3,11,33
10,Success,54,28,0,18,36
10,Success,42,33,0,10,32
10,Success,48,30,10,12,36
10,Success,48,38,0,9,39
10,Success,50,37,0,13,37
10,Success,48,32,0,15,33
10,Success,52,33,0,15,37
10,Success,44,36,8,12,32
10,Success,50,34,0,9,41
10,Success,40,43,5,12,28
10,Success,49,34,0,10,39
10,Success,49,28,7,16,33
10,Success,45,39,0,12,33
10,Success,51,35,0,10,41
10,Success,46,37,3,14,32
10,Success,54,36,0,10,44
10,Success,47,37,0,13,34
10,Success,44,37,6,13,31
10,Success,49,35,6,10,39
10,Success,55,26,0,17,38
10,Success,45,35,0,18,27
10,Success,49,40,0,7,42
10,Success,54,31,0,13,41
10,Success,32,46,7,15,17
10,Success,51,36,0,12,39
10,Success,43,28,0,17,26
10,Success,53,37,1,9,44
10,Success,47,38,2,13,34
10,Success,55,28,0,16,39
10,Success,42,42,4,12,30
10,Success,52,33,0,12,40
10,Success,49,35,0,12,37
10,Success,59,28,2,11,48
10,Success,52,37,2,9,43
10,Success,51,38,0,10,41
10,Success,51,35,7,7,44
10,Success,49,39,3,9,40
10,Success,39,35,0,16,23
10,Success,49,37,0,13,36
10,Success,57,33,0,10,47
10,Success,39,35,0,16,23
10,Success,55,34,0,8,47
10,Success,45,40,0,8,37
10,Success,49,32,0,15,34
10,Success,55,30,0,14,41
10,Success,49,40,1,10,39
10,Success,54,30,1,15,39
10,Success,50,37,0,12,38
10,Success,47,39,0,10,37
10,Success,47,34,0,18,29
10,Success,54,32,0,14,40
10,Success,45,34,0,16,29
10,Success,63,25,0,11,52
10,Success,48,33,0,14,34
10,Success,40,40,0,17,23
10,Success,49,36,4,11,38
10,Success,46,42,3,9,37
10,Success,49,33,0,14,35
10,Success,48,40,1,11,37
10,Success,42,37,0,8,34
10,Success,38,38,7,17,21
10,Success,38,48,2,12,26
10,Success,52,32,2,14,38
10,Success,46,41,0,13,33
10,Success,48,39,0,11,37
10,Success,53,30,0,11,42
10,Success,49,42,0,9,40
10,Success,49,35,2,14,35
10,Success,47,39,0,11,36
10,Success,47,37,0,13,34
10,Success,43,32,0,15,28
10,Success,45,40,2,13,32
10,Success,49,36,6,9,40
10,Success,52,31,0,12,40
10,Success,45,39,2,14,31
10,Success,50,28,0,17,33
10,Success,53,36,5,6,47
10,Success,49,43,0,8,41
10,Success,44,40,0,15,29
10,Success,45,36,8,11,34
10,Success,49,30,7,14,35
10,Success,41,38,0,17,24
10,Success,55,36,4,5,50
10,Success,44,33,3,20,24
10,Success,53,35,6,6,47
10,Success,50,31,4,15,35
10,Success,51,37,1,11,40
10,Success,45,32,0,17,28
10,Success,47,35,2,16,31
10,Success,48,26,14,12,36
10,Success,55,30,3,12,43
10,Success,44,44,1,11,33
10,Success,54,30,5,11,43
10,Success,50,37,1,12,38
10,Success,49,36,4,11,38
10,Success,48,37,0,15,33
10,Success,51,32,0,10,41
10,Success,52,32,8,8,44
10,Success,40,38,12,10,30
10,Success,43,38,4,15,28
10,Success,52,35,0,13,39
10,Success,54,35,1,10,44
10,Success,51,33,0,14,37
10,Success,43,44,2,11,32
10,Success,42,31,9,18,24
10,Success,49,33,0,17,32
10,Success,48,36,1,15,33
10,Success,45,36,6,13,32
10,Success,49,32,0,12,37
10,Success,55,33,0,9,46
10,Success,51,30,0,15,36
10,Success,52,34,0,13,39
10,Success,54,34,2,10,44
10,Success,49,35,0,10,39
10,Success,49,38,2,11,38
10,Success,39,33,13,15,24
10,Success,49,32,0,8,41
10,Success,52,31,5,12,40
10,Success,44,42,2,12,32
10,Success,50,36,0,9,41
10,Success,49,38,1,12,37
10,Success,57,32,0,11,46
10,Success,47,36,0,15,32
10,Success,58,25,2,15,43
10,Success,45,40,0,14,31
10,Success,46,35,0,9,37
10,Success,50,34,2,14,36
10,Success,45,38,2,15,30
10,Success,45,47,0,6,39
10,Success,52,33,0,11,41
10,Success,43,37,0,17,26
10,Success,51,34,0,12,39
10,Success,43,40,8,9,34
10,Success,46,35,0,19,27
10,Success,46,34,0,15,31
10,Success,43,38,0,16,27
10,Success,51,35,3,11,40
10,Success,39,35,8,18,21
10,Success,48,35,5,12,36
10,Success,46,32,0,18,28
10,Success,48,40,4,8,40
10,Success,44,39,5,12,32
10,Success,50,39,3,8,42
10,Success,47,39,3,11,36
10,Success,49,32,0,11,38
10,Success,45,29,0,14,31
10,Success,47,40,0,12,35
10,Success,48,33,1,18,30
10,Success,53,35,5,7,46
10,Success,52,33,3,12,40
10,Success,42,32,0,16,26
10,Success,57,29,0,11,46
10,Success,49,41,0,9,40
10,Success,50,34,4,12,38
10,Success,42,36,6,16,26
10,Success,45,30,0,14,31
10,Success,55,34,3,8,47
10,Success,41,39,0,16,25
10,Success,48,32,0,14,34
10,Success,51,38,2,9,42
10,Success,48,33,0,17,31
10,Success,53,32,1,14,39
10,Success,45,42,0,10,35
10,Success,47,30,9,14,33
10,Success,38,44,4,14,24
10,Success,43,35,0,15,28
10,Success,46,36,0,11,35
10,Success,39,43,7,11,28
10,Success,54,36,1,9,45
10,Success,53,32,0,12,41
10,Success,51,33,6,10,41
10,Success,46,30,9,15,31
10,Success,51,39,0,10,41
10,Success,50,40,0,8,42
10,Success,56,38,2,4,52
10,Success,44,33,10,13,31
10,Success,50,36,0,7,43
10,Success,35,47,6,12,23
10,Success,52,38,1,9,43
10,Success,44,40,7,9,35
10,Success,49,36,0,11,38
10,Success,40,42,0,14,26
10,Success,53,23,0,12,41
10,Success,55,25,7,13,42
10,Success,46,37,0,7,39
10,Success,43,32,0,21,22
10,Success,38,45,0,11,27
10,Success,51,32,5,12,39
10,Success,41,43,0,13,28
10,Success,53,37,2,8,45
10,Success,45,41,0,10,35
10,Success,44,39,0,10,34
10,Success,51,34,0,10,41
10,Success,53,32,0,10,43
10,Success,52,36,0,12,40
10,Success,51,32,2,15,36
10,Success,48,27,0,21,27
10,Success,52,31,0,8,44
10,Success,63,28,0,7,56
10,Success,34,30,0,19,15
10,Success,57,30,0,8,49
10,Success,47,35,0,11,36
10,Success,52,29,6,13,39
10,Success,58,35,3,4,54
10,Success,52,30,6,12,40
10,Success,50,29,0,10,40
10,Success,48,30,12,10,38
10,Success,44,40,0,15,29
10,Success,37,40,5,18,19
10,Success,56,36,1,7,49
10,Success,59,29,0,11,48
10,Success,54,32,0,11,43
10,Success,42,34,0,15,27
10,Success,60,29,0,10,50
10,Success,48,41,0,9,39
10,Success,45,36,0,12,33
10,Success,50,29,8,13,37
10,Success,50,38,0,9,41
10,Success,45,35,0,13,32
10,Success,51,31,0,15,36
10,Success,53,31,0,13,40
10,Success,48,37,2,13,35
10,Success,54,32,0,9,45
10,Success,49,26,12,13,36
10,Success,51,37,0,10,41
10,Success,47,36,3,14,33
10,Success,34,42,0,18,16
10,Success,41,43,7,9,32
10,Success,48,33,3,16,32
10,Success,51,30,1,18,33
10,Success,47,33,4,16,31
10,Success,52,26,9,13,39
10,Success,42,38,0,18,24
10,Success,48,33,0,18,30
10,Success,58,29,0,11,47
10,Success,51,34,0,14,37
10,Success,52,36,1,11,41
10,Success,54,28,1,17,37
10,Success,53,34,2,11,42
10,Success,50,38,0,10,40
10,Success,43,38,0,14,29
10,Success,47,37,3,13,34
10,Success,49,41,0,7,42
10,Success,51,38,2,9,42
10,Success,51,35,0,13,38
10,Success,52,34,3,11,41
10,Success,53,31,0,9,44
10,Success,49,29,7,15,34
10,Success,50,36,4,10,40
10,Success,53,32,0,13,40
10,Success,48,32,5,15,33
10,Success,47,30,3,20,27
10,Success,46,36,0,17,29
10,Success,40,40,0,14,26
10,Success,47,31,0,20,27
10,Success,47,36,4,13,34
10,Success,43,41,0,11,32
10,Success,50,38,0,8,42
10,Success,50,32,0,17,33
10,Success,43,43,3,11,32
10,Success,46,37,0,9,37
10,Success,44,31,6,19,25
10,Success,46,37,0,11,35
10,Success,40,42,1,17,23
10,Success,43,28,0,17,26
10,Success,44,35,5,16,28
10,Success,46,33,0,16,30
10,Success,42,38,2,18,24
10,Success,50,29,0,20,30
10,Success,49,36,0,15,34
10,Success,52,40,1,7,45
10,Success,38,44,6,12,26
10,Success,52,36,0,9,43
10,Success,45,38,2,15,30
10,Success,45,45,0,10,35
10,Success,47,36,3,14,33
10,Success,54,32,3,11,43
10,Success,38,41,0,14,24
10,Success,47,39,3,11,36
10,Success,43,38,0,18,25
10,Success,49,31,7,13,36
10,Success,45,38,1,16,29
10,Success,46,34,0,18,28
10,Success,48,34,4,14,34
10,Success,47,32,3,18,29
10,Success,44,36,1,19,25
10,Success,51,31,0,17,34
10,Success,51,32,5,12,39
10,Success,41,43,6,10,31
10,Success,48,41,0,11,37
10,Success,43,39,0,14,29
10,Success,46,40,4,10,36
10,Success,54,31,7,8,46
10,Success,51,36,3,10,41
10,Success,54,34,1,11,43
10,Success,46,44,0,10,36
10,Success,48,32,0,16,32
10,Success,48,43,0,8,40
10,Success,46,38,3,13,33
10,Success,41,37,6,16,25
10,Success,49,34,0,15,34
10,Success,43,32,3,22,21
10,Success,45,37,3,15,30
10,Success,52,26,0,16,36
10,Success,46,48,0,6,40
10,Success,45,39,1,15,30
10,Success,52,33,0,11,41
10,Success,48,30,9,13,35
10,Success,49,32,5,14,35
10,Success,50,36,4,10,40
10,Success,49,34,0,14,35
10,Success,46,36,2,16,30
10,Success,44,43,5,8,36
10,Success,44,39,0,14,30
10,Success,50,38,0,10,40
10,Success,44,36,0,18,26
10,Success,47,34,0,14,33
10,Success,49,32,0,14,35
10,Success,45,38,2,15,30
10,Success,49,35,0,13,36
10,Success,52,32,3,13,39
10,Success,49,26,0,19,30
10,Success,46,42,4,8,38
10,Success,48,33,1,18,30
10,Success,44,32,8,16,28
10,Success,45,37,5,13,32
10,Success,45,38,0,16,29
10,Success,50,32,2,16,34
10,Success,51,33,5,11,40
10,Success,51,33,0,9,42
10,Success,53,37,0,9,44
10,Success,46,36,4,14,32
10,Success,43,32,5,20,23
10,Success,57,32,4,7,50
10,Success,53,28,5,14,39
10,Success,57,33,0,8,49
10,Success,46,38,5,11,35
10,Success,51,30,8,11,40
10,Success,51,31,5,13,38
10,Success,51,34,3,12,39
10,Success,48,37,2,13,35
10,Success,58,30,0,12,46
10,Success,47,35,2,16,31
10,Success,48,28,0,11,37
10,Success,41,38,0,11,30
10,Success,47,33,0,17,30
10,Success,49,31,0,17,32
10,Success,45,34,6,15,30
10,Success,48,38,2,12,36
10,Success,56,33,0,11,45
10,Success,45,40,6,9,36
10,Success,55,33,0,11,44
10,Success,50,37,0,12,38
10,Success,49,35,6,10,39
10,Success,38,39,10,13,25
10,Success,54,32,0,11,43
10,Success,57,33,1,9,48
10,Success,41,37,4,18,23
10,Success,44,35,0,15,29
10,Success,55,34,0,9,46
10,Success,45,37,0,14,31
10,Success,56,30,0,14,42
10,Success,56,36,0,6,50
10,Success,53,36,3,8,45
10,Success,52,33,0,9,43
10,Success,52,34,2,12,40
10,Success,45,35,6,14,31
10,Success,46,30,0,18,28
10,Success,55,28,9,8,47
10,Success,47,35,4,14,33
10,Success,44,41,3,12,32
10,Success,47,31,0,14,33
10,Success,42,37,7,14,28
10,Success,47,31,0,14,33
10,Success,49,37,2,12,37
10,Success,48,37,1,14,34
10,Success,46,30,0,17,29
10,Success,48,36,8,8,40
10,Success,52,33,0,13,39
10,Success,52,38,2,8,44
10,Success,48,41,0,10,38
10,Success,54,32,2,12,42
10,Success,51,30,0,11,40
10,Success,42,37,5,16,26
10,Success,53,35,0,12,41
10,Success,49,33,5,13,36
10,Success,49,35,3,13,36
10,Success,47,43,0,9,38
10,Success,50,37,4,9,41
10,Success,58,27,0,12,46
10,Success,49,34,7,10,39
10,Success,50,36,4,10,40
10,Success,52,33,0,15,37
10,Success,39,36,0,14,25
10,Success,47,32,0,12,35
10,Success,49,32,8,11,38
10,Success,42,31,0,24,18
10,Success,49,34,0,14,35
10,Success,44,36,0,13,31
10,Success,48,36,3,13,35
10,Success,46,36,0,13,33
10,Success,42,42,0,11,31
10,Success,52,34,3,11,41
10,Success,43,36,8,13,30
10,Success,55,29,0,12,43
10,Success,42,42,0,15,27
10,Success,42,39,5,14,28
10,Success,52,32,3,13,39
10,Success,51,31,0,12,39
10,Success,57,29,0,12,45
10,Success,48,35,1,16,32
10,Success,45,37,0,15,30
10,Success,49,36,10,5,44
10,Success,44,41,0,14,30
10,Success,44,47,0,8,36
10,Success,51,32,1,16,35
10,Success,46,39,0,11,35
10,Success,49,32,2,17,32
10,Success,47,36,7,10,37
10,Success,47,36,2,15,32
10,Success,40,30,0,19,21
10,Success,43,39,0,16,27
10,Success,57,28,0,8,49
10,Success,42,32,0,15,27
10,Success,47,32,14,7,40
10,Success,45,40,0,13,32
10,Success,45,36,6,13,32
10,Success,48,40,2,10,38
10,Success,45,40,0,13,32
10,Success,44,41,0,11,33
10,Success,53,34,0,10,43
10,Success,54,28,2,16,38
10,Success,42,37,0,13,29
10,Success,39,47,0,12,27
10,Success,46,31,0,15,31
10,Success,55,32,2,11,44
10,Success,42,40,5,13,29
10,Success,41,33,10,16,25
10,Success,50,31,5,14,36
10,Success,53,34,5,8,45
10,Success,41,38,9,12,29
10,Success,50,33,0,12,38
10,Success,49,41,1,9,40
10,Success,44,33,0,16,28
10,Success,42,33,0,16,26
10,Success,55,25,8,12,43
10,Success,52,38,0,10,42
10,Success,50,32,9,9,41
10,Success,50,33,4,13,37
10,Success,49,29,0,11,38
10,Success,47,42,1,10,37
10,Success,49,31,0,7,42
10,Success,49,27,12,12,37
10,Success,44,45,0,11,33
10,Success,50,35,0,9,41
10,Success,58,33,2,7,51
10,Success,43,41,0,12,31
10,Success,44,40,0,8,36
10,Success,48,38,3,11,37
10,Success,39,34,12,15,24
10,Success,44,49,0,5,39
10,Success,47,33,0,16,31
10,Success,50,38,0,12,38
10,Success,44,35,5,16,28
10,Success,53,29,0,13,40
10,Success,50,33,8,9,41
10,Success,47,39,3,11,36
10,Success,44,45,0,10,34
10,Success,45,33,10,12,33
10,Success,48,32,0,9,39
10,Success,48,33,0,13,35
10,Success,43,45,0,11,32
10,Success,42,33,0,20,22
10,Success,44,40,4,12,32
10,Success,40,39,0,14,26
10,Success,44,39,0,16,28
10,Success,55,34,3,8,47
10,Success,47,33,10,10,37
10,Success,46,38,0,16,30
10,Success,52,26,0,19,33
10,Success,48,37,0,14,34
10,Success,48,31,0,17,31
10,Success,52,32,0,16,36
10,Success,45,33,9,13,32
10,Success,44,34,0,13,31
10,Success,54,36,0,10,44
10,Success,47,36,0,17,30
10,Success,51,40,0,8,43
10,Success,48,39,0,13,35
10,Success,51,34,2,13,38
10,Success,42,43,3,12,30
10,Success,48,25,0,17,31
10,Success,45,39,5,11,34
10,Success,41,39,0,19,22
10,Success,55,30,4,11,44
10,Success,53,28,0,16,37
10,Success,41,36,10,13,28
10,Success,52,33,3,12,40
10,Success,43,41,4,12,31
10,Success,42,31,0,14,28
10,Success,38,46,0,15,23
10,Success,50,37,0,12,38
10,Success,48,37,0,13,35
10,Success,51,33,0,12,39
10,Success,48,32,5,15,33
10,Success,57,33,0,8,49
10,Success,50,33,0,11,39
10,Success,42,35,0,15,27
10,Success,46,39,0,14,32
10,Success,46,40,0,12,34
10,Success,45,38,3,14,31
10,Success,52,41,1,6,46
10,Success,47,41,1,11,36
10,Success,52,40,0,8,44
10,Success,52,35,4,9,43
10,Success,39,50,2,9,30
10,Success,47,40,3,10,37
10,Success,50,37,0,13,37
10,Success,39,37,0,14,25
10,Success,42,33,13,12,30
10,Success,50,36,4,10,40
10,Success,51,35,0,14,37
10,Success,50,34,0,12,38
10,Success,44,44,0,12,32
10,Success,51,31,3,15,36
10,Success,40,38,6,16,24
10,Success,42,34,10,14,28
10,Success,54,37,0,9,45
10,Success,53,41,0,6,47
10,Success,54,39,0,7,47
10,Success,50,31,8,11,39
10,Success,46,31,0,19,27
10,Success,54,28,0,17,37
10,Success,47,42,4,7,40
10,Success,52,26,0,17,35
10,Success,55,29,0,10,45
10,Success,58,26,0,13,45
10,Success,50,34,0,14,36
10,Success,37,47,0,12,25
10,Success,43,38,1,18,25
10,Success,50,36,3,11,39
10,Success,48,39,3,10,38
10,Success,53,37,0,9,44
10,Success,50,30,10,10,40
10,Success,43,43,0,14,29
10,Success,55,34,0,6,49
10,Success,51,33,4,12,39
10,Success,44,31,13,12,32
10,Success,44,32,0,10,34
10,Success,47,41,0,12,35
10,Success,49,30,6,15,34
10,Success,56,29,2,13,43
10,Success,46,43,0,8,38
10,Success,50,29,0,19,31
10,Success,46,29,4,21,25
10,Success,51,33,0,12,39
10,Success,50,32,8,10,40
10,Success,50,37,0,12,38
10,Success,52,33,4,11,41
10,Success,48,34,0,17,31
10,Success,39,44,0,11,28
10,Success,45,47,1,7,38
10,Success,57,37,0,5,52
10,Success,49,35,0,15,34
10,Success,47,32,0,11,36
10,Success,52,31,7,10,42
10,Success,46,42,0,10,36
10,Success,48,38,3,11,37
10,Success,44,43,1,12,32
10,Success,49,41,0,10,39
10,Success,43,40,5,12,31
10,Success,47,40,1,12,35
10,Success,45,38,0,14,31
10,Success,50,33,0,10,40
10,Success,53,26,7,14,39
10,Success,53,31,1,15,38
10,Success,51,30,0,5,46
10,Success,53,38,0,7,46
10,Success,46,36,0,14,32
10,Success,45,40,0,9,36
10,Success,48,34,6,12,36
10,Success,46,36,0,15,31
10,Success,40,38,4,18,22
10,Success,47,34,0,8,39
10,Success,47,37,0,12,35
10,Success,52,37,0,9,43
10,Success,50,32,0,15,35
10,Success,47,40,0,12,35
10,Success,43,42,2,13,30
10,Success,40,43,0,14,26
10,Success,53,34,0,11,42
10,Success,52,27,7,14,38
10,Success,50,38,0,10,40
10,Success,52,34,6,8,44
10,Success,49,40,0,10,39
10,Success,53,39,0,8,45
10,Success,56,23,4,17,39
10,Success,45,40,0,11,34
10,Success,46,39,6,9,37
10,Success,57,28,8,7,50
10,Success,49,41,1,9,40
10,Success,53,35,0,12,41
10,Success,45,37,0,14,31
10,Success,52,25,8,15,37
10,Success,44,35,0,15,29
10,Success,47,34,0,16,31
10,Success,42,42,0,10,32
10,Success,43,37,5,15,28
10,Success,44,34,0,14,30
10,Success,55,32,1,12,43
10,Success,55,29,0,16,39
10,Success,46,39,4,11,35
10,Success,51,33,3,13,38
10,Success,51,38,0,11,40
10,Success,49,40,1,10,39
10,Success,50,34,0,12,38
10,Success,50,34,3,13,37
10,Success,57,38,0,5,52
10,Success,45,41,4,10,35
10,Success,46,37,6,11,35
10,Success,45,39,0,13,32
10,Success,46,33,0,16,30
10,Success,46,46,0,8,38
10,Success,50,30,8,12,38
10,Success,60,28,1,11,49
10,Success,47,43,2,8,39
10,Success,46,39,4,11,35
10,Success,55,32,2,11,44
10,Success,39,38,0,13,26
10,Success,43,40,0,14,29
10,Success,50,32,0,9,41
10,Success,50,35,2,13,37
10,Success,45,34,7,14,31
10,Success,38,43,6,13,25
10,Success,56,33,2,9,47
10,Success,46,32,0,19,27
10,Success,47,32,7,14,33
10,Success,40,42,0,14,26
10,Success,51,38,1,10,41
10,Success,49,40,1,10,39
10,Success,50,36,0,13,37
10,Success,49,38,2,11,38
10,Success,41,32,8,19,22
10,Success,42,31,9,18,24
10,Success,48,30,9,13,35
10,Success,51,33,8,8,43
10,Success,49,34,0,16,33
10,Success,49,30,12,9,40
10,Success,53,37,2,8,45
10,Success,42,42,0,12,30
10,Success,46,43,2,9,37
10,Success,43,36,0,13,30
10,Success,50,40,0,8,42
10,Success,45,35,1,19,26
10,Success,44,40,0,14,30
10,Success,49,37,0,9,40
10,Success,58,31,5,6,52
10,Success,51,33,0,14,37
10,Success,47,35,0,13,34
10,Success,47,37,3,13,34
10,Success,50,37,2,11,39
10,Success,49,36,0,13,36
10,Success,44,43,2,11,33
10,Success,54,28,0,14,40
10,Success,44,33,0,14,30
10,Success,53,37,0,8,45
10,Success,48,34,3,15,33
10,Success,49,37,0,12,37
10,Success,53,32,3,12,41
10,Success,44,34,0,16,28
10,Success,49,34,0,14,35
10,Success,47,37,5,11,36
10,Success,43,42,0,12,31
10,Success,51,27,7,15,36
10,Success,42,43,0,15,27
10,Success,49,36,3,12,37
10,Success,45,39,4,12,33
10,Success,47,26,0,17,30
10,Success,46,40,0,14,32
10,Success,52,38,0,10,42
10,Success,57,34,0,8,49
10,Success,55,34,1,10,45
10,Success,47,30,0,16,31
10,Success,51,30,8,11,40
10,Success,44,42,0,13,31
10,Success,51,39,0,10,41
10,Success,48,35,1,16,32
10,Success,58,32,1,9,49
10,Success,49,37,0,12,37
10,Success,43,43,5,9,34
10,Success,48,40,0,9,39
10,Success,41,46,0,10,31
10,Success,46,37,0,16,30
10,Success,46,32,3,19,27
10,Success,48,39,0,11,37
10,Success,47,38,0,13,34
10,Success,54,33,2,11,43
10,Success,44,43,5,8,36
10,Success,45,37,0,12,33
10,Success,50,36,2,12,38
10,Success,43,38,0,16,27
10,Success,49,34,0,14,35
10,Success,46,31,2,21,25
10,Success,44,43,1,12,32
10,Success,47,38,5,10,37
10,Success,53,34,3,10,43
10,Success,50,35,5,10,40
10,Success,51,30,0,15,36
10,Success,49,33,0,15,34
10,Success,50,31,10,9,41
10,Success,47,34,0,14,33
10,Success,45,36,2,17,28
10,Success,61,31,0,7,54
10,Success,52,25,0,17,35
10,Success,45,39,0,14,31
10,Success,46,39,0,12,34
10,Success,58,33,0,8,50
10,Success,42,31,0,17,25
10,Success,46,32,0,16,30
10,Success,46,37,0,15,31
10,Success,46,34,0,13,33
10,Success,49,36,6,9,40
10,Success,46,44,0,10,36
10,Success,52,34,1,13,39
10,Success,46,38,0,16,30
10,Success,46,32,7,15,31
10,Success,51,37,0,11,40
10,Success,51,34,0,12,39
10,Success,46,31,0,15,31
10,Success,46,37,0,12,34
10,Success,56,32,2,10,46
10,Success,43,43,4,10,33
10,Success,49,41,0,10,39
10,Success,57,31,0,10,47
10,Success,51,37,0,8,43
10,Success,50,39,0,8,42
10,Success,45,33,5,17,28
10,Success,42,36,0,15,27
10,Success,50,36,0,12,38
10,Success,53,33,0,13,40
10,Success,53,37,0,10,43
10,Success,49,37,1,13,36
10,Success,53,33,0,13,40
10,Success,50,35,2,13,37
10,Success,43,37,0,15,28
10,Success,47,25,13,15,32
10,Success,45,39,0,16,29
10,Success,45,35,0,16,29
10,Success,38,37,7,18,20
10,Success,43,38,0,16,27
10,Success,50,32,0,11,39
10,Success,41,45,7,7,34
10,Success,46,33,6,15,31
10,Success,49,30,0,11,38
10,Success,47,40,0,13,34
10,Success,52,36,0,12,40
10,Success,50,34,0,12,38
10,Success,47,32,0,17,30
10,Success,56,31,0,13,43
10,Success,44,41,1,14,30
10,Success,48,43,0,9,39
10,Success,52,27,0,21,31
10,Success,46,36,2,16,30
10,Success,52,35,0,10,42
10,Success,53,33,2,12,41
10,Success,42,38,0,12,30
10,Success,46,32,15,7,39
10,Success,55,29,4,12,43
10,Success,53,33,1,13,40
10,Success,44,41,3,12,32
10,Success,44,40,1,15,29
10,Success,48,36,4,12,36
10,Success,49,35,1,15,34
10,Success,42,39,6,13,29
10,Success,50,36,0,14,36
10,Success,48,37,3,12,36
10,Success,43,36,0,16,27
10,Success,39,31,18,12,27
10,Success,52,37,1,10,42
10,Success,48,32,7,13,35
10,Success,42,36,7,15,27
10,Success,48,35,0,12,36
10,Success,51,34,0,11,40
10,Success,56,24,0,13,43
10,Success,42,40,0,16,26
10,Success,48,40,0,11,37
10,Success,45,39,0,11,34
10,Success,49,33,0,16,33
10,Success,54,26,0,13,41
10,Success,49,37,0,12,37
10,Success,48,35,0,15,33
10,Success,40,48,0,11,29
10,Success,41,40,0,12,29
10,Success,49,38,0,12,37
10,Success,55,33,0,12,43
10,Success,42,38,0,14,28
10,Success,48,40,0,11,37
10,Success,44,39,3,14,30
10,Success,48,36,0,12,36
10,Success,51,25,0,18,33
10,Success,44,39,1,16,28
10,Success,45,41,1,13,32
10,Success,53,36,1,10,43
10,Success,44,35,0,13,31
10,Success,40,37,0,14,26
10,Success,40,39,0,15,25
10,Success,56,28,0,15,41
10,Success,46,35,9,10,36
10,Success,52,36,0,9,43
10,Success,46,42,1,11,35
10,Success,42,34,7,17,25
10,Success,51,33,0,11,40
10,Success,50,39,0,9,41
10,Success,50,38,0,6,44
10,Success,47,32,2,19,28
10,Success,50,34,8,8,42
10,Success,42,40,0,12,30
10,Success,40,46,5,9,31
10,Success,43,45,0,11,32
10,Success,59,18,7,16,43
10,Success,52,38,0,9,43
10,Success,39,39,8,14,25
10,Success,48,31,0,14,34
10,Success,48,37,0,10,38
10,Success,51,32,0,14,37
10,Success,45,32,3,20,25
10,Success,54,31,0,14,40
10,Success,53,31,1,15,38
10,Success,47,40,0,12,35
10,Success,41,44,2,13,28
10,Success,45,34,0,17,28
10,Success,47,36,0,14,33
10,Success,47,34,0,13,34
10,Success,37,44,0,13,24
10,Success,49,35,1,15,34
10,Success,52,30,1,17,35
10,Success,44,35,7,14,30
10,Success,55,34,3,8,47
10,Success,54,29,7,10,44
10,Success,49,35,0,11,38
10,Success,49,38,3,10,39
10,Success,51,39,3,7,44
10,Success,47,39,3,11,36
10,Success,45,32,0,13,32
10,Success,50,37,3,10,40
10,Success,45,42,0,12,33
10,Success,44,40,0,16,28
10,Success,47,35,12,6,41
10,Success,47,37,2,14,33
10,Success,56,30,0,14,42
10,Success,50,32,5,13,37
10,Success,42,34,9,15,27
10,Success,46,28,11,15,31
10,Success,50,35,0,9,41
10,Success,46,35,5,14,32
10,Success,49,30,0,19,30
10,Success,54,35,0,10,44
10,Success,44,37,2,17,27
10,Success,48,38,0,13,35
10,Success,55,35,2,8,47
10,Success,51,33,0,16,35
10,Success,49,34,1,16,33
10,Success,46,39,3,12,34
10,Success,46,39,0,15,31
10,Success,44,32,0,21,23
10,Success,52,36,4,8,44
10,Success,51,37,3,9,42
10,Success,55,22,0,13,42
10,Success,45,37,0,11,34
10,Success,56,25,0,13,43
10,Success,51,26,6,17,34
10,Success,42,39,6,13,29
10,Success,46,39,1,14,32
10,Success,41,45,0,12,29
10,Success,42,37,0,16,26
10,Success,49,37,0,12,37
10,Success,47,34,6,13,34
10,Success,39,39,9,13,26
10,Success,55,31,0,8,47
10,Success,46,40,0,14,32
10,Success,52,35,1,12,40
10,Success,50,37,1,12,38
10,Success,51,30,2,17,34
10,Success,48,31,0,16,32
10,Success,44,40,1,15,29
10,Success,48,27,9,16,32
10,Success,48,33,6,13,35
10,Success,48,33,7,12,36
10,Success,48,28,15,9,39
10,Success,49,35,1,15,34
10,Success,43,34,6,17,26
10,Success,43,43,0,12,31
10,Success,45,35,0,17,28
10,Success,48,34,0,15,33
10,Success,53,26,0,20,33
10,Success,40,40,0,16,24
10,Success,49,37,0,14,35
10,Success,51,33,3,13,38
10,Success,53,34,0,12,41
10,Success,52,33,0,11,41
10,Success,48,30,0,18,30
10,Success,51,42,0,6,45
10,Success,55,30,6,9,46
10,Success,53,35,5,7,46
10,Success,44,33,9,14,30
10,Success,54,33,0,12,42
10,Success,46,30,0,17,29
10,Success,43,40,2,15,28
10,Success,45,38,1,16,29
10,Success,56,30,0,13,43
10,Success,49,40,0,11,38
10,Success,46,35,0,13,33
10,Success,43,40,0,14,29
10,Success,47,37,0,15,32
10,Success,53,31,0,10,43
10,Success,41,40,3,16,25
10,Success,44,39,0,12,32
10,Success,47,36,0,13,34
10,Success,52,39,1,8,44
10,Success,52,36,3,9,43
10,Success,44,35,0,18,26
10,Success,44,46,2,8,36
10,Success,45,31,11,13,32
10,Success,45,43,0,10,35
10,Success,47,34,5,14,33
10,Success,54,34,0,11,43
10,Success,51,32,5,12,39
10,Success,50,35,0,11,39
10,Success,47,39,3,11,36
10,Success,50,38,0,12,38
10,Success,54,29,10,7,47
10,Success,47,38,0,13,34
10,Success,43,45,3,9,34
10,Success,54,32,4,10,44
10,Success,46,32,12,10,36
10,Success,57,36,0,7,50
10,Success,49,33,9,9,40
10,Success,44,35,0,21,23
10,Success,50,36,0,8,42
10,Success,48,36,1,15,33
10,Success,53,33,3,11,42
10,Success,47,33,7,13,34
10,Success,46,38,2,14,32
10,Success,46,34,0,12,34
10,Success,51,35,0,13,38
10,Success,44,43,2,11,33
10,Success,46,29,0,12,34
10,Success,53,35,0,10,43
10,Success,54,34,0,11,43
10,Success,42,36,0,15,27
10,Success,51,35,5,9,42
10,Success,49,34,0,11,38
10,Success,46,40,0,10,36
10,Success,49,37,0,11,38
10,Success,41,39,4,16,25
10,Success,46,37,0,9,37
10,Success,49,41,0,10,39
10,Success,49,35,0,7,42
10,Success,52,31,0,14,38
10,Success,43,32,11,14,29
10,Success,50,29,5,16,34
10,Success,51,36,0,8,43
10,Success,44,34,0,17,27
10,Success,46,33,0,14,32
10,Success,48,37,3,12,36
10,Success,52,37,0,11,41
10,Success,49,41,0,10,39
10,Success,51,31,0,10,41
10,Success,42,41,4,13,29
10,Success,48,37,2,13,35
10,Success,46,34,0,16,30
10,Success,48,33,0,13,35
10,Success,50,28,10,12,38
10,Success,46,36,0,14,32
10,Success,44,38,1,17,27
10,Success,48,43,0,9,39
10,Success,49,32,4,15,34
10,Success,42,38,4,16,26
10,Success,51,34,4,11,40
10,Success,46,36,4,14,32
10,Success,50,32,10,8,42
10,Success,44,40,8,8,36
10,Success,47,35,4,14,33
10,Success,52,34,0,12,40
10,Success,51,30,3,16,35
10,Success,48,26,0,21,27
10,Success,48,35,0,13,35
10,Success,49,34,5,12,37
10,Success,52,28,5,15,37
10,Success,43,39,1,17,26
10,Success,50,31,0,14,36
10,Success,44,40,1,15,29
10,Success,53,33,0,14,39
10,Success,42,43,4,11,31
10,Success,48,30,0,17,31
10,Success,54,30,0,9,45
10,Success,50,31,5,14,36
10,Success,49,30,8,13,36
10,Success,49,39,6,6,43
10,Success,50,35,1,14,36
10,Success,43,40,0,15,28
10,Success,50,34,4,12,38
10,Success,50,27,7,16,34
10,Success,45,37,5,13,32
10,Success,53,36,1,10,43
10,Success,40,42,0,16,24
10,Success,45,35,0,12,33
10,Success,49,31,9,11,38
10,Success,48,38,0,11,37
10,Success,48,42,2,8,40
10,Success,49,41,1,9,40
10,Success,55,36,0,7,48
10,Success,44,34,10,12,32
10,Success,50,29,4,17,33
10,Success,44,37,0,16,28
10,Success,44,35,0,15,29
10,Success,52,28,7,13,39
10,Success,50,35,3,12,38
10,Success,46,29,0,16,30
10,Success,44,35,10,11,33
10,Success,47,40,0,13,34
10,Success,48,41,0,9,39
10,Success,60,32,0,8,52
10,Success,48,38,0,14,34
10,Success,44,42,0,11,33
10,Success,43,46,0,9,34
10,Success,49,35,3,13,36
10,Success,47,35,1,17,30
10,Success,48,43,1,8,40
10,Success,55,34,6,5,50
10,Success,58,30,0,9,49
10,Success,43,34,9,14,29
10,Success,37,41,11,11,26
10,Success,40,42,0,11,29
10,Success,48,30,9,13,35
10,Success,42,34,9,15,27
10,Success,49,31,0,13,36
10,Success,51,36,3,10,41
10,Success,52,27,2,19,33
10,Success,43,34,0,13,30
10,Success,43,38,8,11,32
10,Success,55,33,0,11,44
10,Success,41,36,6,17,24
10,Success,45,43,1,11,34
10,Success,49,34,1,16,33
10,Success,49,35,5,11,38
10,Success,47,37,0,14,33
10,Success,48,35,0,15,33
10,Success,48,42,0,6,42
10,Success,46,35,8,11,35
10,Success,48,36,1,15,33
10,Success,45,40,0,13,32
10,Success,50,34,0,15,35
10,Success,45,41,5,9,36
10,Success,52,39,1,8,44
10,Success,56,27,3,14,42
10,Success,48,31,0,14,34
10,Success,56,23,0,11,45
10,Success,51,33,0,16,35
10,Success,57,28,3,12,45
10,Success,40,38,2,20,20
10,Success,51,30,0,9,42
10,Success,46,37,0,13,33
10,Success,57,27,0,12,45
10,Success,47,33,0,13,34
10,Success,44,34,5,17,27
10,Success,40,35,0,17,23
10,Success,47,31,0,18,29
10,Success,42,39,0,16,26
10,Success,50,28,0,22,28
10,Success,41,39,0,18,23
10,Success,46,37,0,15,31
10,Success,50,32,5,13,37
10,Success,49,32,0,19,30
10,Success,52,30,0,15,37
10,Success,48,30,0,20,28
10,Success,43,35,4,18,25
10,Success,51,34,0,11,40
10,Success,51,38,0,11,40
10,Success,47,31,0,20,27
10,Success,43,39,0,14,29
10,Success,46,38,0,13,33
10,Success,46,36,0,15,31
10,Success,56,30,4,10,46
10,Success,40,44,0,12,28
10,Success,43,44,2,11,32
10,Success,48,41,0,11,37
10,Success,52,31,5,12,40
10,Success,50,38,0,10,40
10,Success,49,34,0,16,33
10,Success,45,39,0,10,35
10,Success,47,38,0,13,34
10,Success,50,30,11,9,41
10,Success,53,31,0,6,47
10,Success,50,40,2,8,42
10,Success,49,34,6,11,38
10,Success,52,32,6,10,42
10,Success,47,29,10,14,33
10,Success,50,33,0,13,37
10,Success,49,32,4,15,34
10,Success,43,34,0,18,25
10,Success,49,34,4,13,36
10,Success,47,39,4,10,37
10,Success,44,43,0,9,35
10,Success,50,33,4,13,37
10,Success,42,39,0,16,26
10,Success,53,31,8,8,45
10,Success,52,35,1,12,40
10,Success,50,36,0,13,37
10,Success,47,33,8,12,35
10,Success,46,36,0,11,35
10,Success,51,36,0,11,40
10,Success,61,22,0,9,52
10,Success,55,34,0,7,48
10,Success,46,22,16,16,30
10,Success,47,32,0,18,29
10,Success,55,30,0,15,40
10,Success,46,37,0,14,32
10,Success,40,45,0,10,30
10,Success,50,35,7,8,42
10,Success,46,28,7,19,27
10,Success,39,47,0,7,32
10,Success,41,38,0,16,25
10,Success,46,42,1,11,35
10,Success,42,41,3,14,28
10,Success,44,38,0,17,27
10,Success,46,34,0,15,31
10,Success,45,38,0,14,31
10,Success,50,32,0,16,34
10,Success,44,35,0,20,24
10,Success,46,36,5,13,33
10,Success,45,37,2,16,29
10,Success,46,41,0,7,39
10,Success,59,27,0,14,45
10,Success,51,36,0,7,44
10,Success,56,36,1,7,49
10,Success,47,38,0,15,32
10,Success,43,43,5,9,34
10,Success,55,28,4,13,42
10,Success,51,33,0,15,36
10,Success,50,39,0,10,40
10,Success,49,35,3,13,36
10,Success,42,41,0,11,31
10,Success,45,32,3,20,25
10,Success,51,36,0,10,41
10,Success,50,36,0,13,37
10,Success,48,41,0,10,38
10,Success,52,35,0,12,40
10,Success,54,29,2,15,39
10,Success,39,50,0,11,28
10,Success,51,39,0,10,41
10,Success,51,31,2,16,35
10,Success,45,31,0,13,32
10,Success,53,34,2,11,42
10,Success,48,37,0,12,36
10,Success,48,36,3,13,35
10,Success,47,35,4,14,33
10,Success,48,41,1,10,38
10,Success,39,38,13,10,29
10,Success,47,33,8,12,35
10,Success,57,30,0,13,44
10,Success,52,33,7,8,44
10,Success,44,31,9,16,28
10,Success,47,25,0,17,30
10,Success,53,32,4,11,42
10,Success,43,34,6,17,26
10,Success,51,38,1,10,41
10,Success,50,32,0,11,39
10,Success,52,29,3,16,36
10,Success,59,27,3,11,48
10,Success,45,41,0,9,36
10,Success,51,34,0,14,37
10,Success,45,40,3,12,33
10,Success,54,29,7,10,44
10,Success,42,41,0,15,27
10,Success,49,32,0,15,34
10,Success,41,38,6,15,26
10,Success,53,36,2,9,44
10,Success,46,36,8,10,36
10,Success,48,38,0,14,34
10,Success,45,40,0,12,33
10,Success,45,36,6,13,32
10,Success,53,31,3,13,40
10,Success,51,31,0,14,37
10,Success,47,35,0,16,31
10,Success,49,37,0,13,36
10,Success,50,34,0,10,40
10,Success,43,41,3,13,30
10,Success,45,43,3,9,36
10,Success,56,32,0,11,45
10,Success,53,37,0,10,43
10,Success,38,36,0,19,19
10,Success,51,29,7,13,38
10,Success,40,34,9,17,23
10,Success,42,36,2,20,22
10,Success,49,35,5,11,38
10,Success,35,41,12,12,23
10,Success,53,30,0,9,44
10,Success,31,40,11,18,13
10,Success,36,39,10,15,21
10,Success,43,40,2,15,28
10,Success,59,29,2,10,49
10,Success,49,39,4,8,41
10,Success,36,44,0,15,21
10,Success,43,41,0,15,28
10,Success,45,32,0,15,30
10,Success,46,41,0,11,35
10,Success,46,37,3,14,32
10,Success,50,28,0,18,32
10,Success,45,37,5,13,32
10,Success,56,34,2,8,48
10,Success,49,36,0,12,37
10,Success,52,28,0,10,42
10,Success,48,34,5,13,35
10,Success,49,36,3,12,37
10,Success,53,32,2,13,40
10,Success,54,28,0,12,42
10,Success,47,37,0,13,34
10,Success,41,35,3,21,20
10,Success,45,35,0,20,25
10,Success,50,34,0,12,38
10,Success,55,34,1,10,45
10,Success,55,35,0,10,45
10,Success,38,41,0,18,20
10,Success,45,39,0,15,30
10,Success,47,35,5,13,34
10,Success,48,40,0,11,37
10,Success,53,35,0,7,46
10,Success,51,32,0,14,37
10,Success,51,36,2,11,40
10,Success,59,26,0,11,48
10,Success,46,42,0,8,38
10,Success,44,35,0,20,24
10,Success,46,38,0,11,35
10,Success,54,32,3,11,43
10,Success,46,38,0,11,35
10,Success,42,35,7,16,26
10,Success,46,40,0,11,35
10,Success,45,36,9,10,35
10,Success,49,41,0,9,40
10,Success,52,30,0,9,43
10,Success,41,44,0,12,29
10,Success,44,38,2,16,28
10,Success,49,35,0,14,35
10,Success,51,38,0,9,42
10,Success,45,45,0,10,35
10,Success,42,31,0,17,25
10,Success,52,30,0,12,40
10,Success,48,33,0,14,34
10,Success,49,36,0,14,35
10,Success,41,43,4,12,29
10,Success,48,36,5,11,37
10,Success,41,30,0,15,26
10,Success,43,41,6,10,33
10,Success,43,32,0,19,24
10,Success,49,36,0,14,35
10,Success,45,35,0,16,29
10,Success,48,36,1,15,33
10,Success,46,39,8,7,39
10,Success,42,46,2,10,32
10,Success,38,43,0,16,22
10,Success,45,30,0,16,29
10,Success,44,33,0,18,26
10,Success,49,33,8,10,39
10,Success,44,38,0,18,26
10,Success,39,35,0,21,18
10,Success,59,31,0,10,49
10,Success,54,30,4,12,42
10,Success,58,29,4,9,49
10,Success,38,45,4,13,25
10,Success,40,38,0,21,19
10,Success,54,36,2,8,46
10,Success,50,34,0,15,35
10,Success,42,33,8,17,25
10,Success,54,35,1,10,44
10,Success,45,37,6,12,33
10,Success,53,33,0,12,41
10,Success,49,36,0,14,35
10,Success,53,33,0,14,39
10,Success,55,27,5,13,42
10,Success,41,41,0,14,27
10,Success,50,37,0,12,38
10,Success,55,30,0,11,44
10,Success,45,35,0,17,28
10,Success,48,35,0,13,35
10,Success,45,34,7,14,31
10,Success,49,33,5,13,36
10,Success,51,30,0,11,40
10,Success,42,31,0,12,30
10,Success,47,31,9,13,34
10,Success,55,38,0,6,49
10,Success,43,42,0,12,31
10,Success,49,38,0,11,38
10,Success,55,34,2,9,46
10,Success,45,38,0,15,30
10,Success,53,27,6,14,39
10,Success,46,39,2,13,33
10,Success,47,34,2,17,30
10,Success,44,38,0,14,30
10,Success,46,35,0,15,31
10,Success,55,27,7,11,44
10,Success,47,35,10,8,39
10,Success,48,32,5,15,33
10,Success,49,40,0,10,39
10,Success,48,35,4,13,35
10,Success,56,35,0,6,50
10,Success,48,33,0,10,38
10,Success,54,34,0,9,45
10,Success,51,37,0,12,39
10,Success,48,39,0,13,35
10,Success,39,36,0,16,23
10,Success,58,32,0,10,48
10,Success,41,39,0,11,30
10,Success,49,32,2,17,32
10,Success,52,37,0,10,42
10,Success,49,40,0,10,39
10,Success,48,25,10,17,31
10,Success,32,36,0,21,11
10,Success,50,30,2,18,32
10,Success,47,38,0,10,37
10,Success,49,37,0,14,35
10,Success,52,27,5,16,36
10,Success,53,35,0,9,44
10,Success,50,38,0,11,39
10,Success,40,37,0,13,27
10,Success,52,35,0,12,40
10,Success,55,35,1,9,46
10,Success,55,26,0,14,41
10,Success,47,37,2,14,33
10,Success,37,37,9,17,20
10,Success,52,30,7,11,41
10,Success,45,30,11,14,31
10,Success,51,40,0,9,42
10,Success,47,39,3,11,36
10,Success,49,33,0,17,32
10,Success,46,35,8,11,35
10,Success,50,38,0,10,40
10,Success,49,37,2,12,37
10,Success,51,38,0,9,42
10,Success,45,33,0,18,27
10,Success,47,37,3,13,34
10,Success,43,33,0,18,25
10,Success,41,40,0,10,31
10,Success,57,29,0,10,47
10,Success,45,42,2,11,34
10,Success,55,31,8,6,49
10,Success,45,37,0,11,34
10,Success,53,33,0,9,44
10,Success,50,40,0,10,40
10,Success,50,41,0,8,42
10,Success,50,36,0,11,39
10,Success,55,34,1,10,45
10,Success,51,32,3,14,37
10,Success,48,45,2,5,43
10,Success,54,38,2,6,48
10,Success,49,35,0,12,37
10,Success,44,35,6,15,29
10,Success,45,38,1,16,29
10,Success,56,34,0,9,47
10,Success,40,32,0,19,21
10,Success,45,34,6,15,30
10,Success,53,34,4,9,44
10,Success,43,39,0,14,29
10,Success,44,36,10,10,34
10,Success,50,32,5,13,37
10,Success,49,36,0,15,34
10,Success,55,33,0,6,49
10,Success,44,37,0,17,27
10,Success,50,32,0,10,40
10,Success,48,37,3,12,36
10,Success,47,41,0,12,35
10,Success,42,42,0,11,31
10,Success,51,29,3,17,34
10,Success,50,37,2,11,39
10,Success,49,38,5,8,41
10,Success,54,28,6,12,42
10,Success,47,36,0,14,33
10,Success,38,36,0,17,21
10,Success,53,33,1,13,40
10,Success,54,37,0,9,45
10,Success,41,29,0,17,24
10,Success,51,31,4,14,37
10,Success,43,32,0,15,28
10,Success,53,31,5,11,42
10,Success,59,28,5,8,51
10,Success,44,40,2,14,30
10,Success,54,31,0,12,42
10,Success,54,38,0,8,46
10,Success,47,30,0,17,30
10,Success,55,24,1,20,35
10,Success,53,29,0,11,42
10,Success,54,33,0,12,42
10,Success,51,29,0,15,36
10,Success,42,43,3,12,30
10,Success,49,35,1,15,34
10,Success,53,32,3,12,41
10,Success,50,43,1,6,44
10,Success,59,30,0,11,48
10,Success,43,38,1,18,25
10,Success,53,38,0,9,44
10,Success,42,32,7,19,23
10,Success,48,36,5,11,37
10,Success,47,32,0,12,35
10,Success,48,38,0,14,34
10,Success,52,32,4,12,40
10,Success,45,46,0,9,36
10,Success,49,35,0,12,37
10,Success,52,27,0,11,41
10,Success,55,26,3,16,39
10,Success,42,32,0,20,22
10,Success,51,33,2,14,37
10,Success,42,40,6,12,30
10,Success,49,33,0,12,37
10,Success,53,29,0,14,39
10,Success,47,37,6,10,37
10,Success,45,34,5,16,29
10,Success,46,37,4,13,33
10,Success,48,38,7,7,41
10,Success,48,45,2,5,43
10,Success,46,40,6,8,38
10,Success,53,31,0,16,37
10,Success,44,30,4,22,22
10,Success,54,34,3,9,45
10,Success,46,34,4,16,30
10,Success,48,37,3,12,36
10,Success,44,45,0,10,34
10,Success,37,38,9,16,21
10,Success,48,39,0,13,35
10,Success,51,38,1,10,41
10,Success,49,33,4,14,35
10,Success,50,32,3,15,35
10,Success,50,38,0,12,38
10,Success,51,37,0,12,39
10,Success,44,36,10,10,34
10,Success,49,37,0,12,37
10,Success,52,30,0,14,38
10,Success,50,33,6,11,39
10,Success,45,34,7,14,31
10,Success,43,37,0,15,28
10,Success,47,37,0,15,32
10,Success,51,36,2,11,40
10,Success,46,35,1,18,28
10,Success,51,35,0,6,45
10,Success,50,35,4,11,39
10,Success,53,30,0,10,43
10,Success,46,31,0,17,29
10,Success,50,36,4,10,40
10,Success,49,32,0,16,33
10,Success,51,33,1,15,36
10,Success,43,31,11,15,28
10,Success,38,39,3,20,18
10,Success,50,34,0,9,41
10,Success,51,30,0,10,41
10,Success,50,35,6,9,41
10,Success,54,29,0,14,40
10,Success,49,36,0,13,36
10,Success,48,29,0,14,34
10,Success,48,28,8,16,32
10,Success,41,33,4,22,19
10,Success,51,35,5,9,42
10,Success,46,40,0,12,34
10,Success,54,25,0,17,37
10,Success,53,31,6,10,43
10,Success,47,32,0,12,35
10,Success,51,35,0,11,40
10,Success,46,40,0,13,33
10,Success,50,35,5,10,40
10,Success,54,33,1,12,42
10,Success,46,36,0,18,28
10,Success,47,36,1,16,31
10,Success,46,42,0,11,35
10,Success,45,37,0,11,34
10,Success,47,45,1,7,40
10,Success,49,31,5,15,34
10,Success,46,40,0,10,36
10,Success,49,32,4,15,34
10,Success,49,32,0,9,40
10,Success,47,33,3,17,30
10,Success,39,41,4,16,23
10,Success,46,44,0,10,36
10,Success,50,30,0,13,37
10,Success,52,34,2,12,40
10,Success,53,39,0,8,45
10,Success,39,40,0,15,24
10,Success,49,35,0,14,35
10,Success,52,37,0,9,43
10,Success,43,40,0,11,32
10,Success,52,27,0,15,37
10,Success,50,38,1,11,39
10,Success,47,35,0,15,32
10,Success,52,30,5,13,39
10,Success,45,39,0,13,32
10,Success,48,39,4,9,39
10,Success,46,43,2,9,37
10,Success,48,38,2,12,36
10,Success,38,37,2,23,15
10,Success,49,34,5,12,37
10,Success,49,34,1,16,33
10,Success,47,40,0,11,36
10,Success,44,39,6,11,33
10,Success,59,31,0,9,50
10,Success,51,31,0,15,36
10,Success,47,35,5,13,34
10,Success,47,38,0,13,34
10,Success,47,35,3,15,32
10,Success,51,39,1,9,42
10,Success,47,37,0,16,31
10,Success,49,27,0,17,32
10,Success,53,28,0,14,39
10,Success,47,39,0,10,37
10,Success,54,34,0,9,45
10,Success,48,28,0,18,30
10,Success,45,34,0,19,26
10,Success,43,36,1,20,23
10,Success,44,39,5,12,32
10,Success,60,30,2,8,52
10,Success,48,34,2,16,32
10,Success,45,37,0,14,31
10,Success,47,37,0,12,35
10,Success,43,37,12,8,35
10,Success,55,36,3,6,49
10,Success,50,35,4,11,39
10,Success,49,27,0,10,39
10,Success,49,39,0,12,37
10,Success,45,40,0,14,31
10,Success,52,38,0,5,47
10,Success,47,37,1,15,32
10,Success,45,29,0,13,32
10,Success,49,35,0,9,40
10,Success,50,39,0,9,41
10,Success,43,36,2,19,24
10,Success,43,40,8,9,34
10,Success,44,34,10,12,32
10,Success,49,31,0,15,34
10,Success,51,32,0,11,40
10,Success,54,32,0,14,40
10,Success,47,34,0,17,30
10,Success,50,40,3,7,43
10,Success,44,33,11,12,32
10,Success,53,36,0,9,44
10,Success,56,26,0,15,41
10,Success,41,39,7,13,28
10,Success,51,40,1,8,43
10,Success,53,37,0,8,45
10,Success,46,34,0,14,32
10,Success,46,37,0,15,31
10,Success,49,30,7,14,35
10,Success,47,30,0,19,28
10,Success,59,25,0,11,48
10,Success,49,41,3,7,42
10,Success,44,33,0,14,30
10,Success,50,26,0,13,37
10,Success,43,42,0,7,36
10,Success,46,39,5,10,36
10,Success,54,30,0,13,41
10,Success,47,35,0,16,31
10,Success,54,34,0,8,46
10,Success,44,42,0,14,30
10,Success,43,36,0,19,24
10,Success,42,43,6,9,33
10,Success,44,40,0,12,32
10,Success,45,33,9,13,32
10,Success,51,36,2,11,40
10,Success,51,38,0,11,40
10,Success,46,31,0,18,28
10,Success,52,39,0,6,46
10,Success,50,32,0,12,38
10,Success,46,42,0,9,37
10,Success,44,42,2,12,32
10,Success,42,37,4,17,25
10,Success,47,37,0,12,35
10,Success,45,37,0,12,33
10,Success,50,31,0,14,36
10,Success,43,42,2,13,30
10,Success,54,27,8,11,43
10,Success,47,32,4,17,30
10,Success,52,36,3,9,43
10,Success,40,41,0,17,23
10,Success,52,35,3,10,42
10,Success,53,34,0,9,44
10,Success,42,37,0,9,33
10,Success,53,38,0,8,45
10,Success,40,34,5,21,19
10,Success,40,46,0,14,26
10,Success,46,40,0,9,37
10,Success,45,29,0,20,25
10,Success,51,31,0,14,37
10,Success,47,33,0,14,33
10,Success,43,37,0,14,29
10,Success,56,30,0,11,45
10,Success,45,36,0,16,29
10,Success,44,42,6,8,36
10,Success,48,36,0,14,34
10,Success,56,38,0,5,51
10,Success,53,30,0,17,36
10,Success,47,31,0,19,28
10,Success,52,29,0,13,39
10,Success,43,34,6,17,26
10,Success,51,32,2,15,36
10,Success,46,41,3,10,36
10,Success,46,31,8,15,31
10,Success,41,37,5,17,24
10,Success,41,37,10,12,29
10,Success,45,34,0,13,32
10,Success,42,30,0,23,19
10,Success,54,39,0,4,50
10,Success,51,31,4,14,37
10,Success,43,37,6,14,29
10,Success,44,39,0,15,29
10,Success,48,38,4,10,38
10,Success,45,31,0,18,27
10,Success,43,36,4,17,26
10,Success,43,42,0,11,32
10,Success,43,40,0,13,30
10,Success,46,42,1,11,35
10,Success,45,39,4,12,33
10,Success,52,37,0,11,41
10,Success,43,39,10,8,35
10,Success,47,39,0,11,36
10,Success,47,39,3,11,36
10,Success,44,35,0,16,28
10,Success,45,34,7,14,31
10,Success,43,39,3,15,28
10,Success,47,43,1,9,38
10,Success,50,32,0,16,34
10,Success,40,39,0,17,23
10,Success,58,30,0,11,47
10,Success,49,36,3,12,37
10,Success,56,27,0,14,42
10,Success,45,36,0,12,33
10,Success,51,31,0,13,38
10,Success,52,33,3,12,40
10,Success,52,30,0,14,38
10,Success,52,38,0,9,43
10,Success,46,36,4,14,32
10,Success,42,40,7,11,31
10,Success,48,40,1,11,37
10,Success,55,33,0,12,43
10,Success,54,28,0,15,39
10,Success,44,32,8,16,28
10,Success,47,39,0,10,37
10,Success,53,31,3,13,40
10,Success,50,33,5,12,38
10,Success,50,36,0,10,40
10,Success,41,38,7,14,27
10,Success,51,37,0,10,41
10,Success,48,38,2,12,36
10,Success,48,37,0,8,40
10,Success,46,36,9,9,37
10,Success,46,34,0,9,37
10,Success,44,37,6,13,31
10,Success,48,32,8,12,36
10,Success,45,44,0,6,39
10,Success,49,36,4,11,38
10,Success,51,35,2,12,39
10,Success,48,36,0,13,35
10,Success,42,35,0,20,22
10,Success,50,34,0,11,39
10,Success,45,38,1,16,29
10,Success,49,31,0,12,37
10,Success,51,33,0,13,38
10,Success,41,29,10,20,21
10,Success,47,32,1,20,27
10,Success,59,25,0,13,46
10,Success,48,33,0,14,34
10,Success,45,31,9,15,30
10,Success,48,33,0,13,35
10,Success,38,33,8,21,17
10,Success,52,31,5,12,40
10,Success,45,44,1,10,35
10,Success,43,37,1,19,24
10,Success,53,35,0,11,42
10,Success,40,44,2,14,26
10,Success,47,35,0,14,33
10,Success,49,35,0,13,36
10,Success,48,33,0,13,35
10,Success,49,38,7,6,43
10,Success,47,41,0,11,36
10,Success,46,42,2,10,36
10,Success,47,34,0,15,32
10,Success,55,31,0,13,42
10,Success,45,32,8,15,30
10,Success,48,34,0,14,34
10,Success,46,39,0,12,34
10,Success,37,45,7,11,26
10,Success,38,39,5,18,20
10,Success,46,39,0,14,32
10,Success,43,29,11,17,26
10,Success,49,39,2,10,39
10,Success,50,31,3,16,34
10,Success,50,34,0,12,38
10,Success,43,41,0,9,34
10,Success,49,39,0,10,39
10,Success,53,31,0,13,40
10,Success,45,36,0,18,27
10,Success,57,22,8,13,44
10,Success,43,35,10,12,31
10,Success,41,42,2,15,26
10,Success,42,35,0,17,25
10,Success,49,33,6,12,37
10,Success,44,33,0,13,31
10,Success,39,41,0,15,24
10,Success,46,34,0,11,35
10,Success,50,32,2,16,34
10,Success,40,43,6,11,29
10,Success,42,32,8,18,24
10,Success,42,34,11,13,29
10,Success,55,32,0,10,45
10,Success,50,26,0,10,40
10,Success,46,41,0,12,34
10,Success,50,31,0,14,36
10,Success,41,37,11,11,30
10,Success,49,36,0,15,34
10,Success,54,33,3,10,44
10,Success,50,38,5,7,43
10,Success,48,32,6,14,34
10,Success,49,35,0,11,38
10,Success,53,30,0,12,41
10,Success,58,21,6,15,43
10,Success,39,46,0,15,24
10,Success,47,36,4,13,34
10,Success,40,43,0,13,27
10,Success,49,35,1,15,34
10,Success,38,41,0,17,21
10,Success,48,33,0,12,36
10,Success,47,39,0,8,39
10,Success,50,34,0,12,38
10,Success,54,31,0,14,40
10,Success,50,32,0,13,37
10,Success,38,33,13,16,22
10,Success,57,27,0,10,47
10,Success,50,37,6,7,43
10,Success,45,36,5,14,31
10,Success,46,34,0,15,31
10,Success,52,32,4,12,40
10,Success,47,37,0,12,35
10,Success,49,40,0,8,41
10,Success,44,38,8,10,34
10,Success,50,33,6,11,39
10,Success,48,39,3,10,38
10,Success,48,29,6,17,31
10,Success,49,35,2,14,35
10,Success,50,30,0,18,32
10,Success,48,37,2,13,35
10,Success,47,35,0,15,32
10,Success,48,34,7,11,37
10,Success,44,40,1,15,29
10,Success,50,35,6,9,41
10,Success,53,30,6,11,42
10,Success,50,33,0,13,37
10,Success,50,32,9,9,41
10,Success,45,43,1,11,34
10,Success,46,36,3,15,31
10,Success,50,32,5,13,37
10,Success,48,38,4,10,38
10,Success,48,42,0,2,46
10,Success,52,39,1,8,44
10,Success,50,38,0,11,39
10,Success,39,37,0,16,23
10,Success,52,35,3,10,42
10,Success,43,37,3,17,26
10,Success,54,29,3,14,40
10,Success,49,36,0,13,36
10,Success,51,32,1,16,35
10,Success,51,30,0,14,37
10,Success,51,32,3,14,37
10,Success,47,34,7,12,35
10,Success,48,31,0,15,33
10,Success,50,38,0,8,42
10,Success,58,32,0,7,51
10,Success,48,31,0,18,30
10,Success,50,30,2,18,32
10,Success,44,37,7,12,32
10,Success,53,28,9,10,43
10,Success,39,46,1,14,25
10,Success,45,37,9,9,36
10,Success,53,32,0,14,39
10,Success,44,34,12,10,34
10,Success,36,47,0,15,21
10,Success,47,35,5,13,34
10,Success,48,35,4,13,35
10,Success,47,45,0,5,42
10,Success,58,30,0,11,47
10,Success,50,34,0,12,38
10,Success,41,46,2,11,30
10,Success,46,36,2,16,30
10,Success,42,32,0,15,27
10,Success,49,36,0,13,36
10,Success,42,41,8,9,33
10,Success,50,31,0,14,36
10,Success,54,34,0,7,47
10,Success,49,28,7,16,33
10,Success,45,42,0,9,36
10,Success,51,36,0,9,42
10,Success,51,31,1,17,34
10,Success,49,43,0,6,43
10,Success,51,35,2,12,39
10,Success,57,30,0,13,44
10,Success,46,34,12,8,38
10,Success,46,34,0,18,28
10,Success,46,28,0,11,35
10,Success,36,42,9,13,23
10,Success,51,32,0,14,37
10,Success,48,33,5,14,34
10,Success,44,33,7,16,28
10,Success,43,32,0,17,26
10,Success,43,42,0,12,31
10,Success,53,25,0,19,34
10,Success,55,31,0,11,44
10,Success,50,41,0,8,42
10,Success,45,37,4,14,31
10,Success,47,42,0,9,38
10,Success,42,38,7,13,29
10,Success,51,34,5,10,41
10,Success,49,38,1,12,37
10,Success,54,28,3,15,39
10,Success,37,43,0,15,22
10,Success,46,39,4,11,35
10,Success,55,34,2,9,46
10,Success,40,35,10,15,25
10,Success,45,37,5,13,32
10,Success,46,36,0,9,37
10,Success,43,40,0,14,29
10,Success,52,32,2,14,38
10,Success,48,30,7,15,33
10,Success,51,36,4,9,42
10,Success,42,46,1,11,31
10,Success,39,40,0,17,22
10,Success,49,33,3,15,34
10,Success,53,32,0,13,40
10,Success,47,37,2,14,33
10,Success,51,30,0,19,32
10,Success,44,40,0,11,33
10,Success,51,37,1,11,40
10,Success,51,34,0,10,41
10,Success,47,42,0,9,38
10,Success,49,36,6,9,40
10,Success,47,35,5,13,34
10,Success,43,39,0,14,29
10,Success,44,39,0,10,34
10,Success,52,39,0,9,43
10,Success,50,39,0,10,40
10,Success,52,33,0,14,38
10,Success,50,29,0,13,37
10,Success,47,38,2,13,34
10,Success,49,35,0,15,34
10,Success,43,43,3,11,32
10,Success,48,34,0,10,38
10,Success,50,34,0,12,38
10,Success,45,34,7,14,31
10,Success,55,33,1,11,44
10,Success,48,36,0,13,35
10,Success,49,35,5,11,38
10,Success,49,33,7,11,38
10,Success,54,34,4,8,46
10,Success,51,41,1,7,44
10,Success,48,36,0,15,33
10,Success,47,28,0,14,33
10,Success,42,34,0,17,25
10,Success,44,34,2,20,24
10,Success,50,38,0,9,41
10,Success,47,33,0,15,32
10,Success,51,35,3,11,40
10,Success,46,43,0,11,35
10,Success,42,41,0,16,26
10,Success,43,33,9,15,28
10,Success,48,38,0,13,35
10,Success,41,36,7,16,25
10,Success,47,34,9,10,37
10,Success,50,29,5,16,34
10,Success,52,27,11,10,42
10,Success,52,35,0,10,42
10,Success,47,39,0,13,34
10,Success,53,27,0,14,39
10,Success,39,31,0,16,23
10,Success,52,26,5,17,35
10,Success,51,31,0,8,43
10,Success,41,36,8,15,26
10,Success,42,40,0,12,30
10,Success,54,25,0,14,40
10,Success,45,34,0,10,35
10,Success,51,33,0,6,45
10,Success,54,31,0,8,46
10,Success,43,38,0,13,30
10,Success,50,39,0,3,47
10,Success,46,35,0,12,34
10,Success,53,35,0,12,41
10,Success,47,36,0,10,37
10,Success,46,41,0,13,33
10,Success,48,38,0,14,34
10,Success,54,31,5,10,44
10,Success,53,32,2,13,40
10,Success,49,41,1,9,40
10,Success,48,38,0,11,37
10,Success,31,45,0,18,13
10,Success,49,33,7,11,38
10,Success,52,36,2,10,42
10,Success,49,30,0,14,35
10,Success,49,40,4,7,42
10,Success,48,39,1,12,36
10,Success,51,41,2,6,45
10,Success,46,30,3,21,25
10,Success,50,34,0,16,34
10,Success,46,31,0,15,31
10,Success,53,29,6,12,41
10,Success,55,26,7,12,43
10,Success,47,39,0,14,33
10,Success,50,38,0,10,40
10,Success,50,27,11,12,38
10,Success,53,35,1,11,42
10,Success,46,39,3,12,34
10,Success,53,37,2,8,45
10,Success,48,33,0,13,35
10,Success,50,38,5,7,43
10,Success,47,36,5,12,35
10,Success,44,34,0,14,30
10,Success,47,38,3,12,35
10,Success,47,37,1,15,32
10,Success,53,28,6,13,40
10,Success,50,41,0,9,41
10,Success,47,34,0,12,35
10,Success,50,37,0,8,42
10,Success,50,34,0,15,35
10,Success,46,35,0,13,33
10,Success,52,38,3,7,45
10,Success,41,42,8,9,32
10,Success,51,35,4,10,41
10,Success,40,31,0,16,24
10,Success,43,36,5,16,27
10,Success,48,40,0,12,36
10,Success,50,32,2,16,34
10,Success,48,36,0,11,37
10,Success,51,29,9,11,40
10,Success,45,35,0,16,29
10,Success,50,34,4,12,38
10,Success,40,45,1,14,26
10,Success,45,36,5,14,31
10,Success,47,39,0,13,34
10,Success,48,36,0,11,37
10,Success,55,32,0,10,45
10,Success,53,35,0,12,41
10,Success,47,34,0,18,29
10,Success,38,38,0,17,21
10,Success,54,33,1,12,42
10,Success,53,26,10,11,42
10,Success,46,38,0,12,34
10,Success,55,29,5,11,44
10,Success,49,33,0,17,32
10,Success,46,28,9,17,29
10,Success,53,38,3,6,47
10,Success,44,29,11,16,28
10,Success,48,33,0,14,34
10,Success,45,32,11,12,33
10,Success,48,34,4,14,34
10,Success,51,30,7,12,39
10,Success,43,36,6,15,28
10,Success,41,45,4,10,31
10,Success,56,35,0,8,48
10,Success,46,30,9,15,31
10,Success,46,30,0,17,29
10,Success,53,28,10,9,44
10,Success,47,37,0,15,32
10,Success,48,39,2,11,37
10,Success,55,32,4,9,46
10,Success,52,34,2,12,40
10,Success,37,44,0,16,21
10,Success,46,40,1,13,33
10,Success,46,36,2,16,30
10,Success,50,40,0,9,41
10,Success,50,37,0,9,41
10,Success,52,34,0,12,40
10,Success,43,38,0,16,27
10,Success,45,32,11,12,33
10,Success,48,37,0,13,35
10,Success,41,40,0,12,29
10,Success,44,36,0,16,28
10,Success,46,40,0,12,34
10,Success,49,40,1,10,39
10,Success,49,36,0,9,40
10,Success,52,35,2,11,41
10,Success,59,30,0,9,50
10,Success,35,51,3,11,24
10,Success,48,35,0,13,35
10,Success,45,39,7,9,36
10,Success,58,25,3,14,44
10,Success,48,31,10,11,37
10,Success,51,36,0,12,39
10,Success,50,42,0,8,42
10,Success,44,36,5,15,29
10,Success,46,31,0,23,23
10,Success,47,27,11,15,32
10,Success,56,28,0,7,49
10,Success,56,26,0,13,43
10,Success,41,33,7,19,22
10,Success,40,44,2,14,26
10,Success,52,32,0,9,43
10,Success,44,32,12,12,32
10,Success,56,32,1,11,45
10,Success,47,36,0,16,31
10,Success,46,38,2,14,32
10,Success,48,28,9,15,33
10,Success,43,34,0,19,24
10,Success,53,33,0,10,43
10,Success,50,36,5,9,41
10,Success,51,35,3,11,40
10,Success,52,33,0,11,41
10,Success,52,38,0,8,44
10,Success,41,36,0,18,23
10,Success,51,37,0,12,39
10,Success,49,31,0,12,37
10,Success,50,41,2,7,43
10,Success,51,35,3,11,40
10,Success,50,36,4,10,40
10,Success,41,36,0,22,19
10,Success,45,38,3,14,31
10,Success,50,36,5,9,41
10,Success,46,42,0,11,35
10,Success,41,43,6,10,31
10,Success,40,36,0,17,23
10,Success,51,36,0,12,39
10,Success,40,40,5,15,25
10,Success,49,30,3,18,31
10,Success,53,31,0,9,44
10,Success,45,37,0,17,28
10,Success,50,37,0,9,41
10,Success,49,34,3,14,35
10,Success,49,39,2,10,39
10,Success,49,37,2,12,37
10,Success,54,33,0,8,46
10,Success,53,30,0,14,39
10,Success,48,41,1,10,38
10,Success,54,34,0,10,44
10,Success,49,24,7,20,29
10,Success,40,35,10,15,25
10,Success,45,37,0,17,28
10,Success,49,40,5,6,43
10,Success,44,35,0,15,29
10,Success,42,40,2,16,26
10,Success,42,42,0,13,29
10,Success,51,36,4,9,42
10,Success,48,37,0,11,37
10,Success,58,27,0,13,45
10,Success,38,41,0,10,28
10,Success,52,37,0,10,42
10,Success,44,35,0,11,33
10,Success,48,35,0,16,32
10,Success,43,39,2,16,27
10,Success,45,37,4,14,31
10,Success,48,35,0,14,34
10,Success,46,42,0,8,38
10,Success,46,39,0,13,33
10,Success,44,41,0,13,31
10,Success,45,37,9,9,36
10,Success,40,40,0,14,26
10,Success,37,42,7,14,23
10,Success,47,38,5,10,37
10,Success,49,41,0,10,39
10,Success,50,35,3,12,38
10,Success,45,40,1,14,31
10,Success,44,37,0,8,36
10,Success,49,40,0,8,41
10,Success,49,37,3,11,38
10,Success,46,40,2,12,34
10,Success,59,28,0,13,46
10,Success,54,33,0,9,45
10,Success,44,34,0,16,28
10,Success,51,33,0,11,40
10,Success,45,40,2,13,32
10,Success,46,40,5,9,37
10,Success,43,34,2,21,22
10,Success,47,37,0,14,33
10,Success,47,32,0,12,35
10,Success,45,37,2,16,29
10,Success,44,34,11,11,33
10,Success,50,32,0,9,41
10,Success,44,43,0,9,35
10,Success,48,37,4,11,37
10,Success,59,31,1,9,50
10,Success,46,46,0,8,38
10,Success,55,36,0,6,49
10,Success,60,30,3,7,53
10,Success,51,29,4,16,35
10,Success,49,34,2,15,34
10,Success,51,37,0,11,40
10,Success,45,36,0,16,29
10,Success,44,37,0,19,25
10,Success,53,27,11,9,44
10,Success,47,30,6,17,30
10,Success,56,33,0,11,45
10,Success,41,44,0,12,29
10,Success,53,36,3,8,45
10,Success,47,40,0,13,34
10,Success,49,34,0,15,34
10,Success,38,34,10,18,20
10,Success,39,42,7,12,27
10,Success,56,35,2,7,49
10,Success,47,36,0,13,34
10,Success,55,23,5,17,38
10,Success,43,37,0,16,27
10,Success,58,30,0,11,47
10,Success,52,36,5,7,45
10,Success,47,35,0,18,29
10,Success,42,41,6,11,31
10,Success,47,26,0,14,33
10,Success,46,42,1,11,35
10,Success,33,47,7,13,20
10,Success,51,34,0,12,39
10,Success,47,42,0,5,42
10,Success,50,39,2,9,41
10,Success,42,42,4,12,30
10,Success,51,36,0,12,39
10,Success,48,36,5,11,37
10,Success,51,32,8,9,42
10,Success,54,35,0,10,44
10,Success,60,30,0,9,51
10,Success,43,36,0,18,25
10,Success,46,30,3,21,25
10,Success,45,38,2,15,30
10,Success,50,39,3,8,42
10,Success,53,37,0,10,43
10,Success,48,37,1,14,34
10,Success,48,37,0,9,39
10,Success,45,38,0,14,31
10,Success,52,32,8,8,44
10,Success,52,35,0,10,42
10,Success,44,41,2,13,31
10,Success,55,32,0,10,45
10,Success,57,32,0,11,46
10,Success,50,32,4,14,36
10,Success,46,33,0,9,37
10,Success,39,39,6,16,23
10,Success,48,35,8,9,39
10,Success,46,38,1,15,31
10,Success,41,33,0,13,28
10,Success,55,32,1,12,43
10,Success,48,35,0,14,34
10,Success,50,38,0,11,39
10,Success,52,35,0,6,46
10,Success,41,38,3,18,23
10,Success,51,34,0,14,37
10,Success,47,33,0,14,33
10,Success,50,35,2,13,37
10,Success,55,23,9,13,42
10,Success,45,36,0,11,34
10,Success,49,37,0,11,38
10,Success,43,43,0,14,29
10,Success,47,41,0,11,36
10,Success,44,43,0,11,33
10,Success,53,34,0,12,41
10,Success,51,32,0,11,40
10,Success,46,31,0,15,31
10,Success,46,38,0,13,33
10,Success,43,41,0,13,30
10,Success,52,35,0,11,41
10,Success,50,34,0,14,36
10,Success,45,41,3,11,34
10,Success,44,44,3,9,35
10,Success,51,36,1,12,39
10,Success,47,37,4,12,35
10,Success,38,46,0,14,24
10,Success,44,38,0,12,32
10,Success,47,40,0,13,34
10,Success,37,35,9,19,18
10,Success,51,35,4,10,41
10,Success,47,37,2,14,33
10,Success,56,32,0,10,46
10,Success,40,34,11,15,25
10,Success,49,34,3,14,35
10,Success,51,42,0,4,47
10,Success,49,32,0,15,34
10,Success,44,36,6,14,30
10,Success,45,43,2,10,35
10,Success,55,33,0,9,46
10,Success,43,30,0,19,24
10,Success,54,28,1,17,37
10,Success,49,32,0,12,37
10,Success,46,38,0,12,34
10,Success,45,31,0,16,29
10,Success,45,39,0,13,32
10,Success,49,38,3,10,39
10,Success,44,33,0,15,29
10,Success,47,36,0,17,30
10,Success,50,40,1,9,41
10,Success,44,37,2,17,27
10,Success,54,29,2,15,39
10,Success,48,40,0,12,36
10,Success,51,41,2,6,45
10,Success,55,29,5,11,44
10,Success,58,34,1,7,51
10,Success,50,33,3,14,36
10,Success,49,35,4,12,37
10,Success,51,31,1,17,34
10,Success,44,37,3,16,28
10,Success,53,37,1,9,44
10,Success,49,33,9,9,40
10,Success,56,26,3,15,41
10,Success,45,34,2,19,26
10,Success,49,35,0,11,38
10,Success,41,34,0,18,23
10,Success,48,27,0,17,31
10,Success,46,37,0,12,34
10,Success,42,32,0,19,23
10,Success,52,37,0,9,43
10,Success,47,41,0,7,40
10,Success,39,48,0,11,28
10,Success,51,34,3,12,39
10,Success,43,29,0,20,23
10,Success,45,42,1,12,33
10,Success,42,37,0,14,28
10,Success,58,32,0,9,49
10,Success,57,30,3,10,47
10,Success,41,42,0,13,28
10,Success,43,34,5,18,25
10,Success,53,28,9,10,43
10,Success,43,30,0,21,22
10,Success,51,33,0,11,40
10,Success,52,35,0,8,44
10,Success,47,36,0,17,30
10,Success,45,34,0,10,35
10,Success,45,43,0,10,35
10,Success,36,40,0,13,23
10,Success,43,39,5,13,30
10,Success,45,36,0,9,36
10,Success,34,31,0,17,17
10,Success,50,35,0,5,45
10,Success,58,29,2,11,47
10,Success,42,42,0,7,35
10,Success,47,34,5,14,33
10,Success,54,38,0,8,46
10,Success,53,33,5,9,44
10,Success,47,39,2,12,35
10,Success,43,30,0,17,26
10,Success,41,46,2,11,30
10,Success,59,23,4,14,45
10,Success,52,37,0,10,42
10,Success,45,38,1,16,29
10,Success,52,30,8,10,42
10,Success,52,38,0,10,42
10,Success,42,36,0,16,26
10,Success,50,35,0,10,40
10,Success,46,39,0,12,34
10,Success,45,31,0,19,26
10,Success,45,39,0,10,35
10,Success,50,38,1,11,39
10,Success,50,34,3,13,37
10,Success,45,38,1,16,29
10,Success,52,30,4,14,38
10,Success,54,36,0,7,47
10,Success,45,34,6,15,30
10,Success,46,32,0,12,34
10,Success,51,36,0,10,41
10,Success,37,41,3,19,18
10,Success,46,43,2,9,37
10,Success,52,35,2,11,41
10,Success,39,39,0,13,26
10,Success,46,39,1,14,32
10,Success,58,30,1,11,47
10,Success,46,42,0,10,36
10,Success,54,31,0,14,40
10,Success,48,33,7,12,36
10,Success,45,48,3,4,41
10,Success,43,36,0,15,28
10,Success,47,38,0,15,32
10,Success,50,32,0,15,35
10,Success,50,33,0,12,38
10,Success,42,41,2,15,27
10,Success,48,31,9,12,36
10,Success,44,38,7,11,33
10,Success,53,25,8,14,39
10,Success,52,27,0,18,34
10,Success,46,39,0,14,32
10,Success,48,31,0,17,31
10,Success,47,33,0,15,32
10,Success,40,42,3,15,25
10,Success,45,38,4,13,32
10,Success,54,36,0,7,47
10,Success,56,31,1,12,44
10,Success,44,31,0,14,30
10,Success,46,31,7,16,30
10,Success,53,37,2,8,45
10,Success,48,34,3,15,33
10,Success,43,42,0,14,29
10,Success,48,37,4,11,37
10,Success,48,39,0,13,35
10,Success,39,40,7,14,25
10,Success,54,35,6,5,49
10,Success,47,31,0,15,32
10,Success,39,38,7,16,23
10,Success,48,42,0,10,38
10,Success,52,36,0,12,40
10,Success,50,30,0,19,31
10,Success,51,37,0,10,41
10,Success,46,37,0,13,33
10,Success,50,34,4,12,38
10,Success,57,31,0,9,48
10,Success,56,26,7,11,45
10,Success,49,30,11,10,39
10,Success,34,41,0,16,18
10,Success,49,38,0,11,38
10,Success,50,35,2,13,37
10,Success,52,27,12,9,43
10,Success,47,36,0,13,34
10,Success,50,37,2,11,39
10,Success,49,41,3,7,42
10,Success,43,38,5,14,29
10,Success,52,35,4,9,43
10,Success,50,31,0,11,39
10,Success,44,45,4,7,37
10,Success,40,37,0,19,21
10,Success,47,37,0,13,34
10,Success,50,36,2,12,38
10,Success,50,41,0,9,41
10,Success,52,34,4,10,42
10,Success,48,36,0,12,36
10,Success,45,34,0,16,29
10,Success,45,43,1,11,34
10,Success,58,30,4,8,50
10,Success,52,32,5,11,41
10,Success,54,27,6,13,41
10,Success,50,33,4,13,37
10,Success,54,35,2,9,45
10,Success,48,40,0,12,36
10,Success,45,36,0,12,33
10,Success,52,34,3,11,41
10,Success,48,34,7,11,37
10,Success,44,43,1,12,32
10,Success,50,35,3,12,38
10,Success,48,42,0,7,41
10,Success,52,32,6,10,42
10,Success,44,42,0,10,34
10,Success,50,32,0,12,38
10,Success,47,34,0,18,29
10,Success,54,37,0,9,45
10,Success,48,36,4,12,36
10,Success,46,36,4,14,32
10,Success,40,43,0,14,26
10,Success,50,34,2,14,36
10,Success,50,35,3,12,38
10,Success,45,34,0,15,30
10,Success,46,35,7,12,34
10,Success,50,35,3,12,38
10,Success,51,28,5,16,35
10,Success,47,35,5,13,34
10,Success,42,40,7,11,31
10,Success,51,33,4,12,39
10,Success,49,34,0,16,33
10,Success,47,38,0,15,32
10,Success,51,37,0,12,39
10,Success,49,33,0,17,32
10,Success,59,32,0,7,52
10,Success,57,36,4,3,54
10,Success,49,45,1,5,44
10,Success,32,41,0,17,15
10,Success,49,34,4,13,36
10,Success,53,39,0,7,46
10,Success,52,36,2,10,42
10,Success,51,34,0,13,38
10,Success,46,42,0,12,34
10,Success,53,30,4,13,40
10,Success,43,35,0,17,26
10,Success,56,27,0,12,44
10,Success,44,37,5,14,30
10,Success,53,32,0,11,42
10,Success,48,39,4,9,39
10,Success,46,30,9,15,31
10,Success,48,31,0,12,36
10,Success,45,36,6,13,32
10,Success,54,34,2,10,44
10,Success,54,36,0,10,44
10,Success,40,39,0,19,21
10,Success,42,29,12,17,25
10,Success,54,36,3,7,47
10,Success,51,33,6,10,41
10,Success,41,45,3,11,30
10,Success,37,39,0,15,22
10,Success,52,36,3,9,43
10,Success,38,37,0,13,25
10,Success,48,35,3,14,34
10,Success,47,38,0,10,37
10,Success,49,36,0,13,36
10,Success,54,38,2,6,48
10,Success,49,33,0,14,35
10,Success,42,40,4,14,28
10,Success,51,33,0,15,36
10,Success,58,28,0,13,45
10,Success,50,40,0,10,40
10,Success,47,39,0,11,36
10,Success,46,31,5,18,28
10,Success,52,28,0,14,38
10,Success,50,27,10,13,37
10,Success,48,38,0,14,34
10,Success,52,28,0,13,39
10,Success,53,37,2,8,45
10,Success,47,26,0,14,33
10,Success,53,35,0,10,43
10,Success,41,32,0,19,22
10,Success,47,40,1,12,35
10,Success,48,36,2,14,34
10,Success,48,36,0,12,36
10,Success,47,37,5,11,36
10,Success,50,34,8,8,42
10,Success,53,25,0,14,39
10,Success,43,37,0,20,23
10,Success,55,34,3,8,47
10,Success,52,36,0,10,42
10,Success,45,38,0,14,31
10,Success,49,41,0,9,40
10,Success,45,36,0,14,31
10,Success,47,40,0,12,35
10,Success,50,34,0,13,37
10,Success,52,34,1,13,39
10,Success,41,43,10,6,35
10,Success,47,32,0,14,33
10,Success,45,38,0,14,31
10,Success,47,35,9,9,38
10,Success,56,30,2,12,44
10,Success,46,36,0,12,34
10,Success,46,31,11,12,34
10,Success,48,35,0,15,33
10,Success,46,39,3,12,34
10,Success,45,39,0,13,32
10,Success,51,29,0,13,38
10,Success,43,35,7,15,28
10,Success,53,42,0,5,48
10,Success,57,30,0,7,50
10,Success,48,40,0,12,36
10,Success,44,33,0,18,26
10,Success,42,35,0,11,31
10,Success,47,35,7,11,36
10,Success,48,31,0,14,34
10,Success,48,44,1,7,41
10,Success,52,31,0,17,35
10,Success,53,32,2,13,40
10,Success,46,34,2,18,28
10,Success,55,31,1,13,42
10,Success,54,35,0,6,48
10,Success,52,34,6,8,44
10,Success,48,40,0,8,40
10,Success,41,38,0,13,28
10,Success,46,39,4,11,35
10,Success,43,32,0,15,28
10,Success,51,36,0,12,39
10,Success,48,33,0,18,30
10,Success,47,39,0,14,33
10,Success,52,33,1,14,38
10,Success,38,38,8,16,22
10,Success,46,35,8,11,35
10,Success,48,29,0,20,28
10,Success,45,39,3,13,32
10,Success,43,38,4,15,28
10,Success,53,34,2,11,42
10,Success,48,30,0,13,35
10,Success,50,30,1,19,31
10,Success,39,41,0,17,22
10,Success,49,32,4,15,34
10,Success,47,38,0,13,34
10,Success,47,36,1,16,31
10,Success,51,36,1,12,39
10,Success,51,33,0,14,37
10,Success,46,39,4,11,35
10,Success,50,37,1,12,38
10,Success,56,28,0,16,40
10,Success,48,36,0,16,32
10,Success,46,41,0,12,34
10,Success,51,32,0,16,35
10,Success,50,31,6,13,37
10,Success,54,29,0,14,40
10,Success,55,32,3,10,45
10,Success,44,26,0,17,27
10,Success,55,34,0,6,49
10,Success,49,31,0,16,33
10,Success,47,45,0,8,39
10,Success,50,36,0,12,38
10,Success,43,32,10,15,28
10,Success,44,31,0,16,28
10,Success,49,40,0,11,38
10,Success,48,33,0,10,38
10,Success,54,35,0,11,43
10,Success,48,34,0,16,32
10,Success,52,36,4,8,44
10,Success,51,42,0,6,45
10,Success,46,29,0,18,28
10,Success,52,34,0,13,39
10,Success,49,36,1,14,35
10,Success,53,37,0,10,43
10,Success,49,30,9,12,37
10,Success,42,32,9,17,25
10,Success,48,37,0,7,41
10,Success,43,40,7,10,33
10,Success,54,29,6,11,43
10,Success,50,35,0,15,35
10,Success,43,36,0,20,23
10,Success,47,35,5,13,34
10,Success,47,36,0,15,32
10,Success,52,34,5,9,43
10,Success,52,36,0,12,40
10,Success,55,31,3,11,44
10,Success,44,38,0,12,32
10,Success,47,30,10,13,34
10,Success,48,32,0,13,35
10,Success,48,31,0,13,35
10,Success,51,33,0,11,40
10,Success,48,40,3,9,39
10,Success,52,37,0,8,44
10,Success,48,31,0,17,31
10,Success,54,26,5,15,39
10,Success,47,38,0,7,40
10,Success,39,41,0,19,20
10,Success,45,40,0,14,31
10,Success,56,27,1,16,40
10,Success,47,33,0,13,34
10,Success,47,36,3,14,33
10,Success,43,34,11,12,31
10,Success,42,34,0,18,24
10,Success,34,37,0,17,17
10,Success,52,37,0,5,47
10,Success,45,35,7,13,32
10,Success,48,34,0,14,34
10,Success,53,37,0,9,44
10,Success,45,38,0,14,31
10,Success,47,38,0,10,37
10,Success,55,31,1,13,42
10,Success,49,35,6,10,39
10,Success,51,36,1,12,39
10,Success,50,25,10,15,35
10,Success,44,32,0,17,27
10,Success,46,36,0,17,29
10,Success,48,38,1,13,35
10,Success,51,34,3,12,39
10,Success,40,38,6,16,24
10,Success,47,31,2,20,27
10,Success,43,35,11,11,32
10,Success,54,36,1,9,45
10,Success,38,42,0,14,24
10,Success,49,32,5,14,35
10,Success,52,34,0,9,43
10,Success,48,34,0,17,31
10,Success,44,38,3,15,29
10,Success,47,35,4,14,33
10,Success,45,38,0,11,34
10,Success,49,26,14,11,38
10,Success,53,41,0,6,47
10,Success,45,35,0,20,25
10,Success,48,41,0,8,40
10,Success,51,37,1,11,40
10,Success,42,38,0,15,27
10,Success,49,33,6,12,37
10,Success,47,30,8,15,32
10,Success,36,43,0,19,17
10,Success,45,38,0,11,34
10,Success,41,38,7,14,27
10,Success,47,36,0,15,32
10,Success,45,41,0,8,37
10,Success,47,33,0,10,37
10,Success,44,38,0,11,33
10,Success,54,23,0,12,42
10,Success,48,36,4,12,36
10,Success,44,35,0,16,28
10,Success,48,40,0,11,37
10,Success,48,38,0,8,40
10,Success,52,34,0,11,41
10,Success,52,33,3,12,40
10,Success,47,30,5,18,29
10,Success,42,42,2,14,28
10,Success,47,40,0,12,35
10,Success,42,40,0,14,28
10,Success,54,33,0,13,41
10,Success,49,37,0,10,39
10,Success,58,29,0,13,45
10,Success,50,35,0,11,39
10,Success,48,33,8,11,37
10,Success,46,37,1,16,30
10,Success,44,40,1,15,29
10,Success,37,48,5,10,27
10,Success,46,37,0,11,35
10,Success,49,29,6,16,33
10,Success,51,37,0,9,42
10,Success,47,34,0,17,30
10,Success,48,41,0,9,39
10,Success,44,39,0,9,35
10,Success,48,34,0,17,31
10,Success,50,32,5,13,37
10,Success,52,33,3,12,40
10,Success,45,43,2,10,35
10,Success,41,40,0,17,24
10,Success,53,28,4,15,38
10,Success,38,32,11,19,19
10,Success,46,34,0,15,31
10,Success,47,36,0,14,33
10,Success,41,27,12,20,21
10,Success,56,31,0,9,47
10,Success,51,34,0,15,36
10,Success,51,37,0,10,41
10,Success,50,41,0,9,41
10,Success,56,34,0,8,48
10,Success,45,42,0,9,36
10,Success,49,31,10,10,39
10,Success,48,32,0,16,32
10,Success,53,32,5,10,43
10,Success,44,41,0,12,32
10,Success,43,31,0,14,29
10,Success,56,33,2,9,47
10,Success,45,28,0,18,27
10,Success,44,42,0,12,32
10,Success,41,39,0,12,29
10,Success,52,34,0,12,40
10,Success,42,33,0,20,22
10,Success,45,35,3,17,28
10,Success,49,35,0,12,37
10,Success,51,37,5,7,44
10,Success,50,37,0,11,39
10,Success,48,32,0,15,33
10,Success,46,38,0,16,30
10,Success,42,41,0,17,25
10,Success,53,33,1,13,40
10,Success,62,30,0,8,54
10,Success,48,34,6,12,36
10,Success,51,33,4,12,39
10,Success,50,34,8,8,42
10,Success,44,39,3,14,30
10,Success,44,40,0,14,30
10,Success,53,30,4,13,40
10,Success,50,36,2,12,38
10,Success,50,39,0,11,39
10,Success,44,35,5,16,28
10,Success,54,35,7,4,50
10,Success,46,43,1,10,36
10,Success,50,33,2,15,35
10,Success,47,36,0,10,37
10,Success,58,28,8,6,52
10,Success,36,38,0,17,19
10,Success,53,35,1,11,42
10,Success,57,34,1,8,49
10,Success,54,32,2,12,42
10,Success,41,40,5,14,27
10,Success,52,39,1,8,44
10,Success,49,40,1,10,39
10,Success,54,30,4,12,42
10,Success,47,37,0,14,33
10,Success,48,35,2,15,33
10,Success,45,42,2,11,34
10,Success,48,33,0,11,37
10,Success,52,31,0,14,38
10,Success,52,32,2,14,38
10,Success,46,39,4,11,35
10,Success,38,35,6,21,17
10,Success,53,33,2,12,41
10,Success,47,31,0,15,32
10,Success,48,41,0,11,37
10,Success,49,41,2,8,41
10,Success,49,34,2,15,34
10,Success,50,29,0,12,38
10,Success,51,36,0,13,38
10,Success,44,39,2,15,29
10,Success,45,37,5,13,32
10,Success,47,36,3,14,33
10,Success,44,31,13,12,32
10,Success,42,43,0,14,28
10,Success,42,40,3,15,27
10,Success,46,36,0,17,29
10,Success,45,38,9,8,37
10,Success,46,39,0,13,33
10,Success,44,38,3,15,29
10,Success,45,31,0,21,24
10,Success,50,33,0,17,33
10,Success,47,34,4,15,32
10,Success,49,30,9,12,37
10,Success,43,36,0,21,22
10,Success,48,30,12,10,38
10,Success,49,33,0,10,39
10,Success,48,39,0,11,37
10,Success,47,33,0,15,32
10,Success,36,36,0,21,15
10,Success,41,45,0,12,29
10,Success,47,40,0,9,38
10,Success,57,32,0,9,48
10,Success,44,41,0,12,32
10,Success,41,40,0,18,23
10,Success,46,33,0,12,34
10,Success,45,35,3,17,28
10,Success,48,32,7,13,35
10,Success,50,41,0,9,41
10,Success,49,39,2,10,39
10,Success,52,34,4,10,42
10,Success,41,47,2,10,31
10,Success,46,39,4,11,35
10,Success,44,37,0,10,34
10,Success,40,42,0,15,25
10,Success,46,23,11,20,26
10,Success,56,25,5,14,42
10,Success,46,36,0,9,37
10,Success,49,37,0,12,37
10,Success,51,33,6,10,41
10,Success,46,36,0,9,37
10,Success,50,25,0,19,31
10,Success,40,32,0,10,30
10,Success,51,37,6,6,45
10,Success,38,44,6,12,26
10,Success,45,37,2,16,29
10,Success,47,39,0,9,38
10,Success,49,32,3,16,33
10,Success,51,34,0,15,36
10,Success,43,41,1,15,28
10,Success,48,40,0,12,36
10,Success,43,32,5,20,23
10,Success,48,32,4,16,32
10,Success,51,28,0,17,34
10,Success,56,23,4,17,39
10,Success,48,39,0,13,35
10,Success,44,32,0,19,25
10,Success,53,36,5,6,47
10,Success,51,32,2,15,36
10,Success,45,35,4,16,29
10,Success,45,41,1,13,32
10,Success,51,32,0,13,38
10,Success,46,42,0,7,39
10,Success,48,35,1,16,32
10,Success,45,42,0,13,32
10,Success,49,36,0,11,38
10,Success,52,33,4,11,41
10,Success,48,40,0,12,36
10,Success,39,39,4,18,21
10,Success,58,29,0,13,45
10,Success,55,34,0,7,48
10,Success,53,40,1,6,47
10,Success,51,29,0,16,35
10,Success,48,35,5,12,36
10,Success,53,37,0,9,44
10,Success,47,41,0,12,35
10,Success,46,34,0,14,32
10,Success,49,42,0,8,41
10,Success,38,35,12,15,23
10,Success,53,31,8,8,45
10,Success,48,46,0,6,42
10,Success,45,36,3,16,29
10,Success,44,33,0,19,25
10,Success,41,38,0,17,24
10,Success,49,31,0,18,31
10,Success,51,37,3,9,42
10,Success,47,37,0,13,34
10,Success,40,26,0,18,22
10,Success,54,36,1,9,45
10,Success,44,37,6,13,31
10,Success,48,27,0,20,28
10,Success,51,34,3,12,39
10,Success,47,34,0,14,33
10,Success,52,28,0,14,38
10,Success,50,34,7,9,41
10,Success,49,29,0,18,31
10,Success,44,39,1,16,28
10,Success,45,35,0,15,30
10,Success,55,33,1,11,44
10,Success,48,34,0,11,37
10,Success,47,35,0,14,33
10,Success,54,30,2,14,40
10,Success,56,32,1,11,45
10,Success,48,35,0,9,39
10,Success,52,34,0,12,40
10,Success,52,35,2,11,41
10,Success,52,28,0,11,41
10,Success,47,35,1,17,30
10,Success,55,30,3,12,43
10,Success,53,30,0,11,42
10,Success,46,34,5,15,31
10,Success,51,37,1,11,40
10,Success,43,39,5,13,30
10,Success,50,38,2,10,40
10,Success,40,38,5,17,23
10,Success,44,31,0,15,29
10,Success,48,38,0,14,34
10,Success,47,40,1,12,35
10,Success,51,32,0,15,36
10,Success,43,35,0,15,28
10,Success,47,29,0,21,26
10,Success,45,40,1,14,31
10,Success,45,40,0,9,36
10,Success,45,34,0,12,33
10,Success,43,42,0,13,30
10,Success,47,40,0,12,35
10,Success,40,39,0,17,23
10,Success,49,34,3,14,35
10,Success,49,35,1,15,34
10,Success,42,46,0,11,31
10,Success,46,36,1,17,29
10,Success,45,38,0,11,34
10,Success,42,37,8,13,29
10,Success,44,40,0,12,32
10,Success,50,28,9,13,37
10,Success,42,42,0,16,26
10,Success,50,42,1,7,43
10,Success,49,38,0,12,37
10,Success,42,37,0,13,29
10,Success,50,36,0,14,36
10,Success,51,37,3,9,42
10,Success,52,30,3,15,37
10,Success,41,38,0,19,22
10,Success,49,33,8,10,39
10,Success,47,40,7,6,41
10,Success,44,37,9,10,34
10,Success,57,32,0,10,47
10,Success,45,32,8,15,30
10,Success,54,31,3,12,42
10,Success,41,35,10,14,27
10,Success,49,39,4,8,41
10,Success,49,43,0,8,41
10,Success,44,33,2,21,23
10,Success,51,34,1,14,37
10,Success,46,40,1,13,33
10,Success,47,39,0,13,34
10,Success,50,34,5,11,39
10,Success,36,44,0,18,18
10,Success,44,37,0,15,29
10,Success,47,39,0,10,37
10,Success,41,40,5,14,27
10,Success,59,28,1,12,47
10,Success,49,40,1,10,39
10,Success,51,34,1,14,37
10,Success,46,37,0,15,31
10,Success,47,33,2,18,29
10,Success,48,35,1,16,32
10,Success,46,39,4,11,35
10,Success,50,32,5,13,37
10,Success,46,32,0,10,36
10,Success,57,26,0,12,45
10,Success,49,35,0,13,36
10,Success,42,36,8,14,28
10,Success,47,42,0,11,36
10,Success,38,38,5,19,19
10,Success,45,38,0,13,32
10,Success,42,37,10,11,31
10,Success,51,31,0,13,38
10,Success,46,36,2,16,30
10,Success,50,38,0,7,43
10,Success,44,44,0,12,32
10,Success,57,33,4,6,51
10,Success,54,32,0,13,41
10,Success,47,29,7,17,30
10,Success,52,42,0,5,47
10,Success,55,31,0,12,43
10,Success,53,27,0,14,39
10,Success,50,36,1,13,37
10,Success,57,36,1,6,51
10,Success,50,37,0,10,40
10,Success,42,40,7,11,31
10,Success,56,35,3,6,50
10,Success,51,36,0,13,38
10,Success,58,36,0,5,53
10,Success,45,33,0,18,27
10,Success,47,32,12,9,38
10,Success,46,42,0,11,35
10,Success,47,30,0,17,30
10,Success,50,38,0,7,43
10,Success,47,32,0,14,33
10,Success,45,40,0,13,32
10,Success,47,40,0,10,37
10,Success,51,37,0,5,46
10,Success,46,32,6,16,30
10,Success,44,43,0,11,33
10,Success,49,31,1,19,30
10,Success,43,30,0,13,30
10,Success,54,30,0,12,42
10,Success,46,31,6,17,29
10,Success,41,40,1,18,23
10,Success,57,33,0,7,50
10,Success,51,34,0,9,42
10,Success,46,45,0,8,38
10,Success,52,28,0,15,37
10,Success,43,39,3,15,28
10,Success,54,34,0,8,46
10,Success,53,31,0,13,40
10,Success,49,40,0,10,39
10,Success,46,39,0,12,34
10,Success,58,30,0,11,47
10,Success,50,33,3,14,36
10,Success,48,38,0,11,37
10,Success,60,28,0,11,49
10,Success,46,29,0,15,31
10,Success,46,43,2,9,37
10,Success,54,23,9,14,40
10,Success,53,34,1,12,41
10,Success,51,32,0,13,38
10,Success,53,38,0,9,44
10,Success,44,39,7,10,34
10,Success,51,31,6,12,39
10,Success,48,37,0,9,39
10,Success,44,39,5,12,32
10,Success,47,34,5,14,33
10,Success,48,37,4,11,37
10,Success,51,38,0,11,40
10,Success,51,32,0,10,41
10,Success,48,36,0,14,34
10,Success,53,27,0,14,39
10,Success,53,36,0,9,44
10,Success,48,31,0,15,33
10,Success,47,39,0,8,39
10,Success,40,35,0,15,25
10,Success,52,35,0,11,41
10,Success,56,26,5,13,43
10,Success,54,36,0,6,48
10,Success,50,39,3,8,42
10,Success,52,28,0,11,41
10,Success,45,32,0,19,26
10,Success,47,38,0,15,32
10,Success,54,34,1,11,43
10,Success,53,34,3,10,43
10,Success,46,42,0,12,34
10,Success,48,36,0,16,32
10,Success,46,31,4,19,27
10,Success,54,37,0,8,46
10,Success,50,30,5,15,35
10,Success,54,33,0,10,44
10,Success,55,33,0,8,47
10,Success,46,35,1,18,28
10,Success,45,44,0,8,37
10,Success,50,36,0,14,36
10,Success,49,39,5,7,42
10,Success,48,30,0,18,30
10,Success,46,41,0,12,34
10,Success,44,41,2,13,31
10,Success,39,34,13,14,25
10,Success,52,37,2,9,43
10,Success,49,36,0,13,36
10,Success,50,35,1,14,36
10,Success,53,20,9,18,35
10,Success,42,40,0,14,28
10,Success,56,31,2,11,45
10,Success,41,38,0,16,25
10,Success,47,35,1,17,30
10,Success,43,31,9,17,26
10,Success,48,29,10,13,35
10,Success,52,33,0,6,46
10,Success,52,28,7,13,39
10,Success,54,33,0,13,41
10,Success,49,42,2,7,42
10,Success,49,35,0,14,35
10,Success,43,38,0,15,28
10,Success,53,33,0,7,46
10,Success,51,36,0,9,42
10,Success,44,37,5,14,30
10,Success,42,45,4,9,33
10,Success,47,40,0,11,36
10,Success,52,37,0,9,43
10,Success,48,29,7,16,32
10,Success,47,36,7,10,37
10,Success,43,42,3,12,31
10,Success,45,36,0,18,27
10,Success,54,30,0,14,40
10,Success,53,34,0,9,44
10,Success,51,27,8,14,37
10,Success,49,35,0,11,38
10,Success,59,33,0,5,54
10,Success,51,38,0,11,40
10,Success,47,38,0,13,34
10,Success,52,38,0,9,43
10,Success,42,36,0,11,31
10,Success,46,36,2,16,30
10,Success,42,40,0,13,29
10,Success,47,35,0,13,34
10,Success,50,41,1,8,42
10,Success,45,37,6,12,33
10,Success,44,34,10,12,32
10,Success,47,38,6,9,38
10,Success,43,34,0,18,25
10,Success,53,31,0,13,40
10,Success,53,32,0,13,40
10,Success,48,36,5,11,37
10,Success,52,32,4,12,40
10,Success,60,30,2,8,52
10,Success,50,34,0,10,40
10,Success,53,37,1,9,44
10,Success,51,32,3,14,37
10,Success,48,34,0,15,33
10,Success,46,38,0,15,31
10,Success,51,34,0,13,38
10,Success,40,35,11,14,26
10,Success,47,42,0,10,37
10,Success,49,35,6,10,39
10,Success,46,39,0,13,33
10,Success,47,31,0,19,28
10,Success,53,38,0,6,47
10,Success,50,30,4,16,34
10,Success,49,38,0,11,38
10,Success,51,38,0,10,41
10,Success,44,43,1,12,32
10,Success,38,42,6,14,24
10,Success,46,40,0,10,36
10,Success,45,41,0,13,32
10,Success,44,42,3,11,33
10,Success,53,30,0,11,42
10,Success,51,33,3,13,38
10,Success,53,36,0,11,42
10,Success,54,33,2,11,43
10,Success,47,33,0,14,33
10,Success,48,40,0,9,39
10,Success,53,27,0,17,36
10,Success,52,29,2,17,35
10,Success,50,38,0,11,39
10,Success,52,32,3,13,39
10,Success,46,34,0,14,32
10,Success,44,33,9,14,30
10,Success,45,37,0,14,31
10,Success,43,33,0,15,28
10,Success,47,40,0,13,34
10,Success,42,38,4,16,26
10,Success,53,34,0,11,42
10,Success,50,37,1,12,38
10,Success,40,36,0,21,19
10,Success,52,33,0,8,44
10,Success,55,32,3,10,45
10,Success,49,34,0,12,37
10,Success,48,37,0,7,41
10,Success,41,37,0,17,24
10,Success,45,33,7,15,30
10,Success,49,37,2,12,37
10,Success,49,32,0,13,36
10,Success,45,32,0,10,35
10,Success,39,39,2,20,19
10,Success,47,34,8,11,36
10,Success,51,35,0,10,41
10,Success,44,40,0,14,30
10,Success,40,40,0,18,22
10,Success,39,38,7,16,23
10,Success,48,37,3,12,36
10,Success,51,35,0,13,38
10,Success,43,39,0,11,32
10,Success,46,30,11,13,33
10,Success,48,32,6,14,34
10,Success,42,38,0,12,30
10,Success,53,28,4,15,38
10,Success,36,47,3,14,22
10,Success,52,34,0,12,40
10,Success,49,38,2,11,38
10,Success,56,27,0,12,44
10,Success,50,31,0,11,39
10,Success,53,28,5,14,39
10,Success,53,30,3,14,39
10,Success,49,39,0,12,37
10,Success,52,31,5,12,40
10,Success,43,39,3,15,28
10,Success,38,43,0,16,22
10,Success,51,37,0,12,39
10,Success,47,33,12,8,39
10,Success,47,40,0,13,34
10,Success,39,42,0,15,24
10,Success,43,33,6,18,25
10,Success,43,36,0,16,27
10,Success,51,28,1,20,31
10,Success,48,34,2,16,32
10,Success,52,36,3,9,43
10,Success,44,33,8,15,29
10,Success,50,40,0,8,42
10,Success,49,42,0,8,41
10,Success,60,28,0,12,48
10,Success,50,34,2,14,36
10,Success,51,34,0,10,41
10,Success,50,35,0,11,39
10,Success,47,34,0,16,31
10,Success,53,36,2,9,44
10,Success,50,29,0,14,36
10,Success,47,32,8,13,34
10,Success,43,46,3,8,35
10,Success,46,41,4,9,37
10,Success,50,38,0,11,39
10,Success,44,38,3,15,29
10,Success,42,38,0,17,25
10,Success,43,41,0,14,29
10,Success,45,37,7,11,34
10,Success,50,31,4,15,35
10,Success,54,33,2,11,43
10,Success,44,40,0,10,34
10,Success,41,38,3,18,23
10,Success,49,34,1,16,33
10,Success,47,32,0,15,32
10,Success,45,36,6,13,32
10,Success,40,41,2,17,23
10,Success,48,29,0,16,32
10,Success,52,36,0,8,44
10,Success,37,30,0,15,22
10,Success,45,37,0,13,32
10,Success,42,40,5,13,29
10,Success,50,33,2,15,35
10,Success,50,38,1,11,39
10,Success,47,35,0,11,36
10,Success,42,35,9,14,28
10,Success,49,34,2,15,34
10,Success,46,36,0,18,28
10,Success,52,36,0,11,41
10,Success,51,32,4,13,38
10,Success,48,41,3,8,40
10,Success,42,37,0,13,29
10,Success,53,28,7,12,41
10,Success,49,40,0,11,38
10,Success,52,35,1,12,40
10,Success,50,39,1,10,40
10,Success,46,37,3,14,32
10,Success,49,30,5,16,33
10,Success,52,29,7,12,40
10,Success,42,31,9,18,24
10,Success,51,27,0,10,41
10,Success,47,27,0,18,29
10,Success,48,26,0,12,36
10,Success,49,30,0,18,31
10,Success,50,34,0,12,38
10,Success,50,32,0,11,39
10,Success,48,33,6,13,35
10,Success,53,35,2,10,43
10,Success,44,32,0,20,24
10,Success,37,42,0,20,17
10,Success,45,34,0,13,32
10,Success,47,33,0,19,28
10,Success,54,28,0,13,41
10,Success,47,36,6,11,36
10,Success,46,44,0,9,37
10,Success,46,41,0,11,35
10,Success,47,37,0,10,37
10,Success,50,29,7,14,36
10,Success,52,35,0,13,39
10,Success,53,34,0,12,41
10,Success,50,32,0,12,38
10,Success,50,32,0,9,41
10,Success,54,35,0,11,43
10,Success,51,32,5,12,39
10,Success,45,27,9,19,26
10,Success,45,39,0,15,30
10,Success,48,32,3,17,31
10,Success,50,31,5,14,36
10,Success,50,34,1,15,35
10,Success,50,37,1,12,38
10,Success,48,34,1,17,31
10,Success,51,37,3,9,42
10,Success,43,38,0,12,31
10,Success,39,40,4,17,22
10,Success,46,39,1,14,32
10,Success,43,34,0,13,30
10,Success,45,34,8,13,32
10,Success,46,37,4,13,33
10,Success,43,36,0,14,29
10,Success,47,37,0,13,34
10,Success,58,21,0,13,45
10,Success,51,29,0,16,35
10,Success,51,32,0,12,39
10,Success,45,30,12,13,32
10,Success,52,39,0,7,45
10,Success,47,43,1,9,38
10,Success,52,32,4,12,40
10,Success,49,31,8,12,37
10,Success,40,37,0,17,23
10,Success,50,31,0,13,37
10,Success,47,30,0,17,30
10,Success,43,33,7,17,26
10,Success,49,41,3,7,42
10,Success,54,32,4,10,44
10,Success,46,38,0,13,33
10,Success,54,34,1,11,43
10,Success,52,32,0,15,37
10,Success,44,29,0,20,24
10,Success,47,31,9,13,34
10,Success,51,33,0,13,38
10,Success,53,33,4,10,43
10,Success,48,39,2,11,37
10,Success,48,33,0,16,32
10,Success,49,37,0,12,37
10,Success,46,37,4,13,33
10,Success,49,39,0,12,37
10,Success,43,40,0,16,27
10,Success,47,30,0,14,33
10,Success,50,34,4,12,38
10,Success,54,32,0,10,44
10,Success,49,27,14,10,39
10,Success,55,35,2,8,47
10,Success,49,38,3,10,39
10,Success,40,40,0,8,32
10,Success,41,41,5,13,28
10,Success,53,32,6,9,44
10,Success,41,42,0,10,31
10,Success,43,34,9,14,29
10,Success,54,33,0,12,42
10,Success,54,39,0,7,47
10,Success,47,38,0,14,33
10,Success,49,34,0,11,38
10,Success,54,28,7,11,43
10,Success,56,31,0,11,45
10,Success,57,35,0,6,51
10,Success,51,33,4,12,39
10,Success,46,36,0,11,35
10,Success,53,38,0,9,44
10,Success,39,39,0,16,23
10,Success,43,48,0,8,35
10,Success,51,34,7,8,43
10,Success,43,35,18,4,39
10,Success,43,36,6,15,28
10,Success,49,27,12,12,37
10,Success,49,32,2,17,32
10,Success,48,29,1,22,26
10,Success,45,35,3,17,28
10,Success,52,38,0,10,42
10,Success,41,42,2,15,26
10,Success,46,37,0,11,35
10,Success,51,37,0,9,42
10,Success,50,39,0,8,42
10,Success,45,37,4,14,31
10,Success,52,31,0,12,40
10,Success,46,36,0,14,32
10,Success,40,40,0,16,24
10,Success,57,30,1,12,45
10,Success,48,38,0,14,34
10,Success,52,39,0,9,43
10,Success,50,36,6,8,42
10,Success,53,40,0,7,46
10,Success,50,34,2,14,36
10,Success,40,40,0,12,28
10,Success,46,34,0,15,31
10,Success,47,43,0,9,38
10,Success,52,31,7,10,42
10,Success,47,40,0,13,34
10,Success,45,36,0,15,30
10,Success,50,29,6,15,35
10,Success,50,29,0,13,37
10,Success,47,39,0,9,38
10,Success,46,39,0,13,33
10,Success,53,37,2,8,45
10,Success,47,39,0,11,36
10,Success,40,37,12,11,29
10,Success,42,36,0,21,21
10,Success,37,35,0,16,21
10,Success,40,44,0,10,30
10,Success,43,37,2,18,25
10,Success,45,38,1,16,29
10,Success,45,37,5,13,32
10,Success,43,43,0,12,31
10,Success,42,32,0,16,26
10,Success,49,31,9,11,38
10,Success,45,35,11,9,36
10,Success,49,39,0,12,37
10,Success,51,31,1,17,34
10,Success,57,30,3,10,47
10,Success,50,30,6,14,36
10,Success,54,30,0,16,38
10,Success,49,35,1,15,34
10,Success,46,34,5,15,31
10,Success,44,39,9,8,36
10,Success,55,31,1,13,42
10,Success,44,39,0,13,31
10,Success,50,39,0,10,40
10,Success,46,39,1,14,32
10,Success,46,35,0,14,32
10,Success,46,34,7,13,33
10,Success,50,37,3,10,40
10,Success,61,28,3,8,53
10,Success,49,35,0,15,34
10,Success,42,38,10,10,32
10,Success,44,40,7,9,35
10,Success,46,40,0,10,36
10,Success,49,41,0,9,40
10,Success,38,48,0,9,29
10,Success,46,40,0,11,35
10,Success,54,30,0,16,38
10,Success,43,31,9,17,26
10,Success,49,33,0,13,36
10,Success,51,32,2,15,36
10,Success,55,29,4,12,43
10,Success,52,37,0,4,48
10,Success,52,36,0,11,41
10,Success,45,38,2,15,30
10,Success,44,34,0,12,32
10,Success,42,40,0,14,28
10,Success,55,28,0,15,40
10,Success,49,42,0,5,44
10,Success,40,39,6,15,25
10,Success,49,35,3,13,36
10,Success,46,35,0,19,27
10,Success,53,35,1,11,42
10,Success,52,35,3,10,42
10,Success,44,34,0,19,25
10,Success,45,37,2,16,29
10,Success,44,41,0,14,30
10,Success,47,38,0,13,34
10,Success,54,30,3,13,41
10,Success,47,38,0,9,38
10,Success,48,40,0,12,36
10,Success,47,36,0,14,33
10,Success,47,33,6,14,33
10,Success,49,41,3,7,42
10,Success,45,38,0,9,36
10,Success,52,39,3,6,46
10,Success,56,36,2,6,50
10,Success,57,34,2,7,50
10,Success,46,38,4,12,34
10,Success,41,44,1,14,27
10,Success,56,33,0,10,46
10,Success,51,35,0,11,40
10,Success,37,31,0,18,19
10,Success,41,37,6,16,25
10,Success,43,41,0,13,30
10,Success,42,39,3,16,26
10,Success,47,34,3,16,31
10,Success,52,31,0,8,44
10,Success,53,33,0,14,39
10,Success,48,35,6,11,37
10,Success,50,39,0,11,39
10,Success,55,25,0,18,37
10,Success,51,30,0,16,35
10,Success,45,35,12,8,37
10,Success,42,36,4,18,24
10,Success,47,36,4,13,34
10,Success,51,36,3,10,41
10,Success,48,39,1,12,36
10,Success,49,37,0,12,37
10,Success,59,29,0,11,48
10,Success,52,31,0,12,40
10,Success,52,36,0,12,40
10,Success,39,40,0,19,20
10,Success,43,43,0,12,31
10,Success,41,30,8,21,20
10,Success,42,31,10,17,25
10,Success,48,43,0,9,39
10,Success,46,32,1,21,25
10,Success,46,35,0,14,32
10,Success,48,30,7,15,33
10,Success,45,38,0,8,37
10,Success,50,38,3,9,41
10,Success,41,41,0,13,28
10,Success,46,38,0,16,30
10,Success,49,36,5,10,39
10,Success,47,34,0,11,36
10,Success,49,40,3,8,41
10,Success,46,31,0,18,28
10,Success,48,31,0,13,35
10,Success,45,39,0,9,36
10,Success,51,28,8,13,38
10,Success,40,36,6,18,22
10,Success,42,38,0,15,27
10,Success,48,37,0,14,34
10,Success,44,41,0,14,30
10,Success,48,32,0,15,33
10,Success,45,32,9,14,31
10,Success,43,40,3,14,29
10,Success,48,43,0,7,41
10,Success,49,34,8,9,40
10,Success,52,32,1,15,37
10,Success,46,36,4,14,32
10,Success,42,31,7,20,22
10,Success,48,37,0,13,35
10,Success,47,39,4,10,37
10,Success,47,34,2,17,30
10,Success,44,38,7,11,33
10,Success,49,34,0,14,35
10,Success,52,26,0,17,35
10,Success,48,34,0,14,34
10,Success,46,35,0,17,29
10,Success,50,36,0,11,39
10,Success,49,39,6,6,43
10,Success,46,34,4,16,30
10,Success,46,31,0,16,30
10,Success,46,33,3,18,28
10,Success,54,35,3,8,46
10,Success,55,30,0,14,41
10,Success,45,41,0,13,32
10,Success,44,43,0,8,36
10,Success,46,35,4,15,31
10,Success,50,33,0,12,38
10,Success,52,30,4,14,38
10,Success,49,34,3,14,35
10,Success,51,38,0,9,42
10,Success,52,26,0,15,37
10,Success,36,42,7,15,21
10,Success,55,29,2,14,41
10,Success,48,37,0,14,34
10,Success,52,35,0,9,43
10,Success,47,37,0,8,39
10,Success,48,41,0,8,40
10,Success,44,41,0,14,30
10,Success,44,30,5,21,23
10,Success,52,32,0,13,39
10,Success,47,30,0,21,26
10,Success,37,37,0,17,20
10,Success,42,37,0,15,27
10,Success,51,32,0,14,37
10,Success,53,33,0,12,41
10,Success,51,40,0,9,42
10,Success,52,33,0,14,38
10,Success,48,37,2,13,35
10,Success,52,35,0,13,39
10,Success,51,38,2,9,42
10,Success,53,32,2,13,40
10,Success,54,33,0,12,42
10,Success,48,37,5,10,38
10,Success,53,35,0,10,43
10,Success,50,36,1,13,37
10,Success,46,39,3,12,34
10,Success,49,35,0,12,37
10,Success,49,36,0,14,35
10,Success,48,32,3,17,31
10,Success,45,25,0,19,26
10,Success,47,42,2,9,38
10,Success,49,30,4,17,32
10,Success,44,45,3,8,36
10,Success,51,31,4,14,37
10,Success,49,33,7,11,38
10,Success,48,39,1,12,36
10,Success,53,31,0,11,42
10,Success,47,34,4,15,32
10,Success,46,39,6,9,37
10,Success,51,30,0,16,35
10,Success,48,34,5,13,35
10,Success,53,28,6,13,40
20,Success,48,39,7,6,42
20,Success,48,35,0,11,37
20,Success,54,34,2,10,44
20,Success,48,37,1,14,34
20,Success,45,32,0,13,32
20,Success,51,35,0,14,37
20,Success,46,25,0,17,29
20,Success,48,35,3,14,34
20,Success,46,38,0,13,33
20,Success,45,44,2,9,36
20,Success,46,40,0,9,37
20,Success,48,39,1,12,36
20,Success,51,36,0,13,38
20,Success,48,38,1,13,35
20,Success,52,33,2,13,39
20,Success,41,42,4,13,28
20,Success,46,37,0,12,34
20,Success,49,40,0,11,38
20,Success,54,26,0,20,34
20,Success,52,34,0,14,38
20,Success,44,33,7,16,28
20,Success,44,39,2,15,29
20,Success,49,29,5,17,32
20,Success,51,34,0,11,40
20,Success,53,32,5,10,43
20,Success,36,47,3,14,22
20,Success,47,32,3,18,29
20,Success,52,33,0,13,39
20,Success,43,34,0,17,26
20,Success,44,37,2,17,27
20,Success,46,42,2,10,36
20,Success,41,36,0,19,22
20,Success,50,32,5,13,37
20,Success,55,30,0,10,45
20,Success,47,31,0,14,33
20,Success,54,29,0,10,44
20,Success,48,34,5,13,35
20,Success,51,36,0,9,42
20,Success,40,38,0,13,27
20,Success,46,35,0,14,32
20,Success,50,33,0,16,34
20,Success,45,34,3,18,27
20,Success,46,33,0,16,30
20,Success,55,33,3,9,46
20,Success,45,39,5,11,34
20,Success,45,36,0,17,28
20,Success,45,36,6,13,32
20,Success,47,42,1,10,37
20,Success,47,40,6,7,40
20,Success,51,28,0,18,33
20,Success,45,32,0,17,28
20,Success,50,31,0,15,35
20,Success,43,40,0,13,30
20,Success,41,37,7,15,26
20,Success,48,34,0,14,34
20,Success,44,37,0,16,28
20,Success,48,29,11,12,36
20,Success,53,35,1,11,42
20,Success,53,35,0,11,42
20,Success,42,42,0,16,26
20,Success,47,40,0,10,37
20,Success,47,34,3,16,31
20,Success,54,25,12,9,45
20,Success,43,38,0,17,26
20,Success,47,38,0,12,35
20,Success,47,40,4,9,38
20,Success,52,33,0,14,38
20,Success,47,39,0,9,38
20,Success,51,28,5,16,35
20,Success,50,33,4,13,37
20,Success,48,39,0,7,41
20,Success,47,38,0,12,35
20,Success,53,35,1,11,42
20,Success,42,34,8,16,26
20,Success,49,39,0,12,37
20,Success,43,41,3,13,30
20,Success,47,36,2,15,32
20,Success,50,36,3,11,39
20,Success,57,30,0,10,47
20,Success,45,40,0,12,33
20,Success,53,29,0,11,42
20,Success,45,28,0,14,31
20,Success,45,35,0,18,27
20,Success,49,38,0,12,37
20,Success,51,30,3,16,35
20,Success,53,33,0,7,46
20,Success,56,33,1,10,46
20,Success,50,42,1,7,43
20,Success,39,31,0,13,26
20,Success,48,33,0,18,30
20,Success,44,27,16,13,31
20,Success,47,41,2,10,37
20,Success,48,39,0,8,40
20,Success,50,37,0,12,38
20,Success,46,34,0,11,35
20,Success,47,34,5,14,33
20,Success,58,28,1,13,45
20,Success,50,32,6,12,38
20,Success,48,33,0,17,31
20,Success,48,39,0,13,35
20,Success,53,30,3,14,39
20,Success,51,34,0,8,43
20,Success,38,43,5,14,24
20,Success,52,35,0,11,41
20,Success,45,41,0,14,31
20,Success,45,42,3,10,35
20,Success,45,31,12,12,33
20,Success,53,31,0,11,42
20,Success,52,41,0,7,45
20,Success,52,31,0,11,41
20,Success,49,33,0,12,37
20,Success,58,30,0,11,47
20,Success,55,33,1,11,44
20,Success,52,32,0,16,36
20,Success,50,31,2,17,33
20,Success,48,42,0,10,38
20,Success,45,40,0,12,33
20,Success,51,33,0,15,36
20,Success,50,28,4,18,32
20,Success,52,33,4,11,41
20,Success,52,32,2,14,38
20,Success,43,34,0,12,31
20,Success,49,29,0,17,32
20,Success,46,41,1,12,34
20,Success,44,35,11,10,34
20,Success,49,36,0,13,36
20,Success,45,40,0,13,32
20,Success,52,34,0,10,42
20,Success,46,28,11,15,31
20,Success,46,31,11,12,34
20,Success,50,36,3,11,39
20,Success,49,38,0,13,36
20,Success,53,38,3,6,47
20,Success,42,45,0,13,29
20,Success,46,41,1,12,34
20,Success,50,33,0,16,34
20,Success,54,33,0,13,41
20,Success,47,33,0,17,30
20,Fail,35,39,0,23,12
20,Success,55,24,7,14,41
20,Success,48,31,6,15,33
20,Success,52,37,1,10,42
20,Success,46,42,0,8,38
20,Success,50,38,2,10,40
20,Success,49,39,4,8,41
20,Success,47,39,3,11,36
20,Success,41,37,0,19,22
20,Success,55,33,0,12,43
20,Success,44,42,7,7,37
20,Success,48,40,1,11,37
20,Success,48,34,7,11,37
20,Success,47,37,0,14,33
20,Success,48,32,7,13,35
20,Success,49,34,0,13,36
20,Success,52,35,0,12,40
20,Success,52,40,1,7,45
20,Success,51,31,0,15,36
20,Success,43,43,1,13,30
20,Success,48,44,0,8,40
20,Success,44,40,6,10,34
20,Success,49,31,5,15,34
20,Success,55,30,0,12,43
20,Success,47,37,0,15,32
20,Success,54,35,1,10,44
20,Success,46,36,0,13,33
20,Success,52,40,0,8,44
20,Success,35,45,0,12,23
20,Success,56,31,0,11,45
20,Success,46,39,0,15,31
20,Success,42,33,10,15,27
20,Success,42,39,0,13,29
20,Success,46,38,0,12,34
20,Success,40,37,0,16,24
20,Success,44,36,6,14,30
20,Success,43,31,8,18,25
20,Success,43,40,5,12,31
20,Success,49,39,0,12,37
20,Success,52,35,0,11,41
20,Success,50,30,8,12,38
20,Success,54,32,0,11,43
20,Success,55,34,0,10,45
20,Success,57,26,5,12,45
20,Success,46,33,1,20,26
20,Success,50,32,1,17,33
20,Success,42,35,7,16,26
20,Success,46,36,0,11,35
20,Success,51,33,0,16,35
20,Success,50,33,1,16,34
20,Success,45,39,3,13,32
20,Success,50,30,11,9,41
20,Success,56,29,0,14,42
20,Success,41,34,8,17,24
20,Success,47,36,2,15,32
20,Success,54,26,7,13,41
20,Success,46,33,5,16,30
20,Success,64,29,1,6,58
20,Success,43,35,0,13,30
20,Success,46,38,4,12,34
20,Success,46,35,0,11,35
20,Success,51,36,0,11,40
20,Success,49,27,9,15,34
20,Success,53,29,3,15,38
20,Success,46,37,5,12,34
20,Success,61,31,0,8,53
20,Success,43,31,15,11,32
20,Success,41,43,1,15,26
20,Success,43,38,0,16,27
20,Success,45,34,6,15,30
20,Success,47,29,0,22,25
20,Success,50,40,0,8,42
20,Success,59,27,4,10,49
20,Success,52,36,0,12,40
20,Success,50,35,2,13,37
20,Success,49,37,5,9,40
20,Success,52,36,1,11,41
20,Success,47,35,0,17,30
20,Success,51,42,0,6,45
20,Success,44,33,10,13,31
20,Success,43,44,4,9,34
20,Success,43,40,0,8,35
20,Success,52,33,2,13,39
20,Success,56,29,0,11,45
20,Success,41,39,0,15,26
20,Success,46,31,8,15,31
20,Success,41,42,2,15,26
20,Success,43,39,0,13,30
20,Success,52,34,3,11,41
20,Success,49,34,2,15,34
20,Success,48,32,0,13,35
20,Success,46,42,1,11,35
20,Success,51,27,0,6,45
20,Success,50,39,0,7,43
20,Success,47,33,5,15,32
20,Success,46,41,0,11,35
20,Success,44,34,0,11,33
20,Success,45,29,0,18,27
20,Success,56,30,4,10,46
20,Success,46,34,3,17,29
20,Success,43,41,5,11,32
20,Success,51,30,5,14,37
20,Success,45,38,5,12,33
20,Success,48,37,1,14,34
20,Success,49,33,0,14,35
20,Success,57,34,0,6,51
20,Success,45,30,0,19,26
20,Success,48,32,1,19,29
20,Success,42,40,1,17,25
20,Success,46,38,6,10,36
20,Success,43,34,7,16,27
20,Success,47,33,3,17,30
20,Success,48,35,1,16,32
20,Success,41,38,0,13,28
20,Success,47,29,11,13,34
20,Success,53,33,0,9,44
20,Success,46,40,0,11,35
20,Success,47,33,3,17,30
20,Success,49,35,0,9,40
20,Success,50,32,2,16,34
20,Success,55,28,0,11,44
20,Success,44,42,0,9,35
20,Success,43,38,10,9,34
20,Success,45,37,0,15,30
20,Success,54,35,0,10,44
20,Success,42,37,0,11,31
20,Success,53,29,6,12,41
20,Success,56,22,8,14,42
20,Success,48,32,3,17,31
20,Success,45,33,0,18,27
20,Success,53,35,1,11,42
20,Success,44,41,3,12,32
20,Success,59,23,0,9,50
20,Success,48,35,3,14,34
20,Success,42,36,5,17,25
20,Success,51,36,1,12,39
20,Success,50,36,1,13,37
20,Success,51,38,2,9,42
20,Success,50,36,1,13,37
20,Success,50,34,0,11,39
20,Success,39,41,4,16,23
20,Success,50,36,3,11,39
20,Success,43,42,0,10,33
20,Success,39,43,0,17,22
20,Success,44,34,0,14,30
20,Success,50,37,2,11,39
20,Success,47,37,3,13,34
20,Success,47,34,6,13,34
20,Success,54,33,5,8,46
20,Success,41,43,0,12,29
20,Success,47,34,1,18,29
20,Success,44,37,0,13,31
20,Success,52,35,1,12,40
20,Success,47,33,3,17,30
20,Success,49,34,5,12,37
20,Success,52,33,0,13,39
20,Success,48,35,8,9,39
20,Success,57,30,0,13,44
20,Success,50,30,0,17,33
20,Success,43,28,11,18,25
20,Success,46,33,8,13,33
20,Success,44,35,0,15,29
20,Success,44,32,7,17,27
20,Success,53,31,3,13,40
20,Success,52,33,0,12,40
20,Success,48,32,6,14,34
20,Success,44,43,4,9,35
20,Success,48,42,2,8,40
20,Success,49,32,5,14,35
20,Success,51,32,0,14,37
20,Success,45,36,5,14,31
20,Success,46,33,0,20,26
20,Success,52,31,0,12,40
20,Success,44,38,0,11,33
20,Success,46,33,8,13,33
20,Success,53,32,3,12,41
20,Success,50,37,0,9,41
20,Success,48,35,4,13,35
20,Success,42,40,9,9,33
20,Success,50,35,5,10,40
20,Success,46,42,0,12,34
20,Success,48,34,0,13,35
20,Success,47,38,0,11,36
20,Fail,42,30,0,23,19
20,Success,46,35,5,14,32
20,Success,43,36,4,17,26
20,Success,44,46,0,9,35
20,Success,44,35,0,13,31
20,Success,51,31,4,14,37
20,Success,56,29,0,15,41
20,Success,46,29,11,14,32
20,Success,35,52,0,12,23
20,Success,52,30,0,17,35
20,Success,52,34,0,12,40
20,Success,45,44,0,10,35
20,Success,47,36,0,13,34
20,Success,51,31,3,15,36
20,Success,46,39,0,14,32
20,Success,48,37,0,6,42
20,Success,52,28,0,14,38
20,Success,46,42,1,11,35
20,Success,54,30,0,9,45
20,Success,53,36,0,11,42
20,Success,55,34,0,9,46
20,Success,48,44,1,7,41
20,Success,52,34,0,10,42
20,Success,52,32,4,12,40
20,Success,50,31,3,16,34
20,Success,45,41,2,12,33
20,Success,43,39,2,16,27
20,Success,46,33,3,18,28
20,Fail,39,33,0,25,14
20,Success,46,37,0,9,37
20,Success,47,34,9,10,37
20,Success,44,41,1,14,30
20,Success,50,34,0,10,40
20,Success,48,35,0,12,36
20,Success,47,37,0,9,38
20,Success,48,30,0,11,37
20,Success,48,38,0,10,38
20,Success,54,32,0,13,41
20,Success,44,31,0,17,27
20,Success,49,35,3,13,36
20,Success,45,41,0,12,33
20,Success,38,38,0,16,22
20,Success,48,45,2,5,43
20,Success,47,40,0,12,35
20,Success,53,33,0,13,40
20,Success,46,35,5,14,32
20,Success,55,30,4,11,44
20,Success,52,35,0,13,39
20,Success,49,34,0,13,36
20,Success,46,38,0,16,30
20,Success,50,37,0,9,41
20,Success,48,36,0,11,37
20,Success,54,31,0,15,39
20,Success,46,30,0,12,34
20,Success,58,27,0,14,44
20,Success,56,29,0,13,43
20,Success,52,28,4,16,36
20,Success,51,34,0,13,38
20,Success,43,34,0,14,29
20,Success,44,40,0,13,31
20,Success,43,41,3,13,30
20,Success,56,28,6,10,46
20,Success,42,40,5,13,29
20,Success,48,38,0,14,34
20,Success,49,34,0,12,37
20,Success,48,37,0,15,33
20,Success,44,41,7,8,36
20,Success,41,28,13,18,23
20,Success,49,37,1,13,36
20,Success,48,36,2,14,34
20,Success,60,31,2,7,53
20,Success,49,39,0,12,37
20,Success,46,36,7,11,35
20,Success,43,37,0,13,30
20,Success,49,33,0,14,35
20,Success,53,31,0,14,39
20,Success,44,35,0,20,24
20,Success,46,32,13,9,37
20,Success,47,37,0,8,39
20,Success,49,33,8,10,39
20,Success,54,35,0,9,45
20,Success,47,37,1,15,32
20,Success,50,33,0,12,38
20,Success,51,30,0,16,35
20,Success,53,35,3,9,44
20,Success,42,41,3,14,28
20,Success,50,38,1,11,39
20,Success,46,35,0,14,32
20,Success,52,31,3,14,38
20,Success,47,39,0,10,37
20,Success,41,43,0,16,25
20,Success,44,38,4,14,30
20,Success,47,35,2,16,31
20,Success,47,36,9,8,39
20,Success,59,27,0,11,48
20,Success,56,34,0,9,47
20,Success,39,39,5,17,22
20,Success,52,36,0,9,43
20,Success,52,25,0,23,29
20,Success,55,34,0,11,44
20,Success,45,40,3,12,33
20,Success,57,28,1,14,43
20,Success,39,40,9,12,27
20,Success,47,39,3,11,36
20,Success,46,38,8,8,38
20,Success,41,41,7,11,30
20,Success,47,34,0,17,30
20,Success,53,34,0,10,43
20,Success,41,36,0,19,22
20,Success,44,32,0,21,23
20,Success,52,34,1,13,39
20,Success,39,47,0,12,27
20,Success,44,37,0,15,29
20,Success,48,44,1,7,41
20,Success,48,39,2,11,37
20,Success,46,37,0,11,35
20,Success,51,29,0,16,35
20,Success,58,31,0,10,48
20,Success,43,35,11,11,32
20,Success,52,37,0,11,41
20,Success,42,40,1,17,25
20,Success,37,46,1,16,21
20,Success,49,37,0,14,35
20,Success,51,36,5,8,43
20,Success,55,33,4,8,47
20,Success,49,37,1,13,36
20,Success,47,39,0,10,37
20,Success,50,34,0,11,39
20,Success,52,34,1,13,39
20,Success,50,34,2,14,36
20,Success,50,36,0,12,38
20,Success,53,31,0,8,45
20,Success,57,30,4,9,48
20,Success,45,38,0,16,29
20,Success,51,36,0,9,42
20,Success,42,44,0,12,30
20,Success,50,40,0,9,41
20,Success,49,34,0,14,35
20,Success,54,38,1,7,47
20,Success,44,39,0,10,34
20,Success,47,36,0,17,30
20,Success,43,39,6,12,31
20,Success,48,41,0,11,37
20,Success,55,31,2,12,43
20,Success,52,33,0,9,43
20,Success,41,45,1,13,28
20,Success,47,32,0,17,30
20,Success,51,37,0,12,39
20,Success,56,31,5,8,48
20,Success,46,36,0,13,33
20,Success,50,34,3,13,37
20,Success,40,38,0,15,25
20,Success,41,39,0,16,25
20,Success,53,28,5,14,39
20,Success,48,40,1,11,37
20,Success,49,38,0,12,37
20,Success,45,36,0,13,32
20,Success,53,27,6,14,39
20,Success,46,27,9,18,28
20,Success,43,31,0,23,20
20,Success,52,37,1,10,42
20,Success,43,36,7,14,29
20,Fail,37,34,11,18,19
20,Success,46,42,0,12,34
20,Success,52,33,0,15,37
20,Success,47,37,0,12,35
20,Success,51,31,0,13,38
20,Success,52,32,6,10,42
20,Success,50,38,1,11,39
20,Success,51,32,0,10,41
20,Success,48,35,1,16,32
20,Success,48,36,1,15,33
20,Success,40,40,7,13,27
20,Success,51,37,0,12,39
20,Success,52,32,4,12,40
20,Success,47,26,13,14,33
20,Success,48,35,4,13,35
20,Success,52,37,1,10,42
20,Success,52,35,1,12,40
20,Success,43,40,4,13,30
20,Success,41,35,6,18,23
20,Success,43,39,7,11,32
20,Success,51,34,0,12,39
20,Success,43,36,0,16,27
20,Success,46,41,5,8,38
20,Success,52,37,0,11,41
20,Success,58,25,0,10,48
20,Success,50,33,0,15,35
20,Success,48,41,4,7,41
20,Success,47,41,0,8,39
20,Success,48,39,0,11,37
20,Success,42,41,6,11,31
20,Success,45,36,1,18,27
20,Success,48,37,2,13,35
20,Success,45,41,0,12,33
20,Success,50,29,7,14,36
20,Success,42,38,0,15,27
20,Success,46,32,0,14,32
20,Success,51,32,2,15,36
20,Success,47,38,0,14,33
20,Success,47,39,5,9,38
20,Success,49,34,0,13,36
20,Success,46,34,6,14,32
20,Success,40,38,0,16,24
20,Success,46,37,0,13,33
20,Success,54,37,0,9,45
20,Success,45,39,3,13,32
20,Success,47,42,2,9,38
20,Success,42,36,8,14,28
20,Success,58,30,1,11,47
20,Success,50,20,12,18,32
20,Success,51,38,0,11,40
20,Success,47,42,3,8,39
20,Success,51,33,4,12,39
20,Success,51,36,2,11,40
20,Success,53,31,2,14,39
20,Success,48,35,6,11,37
20,Success,44,39,1,16,28
20,Success,52,38,1,9,43
20,Success,43,42,5,10,33
20,Success,50,38,5,7,43
20,Success,49,41,1,9,40
20,Success,51,43,2,4,47
20,Success,46,35,9,10,36
20,Success,43,44,0,10,33
20,Success,48,30,3,19,29
20,Success,48,38,1,13,35
20,Success,46,37,3,14,32
20,Success,50,33,0,17,33
20,Success,50,29,0,19,31
20,Success,45,35,0,9,36
20,Success,47,33,8,12,35
20,Success,55,32,0,10,45
20,Success,41,41,0,18,23
20,Success,41,37,0,16,25
20,Success,41,42,5,12,29
20,Success,45,33,0,17,28
20,Success,46,36,6,12,34
20,Success,43,42,0,15,28
20,Success,49,36,0,12,37
20,Success,53,32,1,14,39
20,Success,57,35,0,7,50
20,Success,44,44,0,9,35
20,Success,49,39,1,11,38
20,Success,42,39,0,16,26
20,Success,46,35,5,14,32
20,Success,47,42,1,10,37
20,Success,50,45,1,4,46
20,Success,43,44,0,9,34
20,Success,52,34,5,9,43
20,Success,49,36,3,12,37
20,Success,52,29,11,8,44
20,Success,44,38,8,10,34
20,Success,52,29,8,11,41
20,Success,43,41,4,12,31
20,Success,39,39,0,16,23
20,Success,51,35,4,10,41
20,Success,49,35,0,14,35
20,Success,49,31,0,18,31
20,Success,34,44,11,11,23
20,Success,48,35,3,14,34
20,Success,51,32,5,12,39
20,Success,56,31,0,10,46
20,Success,48,34,0,14,34
20,Success,50,36,0,11,39
20,Success,53,32,0,13,40
20,Success,45,41,0,14,31
20,Success,48,38,1,13,35
20,Success,53,34,1,12,41
20,Success,59,32,0,9,50
20,Success,48,44,0,8,40
20,Success,52,39,0,9,43
20,Success,46,43,0,10,36
20,Success,52,40,0,7,45
20,Success,52,27,0,18,34
20,Success,44,40,0,16,28
20,Success,46,34,0,10,36
20,Success,47,32,0,10,37
20,Success,50,36,3,11,39
20,Success,46,32,0,17,29
20,Success,45,44,0,11,34
20,Success,52,36,0,12,40
20,Success,57,28,0,13,44
20,Success,49,39,2,10,39
20,Success,44,38,8,10,34
20,Success,43,33,0,21,22
20,Success,45,40,9,6,39
20,Success,50,35,0,9,41
20,Success,45,38,0,14,31
20,Success,48,41,1,10,38
20,Success,46,29,0,15,31
20,Success,55,26,0,16,39
20,Success,49,34,0,11,38
20,Success,50,38,1,11,39
20,Success,55,30,2,13,42
20,Success,55,31,0,14,41
20,Success,44,33,8,15,29
20,Success,50,38,4,8,42
20,Success,45,44,1,10,35
20,Success,49,34,8,9,40
20,Success,48,41,1,10,38
20,Success,57,27,3,13,44
20,Success,50,34,3,13,37
20,Success,52,35,0,11,41
20,Success,49,39,0,12,37
20,Success,45,33,5,17,28
20,Success,49,28,9,14,35
20,Success,56,38,0,5,51
20,Success,49,31,5,15,34
20,Success,50,37,0,12,38
20,Success,50,33,0,13,37
20,Success,43,37,12,8,35
20,Success,44,37,7,12,32
20,Success,50,39,1,10,40
20,Success,41,42,0,17,24
20,Success,48,32,6,14,34
20,Success,50,33,6,11,39
20,Success,44,38,0,17,27
20,Success,53,31,0,13,40
20,Success,54,35,2,9,45
20,Success,45,36,0,15,30
20,Success,52,34,1,13,39
20,Success,50,34,5,11,39
20,Success,49,39,0,11,38
20,Success,48,37,0,13,35
20,Success,55,30,5,10,45
20,Success,46,33,4,17,29
20,Success,50,31,0,17,33
20,Success,44,35,7,14,30
20,Success,47,39,0,13,34
20,Success,45,30,0,18,27
20,Success,42,46,0,10,32
20,Success,50,41,1,8,42
20,Success,46,38,0,10,36
20,Success,46,37,0,12,34
20,Success,47,36,0,15,32
20,Success,52,34,0,10,42
20,Success,51,33,0,12,39
20,Success,49,38,3,10,39
20,Success,44,38,2,16,28
20,Success,55,33,0,7,48
20,Success,42,39,0,16,26
20,Success,41,40,3,16,25
20,Success,44,36,0,14,30
20,Success,46,35,0,17,29
20,Success,48,35,4,13,35
20,Success,51,33,0,16,35
20,Success,45,39,0,14,31
20,Success,47,34,6,13,34
20,Success,48,34,0,16,32
20,Success,49,39,2,10,39
20,Success,45,36,9,10,35
20,Fail,37,38,7,18,19
20,Success,45,36,3,16,29
20,Success,47,35,7,11,36
20,Fail,36,42,4,18,18
20,Success,42,34,8,16,26
20,Success,46,31,0,14,32
20,Success,50,36,0,14,36
20,Success,57,32,1,10,47
20,Success,50,31,0,9,41
20,Success,53,32,3,12,41
20,Success,52,34,0,9,43
20,Success,51,31,0,16,35
20,Success,56,32,0,9,47
20,Success,45,39,6,10,35
20,Success,51,35,0,12,39
20,Success,44,39,2,15,29
20,Success,47,39,3,11,36
20,Success,44,41,0,11,33
20,Success,45,38,2,15,30
20,Success,51,33,5,11,40
20,Success,50,34,2,14,36
20,Success,51,32,0,12,39
20,Success,46,28,6,20,26
20,Fail,37,33,11,19,18
20,Success,50,32,4,14,36
20,Success,44,42,3,11,33
20,Success,49,43,0,7,42
20,Success,45,37,0,13,32
20,Success,52,39,0,7,45
20,Success,52,35,5,8,44
20,Success,51,41,0,7,44
20,Success,50,37,0,10,40
20,Success,50,34,0,12,38
20,Success,48,34,1,17,31
20,Success,41,36,0,11,30
20,Success,44,43,2,11,33
20,Success,46,36,0,10,36
20,Success,45,35,6,14,31
20,Success,41,33,0,19,22
20,Fail,33,39,14,14,19
20,Success,51,35,4,10,41
20,Success,50,34,0,13,37
20,Success,53,27,5,15,38
20,Success,46,32,6,16,30
20,Success,42,38,4,16,26
20,Success,52,34,0,8,44
20,Success,56,29,3,12,44
20,Success,45,34,0,14,31
20,Success,47,38,6,9,38
20,Success,49,35,0,13,36
20,Success,46,33,0,11,35
20,Success,49,31,0,17,32
20,Success,45,35,7,13,32
20,Success,47,38,0,12,35
20,Success,54,35,0,10,44
20,Success,51,29,0,14,37
20,Success,60,29,1,10,50
20,Success,55,29,0,16,39
20,Success,51,34,0,14,37
20,Success,49,33,0,16,33
20,Success,48,34,3,15,33
20,Success,48,32,0,14,34
20,Success,50,41,0,9,41
20,Success,51,32,0,16,35
20,Success,51,34,7,8,43
20,Success,51,32,5,12,39
20,Success,39,41,2,18,21
20,Success,41,38,7,14,27
20,Success,54,32,6,8,46
20,Success,54,40,1,5,49
20,Success,58,28,2,12,46
20,Success,41,36,7,16,25
20,Success,57,33,0,10,47
20,Success,54,30,0,11,43
20,Success,39,48,0,12,27
20,Success,45,40,1,14,31
20,Success,50,36,0,12,38
20,Success,52,28,8,12,40
20,Success,40,42,7,11,29
20,Success,46,34,0,20,26
20,Success,46,26,10,18,28
20,Success,55,29,0,12,43
20,Success,54,26,7,13,41
20,Success,41,47,0,11,30
20,Success,46,33,9,12,34
20,Success,49,33,0,17,32
20,Success,55,32,0,13,42
20,Success,48,28,12,12,36
20,Success,52,35,0,11,41
20,Success,50,31,0,12,38
20,Success,49,30,0,9,40
20,Success,41,38,0,13,28
20,Success,42,46,0,11,31
20,Success,50,35,5,10,40
20,Success,46,35,0,15,31
20,Success,50,32,4,14,36
20,Success,49,32,7,12,37
20,Success,54,29,3,14,40
20,Success,48,32,2,18,30
20,Success,44,34,4,18,26
20,Success,51,34,4,11,40
20,Success,54,39,2,5,49
20,Success,49,30,4,17,32
20,Success,53,29,6,12,41
20,Success,38,42,0,15,23
20,Success,56,28,0,11,45
20,Success,51,36,0,13,38
20,Success,42,37,0,21,21
20,Success,50,33,0,11,39
20,Success,55,33,0,9,46
20,Success,43,31,4,22,21
20,Success,50,37,0,12,38
20,Success,45,41,3,11,34
20,Success,41,44,0,14,27
20,Success,46,31,6,17,29
20,Success,49,38,4,9,40
20,Success,47,36,3,14,33
20,Success,42,32,13,13,29
20,Success,50,35,1,14,36
20,Success,50,33,0,14,36
20,Success,49,34,0,11,38
20,Success,54,39,0,6,48
20,Success,53,33,0,10,43
20,Success,54,33,0,12,42
20,Success,48,29,0,19,29
20,Success,49,37,2,12,37
20,Success,48,37,0,11,37
20,Success,53,28,0,18,35
20,Fail,35,39,8,18,17
20,Success,47,28,0,22,25
20,Success,49,34,3,14,35
20,Success,52,36,0,12,40
20,Success,41,36,5,18,23
20,Success,46,39,0,11,35
20,Success,43,32,4,21,22
20,Success,48,31,0,11,37
20,Success,40,42,0,15,25
20,Success,51,39,0,7,44
20,Success,40,34,11,15,25
20,Success,45,32,8,15,30
20,Success,49,38,4,9,40
20,Success,49,39,0,12,37
20,Success,52,31,0,15,37
20,Success,45,38,0,12,33
20,Success,44,34,0,18,26
20,Success,52,36,2,10,42
20,Success,49,38,3,10,39
20,Fail,40,36,3,21,19
20,Success,55,37,1,7,48
20,Success,59,33,0,7,52
20,Success,49,39,0,10,39
20,Success,52,36,0,8,44
20,Success,46,31,0,10,36
20,Success,56,28,0,13,43
20,Success,39,38,5,18,21
20,Success,46,35,6,13,33
20,Success,52,34,0,8,44
20,Success,44,36,5,15,29
20,Success,51,33,0,16,35
20,Success,41,40,0,17,24
20,Fail,33,42,7,18,15
20,Success,47,38,0,12,35
20,Success,53,35,0,11,42
20,Success,51,39,0,8,43
20,Success,40,44,0,16,24
20,Success,46,33,0,20,26
20,Success,45,34,0,16,29
20,Success,52,36,0,10,42
20,Success,37,36,0,11,26
20,Success,44,35,0,14,30
20,Success,43,36,0,18,25
20,Success,51,32,0,16,35
20,Success,52,33,0,13,39
20,Success,42,45,0,10,32
20,Success,50,37,0,13,37
20,Success,48,38,2,12,36
20,Success,49,42,3,6,43
20,Success,49,36,0,12,37
20,Success,52,39,0,6,46
20,Success,51,33,0,11,40
20,Success,39,38,0,14,25
20,Success,53,37,0,7,46
20,Success,47,40,0,12,35
20,Success,44,39,3,14,30
20,Success,57,37,0,6,51
20,Success,46,39,0,10,36
20,Success,44,44,0,12,32
20,Success,49,43,0,8,41
20,Success,52,29,0,11,41
20,Success,49,38,0,8,41
20,Success,49,30,0,16,33
20,Success,59,32,0,9,50
20,Success,49,38,0,12,37
20,Success,50,33,0,12,38
20,Success,50,31,1,18,32
20,Success,44,33,7,16,28
20,Success,52,36,0,10,42
20,Success,52,31,0,9,43
20,Success,53,32,0,15,38
20,Success,48,29,12,11,37
20,Success,50,38,0,12,38
20,Success,37,44,8,11,26
20,Success,48,40,3,9,39
20,Success,48,37,0,13,35
20,Success,44,33,7,16,28
20,Success,51,39,1,9,42
20,Success,60,29,0,10,50
20,Success,45,40,1,14,31
20,Success,49,19,0,23,26
20,Success,60,33,0,7,53
20,Success,48,31,4,17,31
20,Success,50,33,3,14,36
20,Success,49,38,0,12,37
20,Success,40,42,0,17,23
20,Success,56,34,2,8,48
20,Success,43,35,2,20,23
20,Success,51,32,0,13,38
20,Success,48,35,0,12,36
20,Success,49,35,0,15,34
20,Success,48,34,5,13,35
20,Success,54,30,9,7,47
20,Success,47,36,2,15,32
20,Success,41,37,0,16,25
20,Success,52,34,0,9,43
20,Success,48,29,0,17,31
20,Success,54,27,4,15,39
20,Success,42,32,0,9,33
20,Success,45,33,0,15,30
20,Success,44,32,5,19,25
20,Success,48,35,3,14,34
20,Success,50,36,3,11,39
20,Success,54,29,0,15,39
20,Success,47,38,5,10,37
20,Success,53,35,0,11,42
20,Success,48,32,0,15,33
20,Success,49,35,0,13,36
20,Success,47,41,0,11,36
20,Success,51,30,0,13,38
20,Success,47,34,6,13,34
20,Success,60,30,0,10,50
20,Success,49,37,0,7,42
20,Success,49,33,8,10,39
20,Success,47,42,2,9,38
20,Success,53,36,3,8,45
20,Success,47,36,0,16,31
20,Success,49,41,0,9,40
20,Success,52,33,2,13,39
20,Success,39,43,0,14,25
20,Success,45,42,3,10,35
20,Success,43,39,9,9,34
20,Success,49,30,6,15,34
20,Success,42,40,6,12,30
20,Success,47,40,0,13,34
20,Success,57,30,1,12,45
20,Success,49,34,0,16,33
20,Success,51,35,0,7,44
20,Success,51,34,0,13,38
20,Success,45,37,7,11,34
20,Success,56,29,0,11,45
20,Success,43,34,0,19,24
20,Success,49,36,0,11,38
20,Success,45,43,1,11,34
20,Success,49,34,0,13,36
20,Success,52,36,2,10,42
20,Success,51,34,1,14,37
20,Success,42,40,0,13,29
20,Success,51,30,3,16,35
20,Success,50,39,3,8,42
20,Success,52,32,0,14,38
20,Success,55,34,0,10,45
20,Success,48,37,0,11,37
20,Success,49,37,1,13,36
20,Success,50,40,1,9,41
20,Success,46,33,0,13,33
20,Success,51,36,0,10,41
20,Success,55,29,3,13,42
20,Success,44,42,0,10,34
20,Success,50,38,0,10,40
20,Success,45,39,5,11,34
20,Success,52,41,0,7,45
20,Success,47,31,0,14,33
20,Success,54,30,2,14,40
20,Success,42,34,8,16,26
20,Success,47,35,0,15,32
20,Success,49,41,3,7,42
20,Success,47,39,0,12,35
20,Success,55,34,2,9,46
20,Success,48,35,1,16,32
20,Success,50,38,0,9,41
20,Success,52,34,0,11,41
20,Success,46,35,0,9,37
20,Success,54,32,5,9,45
20,Success,46,34,8,12,34
20,Success,51,34,0,10,41
20,Success,49,29,2,20,29
20,Success,50,27,0,16,34
20,Success,45,32,11,12,33
20,Success,45,28,6,21,24
20,Success,44,35,0,15,29
20,Success,44,32,4,20,24
20,Success,52,27,2,19,33
20,Success,53,30,5,12,41
20,Success,49,39,0,10,39
20,Success,48,36,4,12,36
20,Success,48,41,0,10,38
20,Success,49,38,0,13,36
20,Success,46,37,0,13,33
20,Success,51,32,2,15,36
20,Success,45,39,0,14,31
20,Success,47,36,3,14,33
20,Success,55,22,6,17,38
20,Success,50,32,0,15,35
20,Success,51,34,0,8,43
20,Success,46,41,2,11,35
20,Success,49,37,3,11,38
20,Success,48,40,3,9,39
20,Success,51,40,2,7,44
20,Success,52,24,0,14,38
20,Success,48,34,0,12,36
20,Success,47,32,10,11,36
20,Success,45,38,0,17,28
20,Success,52,29,0,11,41
20,Success,52,34,0,10,42
20,Success,44,34,8,14,30
20,Success,56,23,6,15,41
20,Success,52,29,3,16,36
20,Success,51,34,1,14,37
20,Success,49,41,1,9,40
20,Success,42,41,5,12,30
20,Success,46,35,1,18,28
20,Success,46,36,0,10,36
20,Success,45,41,1,13,32
20,Success,44,35,8,13,31
20,Success,48,36,5,11,37
20,Success,47,39,0,13,34
20,Success,40,41,0,11,29
20,Success,53,35,2,10,43
20,Success,47,32,0,18,29
20,Success,43,40,2,15,28
20,Success,46,42,0,11,35
20,Success,48,35,3,14,34
20,Success,44,33,0,17,27
20,Success,46,36,0,16,30
20,Success,51,33,7,9,42
20,Success,41,39,0,14,27
20,Success,50,39,2,9,41
20,Success,48,33,0,15,33
20,Success,44,45,0,10,34
20,Success,49,36,0,13,36
20,Success,44,40,5,11,33
20,Success,48,41,0,10,38
20,Success,52,25,0,17,35
20,Success,54,35,2,9,45
20,Success,48,39,0,12,36
20,Success,44,32,0,13,31
20,Success,56,26,0,12,44
20,Success,49,36,3,12,37
20,Success,48,26,9,17,31
20,Success,42,35,0,19,23
20,Success,49,36,2,13,36
20,Success,52,29,7,12,40
20,Success,45,35,0,11,34
20,Success,48,38,0,9,39
20,Success,52,30,0,16,36
20,Success,46,39,4,11,35
20,Success,52,35,5,8,44
20,Success,51,29,9,11,40
20,Success,44,36,2,18,26
20,Success,48,43,0,9,39
20,Success,44,36,7,13,31
20,Success,56,33,0,11,45
20,Success,52,35,0,11,41
20,Success,52,27,10,11,41
20,Success,53,34,0,10,43
20,Success,49,37,1,13,36
20,Success,55,26,2,17,38
20,Success,49,34,0,14,35
20,Success,56,35,1,8,48
20,Success,49,35,3,13,36
20,Success,49,36,3,12,37
20,Success,50,35,1,14,36
20,Success,46,40,3,11,35
20,Success,37,36,11,16,21
20,Success,46,37,2,15,31
20,Success,44,40,0,16,28
20,Success,50,33,7,10,40
20,Success,47,33,0,13,34
20,Success,50,37,1,12,38
20,Success,47,45,0,7,40
20,Success,51,36,2,11,40
20,Success,43,35,5,17,26
20,Success,45,34,0,16,29
20,Success,47,32,0,14,33
20,Success,47,37,0,14,33
20,Success,53,35,1,11,42
20,Success,55,30,4,11,44
20,Success,48,35,0,12,36
20,Success,47,32,0,16,31
20,Success,45,44,0,7,38
20,Success,47,35,0,14,33
20,Success,51,34,0,15,36
20,Success,48,36,0,12,36
20,Success,46,35,0,14,32
20,Success,41,45,2,12,29
20,Success,55,32,0,6,49
20,Success,50,37,0,7,43
20,Success,46,39,0,13,33
20,Success,53,40,1,6,47
20,Success,47,33,0,13,34
20,Success,50,40,0,7,43
20,Success,52,37,0,9,43
20,Success,55,28,0,13,42
20,Success,47,29,5,19,28
20,Success,49,40,0,10,39
20,Success,58,35,0,7,51
20,Success,46,40,0,13,33
20,Success,53,33,0,14,39
20,Success,48,40,2,10,38
20,Success,46,32,3,19,27
20,Success,52,40,0,4,48
20,Success,54,30,4,12,42
20,Success,49,38,0,12,37
20,Success,47,43,1,9,38
20,Success,56,32,0,9,47
20,Success,50,30,8,12,38
20,Fail,34,39,0,18,16
20,Success,47,33,5,15,32
20,Success,48,37,0,15,33
20,Success,46,41,7,6,40
20,Success,46,37,5,12,34
20,Success,44,49,0,7,37
20,Success,54,33,0,13,41
20,Success,45,36,5,14,31
20,Success,41,42,0,14,27
20,Success,44,38,1,17,27
20,Success,47,38,0,12,35
20,Success,49,41,0,9,40
20,Success,54,34,0,12,42
20,Success,44,41,5,10,34
20,Success,41,34,0,16,25
20,Success,52,35,2,11,41
20,Success,53,32,5,10,43
20,Success,44,44,0,9,35
20,Success,46,37,3,14,32
20,Success,49,34,6,11,38
20,Success,47,34,5,14,33
20,Success,52,32,4,12,40
20,Success,54,34,0,10,44
20,Success,50,37,5,8,42
20,Success,45,37,0,14,31
20,Success,40,40,0,14,26
20,Success,53,32,0,12,41
20,Success,44,43,0,11,33
20,Success,50,36,0,12,38
20,Success,45,42,0,13,32
20,Success,42,38,0,13,29
20,Success,51,36,0,11,40
20,Success,43,44,1,12,31
20,Success,47,35,5,13,34
20,Success,52,31,0,12,40
20,Success,51,31,0,15,36
20,Success,52,31,0,14,38
20,Success,46,38,0,14,32
20,Success,47,34,7,12,35
20,Success,53,35,0,8,45
20,Success,37,48,0,14,23
20,Success,49,32,0,13,36
20,Success,46,40,2,12,34
20,Success,48,40,0,10,38
20,Success,49,34,0,8,41
20,Success,51,36,0,11,40
20,Success,50,37,0,13,37
20,Success,51,32,0,10,41
20,Success,53,36,0,9,44
20,Success,50,35,1,14,36
20,Success,45,42,0,13,32
20,Success,47,39,0,14,33
20,Success,56,33,0,9,47
20,Fail,42,29,6,23,19
20,Success,44,38,0,13,31
20,Success,35,41,0,14,21
20,Success,44,38,0,15,29
20,Success,49,39,0,12,37
20,Success,48,37,3,12,36
20,Success,51,35,0,12,39
20,Success,48,37,0,12,36
20,Success,52,37,0,9,43
20,Success,48,38,2,12,36
20,Success,47,44,0,5,42
20,Success,53,35,0,10,43
20,Success,48,38,3,11,37
20,Success,45,39,3,13,32
20,Success,42,40,0,15,27
20,Success,46,36,0,15,31
20,Success,42,43,4,11,31
20,Success,48,43,0,9,39
20,Success,43,45,0,10,33
20,Success,42,45,0,10,32
20,Success,49,29,5,17,32
20,Success,48,30,0,13,35
20,Success,44,38,3,15,29
20,Success,41,41,4,14,27
20,Success,47,33,0,10,37
20,Success,51,42,0,5,46
20,Success,48,31,0,17,31
20,Success,45,39,3,13,32
20,Success,45,32,7,16,29
20,Success,51,31,0,15,36
20,Success,50,35,1,14,36
20,Success,51,34,5,10,41
20,Success,47,33,4,16,31
20,Success,49,37,0,14,35
20,Success,51,39,0,10,41
20,Success,37,43,0,15,22
20,Success,55,37,1,7,48
20,Success,42,31,0,15,27
20,Success,46,31,1,22,24
20,Success,46,32,0,17,29
20,Success,40,39,0,15,25
20,Success,46,35,0,11,35
20,Success,47,36,5,12,35
20,Success,47,26,0,19,28
20,Success,40,38,0,14,26
20,Success,52,36,1,11,41
20,Success,51,28,0,19,32
20,Success,46,31,0,12,34
20,Success,51,32,0,10,41
20,Success,45,37,0,10,35
20,Success,49,30,0,10,39
20,Success,54,30,0,10,44
20,Success,45,43,1,11,34
20,Success,44,37,1,18,26
20,Success,45,37,5,13,32
20,Success,50,28,9,13,37
20,Success,53,33,4,10,43
20,Success,50,34,4,12,38
20,Success,57,34,0,6,51
20,Success,52,37,3,8,44
20,Success,48,32,1,19,29
20,Success,39,40,0,13,26
20,Success,44,41,0,14,30
20,Success,55,34,3,8,47
20,Success,48,37,4,11,37
20,Success,52,28,0,14,38
20,Success,43,32,0,15,28
20,Success,49,29,7,15,34
20,Success,51,32,0,14,37
20,Success,47,40,0,11,36
20,Success,48,39,1,12,36
20,Success,46,33,8,13,33
20,Success,43,44,0,10,33
20,Success,46,32,0,9,37
20,Success,47,38,2,13,34
20,Success,50,37,4,9,41
20,Success,53,39,0,8,45
20,Success,36,45,0,11,25
20,Success,49,34,0,11,38
20,Success,44,35,9,12,32
20,Success,38,37,13,12,26
20,Success,50,36,1,13,37
20,Success,56,31,0,9,47
20,Success,49,33,0,16,33
20,Success,37,40,8,15,22
20,Success,41,45,6,8,33
20,Success,45,36,0,18,27
20,Success,51,28,0,11,40
20,Success,52,32,1,15,37
20,Success,44,41,0,13,31
20,Success,44,41,0,9,35
20,Success,52,34,2,12,40
20,Success,48,33,5,14,34
20,Success,53,34,1,12,41
20,Success,52,30,1,17,35
20,Success,53,31,0,14,39
20,Success,50,35,3,12,38
20,Success,51,43,1,5,46
20,Success,46,39,0,14,32
20,Success,50,37,1,12,38
20,Success,40,44,0,15,25
20,Success,58,32,0,6,52
20,Success,49,34,3,14,35
20,Success,50,36,0,11,39
20,Success,50,37,7,6,44
20,Success,53,32,0,15,38
20,Success,49,30,9,12,37
20,Success,46,38,1,15,31
20,Success,52,33,0,14,38
20,Success,52,39,1,8,44
20,Success,48,43,0,5,43
20,Success,43,41,0,13,30
20,Success,57,27,3,13,44
20,Success,57,30,0,6,51
20,Success,52,34,0,14,38
20,Success,51,29,0,16,35
20,Success,40,40,0,16,24
20,Success,45,36,0,9,36
20,Success,51,35,2,12,39
20,Success,50,41,1,8,42
20,Success,48,38,6,8,40
20,Success,53,37,0,8,45
20,Success,39,38,0,18,21
20,Success,44,36,10,10,34
20,Success,47,38,8,7,40
20,Success,46,35,0,12,34
20,Success,40,50,0,10,30
20,Success,57,33,1,9,48
20,Success,40,39,3,18,22
20,Success,51,29,0,18,33
20,Success,48,28,11,13,35
20,Success,44,38,7,11,33
20,Success,40,39,8,13,27
20,Success,40,40,1,19,21
20,Success,57,33,0,10,47
20,Success,47,42,0,11,36
20,Success,52,36,5,7,45
20,Success,49,30,5,16,33
20,Success,46,40,0,13,33
20,Success,50,38,2,10,40
20,Success,40,32,10,18,22
20,Success,51,28,7,14,37
20,Success,56,27,9,8,48
20,Success,42,44,5,9,33
20,Success,53,33,0,13,40
20,Success,50,37,0,13,37
20,Success,51,39,0,9,42
20,Success,50,39,0,11,39
20,Success,47,35,0,17,30
20,Success,45,34,0,14,31
20,Success,51,32,5,12,39
20,Success,43,34,0,11,32
20,Success,45,37,0,17,28
20,Success,54,30,7,9,45
20,Success,47,39,0,9,38
20,Success,49,36,4,11,38
20,Success,49,38,1,12,37
20,Success,47,38,0,14,33
20,Success,52,31,0,15,37
20,Success,47,39,0,12,35
20,Success,43,40,0,9,34
20,Success,50,24,0,16,34
20,Success,51,36,3,10,41
20,Success,47,32,0,15,32
20,Success,39,37,0,19,20
20,Success,50,28,8,14,36
20,Success,41,41,0,16,25
20,Success,52,33,0,11,41
20,Success,43,38,4,15,28
20,Success,49,37,3,11,38
20,Success,53,33,3,11,42
20,Success,43,42,1,14,29
20,Success,50,28,0,22,28
20,Success,42,31,0,21,21
20,Success,55,30,2,13,42
20,Success,59,34,0,7,52
20,Success,50,35,0,15,35
20,Success,48,28,7,17,31
20,Success,50,33,0,14,36
20,Success,50,31,7,12,38
20,Success,49,35,0,16,33
20,Success,51,34,3,12,39
20,Success,45,39,5,11,34
20,Success,48,37,0,15,33
20,Success,49,33,2,16,33
20,Success,41,35,11,13,28
20,Success,44,41,8,7,37
20,Success,50,26,0,17,33
20,Success,39,39,0,16,23
20,Success,43,37,0,14,29
20,Success,48,36,0,7,41
20,Success,44,34,4,18,26
20,Success,48,34,0,13,35
20,Success,46,34,3,17,29
20,Success,53,33,0,9,44
20,Success,40,42,0,18,22
20,Success,49,42,0,9,40
20,Success,44,26,10,20,24
20,Success,51,37,2,10,41
20,Success,48,33,2,17,31
20,Success,42,35,11,12,30
20,Success,51,35,1,13,38
20,Success,47,36,4,13,34
20,Success,52,32,0,15,37
20,Success,52,31,2,15,37
20,Success,43,36,2,19,24
20,Success,48,37,0,15,33
20,Success,53,32,0,14,39
20,Success,48,35,5,12,36
20,Success,47,30,9,14,33
20,Success,49,32,4,15,34
20,Success,57,31,0,8,49
20,Success,51,33,0,16,35
20,Success,53,39,3,5,48
20,Success,56,29,3,12,44
20,Success,42,41,0,15,27
20,Success,45,42,0,11,34
20,Success,47,37,0,16,31
20,Success,42,38,0,12,30
20,Success,40,43,0,16,24
20,Success,43,37,0,12,31
20,Success,47,35,0,12,35
20,Success,53,29,6,12,41
20,Success,42,41,1,16,26
20,Success,41,43,0,13,28
20,Success,45,39,0,13,32
20,Success,41,37,0,19,22
20,Success,57,30,1,12,45
20,Success,48,37,2,13,35
20,Success,46,37,4,13,33
20,Success,44,36,0,11,33
20,Success,51,29,0,11,40
20,Success,51,35,4,10,41
20,Success,54,34,0,8,46
20,Success,44,35,0,18,26
20,Success,44,42,0,9,35
20,Success,39,44,5,12,27
20,Success,51,31,9,9,42
20,Success,55,35,0,10,45
20,Success,52,33,0,15,37
20,Success,51,28,4,17,34
20,Success,41,34,14,11,30
20,Success,50,33,0,15,35
20,Success,44,34,0,13,31
20,Success,54,34,4,8,46
20,Fail,39,38,3,20,19
20,Success,46,31,0,13,33
20,Success,46,39,0,15,31
20,Success,47,31,11,11,36
20,Success,49,28,0,9,40
20,Success,38,44,0,15,23
20,Success,40,41,9,10,30
20,Success,42,45,0,10,32
20,Success,48,35,0,14,34
20,Success,42,32,0,18,24
20,Success,41,34,0,15,26
20,Success,45,38,3,14,31
20,Success,50,37,1,12,38
20,Success,62,24,4,10,52
20,Fail,37,42,0,18,19
20,Success,56,28,0,10,46
20,Success,47,31,0,15,32
20,Success,52,31,0,17,35
20,Success,48,38,5,9,39
20,Success,51,33,0,7,44
20,Success,48,36,0,14,34
20,Success,52,32,0,13,39
20,Success,47,37,0,11,36
20,Success,52,36,0,9,43
20,Success,50,25,0,20,30
20,Success,47,38,0,12,35
20,Success,54,33,4,9,45
20,Success,54,34,0,12,42
20,Success,54,28,1,17,37
20,Success,43,38,7,12,31
20,Success,52,31,4,13,39
20,Success,53,35,0,11,42
20,Success,49,38,1,12,37
20,Success,54,30,0,14,40
20,Success,48,41,0,11,37
20,Success,58,35,0,6,52
20,Success,46,41,0,12,34
20,Success,58,34,0,7,51
20,Success,55,33,3,9,46
20,Success,52,36,0,6,46
20,Success,54,38,0,7,47
20,Success,45,46,3,6,39
20,Success,50,38,0,12,38
20,Success,46,37,0,14,32
20,Success,55,31,0,14,41
20,Success,48,31,4,17,31
20,Success,43,37,0,16,27
20,Success,43,43,1,13,30
20,Success,43,38,0,11,32
20,Success,44,30,12,14,30
20,Success,46,30,0,16,30
20,Success,49,37,0,14,35
20,Success,44,44,2,10,34
20,Success,41,35,10,14,27
20,Success,43,42,4,11,32
20,Success,51,32,0,16,35
20,Success,44,33,0,11,33
20,Success,57,28,0,12,45
20,Success,47,37,0,12,35
20,Success,51,36,1,12,39
20,Success,51,40,0,8,43
20,Success,52,35,0,8,44
20,Success,40,42,3,15,25
20,Success,46,31,5,18,28
20,Success,51,38,0,8,43
20,Success,43,41,0,9,34
20,Success,47,37,0,14,33
20,Success,51,39,1,9,42
20,Success,49,41,1,9,40
20,Success,44,34,0,15,29
20,Success,52,32,0,13,39
20,Success,42,36,7,15,27
20,Success,48,35,1,16,32
20,Success,46,34,0,17,29
20,Success,48,32,0,18,30
20,Success,44,42,4,10,34
20,Success,41,37,9,13,28
20,Success,51,34,0,14,37
20,Success,50,34,0,15,35
20,Success,49,36,0,15,34
20,Success,49,35,0,10,39
20,Success,37,47,0,13,24
20,Success,45,39,0,11,34
20,Success,45,33,3,19,26
20,Success,47,34,0,16,31
20,Success,50,38,0,12,38
20,Success,46,42,1,11,35
20,Success,52,30,4,14,38
20,Success,46,38,0,13,33
20,Success,50,35,0,14,36
20,Success,51,35,3,11,40
20,Success,50,31,10,9,41
20,Success,46,42,0,9,37
20,Success,47,39,0,14,33
20,Success,51,31,0,12,39
20,Success,49,34,1,16,33
20,Success,44,39,0,14,30
20,Success,47,35,3,15,32
20,Success,53,37,0,10,43
20,Success,50,42,0,7,43
20,Success,48,30,8,14,34
20,Success,54,32,0,14,40
20,Success,46,37,8,9,37
20,Success,55,38,0,7,48
20,Success,48,39,1,12,36
20,Success,51,33,0,14,37
20,Success,47,24,12,17,30
20,Success,43,37,0,17,26
20,Success,44,48,0,5,39
20,Success,41,37,10,12,29
20,Success,55,26,6,13,42
20,Success,42,40,4,14,28
20,Success,45,34,2,19,26
20,Success,50,35,0,11,39
20,Success,44,43,0,13,31
20,Success,54,29,4,13,41
20,Success,50,34,0,7,43
20,Success,53,34,1,12,41
20,Success,56,27,1,16,40
20,Success,55,34,0,11,44
20,Success,49,40,0,10,39
20,Success,51,24,0,17,34
20,Success,51,31,2,16,35
20,Success,42,43,5,10,32
20,Success,52,33,0,11,41
20,Success,47,34,0,17,30
20,Success,50,32,0,15,35
20,Success,42,39,0,12,30
20,Success,54,32,0,11,43
20,Success,41,41,3,15,26
20,Success,40,43,5,12,28
20,Success,49,37,0,14,35
20,Success,53,39,2,6,47
20,Success,44,35,6,15,29
20,Success,52,34,1,13,39
20,Success,50,26,6,18,32
20,Success,46,35,0,19,27
20,Success,50,34,3,13,37
20,Success,56,29,1,14,42
20,Success,53,25,0,13,40
20,Success,45,37,0,14,31
20,Success,45,38,8,9,36
20,Success,50,32,0,18,32
20,Success,51,33,0,12,39
20,Success,50,34,0,14,36
20,Success,58,35,0,7,51
20,Success,49,33,8,10,39
20,Success,49,35,3,13,36
20,Success,53,33,4,10,43
20,Success,57,30,4,9,48
20,Success,41,44,0,14,27
20,Success,47,33,3,17,30
20,Success,41,36,11,12,29
20,Success,47,36,3,14,33
20,Success,51,37,0,11,40
20,Success,39,33,0,18,21
20,Success,42,39,6,13,29
20,Success,44,40,7,9,35
20,Success,42,47,2,9,33
20,Success,48,33,6,13,35
20,Success,58,26,0,12,46
20,Success,44,39,4,13,31
20,Success,51,31,1,17,34
20,Success,49,32,0,16,33
20,Success,49,35,0,10,39
20,Success,49,41,0,9,40
20,Success,48,44,2,6,42
20,Success,56,35,0,8,48
20,Success,47,38,0,13,34
20,Success,55,35,0,9,46
20,Success,46,31,0,16,30
20,Success,52,34,3,11,41
20,Success,50,36,7,7,43
20,Success,47,38,5,10,37
20,Success,44,40,2,14,30
20,Success,46,33,5,16,30
20,Success,39,38,0,14,25
20,Success,47,41,0,6,41
20,Success,53,36,0,10,43
20,Success,48,35,0,13,35
20,Success,53,32,1,14,39
20,Success,38,45,0,16,22
20,Success,45,37,0,14,31
20,Success,53,31,1,15,38
20,Success,45,36,0,13,32
20,Success,49,41,2,8,41
20,Success,47,39,0,12,35
20,Success,57,26,7,10,47
20,Success,47,40,2,11,36
20,Success,41,39,4,16,25
20,Success,46,41,0,11,35
20,Success,50,33,3,14,36
20,Success,48,35,0,16,32
20,Success,50,34,5,11,39
20,Success,47,36,5,12,35
20,Success,49,36,0,9,40
20,Success,41,32,0,16,25
20,Success,52,36,3,9,43
20,Success,48,31,0,17,31
20,Success,40,32,9,19,21
20,Success,53,33,0,12,41
20,Success,54,32,2,12,42
20,Success,55,29,1,15,40
20,Success,51,33,1,15,36
20,Success,43,37,0,9,34
20,Success,45,40,0,13,32
20,Success,49,32,5,14,35
20,Success,43,36,7,14,29
20,Success,46,42,0,11,35
20,Success,37,38,11,14,23
20,Success,48,35,2,15,33
20,Success,41,45,5,9,32
20,Success,51,36,0,8,43
20,Success,49,37,5,9,40
20,Success,44,41,0,11,33
20,Success,50,36,0,14,36
20,Success,44,40,0,12,32
20,Success,54,34,2,10,44
20,Success,50,31,2,17,33
20,Success,46,44,0,10,36
20,Success,52,26,0,15,37
20,Success,47,41,0,10,37
20,Success,45,38,4,13,32
20,Success,48,35,7,10,38
20,Success,47,32,4,17,30
20,Success,41,36,0,20,21
20,Success,50,36,2,12,38
20,Success,54,33,2,11,43
20,Success,54,33,0,11,43
20,Success,51,38,0,10,41
20,Success,51,37,0,11,40
20,Success,48,35,0,13,35
20,Success,40,37,4,19,21
20,Success,47,39,0,12,35
20,Success,58,28,0,11,47
20,Success,50,37,0,7,43
20,Success,49,38,0,11,38
20,Success,44,31,14,11,33
20,Success,53,35,0,8,45
20,Success,57,31,0,11,46
20,Success,55,28,3,14,41
20,Success,45,40,0,12,33
20,Success,46,29,0,14,32
20,Success,45,40,0,13,32
20,Success,50,41,0,8,42
20,Success,41,45,0,12,29
20,Success,44,37,3,16,28
20,Success,46,40,2,12,34
20,Success,51,36,5,8,43
20,Success,44,44,3,9,35
20,Success,47,41,1,11,36
20,Success,46,32,11,11,35
20,Success,45,37,0,17,28
20,Success,45,48,0,7,38
20,Success,53,34,0,11,42
20,Success,53,26,0,16,37
20,Success,50,36,3,11,39
20,Success,49,43,0,8,41
20,Success,50,38,0,8,42
20,Success,43,41,0,11,32
20,Success,55,34,0,5,50
20,Success,51,28,0,18,33
20,Success,49,31,4,16,33
20,Success,57,33,1,9,48
20,Success,52,38,2,8,44
20,Success,43,41,0,11,32
20,Success,53,35,0,11,42
20,Success,48,35,7,10,38
20,Success,48,31,8,13,35
20,Success,53,30,3,14,39
20,Success,41,47,0,11,30
20,Success,58,27,2,13,45
20,Success,48,40,0,11,37
20,Success,52,29,3,16,36
20,Success,44,41,0,13,31
20,Success,40,37,0,15,25
20,Success,54,33,0,12,42
20,Success,52,32,0,12,40
20,Success,49,37,3,11,38
20,Success,56,40,2,2,54
20,Success,45,32,11,12,33
20,Success,56,34,0,8,48
20,Success,37,43,0,16,21
20,Success,50,34,5,11,39
20,Success,56,35,1,8,48
20,Success,46,38,0,12,34
20,Success,47,41,0,11,36
20,Success,48,39,0,8,40
20,Success,46,35,0,16,30
20,Success,56,33,0,7,49
20,Success,55,34,2,9,46
20,Success,51,35,2,12,39
20,Success,43,36,0,14,29
20,Success,45,29,0,13,32
20,Success,56,29,4,11,45
20,Success,44,38,1,17,27
20,Success,54,27,10,9,45
20,Success,48,38,2,12,36
20,Success,43,36,0,11,32
20,Success,47,35,6,12,35
20,Success,48,39,4,9,39
20,Success,58,26,0,12,46
20,Success,49,37,0,13,36
20,Success,46,42,0,12,34
20,Success,41,41,0,18,23
20,Success,47,35,0,16,31
20,Success,40,37,0,14,26
20,Success,48,34,4,14,34
20,Success,45,41,3,11,34
20,Success,43,41,3,13,30
20,Success,52,32,3,13,39
20,Success,53,28,0,17,36
20,Success,58,32,2,8,50
20,Success,43,34,9,14,29
20,Success,51,33,4,12,39
20,Success,52,34,0,9,43
20,Success,46,37,0,12,34
20,Success,42,42,0,10,32
20,Success,48,30,0,21,27
20,Success,54,34,0,10,44
20,Success,42,30,0,16,26
20,Success,46,32,3,19,27
20,Success,37,47,7,9,28
20,Success,43,38,6,13,30
20,Success,47,41,2,10,37
20,Success,42,35,0,19,23
20,Success,58,30,0,12,46
20,Success,43,41,4,12,31
20,Success,50,29,0,16,34
20,Success,55,28,0,13,42
20,Success,48,33,5,14,34
20,Success,48,36,0,10,38
20,Success,56,30,5,9,47
20,Success,49,39,0,9,40
20,Success,52,31,0,16,36
20,Success,38,42,3,17,21
20,Success,50,37,1,12,38
20,Success,42,35,0,14,28
20,Success,41,43,3,13,28
20,Success,50,34,1,15,35
20,Success,52,30,0,12,40
20,Success,46,33,5,16,30
20,Success,44,44,0,8,36
20,Success,42,35,5,18,24
20,Success,42,35,0,17,25
20,Success,50,35,0,10,40
20,Success,53,25,5,17,36
20,Success,45,37,0,16,29
20,Success,48,41,0,9,39
20,Success,50,37,0,10,40
20,Success,43,41,2,14,29
20,Success,53,31,0,16,37
20,Success,46,36,5,13,33
20,Success,42,39,0,11,31
20,Success,44,34,0,20,24
20,Success,46,39,0,15,31
20,Success,43,42,5,10,33
20,Success,46,35,5,14,32
20,Success,45,36,0,15,30
20,Success,44,44,0,12,32
20,Success,49,35,0,12,37
20,Success,50,36,3,11,39
20,Fail,39,26,11,24,15
20,Success,44,43,3,10,34
20,Success,51,28,0,14,37
20,Success,48,32,0,14,34
20,Success,50,34,0,6,44
20,Success,56,27,0,13,43
20,Success,44,40,5,11,33
20,Success,47,33,6,14,33
20,Success,46,36,10,8,38
20,Success,45,37,5,13,32
20,Success,57,35,0,7,50
20,Success,41,44,0,13,28
20,Success,42,43,4,11,31
20,Success,48,34,1,17,31
20,Success,46,38,5,11,35
20,Success,52,39,1,8,44
20,Success,55,34,0,9,46
20,Success,51,29,7,13,38
20,Success,53,33,1,13,40
20,Success,53,40,0,6,47
20,Success,45,34,0,10,35
20,Success,43,42,6,9,34
20,Success,43,46,0,7,36
20,Success,48,35,0,13,35
20,Success,45,37,0,16,29
20,Success,50,40,0,5,45
20,Success,57,32,1,10,47
20,Success,51,33,0,16,35
20,Success,45,32,0,8,37
20,Success,48,36,0,9,39
20,Success,41,35,0,16,25
20,Success,40,41,0,14,26
20,Success,41,41,0,15,26
20,Success,45,36,0,19,26
20,Success,51,32,5,12,39
20,Success,39,41,0,13,26
20,Success,45,39,0,10,35
20,Success,41,37,8,14,27
20,Success,54,36,0,10,44
20,Success,42,34,13,11,31
20,Success,48,35,0,17,31
20,Success,50,40,0,10,40
20,Success,46,42,1,11,35
20,Success,48,36,0,8,40
20,Success,46,39,0,14,32
20,Success,48,37,0,12,36
20,Success,48,41,2,9,39
20,Success,48,32,9,11,37
20,Success,47,38,0,12,35
20,Success,45,38,8,9,36
20,Success,42,38,0,14,28
20,Success,54,33,0,9,45
20,Success,56,34,0,10,46
20,Success,51,39,4,6,45
20,Success,48,45,0,6,42
20,Success,50,29,0,21,29
20,Success,44,33,0,16,28
20,Success,46,42,1,11,35
20,Success,50,31,8,11,39
20,Success,45,37,2,16,29
20,Success,43,40,0,11,32
20,Success,40,36,8,16,24
20,Success,43,38,0,14,29
20,Success,47,38,1,14,33
20,Success,52,37,0,11,41
20,Success,50,31,8,11,39
20,Success,56,32,0,9,47
20,Success,46,36,0,13,33
20,Success,41,43,1,15,26
20,Success,51,27,0,15,36
20,Success,48,35,4,13,35
20,Success,59,30,0,8,51
20,Success,47,39,0,12,35
20,Success,54,35,0,11,43
20,Success,51,29,0,14,37
20,Success,51,35,0,12,39
20,Success,47,34,0,12,35
20,Success,46,40,3,11,35
20,Success,54,33,0,8,46
20,Success,42,36,11,11,31
20,Success,54,32,6,8,46
20,Success,51,30,0,11,40
20,Success,45,44,2,9,36
20,Success,50,32,0,13,37
20,Success,51,38,0,11,40
20,Success,47,36,0,14,33
20,Success,50,39,0,9,41
20,Success,60,30,0,9,51
20,Success,43,41,0,9,34
20,Success,50,38,1,11,39
20,Success,45,39,5,11,34
20,Success,52,33,0,15,37
20,Success,58,32,4,6,52
20,Success,45,41,0,10,35
20,Success,46,34,6,14,32
20,Success,53,32,0,14,39
20,Success,53,37,0,9,44
20,Success,53,34,1,12,41
20,Success,45,34,6,15,30
20,Success,48,43,2,7,41
20,Success,46,42,0,9,37
20,Success,47,42,2,9,38
20,Success,48,36,0,13,35
20,Success,49,34,4,13,36
20,Success,46,31,0,13,33
20,Success,45,33,0,12,33
20,Success,53,32,7,8,45
20,Success,51,33,0,15,36
20,Success,54,29,3,14,40
20,Success,54,29,0,10,44
20,Success,51,28,0,12,39
20,Success,43,39,4,14,29
20,Success,49,33,0,8,41
20,Success,48,40,0,12,36
20,Success,44,34,8,14,30
20,Success,50,30,0,18,32
20,Success,43,26,0,16,27
20,Success,49,34,0,16,33
20,Success,55,32,4,9,46
20,Success,55,29,1,15,40
20,Success,43,38,0,12,31
20,Success,50,38,0,11,39
20,Success,51,32,0,13,38
20,Success,45,43,0,10,35
20,Success,48,36,2,14,34
20,Success,51,38,2,9,42
20,Success,53,32,0,13,40
20,Success,46,35,0,14,32
20,Success,51,35,0,12,39
20,Fail,36,35,11,18,18
20,Success,48,33,4,15,33
20,Success,41,32,0,15,26
20,Success,46,42,0,7,39
20,Success,48,35,0,12,36
20,Success,51,32,0,16,35
20,Success,46,41,7,6,40
20,Success,44,40,2,14,30
20,Success,42,38,2,18,24
20,Success,56,32,0,10,46
20,Success,51,31,5,13,38
20,Success,49,35,4,12,37
20,Success,44,30,0,14,30
20,Success,42,35,0,13,29
20,Success,47,32,6,15,32
20,Success,47,38,0,12,35
20,Success,51,39,0,10,41
20,Success,45,34,0,12,33
20,Success,44,44,0,10,34
20,Success,45,36,0,13,32
20,Success,43,40,0,17,26
20,Success,52,34,1,13,39
20,Success,49,33,0,14,35
20,Success,46,40,0,12,34
20,Success,50,30,3,17,33
20,Success,45,34,7,14,31
20,Success,49,31,0,10,39
20,Success,53,37,0,10,43
20,Success,44,38,5,13,31
20,Success,49,36,0,7,42
20,Success,54,35,1,10,44
20,Success,48,39,0,11,37
20,Success,48,40,2,10,38
20,Success,43,42,0,7,36
20,Success,50,38,0,12,38
20,Success,41,36,7,16,25
20,Success,45,38,1,16,29
20,Success,50,34,2,14,36
20,Success,53,29,7,11,42
20,Success,49,30,8,13,36
20,Success,51,36,0,13,38
20,Success,54,34,2,10,44
20,Success,47,34,7,12,35
20,Success,42,39,2,17,25
20,Success,43,37,0,16,27
20,Success,50,29,7,14,36
20,Success,49,31,6,14,35
20,Success,52,30,0,15,37
20,Success,42,37,9,12,30
20,Success,47,40,4,9,38
20,Success,43,43,0,12,31
20,Success,43,37,0,18,25
20,Success,47,37,0,11,36
20,Success,50,42,1,7,43
20,Success,52,33,0,7,45
20,Success,54,37,0,7,47
20,Success,47,37,1,15,32
20,Success,50,34,0,16,34
20,Success,59,29,1,11,48
20,Success,54,25,0,18,36
20,Success,54,35,0,8,46
20,Success,44,32,0,16,28
20,Success,45,48,0,7,38
20,Success,40,36,14,10,30
20,Success,48,38,3,11,37
20,Success,50,33,5,12,38
20,Success,45,34,0,16,29
20,Success,46,36,5,13,33
20,Success,50,32,6,12,38
20,Success,46,34,7,13,33
20,Success,47,34,4,15,32
20,Success,55,30,0,13,42
20,Success,51,38,1,10,41
20,Success,51,36,0,12,39
20,Success,46,42,1,11,35
20,Success,43,39,0,15,28
20,Success,51,34,0,15,36
20,Success,47,36,0,14,33
20,Success,48,35,3,14,34
20,Success,44,40,0,14,30
20,Success,49,30,0,14,35
20,Success,49,30,0,18,31
20,Success,45,37,2,16,29
20,Success,43,43,0,13,30
20,Success,51,33,0,10,41
20,Success,50,30,6,14,36
20,Success,40,41,0,11,29
20,Success,50,37,5,8,42
20,Success,43,33,7,17,26
20,Success,55,32,0,8,47
20,Success,43,33,0,13,30
20,Success,54,36,2,8,46
20,Success,45,39,5,11,34
20,Success,48,36,0,9,39
20,Success,52,32,2,14,38
20,Success,47,41,2,10,37
20,Success,49,40,0,10,39
20,Success,46,30,6,18,28
20,Success,41,40,0,15,26
20,Success,57,27,0,12,45
20,Success,42,37,6,15,27
20,Success,57,27,0,13,44
20,Success,48,41,4,7,41
20,Success,52,34,0,12,40
20,Success,48,35,4,13,35
20,Success,44,40,0,13,31
20,Success,52,36,0,9,43
20,Success,43,32,0,20,23
20,Success,60,29,0,11,49
20,Success,46,31,0,12,34
20,Success,42,36,6,16,26
20,Success,47,38,3,12,35
20,Success,42,39,6,13,29
20,Success,41,41,6,12,29
20,Fail,37,33,0,19,18
20,Success,47,40,0,10,37
20,Success,45,32,3,20,25
20,Success,45,41,0,8,37
20,Success,49,37,0,13,36
20,Success,44,32,2,22,22
20,Success,49,35,3,13,36
20,Success,53,32,7,8,45
20,Success,42,39,8,11,31
20,Success,46,42,0,11,35
20,Success,57,34,0,9,48
20,Success,50,32,6,12,38
20,Success,52,35,0,13,39
20,Success,55,32,0,8,47
20,Success,45,43,0,10,35
20,Success,46,32,7,15,31
20,Success,46,34,8,12,34
20,Success,39,47,4,10,29
20,Success,51,36,0,13,38
20,Success,50,34,0,16,34
20,Fail,37,35,8,20,17
20,Success,42,41,0,12,30
20,Success,45,34,0,18,27
20,Success,49,35,0,16,33
20,Success,50,34,3,13,37
20,Success,50,35,7,8,42
20,Success,55,30,3,12,43
20,Success,41,37,0,15,26
20,Success,42,37,3,18,24
20,Success,47,42,0,9,38
20,Success,48,34,2,16,32
20,Success,49,39,1,11,38
20,Success,45,40,8,7,38
20,Success,57,32,0,10,47
20,Success,47,37,0,16,31
20,Success,53,37,1,9,44
20,Success,53,30,0,17,36
20,Success,47,35,1,17,30
20,Success,54,42,0,4,50
20,Success,46,26,10,18,28
20,Success,50,33,0,13,37
20,Success,52,32,4,12,40
20,Success,48,41,0,11,37
20,Success,46,42,2,10,36
20,Success,52,35,0,8,44
20,Success,42,48,1,9,33
20,Success,44,43,2,11,33
20,Success,45,40,3,12,33
20,Success,56,29,5,10,46
20,Success,36,40,0,10,26
20,Success,43,33,8,16,27
20,Success,47,29,7,17,30
20,Success,45,35,0,14,31
20,Success,54,30,2,14,40
20,Success,44,38,0,16,28
20,Success,44,40,0,16,28
20,Fail,33,43,0,22,11
20,Success,44,39,6,11,33
20,Success,47,41,0,12,35
20,Success,45,37,4,14,31
20,Success,45,42,3,10,35
20,Success,51,33,0,16,35
20,Success,46,39,4,11,35
20,Success,46,38,0,12,34
20,Success,39,38,5,18,21
20,Success,48,33,3,16,32
20,Success,50,33,0,12,38
20,Success,43,34,0,20,23
20,Success,44,38,0,12,32
20,Success,41,36,9,14,27
20,Success,52,31,0,15,37
20,Success,48,39,0,12,36
20,Success,51,34,1,14,37
20,Success,49,34,0,11,38
20,Success,42,38,0,18,24
20,Success,51,32,3,14,37
20,Success,48,38,0,11,37
20,Success,38,39,0,10,28
20,Success,44,44,0,12,32
20,Success,49,37,1,13,36
20,Success,50,37,0,13,37
20,Success,47,35,5,13,34
20,Success,45,33,7,15,30
20,Success,54,32,0,10,44
20,Success,48,29,0,18,30
20,Success,47,41,0,11,36
20,Success,53,32,5,10,43
20,Success,45,36,5,14,31
20,Success,46,35,0,11,35
20,Success,43,41,5,11,32
20,Success,46,38,2,14,32
20,Success,52,29,0,14,38
20,Success,46,29,0,18,28
20,Success,57,32,1,10,47
20,Success,51,35,0,9,42
20,Success,52,34,0,8,44
20,Success,49,27,0,12,37
20,Success,51,32,5,12,39
20,Success,41,38,0,15,26
20,Success,53,30,0,13,40
20,Success,52,33,0,13,39
20,Success,51,37,1,11,40
20,Success,47,38,2,13,34
20,Success,51,33,1,15,36
20,Success,45,39,0,15,30
20,Success,45,39,6,10,35
20,Success,43,43,0,13,30
20,Success,52,31,5,12,40
20,Fail,40,34,0,21,19
20,Success,46,38,1,15,31
20,Success,49,41,0,10,39
20,Success,44,40,4,12,32
20,Success,41,37,5,17,24
20,Success,52,34,0,12,40
20,Success,41,44,0,9,32
20,Success,46,38,0,15,31
20,Success,42,35,1,22,20
20,Success,47,34,0,11,36
20,Success,44,34,0,15,29
20,Success,44,42,4,10,34
20,Success,62,29,0,8,54
20,Success,53,31,0,9,44
20,Success,48,42,0,9,39
20,Success,41,41,8,10,31
20,Success,52,35,3,10,42
20,Success,53,36,0,8,45
20,Success,46,36,6,12,34
20,Success,52,39,0,8,44
20,Success,46,37,0,13,33
20,Success,42,40,5,13,29
20,Success,43,31,7,19,24
20,Success,51,33,0,13,38
20,Success,45,32,10,13,32
20,Success,51,34,3,12,39
20,Success,57,33,4,6,51
20,Success,50,33,0,17,33
20,Success,45,42,0,13,32
20,Success,46,32,0,16,30
20,Success,51,24,12,13,38
20,Success,52,35,0,11,41
20,Success,53,31,3,13,40
20,Success,43,26,0,19,24
20,Success,50,34,0,15,35
20,Success,49,30,5,16,33
20,Success,56,31,3,10,46
20,Success,42,36,3,19,23
20,Success,46,39,0,14,32
20,Success,58,26,6,10,48
20,Success,46,34,7,13,33
20,Success,45,35,3,17,28
20,Success,54,24,0,14,40
20,Success,53,37,0,8,45
20,Success,53,34,0,10,43
20,Success,53,36,5,6,47
20,Success,43,34,9,14,29
20,Success,44,37,0,14,30
20,Success,51,28,0,14,37
20,Success,48,33,0,18,30
20,Success,42,35,6,17,25
20,Success,46,37,4,13,33
20,Success,48,38,1,13,35
20,Success,50,36,1,13,37
20,Success,52,34,0,14,38
20,Success,48,38,0,9,39
20,Success,51,30,0,14,37
20,Success,44,32,10,14,30
20,Success,45,38,0,15,30
20,Success,50,34,0,15,35
20,Success,41,43,0,15,26
20,Success,41,37,0,18,23
20,Success,51,38,1,10,41
20,Success,52,31,0,12,40
20,Success,43,35,11,11,32
20,Success,50,32,3,15,35
20,Success,48,36,3,13,35
20,Success,53,32,0,13,40
20,Success,49,36,4,11,38
20,Success,49,38,0,13,36
20,Success,52,35,0,10,42
20,Success,48,30,0,14,34
20,Success,55,25,9,11,44
20,Success,49,33,7,11,38
20,Success,49,33,4,14,35
20,Success,50,30,2,18,32
20,Success,43,37,0,16,27
20,Success,54,28,0,8,46
20,Success,49,30,0,13,36
20,Success,45,36,0,13,32
20,Success,49,34,0,15,34
20,Success,54,27,5,14,40
20,Success,43,37,9,11,32
20,Success,47,35,0,13,34
20,Success,58,26,5,11,47
20,Success,49,37,0,9,40
20,Success,54,39,1,6,48
20,Success,50,32,6,12,38
20,Success,49,39,0,9,40
20,Success,49,34,4,13,36
20,Success,51,32,0,15,36
20,Success,58,22,7,13,45
20,Fail,33,40,8,19,14
20,Success,58,31,0,9,49
20,Success,46,41,0,12,34
20,Success,40,42,2,16,24
20,Success,43,36,0,11,32
20,Success,51,30,2,17,34
20,Success,51,27,0,13,38
20,Success,50,36,0,9,41
20,Success,43,34,0,15,28
20,Success,49,37,0,11,38
20,Success,45,33,0,16,29
20,Success,49,32,7,12,37
20,Success,47,30,6,17,30
20,Success,48,34,0,12,36
20,Success,49,29,0,12,37
20,Success,55,30,0,13,42
20,Success,42,42,0,12,30
20,Success,54,33,0,10,44
20,Success,55,34,0,7,48
20,Success,48,39,0,9,39
20,Success,47,35,5,13,34
20,Success,49,31,3,17,32
20,Success,55,32,0,12,43
20,Success,57,24,0,9,48
20,Success,52,34,0,13,39
20,Success,49,36,0,13,36
20,Success,43,32,0,22,21
20,Success,62,26,3,9,53
20,Success,45,38,0,12,33
20,Success,58,28,0,8,50
20,Success,46,33,4,17,29
20,Success,50,38,0,9,41
20,Success,47,46,0,6,41
20,Success,38,41,0,13,25
20,Success,48,40,0,8,40
20,Success,40,39,0,18,22
20,Success,58,31,1,10,48
20,Success,44,43,0,8,36
20,Success,46,36,3,15,31
20,Fail,37,40,4,19,18
20,Success,53,40,0,6,47
20,Success,58,26,5,11,47
20,Success,46,40,6,8,38
20,Success,45,32,8,15,30
20,Success,52,35,3,10,42
20,Success,43,42,0,13,30
20,Success,54,26,0,18,36
20,Success,49,32,4,15,34
20,Success,52,32,5,11,41
20,Success,47,37,0,12,35
20,Success,48,36,0,14,34
20,Success,48,38,1,13,35
20,Success,45,45,0,10,35
20,Success,42,48,0,9,33
20,Success,37,47,0,13,24
20,Success,50,39,0,10,40
20,Success,56,28,0,10,46
20,Success,51,35,0,12,39
20,Success,50,36,0,11,39
20,Success,52,32,6,10,42
20,Success,42,36,10,12,30
20,Success,43,32,7,18,25
20,Success,55,37,0,7,48
20,Success,40,50,0,10,30
20,Success,45,35,2,18,27
20,Success,53,37,3,7,46
20,Success,47,36,2,15,32
20,Success,54,33,3,10,44
20,Success,42,39,5,14,28
20,Success,51,37,0,10,41
20,Success,47,38,2,13,34
20,Success,47,42,0,8,39
20,Success,54,31,0,14,40
20,Success,48,36,0,16,32
20,Success,46,36,0,15,31
20,Success,40,40,2,18,22
20,Success,56,32,0,11,45
20,Success,49,29,0,16,33
20,Success,48,31,0,19,29
20,Success,46,36,5,13,33
20,Success,46,32,9,13,33
20,Success,47,36,0,12,35
20,Success,43,41,4,12,31
20,Success,48,33,0,13,35
20,Success,45,45,0,10,35
20,Success,47,34,0,14,33
20,Success,50,39,1,10,40
20,Success,54,24,0,12,42
20,Success,39,41,4,16,23
20,Success,45,36,0,17,28
20,Success,58,33,2,7,51
20,Success,49,36,2,13,36
20,Success,44,42,2,12,32
20,Success,47,40,0,10,37
20,Success,53,35,0,10,43
20,Success,46,38,0,12,34
20,Success,51,35,0,13,38
20,Success,47,39,0,11,36
20,Success,51,35,2,12,39
20,Success,47,31,0,12,35
20,Success,47,31,0,15,32
20,Success,52,31,0,11,41
20,Success,49,41,0,8,41
20,Success,50,37,6,7,43
20,Success,46,30,9,15,31
20,Success,43,37,0,16,27
20,Success,40,40,9,11,29
20,Success,46,33,0,11,35
20,Success,53,35,1,11,42
20,Success,58,27,1,14,44
20,Success,43,37,0,15,28
20,Success,44,30,7,19,25
20,Success,44,38,2,16,28
20,Success,48,41,1,10,38
20,Success,50,41,0,8,42
20,Success,45,40,0,11,34
20,Success,44,39,2,15,29
20,Success,51,29,0,15,36
20,Success,46,37,0,9,37
20,Success,42,36,8,14,28
20,Success,46,40,4,10,36
20,Success,41,42,0,11,30
20,Success,40,41,3,16,24
20,Success,55,36,0,8,47
20,Success,56,31,1,12,44
20,Success,45,33,0,16,29
20,Success,41,34,7,18,23
20,Success,52,25,0,15,37
20,Success,47,34,8,11,36
20,Success,50,26,4,20,30
20,Success,46,38,0,16,30
20,Success,44,35,0,13,31
20,Fail,40,29,6,25,15
20,Success,45,41,0,11,34
20,Success,45,39,0,12,33
20,Success,42,43,0,15,27
20,Success,47,37,3,13,34
20,Success,51,36,0,10,41
20,Success,50,33,9,8,42
20,Success,45,33,11,11,34
20,Success,53,31,0,11,42
20,Success,51,40,3,6,45
20,Success,43,43,7,7,36
20,Success,50,26,9,15,35
20,Success,48,38,0,13,35
20,Success,52,31,2,15,37
20,Success,50,42,0,4,46
20,Success,49,40,0,10,39
20,Success,43,40,0,13,30
20,Success,50,38,0,11,39
20,Success,55,30,3,12,43
20,Success,47,37,3,13,34
20,Success,47,40,0,13,34
20,Success,45,37,4,14,31
20,Success,48,30,2,20,28
20,Success,44,37,6,13,31
20,Success,46,36,7,11,35
20,Success,48,36,0,9,39
20,Success,56,24,0,13,43
20,Success,55,33,1,11,44
20,Success,46,43,2,9,37
20,Success,51,35,0,10,41
20,Success,37,40,6,17,20
20,Success,52,42,0,6,46
20,Success,48,29,6,17,31
20,Success,45,36,0,14,31
20,Success,49,32,7,12,37
20,Success,43,31,4,22,21
20,Success,52,31,0,16,36
20,Success,48,36,0,15,33
20,Success,53,37,0,10,43
20,Success,47,42,1,10,37
20,Success,55,37,4,4,51
20,Success,47,38,0,11,36
20,Success,42,34,7,17,25
20,Success,51,28,3,18,33
20,Success,46,36,0,17,29
20,Success,47,40,0,12,35
20,Success,45,34,0,16,29
20,Success,43,44,1,12,31
20,Success,45,32,0,10,35
20,Success,47,32,0,17,30
20,Success,51,35,0,9,42
20,Success,49,35,0,15,34
20,Success,52,28,5,15,37
20,Success,44,39,2,15,29
20,Success,49,38,0,13,36
20,Success,49,30,0,12,37
20,Success,44,36,8,12,32
20,Success,51,36,2,11,40
20,Success,44,37,7,12,32
20,Success,46,39,6,9,37
20,Success,43,36,6,15,28
20,Success,61,30,0,7,54
20,Success,53,36,0,10,43
20,Success,54,35,5,6,48
20,Success,56,35,0,6,50
20,Success,50,29,0,20,30
20,Success,45,37,7,11,34
20,Success,58,31,1,10,48
20,Success,48,36,5,11,37
20,Success,47,36,0,12,35
20,Success,44,42,2,12,32
20,Success,44,38,2,16,28
20,Success,46,42,0,11,35
20,Success,53,36,0,10,43
20,Success,49,34,7,10,39
20,Success,41,43,0,13,28
20,Success,48,32,0,14,34
20,Success,48,33,0,14,34
20,Success,51,33,0,16,35
20,Success,43,38,6,13,30
20,Success,54,34,0,10,44
20,Success,42,36,0,21,21
20,Success,47,31,0,19,28
20,Success,47,36,0,14,33
20,Success,55,32,0,12,43
20,Success,51,30,0,11,40
20,Success,47,35,10,8,39
20,Success,43,37,0,11,32
20,Success,43,41,0,15,28
20,Success,41,43,0,9,32
20,Success,49,33,0,12,37
20,Fail,37,37,0,19,18
20,Success,47,34,10,9,38
20,Success,46,39,2,13,33
20,Success,42,37,0,18,24
20,Success,51,35,0,11,40
20,Success,56,32,0,12,44
20,Success,45,35,10,10,35
20,Success,49,37,0,13,36
20,Success,48,35,0,17,31
20,Success,51,31,0,10,41
20,Success,47,43,0,10,37
20,Success,44,41,2,13,31
20,Success,44,34,6,16,28
20,Success,51,36,3,10,41
20,Success,47,43,0,7,40
20,Success,50,30,0,14,36
20,Success,48,28,0,16,32
20,Success,42,34,0,19,23
20,Success,52,37,0,9,43
20,Success,43,36,0,19,24
20,Success,57,33,2,8,49
20,Success,43,29,0,16,27
20,Success,51,34,0,11,40
20,Success,44,32,8,16,28
20,Success,53,32,1,14,39
20,Success,46,36,6,12,34
20,Success,41,38,5,16,25
20,Success,43,35,0,17,26
20,Success,40,37,0,14,26
20,Success,45,40,4,11,34
20,Success,47,39,0,11,36
20,Success,53,41,1,5,48
20,Success,58,31,0,9,49
20,Success,50,35,1,14,36
20,Success,47,35,0,10,37
20,Success,52,34,5,9,43
20,Success,44,37,6,13,31
20,Success,48,34,0,17,31
20,Success,43,40,2,15,28
20,Success,47,44,2,7,40
20,Success,47,32,4,17,30
20,Success,48,36,0,10,38
20,Success,49,36,3,12,37
20,Success,54,32,0,10,44
20,Success,48,38,0,8,40
20,Success,42,40,0,14,28
20,Success,56,31,0,12,44
20,Success,44,33,0,14,30
20,Success,43,38,0,14,29
20,Success,52,32,0,15,37
20,Success,47,37,2,14,33
20,Success,52,37,3,8,44
20,Success,49,34,0,17,32
20,Success,44,39,8,9,35
20,Success,51,40,1,8,43
20,Success,47,38,5,10,37
20,Success,49,38,0,12,37
20,Success,57,32,0,10,47
20,Success,38,39,11,12,26
20,Success,45,40,2,13,32
20,Success,46,33,5,16,30
20,Success,48,38,0,13,35
20,Success,47,36,0,9,38
20,Success,45,36,4,15,30
20,Success,49,36,2,13,36
20,Success,46,41,2,11,35
20,Success,58,27,8,7,51
20,Success,38,43,5,14,24
20,Success,41,40,2,17,24
20,Success,43,40,4,13,30
20,Success,51,36,0,12,39
20,Success,45,33,0,19,26
20,Success,57,39,1,3,54
20,Success,41,37,0,13,28
20,Success,45,31,15,9,36
20,Success,47,43,0,6,41
20,Success,45,36,0,13,32
20,Success,46,44,1,9,37
20,Success,45,38,0,12,33
20,Success,58,32,3,7,51
20,Success,49,30,6,15,34
20,Success,56,34,0,9,47
20,Success,51,33,0,14,37
20,Success,45,38,2,15,30
20,Success,45,35,0,18,27
20,Success,50,39,0,11,39
20,Success,49,38,0,12,37
20,Success,49,38,0,11,38
20,Success,45,32,7,16,29
20,Success,43,32,0,18,25
20,Success,51,29,6,14,37
20,Success,44,40,1,15,29
20,Success,45,39,0,15,30
20,Success,43,38,3,16,27
20,Success,53,35,0,12,41
20,Success,42,38,0,11,31
20,Success,62,25,0,8,54
20,Success,45,32,6,17,28
20,Success,53,35,0,11,42
20,Success,45,36,6,13,32
20,Success,47,35,0,17,30
20,Success,47,35,0,14,33
20,Success,44,37,2,17,27
20,Success,58,35,0,4,54
20,Success,50,32,0,11,39
20,Success,52,36,0,9,43
20,Success,39,40,0,16,23
20,Success,59,27,2,12,47
20,Success,55,31,4,10,45
20,Success,55,36,4,5,50
20,Success,43,35,6,16,27
20,Success,47,33,5,15,32
20,Success,40,34,7,19,21
20,Success,44,45,0,7,37
20,Success,48,29,0,15,33
20,Success,53,35,1,11,42
20,Success,51,38,0,6,45
20,Success,56,28,3,13,43
20,Success,49,34,0,16,33
20,Success,51,35,0,14,37
20,Success,44,35,0,19,25
20,Success,52,36,2,10,42
20,Success,41,40,0,14,27
20,Success,50,37,1,12,38
20,Success,41,40,5,14,27
20,Success,50,38,3,9,41
20,Success,52,35,0,9,43
20,Success,55,35,4,6,49
20,Success,38,37,0,16,22
20,Success,47,35,0,10,37
20,Success,47,38,0,10,37
20,Success,49,33,0,16,33
20,Success,47,40,5,8,39
20,Success,51,38,1,10,41
20,Success,52,31,1,16,36
20,Success,49,37,0,13,36
20,Success,50,36,2,12,38
20,Success,55,26,7,12,43
20,Success,50,42,0,8,42
20,Success,50,34,4,12,38
20,Success,45,35,0,13,32
20,Success,44,35,0,15,29
20,Success,47,34,0,11,36
20,Success,46,46,0,8,38
20,Success,48,37,2,13,35
20,Success,50,41,1,8,42
20,Success,46,42,1,11,35
20,Success,53,34,0,12,41
20,Success,45,40,0,8,37
20,Success,46,38,0,14,32
20,Success,39,42,3,16,23
20,Success,51,35,6,8,43
20,Success,47,43,1,9,38
20,Success,51,34,0,13,38
20,Success,49,37,4,10,39
20,Success,57,24,4,15,42
20,Success,56,36,0,8,48
20,Success,52,33,4,11,41
20,Fail,36,42,5,17,19
20,Success,53,36,0,10,43
20,Success,48,38,4,10,38
20,Success,55,38,0,7,48
20,Success,46,34,0,13,33
20,Success,38,40,10,12,26
20,Success,51,34,0,11,40
20,Success,48,35,5,12,36
20,Success,53,34,1,12,41
20,Success,54,29,1,16,38
20,Success,40,34,6,20,20
20,Success,48,29,0,16,32
20,Success,46,37,3,14,32
20,Success,51,34,1,14,37
20,Success,47,37,4,12,35
20,Success,45,37,7,11,34
20,Success,47,35,4,14,33
20,Success,47,38,0,9,38
20,Success,44,42,4,10,34
20,Success,55,33,3,9,46
20,Success,50,40,0,10,40
20,Success,43,38,4,15,28
20,Success,48,38,1,13,35
20,Success,47,37,0,16,31
20,Success,47,33,2,18,29
20,Success,37,48,0,15,22
20,Success,45,41,2,12,33
20,Success,45,38,0,9,36
20,Success,50,36,1,13,37
20,Success,41,43,8,8,33
20,Success,41,39,0,15,26
20,Success,45,35,8,12,33
20,Success,50,38,0,12,38
20,Success,49,31,0,8,41
20,Success,43,35,0,19,24
20,Success,51,34,1,14,37
20,Success,51,40,0,6,45
20,Success,57,36,4,3,54
20,Success,51,36,2,11,40
20,Success,52,35,2,11,41
20,Success,39,36,9,16,23
20,Success,53,32,6,9,44
20,Success,50,41,2,7,43
20,Success,50,33,0,11,39
20,Success,55,28,4,13,42
20,Success,51,35,0,10,41
20,Success,48,45,1,6,42
20,Success,51,32,1,16,35
20,Success,53,34,0,10,43
20,Success,43,36,0,16,27
20,Success,48,29,3,20,28
20,Success,45,37,0,17,28
20,Success,49,36,6,9,40
20,Success,48,31,0,15,33
20,Success,48,42,0,9,39
20,Success,42,36,8,14,28
20,Success,42,38,0,15,27
20,Success,55,25,0,16,39
20,Success,47,32,2,19,28
20,Success,41,37,0,15,26
20,Success,47,35,6,12,35
20,Success,47,36,5,12,35
20,Success,47,34,0,14,33
20,Success,49,37,3,11,38
20,Success,42,44,2,12,30
20,Success,45,35,0,15,30
20,Success,42,40,8,10,32
20,Success,44,39,4,13,31
20,Success,41,37,7,15,26
20,Success,52,28,8,12,40
20,Fail,37,37,4,22,15
20,Success,48,33,7,12,36
20,Success,49,33,6,12,37
20,Success,53,39,1,7,46
20,Success,50,36,0,13,37
20,Success,45,42,0,12,33
20,Success,47,35,0,12,35
20,Success,48,31,0,16,32
20,Success,45,39,1,15,30
20,Success,50,32,0,18,32
20,Success,44,42,0,11,33
20,Success,47,38,6,9,38
20,Success,49,38,0,12,37
20,Success,50,36,0,13,37
20,Success,48,36,0,12,36
20,Success,45,44,0,10,35
20,Success,47,42,0,11,36
20,Success,45,45,0,8,37
20,Success,47,39,0,12,35
20,Success,55,34,0,5,50
20,Success,53,37,2,8,45
20,Success,44,46,1,9,35
20,Success,53,32,0,10,43
20,Success,48,35,0,14,34
20,Success,58,31,2,9,49
20,Success,52,26,0,13,39
20,Success,49,42,0,7,42
20,Success,53,34,0,11,42
20,Success,43,42,0,7,36
20,Success,41,41,6,12,29
20,Success,51,38,0,11,40
20,Success,45,38,6,11,34
20,Success,49,37,2,12,37
20,Success,45,42,0,10,35
20,Success,52,31,0,12,40
20,Success,46,35,0,18,28
20,Success,43,36,0,18,25
20,Success,48,36,0,11,37
20,Success,47,39,0,10,37
20,Success,48,36,0,15,33
20,Success,42,38,0,16,26
20,Success,40,44,2,14,26
20,Success,54,33,6,7,47
20,Success,44,29,0,17,27
20,Success,47,43,1,9,38
20,Success,53,29,4,14,39
20,Success,47,32,6,15,32
20,Success,55,33,0,11,44
20,Success,51,40,0,9,42
20,Success,46,36,2,16,30
20,Success,41,39,0,15,26
20,Success,49,31,0,15,34
20,Success,48,36,5,11,37
20,Success,42,31,0,19,23
20,Success,47,32,9,12,35
20,Success,47,38,0,15,32
20,Success,45,37,3,15,30
20,Success,58,28,0,10,48
20,Success,46,34,0,12,34
20,Success,53,30,7,10,43
20,Success,48,27,5,20,28
20,Success,47,37,0,9,38
20,Success,55,34,1,10,45
20,Success,53,33,2,12,41
20,Success,48,33,6,13,35
20,Success,53,31,0,15,38
20,Success,44,34,11,11,33
20,Success,45,40,3,12,33
20,Success,43,38,6,13,30
20,Success,50,30,6,14,36
20,Success,48,43,3,6,42
20,Success,50,33,0,17,33
20,Success,54,31,0,13,41
20,Success,45,39,3,13,32
20,Success,43,41,2,14,29
20,Success,43,41,2,14,29
20,Success,47,33,3,17,30
20,Success,47,39,0,13,34
20,Success,55,28,7,10,45
20,Success,49,32,8,11,38
20,Success,50,38,3,9,41
20,Success,44,42,6,8,36
20,Success,48,38,3,11,37
20,Success,52,33,0,13,39
20,Success,40,33,8,19,21
20,Success,45,36,0,15,30
20,Success,46,32,10,12,34
20,Success,48,39,0,13,35
20,Success,49,34,4,13,36
20,Success,45,37,0,14,31
20,Success,42,40,0,15,27
20,Success,43,32,5,20,23
20,Success,47,33,2,18,29
20,Success,42,37,8,13,29
20,Success,46,37,0,17,29
20,Success,50,37,2,11,39
20,Success,52,33,0,11,41
20,Success,48,32,0,12,36
20,Success,40,46,0,13,27
20,Success,50,30,8,12,38
20,Success,48,31,0,18,30
20,Success,55,34,0,11,44
20,Success,41,37,0,18,23
20,Success,53,32,4,11,42
20,Success,45,39,0,13,32
20,Success,42,38,0,16,26
20,Success,46,38,0,12,34
20,Success,49,35,7,9,40
20,Success,46,39,0,11,35
20,Success,51,39,4,6,45
20,Success,55,37,0,7,48
20,Success,50,36,1,13,37
20,Success,53,30,0,8,45
20,Success,41,37,8,14,27
20,Success,49,35,0,12,37
20,Success,46,49,0,4,42
20,Success,47,33,0,15,32
20,Success,49,30,0,20,29
20,Success,49,36,0,12,37
20,Success,42,39,4,15,27
20,Success,55,28,0,9,46
20,Success,56,33,0,10,46
20,Success,46,28,0,18,28
20,Success,46,36,3,15,31
20,Success,49,44,2,5,44
20,Success,53,32,0,15,38
20,Success,61,28,0,10,51
20,Success,50,37,5,8,42
20,Success,46,40,4,10,36
20,Success,49,37,0,14,35
20,Success,44,39,0,12,32
20,Success,48,38,6,8,40
20,Success,45,44,1,10,35
20,Success,54,37,1,8,46
20,Success,43,42,0,15,28
20,Success,43,40,3,14,29
20,Success,48,39,0,11,37
20,Success,46,31,0,17,29
20,Success,52,38,2,8,44
20,Success,43,36,8,13,30
20,Success,44,40,6,10,34
20,Success,43,36,5,16,27
20,Success,43,45,0,10,33
20,Success,48,40,0,11,37
20,Success,47,36,0,14,33
20,Success,56,36,0,7,49
20,Success,48,43,0,9,39
20,Success,50,30,0,12,38
20,Success,45,43,3,9,36
20,Success,40,34,0,16,24
20,Success,42,37,5,16,26
20,Success,54,30,0,11,43
20,Success,44,39,7,10,34
20,Success,51,31,0,14,37
20,Success,47,35,0,13,34
20,Success,40,47,0,7,33
20,Success,47,32,5,16,31
20,Success,42,47,2,9,33
20,Success,60,29,0,11,49
20,Success,41,38,0,17,24
20,Success,51,30,0,14,37
20,Success,52,32,6,10,42
20,Success,51,26,6,17,34
20,Success,49,32,0,17,32
20,Success,53,32,0,14,39
20,Success,43,39,6,12,31
20,Success,55,28,5,12,43
20,Success,44,33,0,17,27
20,Success,47,38,3,12,35
20,Success,43,40,0,15,28
20,Success,51,31,2,16,35
20,Success,51,35,3,11,40
20,Success,46,39,0,10,36
20,Success,55,32,0,10,45
20,Success,53,36,0,10,43
20,Success,51,34,0,11,40
20,Success,44,41,0,13,31
20,Success,43,41,0,16,27
20,Success,50,35,3,12,38
20,Success,42,40,3,15,27
20,Success,46,39,2,13,33
20,Success,49,37,0,12,37
20,Success,40,45,3,12,28
20,Success,45,40,0,15,30
20,Success,51,34,1,14,37
20,Success,46,39,0,15,31
20,Success,46,40,0,11,35
20,Success,53,37,0,8,45
20,Success,46,41,0,13,33
20,Success,44,33,0,11,33
20,Success,43,43,0,12,31
20,Success,53,32,0,12,41
20,Success,46,35,8,11,35
20,Success,51,31,0,15,36
20,Success,42,43,4,11,31
20,Fail,33,41,0,14,19
20,Success,49,35,0,13,36
20,Success,47,35,0,18,29
20,Success,53,35,4,8,45
20,Success,42,37,0,17,25
20,Success,45,29,0,16,29
20,Success,46,35,0,15,31
20,Success,44,36,7,13,31
20,Success,50,33,0,11,39
20,Success,47,39,0,13,34
20,Success,51,32,0,12,39
20,Success,51,31,6,12,39
20,Success,48,38,2,12,36
20,Success,45,39,3,13,32
20,Success,42,39,5,14,28
20,Success,47,29,11,13,34
20,Success,45,34,8,13,32
20,Success,52,30,0,15,37
20,Success,50,33,7,10,40
20,Success,58,29,3,10,48
20,Success,46,36,5,13,33
20,Success,52,26,4,18,34
20,Success,49,29,7,15,34
20,Success,47,34,0,15,32
20,Success,56,32,5,7,49
20,Success,53,34,0,12,41
20,Success,47,36,3,14,33
20,Success,41,39,0,11,30
20,Success,41,41,5,13,28
20,Success,48,36,6,10,38
20,Success,45,39,5,11,34
20,Success,56,32,5,7,49
20,Success,50,32,0,14,36
20,Success,53,32,0,10,43
20,Success,51,36,0,13,38
20,Success,50,39,0,10,40
20,Success,42,34,7,17,25
20,Success,43,48,1,8,35
20,Success,47,38,6,9,38
20,Success,51,28,6,15,36
20,Success,53,28,0,13,40
20,Success,42,36,0,14,28
20,Success,46,42,0,8,38
20,Success,45,34,0,13,32
20,Success,47,38,0,13,34
20,Success,53,34,2,11,42
20,Success,46,33,0,18,28
20,Success,43,39,2,16,27
20,Success,51,36,6,7,44
20,Success,48,36,4,12,36
20,Success,48,30,6,16,32
20,Success,48,31,6,15,33
20,Success,56,38,0,6,50
20,Success,50,36,3,11,39
20,Success,49,37,4,10,39
20,Success,37,44,0,13,24
20,Success,48,41,3,8,40
20,Fail,39,34,0,21,18
20,Success,46,38,0,13,33
20,Success,44,35,4,17,27
20,Success,49,34,8,9,40
20,Success,49,37,2,12,37
20,Fail,41,32,5,22,19
20,Success,37,41,5,17,20
20,Success,46,31,7,16,30
20,Success,41,40,0,12,29
20,Success,49,37,1,13,36
20,Success,48,34,5,13,35
20,Success,40,40,1,19,21
20,Success,51,31,0,16,35
20,Success,46,38,0,15,31
20,Success,47,30,9,14,33
20,Success,47,33,5,15,32
20,Success,47,41,0,12,35
20,Success,46,35,0,11,35
20,Success,45,40,0,12,33
20,Success,44,34,0,17,27
20,Success,43,35,0,17,26
20,Success,43,38,3,16,27
20,Success,53,34,0,7,46
20,Success,49,34,8,9,40
20,Success,50,34,0,13,37
20,Success,51,30,0,14,37
20,Success,46,41,0,10,36
20,Success,48,31,0,19,29
20,Success,47,35,1,17,30
20,Success,50,34,0,16,34
20,Success,54,35,1,10,44
20,Success,44,45,0,10,34
20,Success,45,30,0,13,32
20,Success,49,36,0,9,40
20,Success,44,41,3,12,32
20,Success,47,33,1,19,28
20,Success,44,34,0,14,30
20,Success,53,34,0,9,44
20,Success,54,34,0,12,42
20,Success,43,43,0,10,33
20,Success,47,39,0,12,35
20,Success,48,40,5,7,41
20,Success,42,41,6,11,31
20,Success,48,34,4,14,34
20,Success,47,37,0,8,39
20,Success,43,46,0,11,32
20,Success,55,32,1,12,43
20,Success,45,35,4,16,29
20,Success,46,31,9,14,32
20,Success,48,36,0,13,35
20,Success,46,34,0,15,31
20,Success,45,43,0,12,33
20,Success,46,33,0,13,33
20,Success,50,36,0,10,40
20,Success,53,26,0,19,34
20,Success,50,35,3,12,38
20,Success,43,43,3,11,32
20,Success,55,28,0,16,39
20,Success,54,32,0,11,43
20,Success,44,39,4,13,31
20,Success,46,36,8,10,36
20,Success,51,33,0,14,37
20,Success,57,35,0,6,51
20,Success,45,40,0,12,33
20,Success,53,28,5,14,39
20,Success,46,33,0,15,31
20,Success,48,35,1,16,32
20,Success,43,41,0,9,34
20,Success,49,39,0,8,41
20,Success,43,43,3,11,32
20,Success,44,42,4,10,34
20,Success,50,34,0,14,36
20,Success,49,33,0,15,34
20,Success,43,43,2,12,31
20,Success,57,28,0,12,45
20,Success,49,39,2,10,39
20,Success,50,37,0,11,39
20,Success,50,35,4,11,39
20,Success,51,39,0,10,41
20,Success,52,31,0,13,39
20,Success,44,41,0,9,35
20,Success,53,37,0,8,45
20,Success,48,35,0,16,32
20,Success,44,37,6,13,31
20,Success,47,37,0,11,36
20,Success,45,38,0,12,33
20,Success,51,39,1,9,42
20,Success,56,31,1,12,44
20,Success,48,36,2,14,34
20,Success,54,32,0,14,40
20,Success,55,37,0,6,49
20,Success,42,39,0,13,29
20,Success,47,39,4,10,37
20,Success,48,35,4,13,35
20,Success,49,38,0,13,36
20,Success,46,41,0,12,34
20,Success,47,40,0,11,36
20,Success,49,30,0,14,35
20,Success,42,42,0,13,29
20,Success,55,36,0,8,47
20,Success,44,41,4,11,33
20,Success,46,32,4,18,28
20,Success,53,36,1,10,43
20,Success,43,44,1,12,31
20,Success,62,29,2,7,55
20,Success,42,40,0,8,34
20,Success,48,40,0,9,39
20,Success,47,30,6,17,30
20,Success,49,35,6,10,39
20,Success,49,38,0,12,37
20,Success,47,37,0,16,31
20,Success,53,33,2,12,41
20,Success,48,39,1,12,36
20,Success,51,34,7,8,43
20,Success,47,37,0,13,34
20,Success,51,35,0,12,39
20,Success,49,32,6,13,36
20,Success,48,39,0,12,36
20,Success,46,32,0,17,29
20,Success,43,38,4,15,28
20,Success,47,36,0,12,35
20,Success,42,33,9,16,26
20,Success,47,39,0,13,34
20,Success,49,36,2,13,36
20,Success,49,41,2,8,41
20,Success,46,41,0,11,35
20,Success,53,38,0,5,48
20,Success,54,40,2,4,50
20,Success,57,30,0,11,46
20,Success,48,30,5,17,31
20,Success,50,30,0,19,31
20,Success,40,33,9,18,22
20,Success,54,36,0,8,46
20,Success,46,33,10,11,35
20,Success,55,35,2,8,47
20,Success,42,41,1,16,26
20,Success,46,31,0,17,29
20,Success,48,39,0,10,38
20,Success,53,34,0,10,43
20,Success,53,33,0,10,43
20,Success,48,32,10,10,38
20,Success,53,28,0,13,40
20,Success,49,34,3,14,35
20,Success,42,40,0,14,28
20,Success,51,30,0,12,39
20,Success,47,33,0,18,29
20,Success,48,35,5,12,36
20,Success,43,38,10,9,34
20,Success,45,40,5,10,35
20,Success,51,36,0,10,41
20,Success,50,37,0,12,38
20,Success,52,27,0,20,32
20,Success,44,39,8,9,35
20,Success,49,33,10,8,41
20,Success,52,36,1,11,41
20,Success,47,32,0,20,27
20,Success,50,36,0,14,36
20,Success,45,40,0,15,30
20,Success,53,37,0,10,43
20,Success,46,39,6,9,37
20,Success,51,27,6,16,35
20,Success,52,32,1,15,37
20,Success,46,35,0,19,27
20,Success,47,24,0,16,31
20,Success,46,38,0,14,32
20,Success,47,38,4,11,36
20,Success,48,32,0,16,32
20,Success,50,37,0,8,42
20,Success,45,41,7,7,38
20,Success,55,34,1,10,45
20,Success,55,35,0,6,49
20,Success,49,32,8,11,38
20,Success,46,41,0,10,36
20,Success,53,39,1,7,46
20,Success,53,34,2,11,42
20,Success,44,38,4,14,30
20,Success,40,41,0,17,23
20,Success,52,32,4,12,40
20,Success,52,39,4,5,47
20,Success,53,31,0,16,37
20,Fail,37,33,0,19,18
20,Success,38,40,0,16,22
20,Success,54,31,0,14,40
20,Success,51,38,0,11,40
20,Success,47,39,0,12,35
20,Success,52,34,0,11,41
20,Success,49,31,0,13,36
20,Success,36,46,7,11,25
20,Success,44,44,0,11,33
20,Success,52,31,0,14,38
20,Success,50,41,0,9,41
20,Success,54,34,0,7,47
20,Success,48,36,0,16,32
20,Success,51,32,0,14,37
20,Fail,36,31,14,19,17
20,Success,53,33,5,9,44
20,Success,51,35,1,13,38
20,Success,42,39,0,16,26
20,Success,50,31,6,13,37
20,Success,37,45,0,16,21
20,Fail,39,35,0,20,19
20,Success,44,44,4,8,36
20,Success,56,29,7,8,48
20,Success,53,28,1,18,35
20,Success,44,37,0,12,32
20,Success,56,33,4,7,49
20,Success,48,33,5,14,34
20,Success,50,37,0,13,37
20,Success,54,32,2,12,42
20,Fail,39,34,0,22,17
20,Success,51,35,6,8,43
20,Success,51,28,0,10,41
20,Success,41,44,4,11,30
20,Success,47,40,3,10,37
20,Success,42,39,0,16,26
20,Success,49,36,0,14,35
20,Success,47,37,0,16,31
20,Success,50,37,7,6,44
20,Success,46,44,1,9,37
20,Success,42,37,11,10,32
20,Success,56,33,0,10,46
20,Success,52,34,1,13,39
20,Success,43,41,0,13,30
20,Success,44,45,2,9,35
20,Success,49,36,0,12,37
20,Success,48,35,4,13,35
20,Success,47,31,3,19,28
20,Success,50,39,2,9,41
20,Success,48,33,0,16,32
20,Success,45,37,0,13,32
20,Success,45,38,0,13,32
20,Success,51,30,3,16,35
20,Success,52,33,0,14,38
20,Success,54,35,0,11,43
20,Success,42,42,0,13,29
20,Success,53,33,0,6,47
20,Success,52,35,0,12,40
20,Success,45,34,0,15,30
20,Success,54,39,2,5,49
20,Success,45,37,7,11,34
20,Success,47,37,4,12,35
20,Success,45,39,3,13,32
20,Success,47,42,0,11,36
20,Success,45,40,1,14,31
20,Success,50,36,0,12,38
20,Success,47,41,6,6,41
20,Success,46,44,2,8,38
20,Success,54,40,0,5,49
20,Success,44,46,3,7,37
20,Success,52,31,0,14,38
20,Success,47,39,2,12,35
20,Success,48,39,0,8,40
20,Success,44,42,0,14,30
20,Success,52,35,0,11,41
20,Success,51,38,0,8,43
20,Success,54,30,5,11,43
20,Success,42,39,0,11,31
20,Success,56,33,0,6,50
20,Success,46,40,1,13,33
20,Success,48,29,0,16,32
20,Success,42,37,0,18,24
20,Success,49,33,0,16,33
20,Success,52,34,0,9,43
20,Success,42,46,0,11,31
20,Success,52,37,7,4,48
20,Success,49,28,0,13,36
20,Success,47,31,0,20,27
20,Success,52,36,3,9,43
20,Success,45,39,0,15,30
20,Success,48,28,0,16,32
20,Success,42,43,0,11,31
20,Success,49,40,0,8,41
20,Success,46,33,8,13,33
20,Success,40,42,0,16,24
20,Success,50,31,0,11,39
20,Success,47,35,0,17,30
20,Success,55,34,0,11,44
20,Success,41,37,9,13,28
20,Success,50,34,0,15,35
20,Success,44,40,0,10,34
20,Success,54,32,0,11,43
20,Success,43,32,0,13,30
20,Success,47,32,0,16,31
20,Success,54,31,0,14,40
20,Success,46,30,0,12,34
20,Success,49,38,4,9,40
20,Success,44,40,0,13,31
20,Success,50,29,5,16,34
20,Success,37,44,0,13,24
20,Success,42,39,0,15,27
20,Success,55,31,0,14,41
20,Success,41,44,1,14,27
20,Success,50,34,0,9,41
20,Success,52,37,0,9,43
20,Success,54,36,0,10,44
20,Success,48,34,2,16,32
20,Success,49,44,0,7,42
20,Success,41,41,4,14,27
20,Success,46,43,0,9,37
20,Success,47,39,0,13,34
20,Success,52,39,0,6,46
20,Success,43,39,0,12,31
20,Success,42,38,0,12,30
20,Success,47,41,2,10,37
20,Success,44,39,0,13,31
20,Success,48,30,5,17,31
20,Success,55,31,1,13,42
20,Success,57,30,4,9,48
20,Success,43,35,8,14,29
20,Success,50,26,7,17,33
20,Success,46,36,0,13,33
20,Success,41,39,5,15,26
20,Success,53,33,0,12,41
20,Success,49,35,0,13,36
20,Success,46,35,0,13,33
20,Success,42,43,0,10,32
20,Success,47,37,0,13,34
20,Success,41,43,0,13,28
20,Success,50,38,0,6,44
20,Success,39,44,2,15,24
20,Success,54,32,1,13,41
20,Success,40,44,2,14,26
20,Success,46,31,0,11,35
20,Success,53,34,0,10,43
20,Success,44,31,0,15,29
20,Success,50,38,0,11,39
20,Success,48,35,3,14,34
20,Success,42,44,0,10,32
20,Success,52,35,0,11,41
20,Success,53,38,1,8,45
20,Success,53,33,0,14,39
20,Success,54,36,3,7,47
20,Success,44,38,10,8,36
20,Success,42,47,0,10,32
20,Success,45,36,0,13,32
20,Success,47,36,0,11,36
20,Success,46,35,9,10,36
20,Success,49,36,0,14,35
20,Success,55,33,0,11,44
20,Success,54,32,0,13,41
20,Success,51,38,2,9,42
20,Success,42,39,0,12,30
20,Success,44,42,0,12,32
20,Success,52,33,2,13,39
20,Success,46,30,2,22,24
20,Success,41,38,1,20,21
20,Success,50,28,4,18,32
20,Success,48,31,0,16,32
20,Success,51,35,0,11,40
20,Success,46,36,0,17,29
20,Success,52,37,0,9,43
20,Success,50,35,0,15,35
20,Success,43,38,4,15,28
20,Success,52,32,0,12,40
20,Success,46,33,0,12,34
20,Success,49,32,0,16,33
20,Success,56,26,4,14,42
20,Success,43,40,0,15,28
20,Success,46,43,0,9,37
20,Success,46,38,2,14,32
20,Success,50,31,0,11,39
20,Success,47,35,0,16,31
20,Success,44,45,2,9,35
20,Success,53,28,7,12,41
20,Success,54,32,4,10,44
20,Success,46,37,0,10,36
20,Success,49,29,12,10,39
20,Success,54,27,0,11,43
20,Success,49,37,3,11,38
20,Success,52,34,0,12,40
20,Success,45,37,5,13,32
20,Success,53,35,0,7,46
20,Success,51,36,1,12,39
20,Success,49,34,0,16,33
20,Success,49,35,5,11,38
20,Success,49,40,0,10,39
20,Success,50,36,0,12,38
20,Success,55,37,4,4,51
20,Success,51,31,0,8,43
20,Success,55,27,0,16,39
20,Success,51,41,1,7,44
20,Success,45,37,4,14,31
20,Success,52,32,0,14,38
20,Success,41,37,0,15,26
20,Success,54,31,0,13,41
20,Success,48,37,0,13,35
20,Success,46,34,1,19,27
20,Success,46,28,9,17,29
20,Success,47,33,8,12,35
20,Success,43,30,10,17,26
20,Success,50,33,0,10,40
20,Success,48,44,2,6,42
20,Success,53,35,3,9,44
20,Success,54,34,0,12,42
20,Success,43,32,7,18,25
20,Success,43,43,4,10,33
20,Success,42,43,0,12,30
20,Success,47,42,4,7,40
20,Success,50,30,0,12,38
20,Success,55,29,3,13,42
20,Success,53,25,10,12,41
20,Success,42,37,0,18,24
20,Success,40,37,0,20,20
20,Success,49,33,0,11,38
20,Success,57,33,2,8,49
20,Success,53,35,1,11,42
20,Success,47,31,8,14,33
20,Success,44,37,0,16,28
20,Success,46,40,0,11,35
20,Success,46,37,3,14,32
20,Success,45,30,0,15,30
20,Success,52,36,0,9,43
20,Success,40,41,0,18,22
20,Success,45,36,0,15,30
20,Success,52,39,0,7,45
20,Success,50,33,0,16,34
20,Success,50,29,8,13,37
20,Success,41,40,0,17,24
20,Success,42,34,9,15,27
20,Success,56,32,0,11,45
20,Success,38,40,0,14,24
20,Success,43,42,3,12,31
20,Success,52,22,0,13,39
20,Success,54,36,1,9,45
20,Success,51,34,0,11,40
20,Success,45,35,9,11,34
20,Success,37,39,0,9,28
20,Success,44,24,0,17,27
20,Success,41,52,0,7,34
20,Success,40,33,0,14,26
20,Success,44,36,2,18,26
20,Success,41,38,0,10,31
20,Success,49,34,7,10,39
20,Success,47,38,3,12,35
20,Success,51,39,0,7,44
20,Success,49,34,0,16,33
20,Success,52,31,0,13,39
20,Success,47,39,0,12,35
20,Success,51,35,0,13,38
20,Success,49,32,0,16,33
20,Success,45,37,5,13,32
20,Success,49,39,0,11,38
20,Success,46,35,5,14,32
20,Success,53,34,0,8,45
20,Success,46,32,4,18,28
20,Success,41,38,8,13,28
20,Success,48,39,3,10,38
20,Success,47,30,7,16,31
20,Success,52,35,6,7,45
20,Success,53,29,0,15,38
20,Success,52,38,0,10,42
20,Success,45,39,4,12,33
20,Success,42,35,0,16,26
20,Success,47,35,0,14,33
20,Success,55,34,0,11,44
20,Success,42,35,6,17,25
20,Success,49,38,2,11,38
20,Success,46,35,0,16,30
20,Success,51,36,0,12,39
20,Success,42,37,7,14,28
20,Success,46,34,0,12,34
20,Success,49,34,0,17,32
20,Success,48,32,0,14,34
20,Success,45,37,0,7,38
20,Success,50,28,3,19,31
20,Success,43,33,10,14,29
20,Success,61,34,2,3,58
20,Success,42,41,1,16,26
20,Success,49,34,0,16,33
20,Success,47,41,4,8,39
20,Success,52,24,8,16,36
20,Success,42,37,2,19,23
20,Success,51,39,3,7,44
20,Success,50,36,1,13,37
20,Success,50,29,4,17,33
20,Success,51,29,7,13,38
20,Success,55,32,0,12,43
20,Success,41,35,10,14,27
20,Success,39,37,9,15,24
20,Success,45,36,0,16,29
20,Success,44,35,0,14,30
20,Success,44,39,0,14,30
20,Success,46,37,0,11,35
20,Success,56,31,1,12,44
20,Success,51,24,10,15,36
20,Success,52,32,6,10,42
20,Success,45,38,2,15,30
20,Success,52,34,0,12,40
20,Success,54,31,0,14,40
20,Success,57,29,0,14,43
20,Success,42,41,7,10,32
20,Success,47,36,4,13,34
20,Success,47,34,0,12,35
20,Success,56,27,7,10,46
20,Success,46,35,2,17,29
20,Success,51,38,0,8,43
20,Success,51,36,0,8,43
20,Success,52,31,3,14,38
20,Success,42,34,11,13,29
20,Success,49,40,0,7,42
20,Success,57,25,4,14,43
20,Success,53,26,0,13,40
20,Success,44,44,0,12,32
20,Success,46,39,4,11,35
20,Success,42,39,0,8,34
20,Fail,34,42,8,16,18
20,Success,45,37,0,16,29
20,Success,53,32,1,14,39
20,Success,50,38,0,11,39
20,Success,44,45,0,11,33
20,Success,48,37,0,11,37
20,Success,46,41,5,8,38
20,Success,50,34,0,15,35
20,Success,39,31,0,15,24
20,Success,48,32,1,19,29
20,Success,42,35,7,16,26
20,Success,51,36,5,8,43
20,Success,48,37,0,13,35
20,Success,53,34,0,11,42
20,Success,54,35,0,10,44
20,Success,45,39,0,14,31
20,Success,51,40,0,7,44
20,Success,52,37,0,10,42
20,Success,53,39,0,7,46
20,Success,52,28,7,13,39
20,Success,55,33,0,8,47
20,Success,51,38,3,8,43
20,Success,43,39,0,13,30
20,Success,51,35,0,13,38
20,Success,44,36,0,17,27
20,Success,45,37,3,15,30
20,Success,52,36,0,12,40
20,Success,45,40,5,10,35
20,Success,54,36,0,9,45
20,Success,43,37,0,18,25
20,Success,39,37,0,17,22
20,Success,42,31,0,17,25
20,Success,51,30,0,12,39
20,Success,42,30,0,17,25
20,Success,45,41,1,13,32
20,Fail,39,39,0,21,18
20,Success,48,40,0,10,38
20,Success,48,33,0,13,35
20,Success,52,29,4,15,37
20,Success,42,36,0,16,26
20,Success,52,37,0,10,42
20,Success,48,38,0,13,35
20,Success,49,29,6,16,33
20,Success,40,39,0,16,24
20,Success,53,29,7,11,42
20,Success,55,32,3,10,45
20,Success,48,43,1,8,40
20,Success,49,31,1,19,30
20,Success,51,39,1,9,42
20,Success,51,34,0,12,39
20,Success,58,32,3,7,51
20,Success,43,41,1,15,28
20,Success,48,35,2,15,33
20,Success,46,37,1,16,30
20,Success,49,38,3,10,39
20,Success,48,39,3,10,38
20,Success,41,49,0,10,31
20,Success,51,30,3,16,35
20,Success,46,35,3,16,30
20,Success,59,32,1,8,51
20,Success,53,31,7,9,44
20,Success,47,38,5,10,37
20,Success,35,43,0,11,24
20,Success,46,34,7,13,33
20,Success,59,28,3,10,49
20,Success,48,32,0,12,36
20,Success,52,31,0,13,39
20,Success,47,37,0,15,32
20,Success,52,33,5,10,42
20,Success,52,38,0,8,44
20,Success,49,38,5,8,41
20,Success,39,41,7,13,26
20,Success,44,37,4,15,29
20,Success,53,28,0,11,42
20,Success,52,32,1,15,37
20,Success,52,35,0,11,41
20,Success,45,34,2,19,26
20,Success,46,38,1,15,31
20,Success,42,39,5,14,28
20,Success,46,41,2,11,35
20,Success,50,34,9,7,43
20,Success,57,25,6,12,45
20,Success,45,35,6,14,31
20,Success,42,50,0,8,34
20,Success,49,30,7,14,35
20,Success,45,38,0,15,30
20,Success,46,39,0,12,34
20,Success,46,34,0,17,29
20,Success,50,34,0,12,38
20,Success,52,39,1,8,44
20,Success,55,37,4,4,51
20,Success,45,34,0,12,33
20,Success,51,34,4,11,40
20,Success,51,35,0,9,42
20,Success,56,37,0,7,49
20,Success,44,36,0,9,35
20,Success,56,30,1,13,43
20,Success,47,42,0,10,37
20,Success,44,42,2,12,32
20,Success,50,37,0,7,43
20,Success,55,30,0,10,45
20,Success,46,33,2,19,27
20,Success,46,36,2,16,30
20,Success,62,30,0,7,55
20,Success,49,29,8,14,35
20,Success,49,27,12,12,37
20,Success,52,40,0,6,46
20,Success,49,29,4,18,31
20,Success,49,34,0,14,35
20,Success,53,30,0,15,38
20,Success,48,41,0,10,38
20,Success,41,37,6,16,25
20,Success,46,36,4,14,32
20,Success,59,27,0,8,51
20,Success,45,40,4,11,34
20,Success,46,40,1,13,33
20,Success,50,31,2,17,33
20,Success,51,32,5,12,39
20,Success,45,41,0,14,31
20,Success,45,34,0,19,26
20,Success,52,31,4,13,39
20,Success,48,35,1,16,32
20,Success,52,31,0,13,39
20,Success,45,33,0,12,33
20,Success,52,29,0,14,38
20,Success,46,42,0,9,37
20,Success,56,26,0,13,43
20,Success,48,33,0,15,33
20,Success,48,36,0,15,33
20,Success,47,32,3,18,29
20,Success,47,37,0,12,35
20,Success,48,36,0,14,34
20,Success,46,42,2,10,36
20,Success,46,40,0,10,36
20,Success,53,30,6,11,42
20,Success,49,42,0,6,43
20,Success,39,42,4,15,24
20,Success,51,39,0,7,44
20,Success,51,38,0,10,41
20,Success,52,33,2,13,39
20,Success,44,37,5,14,30
20,Success,49,40,0,10,39
20,Success,46,43,0,10,36
20,Success,51,35,0,13,38
20,Success,39,40,5,16,23
20,Success,46,34,5,15,31
20,Success,56,31,0,12,44
20,Success,46,39,2,13,33
20,Success,43,38,0,14,29
20,Success,47,36,0,14,33
20,Success,47,37,5,11,36
20,Success,50,46,0,4,46
20,Success,48,33,5,14,34
20,Success,53,33,0,8,45
20,Success,50,32,0,14,36
20,Success,48,33,7,12,36
20,Success,50,34,0,14,36
20,Success,52,39,1,8,44
20,Success,47,35,4,14,33
20,Success,47,37,0,12,35
20,Success,44,37,0,16,28
20,Success,48,37,5,10,38
20,Success,49,30,0,18,31
20,Success,54,27,0,11,43
20,Success,53,33,2,12,41
20,Success,43,37,3,17,26
20,Success,46,37,4,13,33
20,Success,53,33,0,12,41
20,Success,46,40,0,11,35
20,Success,54,27,0,15,39
20,Success,50,29,12,9,41
20,Success,48,37,4,11,37
20,Success,51,26,0,15,36
20,Success,47,37,1,15,32
20,Success,49,36,2,13,36
20,Success,45,41,7,7,38
20,Success,48,37,3,12,36
20,Success,51,37,0,11,40
20,Success,40,43,1,16,24
20,Success,45,31,8,16,29
20,Success,51,34,0,9,42
20,Success,47,32,7,14,33
20,Success,57,32,0,7,50
20,Success,45,34,0,18,27
20,Fail,34,42,0,15,19
20,Success,48,33,4,15,33
20,Success,42,46,2,10,32
20,Success,48,46,0,6,42
20,Success,51,34,1,14,37
20,Success,51,34,0,11,40
20,Success,41,44,9,6,35
20,Success,49,31,0,14,35
20,Success,54,30,10,6,48
20,Success,48,40,2,10,38
20,Success,45,43,0,11,34
20,Success,53,37,1,9,44
20,Success,48,34,0,13,35
20,Success,42,38,2,18,24
20,Success,51,34,0,14,37
20,Success,45,33,9,13,32
20,Success,48,35,0,14,34
20,Success,45,39,4,12,33
20,Success,51,31,0,15,36
20,Success,48,30,8,14,34
20,Success,49,36,0,10,39
20,Success,49,32,0,14,35
20,Success,49,36,0,13,36
20,Success,49,36,0,14,35
20,Success,47,37,2,14,33
20,Success,44,38,6,12,32
20,Success,50,37,1,12,38
20,Success,48,33,1,18,30
20,Success,47,36,7,10,37
20,Success,50,38,0,10,40
20,Success,48,38,4,10,38
20,Success,54,28,2,16,38
20,Success,47,44,1,8,39
20,Success,53,35,2,10,43
20,Success,47,33,0,14,33
20,Success,43,33,9,15,28
20,Success,44,37,0,15,29
20,Success,44,36,6,14,30
20,Success,43,42,0,12,31
20,Success,44,42,0,12,32
20,Success,52,31,0,17,35
20,Success,45,39,0,9,36
20,Success,49,34,0,14,35
20,Success,48,34,7,11,37
20,Success,43,40,7,10,33
20,Success,54,32,3,11,43
20,Success,49,35,1,15,34
20,Success,50,35,0,13,37
20,Success,49,28,0,14,35
20,Success,46,34,0,11,35
20,Success,53,25,9,13,40
20,Success,39,44,4,13,26
20,Success,50,30,10,10,40
20,Success,45,32,0,18,27
20,Success,49,34,6,11,38
20,Success,48,35,5,12,36
20,Success,48,35,0,15,33
20,Success,53,24,9,14,39
20,Success,46,26,12,16,30
20,Success,47,33,5,15,32
20,Success,59,33,1,7,52
20,Success,44,41,2,13,31
20,Success,45,33,6,16,29
20,Success,44,38,9,9,35
20,Success,43,37,0,17,26
20,Success,39,41,0,13,26
20,Success,52,30,0,9,43
20,Success,49,33,0,17,32
20,Success,43,38,0,17,26
20,Success,50,36,1,13,37
20,Success,50,36,0,13,37
20,Success,43,38,6,13,30
20,Success,45,34,5,16,29
20,Success,55,35,0,10,45
20,Success,47,40,0,9,38
20,Success,54,32,3,11,43
20,Success,45,34,0,16,29
20,Success,48,35,0,10,38
20,Success,41,43,1,15,26
20,Success,52,33,4,11,41
20,Success,48,40,0,11,37
20,Success,48,41,1,10,38
20,Success,48,35,3,14,34
20,Success,41,38,0,18,23
20,Success,41,36,5,18,23
20,Success,52,33,5,10,42
20,Success,49,35,5,11,38
20,Fail,36,41,0,23,13
20,Success,48,37,3,12,36
20,Success,47,26,7,20,27
20,Success,45,43,0,9,36
20,Success,46,42,2,10,36
20,Success,48,36,0,13,35
20,Success,47,36,2,15,32
20,Success,40,45,0,14,26
20,Success,44,37,4,15,29
20,Success,48,37,0,10,38
20,Success,55,33,0,12,43
20,Success,54,29,0,16,38
20,Success,46,36,0,12,34
20,Success,46,39,4,11,35
20,Success,45,36,4,15,30
20,Success,50,34,0,9,41
20,Success,48,30,0,13,35
20,Success,46,34,6,14,32
20,Success,49,31,0,20,29
20,Success,45,37,3,15,30
20,Success,43,43,0,14,29
20,Success,47,37,1,15,32
20,Success,54,33,0,9,45
20,Success,46,36,1,17,29
20,Success,54,30,0,12,42
20,Success,51,25,7,17,34
20,Success,52,35,0,12,40
20,Success,60,29,0,9,51
20,Success,52,33,0,7,45
20,Success,46,33,0,14,32
20,Success,46,31,0,15,31
20,Success,41,45,2,12,29
20,Success,51,35,0,11,40
20,Success,56,32,0,10,46
20,Success,50,31,5,14,36
20,Success,48,28,14,10,38
20,Success,47,41,1,11,36
20,Success,50,38,1,11,39
20,Success,43,36,10,11,32
20,Fail,37,36,9,18,19
20,Success,50,30,0,16,34
20,Success,52,30,0,16,36
20,Success,45,25,0,16,29
20,Success,51,30,0,17,34
20,Success,58,24,2,16,42
20,Success,50,30,0,19,31
20,Success,52,31,3,14,38
20,Success,46,27,0,17,29
20,Success,44,43,2,11,33
20,Success,48,37,2,13,35
20,Success,50,40,2,8,42
20,Success,56,25,2,17,39
20,Success,45,39,3,13,32
20,Success,48,38,3,11,37
20,Success,49,37,0,9,40
20,Success,41,36,7,16,25
20,Success,43,35,0,15,28
20,Success,42,39,6,13,29
20,Success,47,32,6,15,32
20,Success,54,31,8,7,47
20,Success,51,33,0,12,39
20,Success,51,27,0,17,34
20,Success,50,41,0,9,41
20,Success,50,29,6,15,35
20,Success,47,39,0,11,36
20,Success,52,33,4,11,41
20,Success,42,42,3,13,29
20,Success,43,37,10,10,33
20,Success,42,31,10,17,25
20,Success,43,45,0,9,34
20,Success,46,44,1,9,37
20,Success,55,36,1,8,47
20,Success,52,36,0,10,42
20,Success,51,36,2,11,40
20,Success,53,31,4,12,41
20,Success,48,37,0,11,37
20,Success,49,37,0,11,38
20,Success,51,37,0,12,39
20,Success,48,40,0,11,37
20,Success,54,33,0,13,41
20,Success,45,38,0,15,30
20,Success,47,38,0,9,38
20,Success,47,34,7,12,35
20,Success,50,39,0,8,42
20,Success,57,35,0,7,50
20,Success,57,33,0,9,48
20,Success,51,34,0,13,38
20,Success,55,36,0,9,46
20,Success,48,33,6,13,35
20,Success,51,34,1,14,37
20,Success,48,34,7,11,37
20,Success,42,45,0,11,31
20,Success,49,34,0,16,33
20,Success,48,38,0,13,35
20,Success,50,35,0,7,43
20,Success,47,34,0,16,31
20,Success,50,33,5,12,38
20,Success,50,32,0,17,33
20,Success,51,37,0,11,40
20,Success,54,23,8,15,39
20,Success,54,32,0,13,41
20,Success,51,27,6,16,35
20,Success,49,30,2,19,30
20,Success,54,35,0,7,47
20,Success,53,38,0,9,44
20,Success,51,34,4,11,40
20,Success,49,34,0,15,34
20,Success,44,34,0,15,29
20,Success,47,33,0,9,38
20,Success,49,34,1,16,33
20,Success,52,38,5,5,47
20,Success,48,39,0,11,37
20,Success,51,36,2,11,40
20,Success,52,34,0,10,42
20,Success,45,38,6,11,34
20,Success,44,34,0,18,26
20,Success,47,39,0,14,33
20,Success,53,32,0,10,43
20,Success,43,32,6,19,24
20,Success,47,34,0,16,31
20,Success,49,35,0,14,35
20,Success,44,39,8,9,35
20,Success,59,27,0,9,50
20,Success,47,34,6,13,34
20,Success,44,38,3,15,29
20,Success,45,31,1,23,22
20,Success,45,42,0,11,34
20,Success,51,33,2,14,37
20,Success,55,35,1,9,46
20,Success,43,29,12,16,27
20,Success,48,39,4,9,39
20,Success,57,37,0,6,51
20,Success,52,28,0,16,36
20,Success,49,37,0,14,35
20,Success,41,40,8,11,30
20,Success,46,38,0,15,31
20,Success,47,33,10,10,37
20,Success,42,44,0,10,32
20,Success,47,34,5,14,33
20,Success,46,41,5,8,38
20,Success,56,33,0,11,45
20,Success,57,26,0,9,48
20,Success,52,39,1,8,44
20,Success,50,34,0,15,35
20,Success,44,31,0,20,24
20,Success,56,31,0,9,47
20,Success,51,33,2,14,37
20,Success,49,37,3,11,38
20,Success,43,40,0,12,31
20,Success,45,41,0,12,33
20,Success,55,28,0,9,46
20,Success,47,33,8,12,35
20,Success,43,36,0,13,30
20,Success,50,34,5,11,39
20,Success,50,43,0,3,47
20,Success,49,29,0,15,34
20,Success,47,34,0,9,38
20,Success,51,31,4,14,37
20,Success,46,41,4,9,37
20,Success,51,29,0,11,40
20,Success,44,34,3,19,25
20,Success,51,41,0,8,43
20,Success,55,36,0,7,48
20,Success,48,41,0,7,41
20,Success,55,28,0,15,40
20,Success,50,33,3,14,36
20,Success,47,42,0,11,36
20,Success,46,36,2,16,30
20,Success,51,34,4,11,40
20,Success,49,35,5,11,38
20,Success,58,32,5,5,53
20,Success,49,38,3,10,39
20,Success,44,37,0,11,33
20,Success,47,35,0,11,36
20,Success,45,35,7,13,32
20,Success,48,32,0,12,36
20,Success,54,35,0,11,43
20,Success,53,33,0,14,39
20,Success,50,35,8,7,43
20,Success,42,41,0,12,30
20,Success,50,33,0,14,36
20,Success,54,31,2,13,41
20,Success,42,38,0,16,26
20,Success,48,38,0,10,38
20,Success,47,40,0,12,35
20,Success,39,40,0,14,25
20,Success,50,40,0,10,40
20,Success,61,27,0,9,52
20,Success,40,42,0,11,29
20,Success,45,31,0,13,32
20,Success,43,38,0,13,30
20,Success,43,38,0,18,25
20,Success,52,38,1,9,43
20,Success,46,36,4,14,32
20,Success,45,38,0,11,34
20,Success,50,34,0,16,34
20,Success,43,35,0,19,24
20,Success,44,39,0,13,31
20,Success,50,35,4,11,39
20,Success,47,40,6,7,40
20,Success,49,32,0,16,33
20,Success,50,33,6,11,39
20,Success,43,45,0,9,34
20,Success,50,38,2,10,40
20,Success,47,37,0,14,33
20,Success,49,42,2,7,42
20,Success,57,28,5,10,47
20,Success,46,36,6,12,34
20,Success,47,34,0,14,33
20,Success,55,33,0,12,43
20,Success,51,41,0,8,43
20,Success,43,36,0,13,30
20,Success,46,32,11,11,35
20,Success,53,37,0,10,43
20,Success,49,30,6,15,34
20,Success,49,43,0,7,42
20,Success,43,35,0,17,26
20,Success,56,36,0,8,48
20,Success,50,35,5,10,40
20,Success,48,34,4,14,34
20,Success,49,34,0,14,35
20,Success,48,35,2,15,33
20,Success,44,43,0,13,31
20,Success,49,33,0,15,34
20,Success,46,33,4,17,29
20,Success,56,36,0,6,50
20,Success,47,39,2,12,35
20,Success,50,41,0,9,41
20,Success,52,31,1,16,36
20,Success,50,36,0,13,37
20,Success,45,34,0,17,28
20,Success,45,43,0,12,33
20,Success,44,30,2,24,20
20,Success,42,33,13,12,30
20,Success,41,37,0,18,23
20,Success,46,31,10,13,33
20,Success,57,34,0,8,49
20,Success,52,26,6,16,36
20,Success,51,32,0,14,37
20,Success,52,34,5,9,43
20,Success,54,35,0,9,45
20,Success,42,36,0,15,27
20,Success,47,37,0,16,31
20,Success,51,32,3,14,37
20,Success,46,39,0,8,38
20,Success,46,36,0,12,34
20,Success,50,35,0,13,37
20,Success,46,37,0,12,34
20,Success,47,37,2,14,33
20,Success,49,34,6,11,38
20,Success,45,36,8,11,34
20,Success,50,30,7,13,37
20,Success,40,33,12,15,25
20,Success,52,32,0,12,40
20,Success,49,34,3,14,35
20,Success,51,37,0,12,39
20,Success,53,25,6,16,37
20,Success,49,31,0,18,31
20,Success,47,41,0,12,35
20,Success,44,30,0,15,29
20,Success,55,34,1,10,45
20,Success,58,28,3,11,47
20,Success,50,35,0,9,41
20,Success,50,40,3,7,43
20,Success,46,34,7,13,33
20,Success,51,37,0,12,39
20,Success,54,31,1,14,40
20,Success,54,37,3,6,48
20,Success,50,39,3,8,42
20,Success,48,46,0,6,42
20,Success,42,42,0,11,31
20,Success,47,41,2,10,37
20,Success,40,39,0,16,24
20,Success,46,43,0,10,36
20,Success,55,32,2,11,44
20,Success,54,41,0,4,50
20,Success,53,37,0,10,43
20,Success,48,41,1,10,38
20,Success,42,41,0,11,31
20,Success,57,28,3,12,45
20,Success,49,32,0,13,36
20,Success,48,32,11,9,39
20,Success,52,35,0,13,39
20,Success,54,33,2,11,43
20,Success,54,35,1,10,44
20,Success,42,35,7,16,26
20,Success,54,33,4,9,45
20,Success,50,34,3,13,37
20,Success,47,32,8,13,34
20,Success,45,40,0,13,32
20,Success,46,42,0,8,38
20,Success,52,38,4,6,46
20,Success,53,37,0,8,45
20,Success,54,34,1,11,43
20,Success,55,33,0,12,43
20,Success,53,35,0,8,45
20,Success,59,27,0,12,47
20,Success,46,34,3,17,29
20,Success,42,42,11,5,37
20,Success,55,30,0,11,44
20,Success,48,27,0,19,29
20,Success,52,33,3,12,40
20,Success,52,32,3,13,39
20,Success,44,41,1,14,30
20,Success,50,35,3,12,38
20,Success,50,34,0,10,40
20,Success,54,36,0,8,46
20,Success,48,39,0,12,36
20,Success,44,40,4,12,32
20,Success,48,36,0,10,38
20,Success,43,39,0,11,32
20,Success,46,34,0,20,26
20,Success,52,35,3,10,42
20,Success,44,36,3,17,27
20,Success,45,40,0,9,36
20,Success,49,40,0,9,40
20,Success,48,35,0,17,31
20,Success,48,38,3,11,37
20,Success,47,41,0,11,36
20,Success,47,29,7,17,30
20,Success,48,35,0,9,39
20,Success,48,39,2,11,37
20,Success,54,26,0,13,41
20,Success,49,36,0,15,34
20,Success,46,40,0,14,32
20,Success,41,37,10,12,29
20,Success,46,36,6,12,34
20,Success,48,41,0,11,37
20,Success,51,29,0,16,35
20,Success,48,36,0,15,33
20,Success,50,34,7,9,41
20,Success,42,35,12,11,31
20,Success,51,41,2,6,45
20,Success,53,30,0,10,43
20,Success,56,31,2,11,45
20,Success,50,31,0,18,32
20,Success,42,38,0,14,28
20,Success,43,40,4,13,30
20,Fail,38,37,5,20,18
20,Success,50,40,0,10,40
20,Success,46,35,0,15,31
20,Success,47,29,0,15,32
20,Success,54,33,1,12,42
20,Success,47,40,2,11,36
20,Success,45,36,8,11,34
20,Success,43,46,0,11,32
20,Success,45,24,13,18,27
20,Success,47,38,0,15,32
20,Success,58,28,0,10,48
20,Success,50,33,4,13,37
20,Success,49,34,6,11,38
20,Success,52,38,0,10,42
20,Success,43,36,4,17,26
20,Success,50,34,7,9,41
20,Success,50,35,4,11,39
20,Success,47,40,5,8,39
20,Success,45,27,9,19,26
20,Success,50,37,2,11,39
20,Success,51,39,1,9,42
20,Success,46,32,7,15,31
20,Success,48,31,0,9,39
20,Success,46,29,8,17,29
20,Success,47,34,6,13,34
20,Success,46,33,0,16,30
20,Success,54,32,3,11,43
20,Success,49,29,8,14,35
20,Success,48,37,0,12,36
20,Success,42,35,10,13,29
20,Success,51,38,0,9,42
20,Success,43,40,0,15,28
20,Success,49,35,0,16,33
20,Success,49,35,4,12,37
20,Success,51,30,0,17,34
20,Success,51,38,0,11,40
20,Success,41,40,0,17,24
20,Success,43,45,0,5,38
20,Success,50,35,0,12,38
20,Success,41,40,0,15,26
20,Fail,32,38,16,14,18
20,Success,48,39,4,9,39
20,Success,45,40,4,11,34
20,Success,40,43,0,11,29
20,Success,42,36,2,20,22
20,Success,51,31,0,10,41
20,Success,44,47,1,8,36
20,Success,53,40,1,6,47
20,Success,49,47,0,2,47
20,Success,46,35,0,13,33
20,Success,43,39,9,9,34
20,Success,49,37,0,12,37
20,Success,42,49,0,9,33
20,Success,41,40,0,16,25
20,Success,48,33,0,14,34
20,Success,53,38,0,9,44
20,Success,55,36,3,6,49
20,Success,46,40,0,9,37
20,Success,46,40,0,12,34
20,Success,52,38,0,9,43
20,Success,50,36,4,10,40
20,Success,41,46,3,10,31
20,Success,51,34,0,12,39
20,Success,44,42,0,14,30
20,Success,53,24,14,9,44
20,Success,47,38,0,7,40
20,Success,48,37,0,15,33
20,Success,50,38,0,9,41
20,Success,46,41,0,9,37
20,Success,53,32,3,12,41
20,Success,42,38,0,15,27
20,Success,48,39,1,12,36
20,Success,47,38,0,15,32
20,Success,47,33,0,14,33
20,Success,44,35,6,15,29
20,Success,47,37,0,7,40
20,Success,44,38,5,13,31
20,Success,54,31,4,11,43
20,Success,44,31,8,17,27
20,Success,48,36,8,8,40
20,Success,52,31,5,12,40
20,Success,53,36,1,10,43
20,Success,53,36,3,8,45
20,Success,49,33,6,12,37
20,Success,48,37,4,11,37
20,Success,54,32,0,6,48
20,Success,47,41,2,10,37
20,Success,45,42,0,9,36
20,Success,50,41,2,7,43
20,Success,59,34,0,6,53
20,Success,51,37,0,10,41
20,Success,47,40,3,10,37
20,Success,51,32,0,16,35
20,Success,38,44,0,16,22
20,Success,54,38,0,8,46
20,Success,44,39,0,13,31
20,Success,39,51,0,7,32
20,Success,41,35,0,17,24
20,Success,50,36,1,13,37
20,Success,55,36,1,8,47
20,Success,46,35,8,11,35
20,Success,51,38,1,10,41
20,Success,51,32,4,13,38
20,Success,46,34,0,15,31
20,Success,48,37,5,10,38
20,Success,49,34,0,13,36
20,Success,46,42,0,8,38
20,Success,51,35,0,13,38
20,Success,44,40,2,14,30
20,Success,49,30,4,17,32
20,Success,46,33,4,17,29
20,Success,41,39,7,13,28
20,Success,44,39,0,12,32
20,Success,44,36,7,13,31
20,Success,45,33,0,18,27
20,Success,42,34,10,14,28
20,Success,52,40,0,8,44
20,Success,48,41,0,9,39
20,Success,50,39,0,10,40
20,Success,53,38,0,9,44
20,Success,47,36,0,13,34
20,Success,48,37,1,14,34
20,Success,46,32,0,17,29
20,Success,49,39,0,9,40
20,Success,43,32,9,16,27
20,Success,48,35,0,10,38
20,Success,50,39,0,11,39
20,Success,50,39,1,10,40
20,Success,44,40,0,13,31
20,Success,44,40,3,13,31
20,Success,45,38,0,10,35
20,Success,60,27,0,13,47
20,Success,43,41,0,13,30
20,Success,53,36,3,8,45
20,Success,42,44,0,13,29
20,Success,52,31,4,13,39
20,Success,54,33,0,12,42
20,Success,53,35,5,7,46
20,Success,48,33,3,16,32
20,Success,52,31,3,14,38
20,Success,53,27,0,17,36
20,Success,48,34,1,17,31
20,Success,47,39,0,14,33
20,Success,45,24,0,21,24
20,Success,42,38,0,16,26
20,Success,47,31,0,22,25
20,Success,43,37,2,18,25
20,Success,54,34,2,10,44
20,Success,49,38,0,13,36
20,Success,55,28,0,15,40
20,Success,57,31,0,9,48
20,Success,47,41,4,8,39
20,Success,46,35,0,10,36
20,Success,53,37,2,8,45
20,Success,52,31,0,13,39
20,Success,45,40,4,11,34
20,Success,55,33,0,11,44
20,Success,55,34,0,11,44
20,Success,45,38,2,15,30
20,Success,48,41,0,8,40
20,Success,46,36,4,14,32
20,Success,62,24,0,8,54
20,Success,55,26,0,12,43
20,Success,49,28,10,13,36
20,Success,50,29,0,15,35
20,Success,52,35,0,13,39
20,Success,54,29,0,11,43
20,Success,43,44,0,8,35
20,Success,51,34,0,15,36
20,Success,52,29,0,18,34
20,Success,49,38,2,11,38
20,Success,43,32,6,19,24
20,Success,48,29,2,21,27
20,Success,51,31,0,13,38
20,Success,42,38,0,18,24
20,Success,52,36,0,11,41
20,Success,53,37,0,8,45
20,Success,47,39,0,12,35
20,Success,53,34,0,9,44
20,Success,53,39,0,5,48
20,Success,42,46,0,11,31
20,Success,48,31,8,13,35
20,Success,47,40,7,6,41
20,Success,53,35,0,10,43
20,Success,48,37,0,14,34
20,Success,52,33,0,11,41
20,Success,49,42,0,8,41
20,Success,61,32,1,6,55
20,Success,44,30,7,19,25
20,Success,52,33,0,14,38
20,Success,52,35,1,12,40
20,Success,50,26,9,15,35
20,Success,51,40,1,8,43
20,Success,36,45,3,16,20
20,Success,50,31,4,15,35
20,Success,55,33,5,7,48
20,Success,52,30,0,15,37
20,Success,45,38,0,16,29
20,Success,48,35,0,14,34
20,Success,45,37,2,16,29
20,Success,50,34,0,7,43
20,Success,43,34,6,17,26
20,Success,48,40,0,10,38
20,Success,47,40,5,8,39
20,Success,54,29,0,17,37
20,Success,51,33,0,11,40
20,Success,51,35,0,13,38
20,Success,53,27,4,16,37
20,Success,41,44,5,10,31
20,Success,43,39,4,14,29
20,Success,44,41,5,10,34
20,Success,54,34,2,10,44
20,Success,47,43,1,9,38
20,Success,58,31,0,9,49
20,Success,47,38,0,11,36
20,Success,44,32,7,17,27
20,Success,56,35,1,8,48
20,Success,46,43,0,10,36
20,Success,51,38,1,10,41
20,Success,54,31,0,14,40
20,Success,57,34,0,9,48
20,Success,46,36,4,14,32
20,Success,47,35,0,17,30
20,Success,45,31,6,18,27
20,Success,47,38,0,13,34
20,Success,46,36,0,11,35
20,Success,56,29,0,13,43
20,Success,46,28,10,16,30
20,Success,43,30,0,12,31
20,Success,48,33,6,13,35
20,Success,47,36,6,11,36
20,Success,41,42,4,13,28
20,Success,58,27,1,14,44
20,Success,52,32,0,13,39
20,Success,51,39,5,5,46
20,Success,45,37,5,13,32
20,Success,45,38,1,16,29
20,Success,55,30,0,14,41
20,Success,57,31,0,11,46
20,Success,45,37,8,10,35
20,Success,46,38,2,14,32
20,Success,55,30,6,9,46
20,Success,46,37,0,15,31
20,Success,44,37,0,15,29
20,Success,55,31,0,11,44
20,Success,50,36,4,10,40
20,Success,54,33,3,10,44
20,Success,50,34,0,16,34
20,Success,61,27,1,11,50
20,Success,41,42,2,15,26
20,Success,45,33,0,16,29
20,Success,42,34,0,10,32
20,Success,44,33,0,12,32
20,Success,53,35,0,12,41
20,Success,52,34,4,10,42
20,Success,48,37,4,11,37
20,Success,49,39,0,10,39
20,Success,49,32,4,15,34
20,Success,54,32,0,14,40
20,Success,50,30,0,10,40
20,Success,55,29,0,12,43
20,Success,42,36,5,17,25
20,Success,41,38,6,15,26
20,Success,48,39,0,13,35
20,Success,49,35,1,15,34
20,Success,49,38,0,12,37
20,Success,44,42,0,14,30
20,Success,48,39,2,11,37
20,Success,53,34,4,9,44
20,Success,51,36,0,12,39
20,Success,49,34,9,8,41
20,Success,46,35,6,13,33
20,Success,50,31,0,15,35
20,Success,47,34,0,17,30
20,Success,44,30,10,16,28
20,Success,60,35,0,5,55
20,Success,53,31,0,13,40
20,Success,50,33,5,12,38
20,Success,46,32,10,12,34
20,Success,51,34,2,13,38
20,Success,47,38,1,14,33
20,Success,46,25,11,18,28
20,Success,55,31,2,12,43
20,Success,51,35,7,7,44
20,Success,49,30,7,14,35
20,Success,59,28,2,11,48
20,Success,50,34,0,16,34
20,Success,48,28,10,14,34
20,Success,49,37,0,14,35
20,Success,48,34,2,16,32
20,Success,53,38,0,8,45
20,Success,45,34,0,17,28
20,Success,46,35,2,17,29
20,Success,50,33,1,16,34
20,Success,48,34,0,15,33
20,Success,38,35,13,14,24
20,Success,48,37,0,15,33
20,Success,48,30,0,21,27
20,Success,46,32,0,16,30
20,Fail,35,39,0,16,19
20,Success,47,36,9,8,39
20,Success,50,33,0,14,36
20,Success,50,38,0,10,40
20,Success,53,28,3,16,37
20,Success,45,35,0,15,30
20,Success,47,36,0,15,32
20,Success,49,35,3,13,36
20,Success,43,42,0,12,31
20,Success,39,40,14,7,32
20,Success,51,38,0,10,41
20,Success,54,34,0,11,43
20,Success,48,34,9,9,39
20,Success,40,44,3,13,27
20,Success,48,38,0,8,40
20,Success,54,32,3,11,43
20,Success,52,31,2,15,37
20,Success,49,38,0,12,37
20,Success,52,37,1,10,42
20,Success,53,34,4,9,44
20,Success,49,40,2,9,40
20,Success,46,35,9,10,36
20,Success,52,37,0,10,42
20,Success,38,35,0,17,21
20,Success,51,37,5,7,44
20,Success,41,44,0,14,27
20,Success,59,30,1,10,49
20,Success,49,38,0,11,38
20,Success,41,41,0,15,26
20,Success,49,35,0,12,37
20,Success,51,34,5,10,41
20,Success,57,32,3,8,49
20,Success,50,33,1,16,34
20,Success,50,38,0,7,43
20,Success,48,31,0,18,30
20,Success,42,31,0,20,22
20,Success,49,41,0,10,39
20,Success,43,40,7,10,33
20,Success,55,33,3,9,46
20,Success,41,42,0,17,24
20,Success,39,38,11,12,27
20,Success,47,31,0,20,27
20,Success,46,41,0,12,34
20,Success,44,39,0,13,31
20,Success,49,39,0,10,39
20,Success,48,36,0,16,32
20,Success,47,35,5,13,34
20,Success,47,35,7,11,36
20,Success,48,39,5,8,40
20,Success,49,35,4,12,37
20,Success,50,33,0,9,41
20,Success,47,40,0,10,37
20,Success,48,37,2,13,35
20,Success,45,46,3,6,39
20,Success,48,44,0,8,40
20,Success,48,42,2,8,40
20,Success,47,35,0,10,37
20,Success,48,36,0,14,34
20,Success,42,48,0,9,33
20,Success,54,38,0,7,47
20,Success,48,40,0,10,38
20,Success,51,38,0,8,43
20,Success,55,32,3,10,45
20,Success,52,33,2,13,39
20,Success,46,36,6,12,34
20,Success,42,33,0,17,25
20,Success,52,33,0,13,39
20,Success,49,36,1,14,35
20,Success,44,31,5,20,24
20,Success,52,34,0,14,38
20,Success,50,42,2,6,44
20,Success,46,44,1,9,37
20,Success,41,39,0,12,29
20,Success,50,33,6,11,39
20,Success,54,32,4,10,44
20,Success,47,21,0,19,28
20,Success,48,39,0,13,35
20,Success,46,35,0,19,27
20,Success,51,35,0,11,40
20,Success,42,39,2,17,25
20,Success,45,37,2,16,29
20,Success,49,35,5,11,38
20,Success,45,47,0,8,37
20,Success,50,40,0,6,44
20,Success,41,41,1,17,24
20,Success,48,34,0,15,33
20,Success,46,41,5,8,38
20,Success,50,32,0,18,32
20,Success,51,31,7,11,40
20,Success,51,33,2,14,37
20,Success,38,38,0,10,28
20,Success,48,37,3,12,36
20,Success,44,42,0,14,30
20,Success,46,45,0,8,38
20,Success,50,40,0,6,44
20,Success,44,37,6,13,31
20,Success,50,37,2,11,39
20,Success,49,34,1,16,33
20,Success,40,40,11,9,31
20,Success,40,44,0,15,25
20,Success,46,31,0,16,30
20,Success,53,32,0,12,41
20,Success,44,38,0,11,33
20,Success,50,38,0,10,40
20,Success,42,39,0,13,29
20,Success,46,31,7,16,30
20,Success,45,46,1,8,37
20,Success,53,36,2,9,44
20,Success,48,36,0,11,37
20,Success,42,33,0,10,32
20,Success,45,39,8,8,37
20,Success,53,37,0,10,43
20,Success,49,36,1,14,35
20,Success,54,36,1,9,45
20,Success,51,31,0,10,41
20,Success,45,41,2,12,33
20,Success,42,36,0,12,30
20,Success,42,35,0,12,30
20,Success,47,37,0,7,40
20,Success,56,26,7,11,45
20,Success,52,33,0,10,42
20,Success,48,36,0,15,33
20,Success,53,26,0,14,39
20,Success,50,31,0,13,37
20,Success,51,33,0,12,39
20,Success,46,34,8,12,34
20,Success,46,37,0,13,33
20,Success,50,37,0,11,39
20,Success,43,36,0,10,33
20,Success,47,36,2,15,32
20,Success,44,28,8,20,24
20,Success,48,33,0,11,37
20,Success,44,37,0,9,35
20,Success,49,33,0,16,33
20,Success,46,40,0,8,38
20,Success,45,37,0,15,30
20,Success,52,33,1,14,38
20,Success,49,31,8,12,37
20,Success,51,33,3,13,38
20,Success,46,37,0,12,34
20,Success,50,39,4,7,43
20,Success,44,35,0,14,30
20,Success,48,33,0,19,29
20,Success,50,31,3,16,34
20,Success,50,35,0,15,35
20,Success,47,32,7,14,33
20,Success,48,38,0,13,35
20,Success,53,34,0,8,45
20,Success,48,34,5,13,35
20,Success,41,32,0,16,25
20,Success,51,39,0,5,46
20,Success,42,37,4,17,25
20,Success,41,46,0,11,30
20,Success,43,40,2,15,28
20,Success,52,34,5,9,43
20,Success,45,41,5,9,36
20,Success,49,29,6,16,33
20,Success,50,40,2,8,42
20,Success,51,38,0,10,41
20,Success,53,40,0,7,46
20,Success,45,33,10,12,33
20,Success,51,37,4,8,43
20,Success,48,35,0,11,37
20,Success,54,34,0,10,44
20,Success,53,39,0,8,45
20,Success,40,35,0,14,26
20,Success,51,38,1,10,41
20,Success,40,38,6,16,24
20,Success,49,34,2,15,34
20,Success,46,32,0,16,30
20,Success,46,37,0,13,33
20,Success,54,27,7,12,42
20,Success,48,38,0,11,37
20,Success,47,40,0,8,39
20,Success,48,36,0,12,36
20,Success,53,26,6,15,38
20,Success,52,32,0,10,42
20,Success,44,37,2,17,27
20,Success,48,33,0,19,29
20,Success,43,39,0,15,28
20,Success,53,27,1,19,34
20,Success,62,32,0,4,58
20,Success,54,25,0,14,40
20,Success,54,29,0,16,38
20,Success,48,40,0,9,39
20,Success,49,33,0,14,35
20,Success,53,31,1,15,38
20,Success,50,37,4,9,41
20,Success,65,25,0,7,58
20,Success,48,36,7,9,39
20,Success,49,37,1,13,36
20,Success,44,38,1,17,27
20,Success,50,35,3,12,38
20,Success,45,38,2,15,30
20,Success,52,40,0,6,46
20,Success,40,44,0,10,30
20,Success,49,37,1,13,36
20,Success,52,37,3,8,44
20,Success,51,40,1,8,43
20,Success,59,33,0,8,51
20,Success,48,29,10,13,35
20,Success,54,38,0,7,47
20,Success,49,33,0,14,35
20,Success,53,33,0,11,42
20,Success,45,39,5,11,34
20,Success,47,34,9,10,37
20,Fail,38,40,3,19,19
20,Success,52,36,0,11,41
20,Success,45,35,7,13,32
20,Success,54,31,0,13,41
20,Success,52,35,0,9,43
20,Success,50,35,0,12,38
20,Success,42,39,1,18,24
20,Success,44,42,0,13,31
20,Success,47,34,6,13,34
20,Success,53,31,2,14,39
20,Success,49,36,0,13,36
20,Success,51,37,0,10,41
20,Success,50,38,0,11,39
20,Success,49,33,4,14,35
20,Success,45,33,0,14,31
20,Success,50,32,3,15,35
20,Success,50,27,0,15,35
20,Success,47,38,2,13,34
20,Success,49,37,0,14,35
20,Success,49,33,6,12,37
20,Success,44,40,3,13,31
20,Success,45,43,0,9,36
20,Success,54,32,0,11,43
20,Success,51,33,0,15,36
20,Success,50,33,4,13,37
20,Success,41,38,0,15,26
20,Success,46,40,1,13,33
20,Success,42,40,5,13,29
20,Success,52,39,0,7,45
20,Success,43,40,0,13,30
20,Success,47,37,4,12,35
20,Success,51,39,0,9,42
20,Success,46,43,0,11,35
20,Success,41,41,2,16,25
20,Success,47,32,0,13,34
20,Success,51,29,0,11,40
20,Success,49,35,4,12,37
20,Success,45,38,0,8,37
20,Success,54,33,0,12,42
20,Success,48,32,0,18,30
20,Success,48,37,0,14,34
20,Success,45,40,1,14,31
20,Success,40,38,0,18,22
20,Success,52,38,0,10,42
20,Success,55,30,2,13,42
20,Success,47,34,4,15,32
20,Success,55,34,1,10,45
20,Success,44,35,5,16,28
20,Success,49,30,0,14,35
20,Success,46,33,6,15,31
20,Success,54,31,0,14,40
20,Success,53,35,0,12,41
20,Success,42,44,0,14,28
20,Success,50,36,4,10,40
20,Success,48,33,6,13,35
20,Success,39,37,0,16,23
20,Success,50,30,6,14,36
20,Success,46,40,3,11,35
20,Success,40,39,0,15,25
20,Success,46,38,2,14,32
20,Success,51,39,0,10,41
20,Success,45,39,0,16,29
20,Success,50,34,3,13,37
20,Success,55,33,0,9,46
20,Success,49,33,6,12,37
20,Success,54,38,1,7,47
20,Success,47,37,1,15,32
20,Success,50,31,0,11,39
20,Fail,38,33,8,21,17
20,Success,48,34,3,15,33
20,Success,42,34,0,17,25
20,Success,50,39,3,8,42
20,Success,49,33,0,16,33
20,Success,45,38,2,15,30
20,Success,47,40,0,12,35
20,Success,51,31,8,10,41
20,Success,46,37,8,9,37
20,Success,50,35,0,15,35
20,Success,46,38,10,6,40
20,Success,47,36,0,9,38
20,Success,52,33,4,11,41
20,Success,47,37,0,11,36
20,Success,50,33,5,12,38
20,Success,59,24,0,15,44
20,Success,48,35,4,13,35
20,Success,53,28,3,16,37
20,Success,52,35,0,13,39
20,Success,51,34,3,12,39
20,Success,46,36,0,15,31
20,Success,46,32,6,16,30
20,Success,42,42,7,9,33
20,Success,48,35,5,12,36
20,Success,47,41,5,7,40
20,Success,44,36,6,14,30
20,Success,49,38,0,11,38
20,Success,46,29,9,16,30
20,Success,52,37,0,9,43
20,Success,56,29,0,13,43
20,Success,49,31,2,18,31
20,Success,55,27,0,13,42
20,Success,50,36,2,12,38
20,Success,50,35,0,12,38
20,Success,50,35,0,13,37
20,Success,52,34,2,12,40
20,Success,51,37,2,10,41
20,Success,48,33,0,13,35
20,Success,45,39,0,11,34
20,Success,51,37,0,11,40
20,Success,44,49,2,5,39
20,Success,46,37,3,14,32
20,Success,54,34,0,12,42
20,Success,52,32,0,16,36
20,Success,55,37,0,8,47
20,Success,51,30,7,12,39
20,Success,51,37,0,10,41
20,Success,42,43,6,9,33
20,Success,51,38,1,10,41
20,Success,52,29,4,15,37
20,Success,48,39,1,12,36
20,Success,46,36,0,16,30
20,Success,45,32,0,16,29
20,Success,50,32,3,15,35
20,Success,49,31,0,13,36
20,Fail,36,43,1,20,16
20,Success,42,33,0,21,21
20,Success,51,35,4,10,41
20,Success,51,35,5,9,42
20,Success,50,38,0,12,38
20,Success,50,29,0,13,37
20,Success,48,35,0,15,33
20,Success,44,40,4,12,32
20,Success,53,26,0,12,41
20,Success,51,29,0,13,38
20,Success,49,33,0,13,36
20,Success,47,41,0,5,42
20,Success,48,36,4,12,36
20,Success,45,34,0,14,31
20,Success,48,35,4,13,35
20,Success,52,37,3,8,44
20,Success,42,38,4,16,26
20,Success,45,36,7,12,33
20,Success,46,39,0,15,31
20,Success,45,33,0,16,29
20,Success,43,40,0,17,26
20,Success,53,36,0,11,42
20,Success,47,35,1,17,30
20,Success,53,35,5,7,46
20,Success,54,35,1,10,44
20,Success,46,41,4,9,37
20,Success,56,33,2,9,47
20,Fail,37,38,7,18,19
20,Success,49,41,1,9,40
20,Success,48,38,3,11,37
20,Success,46,36,0,17,29
20,Success,45,40,2,13,32
20,Success,52,27,7,14,38
20,Success,47,37,0,12,35
20,Success,55,31,1,13,42
20,Success,50,38,3,9,41
20,Success,49,35,1,15,34
20,Success,46,33,2,19,27
20,Success,53,31,2,14,39
20,Success,52,30,8,10,42
20,Success,46,36,0,9,37
20,Success,47,41,2,10,37
20,Success,44,33,0,14,30
20,Success,52,35,0,10,42
20,Success,52,37,0,6,46
20,Success,45,36,0,14,31
20,Success,54,35,0,9,45
20,Success,43,44,0,11,32
20,Success,41,30,10,19,22
20,Success,45,44,0,10,35
20,Success,55,29,0,15,40
20,Success,56,28,2,14,42
20,Success,49,37,0,10,39
20,Success,43,41,0,15,28
20,Success,46,37,3,14,32
20,Success,38,38,7,17,21
20,Success,46,38,4,12,34
20,Success,45,32,0,19,26
20,Success,50,36,0,12,38
20,Success,52,34,1,13,39
20,Success,38,40,0,13,25
20,Success,44,37,2,17,27
20,Success,47,32,5,16,31
20,Success,46,38,5,11,35
20,Success,42,39,0,15,27
20,Success,51,32,4,13,38
20,Success,42,45,2,11,31
20,Success,49,35,1,15,34
20,Success,50,34,0,16,34
20,Success,50,41,0,8,42
20,Success,52,38,0,10,42
20,Success,44,39,0,14,30
20,Success,47,39,0,10,37
20,Success,43,34,0,16,27
20,Success,45,33,0,17,28
20,Success,43,35,0,13,30
20,Success,50,36,0,10,40
20,Success,54,38,3,5,49
20,Success,41,33,12,14,27
20,Success,49,33,0,13,36
20,Success,48,37,0,13,35
20,Success,50,30,0,14,36
20,Success,47,41,0,11,36
20,Success,41,34,5,20,21
20,Success,46,36,1,17,29
20,Success,49,33,0,11,38
20,Success,43,40,0,16,27
20,Success,52,40,0,6,46
20,Success,48,36,2,14,34
20,Success,45,43,0,10,35
20,Success,43,44,0,10,33
20,Success,55,28,4,13,42
20,Success,49,38,0,10,39
20,Success,51,35,4,10,41
20,Success,50,40,0,6,44
20,Success,59,22,0,11,48
20,Success,50,36,0,13,37
20,Success,50,36,3,11,39
20,Success,49,36,2,13,36
20,Success,56,31,3,10,46
20,Success,55,29,0,15,40
20,Success,46,40,0,13,33
20,Success,53,38,1,8,45
20,Success,46,34,0,16,30
20,Success,46,42,1,11,35
20,Success,41,44,6,9,32
20,Success,45,35,5,15,30
20,Success,38,40,5,17,21
20,Success,55,36,0,9,46
20,Success,43,40,0,9,34
20,Fail,36,39,0,18,18
20,Success,40,42,0,13,27
20,Success,48,40,0,12,36
20,Success,43,35,0,16,27
20,Success,47,38,0,12,35
20,Success,43,35,9,13,30
20,Success,41,50,0,8,33
20,Success,56,32,0,12,44
20,Success,51,36,4,9,42
20,Success,55,31,0,10,45
20,Success,48,38,0,13,35
20,Success,47,38,0,9,38
20,Success,53,27,3,17,36
20,Success,54,38,1,7,47
20,Success,52,35,0,11,41
20,Success,53,32,0,12,41
20,Success,49,31,5,15,34
20,Success,51,34,2,13,38
20,Success,48,35,3,14,34
20,Success,47,34,2,17,30
20,Success,49,35,0,12,37
20,Success,48,32,0,14,34
20,Success,47,34,0,8,39
20,Success,49,37,0,8,41
20,Success,45,34,4,17,28
20,Success,52,32,2,14,38
20,Success,57,30,3,10,47
20,Success,44,29,3,24,20
20,Success,51,29,0,17,34
20,Success,40,39,0,16,24
20,Success,50,38,2,10,40
20,Success,52,31,4,13,39
20,Success,38,43,3,16,22
20,Success,51,38,0,8,43
20,Success,51,37,0,7,44
20,Success,45,39,0,14,31
20,Success,56,32,0,9,47
20,Success,45,48,0,7,38
20,Success,35,41,12,12,23
20,Success,41,35,11,13,28
20,Success,49,31,5,15,34
20,Success,51,40,3,6,45
20,Success,44,36,7,13,31
20,Success,48,37,0,15,33
20,Success,48,36,0,11,37
20,Success,47,33,0,18,29
20,Success,49,37,0,11,38
20,Success,53,33,0,13,40
20,Success,44,33,9,14,30
20,Success,55,28,0,16,39
20,Success,50,33,0,8,42
20,Success,46,40,0,14,32
20,Success,53,35,0,5,48
20,Success,43,37,5,15,28
20,Success,52,35,0,12,40
20,Success,44,43,1,12,32
20,Success,49,37,2,12,37
20,Fail,39,32,6,23,16
20,Success,54,34,0,11,43
20,Success,46,37,0,12,34
20,Success,47,36,2,15,32
20,Success,57,36,0,7,50
20,Success,57,30,1,12,45
20,Success,44,41,0,14,30
20,Success,54,31,0,14,40
20,Success,55,31,0,11,44
20,Success,46,28,10,16,30
20,Success,47,30,5,18,29
20,Success,49,32,9,10,39
20,Success,45,37,3,15,30
20,Success,50,34,4,12,38
20,Success,44,39,7,10,34
20,Success,55,39,0,6,49
20,Success,52,33,1,14,38
20,Success,58,32,0,8,50
20,Success,53,34,5,8,45
20,Success,43,43,0,14,29
20,Success,42,32,0,9,33
20,Success,47,39,2,12,35
20,Success,50,36,2,12,38
20,Success,50,36,1,13,37
20,Success,50,34,12,4,46
20,Fail,41,30,0,22,19
20,Success,43,44,0,9,34
20,Success,54,32,5,9,45
20,Success,45,38,0,17,28
20,Success,49,38,0,12,37
20,Success,50,37,0,11,39
20,Success,46,35,2,17,29
20,Success,50,28,0,14,36
20,Success,44,41,2,13,31
20,Success,46,45,0,8,38
20,Success,49,28,7,16,33
20,Success,48,32,7,13,35
20,Success,45,36,0,11,34
20,Success,49,39,3,9,40
20,Success,46,31,4,19,27
20,Success,39,40,0,17,22
20,Success,45,39,1,15,30
20,Success,48,34,1,17,31
20,Success,50,39,2,9,41
20,Success,42,23,0,19,23
20,Success,45,37,1,17,28
20,Success,49,35,2,14,35
20,Success,45,40,3,12,33
20,Success,54,36,1,9,45
20,Success,55,31,0,9,46
20,Success,44,34,10,12,32
20,Success,41,39,0,15,26
20,Success,39,42,0,18,21
20,Success,59,29,0,11,48
20,Success,54,39,0,6,48
20,Success,45,37,3,15,30
20,Success,45,38,2,15,30
20,Success,53,34,0,8,45
20,Success,50,35,4,11,39
20,Success,50,31,0,13,37
20,Success,39,38,9,14,25
20,Success,46,33,6,15,31
20,Success,49,32,6,13,36
20,Fail,34,36,10,20,14
20,Success,39,47,2,12,27
20,Success,50,36,7,7,43
20,Success,55,28,4,13,42
20,Success,49,40,0,11,38
20,Success,49,37,0,13,36
20,Success,49,35,0,14,35
20,Success,43,37,1,19,24
20,Success,43,37,0,17,26
20,Success,56,27,0,16,40
20,Success,49,35,3,13,36
20,Success,46,39,0,13,33
20,Success,45,32,0,15,30
20,Success,46,35,0,14,32
20,Success,49,36,0,12,37
20,Success,49,31,0,12,37
20,Success,54,32,0,11,43
20,Success,55,33,3,9,46
20,Success,45,36,8,11,34
20,Success,53,32,0,13,40
20,Success,49,34,0,16,33
20,Success,47,39,8,6,41
20,Success,49,40,1,10,39
20,Success,49,28,0,19,30
20,Success,47,40,0,12,35
20,Success,51,38,3,8,43
20,Success,55,28,0,12,43
20,Success,43,36,8,13,30
20,Success,53,34,2,11,42
20,Success,51,35,0,14,37
20,Success,50,35,0,15,35
20,Success,50,35,0,13,37
20,Success,57,29,3,11,46
20,Success,49,35,0,11,38
20,Success,51,33,0,15,36
20,Success,39,46,0,13,26
20,Success,48,33,0,14,34
20,Success,47,41,0,10,37
20,Success,48,35,1,16,32
20,Success,45,35,10,10,35
20,Success,54,33,0,9,45
20,Success,43,30,9,18,25
20,Success,51,35,1,13,38
20,Success,55,29,5,11,44
20,Success,44,43,0,11,33
20,Success,44,37,0,19,25
20,Success,47,37,0,14,33
20,Success,52,33,0,13,39
20,Success,51,33,4,12,39
20,Success,52,37,1,10,42
20,Success,39,35,13,13,26
20,Success,53,36,0,11,42
20,Success,51,35,0,13,38
20,Success,46,33,10,11,35
20,Success,49,41,0,7,42
20,Success,44,40,2,14,30
20,Success,44,41,0,15,29
20,Success,49,33,0,17,32
20,Success,40,33,8,19,21
20,Success,45,41,0,11,34
20,Success,50,35,4,11,39
20,Success,47,28,0,7,40
20,Success,50,38,0,7,43
20,Success,49,39,1,11,38
20,Success,57,34,0,9,48
20,Success,44,34,0,14,30
20,Success,47,34,0,14,33
20,Fail,33,30,15,22,11
20,Success,46,43,0,8,38
20,Success,40,44,0,15,25
20,Success,48,33,0,18,30
20,Success,46,25,0,17,29
20,Success,50,33,7,10,40
20,Success,49,38,3,10,39
20,Success,49,31,0,12,37
20,Success,49,32,3,16,33
20,Success,45,38,6,11,34
20,Success,47,33,0,18,29
20,Success,44,34,4,18,26
20,Success,39,43,0,13,26
20,Success,45,33,6,16,29
20,Success,48,40,0,9,39
20,Success,48,37,0,15,33
20,Success,50,37,0,13,37
20,Success,42,45,0,11,31
20,Success,47,28,0,12,35
20,Success,44,35,6,15,29
20,Success,50,37,1,12,38
20,Success,44,36,0,13,31
20,Success,42,46,0,10,32
20,Success,50,37,1,12,38
20,Success,54,34,0,9,45
20,Success,47,39,1,13,34
20,Success,50,32,0,12,38
20,Success,48,35,0,14,34
20,Success,41,39,0,16,25
20,Success,46,40,1,13,33
20,Success,54,29,2,15,39
20,Success,50,34,5,11,39
20,Success,53,34,5,8,45
20,Success,43,39,0,16,27
20,Success,44,37,0,15,29
20,Success,48,31,0,13,35
20,Success,52,30,0,12,40
20,Success,41,38,4,17,24
20,Success,47,31,0,19,28
20,Success,47,37,0,14,33
20,Success,44,36,0,15,29
20,Success,44,44,0,12,32
20,Success,49,31,0,9,40
20,Success,48,42,3,7,41
20,Success,39,38,5,18,21
20,Success,55,35,0,10,45
20,Success,48,38,1,13,35
20,Success,43,44,0,13,30
20,Success,52,33,0,12,40
20,Success,50,38,0,12,38
20,Success,50,31,2,17,33
20,Success,46,40,0,11,35
20,Success,50,37,0,5,45
20,Success,41,46,1,12,29
20,Success,39,29,16,16,23
20,Success,47,34,0,17,30
20,Success,42,38,2,18,24
20,Success,50,38,0,8,42
20,Success,45,36,0,14,31
20,Success,45,38,0,15,30
20,Success,49,34,0,12,37
20,Success,51,32,0,11,40
20,Success,52,31,5,12,40
20,Success,48,36,0,11,37
20,Success,48,37,0,6,42
20,Success,53,33,4,10,43
20,Success,46,34,0,14,32
20,Success,47,35,5,13,34
20,Success,52,34,0,13,39
20,Success,42,32,0,17,25
20,Success,47,32,0,17,30
20,Success,50,35,1,14,36
20,Success,48,37,0,15,33
20,Success,50,38,0,10,40
20,Success,45,37,4,14,31
20,Success,43,37,3,17,26
20,Success,41,35,0,14,27
20,Success,45,37,2,16,29
20,Success,46,34,0,19,27
20,Success,45,37,4,14,31
20,Fail,40,36,3,21,19
20,Success,52,28,9,11,41
20,Success,50,39,2,9,41
20,Success,42,41,3,14,28
20,Success,43,40,0,15,28
20,Success,44,35,0,16,28
20,Success,51,33,0,14,37
20,Success,45,35,2,18,27
20,Success,44,42,0,13,31
20,Success,52,31,12,5,47
20,Success,55,29,3,13,42
20,Success,47,41,0,11,36
20,Success,54,36,0,10,44
20,Success,44,38,3,15,29
20,Success,40,44,0,11,29
20,Success,44,40,0,12,32
20,Success,51,37,5,7,44
20,Success,46,40,0,11,35
20,Success,46,34,0,11,35
20,Success,40,38,8,14,26
20,Success,56,42,0,2,54
20,Success,37,39,0,17,20
20,Success,54,29,0,12,42
20,Success,58,33,0,9,49
20,Success,46,35,0,12,34
20,Success,49,36,0,10,39
20,Success,43,36,6,15,28
20,Success,53,41,0,6,47
20,Fail,40,33,0,21,19
20,Success,55,29,5,11,44
20,Success,42,35,11,12,30
20,Success,52,29,0,14,38
20,Success,50,35,0,12,38
20,Success,51,35,0,13,38
20,Success,46,39,0,15,31
20,Success,40,43,3,14,26
20,Success,44,34,6,16,28
20,Success,55,33,1,11,44
20,Success,51,41,4,4,47
20,Success,54,33,0,11,43
20,Success,45,30,11,14,31
20,Success,44,37,3,16,28
20,Success,45,39,0,14,31
20,Success,45,44,2,9,36
20,Success,53,34,0,13,40
20,Success,47,32,4,17,30
20,Success,48,36,0,12,36
20,Success,50,35,0,10,40
20,Success,49,38,0,10,39
20,Success,45,35,4,16,29
20,Success,41,31,19,9,32
20,Success,43,33,0,20,23
20,Success,44,39,0,14,30
20,Success,46,29,6,19,27
20,Success,60,31,1,8,52
20,Success,47,35,4,14,33
20,Success,47,36,0,12,35
20,Success,51,41,1,7,44
20,Success,48,40,0,12,36
20,Success,50,37,0,11,39
20,Success,46,33,8,13,33
20,Success,46,40,0,14,32
20,Success,48,37,3,12,36
20,Success,45,40,0,12,33
20,Success,47,39,0,12,35
20,Success,54,35,4,7,47
20,Success,51,40,0,7,44
20,Success,56,33,2,9,47
20,Success,49,35,0,16,33
20,Success,44,39,2,15,29
20,Success,40,34,0,16,24
20,Success,49,32,3,16,33
20,Success,47,41,0,10,37
20,Success,42,41,2,15,27
20,Success,52,33,0,10,42
20,Success,49,34,0,15,34
20,Success,52,32,0,12,40
20,Success,51,37,2,10,41
20,Success,41,46,2,11,30
20,Success,56,33,0,10,46
20,Success,51,32,0,14,37
20,Success,42,46,0,9,33
20,Success,40,43,6,11,29
20,Success,46,28,0,18,28
20,Success,44,33,0,18,26
20,Success,58,31,0,10,48
20,Success,51,32,0,12,39
20,Success,44,37,0,14,30
20,Success,56,26,6,12,44
20,Success,52,34,0,11,41
20,Success,49,30,2,19,30
20,Success,51,27,0,10,41
20,Success,58,30,0,9,49
20,Success,56,30,3,11,45
20,Success,47,44,0,9,38
20,Success,42,36,0,15,27
20,Success,46,35,0,13,33
20,Success,42,33,4,21,21
20,Success,52,38,0,10,42
20,Success,46,35,8,11,35
20,Success,54,37,0,8,46
20,Success,52,36,1,11,41
20,Success,46,27,9,18,28
20,Success,49,38,1,12,37
20,Success,45,35,0,11,34
20,Success,42,42,0,16,26
20,Success,40,40,9,11,29
20,Success,56,32,0,11,45
20,Success,45,34,5,16,29
20,Success,53,32,0,12,41
20,Success,46,32,8,14,32
20,Success,46,38,0,11,35
20,Success,42,39,3,16,26
20,Success,53,28,8,11,42
20,Success,55,31,1,13,42
20,Success,40,41,0,18,22
20,Success,45,40,0,15,30
20,Success,48,40,0,10,38
20,Success,49,33,7,11,38
20,Success,39,42,0,12,27
20,Success,51,37,2,10,41
20,Success,56,31,0,13,43
20,Success,44,35,0,18,26
20,Success,43,33,0,16,27
20,Success,54,26,0,8,46
20,Success,52,39,0,9,43
20,Success,55,37,0,8,47
20,Success,43,38,8,11,32
20,Success,50,37,0,12,38
20,Success,47,34,3,16,31
20,Success,48,31,0,14,34
20,Success,49,29,4,18,31
20,Success,51,37,0,10,41
20,Success,46,36,0,15,31
20,Success,53,34,0,13,40
20,Success,55,30,3,12,43
20,Success,38,42,2,18,20
20,Success,46,38,4,12,34
20,Success,46,37,0,16,30
20,Success,41,35,0,18,23
20,Success,54,32,2,12,42
20,Success,52,35,1,12,40
20,Success,53,32,5,10,43
20,Success,49,30,0,12,37
20,Success,45,40,3,12,33
20,Success,45,29,9,17,28
20,Success,47,36,0,13,34
20,Success,58,27,2,13,45
20,Success,48,36,1,15,33
20,Success,51,37,0,11,40
20,Success,60,26,0,10,50
20,Success,53,32,0,12,41
20,Success,50,40,3,7,43
20,Success,44,36,6,14,30
20,Success,48,35,2,15,33
20,Success,46,29,11,14,32
20,Success,40,41,0,17,23
20,Success,46,32,0,16,30
20,Success,44,38,2,16,28
20,Success,44,43,3,10,34
20,Success,40,36,6,18,22
20,Success,52,36,0,12,40
20,Success,47,43,0,7,40
20,Success,54,36,1,9,45
20,Success,49,38,5,8,41
20,Success,50,32,0,11,39
20,Success,46,37,1,16,30
20,Success,51,35,1,13,38
20,Success,49,34,2,15,34
20,Success,49,29,8,14,35
20,Success,43,37,1,19,24
20,Success,46,36,1,17,29
20,Success,58,29,1,12,46
20,Success,41,43,0,9,32
20,Success,52,33,7,8,44
20,Success,40,32,0,20,20
20,Success,49,29,0,14,35
20,Success,48,29,0,21,27
20,Success,53,35,0,11,42
20,Success,51,35,3,11,40
20,Success,50,38,4,8,42
20,Success,49,34,0,10,39
20,Success,45,40,6,9,36
20,Success,54,23,6,17,37
20,Success,55,30,0,11,44
20,Success,49,33,0,13,36
20,Success,46,31,0,15,31
20,Success,50,36,0,14,36
20,Success,45,39,0,13,32
20,Success,41,46,0,8,33
20,Success,48,34,0,12,36
20,Success,50,44,0,4,46
20,Success,52,33,0,13,39
20,Success,48,30,4,18,30
20,Success,45,30,0,14,31
20,Success,48,38,0,10,38
20,Success,53,39,2,6,47
20,Success,50,35,2,13,37
20,Success,54,32,9,5,49
20,Success,46,40,5,9,37
20,Success,51,29,2,18,33
20,Success,49,35,1,15,34
20,Success,49,38,0,12,37
20,Success,51,37,2,10,41
20,Success,51,36,3,10,41
20,Success,51,40,0,7,44
20,Success,56,31,2,11,45
20,Success,41,38,2,19,22
20,Success,49,38,1,12,37
20,Success,43,40,0,13,30
20,Success,47,36,0,13,34
20,Success,51,35,0,14,37
20,Success,54,30,3,13,41
20,Success,46,39,0,13,33
20,Success,52,32,3,13,39
20,Success,40,41,0,18,22
20,Success,52,30,0,18,34
20,Success,54,32,0,11,43
20,Success,49,35,0,12,37
20,Success,48,38,0,12,36
20,Success,51,32,0,16,35
20,Success,56,37,0,6,50
20,Success,45,38,2,15,30
20,Success,49,27,10,14,35
20,Success,51,37,0,8,43
20,Success,42,44,0,12,30
20,Success,49,28,0,18,31
20,Success,42,38,7,13,29
20,Success,43,33,0,18,25
20,Success,51,38,0,11,40
20,Success,56,30,2,12,44
20,Success,39,42,0,16,23
20,Success,50,28,12,10,40
20,Success,53,33,0,11,42
20,Success,50,33,0,11,39
20,Success,57,31,0,8,49
20,Success,56,32,2,10,46
20,Success,57,35,1,7,50
20,Success,41,40,0,11,30
20,Success,46,38,0,12,34
20,Success,50,38,1,11,39
20,Success,53,35,1,11,42
20,Success,40,38,6,16,24
20,Success,52,32,2,14,38
20,Success,49,32,0,15,34
20,Success,51,34,0,11,40
20,Success,45,34,8,13,32
20,Success,43,34,0,17,26
20,Success,44,37,4,15,29
20,Success,41,38,10,11,30
20,Success,51,28,0,10,41
20,Success,45,38,0,12,33
20,Success,56,33,0,9,47
20,Success,49,33,0,12,37
20,Success,48,37,3,12,36
20,Success,47,37,2,14,33
20,Success,46,43,1,10,36
20,Fail,38,38,0,19,19
20,Success,47,34,0,14,33
20,Success,41,43,5,11,30
20,Success,49,36,0,15,34
20,Success,55,34,1,10,45
20,Success,49,36,6,9,40
20,Success,57,30,0,13,44
20,Success,49,40,0,8,41
20,Success,42,43,1,14,28
20,Success,48,31,3,18,30
20,Success,44,43,0,6,38
20,Success,48,37,0,14,34
20,Success,58,25,5,12,46
20,Success,41,39,5,15,26
20,Success,45,37,0,12,33
20,Success,48,43,0,8,40
20,Success,49,34,0,10,39
20,Success,44,40,0,11,33
20,Success,41,36,0,16,25
20,Success,44,40,3,13,31
20,Success,48,38,0,13,35
20,Success,42,37,0,13,29
20,Success,47,34,0,15,32
20,Success,51,35,0,11,40
20,Success,55,34,0,11,44
20,Success,46,42,3,9,37
20,Success,52,28,0,17,35
20,Success,55,35,1,9,46
20,Success,53,35,0,8,45
20,Success,48,38,3,11,37
20,Success,48,33,5,14,34
20,Success,48,36,0,12,36
20,Success,48,33,0,15,33
20,Success,49,38,0,11,38
20,Success,47,40,0,11,36
20,Success,51,32,0,11,40
20,Success,43,38,0,16,27
20,Success,50,34,4,12,38
20,Success,39,45,0,15,24
20,Success,40,40,10,10,30
20,Success,44,37,0,16,28
20,Success,52,27,7,14,38
20,Success,36,42,0,16,20
20,Success,50,32,0,15,35
20,Success,44,41,0,13,31
20,Success,54,36,2,8,46
20,Success,45,34,0,13,32
20,Success,40,45,0,15,25
20,Success,45,38,0,14,31
20,Success,49,36,3,12,37
20,Success,47,38,7,8,39
20,Success,50,34,2,14,36
20,Success,46,42,0,7,39
20,Success,43,40,0,12,31
20,Success,49,39,0,11,38
20,Success,47,40,6,7,40
20,Success,53,33,0,13,40
20,Success,47,41,0,12,35
20,Success,41,37,4,18,23
20,Success,47,37,0,11,36
20,Success,45,40,0,15,30
20,Success,44,46,1,9,35
20,Success,59,32,2,7,52
20,Success,45,36,0,19,26
20,Success,51,34,1,14,37
20,Success,49,34,0,15,34
20,Success,46,40,5,9,37
20,Success,44,35,5,16,28
20,Success,58,24,0,12,46
20,Success,48,42,2,8,40
20,Success,54,33,3,10,44
20,Success,46,37,2,15,31
20,Success,43,38,0,8,35
20,Success,51,34,0,12,39
20,Success,39,40,8,13,26
20,Success,48,30,0,18,30
20,Success,50,35,2,13,37
20,Success,51,29,6,14,37
20,Success,55,25,4,16,39
20,Success,40,42,0,12,28
20,Success,45,43,0,11,34
20,Success,47,37,0,11,36
20,Success,46,35,0,15,31
20,Success,54,27,0,16,38
20,Success,54,33,0,12,42
20,Success,40,47,1,12,28
20,Success,48,30,0,18,30
20,Success,45,33,0,18,27
20,Success,48,29,3,20,28
20,Success,49,34,0,11,38
20,Success,43,40,5,12,31
20,Fail,30,40,12,18,12
20,Success,46,36,0,16,30
20,Success,52,34,1,13,39
20,Success,48,34,6,12,36
20,Success,46,35,5,14,32
20,Success,48,39,5,8,40
20,Success,52,33,6,9,43
20,Success,49,34,6,11,38
20,Success,47,37,0,13,34
20,Success,58,34,0,7,51
20,Success,49,35,0,12,37
20,Success,44,36,2,18,26
20,Success,52,29,0,15,37
20,Success,42,41,0,10,32
20,Success,47,28,12,13,34
20,Success,47,34,0,17,30
20,Success,49,29,0,9,40
20,Success,41,38,6,15,26
20,Success,53,36,0,11,42
20,Success,46,35,3,16,30
20,Fail,39,33,8,20,19
20,Success,52,34,3,11,41
20,Success,46,37,0,10,36
20,Success,52,35,0,11,41
20,Success,44,41,0,14,30
20,Success,47,36,2,15,32
20,Success,54,28,0,14,40
20,Success,46,39,0,14,32
20,Success,50,33,0,9,41
20,Success,46,40,2,12,34
20,Success,41,34,7,18,23
20,Success,48,35,0,17,31
20,Success,51,33,4,12,39
20,Success,60,32,0,6,54
20,Success,55,30,5,10,45
20,Success,47,43,0,10,37
20,Success,50,32,2,16,34
20,Fail,40,37,0,23,17
20,Success,42,30,0,22,20
20,Success,50,36,1,13,37
20,Success,47,41,0,12,35
20,Success,45,45,1,9,36
20,Success,47,44,0,8,39
20,Success,42,40,8,10,32
20,Success,57,34,0,9,48
20,Success,43,38,5,14,29
20,Success,53,37,0,5,48
20,Success,52,31,4,13,39
20,Success,53,30,0,13,40
20,Success,44,42,0,13,31
20,Success,40,41,5,14,26
20,Success,48,33,6,13,35
20,Success,55,31,0,13,42
20,Success,49,33,5,13,36
20,Success,46,33,4,17,29
20,Success,49,36,0,14,35
20,Success,50,29,7,14,36
20,Success,45,42,0,11,34
20,Success,40,42,0,13,27
20,Success,50,32,2,16,34
20,Success,47,38,0,13,34
20,Success,44,39,5,12,32
20,Success,47,35,0,12,35
20,Success,44,39,0,16,28
20,Success,55,31,0,7,48
20,Success,39,42,3,16,23
20,Success,42,43,0,13,29
20,Success,52,35,0,12,40
20,Success,48,28,6,18,30
20,Success,59,37,1,3,56
20,Success,48,39,7,6,42
20,Success,43,38,0,19,24
20,Success,50,39,0,11,39
20,Success,45,50,0,5,40
20,Success,51,35,2,12,39
20,Success,47,37,5,11,36
20,Success,46,31,4,19,27
20,Success,46,32,7,15,31
20,Success,49,30,4,17,32
20,Success,55,28,1,16,39
20,Success,39,44,2,15,24
20,Success,42,41,2,15,27
20,Success,44,38,0,16,28
20,Success,57,22,0,17,40
20,Success,42,33,9,16,26
20,Success,41,37,0,16,25
20,Success,56,36,0,7,49
20,Success,40,40,0,14,26
20,Success,51,29,0,13,38
20,Success,46,37,3,14,32
20,Success,49,37,0,13,36
20,Success,42,49,0,5,37
20,Success,51,32,0,9,42
20,Success,50,28,0,13,37
20,Success,49,39,1,11,38
20,Success,44,35,9,12,32
20,Success,47,43,0,9,38
20,Success,58,30,0,10,48
20,Success,54,34,0,10,44
20,Success,54,32,0,9,45
20,Success,54,33,0,12,42
20,Success,53,28,3,16,37
20,Success,49,35,0,15,34
20,Fail,34,41,0,16,18
20,Success,57,32,0,10,47
20,Success,35,41,9,15,20
20,Success,42,39,0,18,24
20,Success,47,41,0,10,37
20,Success,54,35,2,9,45
20,Success,43,39,0,14,29
20,Success,45,32,0,17,28
20,Success,44,39,7,10,34
20,Success,43,42,0,9,34
20,Success,61,30,0,8,53
20,Success,54,34,3,9,45
20,Success,48,37,4,11,37
20,Success,51,37,0,11,40
20,Success,49,37,0,11,38
20,Success,47,39,0,10,37
20,Success,47,37,7,9,38
20,Success,48,33,0,16,32
20,Success,51,29,0,15,36
20,Success,40,41,3,16,24
20,Success,48,36,0,12,36
20,Success,47,37,4,12,35
20,Success,49,38,0,9,40
20,Success,46,30,6,18,28
20,Success,49,32,4,15,34
20,Success,42,44,4,10,32
20,Success,58,33,0,9,49
20,Success,48,36,0,16,32
20,Success,44,40,0,13,31
20,Success,42,40,0,15,27
20,Success,60,32,0,5,55
20,Success,45,39,0,14,31
20,Success,50,34,0,8,42
20,Success,50,33,2,15,35
20,Success,44,38,0,14,30
20,Success,51,38,2,9,42
20,Success,47,36,0,13,34
20,Success,38,43,4,15,23
20,Success,56,26,4,14,42
20,Success,42,39,0,19,23
20,Success,52,39,0,6,46
20,Success,56,31,0,9,47
20,Success,45,40,0,12,33
20,Success,43,32,11,14,29
20,Success,47,39,3,11,36
20,Success,61,25,0,12,49
20,Success,47,39,0,9,38
20,Success,54,30,1,15,39
20,Success,46,42,0,6,40
20,Success,54,28,0,15,39
20,Success,52,35,0,10,42
20,Success,45,47,0,7,38
20,Success,50,36,3,11,39
20,Success,38,40,5,17,21
20,Success,51,37,0,6,45
20,Success,47,38,0,10,37
20,Success,51,41,0,6,45
20,Success,45,40,0,12,33
20,Success,40,42,0,12,28
20,Success,47,39,2,12,35
20,Success,47,39,0,10,37
20,Success,46,42,0,9,37
20,Success,50,29,9,12,38
20,Success,47,34,6,13,34
20,Success,54,37,1,8,46
20,Success,56,34,0,10,46
20,Success,58,26,0,9,49
20,Success,42,34,0,21,21
20,Success,50,40,0,7,43
20,Success,44,38,1,17,27
20,Success,47,35,5,13,34
20,Success,49,37,3,11,38
20,Success,56,33,1,10,46
20,Success,47,34,0,14,33
20,Success,46,35,0,17,29
20,Success,53,34,2,11,42
20,Success,54,34,0,7,47
20,Success,44,40,0,15,29
20,Success,46,27,0,15,31
20,Success,41,36,6,17,24
20,Success,47,39,0,12,35
20,Success,50,40,0,8,42
20,Success,45,40,3,12,33
20,Success,49,32,7,12,37
20,Success,43,33,0,13,30
20,Success,45,37,3,15,30
20,Success,45,40,0,10,35
20,Success,47,43,0,8,39
20,Success,50,37,1,12,38
20,Success,43,37,6,14,29
20,Success,48,32,0,18,30
20,Success,40,40,7,13,27
20,Success,43,34,6,17,26
20,Success,44,35,6,15,29
20,Success,51,36,2,11,40
20,Success,50,33,1,16,34
20,Success,50,38,0,10,40
20,Success,50,41,0,7,43
20,Success,51,43,1,5,46
20,Success,47,38,0,8,39
20,Success,56,33,0,10,46
20,Success,52,38,0,7,45
20,Success,51,36,0,10,41
20,Success,40,33,0,20,20
20,Success,50,38,0,10,40
20,Success,47,39,0,11,36
20,Success,57,29,5,9,48
20,Success,44,33,0,14,30
20,Success,52,30,0,11,41
20,Success,45,40,2,13,32
20,Success,47,33,7,13,34
20,Success,43,40,0,17,26
20,Success,54,28,0,11,43
20,Success,48,29,0,20,28
20,Success,48,32,0,14,34
20,Success,51,43,0,6,45
20,Success,45,34,0,15,30
20,Success,48,35,6,11,37
20,Success,57,26,2,15,42
20,Success,50,36,0,11,39
20,Success,48,38,0,13,35
20,Success,35,43,0,14,21
20,Success,46,40,4,10,36
20,Success,50,38,3,9,41
20,Success,39,41,0,18,21
20,Success,46,42,2,10,36
20,Success,45,41,0,13,32
20,Success,46,38,0,11,35
20,Success,51,37,5,7,44
20,Success,56,33,0,6,50
20,Success,45,35,0,14,31
20,Success,43,39,0,13,30
20,Success,47,35,1,17,30
20,Success,45,41,2,12,33
20,Success,45,43,0,11,34
20,Success,45,34,4,17,28
20,Success,52,40,0,8,44
20,Success,45,32,0,14,31
20,Success,47,39,0,13,34
20,Success,45,41,4,10,35
20,Success,58,34,1,7,51
20,Success,50,33,0,14,36
20,Success,47,29,6,18,29
20,Success,52,29,0,18,34
20,Success,47,44,0,6,41
20,Success,44,32,0,19,25
20,Success,39,42,4,15,24
20,Success,52,40,0,4,48
20,Success,52,38,0,10,42
20,Success,53,32,4,11,42
20,Success,43,39,0,15,28
20,Success,43,39,2,16,27
20,Success,40,43,5,12,28
20,Success,52,28,3,17,35
20,Success,46,29,0,15,31
20,Success,45,38,8,9,36
20,Fail,42,33,2,23,19
20,Success,54,28,0,13,41
20,Success,45,31,11,13,32
20,Success,48,30,0,18,30
20,Success,50,34,2,14,36
20,Success,45,44,1,10,35
20,Success,48,35,7,10,38
20,Success,50,34,0,12,38
20,Success,47,36,0,11,36
20,Success,46,43,1,10,36
20,Success,45,41,2,12,33
20,Success,56,29,0,7,49
20,Success,49,38,3,10,39
20,Success,50,31,0,14,36
20,Success,48,33,0,14,34
20,Success,52,34,0,9,43
20,Success,48,37,0,12,36
20,Success,47,35,0,17,30
20,Success,45,33,5,17,28
20,Success,49,28,5,18,31
20,Success,43,33,0,15,28
20,Success,49,41,0,10,39
20,Success,44,36,5,15,29
20,Success,37,46,0,13,24
20,Success,50,30,0,13,37
20,Success,46,37,6,11,35
20,Success,39,36,11,14,25
20,Success,47,33,6,14,33
20,Success,42,39,6,13,29
20,Success,49,34,0,15,34
20,Success,43,38,7,12,31
20,Success,49,40,3,8,41
20,Success,52,32,4,12,40
20,Success,48,35,1,16,32
20,Success,41,43,2,14,27
20,Success,55,36,0,8,47
20,Success,44,39,0,17,27
20,Success,54,33,1,12,42
20,Success,47,42,0,8,39
20,Success,48,37,0,15,33
20,Success,42,41,1,16,26
20,Success,49,35,1,15,34
20,Success,39,44,0,17,22
20,Success,48,30,0,13,35
20,Success,44,38,0,14,30
20,Success,47,35,2,16,31
20,Success,49,30,9,12,37
20,Success,50,42,4,4,46
20,Success,50,38,2,10,40
20,Success,51,38,0,10,41
20,Success,42,36,8,14,28
20,Success,52,36,2,10,42
20,Success,45,39,0,15,30
20,Success,50,34,0,13,37
20,Success,47,32,4,17,30
20,Success,54,36,3,7,47
20,Success,48,38,3,11,37
20,Success,47,42,1,10,37
20,Success,45,33,6,16,29
20,Success,48,29,1,22,26
20,Success,50,36,5,9,41
20,Success,55,35,0,7,48
20,Success,43,31,7,19,24
20,Success,49,34,4,13,36
20,Success,42,45,0,9,33
20,Success,54,35,2,9,45
20,Success,48,31,0,16,32
20,Success,47,35,9,9,38
20,Success,46,37,0,9,37
20,Success,43,34,0,12,31
20,Success,54,31,0,15,39
20,Success,44,38,9,9,35
20,Success,50,37,0,12,38
20,Success,49,40,0,10,39
20,Success,58,30,0,11,47
20,Success,44,47,1,8,36
20,Success,52,28,0,15,37
20,Success,47,33,10,10,37
20,Success,47,30,8,15,32
20,Success,51,34,7,8,43
20,Success,46,37,6,11,35
20,Success,47,35,0,16,31
20,Success,46,32,0,14,32
20,Success,44,31,0,17,27
20,Success,44,42,5,9,35
20,Success,45,35,5,15,30
20,Success,52,34,1,13,39
20,Success,46,41,4,9,37
20,Success,48,35,0,11,37
20,Success,54,35,0,11,43
20,Success,43,41,0,10,33
20,Success,50,34,1,15,35
20,Success,48,29,0,17,31
20,Success,44,32,0,12,32
20,Success,47,37,0,13,34
20,Success,47,32,0,19,28
20,Success,49,40,0,7,42
20,Success,55,24,6,15,40
20,Success,50,30,0,10,40
20,Success,47,37,2,14,33
20,Success,45,33,0,17,28
20,Success,49,29,0,16,33
20,Success,54,29,5,12,42
20,Success,48,36,0,15,33
20,Success,42,38,0,12,30
20,Success,51,36,3,10,41
20,Success,49,37,0,14,35
20,Success,52,33,0,14,38
20,Success,47,37,0,12,35
20,Success,48,25,9,18,30
20,Success,45,37,0,17,28
20,Success,40,35,9,16,24
20,Success,41,32,0,17,24
20,Success,51,36,0,12,39
20,Success,56,35,0,8,48
20,Success,48,34,0,14,34
20,Success,45,40,0,12,33
20,Success,48,35,5,12,36
20,Success,43,43,5,9,34
20,Success,48,36,0,15,33
20,Success,48,36,0,10,38
20,Success,47,38,0,11,36
20,Success,53,33,0,13,40
20,Success,52,36,0,6,46
20,Success,56,27,0,12,44
20,Success,52,26,0,10,42
20,Success,38,37,0,16,22
20,Success,49,37,3,11,38
20,Success,55,31,0,11,44
20,Success,48,34,0,14,34
20,Success,44,40,0,14,30
20,Success,48,28,0,11,37
20,Success,45,37,0,18,27
20,Success,48,34,0,17,31
20,Success,47,32,0,15,32
20,Success,47,35,10,8,39
20,Success,42,37,0,18,24
20,Success,57,26,0,14,43
20,Success,55,34,0,10,45
20,Success,52,34,4,10,42
20,Success,44,37,0,11,33
20,Success,51,37,0,10,41
20,Success,45,40,0,10,35
20,Success,43,36,6,15,28
20,Success,53,27,0,17,36
20,Success,46,32,5,17,29
20,Success,45,35,0,13,32
20,Success,47,33,0,14,33
20,Success,51,30,0,15,36
20,Success,54,35,1,10,44
20,Success,55,34,0,10,45
20,Success,50,32,0,18,32
20,Success,50,34,0,11,39
20,Success,50,38,0,11,39
20,Success,51,35,0,8,43
20,Success,51,39,6,4,47
20,Success,39,40,0,12,27
20,Success,54,32,4,10,44
20,Success,55,32,0,10,45
20,Success,53,35,3,9,44
20,Success,46,37,3,14,32
20,Fail,35,35,13,17,18
20,Success,44,39,5,12,32
20,Fail,35,37,0,18,17
20,Success,49,31,4,16,33
20,Success,54,27,7,12,42
20,Success,49,32,0,16,33
20,Success,48,35,2,15,33
20,Success,54,31,0,12,42
20,Success,45,37,0,15,30
20,Success,49,34,0,13,36
20,Success,49,41,1,9,40
20,Success,53,29,7,11,42
20,Success,48,35,7,10,38
20,Success,42,40,0,13,29
20,Success,49,29,8,14,35
20,Success,55,29,4,12,43
20,Success,52,40,0,6,46
20,Success,49,36,3,12,37
20,Success,50,35,4,11,39
20,Fail,38,36,7,19,19
20,Success,47,43,0,8,39
20,Success,45,36,4,15,30
20,Success,51,31,8,10,41
20,Success,46,39,4,11,35
20,Success,49,35,0,12,37
20,Success,51,31,0,13,38
20,Success,46,33,11,10,36
20,Success,43,47,0,7,36
20,Success,54,34,0,10,44
20,Success,42,38,10,10,32
20,Success,44,46,0,8,36
20,Success,45,37,1,17,28
20,Success,46,36,0,16,30
20,Success,42,46,0,12,30
20,Success,59,30,2,9,50
20,Success,51,29,0,15,36
20,Success,52,35,2,11,41
20,Success,54,30,0,9,45
20,Fail,36,39,0,18,18
20,Success,44,41,0,15,29
20,Success,53,35,0,12,41
20,Success,47,35,0,13,34
20,Success,55,36,1,8,47
20,Success,49,40,0,7,42
20,Success,45,38,0,12,33
20,Success,44,41,0,14,30
20,Success,47,36,0,13,34
20,Success,54,35,0,11,43
20,Success,43,45,3,9,34
20,Success,54,35,2,9,45
20,Success,47,35,5,13,34
20,Success,40,35,0,13,27
20,Success,53,35,0,5,48
20,Success,42,35,0,11,31
20,Success,45,41,0,14,31
20,Success,45,49,0,5,40
20,Success,59,33,0,7,52
20,Success,46,39,0,6,40
20,Success,48,33,3,16,32
20,Success,43,38,6,13,30
20,Success,47,39,1,13,34
20,Success,52,36,2,10,42
20,Success,50,35,0,13,37
20,Success,49,39,3,9,40
20,Success,40,42,4,14,26
20,Success,48,35,0,16,32
20,Success,43,44,0,11,32
20,Success,45,39,0,11,34
20,Success,45,38,6,11,34
20,Success,44,35,0,16,28
20,Success,49,38,4,9,40
20,Success,49,40,2,9,40
20,Success,43,37,11,9,34
20,Success,50,35,0,11,39
20,Success,41,26,0,19,22
20,Success,49,32,0,11,38
20,Success,50,37,0,9,41
20,Fail,39,33,7,21,18
20,Success,48,39,0,12,36
20,Success,54,34,1,11,43
20,Success,51,32,5,12,39
20,Success,60,27,0,12,48
20,Success,48,37,0,7,41
20,Success,47,37,2,14,33
20,Success,51,38,5,6,45
20,Success,43,38,3,16,27
20,Success,52,38,0,8,44
20,Success,51,39,0,9,42
20,Success,48,38,7,7,41
20,Success,46,36,4,14,32
20,Success,51,31,0,14,37
20,Success,47,34,6,13,34
20,Success,51,31,0,14,37
20,Success,50,32,0,13,37
20,Success,54,38,2,6,48
20,Success,50,41,1,8,42
20,Success,50,31,0,17,33
20,Success,43,42,2,13,30
20,Success,48,32,4,16,32
20,Success,48,37,2,13,35
20,Success,50,34,12,4,46
20,Success,58,30,4,8,50
20,Success,47,33,0,13,34
20,Success,53,34,2,11,42
20,Success,41,37,0,15,26
20,Success,59,22,10,9,50
20,Success,45,27,0,19,26
20,Success,42,35,0,11,31
20,Success,46,36,2,16,30
20,Success,46,42,0,11,35
20,Success,48,38,1,13,35
20,Success,49,33,5,13,36
20,Success,44,38,8,10,34
20,Success,41,35,9,15,26
20,Success,44,38,0,15,29
20,Success,47,31,0,17,30
20,Success,48,41,0,10,38
20,Success,50,34,0,8,42
20,Success,58,31,2,9,49
20,Success,49,36,0,15,34
20,Success,49,38,0,12,37
20,Success,48,31,5,16,32
20,Success,42,37,4,17,25
20,Success,52,30,7,11,41
20,Success,46,39,5,10,36
20,Success,46,32,2,20,26
20,Success,44,36,0,15,29
20,Success,50,35,0,10,40
20,Success,43,29,8,20,23
20,Success,51,32,0,15,36
20,Success,46,38,4,12,34
20,Success,39,38,8,15,24
20,Success,46,37,6,11,35
20,Success,45,35,0,15,30
20,Success,49,35,5,11,38
20,Success,63,29,0,7,56
20,Success,40,40,0,16,24
20,Success,45,33,0,17,28
20,Success,56,31,0,12,44
20,Success,51,36,0,11,40
20,Success,42,43,1,14,28
20,Success,49,28,0,15,34
20,Success,45,34,0,14,31
20,Success,47,39,0,11,36
20,Success,45,34,0,19,26
20,Success,51,35,0,13,38
20,Success,51,39,2,8,43
20,Success,50,41,2,7,43
20,Success,45,37,0,13,32
20,Success,50,37,0,10,40
20,Success,49,29,0,9,40
20,Success,52,35,2,11,41
20,Success,43,32,0,15,28
20,Success,52,37,2,9,43
20,Success,48,40,4,8,40
20,Success,47,36,0,13,34
20,Success,45,34,7,14,31
20,Success,60,33,0,7,53
20,Success,51,34,0,11,40
20,Success,49,29,0,15,34
20,Success,44,38,0,11,33
20,Success,41,37,5,17,24
20,Success,47,31,0,14,33
20,Success,47,39,0,10,37
20,Success,43,34,2,21,22
20,Success,44,38,8,10,34
20,Success,49,41,4,6,43
20,Success,43,46,2,9,34
20,Success,48,32,0,14,34
20,Success,62,25,0,12,50
20,Success,48,35,6,11,37
20,Success,44,37,3,16,28
20,Success,44,35,4,17,27
20,Success,48,33,0,16,32
20,Success,50,36,1,13,37
20,Success,41,36,0,11,30
20,Success,52,29,0,15,37
20,Success,48,39,0,9,39
20,Success,46,40,0,11,35
20,Success,45,34,9,12,33
20,Success,44,33,0,14,30
20,Success,50,34,0,11,39
20,Success,53,37,0,10,43
20,Success,52,32,5,11,41
20,Success,52,31,0,13,39
20,Success,42,35,0,17,25
20,Success,40,48,0,10,30
20,Success,45,41,0,7,38
20,Success,50,35,0,9,41
20,Success,47,38,5,10,37
20,Success,53,34,6,7,46
20,Success,50,34,0,15,35
20,Success,52,33,0,13,39
20,Fail,40,31,6,23,17
20,Success,43,40,0,16,27
20,Success,51,35,4,10,41
20,Success,44,34,0,13,31
20,Success,51,38,0,11,40
20,Success,45,40,0,13,32
20,Success,46,40,0,13,33
20,Success,46,33,5,16,30
20,Success,50,28,6,16,34
20,Success,48,35,6,11,37
20,Success,51,32,0,13,38
20,Success,44,37,0,14,30
20,Success,49,29,9,13,36
20,Success,50,31,0,15,35
20,Success,45,38,0,12,33
20,Success,46,38,0,13,33
20,Success,50,38,0,9,41
20,Success,53,28,4,15,38
20,Success,56,33,0,7,49
20,Success,49,42,0,9,40
20,Success,40,41,0,11,29
20,Success,50,35,0,10,40
20,Success,49,37,0,7,42
20,Success,59,28,2,11,48
20,Success,56,32,0,10,46
20,Success,43,41,6,10,33
20,Success,47,33,1,19,28
20,Success,49,38,0,11,38
20,Success,49,36,5,10,39
20,Success,48,42,0,9,39
20,Success,50,40,3,7,43
20,Success,51,32,0,13,38
20,Success,55,32,1,12,43
20,Success,43,39,4,14,29
20,Success,55,28,6,11,44
20,Success,51,38,0,10,41
20,Success,44,41,2,13,31
20,Success,49,43,0,7,42
20,Success,40,39,4,17,23
20,Success,46,33,2,19,27
20,Success,47,35,0,13,34
20,Success,46,39,4,11,35
20,Success,42,38,0,17,25
20,Success,42,39,12,7,35
20,Success,50,38,3,9,41
20,Success,50,33,0,16,34
20,Success,52,35,0,10,42
20,Success,42,41,3,14,28
20,Success,50,31,9,10,40
20,Success,51,36,4,9,42
20,Success,47,39,4,10,37
20,Success,48,35,0,12,36
20,Success,39,35,8,18,21
20,Success,45,44,0,9,36
20,Success,51,37,1,11,40
20,Success,54,36,1,9,45
20,Success,45,37,0,11,34
20,Success,50,38,0,11,39
20,Success,46,30,0,18,28
20,Success,47,32,0,18,29
20,Success,46,37,2,15,31
20,Success,48,29,0,12,36
20,Success,47,40,0,13,34
20,Success,49,29,0,13,36
20,Success,45,42,4,9,36
20,Success,45,41,4,10,35
20,Success,50,30,0,17,33
20,Success,51,25,0,19,32
20,Success,51,37,1,11,40
20,Success,51,32,0,14,37
20,Success,59,31,5,5,54
20,Success,48,34,2,16,32
20,Success,47,34,0,13,34
20,Success,46,35,0,19,27
20,Success,48,45,0,6,42
20,Success,42,46,0,12,30
20,Success,51,37,2,10,41
20,Success,61,29,3,7,54
20,Success,51,35,0,14,37
20,Success,48,41,0,9,39
20,Success,45,35,0,16,29
20,Success,44,39,0,16,28
20,Success,48,31,0,15,33
20,Success,48,39,0,9,39
20,Success,42,35,0,19,23
20,Success,48,34,0,11,37
20,Success,48,29,1,22,26
20,Success,48,43,0,9,39
20,Success,49,38,5,8,41
20,Success,48,32,0,12,36
20,Success,46,37,1,16,30
20,Success,45,34,0,20,25
20,Success,50,40,0,10,40
20,Success,44,34,0,16,28
20,Success,47,43,0,7,40
20,Success,49,37,3,11,38
20,Fail,33,45,7,15,18
20,Success,45,39,0,15,30
20,Success,46,36,0,12,34
20,Success,45,37,0,10,35
20,Success,44,33,4,19,25
20,Success,47,32,0,16,31
20,Success,43,38,1,18,25
20,Success,48,34,0,11,37
20,Success,43,40,6,11,32
20,Success,50,36,0,12,38
20,Success,51,36,0,11,40
20,Success,51,35,5,9,42
20,Success,41,44,0,12,29
20,Success,45,38,0,16,29
20,Success,53,38,4,5,48
20,Success,50,29,0,12,38
20,Success,48,38,0,14,34
20,Success,46,36,9,9,37
20,Success,45,36,0,18,27
20,Success,52,30,5,13,39
20,Success,46,39,0,8,38
20,Success,52,35,0,8,44
20,Success,54,30,0,11,43
20,Success,51,37,0,12,39
20,Success,49,34,4,13,36
20,Success,54,34,2,10,44
20,Success,57,34,0,9,48
20,Success,50,36,5,9,41
20,Success,51,37,2,10,41
20,Success,59,33,0,8,51
20,Success,48,32,7,13,35
20,Success,51,34,4,11,40
20,Success,46,38,0,9,37
20,Success,46,35,0,12,34
20,Success,44,42,5,9,35
20,Success,54,40,1,5,49
20,Success,48,40,2,10,38
20,Success,44,38,0,11,33
20,Success,56,29,7,8,48
20,Success,52,35,0,13,39
20,Success,52,37,0,10,42
20,Success,46,35,0,15,31
20,Success,43,33,0,12,31
20,Success,56,37,1,6,50
20,Success,43,42,0,11,32
20,Success,46,41,1,12,34
20,Success,47,35,8,10,37
20,Success,55,32,0,11,44
20,Success,56,33,1,10,46
20,Success,43,32,13,12,31
20,Success,45,39,0,11,34
20,Success,49,34,6,11,38
20,Success,53,34,3,10,43
20,Success,52,37,0,8,44
20,Success,45,43,0,10,35
20,Success,51,33,3,13,38
20,Success,44,37,10,9,35
20,Fail,38,39,0,19,19
20,Success,54,35,0,9,45
20,Success,61,28,0,10,51
20,Success,48,34,4,14,34
20,Success,52,29,6,13,39
20,Success,53,32,0,14,39
20,Success,47,38,0,10,37
20,Success,49,31,6,14,35
20,Success,45,35,5,15,30
20,Success,54,35,3,8,46
20,Success,45,32,7,16,29
20,Success,47,42,2,9,38
20,Success,42,46,0,12,30
20,Success,43,39,0,13,30
20,Success,45,26,0,20,25
20,Success,51,36,0,10,41
20,Success,52,28,5,15,37
20,Success,52,33,5,10,42
20,Success,47,31,0,14,33
20,Success,43,39,0,13,30
20,Success,57,32,2,9,48
20,Success,58,30,0,12,46
20,Fail,34,43,0,15,19
20,Success,46,40,0,14,32
20,Success,45,38,2,15,30
20,Success,52,34,0,14,38
20,Success,45,35,0,16,29
20,Success,50,35,0,14,36
20,Success,49,40,1,10,39
20,Success,51,37,0,10,41
20,Success,52,29,1,18,34
20,Success,44,36,0,17,27
20,Success,52,43,0,5,47
20,Success,47,41,0,12,35
20,Success,49,40,0,8,41
20,Success,48,40,0,11,37
20,Success,45,33,7,15,30
20,Success,52,34,0,14,38
20,Success,44,40,0,13,31
20,Success,39,42,3,16,23
20,Success,54,33,2,11,43
20,Success,40,44,0,14,26
20,Success,48,37,3,12,36
20,Success,57,30,3,10,47
20,Success,48,38,0,11,37
20,Success,48,41,5,6,42
20,Success,45,30,0,16,29
20,Success,52,32,3,13,39
20,Success,49,33,0,14,35
20,Success,49,31,11,9,40
20,Success,47,40,0,13,34
20,Success,53,37,0,10,43
20,Success,48,32,0,13,35
20,Success,46,34,7,13,33
20,Success,44,39,0,10,34
20,Success,52,39,0,8,44
20,Success,48,37,0,14,34
20,Success,45,35,7,13,32
20,Success,50,41,1,8,42
20,Success,41,40,8,11,30
20,Success,59,29,0,11,48
20,Success,58,31,2,9,49
20,Success,48,38,4,10,38
20,Success,49,39,1,11,38
20,Success,50,30,2,18,32
20,Success,54,25,3,18,36
20,Success,54,29,6,11,43
20,Success,46,32,0,18,28
20,Success,46,39,4,11,35
20,Success,53,31,3,13,40
20,Success,43,38,0,11,32
20,Success,43,41,6,10,33
20,Success,45,34,5,16,29
20,Success,43,36,6,15,28
20,Success,51,38,0,9,42
20,Success,51,35,7,7,44
20,Success,46,31,0,20,26
20,Success,49,38,1,12,37
20,Success,48,28,6,18,30
20,Success,43,37,2,18,25
20,Success,44,30,8,18,26
20,Success,51,33,0,8,43
20,Success,51,39,1,9,42
20,Success,58,33,1,8,50
20,Success,53,32,4,11,42
20,Success,45,36,0,13,32
20,Success,43,39,0,15,28
20,Success,55,35,0,10,45
20,Success,49,40,2,9,40
20,Success,51,39,3,7,44
20,Success,48,37,5,10,38
20,Success,46,36,0,13,33
20,Success,48,34,7,11,37
20,Success,52,33,0,12,40
20,Success,43,44,0,11,32
20,Success,48,34,3,15,33
20,Success,48,34,0,13,35
20,Success,51,33,0,15,36
20,Success,46,37,0,13,33
20,Success,50,38,0,10,40
20,Success,48,31,6,15,33
20,Success,59,29,0,11,48
20,Success,46,29,9,16,30
20,Success,44,37,4,15,29
20,Success,46,34,0,15,31
20,Success,51,40,2,7,44
20,Success,50,33,0,13,37
20,Success,42,37,0,15,27
20,Success,50,36,0,14,36
20,Success,51,35,1,13,38
20,Success,45,36,7,12,33
20,Success,49,34,0,13,36
20,Success,47,34,5,14,33
20,Success,46,39,1,14,32
20,Success,51,40,2,7,44
20,Success,44,32,6,18,26
20,Success,42,42,0,13,29
20,Success,54,34,3,9,45
20,Success,53,31,0,16,37
20,Success,50,32,5,13,37
20,Success,53,32,3,12,41
20,Success,52,30,1,17,35
20,Success,54,31,3,12,42
20,Success,45,40,0,15,30
20,Success,53,34,0,13,40
20,Success,51,36,3,10,41
20,Success,43,32,5,20,23
20,Success,49,28,6,17,32
20,Success,44,36,0,14,30
20,Success,48,33,9,10,38
20,Success,48,30,0,17,31
20,Success,54,34,1,11,43
20,Success,48,39,0,10,38
20,Success,45,41,0,9,36
20,Success,51,31,0,13,38
20,Success,47,38,0,14,33
20,Success,56,32,2,10,46
20,Success,45,31,7,17,28
20,Success,49,30,5,16,33
20,Success,55,28,0,10,45
20,Success,41,45,2,12,29
20,Success,51,26,0,22,29
20,Success,41,45,1,13,28
20,Success,49,34,0,14,35
20,Success,46,36,1,17,29
20,Success,47,22,13,18,29
20,Success,49,33,5,13,36
20,Success,42,41,0,16,26
20,Success,48,34,2,16,32
20,Success,53,38,4,5,48
20,Success,47,42,0,11,36
20,Success,47,35,4,14,33
20,Success,39,49,2,10,29
20,Success,46,32,4,18,28
20,Success,48,35,2,15,33
20,Success,49,30,0,15,34
20,Success,55,35,0,10,45
20,Success,45,36,9,10,35
20,Success,51,36,0,13,38
20,Success,51,39,0,10,41
20,Success,47,30,8,15,32
20,Success,45,32,0,13,32
20,Success,49,40,0,11,38
20,Success,47,32,4,17,30
20,Success,43,40,0,9,34
20,Success,48,34,7,11,37
20,Success,54,31,4,11,43
20,Success,46,46,0,7,39
20,Success,42,50,1,7,35
20,Success,49,37,6,8,41
20,Success,49,35,5,11,38
20,Success,49,27,0,18,31
20,Success,44,32,0,13,31
20,Success,51,33,7,9,42
20,Success,54,33,0,11,43
20,Success,43,44,1,12,31
20,Success,45,37,7,11,34
20,Success,47,35,7,11,36
20,Success,42,39,0,14,28
20,Success,55,34,0,11,44
20,Success,43,34,0,15,28
20,Success,48,40,0,9,39
20,Success,40,44,7,9,31
20,Success,38,42,0,15,23
20,Success,46,34,7,13,33
20,Success,48,37,3,12,36
20,Success,48,37,0,12,36
20,Success,53,38,3,6,47
20,Success,41,41,0,12,29
20,Success,46,37,0,16,30
20,Success,49,37,2,12,37
20,Success,44,42,0,11,33
20,Success,44,38,0,12,32
20,Success,48,37,0,11,37
20,Success,55,26,0,13,42
20,Success,46,36,0,15,31
20,Success,48,34,7,11,37
20,Success,50,35,8,7,43
20,Success,50,39,2,9,41
20,Success,46,34,6,14,32
20,Success,45,35,5,15,30
20,Success,38,44,4,14,24
20,Success,40,30,10,20,20
20,Success,49,41,0,9,40
20,Success,50,33,5,12,38
20,Success,49,29,0,15,34
20,Success,52,34,2,12,40
20,Success,47,38,7,8,39
20,Success,43,37,4,16,27
20,Success,52,34,2,12,40
20,Success,44,36,0,12,32
20,Success,44,41,0,14,30
20,Success,43,41,4,12,31
20,Success,51,33,0,16,35
20,Success,48,32,4,16,32
20,Success,49,26,10,15,34
20,Success,53,31,2,14,39
20,Success,50,36,0,10,40
20,Success,49,29,0,15,34
20,Success,49,34,0,11,38
20,Success,52,31,0,8,44
20,Success,45,33,0,17,28
20,Success,52,37,4,7,45
20,Success,48,33,6,13,35
20,Success,48,38,3,11,37
20,Success,47,32,8,13,34
20,Success,38,35,12,15,23
20,Success,48,31,4,17,31
20,Success,44,39,5,12,32
20,Success,52,41,0,6,46
20,Success,42,40,2,16,26
20,Success,51,37,0,4,47
20,Success,45,32,9,14,31
20,Success,53,28,2,17,36
20,Success,43,42,0,11,32
20,Success,49,37,4,10,39
20,Success,53,27,5,15,38
20,Success,49,32,0,16,33
20,Success,53,35,0,12,41
20,Success,42,45,1,12,30
20,Success,47,34,0,14,33
20,Success,53,42,0,5,48
20,Success,45,37,0,18,27
20,Success,58,30,0,10,48
20,Success,48,34,0,17,31
20,Success,52,35,4,9,43
20,Success,51,38,3,8,43
20,Success,40,42,3,15,25
20,Success,46,38,0,9,37
20,Success,48,38,0,12,36
20,Success,46,40,0,12,34
20,Success,52,35,0,12,40
20,Success,54,27,0,15,39
20,Success,47,28,0,16,31
20,Success,55,35,0,10,45
20,Success,46,38,3,13,33
20,Success,46,40,0,13,33
20,Success,42,31,8,19,23
20,Success,42,40,0,11,31
20,Success,41,34,0,17,24
20,Success,43,39,3,15,28
20,Success,47,35,0,13,34
20,Success,54,36,0,10,44
20,Success,49,37,0,14,35
20,Success,44,39,0,15,29
20,Success,45,45,2,8,37
20,Success,53,35,0,7,46
20,Success,52,34,3,11,41
20,Success,51,39,0,10,41
20,Success,52,34,0,12,40
20,Success,44,44,4,8,36
20,Success,53,38,2,7,46
20,Success,43,38,3,16,27
20,Success,39,44,0,15,24
20,Success,47,36,0,11,36
20,Success,46,34,7,13,33
20,Success,44,35,6,15,29
20,Success,50,35,1,14,36
20,Success,48,35,2,15,33
20,Success,57,32,0,11,46
20,Success,40,41,5,14,26
20,Success,49,41,0,8,41
20,Success,50,35,2,13,37
20,Success,44,44,1,11,33
20,Success,48,37,0,15,33
20,Success,46,41,0,11,35
20,Success,55,28,6,11,44
20,Success,56,25,0,16,40
20,Success,54,31,7,8,46
20,Success,43,43,2,12,31
20,Success,44,38,0,18,26
20,Success,54,36,2,8,46
20,Success,47,37,0,16,31
20,Success,51,37,1,11,40
20,Success,50,24,0,14,36
20,Success,52,37,3,8,44
20,Success,49,36,0,13,36
20,Success,47,32,0,20,27
20,Success,47,32,0,15,32
20,Success,55,35,4,6,49
20,Success,45,37,0,9,36
20,Success,43,40,3,14,29
20,Success,42,39,6,13,29
20,Success,54,39,1,6,48
20,Success,51,29,4,16,35
20,Success,60,30,0,10,50
20,Success,54,31,0,13,41
20,Success,42,37,3,18,24
20,Success,52,26,4,18,34
20,Success,44,36,5,15,29
20,Success,47,36,6,11,36
20,Success,49,38,0,13,36
20,Success,52,27,0,18,34
20,Success,45,36,10,9,36
20,Success,47,42,3,8,39
20,Success,44,39,0,11,33
20,Success,47,36,2,15,32
20,Success,47,34,0,11,36
20,Success,47,32,0,9,38
20,Success,49,33,2,16,33
20,Success,51,30,0,17,34
20,Success,52,27,0,11,41
20,Success,46,34,3,17,29
20,Success,46,39,6,9,37
20,Success,53,29,0,10,43
20,Success,47,41,4,8,39
20,Success,46,38,0,13,33
20,Success,56,29,2,13,43
20,Success,43,44,1,12,31
20,Success,48,32,0,10,38
20,Success,44,41,0,12,32
20,Success,44,38,4,14,30
20,Success,48,32,0,12,36
20,Success,55,33,1,11,44
20,Success,47,41,3,9,38
20,Success,46,33,10,11,35
20,Success,47,34,7,12,35
20,Success,51,32,0,12,39
20,Success,55,32,0,10,45
20,Success,41,37,0,15,26
20,Success,48,39,0,13,35
20,Success,46,37,5,12,34
20,Success,53,34,0,12,41
20,Success,39,36,10,15,24
20,Success,42,38,2,18,24
20,Success,49,33,0,15,34
20,Success,49,36,0,13,36
20,Success,51,38,3,8,43
20,Success,45,36,0,15,30
20,Success,48,34,4,14,34
20,Success,49,37,3,11,38
20,Success,49,32,0,15,34
20,Success,52,35,0,11,41
20,Success,43,34,8,15,28
20,Success,51,36,0,10,41
20,Success,50,26,9,15,35
20,Success,43,43,0,11,32
20,Success,54,33,0,10,44
20,Success,47,37,0,14,33
20,Success,51,30,0,17,34
20,Success,44,38,6,12,32
20,Success,46,38,0,13,33
20,Success,54,35,0,8,46
20,Success,42,36,0,15,27
20,Success,48,33,0,12,36
20,Success,50,38,0,11,39
20,Success,46,26,0,14,32
20,Success,45,37,3,15,30
20,Success,46,30,0,20,26
20,Success,47,38,7,8,39
20,Success,48,36,2,14,34
20,Success,42,40,7,11,31
20,Success,53,33,0,14,39
20,Success,51,36,2,11,40
20,Success,53,38,0,9,44
20,Success,42,37,0,21,21
20,Success,48,39,1,12,36
20,Success,50,34,1,15,35
20,Success,45,35,2,18,27
20,Success,43,40,0,11,32
20,Success,45,42,0,13,32
20,Success,51,35,5,9,42
20,Success,46,35,9,10,36
20,Success,49,33,0,16,33
20,Success,48,35,0,13,35
20,Success,53,26,0,20,33
20,Success,60,35,0,5,55
20,Success,45,36,0,13,32
20,Success,50,28,0,17,33
20,Success,51,35,0,11,40
20,Success,53,41,0,5,48
20,Success,47,38,7,8,39
20,Success,49,39,0,11,38
20,Success,48,27,8,17,31
20,Success,47,41,1,11,36
20,Success,43,39,7,11,32
20,Success,50,35,3,12,38
20,Success,49,34,1,16,33
20,Success,57,33,0,9,48
20,Success,52,32,5,11,41
20,Success,49,31,7,13,36
20,Success,49,37,0,12,37
20,Success,48,38,6,8,40
20,Success,43,45,0,10,33
20,Success,52,34,4,10,42
20,Success,49,27,0,17,32
20,Success,51,36,0,11,40
20,Success,48,39,2,11,37
20,Success,51,35,1,13,38
20,Success,41,39,7,13,28
20,Success,49,34,0,15,34
20,Success,40,40,0,15,25
20,Success,49,39,0,11,38
20,Success,49,36,0,15,34
20,Success,56,32,2,10,46
20,Success,55,34,0,8,47
20,Success,44,40,0,16,28
20,Success,53,33,3,11,42
20,Success,54,30,8,8,46
20,Success,49,38,4,9,40
20,Success,51,32,4,13,38
20,Success,48,38,0,8,40
20,Success,50,38,0,12,38
20,Success,47,37,4,12,35
20,Success,51,37,1,11,40
20,Success,57,31,0,12,45
20,Success,44,36,5,15,29
20,Success,47,39,0,9,38
20,Success,44,43,0,12,32
20,Success,44,37,1,18,26
20,Success,44,28,0,16,28
20,Success,49,37,0,13,36
20,Success,47,38,0,14,33
20,Success,56,34,0,10,46
20,Success,51,37,0,7,44
20,Success,48,36,3,13,35
20,Success,43,34,0,19,24
20,Success,49,36,0,15,34
20,Success,47,36,0,16,31
20,Success,45,41,2,12,33
20,Success,46,37,2,15,31
20,Success,41,37,10,12,29
20,Success,49,36,0,11,38
20,Success,45,34,8,13,32
20,Success,48,33,0,12,36
20,Success,50,34,5,11,39
20,Success,52,37,0,9,43
20,Success,59,30,0,10,49
20,Success,42,42,0,11,31
20,Success,47,37,0,15,32
20,Success,48,34,8,10,38
20,Success,47,40,0,11,36
20,Success,53,33,0,14,39
20,Success,49,33,0,12,37
20,Success,44,39,0,13,31
20,Success,37,40,7,16,21
20,Success,50,39,0,10,40
20,Success,43,45,0,7,36
20,Success,49,33,0,14,35
20,Success,45,38,5,12,33
20,Success,39,42,0,12,27
20,Success,47,36,0,13,34
20,Success,37,44,3,16,21
20,Success,48,44,0,5,43
20,Success,46,42,0,8,38
20,Success,44,32,6,18,26
20,Success,58,30,0,9,49
20,Success,55,33,0,9,46
20,Success,49,37,0,14,35
20,Success,49,36,1,14,35
20,Success,41,40,0,17,24
20,Success,38,38,9,15,23
20,Success,49,39,0,11,38
20,Success,42,45,3,10,32
20,Success,52,32,0,10,42
20,Success,47,44,0,8,39
20,Success,48,37,5,10,38
20,Success,51,39,2,8,43
20,Success,52,34,1,13,39
20,Success,50,34,0,12,38
20,Success,43,38,0,13,30
20,Success,54,28,0,8,46
20,Success,45,40,0,13,32
20,Success,44,31,0,14,30
20,Success,50,33,3,14,36
20,Success,43,32,10,15,28
20,Success,45,36,5,14,31
20,Success,46,43,0,11,35
20,Success,44,33,0,20,24
20,Success,48,35,5,12,36
20,Success,41,36,0,17,24
20,Success,56,36,1,7,49
20,Success,42,41,0,14,28
20,Success,40,38,0,12,28
20,Success,42,34,0,20,22
20,Success,46,41,0,11,35
20,Success,49,32,0,14,35
20,Success,46,43,0,7,39
20,Success,43,35,0,13,30
20,Success,50,28,0,14,36
20,Success,49,32,0,17,32
20,Success,52,44,0,4,48
20,Success,48,44,0,7,41
20,Success,52,37,1,10,42
20,Success,54,31,2,13,41
20,Success,47,37,3,13,34
20,Success,52,32,5,11,41
20,Success,55,35,0,10,45
20,Success,45,35,0,14,31
20,Success,43,37,4,16,27
20,Success,46,33,5,16,30
20,Success,52,35,0,9,43
20,Success,48,33,0,14,34
20,Success,50,38,0,11,39
20,Success,39,38,0,12,27
20,Success,51,34,0,14,37
20,Success,45,40,0,9,36
20,Success,46,39,1,14,32
20,Success,49,35,4,12,37
20,Success,51,36,1,12,39
20,Success,55,33,1,11,44
20,Success,47,36,2,15,32
20,Success,47,37,9,7,40
20,Success,38,34,10,18,20
20,Success,41,37,0,18,23
20,Success,51,35,0,9,42
20,Success,42,41,0,17,25
20,Success,45,43,0,9,36
20,Success,47,33,1,19,28
20,Success,58,32,2,8,50
20,Success,52,38,0,8,44
20,Success,52,38,0,9,43
20,Success,44,39,6,11,33
20,Success,49,30,0,18,31
20,Success,42,37,0,12,30
20,Success,44,39,0,11,33
20,Success,48,37,0,13,35
20,Success,58,32,0,10,48
20,Success,43,36,0,17,26
20,Success,48,37,0,10,38
20,Success,51,37,1,11,40
20,Success,44,36,0,15,29
20,Success,43,36,11,10,33
20,Success,47,42,0,10,37
20,Success,47,38,0,15,32
20,Success,58,29,2,11,47
20,Success,43,39,3,15,28
20,Success,48,40,2,10,38
20,Success,50,36,0,9,41
20,Success,57,32,3,8,49
20,Success,50,35,2,13,37
20,Success,48,36,0,13,35
20,Success,51,36,0,5,46
20,Success,50,37,5,8,42
20,Success,46,38,0,14,32
20,Success,51,28,6,15,36
20,Success,48,32,4,16,32
20,Success,45,33,0,14,31
20,Success,48,30,0,11,37
20,Success,50,36,5,9,41
20,Success,45,40,5,10,35
20,Success,50,37,0,12,38
20,Success,47,35,8,10,37
20,Success,55,30,2,13,42
20,Success,52,34,0,12,40
20,Success,59,29,0,10,49
20,Success,44,44,0,11,33
20,Success,41,40,0,13,28
20,Success,44,33,0,11,33
20,Success,54,29,0,17,37
20,Success,50,35,6,9,41
20,Success,53,27,4,16,37
20,Success,50,32,0,17,33
20,Success,48,40,4,8,40
20,Success,44,40,0,14,30
20,Success,43,36,11,10,33
20,Success,49,32,0,12,37
20,Success,50,40,0,10,40
20,Success,45,40,0,9,36
20,Success,47,40,2,11,36
20,Success,47,35,0,15,32
20,Success,48,31,0,13,35
20,Success,46,35,0,14,32
20,Success,50,39,0,6,44
20,Success,48,31,0,17,31
20,Success,49,41,0,7,42
20,Success,47,30,8,15,32
20,Success,40,37,0,14,26
20,Success,48,43,0,9,39
20,Success,51,39,0,10,41
20,Success,40,38,0,17,23
20,Success,47,42,2,9,38
20,Success,46,35,6,13,33
20,Success,52,31,1,16,36
20,Success,45,36,2,17,28
20,Success,54,34,4,8,46
20,Success,48,37,3,12,36
20,Success,46,34,0,12,34
20,Success,44,35,0,10,34
20,Success,45,39,3,13,32
20,Success,43,40,7,10,33
20,Success,52,35,2,11,41
20,Success,44,37,4,15,29
20,Success,47,46,2,5,42
20,Success,50,41,4,5,45
20,Success,45,39,6,10,35
20,Success,43,37,0,12,31
20,Success,42,41,0,10,32
20,Success,46,25,0,12,34
20,Success,53,34,5,8,45
20,Success,41,42,1,16,25
20,Success,52,33,6,9,43
20,Success,45,41,2,12,33
20,Success,46,40,5,9,37
20,Success,46,38,0,13,33
20,Success,46,37,0,17,29
20,Success,52,39,1,8,44
20,Success,45,32,0,19,26
20,Success,51,35,3,11,40
20,Success,52,31,0,14,38
20,Success,43,37,2,18,25
20,Success,46,41,0,13,33
20,Success,46,35,7,12,34
20,Success,55,35,0,10,45
20,Success,59,27,0,13,46
20,Success,48,32,0,16,32
20,Success,54,35,0,9,45
20,Success,46,34,2,18,28
20,Success,43,35,0,14,29
20,Success,42,42,0,15,27
20,Success,49,35,7,9,40
20,Success,52,30,5,13,39
20,Success,41,39,5,15,26
20,Success,60,28,0,11,49
20,Success,54,36,0,10,44
20,Success,36,34,0,14,22
20,Success,46,33,3,18,28
20,Success,49,37,3,11,38
20,Success,55,31,0,11,44
20,Success,46,42,0,9,37
20,Success,47,40,3,10,37
20,Success,49,35,0,14,35
20,Success,44,40,8,8,36
20,Success,49,33,12,6,43
20,Success,49,31,0,17,32
20,Success,47,41,0,12,35
20,Success,52,35,3,10,42
20,Success,43,39,0,17,26
20,Success,50,33,0,16,34
20,Success,48,32,0,11,37
20,Success,43,42,4,11,32
20,Success,47,33,0,16,31
20,Success,50,31,0,17,33
20,Success,45,28,0,19,26
20,Success,52,38,1,9,43
20,Success,53,31,0,13,40
20,Success,60,28,2,10,50
20,Success,41,35,0,13,28
20,Success,47,36,0,17,30
20,Success,48,32,1,19,29
20,Success,44,37,0,12,32
20,Fail,37,38,7,18,19
20,Success,47,37,5,11,36
20,Success,49,40,0,11,38
20,Success,43,38,7,12,31
20,Success,46,41,0,13,33
20,Success,54,33,4,9,45
20,Success,46,38,0,16,30
20,Success,53,36,0,11,42
20,Success,46,41,0,11,35
20,Success,48,32,7,13,35
20,Success,47,34,0,10,37
20,Success,42,32,0,19,23
20,Success,45,37,0,11,34
20,Success,51,35,3,11,40
20,Success,48,34,0,18,30
20,Success,59,29,5,7,52
20,Success,55,32,2,11,44
20,Success,47,39,6,8,39
20,Success,49,41,3,7,42
20,Success,48,32,2,18,30
20,Success,47,34,3,16,31
20,Success,53,31,1,15,38
20,Success,52,34,0,12,40
20,Success,55,36,0,9,46
20,Success,47,46,0,5,42
20,Success,55,30,0,11,44
20,Success,48,34,0,11,37
20,Success,40,43,4,13,27
20,Success,40,30,0,19,21
20,Success,49,33,3,15,34
20,Success,48,34,6,12,36
20,Success,47,32,3,18,29
20,Success,50,38,1,11,39
20,Success,45,35,0,17,28
20,Success,48,38,0,10,38
20,Success,49,34,4,13,36
20,Success,49,32,1,18,31
20,Success,43,32,9,16,27
20,Success,46,37,6,11,35
20,Success,48,38,3,11,37
20,Success,42,35,0,13,29
20,Success,42,43,3,12,30
20,Success,50,30,10,10,40
20,Success,43,32,13,12,31
20,Success,46,47,0,6,40
20,Fail,36,36,7,21,15
20,Success,42,38,0,11,31
20,Success,46,33,0,16,30
20,Success,42,44,1,13,29
20,Success,57,32,0,8,49
20,Success,49,34,2,15,34
20,Success,51,33,6,10,41
20,Success,53,40,0,6,47
20,Success,44,39,6,11,33
20,Success,53,29,0,16,37
20,Success,53,32,2,13,40
20,Success,57,29,0,10,47
20,Success,47,29,0,17,30
20,Success,42,35,4,19,23
20,Success,48,37,5,10,38
20,Success,54,33,0,13,41
20,Success,46,40,0,8,38
20,Success,51,37,0,11,40
20,Success,46,38,8,8,38
20,Success,53,32,0,14,39
20,Success,60,29,3,8,52
20,Success,40,43,3,14,26
20,Success,50,32,1,17,33
20,Success,46,35,0,12,34
20,Success,48,39,2,11,37
20,Success,39,42,10,9,30
20,Success,52,26,0,18,34
20,Success,43,40,0,13,30
20,Success,55,33,0,8,47
20,Success,48,33,3,16,32
20,Success,50,39,2,9,41
20,Success,51,37,0,10,41
20,Success,52,32,0,15,37
20,Success,53,28,11,8,45
20,Success,51,34,0,15,36
20,Success,43,39,1,17,26
20,Success,45,38,0,13,32
20,Success,49,37,0,13,36
20,Success,41,50,2,7,34
20,Success,49,32,2,17,32
20,Success,56,30,0,11,45
20,Success,39,43,1,17,22
20,Success,49,37,0,10,39
20,Success,50,22,10,18,32
20,Success,44,40,2,14,30
20,Success,48,40,0,6,42
20,Success,46,38,0,10,36
20,Success,44,40,0,16,28
20,Success,41,44,3,12,29
20,Success,57,32,0,10,47
20,Success,50,37,0,10,40
20,Success,51,38,0,11,40
20,Success,45,39,0,14,31
20,Success,48,40,0,12,36
20,Success,41,38,0,19,22
20,Success,53,29,0,15,38
20,Success,56,27,2,15,41
20,Success,53,29,0,14,39
20,Success,36,47,8,9,27
20,Success,51,37,0,10,41
20,Success,53,32,4,11,42
20,Success,42,42,3,13,29
20,Success,48,30,1,21,27
20,Success,49,39,0,11,38
20,Success,53,34,0,7,46
20,Success,53,35,4,8,45
20,Success,40,38,7,15,25
20,Success,43,37,2,18,25
20,Success,59,28,4,9,50
20,Success,52,36,0,6,46
20,Success,44,39,1,16,28
20,Success,48,40,2,10,38
20,Success,47,35,2,16,31
20,Success,48,44,0,8,40
20,Success,42,41,0,16,26
20,Success,46,34,3,17,29
20,Success,46,40,4,10,36
20,Success,45,39,4,12,33
20,Success,53,34,5,8,45
20,Success,49,36,0,12,37
20,Success,50,38,0,10,40
20,Success,57,26,4,13,44
20,Success,53,33,0,11,42
20,Success,50,35,0,14,36
20,Success,50,33,5,12,38
20,Success,48,39,0,11,37
20,Success,51,34,1,14,37
20,Success,46,37,0,9,37
20,Success,51,39,5,5,46
20,Success,41,44,0,15,26
20,Success,55,28,0,13,42
20,Fail,37,40,4,19,18
20,Success,50,25,0,16,34
20,Success,49,42,3,6,43
20,Success,55,33,1,11,44
20,Success,53,34,0,10,43
20,Success,52,25,0,11,41
20,Success,53,37,0,10,43
20,Success,53,30,0,14,39
20,Success,44,35,0,14,30
20,Success,41,46,0,9,32
20,Success,55,34,2,9,46
20,Success,43,41,0,14,29
20,Success,53,30,5,12,41
20,Success,55,29,0,12,43
20,Success,45,37,0,16,29
20,Success,44,36,0,12,32
20,Success,49,38,0,9,40
20,Success,47,39,0,14,33
20,Success,47,37,2,14,33
20,Success,53,33,0,10,43
20,Success,50,35,0,14,36
20,Success,47,34,0,10,37
20,Success,43,40,0,17,26
20,Success,53,39,0,7,46
20,Success,49,33,3,15,34
20,Success,41,40,5,14,27
20,Success,41,42,0,16,25
20,Success,50,37,0,8,42
20,Success,53,31,5,11,42
20,Fail,37,41,0,18,19
20,Success,46,39,0,12,34
20,Success,43,41,3,13,30
20,Success,43,36,8,13,30
20,Success,51,28,6,15,36
20,Success,51,34,1,14,37
20,Success,53,28,4,15,38
20,Success,47,33,0,15,32
20,Success,50,40,1,9,41
20,Success,55,25,7,13,42
20,Success,48,34,1,17,31
20,Success,56,27,4,13,43
20,Success,51,34,3,12,39
20,Success,55,33,0,9,46
20,Success,45,42,6,7,38
20,Success,40,38,4,18,22
20,Success,61,33,0,4,57
20,Success,46,34,4,16,30
20,Success,50,35,6,9,41
20,Success,55,31,0,11,44
20,Success,49,40,0,11,38
20,Success,44,41,0,15,29
20,Success,55,33,0,10,45
20,Success,51,34,2,13,38
20,Success,47,31,3,19,28
20,Success,44,37,0,19,25
20,Success,47,30,14,9,38
20,Success,39,39,4,18,21
20,Success,46,38,3,13,33
20,Success,51,35,3,11,40
20,Success,39,38,5,18,21
20,Success,48,34,0,15,33
20,Success,53,35,0,11,42
20,Success,48,35,1,16,32
20,Success,48,38,0,10,38
20,Success,44,35,10,11,33
20,Success,54,38,0,8,46
20,Success,48,36,0,15,33
20,Success,44,32,0,14,30
20,Success,49,33,0,5,44
20,Success,54,33,1,12,42
20,Success,51,38,2,9,42
20,Success,50,35,0,14,36
20,Success,45,35,5,15,30
20,Success,54,30,0,13,41
20,Success,51,34,1,14,37
20,Success,47,32,10,11,36
20,Success,40,42,0,12,28
20,Success,43,40,0,12,31
20,Success,47,34,4,15,32
20,Success,42,43,0,10,32
20,Success,46,36,0,15,31
20,Success,44,38,0,17,27
20,Success,51,35,0,9,42
20,Success,44,30,2,24,20
20,Success,45,32,0,12,33
20,Success,49,33,0,16,33
20,Success,49,35,0,14,35
20,Success,54,35,2,9,45
20,Success,40,42,6,12,28
20,Success,40,39,0,17,23
20,Success,51,31,7,11,40
20,Success,45,32,0,14,31
20,Success,41,37,0,15,26
20,Success,53,35,0,10,43
20,Success,51,27,1,21,30
20,Success,50,28,7,15,35
20,Success,50,36,0,11,39
20,Success,46,43,0,9,37
20,Success,49,37,5,9,40
20,Success,41,42,0,14,27
20,Success,44,39,5,12,32
20,Success,52,30,5,13,39
20,Success,41,36,0,21,20
20,Success,45,32,8,15,30
20,Success,46,34,0,18,28
20,Success,50,36,3,11,39
20,Success,52,39,1,8,44
20,Success,40,42,0,11,29
20,Success,46,34,0,15,31
20,Success,45,41,4,10,35
20,Success,54,34,3,9,45
20,Success,51,30,8,11,40
20,Success,52,32,0,12,40
20,Success,41,38,6,15,26
20,Success,47,32,6,15,32
20,Success,48,35,0,11,37
20,Success,50,33,2,15,35
20,Success,43,41,7,9,34
20,Success,60,29,0,11,49
20,Success,54,24,0,13,41
20,Success,45,33,7,15,30
20,Success,52,29,8,11,41
20,Success,46,34,0,13,33
20,Success,40,38,0,19,21
20,Success,55,33,0,9,46
20,Success,46,41,0,7,39
20,Success,51,37,0,10,41
20,Success,40,40,9,11,29
20,Success,47,31,0,14,33
20,Success,57,33,0,10,47
20,Success,62,24,0,10,52
20,Success,43,30,0,18,25
20,Success,44,41,4,11,33
20,Success,48,35,4,13,35
20,Success,48,34,5,13,35
20,Success,49,39,1,11,38
20,Success,47,39,3,11,36
20,Success,47,36,6,11,36
20,Success,46,40,0,14,32
20,Success,41,38,10,11,30
20,Success,43,36,0,14,29
20,Success,45,44,3,8,37
20,Success,43,33,0,15,28
20,Success,45,39,5,11,34
20,Success,44,35,0,20,24
20,Success,53,31,0,9,44
20,Success,54,35,0,10,44
20,Success,47,31,0,15,32
20,Success,48,37,0,14,34
20,Success,51,36,4,9,42
20,Success,51,37,0,6,45
20,Success,54,34,1,11,43
20,Success,49,33,2,16,33
20,Success,47,40,4,9,38
20,Fail,39,37,4,20,19
20,Success,48,35,3,14,34
20,Success,54,36,0,10,44
20,Success,55,36,1,8,47
20,Success,51,34,3,12,39
20,Success,45,40,1,14,31
20,Success,54,28,0,16,38
20,Success,47,25,0,20,27
20,Success,46,33,0,13,33
20,Success,51,32,1,16,35
20,Success,39,38,6,17,22
20,Success,47,37,0,11,36
20,Success,54,29,6,11,43
20,Success,36,43,5,16,20
20,Success,50,40,1,9,41
20,Success,42,33,0,18,24
20,Success,48,44,1,7,41
20,Success,50,39,0,11,39
20,Success,46,37,2,15,31
20,Success,52,38,0,6,46
20,Success,47,38,0,10,37
20,Success,45,32,7,16,29
20,Success,48,25,0,15,33
20,Success,58,29,0,10,48
20,Success,47,36,8,9,38
20,Success,51,34,3,12,39
20,Success,48,33,5,14,34
20,Success,44,44,4,8,36
20,Success,51,31,0,18,33
20,Success,44,30,0,16,28
20,Success,50,37,0,9,41
20,Success,46,35,0,12,34
20,Success,49,39,1,11,38
20,Success,46,42,0,10,36
20,Success,51,38,1,10,41
20,Success,52,34,5,9,43
20,Success,50,37,4,9,41
20,Success,40,46,1,13,27
20,Success,46,38,0,13,33
20,Success,56,32,0,11,45
20,Success,50,28,0,14,36
20,Success,55,30,0,12,43
20,Success,47,38,0,15,32
20,Success,49,35,0,11,38
20,Success,48,35,0,13,35
20,Success,53,35,0,9,44
20,Success,45,37,4,14,31
20,Success,45,30,0,18,27
20,Success,42,37,0,14,28
20,Success,47,35,5,13,34
20,Success,39,47,1,13,26
20,Success,50,37,1,12,38
20,Success,50,38,0,9,41
20,Success,45,41,0,13,32
20,Success,48,35,6,11,37
20,Success,58,31,3,8,50
20,Success,42,35,5,18,24
20,Success,45,37,5,13,32
20,Success,53,35,0,6,47
20,Success,51,34,0,11,40
20,Success,50,31,4,15,35
20,Success,41,38,7,14,27
20,Success,48,38,1,13,35
20,Success,46,36,0,12,34
20,Success,43,45,0,9,34
20,Success,47,38,0,11,36
20,Success,49,31,3,17,32
20,Success,58,29,6,7,51
20,Success,48,30,6,16,32
20,Success,55,34,6,5,50
20,Success,53,32,5,10,43
20,Success,46,40,0,14,32
20,Success,53,35,0,8,45
20,Success,48,37,0,14,34
20,Success,48,35,0,13,35
20,Success,45,38,0,11,34
20,Success,47,38,4,11,36
20,Success,49,32,4,15,34
20,Success,46,36,0,16,30
20,Success,44,32,4,20,24
20,Success,52,33,3,12,40
20,Success,44,36,6,14,30
20,Success,46,39,0,13,33
20,Success,44,34,0,16,28
20,Success,42,32,0,12,30
20,Success,50,33,2,15,35
20,Success,46,39,4,11,35
20,Success,44,43,0,10,34
20,Success,45,27,9,19,26
20,Success,52,37,2,9,43
20,Success,46,41,0,10,36
20,Success,52,32,3,13,39
20,Success,47,37,1,15,32
20,Success,52,35,0,10,42
20,Success,45,41,0,10,35
20,Success,40,37,0,17,23
20,Success,45,36,0,15,30
20,Success,51,33,1,15,36
20,Success,54,34,0,6,48
20,Success,49,30,0,18,31
20,Success,53,37,0,10,43
20,Success,48,42,1,9,39
20,Success,49,36,3,12,37
20,Success,48,37,4,11,37
20,Success,53,29,0,18,35
20,Success,43,36,0,19,24
20,Success,50,37,0,12,38
20,Success,42,38,11,9,33
20,Success,48,40,1,11,37
20,Success,46,35,2,17,29
20,Success,44,38,0,12,32
20,Success,56,22,4,18,38
20,Success,48,35,0,14,34
20,Success,53,29,0,16,37
20,Success,51,38,3,8,43
20,Success,50,34,6,10,40
20,Success,50,29,0,12,38
20,Success,49,34,0,12,37
20,Success,48,41,0,9,39
20,Success,49,32,0,17,32
20,Success,53,32,0,11,42
20,Success,43,40,0,12,31
20,Success,49,33,0,15,34
20,Success,48,36,0,15,33
20,Success,52,40,1,7,45
20,Success,44,38,0,12,32
20,Success,48,35,2,15,33
20,Success,50,38,0,11,39
20,Success,60,25,0,10,50
20,Success,39,37,0,15,24
20,Success,40,46,0,9,31
20,Success,49,31,0,20,29
20,Success,48,39,3,10,38
20,Success,49,36,0,13,36
20,Success,41,37,0,18,23
20,Success,44,44,0,7,37
20,Success,50,38,0,10,40
20,Success,47,41,0,11,36
20,Success,43,36,0,11,32
20,Success,53,35,0,11,42
20,Success,54,35,1,10,44
20,Success,51,33,0,12,39
20,Success,47,33,0,18,29
20,Success,41,40,8,11,30
20,Success,41,47,1,11,30
20,Success,47,39,6,8,39
20,Success,39,39,7,15,24
20,Success,49,31,1,19,30
20,Success,47,33,0,15,32
20,Success,51,38,1,10,41
20,Success,51,32,4,13,38
20,Success,47,31,6,16,31
20,Success,51,36,0,11,40
20,Success,50,36,1,13,37
20,Success,51,38,0,11,40
20,Success,50,31,0,14,36
20,Success,52,36,1,11,41
20,Success,49,41,0,9,40
20,Success,48,37,0,15,33
20,Success,50,40,1,9,41
20,Success,45,36,7,12,33
20,Success,50,40,0,10,40
20,Success,50,36,0,13,37
20,Success,42,35,0,12,30
20,Success,44,32,8,16,28
20,Success,46,36,0,11,35
20,Success,55,25,1,19,36
20,Success,43,35,3,19,24
20,Success,51,32,0,16,35
20,Success,53,35,0,9,44
20,Success,46,27,0,11,35
20,Success,47,40,3,10,37
20,Success,38,38,6,18,20
20,Success,47,44,0,9,38
20,Success,41,41,4,14,27
20,Success,44,41,3,12,32
20,Success,46,37,0,16,30
20,Success,45,40,0,8,37
20,Success,52,29,7,12,40
20,Success,46,31,4,19,27
20,Success,50,41,0,8,42
20,Success,51,30,1,18,33
20,Success,49,34,7,10,39
20,Success,43,38,8,11,32
20,Success,46,32,0,19,27
20,Success,53,31,6,10,43
20,Success,56,29,0,13,43
20,Success,45,38,4,13,32
20,Success,54,32,0,14,40
20,Success,49,28,0,12,37
20,Success,49,33,0,13,36
20,Success,49,42,0,9,40
20,Success,54,32,5,9,45
20,Success,45,37,0,10,35
20,Success,44,41,1,14,30
20,Success,57,30,0,10,47
20,Success,52,33,5,10,42
20,Success,50,36,2,12,38
20,Success,53,26,0,16,37
20,Success,43,38,4,15,28
20,Success,45,37,5,13,32
20,Success,48,30,4,18,30
20,Success,55,38,0,7,48
20,Success,53,33,5,9,44
20,Success,45,38,0,17,28
20,Success,39,43,5,13,26
20,Success,51,36,0,11,40
20,Success,48,37,0,12,36
20,Success,50,38,4,8,42
20,Success,59,27,5,9,50
20,Success,46,33,0,19,27
20,Success,52,30,0,15,37
20,Success,46,40,5,9,37
20,Success,42,32,8,18,24
20,Success,61,29,0,9,52
20,Success,50,33,2,15,35
20,Success,52,34,0,13,39
20,Success,44,38,7,11,33
20,Success,45,38,0,11,34
20,Success,45,35,6,14,31
20,Success,44,35,0,18,26
20,Success,50,28,0,20,30
20,Success,45,37,2,16,29
20,Success,47,29,0,18,29
20,Success,52,33,0,14,38
20,Success,51,36,1,12,39
20,Success,52,38,2,8,44
20,Success,43,31,12,14,29
20,Success,50,34,4,12,38
20,Success,57,31,2,10,47
20,Success,47,37,3,13,34
20,Success,45,33,0,17,28
20,Success,51,32,2,15,36
20,Success,43,37,0,16,27
20,Success,47,38,0,12,35
20,Success,50,37,2,11,39
20,Success,54,28,3,15,39
20,Success,48,35,0,13,35
20,Success,47,30,0,14,33
20,Success,47,36,3,14,33
20,Success,46,44,0,8,38
20,Success,47,35,11,7,40
20,Success,39,35,0,11,28
20,Success,55,29,0,8,47
20,Success,47,37,0,14,33
20,Success,53,26,9,12,41
20,Success,47,37,4,12,35
20,Success,46,33,0,19,27
20,Success,43,37,0,20,23
20,Success,51,43,0,6,45
20,Success,44,35,0,16,28
20,Success,43,39,0,13,30
20,Success,50,32,0,12,38
20,Success,53,34,0,11,42
20,Success,53,31,0,15,38
20,Success,52,35,2,11,41
20,Success,56,24,7,13,43
20,Success,39,41,0,13,26
20,Success,46,43,0,9,37
20,Success,55,33,5,7,48
20,Success,54,39,0,6,48
20,Success,49,40,0,11,38
20,Success,49,35,0,13,36
20,Success,46,37,6,11,35
20,Success,48,34,0,12,36
20,Success,48,32,0,12,36
20,Success,48,37,2,13,35
20,Success,49,37,3,11,38
20,Success,45,35,8,12,33
20,Success,49,32,8,11,38
20,Success,44,33,11,12,32
20,Success,47,35,6,12,35
20,Success,46,33,8,13,33
20,Success,45,39,0,16,29
20,Success,40,44,0,15,25
20,Success,56,29,0,15,41
20,Success,46,32,0,15,31
20,Success,50,38,0,11,39
20,Success,45,37,9,9,36
20,Success,52,31,0,17,35
20,Success,44,39,4,13,31
20,Success,53,36,0,9,44
20,Success,42,39,0,16,26
20,Success,39,44,7,10,29
20,Success,45,40,2,13,32
20,Success,43,37,0,17,26
20,Success,45,40,0,15,30
20,Success,47,42,0,10,37
20,Success,55,33,0,10,45
20,Success,42,26,0,14,28
20,Success,48,34,6,12,36
20,Success,50,38,1,11,39
20,Success,42,48,0,8,34
20,Success,52,34,1,13,39
20,Success,50,40,0,9,41
20,Success,43,41,0,11,32
20,Success,45,33,10,12,33
20,Success,42,36,5,17,25
20,Success,39,38,13,10,29
20,Success,51,38,0,9,42
20,Success,56,36,0,4,52
20,Success,43,41,0,11,32
20,Success,55,26,5,14,41
20,Success,50,39,3,8,42
20,Success,47,42,2,9,38
20,Success,52,33,2,13,39
20,Success,50,36,0,12,38
20,Success,50,32,0,15,35
20,Success,46,44,0,10,36
20,Success,50,37,0,12,38
20,Success,51,29,8,12,39
20,Success,47,34,8,11,36
20,Success,51,38,0,10,41
20,Success,44,33,2,21,23
20,Success,59,31,0,9,50
20,Success,59,28,0,13,46
20,Success,45,35,5,15,30
20,Success,48,28,5,19,29
20,Success,51,28,0,17,34
20,Success,50,44,0,5,45
20,Success,47,34,0,16,31
20,Success,51,37,0,12,39
20,Success,43,38,0,14,29
20,Success,51,34,0,15,36
20,Success,40,43,0,14,26
20,Fail,34,43,8,15,19
20,Success,45,40,0,9,36
20,Success,54,30,3,13,41
20,Success,45,40,0,13,32
20,Success,47,46,1,6,41
20,Success,48,32,0,8,40
20,Success,50,32,1,17,33
20,Success,56,35,0,8,48
20,Success,49,33,0,7,42
20,Success,49,35,0,10,39
20,Success,45,37,0,16,29
20,Success,48,39,1,12,36
20,Success,51,36,1,12,39
20,Success,51,41,1,7,44
20,Success,51,39,0,9,42
20,Success,42,29,0,17,25
20,Success,51,31,3,15,36
20,Success,52,37,0,10,42
20,Success,52,36,0,9,43
20,Success,39,31,11,19,20
20,Success,45,36,5,14,31
20,Success,45,34,0,12,33
20,Success,48,38,0,10,38
20,Success,43,37,0,19,24
20,Success,45,40,0,12,33
20,Success,54,34,3,9,45
20,Success,47,35,5,13,34
20,Success,46,36,8,10,36
20,Success,58,28,2,12,46
20,Success,46,40,5,9,37
20,Success,40,45,3,12,28
20,Success,56,31,0,11,45
20,Success,49,38,2,11,38
20,Success,38,41,11,10,28
20,Success,52,30,3,15,37
20,Success,49,31,0,14,35
20,Success,47,33,0,19,28
20,Success,53,35,0,6,47
20,Success,48,42,0,9,39
20,Success,48,34,0,13,35
20,Success,47,37,0,8,39
20,Success,45,37,0,14,31
20,Success,54,37,3,6,48
20,Success,50,32,0,16,34
20,Success,45,42,0,12,33
20,Success,40,35,0,15,25
20,Success,48,36,0,15,33
20,Success,41,38,11,10,31
20,Success,45,34,0,12,33
20,Success,45,37,0,15,30
20,Success,58,30,0,10,48
20,Success,47,39,0,13,34
20,Success,41,37,0,16,25
20,Success,54,33,0,12,42
20,Success,55,33,0,11,44
20,Success,48,39,0,10,38
20,Success,50,31,5,14,36
20,Success,50,43,0,7,43
20,Success,53,35,0,11,42
20,Success,51,37,0,11,40
20,Success,45,46,1,8,37
20,Success,50,41,0,7,43
20,Success,41,32,0,18,23
20,Success,51,33,3,13,38
20,Success,47,44,0,5,42
20,Success,53,31,0,14,39
20,Success,56,28,0,13,43
20,Success,54,35,0,11,43
20,Success,46,35,0,16,30
20,Success,38,40,0,17,21
20,Success,48,42,0,9,39
20,Success,52,37,0,9,43
20,Success,47,32,0,12,35
20,Success,53,27,0,14,39
20,Success,46,38,0,13,33
20,Success,53,34,0,11,42
20,Success,53,35,0,11,42
20,Success,44,40,0,13,31
20,Success,49,34,4,13,36
20,Success,53,35,2,10,43
20,Success,46,36,0,14,32
20,Success,51,28,11,10,41
20,Success,40,40,0,14,26
20,Success,49,37,3,11,38
20,Success,41,35,9,15,26
20,Success,40,33,0,18,22
20,Success,53,31,0,11,42
20,Success,40,37,0,13,27
20,Success,54,32,5,9,45
20,Success,52,33,0,14,38
20,Success,47,31,3,19,28
20,Success,54,27,0,15,39
20,Success,52,29,2,17,35
20,Success,49,32,3,16,33
20,Success,47,30,0,15,32
20,Success,58,24,6,12,46
20,Success,46,31,0,17,29
20,Success,48,31,0,17,31
20,Success,57,33,2,8,49
20,Success,50,33,0,13,37
20,Success,54,32,0,13,41
20,Success,44,36,0,13,31
20,Success,47,39,0,13,34
20,Success,45,34,4,17,28
20,Success,48,36,3,13,35
20,Success,42,48,0,10,32
20,Success,43,37,6,14,29
20,Success,45,39,0,14,31
20,Success,46,28,11,15,31
20,Success,44,35,0,9,35
20,Success,51,30,4,15,36
20,Success,49,39,4,8,41
20,Success,44,36,0,18,26
20,Success,41,37,0,17,24
20,Success,52,29,0,14,38
20,Success,41,40,0,12,29
20,Success,47,37,0,10,37
20,Success,42,39,8,11,31
20,Success,57,28,3,12,45
20,Success,50,36,0,10,40
20,Success,43,44,0,13,30
20,Success,54,31,0,12,42
20,Success,49,32,4,15,34
20,Success,47,40,1,12,35
20,Success,46,43,1,10,36
20,Success,47,37,2,14,33
20,Success,48,38,1,13,35
20,Success,55,30,0,14,41
20,Success,47,35,3,15,32
20,Success,46,41,4,9,37
20,Success,49,37,1,13,36
20,Success,50,34,8,8,42
20,Success,51,39,0,9,42
20,Success,46,37,7,10,36
20,Success,52,35,4,9,43
20,Success,42,31,7,20,22
20,Success,47,37,3,13,34
20,Success,48,35,0,14,34
20,Success,48,35,0,16,32
20,Success,51,32,0,14,37
20,Success,49,31,3,17,32
20,Success,51,33,3,13,38
20,Success,53,29,7,11,42
20,Success,53,31,0,13,40
20,Success,46,38,0,12,34
20,Success,45,30,0,16,29
20,Success,48,41,1,10,38
20,Success,55,38,0,5,50
20,Success,41,36,0,17,24
20,Success,45,39,0,11,34
20,Success,49,30,0,13,36
20,Success,57,32,4,7,50
20,Success,42,29,8,21,21
20,Success,43,39,6,12,31
20,Success,55,32,0,13,42
20,Success,48,41,0,10,38
20,Success,48,34,0,17,31
20,Success,47,39,0,14,33
20,Success,47,39,0,13,34
20,Success,55,34,0,9,46
20,Success,51,36,4,9,42
20,Success,45,42,0,12,33
20,Success,49,30,7,14,35
20,Success,43,41,0,15,28
20,Success,47,33,0,18,29
20,Success,52,31,0,13,39
20,Success,48,38,2,12,36
20,Success,44,41,3,12,32
20,Success,49,35,0,7,42
20,Success,45,36,3,16,29
20,Success,60,27,0,13,47
20,Success,49,38,0,10,39
20,Success,53,33,0,13,40
20,Success,36,51,4,9,27
20,Success,54,31,5,10,44
20,Success,44,41,0,12,32
20,Success,45,36,0,14,31
20,Success,40,40,0,19,21
20,Success,48,36,0,11,37
20,Success,47,35,0,17,30
20,Success,46,37,0,12,34
20,Success,41,42,0,11,30
20,Success,51,32,8,9,42
20,Success,42,39,1,18,24
20,Success,48,30,0,18,30
20,Success,45,39,0,16,29
20,Success,53,32,1,14,39
20,Success,45,39,0,13,32
20,Success,44,38,0,16,28
20,Success,46,36,0,10,36
20,Success,50,28,7,15,35
20,Success,43,40,1,16,27
20,Success,53,32,3,12,41
20,Success,42,38,0,19,23
20,Success,51,30,0,8,43
20,Success,53,32,0,13,40
20,Success,51,35,1,13,38
20,Success,49,41,2,8,41
20,Success,51,36,0,13,38
20,Success,43,33,0,16,27
20,Success,47,38,0,15,32
20,Success,48,24,13,15,33
20,Success,43,40,2,15,28
20,Success,45,43,0,10,35
20,Success,42,35,0,17,25
20,Success,48,32,0,15,33
20,Success,49,34,4,13,36
20,Success,53,31,1,15,38
20,Success,50,34,1,15,35
20,Success,55,33,0,12,43
20,Success,48,41,1,10,38
20,Success,48,36,0,14,34
20,Success,48,38,0,10,38
20,Success,47,29,0,17,30
20,Success,47,39,0,13,34
20,Success,46,33,7,14,32
20,Success,46,33,5,16,30
20,Success,50,32,5,13,37
20,Success,47,40,1,12,35
20,Success,44,32,7,17,27
20,Success,38,44,10,8,30
20,Success,43,32,7,18,25
20,Success,47,36,1,16,31
20,Success,45,38,0,15,30
20,Success,51,33,0,12,39
20,Success,48,32,0,12,36
20,Success,52,31,8,9,43
20,Success,54,34,0,11,43
20,Success,47,37,6,10,37
20,Success,42,40,0,13,29
20,Success,51,28,0,11,40
20,Success,51,37,0,11,40
20,Success,50,29,0,15,35
20,Success,51,27,3,19,32
20,Success,51,35,2,12,39
20,Success,50,36,0,11,39
20,Success,61,24,4,11,50
20,Success,55,38,0,7,48
20,Success,45,34,4,17,28
20,Success,55,32,3,10,45
20,Success,41,30,12,17,24
20,Success,43,35,0,16,27
20,Success,43,38,0,17,26
20,Success,50,36,0,13,37
20,Success,39,43,9,9,30
20,Success,50,33,0,14,36
20,Success,48,31,9,12,36
20,Success,50,39,2,9,41
20,Success,43,46,0,11,32
20,Success,52,38,2,8,44
20,Success,44,37,0,16,28
20,Success,46,43,0,8,38
20,Success,52,31,6,11,41
20,Success,50,40,0,7,43
20,Success,47,35,0,14,33
20,Success,51,32,0,12,39
20,Success,39,47,0,11,28
20,Success,44,34,9,13,31
20,Success,43,39,0,18,25
20,Success,42,34,13,11,31
20,Success,46,29,0,18,28
20,Success,42,38,7,13,29
20,Success,54,33,0,9,45
20,Success,49,39,0,9,40
20,Success,50,38,0,8,42
20,Success,44,47,0,9,35
20,Success,44,37,0,14,30
20,Success,44,39,2,15,29
20,Success,57,33,0,9,48
20,Fail,38,33,0,19,19
20,Success,57,33,0,9,48
20,Success,50,41,0,9,41
20,Success,45,38,4,13,32
20,Success,52,32,0,11,41
20,Success,45,34,6,15,30
20,Success,50,31,0,12,38
20,Success,45,37,0,15,30
20,Success,44,35,0,14,30
20,Success,55,28,0,12,43
20,Success,48,39,4,9,39
20,Success,45,37,9,9,36
20,Success,60,27,5,8,52
20,Success,45,32,0,11,34
20,Success,50,32,0,14,36
20,Success,50,35,0,12,38
20,Success,48,36,3,13,35
20,Success,40,44,0,9,31
20,Success,50,31,0,15,35
20,Success,50,36,0,13,37
20,Success,51,38,0,10,41
20,Success,54,32,1,13,41
20,Success,46,37,0,13,33
20,Success,48,33,0,10,38
20,Success,51,29,4,16,35
20,Success,53,38,0,9,44
20,Success,51,37,0,10,41
20,Success,50,35,1,14,36
20,Success,48,37,2,13,35
20,Success,46,31,2,21,25
20,Success,47,36,0,10,37
20,Success,47,33,5,15,32
20,Success,49,38,0,7,42
20,Success,54,24,5,17,37
20,Success,47,38,5,10,37
20,Success,39,33,0,16,23
20,Success,46,42,0,11,35
20,Success,50,36,0,13,37
20,Success,55,30,2,13,42
20,Success,41,31,12,16,25
20,Success,52,33,3,12,40
20,Success,39,48,0,13,26
20,Success,55,28,2,15,40
20,Success,46,33,0,12,34
20,Success,49,33,9,9,40
20,Success,45,40,3,12,33
20,Success,50,37,1,12,38
20,Success,57,27,0,14,43
20,Success,46,37,5,12,34
20,Success,48,30,0,15,33
20,Success,47,31,5,17,30
20,Success,59,26,0,12,47
20,Success,44,35,9,12,32
20,Success,49,33,6,12,37
20,Success,50,33,0,13,37
20,Success,50,38,0,12,38
20,Success,48,38,0,12,36
20,Success,50,39,3,8,42
20,Success,46,41,0,11,35
20,Success,44,37,0,14,30
20,Success,52,33,1,14,38
20,Success,51,35,0,12,39
20,Success,51,30,2,17,34
20,Success,51,35,0,8,43
20,Success,54,29,4,13,41
20,Success,49,38,0,13,36
20,Success,40,41,0,12,28
20,Success,43,34,0,19,24
20,Success,49,38,0,12,37
20,Success,44,42,1,13,31
20,Success,51,40,1,8,43
20,Success,47,40,5,8,39
20,Success,41,45,0,14,27
20,Success,50,34,0,9,41
20,Success,44,38,0,9,35
20,Success,54,36,0,10,44
20,Success,42,38,1,19,23
20,Success,42,38,0,15,27
20,Success,47,42,0,11,36
20,Success,51,33,0,14,37
20,Success,51,40,0,7,44
20,Success,40,34,0,17,23
20,Success,42,37,5,16,26
20,Success,54,36,0,7,47
20,Success,51,32,0,14,37
20,Success,51,35,0,10,41
20,Success,39,47,0,9,30
20,Success,51,25,6,18,33
20,Success,46,41,0,8,38
20,Success,48,34,0,15,33
20,Success,51,31,0,13,38
20,Success,45,37,0,16,29
20,Success,50,32,7,11,39
20,Success,48,36,0,14,34
20,Success,51,34,5,10,41
20,Success,49,37,6,8,41
20,Success,50,36,0,10,40
20,Success,49,40,0,9,40
20,Success,43,42,3,12,31
20,Success,48,38,3,11,37
20,Success,51,36,4,9,42
20,Success,50,33,0,15,35
20,Success,44,46,1,9,35
20,Success,46,34,0,15,31
20,Success,58,26,2,14,44
20,Success,51,38,0,10,41
20,Success,44,30,11,15,29
20,Success,45,27,0,13,32
20,Success,42,35,0,18,24
20,Success,52,39,1,8,44
20,Success,56,33,0,11,45
20,Success,45,35,0,8,37
20,Success,51,39,0,8,43
20,Success,49,36,2,13,36
20,Success,41,48,1,10,31
20,Success,47,39,0,11,36
20,Success,41,31,9,19,22
20,Fail,39,37,4,20,19
20,Success,50,38,2,10,40
20,Success,46,37,0,12,34
20,Success,54,32,3,11,43
20,Success,46,32,0,17,29
20,Success,48,41,0,10,38
20,Success,45,31,7,17,28
20,Success,52,38,0,9,43
20,Success,53,32,0,14,39
20,Success,47,36,4,13,34
20,Success,43,27,0,18,25
20,Success,49,35,0,12,37
20,Success,46,34,0,15,31
20,Success,46,40,4,10,36
20,Success,46,32,0,16,30
20,Success,48,36,0,9,39
20,Success,50,39,2,9,41
20,Success,48,39,0,12,36
20,Success,48,33,0,15,33
20,Success,37,44,4,15,22
20,Success,51,38,0,7,44
20,Success,44,36,9,11,33
20,Success,49,33,5,13,36
20,Success,44,38,5,13,31
20,Success,54,34,1,11,43
20,Success,50,34,0,16,34
20,Success,55,32,0,10,45
20,Success,50,38,0,11,39
20,Success,54,30,0,16,38
20,Success,47,36,7,10,37
20,Success,47,38,0,11,36
20,Success,52,36,4,8,44
20,Success,44,38,4,14,30
20,Success,58,31,3,8,50
20,Success,39,32,11,18,21
20,Success,53,29,0,16,37
20,Success,43,35,0,12,31
20,Success,45,40,0,13,32
20,Success,47,27,0,14,33
20,Success,42,34,0,14,28
20,Success,58,33,2,7,51
20,Success,54,36,0,9,45
20,Success,46,37,1,16,30
20,Success,48,38,0,12,36
20,Success,49,33,3,15,34
20,Success,42,32,0,15,27
20,Success,51,36,0,12,39
20,Success,48,36,0,11,37
20,Success,54,28,0,9,45
20,Success,48,35,0,12,36
20,Success,44,34,0,15,29
20,Success,44,40,1,15,29
20,Success,48,37,0,13,35
20,Success,47,36,2,15,32
20,Success,51,36,0,10,41
20,Success,53,34,0,11,42
20,Success,58,30,1,11,47
20,Success,47,38,2,13,34
20,Success,52,31,0,17,35
20,Success,42,36,14,8,34
20,Success,49,37,0,13,36
20,Success,46,38,7,9,37
20,Success,49,36,0,11,38
20,Success,42,37,7,14,28
20,Success,46,40,9,5,41
20,Success,47,38,0,11,36
20,Success,49,35,0,14,35
20,Success,45,43,0,8,37
20,Success,44,38,3,15,29
20,Success,43,38,5,14,29
20,Success,46,35,0,16,30
20,Success,44,43,0,7,37
20,Success,43,39,7,11,32
20,Success,45,34,0,10,35
20,Success,47,41,2,10,37
20,Success,48,36,0,16,32
20,Success,50,34,0,11,39
20,Success,47,34,4,15,32
20,Success,46,39,0,14,32
20,Success,45,41,5,9,36
20,Success,54,29,4,13,41
20,Success,46,28,3,23,23
20,Success,48,33,0,14,34
20,Success,49,39,0,8,41
20,Success,48,34,5,13,35
20,Success,52,35,0,10,42
20,Success,42,44,0,10,32
20,Success,42,29,0,15,27
20,Success,47,36,5,12,35
20,Success,45,42,0,12,33
20,Success,49,39,4,8,41
20,Success,41,40,3,16,25
20,Success,51,34,3,12,39
20,Success,43,44,5,8,35
20,Success,47,32,0,13,34
20,Success,44,38,5,13,31
20,Success,46,34,0,16,30
20,Success,47,39,3,11,36
20,Success,44,37,3,16,28
20,Success,48,36,0,14,34
20,Success,52,33,3,12,40
20,Success,44,37,0,14,30
20,Success,59,30,0,10,49
20,Success,46,37,3,14,32
20,Success,50,35,0,14,36
20,Success,44,38,5,13,31
20,Success,45,35,9,11,34
20,Success,52,38,0,9,43
20,Success,48,34,7,11,37
20,Success,53,32,0,12,41
20,Success,49,35,1,15,34
20,Success,45,39,2,14,31
20,Success,51,41,1,7,44
20,Success,45,43,0,6,39
20,Success,46,34,0,16,30
20,Success,50,33,0,14,36
20,Success,53,33,0,12,41
20,Success,46,34,0,19,27
20,Success,40,41,0,15,25
20,Success,40,39,7,14,26
20,Success,49,35,6,10,39
20,Success,43,33,0,13,30
20,Success,53,29,0,16,37
20,Success,43,47,0,10,33
20,Success,37,45,5,13,24
20,Success,55,29,9,7,48
20,Success,39,39,10,12,27
20,Success,45,38,8,9,36
20,Success,53,38,3,6,47
20,Success,46,34,7,13,33
20,Success,45,40,0,10,35
20,Success,48,34,4,14,34
20,Success,54,36,0,9,45
20,Success,58,31,0,9,49
20,Success,42,45,0,10,32
20,Success,55,25,0,13,42
20,Success,43,38,0,12,31
20,Success,48,32,0,14,34
20,Success,42,37,9,12,30
20,Success,46,39,5,10,36
20,Success,42,37,0,17,25
20,Success,44,32,1,23,21
20,Success,48,35,0,7,41
20,Success,43,35,0,16,27
20,Success,43,35,7,15,28
20,Success,43,44,2,11,32
20,Success,46,37,9,8,38
20,Success,45,37,4,14,31
20,Success,42,32,0,14,28
20,Success,45,40,0,14,31
20,Success,44,40,0,14,30
20,Success,50,36,0,8,42
20,Success,48,39,0,11,37
20,Success,48,41,0,11,37
20,Success,50,39,3,8,42
20,Success,42,39,0,17,25
20,Success,48,35,2,15,33
20,Success,37,37,9,17,20
20,Success,50,39,1,10,40
20,Success,45,37,0,17,28
20,Success,53,29,0,12,41
20,Success,47,36,0,9,38
20,Success,59,34,0,7,52
20,Success,42,34,0,17,25
20,Success,49,36,0,9,40
20,Success,51,25,2,22,29
20,Success,53,26,0,16,37
20,Success,47,43,2,8,39
20,Success,42,41,1,16,26
20,Success,47,36,0,17,30
20,Success,41,36,4,19,22
20,Success,46,41,0,12,34
20,Success,46,34,0,16,30
20,Success,46,35,0,13,33
20,Success,45,32,0,17,28
20,Success,47,39,0,12,35
20,Success,51,30,0,16,35
20,Success,47,39,3,11,36
20,Success,45,30,8,17,28
20,Success,42,35,4,19,23
20,Success,46,43,0,10,36
20,Success,46,41,0,10,36
20,Success,51,32,3,14,37
20,Success,47,37,3,13,34
20,Success,43,37,0,15,28
20,Success,53,28,6,13,40
20,Success,47,37,1,15,32
20,Success,54,33,0,13,41
20,Success,52,31,7,10,42
20,Success,50,34,0,15,35
20,Success,50,35,0,12,38
20,Success,50,32,6,12,38
20,Success,57,31,0,7,50
20,Success,51,34,2,13,38
20,Success,53,33,0,14,39
20,Success,53,36,3,8,45
20,Success,52,34,0,13,39
20,Success,48,36,3,13,35
20,Success,49,37,0,11,38
20,Success,53,35,0,9,44
20,Success,53,28,4,15,38
20,Success,48,34,10,8,40
20,Success,58,30,1,11,47
20,Success,56,35,0,5,51
20,Success,47,41,1,11,36
20,Success,47,40,4,9,38
20,Success,54,30,2,14,40
20,Success,51,37,0,12,39
20,Success,50,33,0,13,37
20,Success,48,39,0,12,36
20,Success,50,36,0,12,38
20,Success,43,40,0,8,35
20,Success,47,35,2,16,31
20,Success,49,37,0,12,37
20,Success,55,26,0,13,42
20,Success,49,34,5,12,37
20,Success,46,34,6,14,32
20,Success,51,34,0,13,38
20,Success,51,35,2,12,39
20,Success,43,38,0,16,27
20,Success,58,29,0,12,46
20,Success,43,32,0,17,26
20,Success,50,37,2,11,39
20,Success,50,32,3,15,35
20,Success,49,32,1,18,31
20,Success,45,38,0,16,29
20,Success,55,35,0,9,46
20,Success,46,36,0,18,28
20,Success,42,44,0,11,31
20,Success,52,31,4,13,39
20,Success,48,36,1,15,33
20,Success,52,34,0,11,41
20,Success,52,33,0,10,42
20,Success,40,38,9,13,27
20,Success,46,33,4,17,29
20,Success,49,33,4,14,35
20,Success,47,40,5,8,39
20,Success,56,28,0,12,44
20,Success,52,35,3,10,42
20,Success,44,38,0,14,30
20,Success,50,31,0,10,40
20,Success,49,36,0,8,41
20,Success,38,43,0,14,24
20,Success,50,35,0,13,37
20,Success,51,31,7,11,40
20,Success,52,34,2,12,40
20,Success,51,30,0,17,34
20,Success,58,30,0,12,46
20,Success,49,34,0,15,34
20,Success,45,40,0,13,32
20,Success,46,35,0,16,30
20,Success,49,36,3,12,37
20,Success,45,42,0,13,32
20,Success,44,40,1,15,29
20,Success,52,29,5,14,38
20,Success,53,29,0,17,36
20,Success,48,38,2,12,36
20,Success,42,33,9,16,26
20,Success,45,29,0,12,33
20,Success,64,24,1,11,53
20,Success,44,40,0,16,28
20,Success,48,41,3,8,40
20,Success,51,38,0,9,42
20,Success,41,45,0,12,29
20,Success,54,33,0,9,45
20,Success,54,28,0,16,38
20,Success,44,39,1,16,28
20,Success,45,41,0,11,34
20,Success,46,34,2,18,28
20,Success,42,38,7,13,29
20,Success,53,34,3,10,43
20,Success,49,36,0,15,34
20,Success,55,30,0,13,42
20,Success,45,38,0,14,31
20,Success,43,40,3,14,29
20,Success,47,33,10,10,37
20,Success,50,37,0,12,38
20,Success,42,35,10,13,29
20,Success,45,26,15,14,31
20,Success,58,30,0,10,48
20,Success,50,34,0,9,41
20,Success,55,34,0,9,46
20,Success,45,36,7,12,33
20,Success,38,45,0,12,26
20,Success,43,30,8,19,24
20,Success,40,35,0,19,21
20,Success,49,35,3,13,36
20,Success,56,32,0,9,47
20,Success,49,38,3,10,39
20,Success,48,32,0,13,35
20,Success,44,39,7,10,34
20,Success,57,35,5,3,54
20,Success,47,39,2,12,35
20,Success,48,36,6,10,38
20,Success,47,30,0,21,26
20,Success,47,40,0,10,37
20,Success,47,38,4,11,36
20,Success,51,32,2,15,36
20,Success,43,34,0,14,29
20,Success,40,33,10,17,23
20,Success,48,40,0,10,38
20,Success,47,31,5,17,30
20,Success,47,40,0,11,36
20,Success,52,39,2,7,45
20,Success,50,34,0,11,39
20,Success,49,33,0,13,36
20,Success,51,34,7,8,43
20,Success,51,32,0,11,40
20,Success,40,41,0,11,29
20,Success,39,43,2,16,23
20,Success,52,29,5,14,38
20,Success,45,36,4,15,30
20,Success,46,41,0,12,34
20,Success,49,30,0,15,34
20,Fail,35,38,6,21,14
20,Success,42,40,0,10,32
20,Success,46,37,3,14,32
20,Success,53,30,5,12,41
20,Success,53,30,0,15,38
20,Success,49,41,2,8,41
20,Success,49,40,0,7,42
20,Success,47,27,0,17,30
20,Success,48,40,0,10,38
20,Success,52,37,0,11,41
20,Success,49,39,1,11,38
20,Success,47,35,4,14,33
20,Success,52,35,4,9,43
20,Success,45,42,0,8,37
20,Success,55,33,0,11,44
20,Success,44,37,0,12,32
20,Success,53,36,2,9,44
20,Success,41,34,0,19,22
20,Success,45,36,0,17,28
20,Success,45,37,0,10,35
20,Success,43,40,0,14,29
20,Success,47,38,7,8,39
20,Success,49,38,0,12,37
20,Success,38,44,0,10,28
20,Success,43,39,4,14,29
20,Success,47,37,2,14,33
20,Success,37,35,0,16,21
20,Success,48,36,0,15,33
20,Success,53,37,0,10,43
20,Success,48,38,1,13,35
20,Success,47,35,0,14,33
20,Success,48,37,2,13,35
20,Success,49,32,0,15,34
20,Success,49,41,1,9,40
20,Success,50,33,0,14,36
20,Success,45,42,0,10,35
20,Success,49,36,6,9,40
20,Success,46,36,0,11,35
20,Success,55,32,0,10,45
20,Success,49,31,8,12,37
20,Success,53,35,0,9,44
20,Success,47,40,0,13,34
20,Success,52,31,7,10,42
20,Success,48,39,0,11,37
20,Success,45,40,7,8,37
20,Success,50,35,0,15,35
20,Success,41,36,0,14,27
20,Success,46,41,2,11,35
20,Success,56,35,0,9,47
20,Success,52,34,1,13,39
20,Success,56,34,2,8,48
20,Success,54,29,4,13,41
20,Success,48,33,0,11,37
20,Success,50,33,7,10,40
20,Success,49,36,4,11,38
20,Success,49,35,0,16,33
20,Success,49,34,0,8,41
20,Success,51,33,0,14,37
20,Success,43,40,3,14,29
20,Success,47,43,0,9,38
20,Success,55,30,5,10,45
20,Success,52,29,7,12,40
20,Success,49,40,2,9,40
20,Success,45,34,0,13,32
20,Success,55,31,0,11,44
20,Success,47,41,5,7,40
20,Success,53,36,0,7,46
20,Success,47,36,0,16,31
20,Success,45,37,0,13,32
20,Success,47,37,3,13,34
20,Success,58,32,5,5,53
20,Success,54,32,0,12,42
20,Success,48,30,0,21,27
20,Success,51,35,6,8,43
20,Success,54,25,0,19,35
20,Success,49,30,0,11,38
20,Success,43,39,0,16,27
20,Success,47,36,0,15,32
20,Success,46,37,5,12,34
20,Success,55,30,0,13,42
20,Success,51,35,0,12,39
20,Success,51,31,0,13,38
20,Success,43,37,1,19,24
20,Success,53,28,0,17,36
20,Success,46,39,0,11,35
20,Success,46,33,0,18,28
20,Success,50,37,0,12,38
20,Success,47,30,10,13,34
20,Success,50,25,0,23,27
20,Success,51,34,0,11,40
20,Success,50,36,0,11,39
20,Success,50,27,0,19,31
20,Success,41,41,4,14,27
20,Success,45,32,7,16,29
20,Success,46,40,0,12,34
20,Success,55,28,0,14,41
20,Success,54,35,1,10,44
20,Success,45,37,0,12,33
20,Success,44,38,0,12,32
20,Success,51,39,4,6,45
20,Success,49,39,4,8,41
20,Success,46,32,7,15,31
20,Success,47,33,6,14,33
20,Success,50,37,4,9,41
20,Success,44,41,3,12,32
20,Success,49,33,6,12,37
20,Success,53,27,9,11,42
20,Success,58,31,3,8,50
20,Success,55,33,2,10,45
20,Success,46,44,1,9,37
20,Success,51,36,0,12,39
20,Success,50,39,0,9,41
20,Success,52,38,3,7,45
20,Success,46,39,4,11,35
20,Success,49,40,0,10,39
20,Success,46,31,0,15,31
20,Success,42,38,0,15,27
20,Success,50,32,5,13,37
20,Success,47,33,6,14,33
20,Success,44,38,1,17,27
20,Success,49,35,0,12,37
20,Success,44,33,6,17,27
20,Success,54,32,2,12,42
20,Success,47,28,0,12,35
20,Success,49,36,0,10,39
20,Success,45,33,4,18,27
20,Success,55,31,9,5,50
20,Success,51,29,0,15,36
20,Success,51,34,0,15,36
20,Success,48,33,9,10,38
20,Success,47,38,0,7,40
20,Success,49,31,0,15,34
20,Success,48,36,7,9,39
20,Success,50,37,0,13,37
20,Success,54,38,5,3,51
20,Success,51,34,0,12,39
20,Success,50,27,5,18,32
20,Success,50,29,5,16,34
20,Success,58,25,2,15,43
20,Success,48,38,0,14,34
20,Success,53,29,0,9,44
20,Success,43,36,8,13,30
20,Success,43,37,0,9,34
20,Success,57,28,0,10,47
20,Success,47,34,3,16,31
20,Success,51,32,3,14,37
20,Success,45,40,0,15,30
20,Success,62,29,0,4,58
20,Success,39,41,0,15,24
20,Success,46,32,2,20,26
20,Success,43,34,1,22,21
20,Success,50,33,0,9,41
20,Success,48,37,8,7,41
20,Success,52,32,0,10,42
20,Success,49,36,2,13,36
20,Fail,39,26,0,24,15
20,Success,48,39,0,13,35
20,Success,40,46,2,12,28
20,Success,54,34,5,7,47
20,Success,43,41,8,8,35
20,Success,49,33,6,12,37
20,Success,45,39,0,16,29
20,Success,39,36,11,14,25
20,Success,57,33,0,9,48
20,Success,48,34,0,12,36
20,Success,42,36,8,14,28
20,Success,54,28,0,14,40
20,Success,41,39,7,13,28
20,Success,47,43,0,9,38
20,Success,51,38,1,10,41
20,Success,46,31,0,11,35
20,Success,44,30,6,20,24
20,Success,50,38,0,11,39
20,Success,51,33,3,13,38
20,Success,48,35,3,14,34
20,Success,42,35,2,21,21
20,Success,42,36,6,16,26
20,Success,43,39,0,12,31
20,Success,38,33,11,18,20
20,Success,44,37,0,14,30
20,Success,49,36,2,13,36
20,Success,43,34,0,12,31
20,Success,49,36,0,13,36
20,Success,50,35,3,12,38
20,Success,50,37,2,11,39
20,Success,42,45,0,9,33
20,Success,47,33,5,15,32
20,Success,50,38,0,8,42
20,Success,49,35,6,10,39
20,Success,47,33,7,13,34
20,Success,53,27,0,15,38
20,Success,54,39,0,6,48
20,Success,43,42,6,9,34
20,Success,45,33,10,12,33
20,Success,47,38,2,13,34
20,Success,54,31,0,11,43
20,Success,49,40,2,9,40
20,Success,45,36,7,12,33
20,Success,49,39,1,11,38
20,Success,52,32,0,11,41
20,Success,46,42,0,12,34
20,Success,45,35,9,11,34
20,Success,49,31,7,13,36
20,Success,48,41,1,10,38
20,Success,50,31,0,17,33
20,Success,47,34,0,12,35
20,Success,47,41,0,11,36
20,Success,52,32,0,15,37
20,Success,49,30,0,16,33
20,Success,44,38,7,11,33
20,Success,51,36,0,13,38
20,Success,52,37,0,8,44
20,Success,55,28,0,16,39
20,Success,47,35,1,17,30
20,Success,48,32,0,11,37
20,Success,46,37,0,16,30
20,Success,46,34,1,19,27
20,Success,46,33,0,14,32
20,Success,46,40,0,12,34
20,Success,56,33,1,10,46
20,Success,47,27,5,21,26
20,Success,47,34,0,12,35
20,Success,57,33,0,10,47
20,Success,45,37,2,16,29
20,Success,39,45,4,12,27
20,Success,46,33,6,15,31
20,Success,47,30,9,14,33
20,Success,49,26,0,14,35
20,Success,44,37,4,15,29
20,Success,50,32,3,15,35
20,Success,46,36,2,16,30
20,Success,51,30,0,19,32
20,Success,57,34,3,6,51
20,Success,52,35,5,8,44
20,Success,52,30,0,13,39
20,Success,55,35,1,9,46
20,Success,54,29,0,7,47
20,Success,49,36,0,13,36
20,Success,54,37,0,9,45
20,Success,45,42,5,8,37
20,Success,52,38,0,4,48
20,Success,49,37,4,10,39
20,Success,47,35,0,13,34
20,Success,52,37,1,10,42
20,Success,43,36,9,12,31
20,Success,58,29,7,6,52
20,Success,46,37,5,12,34
20,Success,43,38,0,13,30
20,Success,47,41,1,11,36
20,Success,48,35,1,16,32
20,Success,51,38,0,11,40
20,Success,48,37,0,10,38
20,Success,53,35,0,8,45
20,Success,42,37,3,18,24
20,Success,56,29,0,13,43
20,Success,53,35,5,7,46
20,Success,46,34,9,11,35
20,Success,43,37,5,15,28
20,Success,47,37,5,11,36
20,Success,52,32,2,14,38
20,Success,39,46,3,12,27
20,Success,54,29,0,17,37
20,Success,50,30,1,19,31
20,Success,45,40,0,13,32
20,Success,45,37,6,12,33
20,Success,54,31,0,13,41
20,Success,50,32,4,14,36
20,Success,49,33,0,13,36
20,Success,41,45,4,10,31
20,Success,54,28,8,10,44
20,Success,47,34,0,19,28
20,Success,48,36,0,16,32
20,Success,41,42,4,13,28
20,Success,53,32,1,14,39
20,Success,54,32,4,10,44
20,Success,56,33,0,10,46
20,Success,42,40,5,13,29
20,Success,52,32,0,9,43
20,Success,51,36,1,12,39
20,Success,45,41,0,10,35
20,Success,45,40,2,13,32
20,Success,49,38,2,11,38
20,Success,46,34,0,12,34
20,Success,48,38,0,10,38
20,Success,52,32,0,15,37
20,Success,44,34,0,12,32
20,Success,54,31,6,9,45
20,Success,49,32,2,17,32
20,Success,49,37,0,13,36
20,Success,48,39,0,13,35
20,Success,43,36,0,14,29
20,Success,49,36,1,14,35
20,Success,59,27,1,13,46
20,Success,48,36,0,12,36
20,Success,46,41,3,10,36
20,Success,50,40,0,10,40
20,Success,51,37,1,11,40
20,Success,47,39,0,13,34
20,Success,52,33,1,14,38
20,Success,52,33,4,11,41
20,Success,52,33,5,10,42
20,Success,49,33,6,12,37
20,Success,49,31,2,18,31
20,Success,44,40,0,14,30
20,Success,43,42,0,12,31
20,Success,47,30,14,9,38
20,Success,58,35,1,6,52
20,Success,50,35,0,12,38
20,Success,50,39,1,10,40
20,Success,56,28,0,10,46
20,Success,46,41,0,9,37
20,Success,49,34,1,16,33
20,Success,42,38,0,14,28
20,Success,48,40,0,12,36
20,Success,52,35,3,10,42
20,Success,57,33,0,10,47
20,Success,38,37,0,17,21
20,Success,50,32,11,7,43
20,Success,53,34,0,13,40
20,Success,47,35,0,10,37
20,Success,49,38,0,11,38
20,Success,37,49,0,14,23
20,Success,46,40,0,11,35
20,Success,54,30,0,9,45
20,Success,51,30,6,13,38
20,Success,52,33,6,9,43
20,Success,54,37,2,7,47
20,Success,52,32,0,11,41
20,Success,44,37,0,16,28
20,Success,45,36,0,16,29
20,Success,38,34,0,15,23
20,Fail,39,34,7,20,19
20,Success,41,39,8,12,29
20,Success,44,45,4,7,37
20,Success,49,36,5,10,39
20,Success,42,37,7,14,28
20,Success,42,35,12,11,31
20,Success,47,38,0,11,36
20,Success,52,30,5,13,39
20,Success,45,36,0,16,29
20,Success,41,36,6,17,24
20,Success,54,37,1,8,46
20,Success,49,38,0,12,37
20,Success,55,34,0,10,45
20,Success,48,39,0,10,38
20,Success,48,44,3,5,43
20,Success,40,30,0,17,23
20,Success,49,32,0,18,31
20,Success,43,40,0,14,29
20,Success,48,34,1,17,31
20,Success,50,32,0,12,38
20,Success,44,40,3,13,31
20,Success,43,37,0,14,29
20,Success,46,40,0,14,32
20,Success,43,41,5,11,32
20,Success,46,38,0,13,33
20,Success,53,36,1,10,43
20,Success,50,31,0,16,34
20,Success,57,30,0,8,49
20,Success,45,35,0,10,35
20,Success,55,35,2,8,47
20,Success,50,34,0,15,35
20,Success,46,41,0,9,37
20,Success,53,32,1,14,39
20,Success,46,31,0,16,30
20,Success,42,36,0,17,25
20,Success,42,39,8,11,31
20,Success,48,37,8,7,41
20,Success,51,36,1,12,39
20,Success,47,43,5,5,42
20,Success,50,31,5,14,36
20,Success,40,33,0,17,23
20,Success,42,34,6,18,24
20,Success,50,36,0,10,40
20,Success,46,43,0,10,36
20,Success,47,38,3,12,35
20,Success,54,36,1,9,45
20,Success,47,37,0,14,33
20,Success,45,35,0,20,25
20,Success,48,39,2,11,37
20,Success,50,36,0,12,38
20,Success,56,30,0,10,46
20,Success,48,38,0,9,39
20,Success,45,39,4,12,33
20,Success,53,34,0,10,43
20,Success,52,34,2,12,40
20,Success,49,40,1,10,39
20,Success,47,39,0,11,36
20,Success,45,40,0,14,31
20,Success,44,35,0,15,29
20,Success,55,31,3,11,44
20,Success,44,37,0,14,30
20,Success,45,41,0,11,34
20,Success,55,32,0,10,45
20,Success,50,30,0,17,33
20,Success,49,33,0,16,33
20,Success,52,35,0,12,40
20,Success,47,32,0,10,37
20,Success,48,34,0,11,37
20,Success,53,29,7,11,42
20,Success,47,38,0,9,38
20,Success,49,33,0,17,32
20,Success,48,37,3,12,36
20,Success,45,38,3,14,31
20,Success,50,35,0,10,40
20,Success,46,37,0,14,32
20,Success,55,26,4,15,40
20,Success,46,34,0,12,34
20,Success,39,37,0,14,25
20,Success,42,43,2,13,29
20,Success,45,35,0,14,31
20,Fail,36,41,0,17,19
20,Success,50,38,6,6,44
20,Success,52,29,7,12,40
20,Success,47,35,4,14,33
20,Success,55,32,0,11,44
20,Success,48,34,0,12,36
20,Success,51,38,1,10,41
20,Success,45,39,0,15,30
20,Success,47,39,0,11,36
20,Success,46,41,0,8,38
20,Success,50,33,3,14,36
20,Success,47,38,3,12,35
20,Success,50,32,5,13,37
20,Success,49,33,4,14,35
20,Success,46,32,0,14,32
20,Success,50,35,0,10,40
20,Success,48,41,2,9,39
20,Success,55,32,3,10,45
20,Success,51,38,0,9,42
20,Success,49,36,0,11,38
20,Success,41,41,4,14,27
20,Success,50,37,1,12,38
20,Success,44,32,4,20,24
20,Success,51,33,1,15,36
20,Success,45,41,2,12,33
20,Success,50,35,3,12,38
20,Success,43,41,0,15,28
20,Success,46,31,0,8,38
20,Success,56,30,4,10,46
20,Success,47,29,11,13,34
20,Success,45,37,0,16,29
20,Success,52,33,1,14,38
20,Success,46,39,0,15,31
20,Success,51,36,3,10,41
20,Success,45,31,6,18,27
20,Success,46,28,13,13,33
20,Success,46,41,3,10,36
20,Success,41,30,0,17,24
20,Success,46,37,0,12,34
20,Success,47,34,0,12,35
20,Success,49,39,1,11,38
20,Success,50,44,0,6,44
20,Success,49,40,3,8,41
20,Success,47,40,2,11,36
20,Success,52,35,0,13,39
20,Success,52,35,1,12,40
20,Success,52,24,0,16,36
20,Success,47,42,3,8,39
20,Success,50,32,4,14,36
20,Success,49,32,0,18,31
20,Success,56,39,0,4,52
20,Success,57,29,0,9,48
20,Success,52,33,6,9,43
20,Success,55,35,0,8,47
20,Success,43,37,4,16,27
20,Success,46,35,0,15,31
20,Success,45,39,6,10,35
20,Success,43,41,0,10,33
20,Success,50,35,0,10,40
20,Success,52,36,0,11,41
20,Success,49,34,5,12,37
20,Success,53,33,0,11,42
20,Success,39,47,0,11,28
20,Success,54,32,2,12,42
20,Success,53,42,0,5,48
20,Success,53,31,0,15,38
20,Success,49,33,7,11,38
20,Success,56,31,2,11,45
20,Success,49,28,0,23,26
20,Fail,37,41,0,20,17
20,Success,48,37,0,13,35
20,Success,50,39,0,9,41
20,Success,45,38,0,12,33
20,Success,45,39,5,11,34
20,Success,44,32,9,15,29
20,Success,56,33,0,9,47
20,Success,43,29,6,22,21
20,Success,47,33,8,12,35
20,Success,48,36,6,10,38
20,Success,49,35,3,13,36
20,Success,47,36,1,16,31
20,Success,45,34,3,18,27
20,Success,47,40,0,13,34
20,Success,41,36,0,17,24
20,Success,48,41,1,10,38
20,Success,43,35,9,13,30
20,Success,50,24,0,20,30
20,Success,43,40,1,16,27
20,Success,42,41,0,14,28
20,Success,55,27,0,18,37
20,Success,49,34,0,9,40
20,Success,55,35,0,7,48
20,Success,50,33,4,13,37
20,Success,46,32,9,13,33
20,Success,45,39,0,14,31
20,Success,44,39,0,16,28
20,Success,47,29,0,16,31
20,Success,42,34,0,15,27
20,Success,38,40,5,17,21
20,Success,52,38,2,8,44
20,Success,52,33,0,15,37
20,Success,52,32,0,13,39
20,Success,53,34,1,12,41
20,Success,52,31,9,8,44
20,Success,54,32,1,13,41
20,Success,52,35,0,10,42
20,Success,50,37,0,11,39
20,Success,49,36,0,14,35
20,Success,48,43,3,6,42
20,Success,44,33,0,18,26
20,Success,48,38,0,13,35
20,Success,46,27,13,14,32
20,Success,58,35,0,7,51
20,Success,46,40,0,14,32
20,Success,47,31,0,22,25
20,Success,45,40,5,10,35
20,Success,49,31,5,15,34
20,Success,46,39,0,11,35
20,Success,51,34,0,11,40
20,Success,39,42,3,16,23
20,Success,52,30,0,15,37
20,Success,47,35,0,18,29
20,Success,49,33,6,12,37
20,Success,43,45,3,9,34
20,Success,45,31,8,16,29
20,Success,51,32,5,12,39
20,Success,46,39,1,14,32
20,Success,46,34,0,16,30
20,Success,51,29,0,11,40
20,Success,51,38,1,10,41
20,Success,48,39,0,9,39
20,Success,40,40,0,11,29
20,Success,43,40,3,14,29
20,Success,47,35,0,16,31
20,Success,47,31,1,21,26
20,Success,42,36,0,14,28
20,Success,47,36,6,11,36
20,Success,40,36,0,18,22
20,Success,41,42,3,14,27
20,Success,46,39,0,12,34
20,Success,47,31,8,14,33
20,Success,41,43,2,14,27
20,Success,40,44,0,9,31
20,Success,43,32,0,18,25
20,Success,43,35,2,20,23
20,Success,58,28,0,9,49
20,Success,51,27,3,19,32
20,Success,48,38,0,11,37
20,Success,48,35,0,14,34
20,Success,50,38,5,7,43
20,Success,44,37,0,17,27
20,Success,38,46,0,16,22
20,Success,49,35,0,15,34
20,Success,48,26,0,20,28
20,Success,45,35,9,11,34
20,Success,49,31,3,17,32
20,Success,44,35,8,13,31
20,Success,40,37,0,13,27
20,Success,44,37,0,12,32
20,Success,47,37,4,12,35
20,Success,58,32,1,9,49
20,Success,47,36,4,13,34
20,Success,56,31,4,9,47
20,Success,46,36,0,10,36
20,Success,49,32,0,13,36
20,Success,50,43,0,7,43
20,Success,49,32,0,15,34
20,Success,45,42,1,12,33
20,Success,48,32,0,11,37
20,Success,48,31,0,19,29
20,Success,51,35,3,11,40
20,Success,43,31,0,15,28
20,Success,50,38,0,10,40
20,Success,47,38,3,12,35
20,Success,42,37,0,15,27
20,Success,46,36,0,11,35
20,Success,49,37,5,9,40
20,Success,52,33,0,11,41
20,Success,43,38,1,18,25
20,Success,56,32,4,8,48
20,Success,54,31,0,15,39
20,Success,46,35,1,18,28
20,Success,52,39,4,5,47
20,Success,40,42,0,12,28
20,Success,51,32,1,16,35
20,Success,53,30,3,14,39
20,Success,46,36,5,13,33
20,Success,38,45,0,10,28
20,Success,43,40,0,10,33
20,Success,44,33,8,15,29
20,Success,55,30,0,11,44
20,Success,43,41,0,13,30
20,Success,55,28,1,16,39
20,Success,44,41,0,12,32
20,Success,42,40,0,14,28
20,Success,47,35,0,13,34
20,Success,44,45,0,10,34
20,Success,53,31,3,13,40
20,Success,47,36,0,15,32
20,Success,50,29,2,19,31
20,Success,53,31,0,9,44
20,Success,48,38,0,12,36
20,Success,47,30,1,22,25
20,Success,38,44,1,17,21
20,Success,49,43,0,7,42
20,Success,52,37,0,11,41
20,Success,46,39,0,14,32
20,Success,49,24,0,25,24
20,Success,47,37,0,11,36
20,Success,54,32,3,11,43
20,Success,43,34,0,15,28
20,Success,45,33,0,19,26
20,Success,43,37,5,15,28
20,Success,45,29,0,19,26
20,Success,56,27,1,16,40
20,Success,52,37,0,8,44
20,Success,52,33,3,12,40
20,Success,46,41,7,6,40
20,Success,44,43,0,10,34
20,Success,53,38,1,8,45
20,Success,49,34,2,15,34
20,Success,39,40,5,16,23
20,Success,46,25,0,13,33
20,Success,52,36,0,10,42
20,Success,50,31,10,9,41
20,Success,51,33,5,11,40
20,Success,48,33,8,11,37
20,Success,47,39,1,13,34
20,Success,40,39,0,13,27
20,Success,41,39,0,11,30
20,Success,48,37,0,7,41
20,Success,50,38,0,12,38
20,Success,48,31,7,14,34
20,Success,55,28,0,10,45
20,Success,44,37,0,15,29
20,Success,41,35,11,13,28
20,Success,47,29,3,21,26
20,Success,52,32,0,15,37
20,Success,46,38,0,12,34
20,Success,42,35,0,15,27
20,Success,42,34,0,21,21
20,Success,50,35,0,14,36
20,Success,47,34,8,11,36
20,Success,42,33,0,12,30
20,Success,54,29,0,12,42
20,Success,51,32,0,17,34
20,Success,44,42,0,10,34
20,Success,50,33,6,11,39
20,Success,50,35,0,10,40
20,Success,48,37,9,6,42
20,Success,51,34,2,13,38
20,Success,44,34,0,11,33
20,Success,42,34,15,9,33
20,Success,49,39,0,8,41
20,Success,42,39,4,15,27
20,Success,40,37,5,18,22
20,Success,45,37,2,16,29
20,Success,53,30,0,10,43
20,Success,41,46,0,11,30
20,Success,54,35,0,9,45
20,Success,41,47,0,12,29
20,Success,50,35,0,14,36
20,Success,48,42,0,8,40
20,Success,62,28,3,7,55
20,Success,50,34,0,14,36
20,Success,43,41,0,9,34
20,Success,47,39,2,12,35
20,Success,49,35,0,9,40
20,Success,46,40,0,12,34
20,Success,48,38,0,14,34
20,Success,49,37,1,13,36
20,Success,56,33,0,8,48
20,Success,36,40,0,16,20
20,Success,45,35,5,15,30
20,Success,56,32,0,12,44
20,Success,46,36,4,14,32
20,Success,41,42,7,10,31
20,Success,42,39,3,16,26
20,Success,51,31,0,14,37
20,Success,56,29,3,12,44
20,Success,53,31,2,14,39
20,Success,43,37,5,15,28
20,Success,44,40,0,16,28
20,Success,52,31,0,11,41
20,Success,51,35,0,10,41
20,Success,44,41,4,11,33
20,Success,46,38,0,16,30
20,Success,44,33,9,14,30
20,Success,50,36,3,11,39
20,Success,52,32,2,14,38
20,Success,40,40,0,15,25
20,Success,55,30,5,10,45
20,Success,52,27,0,15,37
20,Success,48,30,4,18,30
20,Success,49,36,0,13,36
20,Success,47,34,0,12,35
20,Success,45,38,0,14,31
20,Success,44,33,0,14,30
20,Success,48,35,7,10,38
20,Success,46,35,1,18,28
20,Success,50,43,0,7,43
20,Success,48,35,4,13,35
20,Success,43,40,0,13,30
20,Success,50,37,4,9,41
20,Success,51,33,3,13,38
20,Success,53,35,0,12,41
20,Success,48,29,4,19,29
20,Success,48,38,7,7,41
20,Success,51,30,6,13,38
20,Success,43,45,1,11,32
20,Success,52,34,1,13,39
20,Success,51,27,7,15,36
20,Success,39,33,9,19,20
20,Success,47,33,0,15,32
20,Success,47,32,1,20,27
20,Success,45,40,5,10,35
20,Success,43,33,7,17,26
20,Success,39,44,0,17,22
20,Success,49,32,1,18,31
20,Fail,42,31,4,23,19
20,Success,43,38,0,15,28
20,Success,41,45,3,11,30
20,Success,41,43,0,12,29
20,Success,47,30,10,13,34
20,Success,53,30,0,17,36
20,Success,48,38,0,10,38
20,Success,55,36,0,9,46
20,Success,44,47,0,7,37
20,Success,52,33,0,12,40
20,Success,44,34,0,17,27
20,Success,51,32,0,14,37
20,Success,54,35,0,10,44
20,Success,57,35,0,6,51
20,Success,50,40,2,8,42
20,Success,40,33,0,18,22
20,Success,54,37,3,6,48
20,Success,46,36,0,15,31
20,Success,53,34,7,6,47
20,Success,44,36,2,18,26
20,Success,59,32,1,8,51
20,Success,51,41,0,8,43
20,Success,50,35,3,12,38
20,Success,48,37,0,15,33
20,Success,41,42,4,13,28
20,Success,49,29,4,18,31
20,Success,54,29,0,11,43
20,Success,38,45,6,11,27
20,Success,35,43,12,10,25
20,Success,61,29,0,8,53
20,Success,44,38,0,12,32
20,Success,55,33,0,8,47
20,Success,45,38,0,12,33
20,Success,48,31,0,15,33
20,Fail,33,42,4,21,12
20,Success,53,34,0,12,41
20,Success,54,32,0,7,47
20,Success,48,34,0,10,38
20,Success,54,33,0,11,43
20,Success,47,37,0,9,38
20,Success,48,37,0,13,35
20,Success,53,36,0,11,42
20,Success,46,38,0,11,35
20,Success,55,28,5,12,43
20,Success,56,35,0,8,48
20,Success,49,45,0,4,45
20,Success,49,36,4,11,38
20,Success,55,36,0,8,47
20,Success,49,32,0,14,35
20,Success,49,34,7,10,39
20,Success,50,34,7,9,41
20,Success,48,40,3,9,39
20,Success,45,38,0,12,33
20,Success,49,33,0,11,38
20,Success,45,39,0,13,32
20,Success,47,37,1,15,32
20,Success,49,41,0,9,40
20,Success,49,40,0,8,41
20,Success,47,31,9,13,34
20,Success,47,38,0,10,37
20,Success,54,35,2,9,45
20,Success,50,33,2,15,35
20,Success,62,25,3,10,52
20,Success,51,38,1,10,41
20,Success,52,32,9,7,45
20,Success,43,34,4,19,24
20,Success,56,28,0,11,45
20,Success,51,26,7,16,35
20,Success,40,47,0,11,29
20,Success,44,40,2,14,30
20,Success,48,29,9,14,34
20,Success,45,35,0,13,32
20,Success,57,36,0,7,50
20,Success,47,38,0,13,34
20,Success,44,41,0,9,35
20,Success,47,40,3,10,37
20,Success,45,32,4,19,26
20,Success,56,31,0,9,47
20,Success,55,38,0,7,48
20,Success,45,43,4,8,37
20,Success,48,39,0,8,40
20,Success,50,31,0,15,35
20,Success,51,33,0,14,37
20,Success,51,29,0,19,32
20,Success,50,30,7,13,37
20,Success,52,35,1,12,40
20,Success,44,33,8,15,29
20,Success,49,38,0,11,38
20,Success,50,32,4,14,36
20,Success,43,34,4,19,24
20,Success,52,33,0,15,37
20,Success,45,42,0,10,35
20,Success,48,34,3,15,33
20,Success,47,33,0,17,30
20,Success,47,36,5,12,35
20,Success,50,39,0,9,41
20,Success,48,37,0,15,33
20,Success,54,29,0,14,40
20,Success,58,27,3,12,46
20,Success,50,34,2,14,36
20,Success,48,31,4,17,31
20,Success,49,35,3,13,36
20,Success,55,36,1,8,47
20,Success,47,30,3,20,27
20,Success,54,24,3,19,35
20,Success,52,31,0,14,38
20,Success,40,41,0,18,22
20,Success,47,35,0,14,33
20,Success,55,36,0,9,46
20,Success,50,38,0,10,40
20,Success,40,33,0,14,26
20,Success,55,33,2,10,45
20,Success,47,35,0,14,33
20,Success,53,37,3,7,46
20,Success,48,36,0,13,35
20,Success,48,26,12,14,34
20,Success,47,41,0,12,35
20,Success,52,32,0,8,44
20,Success,48,37,1,14,34
20,Success,46,29,6,19,27
20,Success,44,35,0,12,32
20,Fail,34,36,0,22,12
20,Success,48,33,0,17,31
20,Success,50,30,7,13,37
20,Success,43,42,3,12,31
20,Success,44,42,0,11,33
20,Success,41,42,6,11,30
20,Success,57,32,0,11,46
20,Success,46,40,0,11,35
20,Success,41,39,0,15,26
20,Success,58,34,0,6,52
20,Success,49,29,9,13,36
20,Success,53,30,0,9,44
20,Success,44,38,4,14,30
20,Success,44,38,3,15,29
20,Success,48,36,0,16,32
20,Success,48,30,3,19,29
20,Success,48,40,0,11,37
20,Success,49,32,0,19,30
20,Success,47,30,5,18,29
20,Success,45,41,0,10,35
20,Success,54,36,2,8,46
20,Success,48,37,5,10,38
20,Success,43,42,0,14,29
20,Success,42,36,7,15,27
20,Success,42,35,0,15,27
20,Success,51,33,0,12,39
20,Success,47,37,2,14,33
20,Success,46,27,8,19,27
20,Success,67,20,1,12,55
20,Success,48,29,0,18,30
20,Success,49,33,0,10,39
20,Success,46,36,0,12,34
20,Success,50,36,1,13,37
20,Success,44,39,0,10,34
20,Success,55,29,0,16,39
20,Success,49,35,4,12,37
20,Success,55,34,0,9,46
20,Success,47,39,0,13,34
20,Success,53,38,0,9,44
20,Success,45,38,0,14,31
20,Success,45,30,12,13,32
20,Success,48,41,0,8,40
20,Success,52,29,0,14,38
20,Success,52,39,0,9,43
20,Success,51,32,0,14,37
20,Success,51,36,6,7,44
20,Success,55,28,5,12,43
20,Success,50,35,0,11,39
20,Success,45,44,0,9,36
20,Success,45,39,5,11,34
20,Success,57,34,0,9,48
20,Success,53,33,0,14,39
20,Success,44,43,2,11,33
20,Success,49,29,9,13,36
20,Success,50,33,0,12,38
20,Success,52,36,0,11,41
20,Success,41,35,0,21,20
20,Success,51,32,6,11,40
20,Success,46,40,0,12,34
20,Success,50,31,1,18,32
20,Success,46,29,0,13,33
20,Success,47,36,1,16,31
20,Success,46,31,7,16,30
20,Success,52,34,4,10,42
20,Success,46,38,4,12,34
20,Success,47,33,0,13,34
20,Success,45,34,0,19,26
20,Success,46,38,2,14,32
20,Success,38,41,0,10,28
20,Success,53,34,5,8,45
20,Success,52,34,0,9,43
20,Success,51,33,2,14,37
20,Success,56,28,0,8,48
20,Success,49,35,0,16,33
20,Success,50,33,0,14,36
20,Success,49,37,0,13,36
20,Success,47,34,3,16,31
20,Success,44,36,2,18,26
20,Success,54,37,3,6,48
20,Success,54,36,0,8,46
20,Success,46,36,0,8,38
20,Success,45,37,5,13,32
20,Success,45,37,0,12,33
20,Success,51,31,0,13,38
20,Success,45,44,0,8,37
20,Success,48,44,5,3,45
20,Success,55,31,0,9,46
20,Success,52,28,0,14,38
20,Success,48,32,0,15,33
20,Success,54,35,1,10,44
20,Success,44,37,0,15,29
20,Success,51,34,0,13,38
20,Success,51,37,0,11,40
20,Success,48,32,5,15,33
20,Success,56,29,6,9,47
20,Success,39,43,0,14,25
20,Success,48,36,5,11,37
20,Success,44,38,0,14,30
20,Success,50,37,3,10,40
20,Success,50,32,0,17,33
20,Success,39,41,0,8,31
20,Success,49,35,0,14,35
20,Success,49,36,0,7,42
20,Success,51,37,0,11,40
20,Success,47,40,0,11,36
20,Success,43,34,6,17,26
20,Success,40,46,1,13,27
20,Success,43,41,4,12,31
20,Success,42,38,4,16,26
20,Success,56,32,0,11,45
20,Success,45,45,0,10,35
20,Success,53,34,3,10,43
20,Success,59,30,3,8,51
20,Success,48,35,0,14,34
20,Success,41,38,0,12,29
20,Success,50,33,0,16,34
20,Success,48,34,0,5,43
20,Success,57,33,0,10,47
20,Success,46,35,0,12,34
20,Success,44,32,7,17,27
20,Success,43,45,1,11,32
20,Success,44,34,0,16,28
20,Success,55,36,1,8,47
20,Success,47,36,4,13,34
20,Success,56,33,0,6,50
20,Success,49,36,3,12,37
20,Success,47,33,0,17,30
20,Success,41,38,5,16,25
20,Success,50,34,3,13,37
20,Success,49,33,0,7,42
20,Success,54,35,2,9,45
20,Success,47,41,0,12,35
20,Success,50,31,0,13,37
20,Success,44,30,0,16,28
20,Success,48,35,0,10,38
20,Success,46,31,7,16,30
20,Success,47,32,0,16,31
20,Success,46,41,3,10,36
20,Success,51,33,1,15,36
20,Success,52,33,0,13,39
20,Success,53,28,3,16,37
20,Success,50,32,0,9,41
20,Success,46,35,0,12,34
20,Success,50,34,0,13,37
20,Success,46,40,0,8,38
20,Success,47,36,3,14,33
20,Success,50,30,0,17,33
20,Success,50,33,3,14,36
20,Success,47,38,0,11,36
20,Success,57,32,0,8,49
20,Success,47,38,0,13,34
20,Success,47,33,9,11,36
20,Success,49,39,0,10,39
20,Success,48,35,2,15,33
20,Success,45,35,3,17,28
20,Success,44,38,0,18,26
20,Success,44,39,0,14,30
20,Success,46,36,0,10,36
20,Success,54,38,2,6,48
20,Success,52,35,3,10,42
20,Success,52,35,4,9,43
20,Success,46,38,0,12,34
20,Success,44,41,0,11,33
20,Success,44,36,10,10,34
20,Success,52,31,6,11,41
20,Success,50,40,3,7,43
20,Success,50,32,2,16,34
20,Success,50,35,1,14,36
20,Success,48,43,2,7,41
20,Success,46,33,0,14,32
20,Success,45,31,12,12,33
20,Success,51,36,0,11,40
20,Success,49,35,5,11,38
20,Success,50,31,0,9,41
20,Success,48,38,2,12,36
20,Success,49,39,0,11,38
20,Success,50,35,1,14,36
20,Success,55,33,2,10,45
20,Success,47,42,0,7,40
20,Success,50,38,1,11,39
20,Success,45,26,11,18,27
20,Success,46,38,0,16,30
20,Success,52,34,0,10,42
20,Success,45,37,6,12,33
20,Success,50,37,0,13,37
20,Success,47,38,0,11,36
20,Success,44,35,2,19,25
20,Success,49,29,5,17,32
20,Success,48,36,0,6,42
20,Success,44,32,0,21,23
20,Success,48,40,1,11,37
20,Success,51,37,0,11,40
20,Success,50,34,9,7,43
20,Success,40,41,0,12,28
20,Success,53,36,0,11,42
20,Success,41,39,0,15,26
20,Success,45,32,11,12,33
20,Success,48,28,8,16,32
20,Success,39,41,0,13,26
20,Success,49,31,6,14,35
20,Success,46,44,0,9,37
20,Success,46,38,0,14,32
20,Success,49,39,2,10,39
20,Success,50,39,0,9,41
20,Success,50,32,0,12,38
20,Success,51,37,0,11,40
20,Success,47,39,0,9,38
20,Success,48,33,0,17,31
20,Success,52,37,1,10,42
20,Success,47,32,5,16,31
20,Success,49,31,5,15,34
20,Success,43,40,3,14,29
20,Success,45,40,6,9,36
20,Success,45,32,0,11,34
20,Success,43,39,0,16,27
20,Success,37,41,0,16,21
20,Success,45,37,0,15,30
20,Success,45,41,2,12,33
20,Success,47,33,5,15,32
20,Success,48,36,0,15,33
20,Success,49,33,0,15,34
20,Success,51,32,3,14,37
20,Success,46,37,0,17,29
20,Success,53,28,9,10,43
20,Success,39,43,0,14,25
20,Success,55,30,3,12,43
20,Success,41,44,0,13,28
20,Success,43,39,0,14,29
20,Success,52,37,0,9,43
20,Success,46,28,0,18,28
20,Success,51,29,8,12,39
20,Success,47,34,0,17,30
20,Success,49,28,0,17,32
20,Success,53,37,4,6,47
20,Success,43,32,0,23,20
20,Success,49,38,0,5,44
20,Success,45,36,0,15,30
20,Success,52,34,0,12,40
20,Success,43,42,0,13,30
20,Success,44,40,3,13,31
20,Success,48,32,0,14,34
20,Success,43,37,11,9,34
20,Success,40,38,0,13,27
20,Success,48,40,0,12,36
20,Success,45,35,6,14,31
20,Success,47,39,1,13,34
20,Success,49,26,12,13,36
20,Success,44,34,7,15,29
20,Success,52,40,2,6,46
20,Success,48,34,4,14,34
20,Success,45,34,13,8,37
20,Success,41,40,0,15,26
20,Success,46,38,0,16,30
20,Success,37,42,11,10,27
20,Success,50,32,6,12,38
20,Success,53,39,0,5,48
20,Success,46,35,1,18,28
20,Success,49,42,1,8,41
20,Success,47,40,0,13,34
20,Success,40,36,0,18,22
20,Success,52,32,0,14,38
20,Success,46,38,0,10,36
20,Success,47,42,1,10,37
20,Success,43,43,0,9,34
20,Success,48,33,9,10,38
20,Success,55,31,0,12,43
20,Success,40,38,5,17,23
20,Success,48,32,0,15,33
20,Success,52,37,1,10,42
20,Success,49,38,0,13,36
20,Success,45,35,0,12,33
20,Success,48,29,0,18,30
20,Success,48,38,0,11,37
20,Success,59,26,3,12,47
20,Success,48,37,1,14,34
20,Success,49,37,0,12,37
20,Success,45,32,4,19,26
20,Success,44,34,3,19,25
20,Success,53,28,9,10,43
20,Success,52,36,1,11,41
20,Success,44,42,0,14,30
20,Success,50,37,0,13,37
20,Success,48,33,2,17,31
20,Success,39,39,5,17,22
20,Success,46,37,0,14,32
20,Success,51,31,0,14,37
20,Success,51,36,0,10,41
20,Success,51,37,1,11,40
20,Success,52,30,2,16,36
20,Success,42,44,0,14,28
20,Success,49,33,0,13,36
20,Success,53,29,8,10,43
20,Success,42,36,0,16,26
20,Success,49,38,0,10,39
20,Success,42,38,4,16,26
20,Success,44,40,0,12,32
20,Success,46,38,0,12,34
20,Success,46,30,7,17,29
20,Success,45,39,1,15,30
20,Success,47,35,3,15,32
20,Success,45,37,0,16,29
20,Success,47,37,0,10,37
20,Success,48,38,1,13,35
20,Success,53,37,0,10,43
20,Success,52,38,1,9,43
20,Success,49,36,7,8,41
20,Success,48,33,5,14,34
20,Success,46,39,3,12,34
20,Success,51,28,0,16,35
20,Success,48,43,0,9,39
20,Success,46,31,3,20,26
20,Success,48,33,0,14,34
20,Success,52,39,0,6,46
20,Success,42,36,0,14,28
20,Success,46,39,3,12,34
20,Success,50,28,0,18,32
20,Success,47,35,1,17,30
20,Success,50,34,2,14,36
20,Success,48,32,0,18,30
20,Success,48,35,0,16,32
20,Success,54,34,1,11,43
20,Success,51,27,0,14,37
20,Success,55,33,0,12,43
20,Success,51,35,0,13,38
20,Success,49,37,5,9,40
20,Success,52,34,3,11,41
20,Success,46,40,0,12,34
20,Success,45,35,3,17,28
20,Success,47,36,0,14,33
20,Success,55,30,2,13,42
20,Success,41,42,6,11,30
20,Success,43,30,0,20,23
20,Success,46,39,0,15,31
20,Success,51,31,1,17,34
20,Success,46,37,0,15,31
20,Success,49,34,2,15,34
20,Success,52,28,7,13,39
20,Success,46,29,0,17,29
20,Success,48,42,0,10,38
20,Success,48,40,1,11,37
20,Success,49,42,2,7,42
20,Success,45,37,1,17,28
20,Success,50,29,0,17,33
20,Fail,35,45,2,18,17
20,Success,48,41,0,9,39
20,Fail,34,38,0,22,12
20,Success,50,35,4,11,39
20,Success,52,32,3,13,39
20,Success,51,35,7,7,44
20,Success,49,37,2,12,37
20,Success,47,38,3,12,35
20,Success,45,37,4,14,31
20,Success,49,34,0,16,33
20,Success,49,28,0,20,29
20,Success,44,39,7,10,34
20,Success,50,42,0,8,42
20,Success,47,38,1,14,33
20,Success,45,35,1,19,26
20,Success,48,39,0,13,35
20,Success,51,36,0,13,38
20,Success,46,46,3,5,41
20,Success,55,28,0,16,39
20,Success,53,32,2,13,40
20,Success,57,31,0,12,45
20,Success,54,33,0,12,42
20,Success,53,35,0,8,45
20,Success,53,33,0,9,44
20,Success,48,32,8,12,36
20,Success,46,34,2,18,28
20,Success,47,36,7,10,37
20,Success,45,35,6,14,31
20,Success,47,37,0,16,31
20,Success,58,27,0,12,46
20,Success,46,39,1,14,32
20,Success,43,39,4,14,29
20,Success,46,32,9,13,33
20,Success,48,34,0,10,38
20,Success,48,35,11,6,42
20,Success,54,31,0,14,40
20,Success,40,39,4,17,23
20,Success,53,36,0,8,45
20,Success,37,41,0,14,23
20,Success,45,36,4,15,30
20,Success,45,37,0,18,27
20,Success,48,40,1,11,37
20,Success,56,35,0,6,50
20,Success,52,35,3,10,42
20,Success,44,38,2,16,28
20,Success,48,43,0,9,39
20,Success,49,37,0,12,37
20,Success,49,32,0,12,37
20,Success,52,38,0,9,43
20,Success,53,33,0,13,40
20,Success,54,26,5,15,39
20,Success,47,35,4,14,33
20,Success,48,33,0,12,36
20,Success,45,31,0,16,29
20,Success,48,30,7,15,33
20,Success,50,31,0,14,36
20,Success,45,36,0,9,36
20,Success,47,33,0,14,33
20,Success,50,39,4,7,43
20,Success,45,34,0,19,26
20,Success,51,38,0,8,43
20,Success,49,37,0,11,38
20,Success,47,32,5,16,31
20,Success,51,38,0,10,41
20,Success,51,35,4,10,41
20,Success,52,39,0,8,44
20,Success,55,32,0,8,47
20,Success,48,40,0,12,36
20,Success,42,36,0,17,25
20,Success,54,34,2,10,44
20,Success,51,34,3,12,39
20,Success,44,31,9,16,28
20,Success,44,45,0,10,34
20,Success,47,33,0,19,28
20,Success,49,39,0,10,39
20,Success,45,41,0,9,36
20,Success,55,36,0,9,46
20,Success,47,41,1,11,36
20,Success,52,32,0,15,37
20,Success,46,38,1,15,31
20,Success,53,38,0,8,45
20,Success,51,28,5,16,35
20,Success,50,33,1,16,34
20,Success,37,46,0,14,23
20,Success,51,28,0,16,35
20,Success,43,42,3,12,31
20,Success,54,23,0,14,40
20,Success,47,39,2,12,35
20,Success,45,24,0,18,27
20,Success,51,39,0,8,43
20,Success,50,43,0,6,44
20,Success,47,37,0,11,36
20,Success,50,34,0,13,37
20,Success,42,48,0,10,32
20,Success,43,35,8,14,29
20,Success,48,36,0,16,32
20,Success,52,32,0,11,41
20,Success,37,44,4,15,22
20,Success,46,36,5,13,33
20,Success,59,32,2,7,52
20,Success,43,43,0,14,29
20,Success,51,27,7,15,36
20,Success,40,48,1,11,29
20,Success,43,30,6,21,22
20,Success,48,36,0,11,37
20,Success,56,27,0,10,46
20,Success,51,37,0,12,39
20,Success,53,31,6,10,43
20,Success,52,30,5,13,39
20,Success,48,43,0,6,42
20,Success,46,40,0,13,33
20,Success,52,30,0,14,38
20,Success,52,36,0,12,40
20,Success,50,35,0,13,37
20,Success,55,34,1,10,45
20,Success,38,45,2,15,23
20,Success,51,39,0,10,41
20,Success,38,36,15,11,27
20,Success,50,36,0,13,37
20,Success,50,34,2,14,36
20,Success,48,36,4,12,36
20,Success,50,37,0,9,41
20,Success,44,36,0,13,31
20,Success,42,38,0,13,29
20,Success,39,33,10,18,21
20,Success,51,34,0,10,41
20,Success,44,39,0,15,29
20,Success,53,28,11,8,45
20,Success,48,42,3,7,41
20,Success,49,38,0,12,37
20,Success,54,30,0,13,41
20,Success,47,29,0,19,28
20,Success,54,28,6,12,42
20,Success,51,36,0,10,41
20,Success,45,41,0,12,33
20,Success,42,41,0,12,30
20,Success,46,38,5,11,35
20,Success,49,36,2,13,36
20,Success,49,38,2,11,38
20,Success,42,40,5,13,29
20,Success,46,39,0,14,32
20,Success,49,39,0,12,37
20,Success,49,38,0,11,38
20,Success,44,42,2,12,32
20,Success,52,37,2,9,43
20,Success,55,30,5,10,45
20,Success,54,30,7,9,45
20,Success,46,42,0,7,39
20,Success,49,31,3,17,32
20,Success,45,41,1,13,32
20,Success,55,33,0,8,47
20,Success,49,33,1,17,32
20,Success,47,33,0,10,37
20,Success,43,39,8,10,33
20,Success,43,39,0,18,25
20,Success,48,34,1,17,31
20,Success,49,28,0,11,38
20,Success,48,34,0,17,31
20,Success,44,39,0,15,29
20,Success,46,38,0,13,33
20,Success,53,34,0,13,40
20,Success,53,30,0,15,38
20,Success,44,39,0,15,29
20,Success,48,30,0,13,35
20,Success,44,38,0,12,32
20,Success,54,30,2,14,40
20,Success,46,39,2,13,33
20,Success,52,29,0,15,37
20,Success,50,38,3,9,41
20,Success,42,39,8,11,31
20,Success,48,31,0,16,32
20,Success,54,33,2,11,43
20,Success,44,43,0,12,32
20,Success,43,32,8,17,26
20,Success,52,31,0,11,41
20,Success,52,40,4,4,48
20,Success,46,36,4,14,32
20,Success,42,31,12,15,27
20,Success,54,32,1,13,41
20,Success,40,32,0,15,25
20,Success,48,37,0,14,34
20,Success,52,37,2,9,43
20,Success,45,33,10,12,33
20,Success,50,37,0,12,38
20,Success,45,35,4,16,29
20,Success,47,34,2,17,30
20,Success,49,36,0,14,35
20,Success,49,34,0,12,37
20,Success,50,35,5,10,40
20,Success,45,38,2,15,30
20,Success,54,35,0,10,44
20,Success,48,38,1,13,35
20,Success,46,35,7,12,34
20,Success,40,39,0,12,28
20,Success,46,34,5,15,31
20,Success,50,32,0,16,34
20,Success,50,36,0,12,38
20,Success,47,36,0,13,34
20,Success,51,32,7,10,41
20,Fail,38,35,8,19,19
20,Success,46,38,5,11,35
20,Success,50,34,0,13,37
20,Success,56,31,0,13,43
20,Success,39,44,0,10,29
20,Success,42,40,0,8,34
20,Success,43,43,0,13,30
20,Success,56,32,1,11,45
20,Success,59,29,0,9,50
20,Success,43,33,0,20,23
20,Success,56,38,1,5,51
20,Success,45,41,0,13,32
20,Success,48,29,8,15,33
20,Success,43,42,4,11,32
20,Success,51,29,1,19,32
20,Success,45,34,0,19,26
20,Success,49,39,5,7,42
20,Success,46,34,0,13,33
20,Success,51,31,1,17,34
20,Success,46,39,2,13,33
20,Success,43,40,0,16,27
20,Success,49,33,0,17,32
20,Success,41,35,0,7,34
20,Success,50,38,0,10,40
20,Success,45,34,12,9,36
20,Success,58,33,1,8,50
20,Success,41,42,0,14,27
20,Success,43,38,5,14,29
20,Success,45,36,0,11,34
20,Success,48,33,0,11,37
20,Success,45,41,3,11,34
20,Success,40,43,3,14,26
20,Success,52,38,0,9,43
20,Success,51,25,3,21,30
20,Success,46,38,4,12,34
20,Success,40,38,0,19,21
20,Success,52,35,1,12,40
20,Success,48,37,0,13,35
20,Success,45,40,2,13,32
20,Success,44,44,0,12,32
20,Success,45,37,0,14,31
20,Success,53,28,0,17,36
20,Success,48,33,0,14,34
20,Success,48,38,0,11,37
20,Success,50,41,1,8,42
20,Success,48,37,4,11,37
20,Success,44,41,2,13,31
20,Success,45,43,1,11,34
20,Success,55,30,6,9,46
20,Success,43,41,0,15,28
20,Success,46,43,1,10,36
20,Success,40,44,0,15,25
20,Success,47,41,5,7,40
20,Success,42,36,0,14,28
20,Success,44,40,0,14,30
20,Success,52,37,0,10,42
20,Success,48,36,0,15,33
20,Success,53,33,3,11,42
20,Success,45,34,0,16,29
20,Success,54,27,0,14,40
20,Success,52,36,0,12,40
20,Success,37,37,0,14,23
20,Success,46,32,0,16,30
20,Success,49,29,5,17,32
20,Success,43,42,1,14,29
20,Success,43,41,2,14,29
20,Success,43,37,0,13,30
20,Success,45,40,1,14,31
20,Success,39,38,0,17,22
20,Success,37,37,9,17,20
20,Success,49,35,5,11,38
20,Success,46,39,0,15,31
20,Success,42,33,0,14,28
20,Success,51,32,11,6,45
20,Success,50,37,2,11,39
20,Success,46,38,0,16,30
20,Success,43,38,9,10,33
20,Success,46,45,2,7,39
20,Success,52,32,0,15,37
20,Success,42,40,3,15,27
20,Success,37,42,0,10,27
20,Success,43,45,0,10,33
20,Success,46,33,10,11,35
20,Success,47,39,0,13,34
20,Success,48,36,4,12,36
20,Success,46,37,6,11,35
20,Success,52,40,0,8,44
20,Success,46,36,0,17,29
20,Success,50,31,7,12,38
20,Success,49,35,1,15,34
20,Success,48,38,3,11,37
20,Success,51,37,0,12,39
20,Success,42,39,8,11,31
20,Success,43,41,2,14,29
20,Success,55,37,0,8,47
20,Success,55,36,0,9,46
20,Success,48,36,2,14,34
20,Success,56,29,0,15,41
20,Success,44,38,0,16,28
20,Success,47,39,7,7,40
20,Success,49,34,0,14,35
20,Success,51,32,2,15,36
20,Success,48,37,0,12,36
20,Success,56,34,1,9,47
20,Success,50,34,4,12,38
20,Success,58,31,0,8,50
20,Success,43,39,0,15,28
20,Success,46,39,1,14,32
20,Success,51,36,0,12,39
20,Success,50,30,0,15,35
20,Success,47,38,3,12,35
20,Success,49,35,0,14,35
20,Success,47,38,0,11,36
20,Success,48,35,2,15,33
20,Success,53,30,0,9,44
20,Success,44,40,0,14,30
20,Success,42,38,0,18,24
20,Success,48,36,2,14,34
20,Success,48,30,0,11,37
20,Success,49,34,0,15,34
20,Success,54,30,5,11,43
20,Success,51,32,3,14,37
20,Success,45,42,1,12,33
20,Success,46,40,0,10,36
20,Success,41,36,3,20,21
20,Success,55,27,8,10,45
20,Success,44,34,12,10,34
20,Success,46,42,0,9,37
20,Success,47,31,0,16,31
20,Success,46,32,0,12,34
20,Success,41,36,5,18,23
20,Success,39,42,4,15,24
20,Success,49,34,0,11,38
20,Success,54,34,0,11,43
20,Success,44,33,4,19,25
20,Success,44,33,8,15,29
20,Success,43,39,0,13,30
20,Success,51,33,2,14,37
20,Success,41,34,5,20,21
20,Success,55,35,2,8,47
20,Success,50,29,0,17,33
20,Success,37,44,0,13,24
20,Success,49,34,0,11,38
20,Success,54,29,0,13,41
20,Success,43,39,0,13,30
20,Success,52,32,0,13,39
20,Success,56,34,1,9,47
20,Success,41,43,0,6,35
20,Success,53,29,8,10,43
20,Success,49,33,0,14,35
20,Success,54,32,0,10,44
20,Success,38,44,4,14,24
20,Success,52,32,0,8,44
20,Success,43,35,10,12,31
20,Success,53,30,13,4,49
20,Success,50,32,2,16,34
20,Success,48,41,1,10,38
20,Success,52,30,0,18,34
20,Success,47,34,0,13,34
20,Success,44,40,0,12,32
20,Success,50,30,5,15,35
20,Success,54,37,0,9,45
20,Success,54,28,0,15,39
20,Success,45,38,4,13,32
20,Success,41,36,0,19,22
20,Success,44,39,0,16,28
20,Success,47,32,0,12,35
20,Success,50,24,8,18,32
20,Success,52,36,2,10,42
20,Success,56,31,0,12,44
20,Success,49,34,1,16,33
20,Success,47,37,0,12,35
20,Success,56,27,6,11,45
20,Success,46,39,1,14,32
20,Success,60,30,3,7,53
20,Success,51,37,2,10,41
20,Success,47,41,0,9,38
20,Success,57,34,2,7,50
20,Success,50,32,9,9,41
20,Success,54,36,1,9,45
20,Success,42,37,0,14,28
20,Success,47,35,0,15,32
20,Success,48,32,0,14,34
20,Success,49,33,5,13,36
20,Success,41,44,4,11,30
20,Success,45,35,0,15,30
20,Success,50,29,8,13,37
20,Success,51,32,0,15,36
20,Success,50,31,7,12,38
20,Success,52,40,0,7,45
20,Success,48,37,2,13,35
20,Success,54,34,3,9,45
20,Success,49,36,0,15,34
20,Success,48,39,3,10,38
20,Success,57,35,0,8,49
20,Success,48,33,0,13,35
20,Success,53,40,0,7,46
20,Success,56,32,1,11,45
20,Success,46,31,0,19,27
20,Success,52,35,3,10,42
20,Success,51,40,1,8,43
20,Success,55,33,0,11,44
20,Success,45,39,0,15,30
20,Fail,38,35,0,21,17
20,Success,53,29,9,9,44
20,Success,51,37,6,6,45
20,Success,44,41,3,12,32
20,Success,52,35,5,8,44
20,Success,47,38,3,12,35
20,Success,46,36,6,12,34
20,Success,54,34,0,11,43
20,Success,44,38,0,13,31
20,Success,43,41,5,11,32
20,Success,51,33,0,15,36
20,Success,42,38,0,11,31
20,Success,52,38,2,8,44
20,Success,39,41,3,17,22
20,Success,53,33,0,8,45
20,Success,49,41,1,9,40
20,Success,44,40,1,15,29
20,Success,40,39,5,16,24
20,Success,48,32,3,17,31
20,Success,56,28,6,10,46
20,Success,49,40,0,7,42
20,Success,47,44,0,9,38
20,Success,41,41,1,17,24
20,Success,43,33,0,22,21
20,Success,53,25,0,17,36
20,Success,43,39,9,9,34
20,Success,44,41,0,8,36
20,Success,47,40,2,11,36
20,Success,47,36,1,16,31
20,Success,49,36,0,9,40
20,Success,61,33,0,4,57
20,Success,46,39,5,10,36
20,Success,53,35,1,11,42
20,Success,47,36,0,13,34
20,Success,52,30,3,15,37
20,Success,53,32,3,12,41
20,Success,50,33,2,15,35
20,Success,47,33,0,15,32
20,Success,43,40,1,16,27
20,Success,51,33,0,14,37
20,Success,50,37,0,11,39
20,Success,50,35,0,11,39
20,Success,49,36,5,10,39
20,Success,51,37,0,8,43
20,Success,50,31,0,14,36
20,Success,47,32,3,18,29
20,Success,48,37,0,11,37
20,Success,53,34,0,11,42
20,Success,48,32,3,17,31
20,Success,46,33,0,11,35
20,Success,49,31,3,17,32
20,Success,48,40,0,10,38
20,Success,48,37,0,13,35
20,Success,42,31,12,15,27
20,Success,50,33,4,13,37
20,Success,57,32,0,9,48
20,Success,53,33,5,9,44
20,Success,55,30,4,11,44
20,Success,43,37,2,18,25
20,Success,49,29,0,15,34
20,Success,43,41,0,13,30
20,Success,45,38,2,15,30
20,Success,39,44,0,16,23
20,Success,50,35,2,13,37
20,Success,48,40,1,11,37
20,Success,49,29,7,15,34
20,Success,49,30,3,18,31
20,Success,48,33,5,14,34
20,Success,59,33,0,8,51
20,Success,48,31,0,14,34
20,Success,51,38,0,8,43
20,Success,42,31,11,16,26
20,Success,47,38,2,13,34
20,Success,42,43,2,13,29
20,Success,49,32,6,13,36
20,Success,43,41,0,12,31
20,Success,42,36,5,17,25
20,Success,53,35,0,11,42
20,Success,42,33,11,14,28
20,Success,45,43,0,9,36
20,Success,45,38,0,17,28
20,Success,49,38,0,12,37
20,Success,48,37,2,13,35
20,Success,47,31,4,18,29
20,Fail,37,34,0,20,17
20,Success,38,41,0,15,23
20,Success,48,32,0,14,34
20,Success,51,38,1,10,41
20,Success,54,29,6,11,43
20,Success,40,37,9,14,26
20,Success,49,28,7,16,33
20,Success,47,38,3,12,35
20,Success,48,40,0,12,36
20,Success,53,36,0,11,42
20,Success,49,38,0,12,37
20,Success,39,32,0,15,24
20,Success,48,33,6,13,35
20,Success,55,29,2,14,41
20,Success,58,31,0,10,48
20,Success,50,30,0,18,32
20,Success,45,35,0,18,27
20,Success,51,33,6,10,41
20,Success,51,37,0,10,41
20,Success,41,44,0,7,34
20,Success,45,35,0,16,29
20,Success,48,31,0,16,32
20,Success,50,32,4,14,36
20,Success,44,37,0,19,25
20,Success,50,40,0,7,43
20,Success,53,37,1,9,44
20,Success,51,36,5,8,43
20,Success,46,32,10,12,34
20,Success,50,39,0,11,39
20,Success,46,36,4,14,32
20,Success,47,27,0,16,31
20,Success,46,39,2,13,33
20,Success,55,34,0,8,47
20,Success,59,33,0,7,52
20,Success,54,34,3,9,45
20,Success,47,33,0,19,28
20,Success,46,34,7,13,33
20,Success,54,36,0,5,49
20,Success,40,34,9,17,23
20,Success,44,35,7,14,30
20,Success,51,30,9,10,41
20,Success,46,29,3,22,24
20,Success,45,35,3,17,28
20,Success,49,27,7,17,32
20,Success,48,32,0,14,34
20,Success,52,30,0,15,37
20,Success,47,40,3,10,37
20,Success,50,33,0,8,42
20,Success,51,27,0,15,36
20,Success,58,33,0,6,52
20,Success,43,35,0,19,24
20,Success,51,28,6,15,36
20,Success,51,30,5,14,37
20,Success,58,31,0,11,47
20,Success,52,33,0,12,40
20,Success,50,37,2,11,39
20,Success,46,43,0,11,35
20,Success,49,41,0,7,42
20,Success,44,37,6,13,31
20,Success,49,33,5,13,36
20,Success,45,37,7,11,34
20,Success,48,32,0,12,36
20,Success,58,27,0,10,48
20,Success,44,34,0,18,26
20,Success,47,35,0,18,29
20,Success,45,44,3,8,37
20,Success,47,36,5,12,35
20,Success,47,38,0,9,38
20,Success,48,34,0,18,30
20,Success,52,32,0,12,40
20,Success,42,33,9,16,26
20,Success,48,38,0,13,35
20,Success,40,43,2,15,25
20,Success,48,41,0,10,38
20,Success,50,38,0,11,39
20,Success,51,33,0,12,39
20,Success,44,40,0,16,28
20,Success,46,32,11,11,35
20,Success,46,29,0,13,33
20,Success,41,41,6,12,29
20,Success,48,35,4,13,35
20,Success,48,31,7,14,34
20,Success,44,43,0,10,34
20,Success,47,32,7,14,33
20,Success,54,30,7,9,45
20,Success,53,32,4,11,42
20,Success,46,37,1,16,30
20,Success,46,39,4,11,35
20,Success,50,33,0,16,34
20,Success,46,38,4,12,34
20,Success,60,31,1,8,52
20,Success,52,35,0,9,43
20,Success,44,34,5,17,27
20,Success,43,38,5,14,29
20,Success,42,47,0,11,31
20,Success,51,37,3,9,42
20,Success,55,34,0,10,45
20,Success,47,32,0,19,28
20,Success,48,39,1,12,36
20,Success,50,39,0,11,39
20,Success,47,39,4,10,37
20,Success,46,36,2,16,30
20,Success,46,38,0,13,33
20,Success,41,42,0,11,30
20,Success,47,34,3,16,31
20,Success,53,31,5,11,42
20,Success,50,36,1,13,37
20,Success,51,30,0,18,33
20,Success,46,42,0,8,38
20,Success,58,31,0,8,50
20,Success,48,34,0,16,32
20,Success,50,32,1,17,33
20,Success,38,46,0,11,27
20,Success,54,27,1,18,36
20,Success,43,36,7,14,29
20,Success,49,34,0,10,39
20,Success,50,38,1,11,39
20,Success,37,45,0,8,29
20,Success,56,33,2,9,47
20,Success,49,34,0,16,33
20,Success,45,34,0,18,27
20,Success,48,30,4,18,30
20,Success,44,38,1,17,27
20,Success,51,30,2,17,34
20,Success,48,38,0,14,34
20,Success,46,36,0,16,30
20,Success,50,26,0,13,37
20,Success,50,38,3,9,41
20,Success,45,35,10,10,35
20,Success,59,28,0,13,46
20,Success,54,35,1,10,44
20,Fail,38,42,0,20,18
20,Success,41,34,0,16,25
20,Fail,39,32,0,20,19
20,Success,54,26,0,17,37
20,Success,50,40,0,10,40
20,Success,47,36,4,13,34
20,Success,46,33,2,19,27
20,Success,53,37,0,10,43
20,Success,49,35,0,12,37
20,Success,44,40,0,10,34
20,Success,50,24,8,18,32
20,Success,52,31,0,12,40
20,Success,50,28,0,15,35
20,Success,50,40,1,9,41
20,Success,53,27,0,19,34
20,Success,58,33,2,7,51
20,Success,48,40,0,8,40
20,Success,45,37,0,12,33
20,Success,47,32,0,15,32
20,Success,48,45,0,5,43
20,Success,39,43,2,16,23
20,Success,46,40,7,7,39
20,Success,51,33,2,14,37
20,Success,49,33,0,13,36
20,Success,44,35,12,9,35
20,Success,48,39,0,10,38
20,Success,37,49,8,6,31
20,Success,46,33,0,20,26
20,Success,48,31,3,18,30
20,Success,53,31,0,16,37
20,Success,51,33,0,10,41
20,Success,43,37,3,17,26
20,Success,54,35,0,8,46
20,Success,44,36,0,16,28
20,Success,47,30,1,22,25
20,Success,39,44,0,14,25
20,Success,49,42,3,6,43
20,Success,50,35,6,9,41
20,Success,50,32,10,8,42
20,Success,55,35,2,8,47
20,Success,50,33,0,11,39
20,Success,48,40,0,6,42
20,Success,47,39,0,10,37
20,Success,41,38,0,15,26
20,Success,53,34,4,9,44
20,Success,43,38,0,17,26
20,Success,50,33,0,14,36
20,Success,48,36,0,11,37
20,Success,48,39,0,13,35
20,Success,54,31,5,10,44
20,Success,57,30,6,7,50
20,Success,45,41,0,14,31
20,Success,44,28,0,20,24
20,Success,55,30,0,12,43
20,Success,45,38,4,13,32
20,Fail,36,42,0,17,19
20,Success,48,34,9,9,39
20,Success,42,45,0,12,30
20,Success,46,35,1,18,28
20,Success,53,34,2,11,42
20,Success,48,39,0,12,36
20,Success,48,40,0,10,38
20,Success,51,39,0,5,46
20,Success,49,28,7,16,33
20,Success,49,37,1,13,36
20,Success,53,34,2,11,42
20,Success,41,37,9,13,28
20,Success,43,41,0,15,28
20,Success,39,40,0,16,23
20,Success,48,35,0,14,34
20,Success,37,35,0,13,24
20,Success,48,32,0,11,37
20,Success,44,38,0,16,28
20,Success,49,38,0,13,36
20,Success,42,42,3,13,29
20,Success,53,35,0,12,41
30,Success,46,34,0,15,31
30,Success,53,38,0,8,45
30,Success,47,42,0,10,37
30,Success,45,40,3,12,33
30,Success,52,37,0,11,41
30,Success,55,35,1,9,46
30,Fail,42,38,0,13,29
30,Success,40,45,7,8,32
30,Success,54,30,0,15,39
30,Success,48,42,0,8,40
30,Success,47,35,0,14,33
30,Success,46,36,4,14,32
30,Success,51,35,0,12,39
30,Success,57,28,10,5,52
30,Success,46,34,0,15,31
30,Success,50,35,5,10,40
30,Success,49,36,0,15,34
30,Success,49,38,2,11,38
30,Success,48,37,5,10,38
30,Success,50,37,0,13,37
30,Fail,48,27,0,20,28
30,Success,49,32,5,14,35
30,Success,48,33,0,18,30
30,Success,50,34,2,14,36
30,Success,47,35,5,13,34
30,Fail,39,33,0,17,22
30,Success,46,44,2,8,38
30,Success,51,38,0,8,43
30,Success,47,38,8,7,40
30,Success,47,40,0,13,34
30,Success,52,33,4,11,41
30,Success,46,33,5,16,30
30,Success,50,32,0,14,36
30,Success,50,34,4,12,38
30,Success,42,44,2,12,30
30,Success,48,33,0,14,34
30,Success,45,36,9,10,35
30,Fail,47,25,6,22,25
30,Success,51,36,0,12,39
30,Success,51,30,2,17,34
30,Success,45,36,0,13,32
30,Success,44,41,0,9,35
30,Success,49,38,1,12,37
30,Fail,38,37,5,20,18
30,Fail,41,33,0,16,25
30,Success,52,36,0,11,41
30,Success,48,35,3,14,34
30,Success,49,37,2,12,37
30,Success,61,23,0,12,49
30,Success,50,29,0,17,33
30,Success,58,31,2,9,49
30,Success,48,38,0,10,38
30,Fail,38,41,5,16,22
30,Success,51,35,3,11,40
30,Success,49,35,2,14,35
30,Success,47,41,0,12,35
30,Success,48,38,2,12,36
30,Success,46,34,6,14,32
30,Success,49,30,7,14,35
30,Fail,44,29,7,20,24
30,Success,50,37,2,11,39
30,Success,55,32,0,8,47
30,Success,46,37,0,13,33
30,Success,52,33,2,13,39
30,Success,47,38,1,14,33
30,Success,46,37,0,14,32
30,Success,49,29,0,8,41
30,Fail,36,41,0,15,21
30,Success,48,37,6,9,39
30,Success,53,28,0,13,40
30,Fail,40,39,0,21,19
30,Success,54,24,0,12,42
30,Success,44,35,10,11,33
30,Success,46,34,8,12,34
30,Success,50,34,3,13,37
30,Success,52,38,0,9,43
30,Success,44,42,7,7,37
30,Success,54,33,7,6,48
30,Success,45,33,7,15,30
30,Success,54,29,9,8,46
30,Success,50,34,0,14,36
30,Success,47,34,8,11,36
30,Success,55,32,5,8,47
30,Success,50,32,0,15,35
30,Fail,40,41,2,17,23
30,Success,47,41,0,10,37
30,Success,48,40,0,10,38
30,Success,51,35,3,11,40
30,Success,59,27,2,12,47
30,Success,45,35,0,14,31
30,Success,51,33,0,9,42
30,Success,44,28,14,14,30
30,Fail,42,32,0,16,26
30,Success,46,35,4,15,31
30,Success,48,30,0,17,31
30,Success,45,42,2,11,34
30,Success,52,31,4,13,39
30,Fail,46,34,2,18,28
30,Success,51,28,8,13,38
30,Fail,43,39,1,17,26
30,Success,52,36,1,11,41
30,Fail,41,39,0,16,25
30,Success,47,42,3,8,39
30,Fail,37,38,9,16,21
30,Success,47,42,0,11,36
30,Fail,44,35,4,17,27
30,Success,48,35,0,14,34
30,Success,47,37,0,16,31
30,Success,46,38,3,13,33
30,Success,49,36,0,13,36
30,Success,49,36,0,12,37
30,Fail,43,32,11,14,29
30,Success,47,37,6,10,37
30,Success,52,38,0,9,43
30,Success,51,36,0,8,43
30,Success,53,35,0,11,42
30,Success,51,32,0,16,35
30,Success,50,25,7,18,32
30,Success,49,34,0,17,32
30,Success,47,34,0,14,33
30,Success,48,28,0,15,33
30,Success,41,43,0,11,30
30,Success,47,42,0,11,36
30,Success,53,33,0,7,46
30,Success,55,26,0,14,41
30,Success,50,32,3,15,35
30,Success,55,29,3,13,42
30,Success,50,38,1,11,39
30,Success,52,29,0,11,41
30,Success,48,33,0,12,36
30,Success,49,31,5,15,34
30,Fail,41,41,3,15,26
30,Success,57,31,4,8,49
30,Success,49,39,2,10,39
30,Success,48,31,0,18,30
30,Success,53,34,4,9,44
30,Fail,47,35,0,18,29
30,Success,51,31,10,8,43
30,Success,48,37,5,10,38
30,Success,46,40,0,14,32
30,Success,46,40,0,13,33
30,Success,50,35,0,13,37
30,Success,55,26,0,10,45
30,Success,45,41,0,14,31
30,Success,50,34,7,9,41
30,Success,45,37,3,15,30
30,Success,47,26,12,15,32
30,Success,48,33,0,13,35
30,Success,47,30,0,13,34
30,Success,56,32,0,11,45
30,Success,56,31,0,10,46
30,Success,49,30,0,13,36
30,Success,51,36,0,12,39
30,Success,50,40,1,9,41
30,Success,49,39,0,10,39
30,Success,46,38,0,14,32
30,Success,49,29,4,18,31
30,Success,42,37,0,9,33
30,Fail,46,35,0,18,28
30,Success,52,39,0,7,45
30,Success,50,40,0,10,40
30,Fail,41,45,0,12,29
30,Success,48,40,0,12,36
30,Success,54,36,0,7,47
30,Fail,41,33,0,18,23
30,Success,47,36,0,17,30
30,Success,52,37,0,11,41
30,Success,53,36,0,10,43
30,Success,54,26,0,16,38
30,Success,50,32,2,16,34
30,Success,50,42,1,7,43
30,Success,49,34,0,15,34
30,Success,56,29,4,11,45
30,Success,46,37,4,13,33
30,Success,51,33,0,12,39
30,Fail,45,30,0,17,28
30,Success,52,32,0,14,38
30,Success,44,34,10,12,32
30,Success,41,44,0,10,31
30,Success,44,38,0,12,32
30,Success,41,41,0,11,30
30,Success,52,29,0,11,41
30,Fail,45,32,0,16,29
30,Success,45,39,7,9,36
30,Success,48,39,0,11,37
30,Success,44,39,4,13,31
30,Success,44,43,4,9,35
30,Fail,42,39,0,18,24
30,Success,49,42,2,7,42
30,Success,57,30,0,6,51
30,Success,51,35,5,9,42
30,Success,52,26,0,16,36
30,Success,51,27,7,15,36
30,Success,53,34,2,11,42
30,Success,53,32,4,11,42
30,Success,49,38,4,9,40
30,Success,47,34,4,15,32
30,Success,50,31,8,11,39
30,Fail,43,37,3,17,26
30,Success,42,37,10,11,31
30,Fail,43,36,0,20,23
30,Success,53,40,0,7,46
30,Fail,42,36,2,20,22
30,Fail,40,37,8,15,25
30,Success,52,32,6,10,42
30,Success,45,38,0,14,31
30,Fail,34,33,13,20,14
30,Success,49,33,0,15,34
30,Success,55,28,0,13,42
30,Success,51,32,7,10,41
30,Success,51,40,0,9,42
30,Success,48,37,0,14,34
30,Fail,46,33,4,17,29
30,Success,53,33,3,11,42
30,Success,45,39,4,12,33
30,Success,44,38,4,14,30
30,Fail,41,32,0,17,24
30,Fail,47,34,0,19,28
30,Success,45,44,0,7,38
30,Success,53,32,0,14,39
30,Success,48,35,0,13,35
30,Success,52,35,0,12,40
30,Success,51,38,0,10,41
30,Success,52,35,1,12,40
30,Success,55,41,0,4,51
30,Success,50,31,0,15,35
30,Success,45,40,1,14,31
30,Success,47,37,5,11,36
30,Success,48,35,0,12,36
30,Success,51,35,4,10,41
30,Success,51,35,5,9,42
30,Success,48,37,0,13,35
30,Success,51,34,3,12,39
30,Success,50,36,5,9,41
30,Success,52,35,1,12,40
30,Fail,35,39,0,20,15
30,Fail,47,27,0,21,26
30,Success,51,39,0,9,42
30,Success,51,36,0,6,45
30,Success,54,38,0,7,47
30,Success,46,39,2,13,33
30,Success,52,39,0,9,43
30,Success,48,36,6,10,38
30,Success,44,39,6,11,33
30,Success,46,29,0,13,33
30,Success,49,37,2,12,37
30,Success,49,39,1,11,38
30,Success,47,44,0,8,39
30,Success,48,32,0,15,33
30,Success,50,37,0,10,40
30,Success,46,34,0,15,31
30,Success,54,34,0,10,44
30,Success,53,36,2,9,44
30,Success,49,40,0,11,38
30,Success,45,37,5,13,32
30,Success,53,30,1,16,37
30,Success,46,37,0,13,33
30,Success,51,33,0,14,37
30,Success,50,32,0,11,39
30,Fail,43,35,5,17,26
30,Success,54,29,0,16,38
30,Success,45,37,6,12,33
30,Success,45,33,0,14,31
30,Fail,41,44,0,15,26
30,Success,50,38,3,9,41
30,Success,53,33,1,13,40
30,Success,49,40,5,6,43
30,Fail,41,40,0,16,25
30,Success,50,29,9,12,38
30,Fail,43,36,3,18,25
30,Fail,40,46,3,11,29
30,Success,51,28,2,19,32
30,Success,52,31,0,16,36
30,Success,51,35,5,9,42
30,Success,46,32,8,14,32
30,Success,54,32,0,12,42
30,Success,48,33,0,16,32
30,Success,46,36,6,12,34
30,Success,65,27,0,7,58
30,Success,46,36,0,12,34
30,Fail,42,33,9,16,26
30,Success,51,42,1,6,45
30,Success,47,39,6,8,39
30,Success,44,41,2,13,31
30,Fail,38,41,7,14,24
30,Success,50,37,0,8,42
30,Success,42,35,11,12,30
30,Success,45,44,0,11,34
30,Success,54,33,1,12,42
30,Success,43,40,6,11,32
30,Success,48,37,4,11,37
30,Success,53,36,0,8,45
30,Success,46,45,1,8,38
30,Success,48,34,0,11,37
30,Fail,41,41,0,15,26
30,Success,50,34,0,12,38
30,Success,46,33,0,16,30
30,Fail,39,33,12,16,23
30,Fail,41,43,0,14,27
30,Success,48,39,0,12,36
30,Success,48,40,0,8,40
30,Success,43,50,0,7,36
30,Success,42,46,0,12,30
30,Success,46,38,0,15,31
30,Success,51,36,6,7,44
30,Success,52,35,4,9,43
30,Success,49,39,0,10,39
30,Success,44,39,0,12,32
30,Success,52,35,0,11,41
30,Fail,38,40,0,14,24
30,Success,53,28,0,12,41
30,Success,56,32,2,10,46
30,Success,48,29,0,11,37
30,Fail,43,41,1,15,28
30,Success,49,33,5,13,36
30,Success,49,31,7,13,36
30,Success,47,41,0,8,39
30,Success,47,38,2,13,34
30,Success,49,37,0,13,36
30,Fail,46,37,0,17,29
30,Success,51,38,0,10,41
30,Success,49,38,0,11,38
30,Success,39,43,9,9,30
30,Success,47,37,6,10,37
30,Fail,45,26,8,21,24
30,Success,49,34,4,13,36
30,Success,54,37,0,9,45
30,Success,48,33,1,18,30
30,Success,43,38,0,10,33
30,Success,59,35,0,6,53
30,Success,46,41,0,9,37
30,Success,46,35,4,15,31
30,Success,47,36,3,14,33
30,Success,45,41,2,12,33
30,Success,50,37,3,10,40
30,Success,50,33,0,15,35
30,Success,53,26,0,9,44
30,Fail,43,30,0,18,25
30,Success,43,44,2,11,32
30,Fail,45,35,0,17,28
30,Fail,40,36,10,14,26
30,Success,52,32,0,9,43
30,Success,45,40,5,10,35
30,Success,49,37,3,11,38
30,Success,53,33,0,12,41
30,Fail,45,28,0,19,26
30,Success,49,39,0,11,38
30,Fail,46,36,0,17,29
30,Success,45,40,5,10,35
30,Success,53,28,0,12,41
30,Success,42,49,0,7,35
30,Success,50,33,3,14,36
30,Success,48,34,1,17,31
30,Fail,46,32,4,18,28
30,Fail,38,42,0,14,24
30,Success,46,35,0,11,35
30,Success,50,36,1,13,37
30,Success,61,32,1,6,55
30,Success,47,36,0,17,30
30,Success,54,33,0,11,43
30,Success,45,35,7,13,32
30,Success,46,38,3,13,33
30,Success,61,31,3,5,56
30,Success,48,38,2,12,36
30,Success,42,43,0,9,33
30,Success,51,38,4,7,44
30,Success,51,34,0,11,40
30,Success,47,38,3,12,35
30,Success,46,37,0,15,31
30,Success,46,36,3,15,31
30,Success,56,35,0,7,49
30,Fail,43,35,7,15,28
30,Fail,42,38,0,16,26
30,Fail,43,40,3,14,29
30,Success,52,34,0,10,42
30,Success,51,28,0,13,38
30,Fail,41,39,7,13,28
30,Success,56,28,3,13,43
30,Success,50,29,0,12,38
30,Success,48,37,4,11,37
30,Fail,41,37,0,16,25
30,Success,55,38,1,6,49
30,Success,56,36,0,8,48
30,Fail,42,40,0,14,28
30,Success,53,33,1,13,40
30,Success,46,40,4,10,36
30,Success,49,34,4,13,36
30,Success,47,35,0,9,38
30,Success,50,33,0,15,35
30,Success,53,31,0,11,42
30,Success,47,33,0,13,34
30,Success,53,39,0,6,47
30,Fail,41,35,0,16,25
30,Success,44,37,0,8,36
30,Success,44,33,10,13,31
30,Success,52,35,0,12,40
30,Success,46,37,0,12,34
30,Success,45,38,0,12,33
30,Fail,41,40,5,14,27
30,Success,40,44,0,8,32
30,Success,46,38,4,12,34
30,Success,45,35,10,10,35
30,Fail,44,33,7,16,28
30,Success,47,38,8,7,40
30,Success,45,33,8,14,31
30,Success,49,36,3,12,37
30,Fail,42,34,0,18,24
30,Fail,43,34,0,16,27
30,Success,53,31,2,14,39
30,Success,51,38,0,9,42
30,Success,51,35,0,13,38
30,Fail,44,39,0,16,28
30,Success,54,27,7,12,42
30,Success,48,34,0,15,33
30,Success,48,37,0,12,36
30,Success,44,32,10,14,30
30,Success,47,39,1,13,34
30,Success,46,32,0,10,36
30,Success,51,36,5,8,43
30,Success,49,37,4,10,39
30,Success,49,39,0,12,37
30,Success,50,36,2,12,38
30,Success,47,37,1,15,32
30,Fail,40,42,0,12,28
30,Fail,45,27,0,19,26
30,Success,47,38,4,11,36
30,Success,48,40,0,11,37
30,Success,58,34,1,7,51
30,Success,50,34,5,11,39
30,Success,49,43,0,7,42
30,Fail,46,32,3,19,27
30,Success,54,33,0,8,46
30,Success,54,34,0,11,43
30,Fail,40,37,8,15,25
30,Success,45,41,1,13,32
30,Success,44,39,0,12,32
30,Success,50,34,1,15,35
30,Success,48,33,3,16,32
30,Success,54,21,0,23,31
30,Success,46,39,0,12,34
30,Success,50,33,1,16,34
30,Success,51,35,2,12,39
30,Fail,39,39,4,18,21
30,Success,53,35,0,12,41
30,Success,48,37,6,9,39
30,Success,52,33,3,12,40
30,Fail,44,31,6,19,25
30,Success,53,30,0,11,42
30,Success,48,39,2,11,37
30,Success,51,34,3,12,39
30,Success,48,34,7,11,37
30,Success,45,40,3,12,33
30,Success,54,34,1,11,43
30,Success,46,39,2,13,33
30,Success,49,34,0,13,36
30,Success,46,35,6,13,33
30,Success,51,35,0,11,40
30,Success,49,31,6,14,35
30,Success,54,37,1,8,46
30,Fail,44,33,0,16,28
30,Success,53,34,3,10,43
30,Success,49,34,0,11,38
30,Success,47,40,1,12,35
30,Success,43,43,5,9,34
30,Success,54,24,0,17,37
30,Success,46,33,0,9,37
30,Fail,40,38,4,18,22
30,Fail,42,37,8,13,29
30,Success,54,34,2,10,44
30,Success,52,28,0,16,36
30,Success,55,28,3,14,41
30,Success,55,29,8,8,47
30,Success,53,30,0,11,42
30,Success,45,35,0,15,30
30,Success,44,34,13,9,35
30,Fail,43,37,4,16,27
30,Success,50,35,6,9,41
30,Success,51,38,4,7,44
30,Success,52,35,0,12,40
30,Success,55,34,1,10,45
30,Fail,46,32,0,17,29
30,Success,44,42,4,10,34
30,Success,47,38,2,13,34
30,Fail,41,39,6,14,27
30,Fail,46,34,2,18,28
30,Success,53,37,0,9,44
30,Success,56,28,5,11,45
30,Success,54,32,0,14,40
30,Success,61,26,0,11,50
30,Success,49,38,1,12,37
30,Success,53,34,1,12,41
30,Success,55,28,0,12,43
30,Success,48,34,3,15,33
30,Success,46,36,0,14,32
30,Success,51,37,0,11,40
30,Success,52,30,1,17,35
30,Fail,41,35,0,14,27
30,Success,46,38,4,12,34
30,Success,48,36,7,9,39
30,Success,49,36,0,15,34
30,Success,50,32,0,16,34
30,Fail,38,36,0,15,23
30,Success,54,35,0,9,45
30,Success,45,39,0,11,34
30,Success,51,42,1,6,45
30,Success,45,33,11,11,34
30,Success,54,32,0,9,45
30,Success,44,43,1,12,32
30,Success,50,35,4,11,39
30,Fail,45,36,3,16,29
30,Success,48,41,0,11,37
30,Fail,45,31,6,18,27
30,Success,49,31,9,11,38
30,Success,48,35,6,11,37
30,Success,50,37,1,12,38
30,Success,52,32,5,11,41
30,Success,53,22,6,19,34
30,Success,48,34,5,13,35
30,Success,42,40,6,12,30
30,Success,52,32,5,11,41
30,Success,59,28,1,12,47
30,Fail,41,35,0,17,24
30,Success,49,40,0,10,39
30,Success,50,40,0,7,43
30,Fail,43,40,0,16,27
30,Fail,42,37,0,16,26
30,Success,46,34,0,14,32
30,Success,50,40,0,10,40
30,Success,43,43,1,13,30
30,Success,49,36,0,13,36
30,Success,52,34,0,11,41
30,Success,53,32,3,12,41
30,Success,48,36,2,14,34
30,Success,50,27,12,11,39
30,Success,50,35,0,12,38
30,Success,42,42,6,10,32
30,Success,45,40,4,11,34
30,Success,53,35,4,8,45
30,Success,46,38,3,13,33
30,Fail,46,34,3,17,29
30,Success,51,32,1,16,35
30,Success,49,39,0,8,41
30,Success,50,31,3,16,34
30,Success,50,37,0,8,42
30,Success,49,40,3,8,41
30,Success,60,34,0,6,54
30,Success,45,45,0,9,36
30,Success,51,28,0,13,38
30,Success,44,35,12,9,35
30,Success,49,40,2,9,40
30,Success,52,28,0,15,37
30,Success,47,39,0,9,38
30,Success,42,40,0,12,30
30,Fail,42,31,0,13,29
30,Success,48,36,4,12,36
30,Fail,43,33,7,17,26
30,Success,48,32,0,15,33
30,Success,49,36,0,15,34
30,Fail,48,31,0,19,29
30,Fail,46,33,4,17,29
30,Success,49,37,1,13,36
30,Fail,40,31,11,18,22
30,Fail,47,30,0,20,27
30,Fail,41,39,6,14,27
30,Success,53,30,1,16,37
30,Success,48,32,5,15,33
30,Success,49,39,0,11,38
30,Success,53,38,1,8,45
30,Success,54,39,0,7,47
30,Fail,39,39,12,10,29
30,Success,47,36,4,13,34
30,Success,55,31,0,11,44
30,Fail,42,41,3,14,28
30,Success,44,34,11,11,33
30,Success,53,30,7,10,43
30,Fail,44,37,3,16,28
30,Success,61,26,2,11,50
30,Success,46,31,0,14,32
30,Success,49,36,0,9,40
30,Success,56,29,0,11,45
30,Success,49,37,7,7,42
30,Success,44,37,6,13,31
30,Success,47,37,1,15,32
30,Success,50,37,0,11,39
30,Success,55,30,6,9,46
30,Success,51,39,0,9,42
30,Success,43,47,0,10,33
30,Success,46,33,9,12,34
30,Success,46,36,0,11,35
30,Fail,39,47,0,10,29
30,Success,51,29,0,13,38
30,Success,46,34,6,14,32
30,Success,46,37,0,13,33
30,Success,51,38,0,11,40
30,Success,50,27,6,17,33
30,Success,54,36,0,8,46
30,Success,50,31,12,7,43
30,Success,52,34,0,14,38
30,Success,47,37,0,15,32
30,Fail,42,39,1,18,24
30,Fail,44,38,1,17,27
30,Success,51,38,2,9,42
30,Success,56,33,3,8,48
30,Success,51,37,0,9,42
30,Success,44,42,2,12,32
30,Success,45,38,6,11,34
30,Success,42,44,0,12,30
30,Success,47,39,0,10,37
30,Success,48,37,0,11,37
30,Success,47,38,0,14,33
30,Fail,42,44,0,14,28
30,Success,45,31,0,14,31
30,Success,55,32,1,12,43
30,Success,45,42,0,13,32
30,Success,51,35,0,9,42
30,Fail,43,31,8,18,25
30,Fail,40,38,2,20,20
30,Fail,40,40,0,14,26
30,Fail,44,34,0,19,25
30,Success,45,37,7,11,34
30,Success,46,30,0,14,32
30,Success,54,39,0,6,48
30,Fail,46,36,1,17,29
30,Success,46,41,2,11,35
30,Success,46,38,1,15,31
30,Success,49,35,0,11,38
30,Success,47,35,0,10,37
30,Success,49,35,0,14,35
30,Success,51,31,0,15,36
30,Fail,39,38,0,14,25
30,Fail,43,33,3,21,22
30,Success,59,33,0,8,51
30,Success,42,36,0,11,31
30,Success,47,39,3,11,36
30,Success,45,42,0,11,34
30,Fail,38,40,9,13,25
30,Success,53,34,3,10,43
30,Success,43,36,8,13,30
30,Success,48,32,7,13,35
30,Success,53,31,3,13,40
30,Success,48,35,0,9,39
30,Success,55,34,0,10,45
30,Fail,45,34,0,17,28
30,Success,48,39,2,11,37
30,Success,60,28,0,12,48
30,Success,47,38,0,13,34
30,Success,51,26,7,16,35
30,Success,44,40,0,12,32
30,Success,50,39,0,10,40
30,Success,52,34,0,14,38
30,Success,45,43,0,11,34
30,Success,51,35,2,12,39
30,Success,41,37,0,11,30
30,Fail,38,44,0,14,24
30,Fail,48,29,3,20,28
30,Success,45,36,0,12,33
30,Success,52,39,0,7,45
30,Success,45,40,0,13,32
30,Success,49,36,7,8,41
30,Success,57,30,0,12,45
30,Success,52,29,0,17,35
30,Fail,44,35,3,18,26
30,Success,60,27,1,12,48
30,Success,50,36,1,13,37
30,Success,54,36,0,9,45
30,Success,50,34,0,11,39
30,Success,44,37,0,13,31
30,Success,50,32,5,13,37
30,Success,51,36,1,12,39
30,Success,48,35,4,13,35
30,Success,45,42,1,12,33
30,Success,49,33,4,14,35
30,Success,57,31,0,12,45
30,Success,41,37,11,11,30
30,Success,52,35,0,13,39
30,Success,52,34,0,10,42
30,Success,48,34,0,17,31
30,Success,51,35,2,12,39
30,Success,45,39,0,11,34
30,Success,47,33,5,15,32
30,Success,45,41,4,10,35
30,Success,53,29,3,15,38
30,Success,49,33,6,12,37
30,Success,43,44,1,12,31
30,Success,51,35,0,14,37
30,Fail,43,30,6,21,22
30,Fail,43,39,2,16,27
30,Success,47,40,0,12,35
30,Success,49,32,0,18,31
30,Success,46,39,0,11,35
30,Success,50,39,0,10,40
30,Success,48,44,0,8,40
30,Success,51,39,1,9,42
30,Success,52,32,2,14,38
30,Success,50,31,0,14,36
30,Success,46,42,0,10,36
30,Fail,42,34,9,15,27
30,Fail,46,33,0,17,29
30,Fail,40,43,2,15,25
30,Success,48,35,0,15,33
30,Success,51,36,0,12,39
30,Success,52,33,0,15,37
30,Success,49,31,0,11,38
30,Success,45,39,3,13,32
30,Success,52,40,0,4,48
30,Success,52,33,0,10,42
30,Success,47,35,7,11,36
30,Success,45,40,0,15,30
30,Success,47,39,2,12,35
30,Fail,41,36,0,12,29
30,Success,47,33,10,10,37
30,Success,46,41,0,10,36
30,Success,51,35,0,10,41
30,Success,49,35,2,14,35
30,Success,47,37,6,10,37
30,Success,50,33,0,15,35
30,Fail,48,31,0,21,27
30,Fail,43,33,9,15,28
30,Success,49,36,0,13,36
30,Success,53,29,7,11,42
30,Success,55,30,0,12,43
30,Success,46,41,2,11,35
30,Success,50,37,1,12,38
30,Success,53,30,6,11,42
30,Fail,46,31,0,18,28
30,Success,54,29,2,15,39
30,Success,45,37,4,14,31
30,Success,52,38,0,10,42
30,Success,56,32,2,10,46
30,Success,48,37,0,11,37
30,Success,47,40,0,12,35
30,Success,51,37,3,9,42
30,Fail,45,35,4,16,29
30,Fail,44,31,10,15,29
30,Success,51,33,1,15,36
30,Success,45,36,0,12,33
30,Success,45,39,3,13,32
30,Fail,45,35,0,16,29
30,Success,58,34,1,7,51
30,Success,53,33,0,10,43
30,Success,50,30,0,17,33
30,Success,45,37,5,13,32
30,Success,55,32,0,12,43
30,Success,54,32,0,14,40
30,Success,49,40,0,11,38
30,Fail,44,37,2,17,27
30,Success,49,42,1,8,41
30,Success,48,38,6,8,40
30,Success,44,35,10,11,33
30,Success,45,38,0,13,32
30,Success,54,26,0,14,40
30,Success,58,32,2,8,50
30,Fail,41,33,0,13,28
30,Fail,43,38,4,15,28
30,Success,48,39,0,11,37
30,Fail,41,41,0,13,28
30,Success,50,41,1,8,42
30,Success,45,40,6,9,36
30,Fail,46,32,3,19,27
30,Success,49,38,0,10,39
30,Success,49,33,0,15,34
30,Success,53,32,0,10,43
30,Success,53,31,1,15,38
30,Success,50,39,0,11,39
30,Success,49,37,0,12,37
30,Fail,41,38,9,12,29
30,Success,51,35,2,12,39
30,Success,49,37,7,7,42
30,Success,44,42,4,10,34
30,Success,53,38,0,7,46
30,Success,55,35,1,9,46
30,Success,45,34,0,14,31
30,Success,47,35,0,15,32
30,Fail,44,30,10,16,28
30,Success,52,28,3,17,35
30,Success,48,37,0,10,38
30,Fail,45,38,1,16,29
30,Success,45,34,0,15,30
30,Success,56,22,0,16,40
30,Success,45,41,3,11,34
30,Success,47,41,0,9,38
30,Success,49,38,0,10,39
30,Success,51,37,0,11,40
30,Fail,43,41,0,14,29
30,Success,54,34,2,10,44
30,Success,53,39,1,7,46
30,Success,49,36,5,10,39
30,Success,50,30,3,17,33
30,Fail,48,32,0,20,28
30,Success,52,41,0,6,46
30,Success,49,37,4,10,39
30,Success,45,41,0,12,33
30,Success,47,38,0,15,32
30,Success,47,42,0,11,36
30,Success,53,28,0,11,42
30,Success,49,36,1,14,35
30,Success,49,34,4,13,36
30,Success,45,38,2,15,30
30,Success,53,36,0,10,43
30,Fail,42,36,1,21,21
30,Fail,45,37,2,16,29
30,Success,51,33,4,12,39
30,Success,55,37,0,5,50
30,Success,57,32,0,8,49
30,Success,52,27,10,11,41
30,Success,51,34,2,13,38
30,Success,47,42,0,8,39
30,Success,50,37,0,9,41
30,Success,52,35,0,13,39
30,Fail,40,40,5,15,25
30,Success,44,38,0,12,32
30,Success,46,32,6,16,30
30,Fail,38,43,0,15,23
30,Success,53,35,0,12,41
30,Success,45,29,0,14,31
30,Success,51,33,6,10,41
30,Success,53,36,0,10,43
30,Success,44,37,7,12,32
30,Success,46,35,7,12,34
30,Success,46,31,0,12,34
30,Fail,44,37,0,18,26
30,Success,47,34,3,16,31
30,Success,48,33,10,9,39
30,Success,52,35,0,9,43
30,Success,45,39,0,15,30
30,Fail,43,36,0,15,28
30,Success,48,39,5,8,40
30,Success,46,31,8,15,31
30,Success,45,39,0,12,33
30,Success,50,37,0,13,37
30,Success,51,30,3,16,35
30,Success,49,34,8,9,40
30,Success,49,35,0,14,35
30,Success,52,33,5,10,42
30,Fail,42,36,0,13,29
30,Success,45,40,3,12,33
30,Success,55,28,0,15,40
30,Success,50,38,0,9,41
30,Success,47,37,0,12,35
30,Success,58,36,0,6,52
30,Success,49,35,2,14,35
30,Success,52,31,0,14,38
30,Success,42,42,5,11,31
30,Success,52,29,1,18,34
30,Success,47,39,0,9,38
30,Success,49,34,9,8,41
30,Success,43,32,15,10,33
30,Fail,40,36,0,14,26
30,Success,48,35,0,12,36
30,Success,44,40,0,10,34
30,Success,53,35,2,10,43
30,Success,41,45,0,10,31
30,Success,57,32,0,9,48
30,Success,52,34,0,11,41
30,Success,50,34,7,9,41
30,Success,46,41,0,12,34
30,Success,49,41,1,9,40
30,Success,50,36,4,10,40
30,Success,53,32,0,15,38
30,Success,47,37,3,13,34
30,Success,46,42,0,9,37
30,Success,44,44,2,10,34
30,Fail,41,34,0,19,22
30,Success,59,30,0,7,52
30,Success,46,31,0,15,31
30,Success,51,31,6,12,39
30,Success,49,37,2,12,37
30,Fail,40,44,3,13,27
30,Fail,41,38,0,15,26
30,Fail,34,41,0,18,16
30,Success,50,30,8,12,38
30,Success,54,33,0,10,44
30,Success,49,38,2,11,38
30,Success,53,32,5,10,43
30,Success,40,41,10,9,31
30,Success,51,38,5,6,45
30,Fail,42,39,0,14,28
30,Success,51,42,0,7,44
30,Fail,43,37,2,18,25
30,Success,52,26,0,15,37
30,Fail,37,40,7,16,21
30,Success,58,33,1,8,50
30,Fail,41,41,0,12,29
30,Success,49,33,0,14,35
30,Success,46,36,0,9,37
30,Fail,42,35,0,18,24
30,Success,45,35,7,13,32
30,Success,50,34,0,13,37
30,Success,44,39,7,10,34
30,Success,48,35,3,14,34
30,Success,48,33,4,15,33
30,Success,47,32,0,14,33
30,Success,48,37,1,14,34
30,Success,45,35,7,13,32
30,Fail,41,39,0,19,22
30,Fail,38,39,2,21,17
30,Success,53,34,0,10,43
30,Success,42,45,0,12,30
30,Success,49,38,0,10,39
30,Success,43,37,12,8,35
30,Success,52,34,0,10,42
30,Success,43,40,4,13,30
30,Success,54,38,0,7,47
30,Success,47,40,0,12,35
30,Success,53,37,0,10,43
30,Success,52,32,3,13,39
30,Success,47,38,3,12,35
30,Success,44,43,0,10,34
30,Fail,45,35,3,17,28
30,Success,43,38,0,11,32
30,Success,47,40,1,12,35
30,Success,51,35,4,10,41
30,Success,56,28,0,11,45
30,Success,49,37,2,12,37
30,Success,49,36,2,13,36
30,Success,53,35,0,11,42
30,Success,55,32,0,11,44
30,Success,47,35,0,15,32
30,Success,48,32,6,14,34
30,Success,49,34,0,12,37
30,Success,53,34,0,11,42
30,Success,45,42,1,12,33
30,Success,49,40,0,10,39
30,Success,46,36,6,12,34
30,Success,50,37,0,12,38
30,Fail,43,37,2,18,25
30,Success,45,38,7,10,35
30,Success,53,35,0,12,41
30,Success,43,35,0,13,30
30,Fail,44,36,3,17,27
30,Fail,39,38,0,15,24
30,Fail,42,37,7,14,28
30,Success,48,36,0,10,38
30,Success,52,33,0,10,42
30,Success,40,41,9,10,30
30,Success,48,36,2,14,34
30,Success,54,34,0,10,44
30,Success,44,38,5,13,31
30,Success,50,38,0,11,39
30,Success,48,33,0,11,37
30,Success,49,33,0,9,40
30,Success,43,46,0,11,32
30,Success,45,36,0,14,31
30,Success,53,33,2,12,41
30,Success,46,29,0,16,30
30,Success,52,40,0,7,45
30,Success,48,25,0,17,31
30,Success,47,39,0,11,36
30,Fail,41,43,0,12,29
30,Success,51,34,8,7,44
30,Success,50,37,0,11,39
30,Fail,41,39,0,17,24
30,Fail,45,33,4,18,27
30,Success,52,41,0,6,46
30,Success,45,45,0,8,37
30,Success,53,34,1,12,41
30,Success,46,42,0,12,34
30,Success,48,33,0,13,35
30,Success,52,30,8,10,42
30,Success,49,35,1,15,34
30,Success,49,42,0,9,40
30,Success,48,39,0,12,36
30,Fail,45,34,0,16,29
30,Success,52,31,0,11,41
30,Success,49,37,4,10,39
30,Fail,40,41,0,13,27
30,Success,50,39,0,11,39
30,Success,50,37,0,13,37
30,Fail,40,40,3,17,23
30,Success,46,35,0,14,32
30,Success,54,30,0,15,39
30,Fail,44,35,1,20,24
30,Success,50,34,0,13,37
30,Success,45,41,0,13,32
30,Success,47,39,5,9,38
30,Success,47,33,5,15,32
30,Success,48,36,7,9,39
30,Success,43,39,0,13,30
30,Fail,42,38,0,16,26
30,Success,46,40,0,12,34
30,Success,49,36,3,12,37
30,Success,51,34,4,11,40
30,Success,50,26,4,20,30
30,Success,51,38,0,9,42
30,Fail,44,37,0,15,29
30,Success,50,34,0,15,35
30,Success,51,29,0,12,39
30,Success,48,38,0,7,41
30,Success,55,40,0,5,50
30,Success,50,30,7,13,37
30,Success,46,35,4,15,31
30,Success,52,33,4,11,41
30,Fail,43,29,0,18,25
30,Success,52,27,0,16,36
30,Success,45,45,0,5,40
30,Success,46,39,0,14,32
30,Success,52,31,6,11,41
30,Success,46,35,8,11,35
30,Success,47,38,0,11,36
30,Success,48,38,7,7,41
30,Fail,39,43,0,10,29
30,Success,45,40,3,12,33
30,Success,51,32,0,13,38
30,Success,47,37,0,16,31
30,Success,53,37,0,9,44
30,Success,50,29,0,15,35
30,Fail,46,29,0,18,28
30,Success,52,36,2,10,42
30,Success,47,42,5,6,41
30,Success,53,37,0,9,44
30,Success,47,40,0,12,35
30,Success,43,38,0,13,30
30,Success,55,31,0,13,42
30,Success,47,39,1,13,34
30,Fail,40,33,0,19,21
30,Success,57,30,2,11,46
30,Success,50,28,8,14,36
30,Success,54,31,0,11,43
30,Success,54,37,0,6,48
30,Success,52,40,0,8,44
30,Success,53,35,3,9,44
30,Success,47,35,7,11,36
30,Success,56,28,2,14,42
30,Success,48,33,0,15,33
30,Success,52,39,1,8,44
30,Success,53,31,2,14,39
30,Success,48,37,0,11,37
30,Success,47,36,0,12,35
30,Success,49,34,1,16,33
30,Fail,45,34,2,19,26
30,Success,53,31,4,12,41
30,Success,45,24,16,15,30
30,Success,50,34,0,14,36
30,Success,44,44,3,9,35
30,Success,45,41,0,11,34
30,Success,53,33,5,9,44
30,Fail,40,45,0,14,26
30,Success,48,30,0,17,31
30,Success,49,34,5,12,37
30,Success,56,31,0,9,47
30,Success,58,28,3,11,47
30,Success,44,39,4,13,31
30,Success,50,30,0,14,36
30,Success,48,38,1,13,35
30,Success,47,29,0,14,33
30,Success,55,29,0,16,39
30,Success,48,32,0,14,34
30,Success,56,33,2,9,47
30,Success,50,39,0,6,44
30,Success,50,35,0,15,35
30,Success,53,35,5,7,46
30,Success,46,40,2,12,34
30,Success,52,33,0,12,40
30,Success,53,32,1,14,39
30,Fail,43,37,0,14,29
30,Fail,42,37,8,13,29
30,Fail,41,43,0,12,29
30,Success,48,33,9,10,38
30,Success,48,37,0,13,35
30,Success,44,41,0,10,34
30,Success,48,38,0,12,36
30,Success,48,39,2,11,37
30,Success,49,37,6,8,41
30,Success,49,38,4,9,40
30,Success,57,27,4,12,45
30,Success,53,29,0,10,43
30,Success,51,34,0,15,36
30,Success,46,40,0,9,37
30,Success,50,37,8,5,45
30,Success,48,37,0,10,38
30,Success,52,33,6,9,43
30,Success,53,32,1,14,39
30,Success,57,29,5,9,48
30,Success,51,37,3,9,42
30,Success,50,38,0,8,42
30,Fail,39,36,6,19,20
30,Fail,41,35,3,21,20
30,Fail,43,34,0,14,29
30,Success,52,33,2,13,39
30,Fail,44,34,6,16,28
30,Success,44,30,12,14,30
30,Success,43,46,0,6,37
30,Success,54,33,0,12,42
30,Success,46,34,0,14,32
30,Success,44,38,5,13,31
30,Success,54,36,0,10,44
30,Success,50,34,4,12,38
30,Success,50,32,0,15,35
30,Success,59,27,4,10,49
30,Success,44,45,0,6,38
30,Success,50,40,1,9,41
30,Success,53,38,0,8,45
30,Fail,40,44,0,11,29
30,Fail,46,35,2,17,29
30,Fail,43,38,3,16,27
30,Success,58,32,0,8,50
30,Success,49,39,0,11,38
30,Fail,38,40,5,17,21
30,Success,48,31,7,14,34
30,Success,54,34,0,12,42
30,Success,51,35,4,10,41
30,Success,49,39,0,7,42
30,Success,46,38,0,15,31
30,Fail,42,39,2,17,25
30,Success,52,33,9,6,46
30,Success,46,32,8,14,32
30,Success,50,36,0,10,40
30,Success,47,36,0,12,35
30,Fail,43,33,0,21,22
30,Success,49,32,0,19,30
30,Success,51,34,3,12,39
30,Success,53,27,9,11,42
30,Success,47,40,0,10,37
30,Fail,40,34,0,16,24
30,Success,53,37,2,8,45
30,Fail,46,34,3,17,29
30,Success,49,37,0,12,37
30,Success,49,32,5,14,35
30,Success,61,27,2,10,51
30,Success,51,35,2,12,39
30,Success,50,34,2,14,36
30,Success,48,32,10,10,38
30,Success,47,34,0,16,31
30,Success,51,31,0,15,36
30,Success,54,33,0,12,42
30,Success,46,39,0,10,36
30,Success,49,39,0,8,41
30,Success,51,34,2,13,38
30,Success,51,28,0,19,32
30,Fail,40,44,5,11,29
30,Success,51,34,0,13,38
30,Success,45,37,7,11,34
30,Success,54,30,2,14,40
30,Success,52,34,0,12,40
30,Success,48,36,7,9,39
30,Success,50,38,2,10,40
30,Success,44,42,2,12,32
30,Success,53,38,0,9,44
30,Fail,39,48,0,12,27
30,Success,54,32,0,13,41
30,Success,51,34,0,12,39
30,Success,51,42,0,6,45
30,Success,48,40,1,11,37
30,Success,47,30,6,17,30
30,Success,46,30,8,16,30
30,Success,42,46,0,12,30
30,Success,47,32,0,12,35
30,Success,49,32,0,14,35
30,Success,49,29,10,12,37
30,Success,46,31,0,16,30
30,Success,46,36,0,16,30
30,Success,49,36,1,14,35
30,Fail,42,38,5,15,27
30,Success,47,37,0,9,38
30,Success,45,30,14,11,34
30,Success,55,28,0,9,46
30,Success,48,33,0,16,32
30,Success,50,47,0,3,47
30,Fail,41,41,0,18,23
30,Success,49,33,2,16,33
30,Success,51,40,0,7,44
30,Success,50,35,0,14,36
30,Success,48,31,4,17,31
30,Success,59,27,0,12,47
30,Success,53,34,0,13,40
30,Success,52,34,4,10,42
30,Success,47,33,0,16,31
30,Success,49,39,2,10,39
30,Success,44,35,11,10,34
30,Fail,39,42,8,11,28
30,Success,50,36,0,12,38
30,Fail,38,39,8,15,23
30,Success,55,29,1,15,40
30,Fail,44,36,0,16,28
30,Success,56,31,0,11,45
30,Fail,46,31,0,17,29
30,Fail,41,36,0,16,25
30,Fail,38,43,7,12,26
30,Success,42,42,0,11,31
30,Success,48,36,4,12,36
30,Fail,42,35,0,17,25
30,Success,50,38,2,10,40
30,Success,41,47,4,8,33
30,Success,52,36,2,10,42
30,Success,54,31,7,8,46
30,Fail,43,34,0,15,28
30,Success,46,35,0,12,34
30,Success,56,30,0,13,43
30,Fail,43,39,0,14,29
30,Success,50,32,0,14,36
30,Success,49,29,6,16,33
30,Success,43,43,1,13,30
30,Success,60,25,0,14,46
30,Success,46,40,0,13,33
30,Success,45,30,12,13,32
30,Success,45,37,0,14,31
30,Success,48,42,1,9,39
30,Success,47,41,0,11,36
30,Success,49,31,11,9,40
30,Success,53,31,0,16,37
30,Success,46,39,5,10,36
30,Success,50,31,0,14,36
30,Success,49,36,4,11,38
30,Success,45,44,0,10,35
30,Success,45,32,11,12,33
30,Success,50,29,7,14,36
30,Success,54,32,0,14,40
30,Success,45,41,0,13,32
30,Success,47,40,0,9,38
30,Success,48,45,0,5,43
30,Success,48,39,0,10,38
30,Success,46,34,0,11,35
30,Success,48,31,0,15,33
30,Success,48,36,0,11,37
30,Success,53,28,6,13,40
30,Success,49,33,0,13,36
30,Success,46,39,0,13,33
30,Success,54,35,0,10,44
30,Fail,41,42,3,14,27
30,Success,55,35,0,8,47
30,Success,47,38,0,14,33
30,Success,46,40,0,10,36
30,Success,55,30,0,9,46
30,Success,49,34,0,12,37
30,Success,48,38,0,8,40
30,Success,48,32,0,14,34
30,Success,49,37,0,10,39
30,Success,46,34,0,10,36
30,Success,47,30,9,14,33
30,Success,51,37,0,10,41
30,Fail,39,37,3,21,18
30,Fail,40,41,6,13,27
30,Success,49,39,5,7,42
30,Success,45,43,0,8,37
30,Success,53,36,0,11,42
30,Fail,42,43,0,13,29
30,Success,58,34,0,6,52
30,Success,47,37,0,12,35
30,Success,46,36,0,12,34
30,Success,47,40,1,12,35
30,Fail,44,30,0,20,24
30,Success,51,35,0,8,43
30,Success,55,34,0,11,44
30,Success,49,34,0,14,35
30,Success,42,40,0,12,30
30,Success,47,33,0,16,31
30,Success,55,34,0,4,51
30,Success,48,35,1,16,32
30,Success,54,31,0,10,44
30,Fail,36,36,11,17,19
30,Success,51,37,1,11,40
30,Success,53,34,1,12,41
30,Success,48,36,5,11,37
30,Fail,39,40,0,14,25
30,Success,44,43,0,11,33
30,Success,55,30,0,14,41
30,Success,45,36,5,14,31
30,Success,51,35,5,9,42
30,Success,53,30,0,10,43
30,Fail,41,42,0,16,25
30,Success,50,38,0,11,39
30,Success,49,35,4,12,37
30,Success,51,31,0,15,36
30,Fail,40,37,0,16,24
30,Success,46,37,5,12,34
30,Success,44,35,14,7,37
30,Success,52,30,6,12,40
30,Fail,40,41,0,15,25
30,Success,50,36,0,9,41
30,Success,54,29,0,12,42
30,Fail,39,43,0,12,27
30,Success,48,33,4,15,33
30,Fail,43,35,0,18,25
30,Success,45,36,0,9,36
30,Success,47,28,10,15,32
30,Fail,43,39,2,16,27
30,Fail,38,43,0,17,21
30,Success,52,36,3,9,43
30,Success,51,35,1,13,38
30,Success,49,40,1,10,39
30,Success,59,30,0,8,51
30,Fail,42,37,3,18,24
30,Success,49,38,4,9,40
30,Success,59,30,0,11,48
30,Fail,39,40,1,20,19
30,Success,52,31,5,12,40
30,Success,57,28,5,10,47
30,Success,51,36,1,12,39
30,Success,44,36,0,13,31
30,Success,53,27,0,20,33
30,Success,51,42,0,6,45
30,Success,52,34,0,12,40
30,Success,47,36,4,13,34
30,Success,50,31,0,15,35
30,Success,48,38,0,9,39
30,Success,46,31,0,15,31
30,Success,48,37,0,15,33
30,Fail,44,33,0,16,28
30,Success,50,39,0,10,40
30,Success,45,39,2,14,31
30,Fail,37,44,0,13,24
30,Success,41,38,0,9,32
30,Success,49,39,1,11,38
30,Success,50,33,2,15,35
30,Success,47,29,8,16,31
30,Success,48,35,0,10,38
30,Success,48,35,5,12,36
30,Success,49,41,0,9,40
30,Success,44,42,0,13,31
30,Success,50,36,0,10,40
30,Success,43,34,10,13,30
30,Success,50,29,7,14,36
30,Success,39,48,0,8,31
30,Success,55,38,0,7,48
30,Success,52,37,0,11,41
30,Success,49,34,6,11,38
30,Success,43,41,4,12,31
30,Success,49,42,2,7,42
30,Success,47,36,0,14,33
30,Success,52,31,4,13,39
30,Success,51,29,3,17,34
30,Success,51,31,5,13,38
30,Success,51,35,6,8,43
30,Success,53,31,0,14,39
30,Success,47,37,0,14,33
30,Success,52,28,0,11,41
30,Success,46,36,0,15,31
30,Success,53,32,0,12,41
30,Success,50,32,0,12,38
30,Success,48,40,1,11,37
30,Success,50,35,4,11,39
30,Success,47,37,0,11,36
30,Success,49,36,0,12,37
30,Fail,43,37,3,17,26
30,Success,47,38,3,12,35
30,Success,50,37,0,10,40
30,Success,54,34,1,11,43
30,Success,44,33,11,12,32
30,Success,50,37,0,13,37
30,Success,54,37,0,9,45
30,Success,44,39,0,10,34
30,Success,49,31,7,13,36
30,Success,47,38,3,12,35
30,Success,51,35,2,12,39
30,Success,46,36,6,12,34
30,Success,41,44,9,6,35
30,Fail,39,40,6,15,24
30,Fail,45,30,9,16,29
30,Success,44,42,0,10,34
30,Success,47,37,3,13,34
30,Success,50,36,2,12,38
30,Success,48,37,1,14,34
30,Success,50,34,4,12,38
30,Success,53,36,2,9,44
30,Success,49,33,3,15,34
30,Success,45,37,0,9,36
30,Success,54,36,1,9,45
30,Success,46,39,0,14,32
30,Fail,39,38,8,15,24
30,Success,55,28,0,12,43
30,Success,49,35,3,13,36
30,Success,57,30,0,10,47
30,Fail,41,31,11,17,24
30,Success,51,32,5,12,39
30,Success,51,33,0,14,37
30,Success,50,33,3,14,36
30,Fail,44,38,0,15,29
30,Success,53,41,0,4,49
30,Success,51,36,3,10,41
30,Success,50,33,1,16,34
30,Fail,43,37,0,16,27
30,Success,48,35,0,17,31
30,Fail,44,35,3,18,26
30,Fail,40,38,10,12,28
30,Success,51,29,0,8,43
30,Success,50,26,0,20,30
30,Success,48,44,1,7,41
30,Success,50,39,2,9,41
30,Success,50,36,1,13,37
30,Success,49,38,1,12,37
30,Success,57,28,0,12,45
30,Success,42,36,14,8,34
30,Success,52,27,0,16,36
30,Success,49,25,10,16,33
30,Success,47,33,0,14,33
30,Success,44,34,0,10,34
30,Success,49,41,1,9,40
30,Success,56,31,4,9,47
30,Success,49,36,1,14,35
30,Success,50,36,0,12,38
30,Success,52,32,0,12,40
30,Success,54,35,1,10,44
30,Success,48,39,0,11,37
30,Success,44,41,0,12,32
30,Success,50,36,3,11,39
30,Success,49,39,7,5,44
30,Success,49,36,0,11,38
30,Success,56,29,2,13,43
30,Success,57,32,2,9,48
30,Success,49,32,6,13,36
30,Success,47,38,0,9,38
30,Success,50,34,0,11,39
30,Success,54,35,0,8,46
30,Fail,42,39,0,15,27
30,Success,48,36,7,9,39
30,Success,47,27,11,15,32
30,Success,46,36,0,16,30
30,Success,45,37,0,15,30
30,Fail,43,39,0,17,26
30,Success,57,32,0,10,47
30,Success,50,37,5,8,42
30,Success,49,35,0,10,39
30,Fail,44,31,6,19,25
30,Fail,46,31,0,19,27
30,Success,52,36,4,8,44
30,Success,47,33,0,15,32
30,Success,49,36,1,14,35
30,Success,50,37,0,10,40
30,Success,51,33,7,9,42
30,Success,51,34,0,10,41
30,Success,48,36,0,9,39
30,Success,51,31,0,15,36
30,Success,57,36,0,7,50
30,Success,51,38,0,9,42
30,Success,56,27,5,12,44
30,Success,49,32,4,15,34
30,Success,53,33,4,10,43
30,Fail,39,31,8,22,17
30,Success,50,35,5,10,40
30,Fail,43,35,6,16,27
30,Success,52,37,0,11,41
30,Fail,43,42,0,14,29
30,Success,53,32,6,9,44
30,Success,54,33,4,9,45
30,Success,48,35,0,17,31
30,Fail,43,38,2,17,26
30,Success,51,39,0,10,41
30,Success,54,33,0,8,46
30,Success,54,35,0,9,45
30,Success,49,39,0,8,41
30,Success,50,36,0,10,40
30,Fail,43,36,3,18,25
30,Success,43,37,0,13,30
30,Success,53,38,0,9,44
30,Success,46,42,3,9,37
30,Success,48,36,0,16,32
30,Success,49,38,4,9,40
30,Success,48,42,1,9,39
30,Success,50,30,6,14,36
30,Success,53,32,5,10,43
30,Success,47,36,0,11,36
30,Success,47,30,0,15,32
30,Success,53,33,2,12,41
30,Success,46,34,0,14,32
30,Success,51,38,2,9,42
30,Success,46,35,0,15,31
30,Success,48,40,2,10,38
30,Success,54,42,0,1,53
30,Success,47,37,0,12,35
30,Success,56,34,0,9,47
30,Success,48,38,0,14,34
30,Success,47,33,0,14,33
30,Success,49,29,9,13,36
30,Success,53,38,0,9,44
30,Success,49,37,1,13,36
30,Success,46,39,2,13,33
30,Fail,38,42,8,12,26
30,Success,49,32,2,17,32
30,Success,45,39,0,10,35
30,Success,52,38,0,9,43
30,Fail,45,31,0,16,29
30,Success,51,33,3,13,38
30,Success,46,37,2,15,31
30,Success,49,29,7,15,34
30,Fail,44,40,1,15,29
30,Success,49,30,0,18,31
30,Success,46,39,0,15,31
30,Success,46,37,0,12,34
30,Success,48,38,0,12,36
30,Success,46,35,5,14,32
30,Success,51,42,1,6,45
30,Fail,41,38,0,12,29
30,Success,48,31,6,15,33
30,Success,47,32,0,12,35
30,Success,50,25,8,17,33
30,Success,49,27,6,18,31
30,Success,55,34,0,9,46
30,Success,48,29,0,16,32
30,Fail,45,32,0,17,28
30,Fail,45,30,0,19,26
30,Success,52,29,0,14,38
30,Success,45,41,0,11,34
30,Success,56,29,3,12,44
30,Success,49,38,0,9,40
30,Success,58,33,2,7,51
30,Success,55,35,0,9,46
30,Fail,44,32,2,22,22
30,Success,47,42,0,11,36
30,Fail,43,35,7,15,28
30,Success,49,39,0,11,38
30,Success,49,34,0,17,32
30,Success,51,43,0,5,46
30,Fail,44,29,0,17,27
30,Fail,38,44,6,12,26
30,Success,49,42,1,8,41
30,Success,55,35,0,9,46
30,Success,45,40,1,14,31
30,Success,46,37,0,11,35
30,Success,46,43,0,11,35
30,Fail,44,28,8,20,24
30,Success,50,41,0,9,41
30,Success,50,32,6,12,38
30,Success,43,38,0,13,30
30,Success,47,37,0,16,31
30,Success,41,44,0,8,33
30,Success,46,42,0,9,37
30,Success,46,31,10,13,33
30,Success,54,35,0,8,46
30,Success,51,37,3,9,42
30,Success,47,37,0,9,38
30,Success,53,35,0,11,42
30,Success,55,28,3,14,41
30,Success,48,35,0,14,34
30,Success,41,45,3,11,30
30,Success,46,39,0,12,34
30,Success,53,30,0,15,38
30,Success,49,38,1,12,37
30,Success,52,40,0,8,44
30,Success,45,38,0,15,30
30,Success,52,39,1,8,44
30,Success,51,36,0,9,42
30,Success,52,32,1,15,37
30,Success,44,40,5,11,33
30,Success,48,33,2,17,31
30,Success,49,41,0,8,41
30,Success,49,41,0,8,41
30,Success,49,34,2,15,34
30,Success,56,31,0,7,49
30,Success,48,34,0,15,33
30,Success,49,33,7,11,38
30,Success,46,39,0,8,38
30,Success,45,34,0,14,31
30,Fail,39,37,0,16,23
30,Success,49,38,1,12,37
30,Success,49,27,7,17,32
30,Success,45,35,8,12,33
30,Success,53,33,0,12,41
30,Success,46,36,3,15,31
30,Success,51,40,2,7,44
30,Success,47,41,1,11,36
30,Fail,42,38,0,17,25
30,Success,55,30,0,9,46
30,Fail,46,34,0,20,26
30,Success,56,35,0,8,48
30,Success,52,37,0,7,45
30,Success,46,41,2,11,35
30,Success,47,40,0,11,36
30,Success,47,34,0,13,34
30,Success,44,41,4,11,33
30,Success,50,40,3,7,43
30,Success,47,38,0,15,32
30,Success,43,43,0,12,31
30,Success,49,27,0,18,31
30,Fail,42,37,0,14,28
30,Fail,45,39,0,16,29
30,Success,46,37,6,11,35
30,Success,46,37,0,11,35
30,Success,51,35,0,14,37
30,Success,46,31,0,15,31
30,Success,44,34,0,14,30
30,Success,49,32,5,14,35
30,Fail,43,35,0,17,26
30,Success,43,39,0,12,31
30,Success,49,37,4,10,39
30,Success,45,39,3,13,32
30,Success,54,37,3,6,48
30,Success,52,30,8,10,42
30,Success,52,29,7,12,40
30,Fail,42,31,9,18,24
30,Success,50,37,3,10,40
30,Success,50,32,3,15,35
30,Success,54,36,3,7,47
30,Success,57,28,4,11,46
30,Success,47,44,0,8,39
30,Success,49,42,0,8,41
30,Success,50,42,0,7,43
30,Fail,40,42,1,17,23
30,Success,47,42,0,11,36
30,Success,55,29,2,14,41
30,Success,44,44,0,11,33
30,Success,47,39,0,5,42
30,Fail,40,40,0,16,24
30,Success,50,32,2,16,34
30,Fail,44,32,0,16,28
30,Fail,43,38,5,14,29
30,Success,51,38,2,9,42
30,Success,55,36,0,7,48
30,Success,49,37,4,10,39
30,Fail,48,31,0,20,28
30,Fail,41,38,5,16,25
30,Success,54,34,0,11,43
30,Success,47,39,2,12,35
30,Success,44,42,0,14,30
30,Fail,48,28,0,19,29
30,Success,49,32,0,13,36
30,Success,48,34,4,14,34
30,Fail,42,32,0,18,24
30,Fail,37,32,8,23,14
30,Success,47,35,5,13,34
30,Success,50,38,2,10,40
30,Success,58,33,0,6,52
30,Success,51,37,0,10,41
30,Success,48,36,1,15,33
30,Fail,40,39,0,12,28
30,Success,60,30,0,10,50
30,Success,44,33,0,14,30
30,Success,45,36,0,8,37
30,Success,51,31,5,13,38
30,Success,50,30,0,12,38
30,Success,50,29,0,15,35
30,Fail,46,30,7,17,29
30,Success,46,37,0,14,32
30,Success,50,42,0,5,45
30,Fail,43,41,0,14,29
30,Success,49,42,1,8,41
30,Success,41,40,0,11,30
30,Success,47,44,0,9,38
30,Success,51,36,2,11,40
30,Success,48,33,0,18,30
30,Success,52,35,1,12,40
30,Success,44,44,0,11,33
30,Success,48,37,0,15,33
30,Success,44,45,0,9,35
30,Success,52,34,0,14,38
30,Success,49,37,1,13,36
30,Success,45,37,6,12,33
30,Success,56,32,0,9,47
30,Success,52,29,0,14,38
30,Success,54,35,0,11,43
30,Success,53,32,0,13,40
30,Success,51,35,2,12,39
30,Success,48,41,0,11,37
30,Success,48,37,1,14,34
30,Fail,45,36,2,17,28
30,Fail,43,35,5,17,26
30,Fail,47,33,1,19,28
30,Fail,43,36,0,18,25
30,Success,54,25,10,11,43
30,Success,50,37,6,7,43
30,Fail,44,30,7,19,25
30,Fail,44,34,1,21,23
30,Success,48,35,0,13,35
30,Success,48,38,3,11,37
30,Fail,39,31,0,16,23
30,Success,45,41,0,14,31
30,Success,45,41,0,13,32
30,Success,48,35,0,14,34
30,Fail,42,33,10,15,27
30,Success,55,35,4,6,49
30,Success,60,35,1,4,56
30,Success,48,35,0,11,37
30,Success,52,33,1,14,38
30,Success,54,31,3,12,42
30,Success,48,35,0,11,37
30,Success,57,34,0,7,50
30,Success,47,41,0,10,37
30,Success,48,33,9,10,38
30,Fail,45,33,2,20,25
30,Success,56,27,6,11,45
30,Success,51,32,0,14,37
30,Success,53,28,1,18,35
30,Success,44,41,2,13,31
30,Success,52,34,0,13,39
30,Fail,47,29,0,19,28
30,Success,44,38,0,14,30
30,Success,49,34,0,13,36
30,Success,44,42,0,13,31
30,Success,56,30,2,12,44
30,Success,51,38,0,10,41
30,Success,52,35,1,12,40
30,Fail,42,43,0,15,27
30,Success,53,28,4,15,38
30,Success,49,38,0,12,37
30,Fail,40,35,0,12,28
30,Fail,43,36,6,15,28
30,Success,52,34,2,12,40
30,Success,49,30,0,19,30
30,Success,50,37,0,13,37
30,Success,56,34,1,9,47
30,Success,45,41,0,13,32
30,Success,58,24,5,13,45
30,Success,52,39,0,8,44
30,Success,49,36,5,10,39
30,Success,52,33,0,12,40
30,Success,51,32,0,14,37
30,Success,47,34,3,16,31
30,Success,55,32,6,7,48
30,Success,50,32,0,15,35
30,Success,45,40,0,12,33
30,Success,51,34,0,13,38
30,Success,53,34,5,8,45
30,Fail,40,36,0,19,21
30,Success,49,39,0,11,38
30,Success,44,37,9,10,34
30,Success,53,34,1,12,41
30,Fail,41,37,0,16,25
30,Success,55,35,0,10,45
30,Success,51,35,1,13,38
30,Fail,45,32,5,18,27
30,Success,51,34,1,14,37
30,Success,49,37,0,10,39
30,Success,46,39,0,12,34
30,Success,54,37,0,9,45
30,Success,47,36,0,13,34
30,Fail,43,38,0,17,26
30,Success,52,35,4,9,43
30,Success,45,40,0,15,30
30,Success,51,32,0,13,38
30,Success,52,34,0,10,42
30,Success,54,34,1,11,43
30,Fail,43,34,6,17,26
30,Fail,43,37,0,17,26
30,Success,53,37,0,8,45
30,Success,42,36,0,9,33
30,Success,44,33,0,12,32
30,Success,50,35,6,9,41
30,Success,44,35,0,11,33
30,Success,51,28,6,15,36
30,Success,56,34,2,8,48
30,Success,42,47,0,7,35
30,Success,52,35,5,8,44
30,Fail,46,32,3,19,27
30,Success,48,33,3,16,32
30,Success,51,35,6,8,43
30,Fail,47,31,0,19,28
30,Success,49,42,3,6,43
30,Success,43,39,5,13,30
30,Success,42,44,0,10,32
30,Success,46,31,0,11,35
30,Success,45,47,1,7,38
30,Success,45,39,6,10,35
30,Fail,41,35,6,18,23
30,Success,46,37,4,13,33
30,Success,48,42,0,10,38
30,Success,46,39,0,14,32
30,Success,52,39,1,8,44
30,Success,49,28,0,14,35
30,Success,46,40,3,11,35
30,Success,54,31,0,13,41
30,Fail,42,38,5,15,27
30,Success,48,37,2,13,35
30,Success,47,35,2,16,31
30,Success,55,28,3,14,41
30,Success,47,41,1,11,36
30,Success,49,37,5,9,40
30,Fail,41,43,0,13,28
30,Success,52,36,2,10,42
30,Success,49,34,5,12,37
30,Success,51,35,4,10,41
30,Success,48,32,0,13,35
30,Success,52,35,1,12,40
30,Success,45,43,0,10,35
30,Success,52,31,0,17,35
30,Success,47,34,6,13,34
30,Success,48,39,0,12,36
30,Success,48,35,5,12,36
30,Success,46,36,4,14,32
30,Success,47,33,5,15,32
30,Success,43,43,0,13,30
30,Fail,43,38,0,15,28
30,Success,49,36,0,14,35
30,Success,50,35,1,14,36
30,Success,53,26,6,15,38
30,Success,52,35,1,12,40
30,Fail,41,39,0,15,26
30,Success,47,32,0,12,35
30,Success,48,33,9,10,38
30,Success,52,38,2,8,44
30,Success,46,35,0,15,31
30,Success,49,38,4,9,40
30,Success,52,33,7,8,44
30,Success,47,38,3,12,35
30,Success,55,40,0,5,50
30,Success,52,36,0,7,45
30,Success,50,38,7,5,45
30,Fail,46,30,0,22,24
30,Success,48,31,4,17,31
30,Success,46,43,0,7,39
30,Success,53,35,1,11,42
30,Fail,39,33,0,19,20
30,Success,52,37,1,10,42
30,Fail,41,32,0,18,23
30,Success,49,31,0,16,33
30,Success,48,33,4,15,33
30,Success,52,28,0,13,39
30,Success,49,36,1,14,35
30,Success,43,37,10,10,33
30,Success,51,35,0,11,40
30,Success,46,39,0,11,35
30,Fail,44,34,5,17,27
30,Success,47,40,3,10,37
30,Success,52,34,0,14,38
30,Success,45,40,0,9,36
30,Success,52,33,0,13,39
30,Success,53,32,0,14,39
30,Success,52,33,0,14,38
30,Success,60,32,0,6,54
30,Success,52,36,0,10,42
30,Success,49,32,0,12,37
30,Fail,43,32,8,17,26
30,Success,48,28,0,17,31
30,Success,53,31,0,12,41
30,Success,47,38,0,6,41
30,Success,56,38,0,5,51
30,Success,50,32,8,10,40
30,Success,44,44,0,10,34
30,Fail,39,39,0,20,19
30,Fail,43,36,3,18,25
30,Success,47,39,0,10,37
30,Success,44,41,0,12,32
30,Success,58,28,0,14,44
30,Success,48,35,3,14,34
30,Success,44,38,0,14,30
30,Success,47,37,3,13,34
30,Success,48,33,2,17,31
30,Success,44,29,0,12,32
30,Success,47,35,0,16,31
30,Success,48,37,0,14,34
30,Success,51,24,0,13,38
30,Fail,47,29,5,19,28
30,Success,46,42,0,12,34
30,Success,55,37,0,8,47
30,Success,50,32,0,13,37
30,Success,52,30,0,14,38
30,Success,49,34,3,14,35
30,Success,48,35,0,14,34
30,Success,50,36,1,13,37
30,Success,53,29,3,15,38
30,Fail,43,40,0,14,29
30,Fail,45,36,0,18,27
30,Success,48,37,0,8,40
30,Success,48,33,0,7,41
30,Success,52,34,0,12,40
30,Success,54,38,1,7,47
30,Fail,45,37,1,17,28
30,Success,55,32,0,10,45
30,Success,51,40,2,7,44
30,Success,48,33,0,17,31
30,Success,48,34,1,17,31
30,Success,50,31,3,16,34
30,Success,52,31,7,10,42
30,Success,43,35,0,11,32
30,Success,51,36,0,12,39
30,Success,53,36,2,9,44
30,Success,47,34,6,13,34
30,Success,49,31,0,14,35
30,Success,51,33,5,11,40
30,Success,52,35,0,9,43
30,Success,55,27,3,15,40
30,Success,52,31,0,5,47
30,Success,51,31,0,13,38
30,Success,54,36,1,9,45
30,Success,48,37,0,10,38
30,Success,51,33,0,16,35
30,Success,44,35,9,12,32
30,Fail,38,39,0,13,25
30,Success,44,33,9,14,30
30,Success,49,35,0,10,39
30,Success,54,34,0,7,47
30,Success,49,37,0,11,38
30,Success,54,33,3,10,44
30,Success,47,36,0,16,31
30,Success,49,37,3,11,38
30,Success,49,34,1,16,33
30,Success,48,38,0,13,35
30,Success,47,37,0,15,32
30,Success,48,32,7,13,35
30,Fail,48,30,3,19,29
30,Success,46,37,5,12,34
30,Fail,48,29,0,19,29
30,Success,48,35,1,16,32
30,Success,46,31,10,13,33
30,Success,56,25,0,9,47
30,Success,48,39,2,11,37
30,Success,43,36,0,11,32
30,Fail,43,32,9,16,27
30,Success,57,30,1,12,45
30,Success,48,39,0,11,37
30,Success,42,39,7,12,30
30,Success,50,36,2,12,38
30,Fail,43,39,3,15,28
30,Success,50,34,0,9,41
30,Fail,49,24,6,21,28
30,Success,50,36,0,8,42
30,Success,50,33,0,13,37
30,Success,47,41,0,9,38
30,Success,47,35,0,13,34
30,Fail,46,36,0,17,29
30,Fail,44,32,8,16,28
30,Success,49,34,0,16,33
30,Success,45,40,0,10,35
30,Success,44,41,0,10,34
30,Fail,44,32,0,18,26
30,Fail,43,40,0,15,28
30,Success,44,34,11,11,33
30,Success,47,34,3,16,31
30,Success,48,37,0,11,37
30,Fail,35,35,0,14,21
30,Success,50,40,1,9,41
30,Success,55,32,0,9,46
30,Success,57,35,0,8,49
30,Success,39,43,0,7,32
30,Success,50,32,4,14,36
30,Success,47,32,0,13,34
30,Fail,42,44,0,13,29
30,Fail,40,43,2,15,25
30,Success,47,42,2,9,38
30,Success,47,40,1,12,35
30,Success,54,33,0,10,44
30,Success,47,42,3,8,39
30,Success,46,39,0,10,36
30,Success,44,40,0,8,36
30,Success,48,32,2,18,30
30,Fail,39,42,2,17,22
30,Success,54,36,1,9,45
30,Fail,43,39,0,18,25
30,Fail,42,41,1,16,26
30,Success,49,36,0,12,37
30,Success,49,34,0,9,40
30,Success,43,39,8,10,33
30,Success,47,34,0,16,31
30,Success,49,39,0,12,37
30,Success,52,39,0,9,43
30,Success,58,32,0,7,51
30,Success,50,33,0,17,33
30,Fail,43,34,0,18,25
30,Success,54,35,0,8,46
30,Success,41,45,0,11,30
30,Success,56,38,1,5,51
30,Success,58,33,0,9,49
30,Fail,43,36,0,18,25
30,Success,57,33,2,8,49
30,Success,49,36,2,13,36
30,Success,43,40,0,12,31
30,Success,51,32,0,14,37
30,Success,48,31,3,18,30
30,Success,48,34,0,18,30
30,Success,46,29,12,13,33
30,Success,49,33,0,14,35
30,Success,49,32,0,15,34
30,Fail,41,45,0,13,28
30,Success,45,36,0,15,30
30,Success,44,40,0,13,31
30,Success,46,44,1,9,37
30,Fail,41,43,3,13,28
30,Success,45,39,4,12,33
30,Success,52,34,0,10,42
30,Success,51,30,9,10,41
30,Success,44,40,0,9,35
30,Success,49,39,0,11,38
30,Success,45,35,6,14,31
30,Success,41,44,0,9,32
30,Fail,45,35,4,16,29
30,Success,56,28,0,13,43
30,Success,54,33,0,8,46
30,Success,44,43,1,12,32
30,Success,48,32,7,13,35
30,Success,48,33,6,13,35
30,Success,45,41,0,10,35
30,Success,50,33,0,16,34
30,Success,51,34,4,11,40
30,Success,44,39,0,13,31
30,Success,48,36,2,14,34
30,Fail,40,38,0,15,25
30,Success,51,35,4,10,41
30,Fail,44,38,3,15,29
30,Success,51,36,4,9,42
30,Success,45,39,0,15,30
30,Success,45,34,8,13,32
30,Success,57,28,0,13,44
30,Fail,44,34,0,19,25
30,Success,55,33,1,11,44
30,Success,50,36,0,12,38
30,Success,55,33,0,11,44
30,Success,43,41,0,12,31
30,Success,52,38,1,9,43
30,Success,46,34,0,16,30
30,Success,52,32,2,14,38
30,Success,51,38,3,8,43
30,Success,54,34,0,9,45
30,Success,49,39,0,12,37
30,Success,47,36,0,15,32
30,Fail,47,31,3,19,28
30,Success,53,40,1,6,47
30,Success,47,40,0,13,34
30,Success,47,37,1,15,32
30,Success,47,47,0,6,41
30,Success,50,35,0,15,35
30,Success,43,33,13,11,32
30,Fail,46,34,0,20,26
30,Fail,44,35,0,16,28
30,Success,56,29,3,12,44
30,Success,46,27,0,16,30
30,Success,49,40,0,7,42
30,Fail,42,36,3,19,23
30,Success,45,31,0,13,32
30,Success,52,36,2,10,42
30,Success,45,42,0,13,32
30,Success,53,35,1,11,42
30,Fail,39,33,0,15,24
30,Fail,41,44,1,14,27
30,Success,43,36,9,12,31
30,Success,45,36,0,12,33
30,Success,42,51,0,7,35
30,Success,52,29,0,13,39
30,Success,49,40,1,10,39
30,Success,48,34,5,13,35
30,Success,50,38,0,11,39
30,Success,51,36,1,12,39
30,Success,51,36,2,11,40
30,Fail,45,37,0,16,29
30,Success,47,38,0,10,37
30,Success,51,34,0,10,41
30,Success,52,35,1,12,40
30,Success,52,33,7,8,44
30,Success,46,37,0,15,31
30,Success,50,35,4,11,39
30,Success,45,36,0,15,30
30,Fail,42,34,0,16,26
30,Success,50,35,0,13,37
30,Success,50,31,8,11,39
30,Success,48,40,2,10,38
30,Success,48,36,2,14,34
30,Success,56,29,0,11,45
30,Success,51,36,5,8,43
30,Fail,45,34,0,16,29
30,Success,58,30,1,11,47
30,Success,49,27,6,18,31
30,Success,58,31,0,10,48
30,Success,46,38,2,14,32
30,Success,62,28,1,9,53
30,Success,42,36,0,12,30
30,Success,48,36,0,12,36
30,Success,52,27,0,13,39
30,Success,48,38,0,11,37
30,Success,40,40,0,10,30
30,Success,54,34,3,9,45
30,Success,50,29,6,15,35
30,Success,49,39,0,10,39
30,Success,45,40,0,8,37
30,Fail,41,44,0,14,27
30,Success,49,33,0,15,34
30,Success,48,32,0,12,36
30,Success,49,36,3,12,37
30,Success,46,39,3,12,34
30,Fail,43,31,0,14,29
30,Success,56,33,1,10,46
30,Success,58,35,0,6,52
30,Success,47,33,0,12,35
30,Success,49,41,1,9,40
30,Success,54,35,3,8,46
30,Success,56,36,0,8,48
30,Success,55,28,0,16,39
30,Success,46,31,10,13,33
30,Success,46,36,0,11,35
30,Success,48,37,0,9,39
30,Success,45,41,0,10,35
30,Success,51,36,1,12,39
30,Success,48,33,0,17,31
30,Success,42,45,7,6,36
30,Success,58,32,0,7,51
30,Success,49,31,6,14,35
30,Success,50,39,2,9,41
30,Success,47,35,3,15,32
30,Success,49,35,5,11,38
30,Fail,39,38,0,21,18
30,Success,51,34,0,15,36
30,Success,48,39,0,11,37
30,Success,52,29,5,14,38
30,Success,46,30,8,16,30
30,Success,53,37,0,10,43
30,Success,47,31,0,15,32
30,Success,55,30,0,11,44
30,Success,39,36,0,9,30
30,Fail,42,38,7,13,29
30,Fail,39,45,0,13,26
30,Success,49,41,1,9,40
30,Success,51,29,6,14,37
30,Fail,43,33,0,17,26
30,Success,51,34,5,10,41
30,Fail,43,35,3,19,24
30,Success,45,42,2,11,34
30,Success,46,44,1,9,37
30,Success,49,33,0,9,40
30,Success,47,35,0,10,37
30,Success,49,35,0,10,39
30,Success,49,40,2,9,40
30,Success,56,30,3,11,45
30,Success,61,28,1,10,51
30,Fail,44,38,0,16,28
30,Success,46,45,3,6,40
30,Success,41,43,6,10,31
30,Success,45,38,0,13,32
30,Success,45,37,0,13,32
30,Fail,42,43,0,14,28
30,Success,49,39,3,9,40
30,Success,47,37,5,11,36
30,Fail,41,38,0,15,26
30,Success,45,40,0,10,35
30,Success,53,36,0,7,46
30,Success,49,27,0,15,34
30,Success,47,36,0,15,32
30,Success,45,35,0,15,30
30,Fail,41,42,1,16,25
30,Success,48,34,0,14,34
30,Fail,44,33,0,16,28
30,Success,46,39,2,13,33
30,Success,45,43,0,8,37
30,Success,45,40,0,12,33
30,Success,44,36,0,13,31
30,Success,50,38,1,11,39
30,Fail,42,42,3,13,29
30,Success,55,30,1,14,41
30,Fail,38,33,0,21,17
30,Success,50,38,2,10,40
30,Success,57,31,1,11,46
30,Success,56,31,3,10,46
30,Success,50,34,0,13,37
30,Success,58,36,0,4,54
30,Fail,42,37,7,14,28
30,Success,52,37,1,10,42
30,Fail,46,31,5,18,28
30,Success,51,41,1,7,44
30,Success,50,41,0,9,41
30,Success,52,35,0,11,41
30,Success,51,38,0,9,42
30,Success,45,39,0,10,35
30,Success,51,38,1,10,41
30,Success,48,39,2,11,37
30,Success,46,37,0,11,35
30,Success,51,34,0,13,38
30,Success,52,38,0,9,43
30,Success,45,37,4,14,31
30,Success,49,37,4,10,39
30,Success,52,35,0,11,41
30,Fail,43,37,0,15,28
30,Success,51,32,0,14,37
30,Success,47,45,1,7,40
30,Success,50,37,0,13,37
30,Success,43,32,12,13,30
30,Fail,42,40,0,18,24
30,Success,47,37,0,15,32
30,Success,52,32,0,13,39
30,Success,54,29,0,11,43
30,Success,50,33,0,16,34
30,Success,51,34,0,15,36
30,Success,47,37,0,13,34
30,Success,58,29,0,10,48
30,Success,50,32,0,12,38
30,Success,52,35,1,12,40
30,Success,52,42,0,6,46
30,Success,47,42,0,11,36
30,Success,47,38,0,13,34
30,Fail,43,39,0,15,28
30,Success,48,39,2,11,37
30,Success,45,37,6,12,33
30,Fail,42,35,7,16,26
30,Success,49,38,0,11,38
30,Fail,42,38,1,19,23
30,Success,44,48,0,8,36
30,Success,45,38,2,15,30
30,Success,55,34,4,7,48
30,Fail,44,37,0,16,28
30,Fail,46,32,5,17,29
30,Fail,42,37,6,15,27
30,Success,47,36,0,10,37
30,Fail,43,37,5,15,28
30,Success,50,36,2,12,38
30,Success,48,35,0,14,34
30,Fail,38,27,18,17,21
30,Success,52,35,0,10,42
30,Success,41,38,11,10,31
30,Success,54,31,0,14,40
30,Success,51,35,1,13,38
30,Success,47,36,0,17,30
30,Success,45,41,6,8,37
30,Success,51,29,5,15,36
30,Success,51,39,2,8,43
30,Fail,46,26,0,19,27
30,Success,54,29,0,13,41
30,Success,48,32,7,13,35
30,Success,50,37,3,10,40
30,Fail,44,36,3,17,27
30,Success,47,35,3,15,32
30,Success,46,36,6,12,34
30,Success,53,37,0,10,43
30,Success,50,36,0,12,38
30,Success,56,30,1,13,43
30,Success,50,32,0,15,35
30,Success,48,40,1,11,37
30,Success,54,29,0,12,42
30,Success,48,33,4,15,33
30,Fail,42,38,5,15,27
30,Success,49,34,0,11,38
30,Fail,41,36,0,20,21
30,Success,56,32,0,9,47
30,Success,45,41,0,10,35
30,Fail,42,43,2,13,29
30,Success,50,33,4,13,37
30,Success,44,39,0,13,31
30,Fail,39,45,0,14,25
30,Success,55,33,0,11,44
30,Success,55,32,3,10,45
30,Success,50,28,0,12,38
30,Success,46,34,6,14,32
30,Fail,46,34,0,17,29
30,Success,51,33,0,11,40
30,Success,49,37,1,13,36
30,Success,51,37,1,11,40
30,Fail,43,40,3,14,29
30,Fail,40,39,0,13,27
30,Fail,47,32,2,19,28
30,Success,47,33,3,17,30
30,Fail,40,37,0,13,27
30,Fail,46,33,4,17,29
30,Success,52,28,0,13,39
30,Success,41,41,9,9,32
30,Success,45,37,4,14,31
30,Success,52,35,0,8,44
30,Success,45,30,16,9,36
30,Success,54,36,0,9,45
30,Success,40,42,9,9,31
30,Success,47,33,0,16,31
30,Success,50,29,0,14,36
30,Success,57,33,2,8,49
30,Success,50,27,8,15,35
30,Success,48,36,1,15,33
30,Success,51,32,7,10,41
30,Success,53,32,2,13,40
30,Fail,42,38,0,18,24
30,Success,51,36,0,13,38
30,Success,52,35,1,12,40
30,Success,46,36,4,14,32
30,Success,50,33,0,13,37
30,Success,49,35,0,10,39
30,Success,48,42,2,8,40
30,Fail,44,34,0,15,29
30,Success,53,38,1,8,45
30,Success,42,41,7,10,32
30,Success,49,34,3,14,35
30,Success,49,31,4,16,33
30,Fail,41,36,0,13,28
30,Success,54,39,0,5,49
30,Fail,39,37,13,11,28
30,Success,48,26,11,15,33
30,Fail,38,32,0,22,16
30,Success,44,35,7,14,30
30,Fail,40,45,0,14,26
30,Success,45,43,0,12,33
30,Success,49,36,0,12,37
30,Success,54,32,0,9,45
30,Fail,47,28,6,19,28
30,Success,56,33,0,10,46
30,Success,49,39,0,11,38
30,Success,49,30,6,15,34
30,Fail,45,31,0,18,27
30,Success,56,30,4,10,46
30,Success,48,34,0,11,37
30,Success,45,34,9,12,33
30,Fail,41,42,0,16,25
30,Success,53,37,1,9,44
30,Success,50,38,2,10,40
30,Success,46,40,0,13,33
30,Success,49,35,8,8,41
30,Success,46,32,0,13,33
30,Success,47,39,0,10,37
30,Fail,37,36,14,13,24
30,Success,51,34,2,13,38
30,Success,52,25,0,15,37
30,Success,59,25,4,12,47
30,Fail,44,35,0,21,23
30,Success,46,38,0,14,32
30,Fail,41,39,3,17,24
30,Success,48,44,4,4,44
30,Success,44,41,0,14,30
30,Success,44,38,4,14,30
30,Success,48,43,0,9,39
30,Success,53,33,7,7,46
30,Success,47,36,2,15,32
30,Success,56,32,5,7,49
30,Success,47,40,0,12,35
30,Success,43,36,8,13,30
30,Success,48,34,0,16,32
30,Success,52,29,0,17,35
30,Success,50,35,2,13,37
30,Success,49,35,1,15,34
30,Success,55,33,0,6,49
30,Success,51,33,0,13,38
30,Success,49,42,0,8,41
30,Success,47,38,0,14,33
30,Success,50,31,10,9,41
30,Success,47,33,0,12,35
30,Success,47,41,1,11,36
30,Fail,46,34,0,17,29
30,Success,49,31,0,19,30
30,Success,52,35,0,10,42
30,Fail,43,40,3,14,29
30,Success,49,32,0,16,33
30,Success,54,31,0,11,43
30,Success,51,36,4,9,42
30,Success,48,34,3,15,33
30,Success,54,30,5,11,43
30,Success,53,38,1,8,45
30,Success,50,31,0,16,34
30,Fail,48,30,3,19,29
30,Success,51,35,0,14,37
30,Success,52,26,6,16,36
30,Success,46,42,2,10,36
30,Fail,43,36,0,17,26
30,Success,47,40,0,13,34
30,Fail,40,35,0,19,21
30,Success,50,40,0,10,40
30,Success,52,29,0,11,41
30,Success,47,34,11,8,39
30,Success,52,34,0,13,39
30,Fail,34,44,0,13,21
30,Success,46,36,0,11,35
30,Success,51,32,3,14,37
30,Success,43,35,10,12,31
30,Success,49,30,0,18,31
30,Success,52,37,1,10,42
30,Success,54,31,5,10,44
30,Success,59,30,0,7,52
30,Success,49,37,5,9,40
30,Success,52,28,0,16,36
30,Success,50,35,1,14,36
30,Success,51,36,0,11,40
30,Success,52,33,1,14,38
30,Fail,42,41,0,14,28
30,Success,49,43,1,7,42
30,Fail,41,39,0,12,29
30,Success,45,32,8,15,30
30,Success,52,32,0,15,37
30,Success,46,41,0,9,37
30,Fail,40,41,0,13,27
30,Success,46,41,0,9,37
30,Success,48,40,1,11,37
30,Fail,41,36,7,16,25
30,Success,45,36,6,13,32
30,Success,49,40,1,10,39
30,Success,62,29,0,8,54
30,Fail,44,35,4,17,27
30,Fail,44,36,2,18,26
30,Fail,44,33,4,19,25
30,Success,48,38,2,12,36
30,Success,46,41,2,11,35
30,Success,47,31,5,17,30
30,Success,50,37,1,12,38
30,Success,49,30,0,14,35
30,Success,53,36,5,6,47
30,Success,49,35,6,10,39
30,Success,54,32,2,12,42
30,Success,52,33,0,10,42
30,Success,43,35,12,10,33
30,Success,49,31,0,14,35
30,Success,45,38,8,9,36
30,Fail,39,37,12,12,27
30,Success,56,31,2,11,45
30,Success,48,34,0,10,38
30,Success,52,34,4,10,42
30,Success,50,32,3,15,35
30,Fail,45,26,0,17,28
30,Success,49,34,0,8,41
30,Success,46,45,0,9,37
30,Success,49,38,0,12,37
30,Success,51,31,3,15,36
30,Fail,44,29,8,19,25
30,Fail,40,39,7,14,26
30,Success,51,28,0,16,35
30,Success,45,41,6,8,37
30,Success,50,39,0,6,44
30,Success,54,35,5,6,48
30,Success,50,39,0,8,42
30,Success,49,33,5,13,36
30,Success,54,30,2,14,40
30,Success,49,32,4,15,34
30,Success,50,36,3,11,39
30,Success,41,44,5,10,31
30,Success,49,33,0,16,33
30,Fail,43,27,10,20,23
30,Success,49,35,0,13,36
30,Success,50,34,1,15,35
30,Success,47,44,2,7,40
30,Success,51,36,0,12,39
30,Success,53,36,0,11,42
30,Success,48,30,0,16,32
30,Success,50,35,0,14,36
30,Success,54,33,4,9,45
30,Success,49,34,0,11,38
30,Success,58,32,2,8,50
30,Success,49,40,0,10,39
30,Success,45,36,4,15,30
30,Fail,43,38,0,17,26
30,Fail,40,36,0,15,25
30,Success,51,37,2,10,41
30,Success,50,37,1,12,38
30,Success,51,33,0,10,41
30,Success,49,32,3,16,33
30,Success,45,39,0,12,33
30,Success,49,34,0,12,37
30,Success,50,34,1,15,35
30,Success,43,43,0,13,30
30,Success,43,43,3,11,32
30,Success,49,35,0,14,35
30,Success,50,33,4,13,37
30,Success,49,37,2,12,37
30,Success,51,37,0,11,40
30,Success,52,35,0,13,39
30,Success,43,42,2,13,30
30,Success,52,41,0,6,46
30,Fail,39,43,2,16,23
30,Success,52,41,1,6,46
30,Success,41,42,7,10,31
30,Success,48,33,5,14,34
30,Success,47,34,0,16,31
30,Fail,43,33,0,15,28
30,Success,46,35,3,16,30
30,Success,51,32,0,15,36
30,Success,56,31,1,12,44
30,Success,48,35,1,16,32
30,Success,50,35,3,12,38
30,Success,45,39,0,9,36
30,Success,58,33,0,9,49
30,Success,53,27,10,10,43
30,Success,45,46,1,8,37
30,Fail,43,39,0,16,27
30,Success,44,41,4,11,33
30,Success,46,33,0,15,31
30,Success,46,40,0,14,32
30,Success,45,36,0,14,31
30,Success,41,32,16,11,30
30,Success,58,33,3,6,52
30,Success,57,37,0,5,52
30,Success,54,39,0,7,47
30,Success,51,35,0,11,40
30,Success,47,39,0,14,33
30,Success,52,38,1,9,43
30,Success,47,37,1,15,32
30,Success,52,39,1,8,44
30,Success,46,39,6,9,37
30,Success,51,41,2,6,45
30,Success,47,29,13,11,36
30,Success,49,35,9,7,42
30,Success,53,35,5,7,46
30,Success,46,36,0,16,30
30,Fail,43,33,0,15,28
30,Fail,42,36,0,13,29
30,Success,54,33,3,10,44
30,Success,52,36,0,12,40
30,Success,44,39,0,13,31
30,Success,49,34,6,11,38
30,Success,50,38,0,9,41
30,Success,57,32,0,7,50
30,Success,52,37,0,10,42
30,Fail,44,40,0,15,29
30,Success,51,31,7,11,40
30,Fail,44,35,0,16,28
30,Success,49,36,0,14,35
30,Success,49,24,9,18,31
30,Success,39,44,12,5,34
30,Success,49,38,0,12,37
30,Success,48,29,0,14,34
30,Success,49,38,0,10,39
30,Success,48,32,0,13,35
30,Success,51,32,5,12,39
30,Success,50,36,0,11,39
30,Success,56,30,1,13,43
30,Fail,45,35,2,18,27
30,Success,51,32,4,13,38
30,Success,55,33,0,12,43
30,Success,53,33,0,8,45
30,Success,44,32,10,14,30
30,Success,52,36,0,10,42
30,Success,43,41,4,12,31
30,Fail,40,29,0,22,18
30,Fail,41,38,3,18,23
30,Success,50,28,0,11,39
30,Success,48,34,0,15,33
30,Success,53,35,0,11,42
30,Fail,42,40,0,13,29
30,Success,54,37,0,9,45
30,Success,48,38,0,7,41
30,Success,53,31,3,13,40
30,Success,46,37,0,12,34
30,Success,52,36,2,10,42
30,Success,52,36,1,11,41
30,Success,53,39,0,7,46
30,Success,57,26,0,16,41
30,Fail,41,37,0,18,23
30,Fail,42,37,0,16,26
30,Success,49,41,1,9,40
30,Fail,44,34,0,15,29
30,Fail,44,34,7,15,29
30,Fail,47,33,0,18,29
30,Success,52,29,6,13,39
30,Fail,43,33,0,17,26
30,Success,49,36,2,13,36
30,Fail,45,34,0,17,28
30,Success,47,39,0,9,38
30,Success,47,37,4,12,35
30,Fail,45,30,0,17,28
30,Success,48,33,0,13,35
30,Success,46,39,0,15,31
30,Fail,41,39,4,16,25
30,Success,44,37,6,13,31
30,Fail,43,39,2,16,27
30,Success,51,36,0,11,40
30,Success,47,31,6,16,31
30,Success,53,40,1,6,47
30,Success,46,33,6,15,31
30,Success,47,42,1,10,37
30,Success,50,37,0,13,37
30,Success,50,32,5,13,37
30,Success,53,32,5,10,43
30,Success,50,33,0,16,34
30,Success,53,35,1,11,42
30,Success,47,39,4,10,37
30,Success,49,37,0,13,36
30,Success,45,44,0,8,37
30,Success,45,41,0,14,31
30,Success,51,37,0,11,40
30,Success,44,38,0,11,33
30,Success,44,38,0,11,33
30,Success,48,36,2,14,34
30,Success,55,37,0,7,48
30,Fail,42,35,8,15,27
30,Success,46,31,14,9,37
30,Success,53,27,0,15,38
30,Success,42,43,0,12,30
30,Success,43,40,5,12,31
30,Success,53,34,1,12,41
30,Success,54,30,1,15,39
30,Success,50,39,1,10,40
30,Fail,44,37,0,17,27
30,Success,46,36,5,13,33
30,Success,44,38,6,12,32
30,Success,46,46,0,7,39
30,Success,47,36,6,11,36
30,Success,53,33,0,14,39
30,Success,51,37,0,10,41
30,Success,51,37,0,10,41
30,Success,47,36,2,15,32
30,Success,44,38,0,8,36
30,Success,55,34,1,10,45
30,Success,47,39,2,12,35
30,Success,53,33,1,13,40
30,Success,51,34,1,14,37
30,Success,50,35,0,11,39
30,Success,46,41,3,10,36
30,Success,52,29,5,14,38
30,Success,51,40,0,8,43
30,Success,54,31,1,14,40
30,Success,54,38,1,7,47
30,Success,42,46,2,10,32
30,Fail,42,34,0,19,23
30,Fail,43,40,0,14,29
30,Success,50,35,0,13,37
30,Success,45,41,5,9,36
30,Success,56,30,0,8,48
30,Success,52,33,5,10,42
30,Success,46,39,0,11,35
30,Success,44,40,6,10,34
30,Success,47,33,5,15,32
30,Success,48,39,0,12,36
30,Success,44,37,0,13,31
30,Fail,42,44,0,14,28
30,Success,46,30,9,15,31
30,Success,53,35,0,12,41
30,Success,52,36,2,10,42
30,Success,47,37,4,12,35
30,Fail,40,43,3,14,26
30,Success,50,35,0,14,36
30,Success,48,36,0,11,37
30,Fail,39,45,0,11,28
30,Success,44,42,0,12,32
30,Success,48,37,2,13,35
30,Success,49,37,0,9,40
30,Fail,42,39,3,16,26
30,Success,50,37,5,8,42
30,Success,47,39,1,13,34
30,Fail,44,31,10,15,29
30,Success,50,31,0,13,37
30,Success,49,38,1,12,37
30,Success,46,37,0,12,34
30,Success,46,40,0,14,32
30,Fail,42,43,2,13,29
30,Success,58,29,0,10,48
30,Fail,42,36,0,15,27
30,Success,44,40,0,11,33
30,Success,52,35,0,12,40
30,Success,47,33,0,14,33
30,Success,50,40,0,10,40
30,Success,52,26,11,11,41
30,Fail,46,34,3,17,29
30,Success,53,34,1,12,41
30,Fail,44,39,0,16,28
30,Success,47,45,0,8,39
30,Success,47,38,4,11,36
30,Fail,42,37,0,14,28
30,Fail,44,39,0,17,27
30,Success,46,31,8,15,31
30,Success,51,37,3,9,42
30,Success,47,41,0,9,38
30,Success,49,33,0,16,33
30,Fail,45,31,0,17,28
30,Success,44,45,0,8,36
30,Success,51,28,4,17,34
30,Success,48,37,4,11,37
30,Fail,44,38,0,16,28
30,Success,53,33,0,9,44
30,Fail,44,38,0,17,27
30,Success,53,25,0,18,35
30,Success,52,37,0,10,42
30,Success,52,36,0,11,41
30,Success,48,38,0,13,35
30,Fail,43,37,5,15,28
30,Success,47,34,0,16,31
30,Success,56,27,2,15,41
30,Success,51,32,2,15,36
30,Success,55,37,1,7,48
30,Success,51,32,4,13,38
30,Fail,42,29,0,24,18
30,Fail,46,33,4,17,29
30,Success,50,34,5,11,39
30,Success,52,36,0,8,44
30,Success,48,33,7,12,36
30,Fail,40,40,5,15,25
30,Success,48,40,0,9,39
30,Success,49,36,1,14,35
30,Success,45,34,12,9,36
30,Success,48,43,0,7,41
30,Success,47,35,0,13,34
30,Success,41,48,3,8,33
30,Success,47,44,0,9,38
30,Success,44,38,4,14,30
30,Success,50,32,0,13,37
30,Success,46,34,8,12,34
30,Success,49,38,0,12,37
30,Success,48,31,0,15,33
30,Fail,41,33,0,17,24
30,Success,51,33,4,12,39
30,Success,45,37,4,14,31
30,Success,45,38,7,10,35
30,Success,43,32,14,11,32
30,Fail,41,40,2,17,24
30,Success,57,29,0,13,44
30,Fail,44,32,0,20,24
30,Success,47,37,0,15,32
30,Success,46,35,0,14,32
30,Success,53,31,0,11,42
30,Success,53,41,0,6,47
30,Success,51,40,2,7,44
30,Success,50,28,8,14,36
30,Success,45,38,0,13,32
30,Success,47,36,3,14,33
30,Fail,43,42,1,14,29
30,Success,47,39,2,12,35
30,Success,44,39,3,14,30
30,Success,46,39,0,13,33
30,Success,47,39,0,12,35
30,Success,54,34,3,9,45
30,Success,43,40,0,13,30
30,Success,53,34,4,9,44
30,Success,45,39,6,10,35
30,Success,47,38,1,14,33
30,Success,52,35,0,13,39
30,Success,55,29,5,11,44
30,Success,51,33,0,11,40
30,Success,50,33,4,13,37
30,Fail,44,29,10,17,27
30,Success,46,31,8,15,31
30,Success,52,35,0,12,40
30,Success,52,36,0,11,41
30,Success,46,36,9,9,37
30,Fail,43,33,7,17,26
30,Success,49,35,2,14,35
30,Success,59,29,0,9,50
30,Success,46,38,6,10,36
30,Fail,44,31,0,22,22
30,Success,49,33,0,12,37
30,Success,47,37,0,8,39
30,Success,45,40,2,13,32
30,Fail,43,35,0,20,23
30,Success,44,43,0,11,33
30,Success,53,33,1,13,40
30,Fail,42,38,0,19,23
30,Success,41,40,0,9,32
30,Success,52,22,8,18,34
30,Success,48,38,0,13,35
30,Success,46,34,0,11,35
30,Success,50,37,0,11,39
30,Success,47,37,1,15,32
30,Success,45,31,0,12,33
30,Fail,41,37,5,17,24
30,Success,48,37,1,14,34
30,Success,53,30,0,17,36
30,Fail,42,33,8,17,25
30,Success,52,31,0,12,40
30,Success,45,40,0,12,33
30,Success,53,35,0,10,43
30,Fail,42,39,6,13,29
30,Success,51,28,0,19,32
30,Success,53,26,5,16,37
30,Success,52,35,0,12,40
30,Success,51,32,0,16,35
30,Success,48,35,2,15,33
30,Success,58,31,1,10,48
30,Success,58,32,1,9,49
30,Success,51,34,3,12,39
30,Success,47,42,0,10,37
30,Success,53,37,1,9,44
30,Success,45,41,0,14,31
30,Fail,40,27,8,25,15
30,Fail,46,33,4,17,29
30,Success,49,37,0,12,37
30,Success,52,33,0,12,40
30,Success,49,38,4,9,40
30,Success,55,30,0,14,41
30,Fail,45,37,0,16,29
30,Success,46,38,2,14,32
30,Success,48,26,0,16,32
30,Fail,42,37,6,15,27
30,Success,50,35,0,10,40
30,Fail,43,42,0,15,28
30,Success,48,33,4,15,33
30,Success,39,40,12,9,30
30,Success,46,42,2,10,36
30,Fail,41,34,9,16,25
30,Success,49,33,11,7,42
30,Success,50,29,0,17,33
30,Fail,43,39,0,15,28
30,Success,48,37,0,11,37
30,Success,56,36,2,6,50
30,Fail,42,39,0,17,25
30,Fail,39,40,9,12,27
30,Success,53,30,0,15,38
30,Success,46,33,9,12,34
30,Success,50,39,0,10,40
30,Success,47,33,8,12,35
30,Fail,45,36,0,19,26
30,Success,54,27,0,16,38
30,Success,47,34,0,12,35
30,Success,44,37,5,14,30
30,Success,48,34,0,16,32
30,Success,54,36,1,9,45
30,Success,61,25,0,9,52
30,Fail,41,38,7,14,27
30,Success,49,37,0,8,41
30,Fail,42,33,10,15,27
30,Success,50,37,0,9,41
30,Success,43,39,9,9,34
30,Success,53,30,2,15,38
30,Success,50,35,0,10,40
30,Fail,41,40,0,13,28
30,Success,47,32,5,16,31
30,Fail,43,42,0,14,29
30,Success,52,36,2,10,42
30,Fail,42,36,0,14,28
30,Success,48,31,8,13,35
30,Success,42,45,0,10,32
30,Success,55,32,2,11,44
30,Success,51,39,2,8,43
30,Success,49,35,0,13,36
30,Success,49,34,0,12,37
30,Success,47,30,0,17,30
30,Success,53,32,0,14,39
30,Success,46,36,0,14,32
30,Success,54,32,0,14,40
30,Success,46,38,1,15,31
30,Success,43,38,8,11,32
30,Success,52,34,0,11,41
30,Success,58,30,0,11,47
30,Success,46,40,0,12,34
30,Success,48,36,1,15,33
30,Fail,39,49,1,11,28
30,Success,55,26,6,13,42
30,Success,55,40,0,5,50
30,Success,51,31,4,14,37
30,Success,64,27,0,8,56
30,Fail,45,34,0,20,25
30,Success,49,34,0,17,32
30,Success,47,31,0,14,33
30,Fail,44,33,5,18,26
30,Success,48,40,0,7,41
30,Success,49,40,1,10,39
30,Success,53,32,0,14,39
30,Success,53,33,0,12,41
30,Success,51,32,4,13,38
30,Success,52,37,1,10,42
30,Success,50,34,10,6,44
30,Success,47,38,0,11,36
30,Success,54,31,6,9,45
30,Fail,43,41,0,15,28
30,Success,45,42,0,9,36
30,Fail,36,43,0,18,18
30,Success,50,37,0,12,38
30,Fail,44,38,0,16,28
30,Success,52,31,0,12,40
30,Success,54,31,5,10,44
30,Success,53,29,0,14,39
30,Success,50,39,6,5,45
30,Success,53,36,0,11,42
30,Success,50,34,3,13,37
30,Success,46,39,4,11,35
30,Success,48,39,0,13,35
30,Success,51,33,0,16,35
30,Success,48,30,0,10,38
30,Success,50,38,0,9,41
30,Success,51,29,6,14,37
30,Success,48,37,1,14,34
30,Success,53,28,0,15,38
30,Fail,40,38,0,19,21
30,Success,54,35,0,10,44
30,Success,55,29,6,10,45
30,Success,45,36,0,14,31
30,Success,58,27,3,12,46
30,Success,54,31,0,11,43
30,Success,54,25,0,15,39
30,Success,52,35,0,12,40
30,Success,43,33,13,11,32
30,Success,51,33,0,11,40
30,Success,46,46,0,7,39
30,Success,48,38,0,12,36
30,Success,52,38,0,9,43
30,Success,52,36,0,7,45
30,Fail,45,34,5,16,29
30,Fail,44,33,0,17,27
30,Success,45,37,4,14,31
30,Fail,41,40,0,16,25
30,Success,45,37,3,15,30
30,Success,53,35,0,11,42
30,Success,44,37,8,11,33
30,Success,55,28,7,10,45
30,Success,49,38,0,9,40
30,Fail,44,31,0,16,28
30,Success,48,34,0,10,38
30,Success,49,27,0,14,35
30,Success,51,34,0,14,37
30,Success,56,27,0,17,39
30,Success,48,31,0,17,31
30,Success,52,26,0,13,39
30,Success,45,39,0,14,31
30,Success,54,32,5,9,45
30,Success,58,35,0,7,51
30,Success,46,37,0,14,32
30,Fail,42,31,7,20,22
30,Fail,36,39,11,14,22
30,Success,56,33,0,9,47
30,Success,47,37,0,14,33
30,Success,48,40,0,10,38
30,Success,52,30,7,11,41
30,Success,54,34,0,9,45
30,Success,48,36,0,14,34
30,Success,48,43,1,8,40
30,Success,59,29,3,9,50
30,Success,45,36,10,9,36
30,Success,49,33,0,11,38
30,Success,45,38,3,14,31
30,Success,49,41,0,9,40
30,Success,54,29,6,11,43
30,Success,55,34,1,10,45
30,Success,56,31,0,12,44
30,Success,50,36,2,12,38
30,Success,51,34,4,11,40
30,Success,48,35,5,12,36
30,Success,47,43,2,8,39
30,Fail,38,45,7,10,28
30,Success,51,26,10,13,38
30,Success,44,36,6,14,30
30,Success,46,35,0,15,31
30,Success,46,34,6,14,32
30,Success,47,35,5,13,34
30,Success,48,43,1,8,40
30,Success,58,32,1,9,49
30,Fail,46,35,0,17,29
30,Success,47,37,7,9,38
30,Success,46,33,9,12,34
30,Success,52,33,0,11,41
30,Fail,46,35,0,17,29
30,Success,48,36,3,13,35
30,Success,47,42,0,8,39
30,Success,60,30,0,9,51
30,Success,52,42,2,4,48
30,Fail,43,34,0,14,29
30,Fail,40,35,11,14,26
30,Success,50,32,0,18,32
30,Success,49,40,3,8,41
30,Success,52,30,8,10,42
30,Success,46,34,0,13,33
30,Success,51,37,0,10,41
30,Success,53,26,0,15,38
30,Success,51,31,1,17,34
30,Success,47,34,0,17,30
30,Success,48,36,1,15,33
30,Success,45,35,7,13,32
30,Success,55,34,0,11,44
30,Success,51,29,4,16,35
30,Success,51,39,1,9,42
30,Fail,39,45,1,15,24
30,Success,44,40,0,14,30
30,Success,49,41,2,8,41
30,Success,53,30,0,14,39
30,Success,46,32,0,13,33
30,Success,52,33,1,14,38
30,Success,47,32,0,13,34
30,Success,40,48,2,10,30
30,Success,47,41,0,9,38
30,Success,43,40,5,12,31
30,Fail,39,44,0,11,28
30,Success,59,32,1,8,51
30,Success,50,31,0,14,36
30,Success,49,34,5,12,37
30,Success,52,40,3,5,47
30,Success,51,34,4,11,40
30,Success,48,37,2,13,35
30,Success,54,31,1,14,40
30,Success,46,36,4,14,32
30,Success,49,37,3,11,38
30,Success,47,38,1,14,33
30,Success,48,43,0,9,39
30,Success,43,44,0,8,35
30,Success,50,39,0,8,42
30,Fail,44,32,0,20,24
30,Fail,43,39,0,17,26
30,Success,53,33,0,9,44
30,Fail,41,44,0,13,28
30,Fail,43,34,0,17,26
30,Fail,42,35,8,15,27
30,Success,48,29,0,15,33
30,Success,46,36,0,13,33
30,Success,46,41,0,13,33
30,Success,50,37,1,12,38
30,Success,53,39,0,7,46
30,Success,52,34,2,12,40
30,Fail,40,45,0,12,28
30,Success,50,32,6,12,38
30,Success,54,31,2,13,41
30,Success,52,34,4,10,42
30,Fail,41,41,0,14,27
30,Success,55,30,1,14,41
30,Success,49,35,0,14,35
30,Fail,41,42,1,16,25
30,Fail,44,38,0,16,28
30,Success,46,34,0,11,35
30,Fail,41,35,4,20,21
30,Fail,37,39,9,15,22
30,Success,49,33,0,15,34
30,Fail,39,28,14,19,20
30,Success,50,29,0,13,37
30,Success,44,43,4,9,35
30,Success,52,38,0,9,43
30,Fail,46,34,0,18,28
30,Success,55,33,0,12,43
30,Success,51,36,0,13,38
30,Success,55,35,2,8,47
30,Fail,43,39,0,17,26
30,Fail,44,35,0,16,28
30,Success,46,37,4,13,33
30,Success,45,38,0,7,38
30,Success,50,32,6,12,38
30,Fail,43,37,0,14,29
30,Success,47,35,6,12,35
30,Success,52,40,1,7,45
30,Success,44,41,2,13,31
30,Success,51,34,2,13,38
30,Success,45,43,0,11,34
30,Success,52,27,0,17,35
30,Success,50,43,0,7,43
30,Success,46,39,2,13,33
30,Success,52,31,1,16,36
30,Success,44,34,0,14,30
30,Success,42,37,10,11,31
30,Success,55,31,7,7,48
30,Success,47,41,3,9,38
30,Success,49,32,0,18,31
30,Success,43,45,0,8,35
30,Success,54,33,0,11,43
30,Success,51,42,1,6,45
30,Success,49,33,5,13,36
30,Fail,46,31,0,17,29
30,Success,50,40,0,10,40
30,Success,59,30,0,9,50
30,Success,56,34,0,10,46
30,Success,55,34,1,10,45
30,Success,52,30,7,11,41
30,Success,60,26,0,13,47
30,Success,49,41,0,8,41
30,Success,51,36,0,10,41
30,Fail,44,36,4,16,28
30,Success,48,39,1,12,36
30,Success,47,36,6,11,36
30,Success,50,33,0,12,38
30,Success,50,34,3,13,37
30,Success,48,37,0,7,41
30,Success,42,42,0,12,30
30,Success,50,29,0,14,36
30,Success,55,35,0,9,46
30,Success,50,36,2,12,38
30,Fail,44,36,5,15,29
30,Fail,42,37,8,13,29
30,Success,50,31,7,12,38
30,Success,47,38,0,12,35
30,Success,49,36,0,12,37
30,Success,46,31,13,10,36
30,Success,55,33,2,10,45
30,Success,50,37,0,12,38
30,Success,47,36,3,14,33
30,Success,53,36,0,9,44
30,Success,50,34,0,13,37
30,Success,58,31,0,11,47
30,Success,58,34,0,6,52
30,Success,49,31,7,13,36
30,Success,46,40,1,13,33
30,Success,47,37,1,15,32
30,Success,58,32,0,10,48
30,Success,41,40,0,11,30
30,Success,46,32,8,14,32
30,Success,54,28,0,12,42
30,Success,56,29,0,13,43
30,Success,42,41,0,12,30
30,Success,52,31,0,13,39
30,Success,58,34,4,4,54
30,Fail,40,40,6,14,26
30,Fail,45,35,0,16,29
30,Success,49,33,0,12,37
30,Success,49,35,0,16,33
30,Success,49,31,0,11,38
30,Success,52,30,5,13,39
30,Success,54,33,0,13,41
30,Fail,40,44,5,11,29
30,Success,48,37,2,13,35
30,Success,45,36,9,10,35
30,Success,55,35,3,7,48
30,Success,47,40,3,10,37
30,Fail,40,33,0,12,28
30,Success,48,34,1,17,31
30,Fail,44,38,0,16,28
30,Fail,44,35,4,17,27
30,Success,45,35,5,15,30
30,Success,47,45,2,6,41
30,Success,50,37,6,7,43
30,Success,47,35,0,12,35
30,Success,58,30,0,12,46
30,Fail,42,42,0,14,28
30,Success,51,29,0,16,35
30,Success,50,38,0,8,42
30,Success,46,37,0,14,32
30,Success,51,37,0,10,41
30,Fail,41,44,2,13,28
30,Success,45,35,0,15,30
30,Success,51,33,3,13,38
30,Success,49,36,4,11,38
30,Fail,41,37,0,17,24
30,Success,47,36,3,14,33
30,Success,52,30,2,16,36
30,Success,55,33,1,11,44
30,Success,51,33,0,12,39
30,Success,51,35,0,13,38
30,Success,47,43,2,8,39
30,Success,47,40,2,11,36
30,Success,46,39,5,10,36
30,Success,53,35,2,10,43
30,Success,45,35,0,14,31
30,Success,47,36,3,14,33
30,Success,47,43,0,10,37
30,Success,51,34,1,14,37
30,Fail,42,39,2,17,25
30,Fail,45,34,4,17,28
30,Success,53,30,0,14,39
30,Success,53,34,0,10,43
30,Fail,47,29,0,22,25
30,Success,41,39,11,9,32
30,Success,48,34,0,15,33
30,Success,50,36,0,11,39
30,Success,44,36,0,13,31
30,Fail,42,36,8,14,28
30,Fail,42,35,0,18,24
30,Fail,44,36,0,20,24
30,Success,48,42,0,7,41
30,Fail,38,41,6,15,23
30,Success,51,38,0,9,42
30,Success,47,38,0,15,32
30,Success,45,38,3,14,31
30,Fail,43,35,3,19,24
30,Success,48,42,1,9,39
30,Success,57,31,0,9,48
30,Success,46,41,0,11,35
30,Success,48,33,3,16,32
30,Fail,47,28,6,19,28
30,Fail,45,33,0,16,29
30,Fail,45,32,5,18,27
30,Success,50,36,1,13,37
30,Success,52,34,0,10,42
30,Success,47,38,1,14,33
30,Fail,43,35,5,17,26
30,Success,53,32,0,15,38
30,Success,47,36,5,12,35
30,Fail,37,44,2,17,20
30,Fail,43,36,3,18,25
30,Success,47,36,3,14,33
30,Success,49,34,2,15,34
30,Success,56,27,0,15,41
30,Success,45,45,0,8,37
30,Success,55,31,4,10,45
30,Fail,41,33,0,16,25
30,Success,48,35,0,12,36
30,Success,49,34,3,14,35
30,Success,45,39,2,14,31
30,Success,45,35,0,15,30
30,Success,47,40,1,12,35
30,Success,57,30,0,12,45
30,Fail,39,40,3,18,21
30,Success,51,31,2,16,35
30,Success,50,33,0,13,37
30,Success,49,38,0,10,39
30,Success,44,39,0,11,33
30,Fail,40,39,0,15,25
30,Success,52,26,10,12,40
30,Success,47,30,11,12,35
30,Fail,42,29,0,19,23
30,Success,50,41,0,8,42
30,Success,51,36,1,12,39
30,Fail,45,32,0,17,28
30,Fail,46,33,0,18,28
30,Success,51,34,0,13,38
30,Fail,45,35,0,16,29
30,Fail,44,37,0,18,26
30,Success,54,32,0,12,42
30,Success,51,28,7,14,37
30,Success,51,35,2,12,39
30,Fail,30,44,0,13,17
30,Fail,47,35,0,18,29
30,Success,53,37,3,7,46
30,Fail,45,34,0,18,27
30,Success,47,32,4,17,30
30,Success,54,33,0,12,42
30,Success,56,34,6,4,52
30,Fail,37,44,6,13,24
30,Success,47,34,6,13,34
30,Success,49,32,0,15,34
30,Success,49,41,0,8,41
30,Success,48,38,3,11,37
30,Success,50,36,0,13,37
30,Success,49,43,0,7,42
30,Success,47,31,7,15,32
30,Success,50,31,6,13,37
30,Success,45,42,0,10,35
30,Success,52,29,0,14,38
30,Success,55,35,0,8,47
30,Fail,43,31,9,17,26
30,Success,48,40,2,10,38
30,Success,54,31,5,10,44
30,Success,44,42,4,10,34
30,Success,45,48,0,7,38
30,Fail,46,30,0,22,24
30,Success,44,42,1,13,31
30,Success,58,37,0,5,53
30,Success,53,32,0,14,39
30,Success,49,33,0,14,35
30,Success,50,33,0,14,36
30,Success,56,33,0,11,45
30,Success,49,37,2,12,37
30,Success,48,41,1,10,38
30,Success,56,34,1,9,47
30,Success,52,36,2,10,42
30,Success,61,33,0,5,56
30,Success,46,43,0,10,36
30,Fail,39,47,2,12,27
30,Success,51,29,0,16,35
30,Success,48,36,0,6,42
30,Success,50,31,0,15,35
30,Success,51,35,0,11,40
30,Success,49,34,0,16,33
30,Success,44,44,2,10,34
30,Success,49,39,0,12,37
30,Fail,44,39,0,16,28
30,Success,44,42,0,14,30
30,Success,54,27,4,15,39
30,Success,48,29,0,17,31
30,Success,49,42,0,7,42
30,Success,50,37,0,10,40
30,Success,45,41,5,9,36
30,Success,45,36,4,15,30
30,Fail,36,32,0,22,14
30,Success,50,33,1,16,34
30,Success,51,36,0,13,38
30,Success,51,33,0,13,38
30,Success,45,38,0,8,37
30,Success,59,26,5,10,49
30,Success,53,35,0,11,42
30,Success,44,39,4,13,31
30,Success,48,38,0,13,35
30,Success,48,28,12,12,36
30,Success,50,28,7,15,35
30,Success,50,40,5,5,45
30,Success,48,40,0,11,37
30,Success,45,36,9,10,35
30,Success,51,29,0,18,33
30,Success,53,36,0,11,42
30,Success,46,39,0,11,35
30,Success,42,43,0,11,31
30,Success,55,35,0,10,45
30,Success,44,39,0,13,31
30,Fail,42,40,4,14,28
30,Success,42,43,0,12,30
30,Success,47,37,7,9,38
30,Fail,42,41,0,17,25
30,Success,52,40,0,8,44
30,Fail,40,35,9,16,24
30,Fail,38,29,14,19,19
30,Success,53,32,4,11,42
30,Fail,41,35,0,13,28
30,Fail,45,31,0,23,22
30,Success,51,38,3,8,43
30,Success,45,41,0,11,34
30,Fail,38,41,0,14,24
30,Success,52,31,0,13,39
30,Success,48,30,7,15,33
30,Success,46,34,0,16,30
30,Fail,46,35,0,19,27
30,Success,45,41,0,12,33
30,Success,51,31,0,11,40
30,Success,47,35,0,14,33
30,Success,50,30,3,17,33
30,Success,52,32,0,14,38
30,Success,51,36,4,9,42
30,Success,51,37,0,11,40
30,Success,47,37,0,6,41
30,Success,45,38,0,13,32
30,Success,50,38,0,7,43
30,Success,50,34,0,14,36
30,Success,54,37,1,8,46
30,Success,49,34,2,15,34
30,Success,46,34,6,14,32
30,Success,47,34,0,16,31
30,Success,56,31,0,13,43
30,Success,49,34,0,9,40
30,Success,45,41,0,14,31
30,Success,48,32,7,13,35
30,Fail,44,37,4,15,29
30,Success,47,43,0,9,38
30,Fail,43,38,5,14,29
30,Success,48,31,9,12,36
30,Success,49,40,0,11,38
30,Success,48,41,0,11,37
30,Success,52,34,2,12,40
30,Success,53,35,2,10,43
30,Success,51,41,0,8,43
30,Success,45,39,0,11,34
30,Success,42,46,0,7,35
30,Success,47,33,0,17,30
30,Success,57,34,0,8,49
30,Success,48,31,9,12,36
30,Fail,43,37,0,15,28
30,Fail,48,31,0,19,29
30,Fail,39,40,4,17,22
30,Success,48,36,5,11,37
30,Fail,40,37,4,19,21
30,Success,47,34,5,14,33
30,Success,43,37,10,10,33
30,Success,48,35,5,12,36
30,Success,52,30,7,11,41
30,Fail,41,43,3,13,28
30,Success,50,41,3,6,44
30,Fail,43,40,0,15,28
30,Success,46,35,0,14,32
30,Success,49,37,2,12,37
30,Success,49,40,0,8,41
30,Success,44,39,4,13,31
30,Success,54,37,0,6,48
30,Success,52,33,1,14,38
30,Fail,44,33,0,15,29
30,Success,52,41,0,5,47
30,Success,51,35,4,10,41
30,Success,46,34,0,12,34
30,Fail,44,26,11,19,25
30,Success,46,35,0,13,33
30,Success,45,35,0,13,32
30,Fail,36,38,0,21,15
30,Fail,44,35,0,17,27
30,Success,56,29,0,15,41
30,Success,51,33,0,10,41
30,Success,49,34,0,10,39
30,Success,50,40,1,9,41
30,Success,48,29,10,13,35
30,Success,50,38,3,9,41
30,Success,45,37,0,11,34
30,Success,51,37,0,12,39
30,Success,48,34,0,9,39
30,Success,51,33,0,14,37
30,Fail,42,33,3,22,20
30,Success,48,39,4,9,39
30,Fail,45,35,2,18,27
30,Fail,46,35,0,19,27
30,Fail,44,39,1,16,28
30,Success,56,32,0,10,46
30,Fail,40,33,0,14,26
30,Success,50,28,6,16,34
30,Success,45,47,2,6,39
30,Success,50,41,3,6,44
30,Success,53,29,0,8,45
30,Success,48,37,0,12,36
30,Success,57,35,0,7,50
30,Success,58,36,2,4,54
30,Fail,39,41,8,12,27
30,Success,45,39,0,12,33
30,Success,54,29,0,15,39
30,Success,51,32,4,13,38
30,Success,51,39,0,6,45
30,Fail,45,34,0,18,27
30,Success,46,38,0,14,32
30,Success,53,28,8,11,42
30,Success,51,35,0,14,37
30,Success,54,37,0,8,46
30,Success,45,44,0,10,35
30,Success,45,39,0,12,33
30,Success,54,29,7,10,44
30,Success,50,41,0,9,41
30,Success,46,36,5,13,33
30,Success,49,42,0,8,41
30,Success,54,26,10,10,44
30,Success,46,37,4,13,33
30,Success,47,29,12,12,35
30,Fail,45,38,0,16,29
30,Success,44,40,0,12,32
30,Success,47,32,6,15,32
30,Success,48,30,6,16,32
30,Success,52,38,0,9,43
30,Success,47,38,0,13,34
30,Success,54,35,0,10,44
30,Success,48,37,0,12,36
30,Fail,43,32,0,16,27
30,Success,50,38,0,9,41
30,Success,49,39,0,12,37
30,Success,43,37,0,13,30
30,Success,45,38,0,11,34
30,Success,48,32,0,18,30
30,Success,49,39,0,8,41
30,Success,50,30,0,15,35
30,Fail,41,46,0,12,29
30,Success,56,32,0,10,46
30,Success,44,38,6,12,32
30,Success,51,35,0,11,40
30,Fail,41,45,0,13,28
30,Success,44,47,1,8,36
30,Success,46,40,0,14,32
30,Success,46,36,0,15,31
30,Fail,49,29,0,21,28
30,Success,47,32,7,14,33
30,Success,43,36,0,10,33
30,Success,46,36,0,16,30
30,Success,50,36,0,11,39
30,Success,52,29,5,14,38
30,Success,48,36,4,12,36
30,Success,45,36,10,9,36
30,Success,63,28,0,9,54
30,Success,48,29,0,15,33
30,Success,49,38,0,10,39
30,Success,53,34,0,10,43
30,Success,46,41,2,11,35
30,Success,44,42,3,11,33
30,Success,54,33,2,11,43
30,Success,42,41,9,8,34
30,Success,51,39,0,9,42
30,Success,50,36,0,14,36
30,Fail,37,35,10,18,19
30,Success,50,33,0,14,36
30,Success,52,33,4,11,41
30,Success,47,35,3,15,32
30,Success,54,41,0,4,50
30,Success,46,34,0,16,30
30,Fail,40,33,0,17,23
30,Success,47,39,0,12,35
30,Success,46,42,1,11,35
30,Success,49,35,0,13,36
30,Success,49,30,6,15,34
30,Success,47,36,1,16,31
30,Success,55,32,0,7,48
30,Success,50,34,0,13,37
30,Success,46,37,0,14,32
30,Success,50,43,0,7,43
30,Success,51,33,3,13,38
30,Success,48,30,9,13,35
30,Success,46,40,0,14,32
30,Success,45,43,1,11,34
30,Fail,46,31,0,18,28
30,Success,50,34,0,15,35
30,Success,50,35,0,11,39
30,Success,51,38,1,10,41
30,Success,52,35,0,11,41
30,Success,50,37,0,12,38
30,Success,51,30,0,16,35
30,Success,42,41,0,12,30
30,Success,51,32,0,12,39
30,Success,44,42,0,14,30
30,Fail,38,39,0,17,21
30,Success,44,39,3,14,30
30,Success,43,37,9,11,32
30,Fail,45,31,0,22,23
30,Success,42,43,0,10,32
30,Success,47,37,1,15,32
30,Success,46,37,0,11,35
30,Success,58,29,6,7,51
30,Success,46,37,3,14,32
30,Fail,42,42,0,16,26
30,Success,51,38,0,9,42
30,Fail,37,49,0,11,26
30,Success,45,39,7,9,36
30,Fail,46,31,0,20,26
30,Fail,44,29,12,15,29
30,Success,52,35,0,9,43
30,Success,50,38,0,9,41
30,Fail,46,35,2,17,29
30,Success,57,22,7,14,43
30,Fail,41,40,6,13,28
30,Success,47,39,5,9,38
30,Fail,43,37,0,15,28
30,Fail,41,34,0,14,27
30,Success,47,35,10,8,39
30,Success,48,35,4,13,35
30,Fail,44,36,0,19,25
30,Success,53,29,0,12,41
30,Success,54,36,2,8,46
30,Success,46,38,1,15,31
30,Success,54,33,0,9,45
30,Success,41,39,0,11,30
30,Success,49,34,0,13,36
30,Success,48,38,4,10,38
30,Fail,42,29,0,20,22
30,Success,55,31,2,12,43
30,Success,47,39,3,11,36
30,Success,50,35,0,13,37
30,Fail,43,34,0,19,24
30,Success,48,38,0,11,37
30,Success,54,30,2,14,40
30,Success,53,33,0,14,39
30,Success,51,37,0,8,43
30,Success,47,37,0,12,35
30,Success,46,38,0,16,30
30,Fail,40,42,1,17,23
30,Success,50,35,0,14,36
30,Success,48,32,5,15,33
30,Success,51,30,0,8,43
30,Success,47,34,0,8,39
30,Success,45,41,0,13,32
30,Fail,35,49,0,12,23
30,Fail,40,36,6,18,22
30,Fail,37,42,1,20,17
30,Fail,42,32,9,17,25
30,Success,55,29,2,14,41
30,Fail,41,38,0,18,23
30,Success,46,34,5,15,31
30,Success,46,40,1,13,33
30,Success,41,42,0,11,30
30,Success,57,29,0,14,43
30,Success,46,36,0,11,35
30,Success,48,38,1,13,35
30,Success,43,40,5,12,31
30,Success,53,34,4,9,44
30,Success,52,34,0,11,41
30,Success,57,27,0,13,44
30,Success,47,44,0,9,38
30,Success,47,41,4,8,39
30,Fail,43,39,0,15,28
30,Success,52,31,6,11,41
30,Success,50,36,0,11,39
30,Success,54,21,0,21,33
30,Success,46,41,0,10,36
30,Success,51,33,4,12,39
30,Success,57,35,0,8,49
30,Success,44,42,0,13,31
30,Fail,40,32,8,20,20
30,Fail,38,43,1,18,20
30,Success,46,37,7,10,36
30,Success,48,43,0,8,40
30,Success,47,36,3,14,33
30,Success,45,29,11,15,30
30,Success,46,36,10,8,38
30,Success,51,36,0,13,38
30,Success,43,34,0,12,31
30,Success,56,29,0,10,46
30,Fail,43,41,0,14,29
30,Success,54,33,1,12,42
30,Success,54,33,0,13,41
30,Success,56,31,1,12,44
30,Fail,37,32,0,20,17
30,Success,57,34,0,7,50
30,Success,48,27,8,17,31
30,Success,46,39,0,15,31
30,Success,51,27,9,13,38
30,Success,49,39,0,10,39
30,Success,53,31,0,11,42
30,Success,51,29,0,17,34
30,Success,47,37,4,12,35
30,Success,46,43,0,11,35
30,Success,50,31,0,14,36
30,Success,46,41,0,12,34
30,Fail,43,31,0,18,25
30,Success,50,37,0,13,37
30,Success,49,36,2,13,36
30,Fail,45,35,0,16,29
30,Success,52,36,4,8,44
30,Success,50,32,1,17,33
30,Success,49,35,1,15,34
30,Success,46,36,7,11,35
30,Success,50,33,0,11,39
30,Success,53,28,5,14,39
30,Success,48,36,0,10,38
30,Success,53,34,0,11,42
30,Success,46,40,0,13,33
30,Success,47,38,1,14,33
30,Success,59,28,4,9,50
30,Success,47,38,0,9,38
30,Success,48,34,0,18,30
30,Success,51,36,2,11,40
30,Success,47,38,0,11,36
30,Success,55,34,0,10,45
30,Success,45,43,1,11,34
30,Success,47,38,4,11,36
30,Success,52,26,0,16,36
30,Success,53,31,4,12,41
30,Success,57,32,0,8,49
30,Success,56,27,4,13,43
30,Fail,39,44,1,16,23
30,Success,51,33,6,10,41
30,Fail,38,49,0,13,25
30,Success,42,38,0,12,30
30,Success,49,31,3,17,32
30,Success,57,34,0,8,49
30,Success,46,38,1,15,31
30,Success,50,31,0,13,37
30,Fail,42,39,0,18,24
30,Fail,41,36,0,18,23
30,Fail,41,35,9,15,26
30,Success,46,35,9,10,36
30,Fail,40,42,5,13,27
30,Success,50,38,1,11,39
30,Success,42,40,0,11,31
30,Success,47,32,5,16,31
30,Success,48,35,2,15,33
30,Success,52,34,0,14,38
30,Success,49,37,0,14,35
30,Fail,43,35,0,15,28
30,Fail,38,36,5,21,17
30,Success,57,26,0,14,43
30,Success,56,29,0,12,44
30,Success,49,32,6,13,36
30,Success,57,28,6,9,48
30,Success,52,35,0,9,43
30,Success,47,37,1,15,32
30,Success,59,29,0,11,48
30,Fail,47,33,1,19,28
30,Success,48,33,0,9,39
30,Success,51,32,0,15,36
30,Fail,40,35,4,21,19
30,Success,53,36,3,8,45
30,Success,47,39,0,13,34
30,Success,43,43,0,10,33
30,Fail,45,36,0,18,27
30,Success,50,37,0,11,39
30,Success,47,34,0,16,31
30,Fail,42,30,0,25,17
30,Success,51,36,3,10,41
30,Success,50,39,3,8,42
30,Success,46,28,13,13,33
30,Fail,41,37,2,20,21
30,Success,49,35,0,10,39
30,Success,51,35,5,9,42
30,Success,46,42,2,10,36
30,Success,47,41,3,9,38
30,Success,51,36,0,9,42
30,Success,50,35,1,14,36
30,Success,47,35,8,10,37
30,Success,44,40,5,11,33
30,Success,48,39,0,11,37
30,Success,48,28,7,17,31
30,Fail,47,31,0,18,29
30,Fail,40,37,3,20,20
30,Success,50,36,3,11,39
30,Fail,41,39,6,14,27
30,Success,60,27,2,11,49
30,Success,52,31,8,9,43
30,Success,49,37,3,11,38
30,Success,57,29,0,13,44
30,Success,46,37,0,16,30
30,Success,48,38,3,11,37
30,Fail,40,42,0,11,29
30,Success,49,33,4,14,35
30,Success,51,34,0,14,37
30,Success,51,35,1,13,38
30,Success,50,39,0,7,43
30,Success,42,36,11,11,31
30,Success,57,32,2,9,48
30,Success,43,41,0,9,34
30,Success,45,39,3,13,32
30,Success,43,41,0,12,31
30,Success,54,28,0,10,44
30,Success,46,37,4,13,33
30,Success,53,36,2,9,44
30,Success,49,42,0,8,41
30,Success,47,37,3,13,34
30,Fail,42,36,0,18,24
30,Success,46,35,0,13,33
30,Success,50,39,5,6,44
30,Success,52,37,6,5,47
30,Success,54,32,3,11,43
30,Success,48,30,0,14,34
30,Success,54,33,4,9,45
30,Success,43,39,6,12,31
30,Success,50,31,0,17,33
30,Success,57,27,4,12,45
30,Success,45,38,0,14,31
30,Success,51,40,0,7,44
30,Success,49,41,0,9,40
30,Fail,41,38,2,19,22
30,Success,48,36,0,14,34
30,Success,50,36,2,12,38
30,Success,50,37,0,13,37
30,Success,44,41,0,9,35
30,Success,52,36,3,9,43
30,Success,52,33,2,13,39
30,Success,48,35,4,13,35
30,Success,51,40,1,8,43
30,Success,44,39,4,13,31
30,Success,54,27,5,14,40
30,Success,44,30,13,13,31
30,Fail,44,32,0,16,28
30,Success,49,39,0,7,42
30,Success,52,37,1,10,42
30,Success,52,34,7,7,45
30,Fail,41,38,0,17,24
30,Success,52,35,2,11,41
30,Success,45,45,0,5,40
30,Success,44,38,0,14,30
30,Success,49,35,0,12,37
30,Success,46,40,4,10,36
30,Success,50,25,9,16,34
30,Success,56,29,2,13,43
30,Fail,40,44,0,16,24
30,Success,45,39,4,12,33
30,Success,50,35,2,13,37
30,Fail,37,44,7,12,25
30,Success,53,30,0,11,42
30,Success,48,41,0,11,37
30,Fail,40,42,4,14,26
30,Success,52,38,0,10,42
30,Success,50,30,0,17,33
30,Success,45,39,7,9,36
30,Success,49,28,4,19,30
30,Success,43,37,0,13,30
30,Success,49,34,0,14,35
30,Success,47,38,4,11,36
30,Fail,44,34,0,16,28
30,Success,49,34,4,13,36
30,Success,53,41,0,6,47
30,Success,47,37,4,12,35
30,Success,61,28,0,6,55
30,Success,50,35,0,10,40
30,Success,48,33,2,17,31
30,Success,50,40,0,8,42
30,Fail,45,35,4,16,29
30,Fail,41,39,4,16,25
30,Fail,42,43,0,15,27
30,Fail,43,39,0,16,27
30,Success,51,32,5,12,39
30,Success,61,32,0,7,54
30,Success,51,38,0,11,40
30,Fail,39,30,11,20,19
30,Fail,44,40,0,16,28
30,Fail,48,32,0,19,29
30,Success,51,33,0,14,37
30,Success,52,29,1,18,34
30,Fail,44,31,8,17,27
30,Success,48,36,0,6,42
30,Fail,43,31,6,20,23
30,Success,49,33,2,16,33
30,Fail,42,41,0,16,26
30,Success,53,35,0,7,46
30,Success,48,40,2,10,38
30,Success,47,36,0,15,32
30,Success,49,36,5,10,39
30,Success,49,36,0,15,34
30,Success,44,37,5,14,30
30,Fail,46,35,0,17,29
30,Fail,41,39,7,13,28
30,Fail,42,30,10,18,24
30,Success,47,39,0,9,38
30,Success,47,32,0,14,33
30,Success,46,38,0,14,32
30,Success,44,40,4,12,32
30,Success,45,34,0,14,31
30,Success,48,37,0,15,33
30,Success,52,34,0,13,39
30,Success,48,30,6,16,32
30,Success,43,43,4,10,33
30,Success,48,39,0,9,39
30,Success,48,37,3,12,36
30,Success,53,37,0,9,44
30,Success,46,38,2,14,32
30,Success,46,40,0,13,33
30,Success,49,35,0,16,33
30,Success,55,30,0,10,45
30,Success,49,37,0,13,36
30,Success,47,40,0,12,35
30,Fail,44,28,0,17,27
30,Success,57,29,0,13,44
30,Success,45,38,3,14,31
30,Success,49,34,2,15,34
30,Success,48,38,2,12,36
30,Fail,42,39,0,13,29
30,Success,46,42,0,12,34
30,Success,52,41,0,6,46
30,Fail,45,32,0,19,26
30,Fail,44,37,0,18,26
30,Success,48,35,0,16,32
30,Success,55,31,0,11,44
30,Success,51,31,0,11,40
30,Success,50,39,1,10,40
30,Success,51,38,0,7,44
30,Success,45,37,0,10,35
30,Success,48,36,5,11,37
30,Success,49,40,0,4,45
30,Success,51,32,3,14,37
30,Fail,47,32,3,18,29
30,Success,45,40,0,10,35
30,Success,49,42,0,9,40
30,Success,48,28,0,16,32
30,Success,47,33,0,12,35
30,Success,52,35,0,11,41
30,Success,48,34,0,17,31
30,Fail,41,41,0,14,27
30,Success,44,41,1,14,30
30,Success,45,41,1,13,32
30,Success,45,42,4,9,36
30,Success,53,28,0,14,39
30,Success,45,41,1,13,32
30,Success,48,32,10,10,38
30,Fail,41,31,15,13,28
30,Success,44,36,6,14,30
30,Success,48,37,0,10,38
30,Success,47,38,0,12,35
30,Success,49,32,13,6,43
30,Success,51,36,1,12,39
30,Success,48,37,1,14,34
30,Success,52,37,4,7,45
30,Success,50,37,5,8,42
30,Success,46,37,0,15,31
30,Success,50,36,0,14,36
30,Success,49,40,4,7,42
30,Success,45,38,0,14,31
30,Success,47,37,0,11,36
30,Fail,45,36,0,16,29
30,Fail,45,37,2,16,29
30,Success,52,29,4,15,37
30,Success,55,32,3,10,45
30,Fail,43,36,6,15,28
30,Success,50,36,0,10,40
30,Success,46,34,0,12,34
30,Success,44,38,5,13,31
30,Success,43,42,5,10,33
30,Success,45,38,0,13,32
30,Fail,43,41,0,14,29
30,Success,54,29,0,15,39
30,Success,47,37,7,9,38
30,Success,47,36,0,13,34
30,Success,53,34,0,7,46
30,Success,45,38,3,14,31
30,Fail,44,33,0,17,27
30,Fail,41,34,0,18,23
30,Success,48,35,0,14,34
30,Success,53,34,2,11,42
30,Success,48,40,1,11,37
30,Success,44,39,0,12,32
30,Success,45,38,6,11,34
30,Success,51,35,0,11,40
30,Success,46,41,3,10,36
30,Success,54,37,0,7,47
30,Success,51,33,0,13,38
30,Success,46,33,7,14,32
30,Success,44,34,11,11,33
30,Success,47,36,0,16,31
30,Success,47,37,4,12,35
30,Fail,41,39,0,13,28
30,Success,46,42,0,6,40
30,Success,50,38,0,10,40
30,Success,47,41,4,8,39
30,Success,60,32,0,7,53
30,Success,55,33,2,10,45
30,Success,52,30,0,18,34
30,Success,49,39,0,10,39
30,Success,42,39,8,11,31
30,Success,47,35,1,17,30
30,Success,50,32,10,8,42
30,Success,47,33,0,14,33
30,Fail,45,29,6,20,25
30,Success,46,36,7,11,35
30,Success,53,34,4,9,44
30,Success,49,41,0,8,41
30,Success,53,27,3,17,36
30,Success,51,36,0,10,41
30,Success,47,36,0,16,31
30,Fail,34,41,8,17,17
30,Fail,44,33,0,15,29
30,Success,50,36,0,10,40
30,Success,48,43,0,6,42
30,Success,46,40,0,10,36
30,Fail,49,27,0,24,25
30,Fail,44,35,0,21,23
30,Success,47,40,0,10,37
30,Success,48,37,0,11,37
30,Success,42,40,0,11,31
30,Success,45,37,0,12,33
30,Fail,36,48,0,12,24
30,Fail,42,39,1,18,24
30,Success,48,41,2,9,39
30,Fail,45,34,5,16,29
30,Success,53,29,1,17,36
30,Success,46,44,2,8,38
30,Success,58,35,0,6,52
30,Success,54,33,0,13,41
30,Fail,44,39,2,15,29
30,Success,50,35,0,13,37
30,Success,48,36,0,10,38
30,Fail,37,45,2,16,21
30,Success,42,36,0,12,30
30,Fail,42,39,0,15,27
30,Success,49,30,4,17,32
30,Success,54,37,2,7,47
30,Success,55,28,11,6,49
30,Success,48,32,0,11,37
30,Success,52,36,0,11,41
30,Success,50,35,0,11,39
30,Success,54,35,0,11,43
30,Success,49,33,0,15,34
30,Success,48,36,0,12,36
30,Success,51,38,2,9,42
30,Success,56,35,0,9,47
30,Fail,41,39,0,13,28
30,Success,45,40,0,11,34
30,Success,49,34,0,12,37
30,Success,52,41,0,7,45
30,Success,53,38,0,8,45
30,Success,47,41,0,9,38
30,Success,53,38,0,9,44
30,Success,47,32,8,13,34
30,Success,49,36,1,14,35
30,Success,52,32,1,15,37
30,Fail,42,37,5,16,26
30,Success,51,38,0,8,43
30,Success,49,33,11,7,42
30,Success,49,33,1,17,32
30,Fail,42,39,6,13,29
30,Success,51,30,1,18,33
30,Success,54,41,0,5,49
30,Success,48,41,0,3,45
30,Success,55,33,0,10,45
30,Success,44,37,0,11,33
30,Success,54,31,0,12,42
30,Success,53,35,3,9,44
30,Success,46,37,4,13,33
30,Success,48,27,9,16,32
30,Fail,47,31,1,21,26
30,Success,50,35,0,11,39
30,Success,47,38,4,11,36
30,Success,46,35,10,9,37
30,Success,54,35,1,10,44
30,Success,55,27,0,16,39
30,Success,47,35,2,16,31
30,Success,47,36,4,13,34
30,Success,47,37,0,15,32
30,Fail,46,33,0,19,27
30,Success,52,36,0,8,44
30,Success,55,34,0,10,45
30,Success,45,44,3,8,37
30,Success,54,37,0,9,45
30,Success,58,30,0,7,51
30,Success,56,27,0,14,42
30,Success,51,31,2,16,35
30,Success,48,33,1,18,30
30,Success,50,29,4,17,33
30,Success,53,28,8,11,42
30,Success,47,40,1,12,35
30,Success,53,31,0,13,40
30,Fail,45,27,0,16,29
30,Success,46,34,0,16,30
30,Fail,44,33,7,16,28
30,Success,44,32,0,13,31
30,Success,50,34,0,10,40
30,Success,51,36,4,9,42
30,Fail,43,38,4,15,28
30,Success,53,30,5,12,41
30,Success,46,32,0,13,33
30,Fail,43,40,3,14,29
30,Success,49,36,4,11,38
30,Success,53,31,2,14,39
30,Success,45,39,0,11,34
30,Success,46,43,0,9,37
30,Success,54,30,7,9,45
30,Success,44,44,0,9,35
30,Success,44,40,3,13,31
30,Success,53,33,0,13,40
30,Success,55,34,0,9,46
30,Success,46,40,0,13,33
30,Success,51,40,0,9,42
30,Success,44,42,0,12,32
30,Success,53,35,0,10,43
30,Success,50,37,0,10,40
30,Success,47,34,4,15,32
30,Fail,50,26,0,22,28
30,Success,48,33,0,11,37
30,Success,51,41,0,7,44
30,Success,46,29,0,10,36
30,Success,43,40,0,13,30
30,Fail,47,29,5,19,28
30,Success,48,36,2,14,34
30,Fail,39,42,8,11,28
30,Success,46,41,0,6,40
30,Fail,44,39,1,16,28
30,Success,45,35,5,15,30
30,Success,49,30,5,16,33
30,Success,52,30,0,10,42
30,Success,50,36,0,14,36
30,Success,49,32,0,15,34
30,Success,50,32,3,15,35
30,Success,45,38,0,15,30
30,Success,46,40,0,13,33
30,Success,46,41,0,10,36
30,Success,52,37,0,11,41
30,Success,57,37,0,6,51
30,Success,48,30,8,14,34
30,Success,47,34,0,17,30
30,Success,50,37,0,11,39
30,Success,55,34,2,9,46
30,Success,55,29,2,14,41
30,Fail,39,43,2,16,23
30,Success,46,37,5,12,34
30,Fail,40,36,0,16,24
30,Fail,45,34,0,18,27
30,Success,46,38,1,15,31
30,Success,50,38,5,7,43
30,Success,47,40,0,12,35
30,Success,44,43,0,8,36
30,Success,51,30,0,13,38
30,Fail,48,26,0,20,28
30,Fail,44,36,0,19,25
30,Fail,45,35,0,18,27
30,Fail,42,34,0,16,26
30,Fail,40,40,0,18,22
30,Success,53,35,3,9,44
30,Fail,45,37,1,17,28
30,Success,55,35,1,9,46
30,Fail,43,39,2,16,27
30,Fail,38,41,0,12,26
30,Success,54,38,0,6,48
30,Success,52,34,0,13,39
30,Success,51,33,0,12,39
30,Success,54,36,0,10,44
30,Success,48,38,0,8,40
30,Fail,41,43,4,12,29
30,Fail,45,34,0,16,29
30,Success,47,45,0,7,40
30,Success,55,38,1,6,49
30,Fail,39,46,2,13,26
30,Fail,42,40,0,15,27
30,Success,51,34,0,14,37
30,Success,46,36,4,14,32
30,Success,44,41,0,9,35
30,Success,44,38,9,9,35
30,Success,49,31,0,17,32
30,Success,49,38,2,11,38
30,Fail,38,50,0,10,28
30,Success,47,33,0,12,35
30,Success,51,35,0,14,37
30,Success,52,28,3,17,35
30,Success,48,34,0,16,32
30,Success,51,33,0,14,37
30,Success,49,36,0,11,38
30,Success,53,35,1,11,42
30,Success,43,39,5,13,30
30,Success,45,29,0,14,31
30,Success,50,37,3,10,40
30,Success,54,34,2,10,44
30,Success,52,25,4,19,33
30,Success,52,27,0,16,36
30,Success,48,41,0,10,38
30,Success,49,30,0,19,30
30,Fail,42,37,2,19,23
30,Success,47,42,0,7,40
30,Fail,40,40,4,16,24
30,Success,54,34,2,10,44
30,Success,48,35,0,16,32
30,Success,54,31,4,11,43
30,Fail,44,41,0,15,29
30,Success,47,34,0,16,31
30,Success,45,43,4,8,37
30,Success,51,38,0,11,40
30,Success,53,35,0,8,45
30,Fail,40,35,7,18,22
30,Success,54,36,2,8,46
30,Success,46,35,0,16,30
30,Success,50,37,0,11,39
30,Success,58,37,0,4,54
30,Success,50,36,0,11,39
30,Success,52,31,0,13,39
30,Fail,43,35,5,17,26
30,Success,53,34,0,12,41
30,Success,50,34,0,12,38
30,Success,47,39,0,11,36
30,Success,53,35,0,7,46
30,Success,50,35,0,13,37
30,Fail,40,41,7,12,28
30,Success,54,30,6,10,44
30,Fail,43,38,5,14,29
30,Success,52,30,1,17,35
30,Success,51,32,3,14,37
30,Success,44,39,0,7,37
30,Success,47,34,0,11,36
30,Success,46,41,0,9,37
30,Success,51,33,0,13,38
30,Success,58,31,5,6,52
30,Success,48,39,0,9,39
30,Success,48,36,0,13,35
30,Fail,48,28,5,19,29
30,Fail,46,36,0,18,28
30,Success,44,37,0,14,30
30,Success,57,35,0,7,50
30,Success,49,33,3,15,34
30,Success,52,32,0,14,38
30,Success,55,37,4,4,51
30,Success,45,42,0,10,35
30,Success,46,38,0,13,33
30,Success,49,37,0,11,38
30,Fail,44,36,0,15,29
30,Success,51,36,1,12,39
30,Success,48,36,0,15,33
30,Success,49,40,0,11,38
30,Success,52,30,2,16,36
30,Success,53,31,2,14,39
30,Success,47,36,0,15,32
30,Success,49,35,3,13,36
30,Success,49,41,3,7,42
30,Success,57,29,0,13,44
30,Success,50,36,0,14,36
30,Success,46,39,0,11,35
30,Fail,42,41,4,13,29
30,Success,51,35,6,8,43
30,Success,51,34,1,14,37
30,Success,46,33,0,14,32
30,Success,51,36,0,11,40
30,Success,58,27,0,13,45
30,Success,42,40,7,11,31
30,Success,49,39,4,8,41
30,Success,48,34,3,15,33
30,Success,51,35,0,12,39
30,Fail,42,41,2,15,27
30,Fail,45,31,0,19,26
30,Success,54,35,0,10,44
30,Success,58,33,0,7,51
30,Success,51,32,0,17,34
30,Success,57,35,0,8,49
30,Success,46,40,1,13,33
30,Success,46,40,0,11,35
30,Success,50,31,0,12,38
30,Success,44,36,8,12,32
30,Success,50,41,2,7,43
30,Fail,45,34,4,17,28
30,Success,46,38,6,10,36
30,Success,49,36,0,12,37
30,Success,48,38,2,12,36
30,Success,55,29,0,15,40
30,Success,51,33,0,11,40
30,Success,50,36,0,13,37
30,Success,46,41,1,12,34
30,Success,48,30,0,17,31
30,Fail,42,33,9,16,26
30,Success,50,31,4,15,35
30,Success,56,28,2,14,42
30,Success,50,35,0,13,37
30,Success,50,40,1,9,41
30,Success,50,39,0,10,40
30,Success,53,42,0,5,48
30,Success,52,33,0,13,39
30,Success,53,34,5,8,45
30,Success,48,34,0,13,35
30,Success,45,38,2,15,30
30,Success,52,28,0,16,36
30,Success,51,34,0,14,37
30,Success,57,33,0,8,49
30,Success,54,33,5,8,46
30,Success,51,39,0,10,41
30,Success,51,37,0,9,42
30,Success,53,33,1,13,40
30,Fail,43,40,0,15,28
30,Fail,35,41,8,16,19
30,Success,54,31,0,15,39
30,Success,51,39,0,9,42
30,Fail,43,28,8,21,22
30,Success,49,36,1,14,35
30,Success,55,29,3,13,42
30,Success,55,32,0,11,44
30,Success,47,38,2,13,34
30,Success,56,37,0,6,50
30,Success,50,32,0,18,32
30,Success,48,33,7,12,36
30,Success,52,30,0,13,39
30,Success,49,38,5,8,41
30,Fail,45,39,0,16,29
30,Fail,41,39,0,14,27
30,Success,51,41,0,5,46
30,Success,47,37,0,16,31
30,Fail,40,39,2,19,21
30,Success,48,34,0,11,37
30,Success,51,35,2,12,39
30,Fail,37,40,0,19,18
30,Success,51,34,0,14,37
30,Success,47,31,11,11,36
30,Success,45,32,12,11,34
30,Success,49,35,0,15,34
30,Fail,47,30,0,18,29
30,Success,46,36,2,16,30
30,Success,47,33,10,10,37
30,Success,48,33,0,13,35
30,Success,47,39,0,10,37
30,Success,52,38,0,10,42
30,Success,50,28,6,16,34
30,Success,44,34,0,14,30
30,Success,54,35,0,10,44
30,Success,50,35,0,12,38
30,Success,52,39,0,7,45
30,Success,51,34,0,12,39
30,Success,49,30,0,16,33
30,Success,49,39,2,10,39
30,Fail,37,43,0,14,23
30,Success,54,34,0,10,44
30,Fail,47,34,0,19,28
30,Success,44,43,0,13,31
30,Success,49,31,9,11,38
30,Success,50,29,0,13,37
30,Success,51,38,0,10,41
30,Success,47,40,0,11,36
30,Success,49,30,0,18,31
30,Success,53,40,0,7,46
30,Success,47,37,4,12,35
30,Fail,41,41,0,15,26
30,Success,46,37,0,14,32
30,Success,49,35,6,10,39
30,Success,42,47,0,10,32
30,Success,52,32,0,9,43
30,Success,51,39,0,10,41
30,Success,56,31,2,11,45
30,Success,48,32,6,14,34
30,Success,52,29,0,15,37
30,Fail,44,31,0,17,27
30,Success,50,31,4,15,35
30,Success,53,36,0,9,44
30,Success,57,29,0,13,44
30,Success,48,37,7,8,40
30,Success,51,27,0,18,33
30,Success,48,38,2,12,36
30,Success,60,25,2,13,47
30,Success,47,38,0,11,36
30,Success,48,32,0,13,35
30,Success,49,40,0,9,40
30,Success,49,40,0,9,40
30,Success,48,40,2,10,38
30,Success,50,41,0,7,43
30,Success,52,37,1,10,42
30,Success,46,42,3,9,37
30,Success,47,34,2,17,30
30,Success,48,36,0,16,32
30,Success,54,29,0,16,38
30,Success,47,38,1,14,33
30,Success,58,29,3,10,48
30,Fail,46,29,0,17,29
30,Success,53,38,1,8,45
30,Fail,42,36,5,17,25
30,Success,48,40,4,8,40
30,Success,51,38,0,11,40
30,Success,55,31,0,12,43
30,Fail,43,32,0,19,24
30,Success,44,39,5,12,32
30,Success,50,31,0,13,37
30,Success,44,45,0,8,36
30,Success,53,35,0,11,42
30,Success,57,31,0,10,47
30,Fail,44,33,7,16,28
30,Success,49,40,2,9,40
30,Success,45,39,5,11,34
30,Success,48,34,0,14,34
30,Success,56,27,0,13,43
30,Success,52,39,1,8,44
30,Success,47,37,4,12,35
30,Success,48,36,0,16,32
30,Fail,39,40,0,16,23
30,Success,53,36,3,8,45
30,Success,45,42,0,13,32
30,Success,53,35,0,12,41
30,Fail,42,43,1,14,28
30,Success,51,34,4,11,40
30,Success,49,30,0,16,33
30,Success,50,32,2,16,34
30,Success,47,40,0,9,38
30,Fail,41,33,0,17,24
30,Success,56,31,0,13,43
30,Fail,44,39,2,15,29
30,Fail,39,42,0,10,29
30,Success,47,35,0,12,35
30,Success,47,35,0,15,32
30,Success,52,36,0,11,41
30,Fail,41,35,0,12,29
30,Success,48,40,0,12,36
30,Success,53,37,0,10,43
30,Success,51,37,2,10,41
30,Success,54,39,4,3,51
30,Success,47,39,0,7,40
30,Success,43,40,6,11,32
30,Fail,43,31,10,16,27
30,Success,48,34,0,13,35
30,Success,52,34,5,9,43
30,Success,45,42,1,12,33
30,Success,50,39,0,9,41
30,Fail,40,43,0,15,25
30,Success,53,32,4,11,42
30,Success,47,33,5,15,32
30,Success,57,29,0,11,46
30,Success,43,41,0,12,31
30,Fail,41,43,0,15,26
30,Success,51,38,1,10,41
30,Success,45,38,0,14,31
30,Success,52,32,7,9,43
30,Success,47,39,1,13,34
30,Success,50,33,0,10,40
30,Success,50,40,0,8,42
30,Success,48,39,0,13,35
30,Fail,45,33,6,16,29
30,Success,47,31,0,15,32
30,Success,46,34,0,11,35
30,Success,48,33,4,15,33
30,Success,44,32,0,12,32
30,Success,46,39,0,5,41
30,Success,49,36,1,14,35
30,Success,47,31,0,15,32
30,Success,47,30,10,13,34
30,Success,58,32,0,10,48
30,Success,53,35,2,10,43
30,Success,49,34,3,14,35
30,Fail,43,41,0,14,29
30,Success,45,27,14,14,31
30,Success,44,35,0,11,33
30,Success,48,36,7,9,39
30,Success,55,33,0,12,43
30,Success,48,39,0,11,37
30,Success,52,32,0,11,41
30,Success,45,37,0,9,36
30,Fail,47,30,5,18,29
30,Success,52,32,5,11,41
30,Success,52,36,0,9,43
30,Success,45,36,0,13,32
30,Fail,38,41,0,13,25
30,Success,44,35,7,14,30
30,Success,49,35,0,14,35
30,Success,49,36,0,14,35
30,Success,50,33,1,16,34
30,Fail,43,41,2,14,29
30,Success,44,37,0,10,34
30,Success,46,35,3,16,30
30,Success,49,33,5,13,36
30,Success,44,39,0,12,32
30,Success,51,30,2,17,34
30,Success,47,40,0,13,34
30,Success,49,37,0,10,39
30,Success,49,34,0,15,34
30,Success,49,42,0,9,40
30,Fail,41,42,0,14,27
30,Fail,40,38,7,15,25
30,Success,49,31,0,14,35
30,Success,47,40,0,12,35
30,Fail,38,31,0,20,18
30,Success,46,47,0,7,39
30,Success,48,42,0,10,38
30,Success,42,48,0,7,35
30,Fail,41,39,0,13,28
30,Success,48,31,0,17,31
30,Success,47,38,1,14,33
30,Success,54,31,0,11,43
30,Success,53,29,3,15,38
30,Success,53,25,0,12,41
30,Success,59,25,0,14,45
30,Fail,33,43,0,18,15
30,Success,47,41,0,9,38
30,Success,46,32,8,14,32
30,Success,48,37,0,13,35
30,Success,53,32,0,13,40
30,Success,42,41,0,10,32
30,Success,56,31,0,13,43
30,Success,47,33,0,12,35
30,Success,49,37,6,8,41
30,Success,52,34,0,10,42
30,Success,45,39,5,11,34
30,Success,47,41,0,10,37
30,Success,48,36,3,13,35
30,Fail,39,30,0,18,21
30,Success,47,39,0,10,37
30,Success,50,41,4,5,45
30,Success,49,44,1,6,43
30,Success,42,41,0,11,31
30,Success,51,34,0,14,37
30,Fail,44,39,2,15,29
30,Success,52,38,0,9,43
30,Success,47,34,4,15,32
30,Fail,43,42,0,14,29
30,Success,58,29,1,12,46
30,Success,49,34,0,16,33
30,Success,44,42,2,12,32
30,Success,46,39,0,10,36
30,Fail,41,38,8,13,28
30,Success,43,41,0,10,33
30,Success,47,40,3,10,37
30,Success,51,42,0,5,46
30,Success,50,36,0,14,36
30,Success,47,39,0,12,35
30,Success,48,40,0,11,37
30,Fail,36,46,0,16,20
30,Success,58,23,0,12,46
30,Success,50,37,0,9,41
30,Fail,40,41,0,14,26
30,Success,49,32,0,14,35
30,Success,44,40,0,12,32
30,Fail,44,35,6,15,29
30,Fail,45,34,5,16,29
30,Success,54,35,0,11,43
30,Fail,39,39,4,18,21
30,Success,45,38,0,11,34
30,Success,54,33,0,8,46
30,Success,45,41,3,11,34
30,Success,46,38,3,13,33
30,Success,50,36,4,10,40
30,Success,55,31,1,13,42
30,Success,50,32,0,13,37
30,Success,48,34,7,11,37
30,Success,52,32,2,14,38
30,Success,54,28,0,13,41
30,Success,48,37,3,12,36
30,Fail,41,31,0,17,24
30,Success,48,30,0,14,34
30,Success,52,39,1,8,44
30,Fail,39,40,0,14,25
30,Success,58,31,2,9,49
30,Success,53,35,0,6,47
30,Success,48,37,3,12,36
30,Success,47,36,6,11,36
30,Success,55,32,4,9,46
30,Fail,45,35,3,17,28
30,Success,44,36,0,11,33
30,Success,51,37,0,12,39
30,Success,42,37,9,12,30
30,Success,48,40,0,11,37
30,Success,54,34,0,9,45
30,Success,51,31,1,17,34
30,Success,53,38,0,8,45
30,Success,51,34,3,12,39
30,Fail,37,45,7,11,26
30,Fail,35,45,4,16,19
30,Fail,41,32,0,14,27
30,Success,50,36,0,14,36
30,Success,49,30,5,16,33
30,Success,47,37,7,9,38
30,Fail,40,42,6,12,28
30,Success,42,43,5,10,32
30,Success,55,34,1,10,45
30,Success,51,34,0,8,43
30,Success,49,27,0,15,34
30,Fail,43,36,6,15,28
30,Success,45,38,0,11,34
30,Fail,43,41,2,14,29
30,Success,54,29,0,10,44
30,Success,46,36,0,14,32
30,Success,52,37,0,9,43
30,Fail,45,28,5,22,23
30,Success,53,24,7,16,37
30,Success,46,37,0,13,33
30,Success,50,27,0,11,39
30,Success,50,39,0,9,41
30,Fail,36,41,0,20,16
30,Success,48,35,0,10,38
30,Success,44,37,6,13,31
30,Success,50,37,0,12,38
30,Success,48,39,5,8,40
30,Success,48,36,0,16,32
30,Success,46,32,13,9,37
30,Success,49,37,1,13,36
30,Success,46,39,0,10,36
30,Success,51,36,1,12,39
30,Success,53,32,0,13,40
30,Fail,39,43,0,14,25
30,Success,50,38,0,11,39
30,Success,48,36,0,13,35
30,Success,53,31,1,15,38
30,Success,43,47,0,9,34
30,Success,49,37,0,11,38
30,Fail,43,36,2,19,24
30,Success,56,33,0,11,45
30,Success,59,29,1,11,48
30,Success,44,39,0,9,35
30,Success,48,37,1,14,34
30,Success,46,36,0,13,33
30,Success,53,31,0,12,41
30,Success,49,38,1,12,37
30,Success,47,38,0,14,33
30,Success,47,39,3,11,36
30,Fail,35,38,10,17,18
30,Success,52,36,0,9,43
30,Success,49,37,4,10,39
30,Fail,43,37,0,19,24
30,Success,46,33,10,11,35
30,Fail,44,28,0,22,22
30,Success,52,35,0,13,39
30,Fail,48,31,0,19,29
30,Success,53,31,0,12,41
30,Success,51,39,0,9,42
30,Success,47,36,0,10,37
30,Fail,42,29,0,21,21
30,Success,48,41,1,10,38
30,Success,53,36,1,10,43
30,Fail,43,40,0,14,29
30,Fail,40,46,0,13,27
30,Success,45,39,8,8,37
30,Success,48,40,5,7,41
30,Fail,45,32,0,16,29
30,Success,48,38,0,12,36
30,Success,49,36,0,13,36
30,Success,53,28,0,13,40
30,Success,52,32,0,13,39
30,Success,43,42,3,12,31
30,Success,54,30,0,15,39
30,Fail,45,36,0,16,29
30,Fail,43,37,0,16,27
30,Success,48,38,0,14,34
30,Success,43,46,0,9,34
30,Success,55,34,1,10,45
30,Success,51,29,1,19,32
30,Success,56,32,0,11,45
30,Fail,41,39,5,15,26
30,Fail,46,32,0,19,27
30,Fail,43,41,0,14,29
30,Success,45,31,0,12,33
30,Success,48,39,0,13,35
30,Success,50,30,0,14,36
30,Success,49,36,4,11,38
30,Success,50,39,2,9,41
30,Success,52,31,2,15,37
30,Success,46,34,7,13,33
30,Success,50,34,0,8,42
30,Success,57,31,2,10,47
30,Fail,43,38,5,14,29
30,Fail,36,45,0,13,23
30,Success,48,35,3,14,34
30,Success,53,31,4,12,41
30,Fail,42,42,0,13,29
30,Fail,45,32,0,16,29
30,Success,56,33,0,7,49
30,Success,50,33,2,15,35
30,Success,56,29,0,15,41
30,Success,42,42,0,9,33
30,Success,41,42,12,5,36
30,Success,48,35,0,12,36
30,Success,57,35,1,7,50
30,Success,46,39,0,14,32
30,Success,49,29,0,17,32
30,Success,47,37,0,12,35
30,Fail,45,33,0,19,26
30,Success,55,36,2,7,48
30,Success,49,35,0,13,36
30,Fail,42,33,0,17,25
30,Success,51,31,5,13,38
30,Fail,40,38,0,14,26
30,Fail,43,36,6,15,28
30,Success,50,31,0,18,32
30,Success,51,34,0,14,37
30,Success,45,41,0,11,34
30,Success,50,31,0,18,32
30,Success,47,36,3,14,33
30,Success,55,31,0,12,43
30,Success,47,33,0,13,34
30,Success,51,32,0,8,43
30,Success,49,37,2,12,37
30,Success,50,32,0,10,40
30,Success,46,44,0,10,36
30,Success,47,37,0,12,35
30,Success,52,29,0,12,40
30,Success,51,36,2,11,40
30,Success,47,33,0,13,34
30,Success,52,32,2,14,38
30,Success,53,36,2,9,44
30,Success,53,33,2,12,41
30,Success,56,33,0,9,47
30,Success,46,42,0,6,40
30,Success,44,36,8,12,32
30,Success,45,37,0,15,30
30,Success,43,38,0,11,32
30,Fail,42,34,5,19,23
30,Success,45,39,0,15,30
30,Success,42,43,0,9,33
30,Fail,43,33,10,14,29
30,Success,55,36,0,8,47
30,Success,52,30,6,12,40
30,Success,54,27,7,12,42
30,Success,46,32,0,15,31
30,Success,51,37,0,9,42
30,Fail,45,29,0,19,26
30,Success,50,28,0,15,35
30,Success,48,36,6,10,38
30,Success,44,33,0,14,30
30,Success,48,40,5,7,41
30,Success,54,38,0,7,47
30,Success,52,35,0,12,40
30,Success,45,31,9,15,30
30,Success,50,32,2,16,34
30,Success,43,36,11,10,33
30,Success,44,38,0,10,34
30,Fail,44,34,0,16,28
30,Fail,45,34,0,17,28
30,Success,56,33,1,10,46
30,Success,52,33,3,12,40
30,Success,51,28,4,17,34
30,Success,42,47,1,10,32
30,Success,50,29,5,16,34
30,Success,46,32,0,11,35
30,Success,46,37,0,13,33
30,Fail,44,34,0,16,28
30,Success,51,41,0,8,43
30,Success,51,33,0,11,40
30,Success,48,35,0,16,32
30,Fail,45,30,0,17,28
30,Success,48,31,6,15,33
30,Success,51,31,4,14,37
30,Success,49,39,1,11,38
30,Fail,41,37,0,18,23
30,Success,47,36,0,14,33
30,Success,45,39,6,10,35
30,Success,45,36,0,14,31
30,Success,45,43,0,12,33
30,Fail,42,38,3,17,25
30,Success,45,44,0,8,37
30,Fail,40,39,0,19,21
30,Success,47,36,6,11,36
30,Success,45,40,0,12,33
30,Success,49,37,1,13,36
30,Fail,45,31,0,22,23
30,Fail,40,42,0,13,27
30,Success,49,32,5,14,35
30,Success,44,38,6,12,32
30,Success,50,35,0,11,39
30,Success,49,26,8,17,32
30,Success,51,36,0,7,44
30,Success,43,40,0,10,33
30,Success,47,42,0,8,39
30,Success,52,39,1,8,44
30,Success,48,37,5,10,38
30,Success,47,41,0,11,36
30,Success,47,38,0,15,32
30,Success,45,38,7,10,35
30,Success,53,32,3,12,41
30,Success,53,32,0,15,38
30,Success,51,35,3,11,40
30,Success,48,38,3,11,37
30,Success,47,36,0,16,31
30,Fail,38,40,6,16,22
30,Success,50,34,0,13,37
30,Success,53,39,0,6,47
30,Success,49,33,0,13,36
30,Success,50,35,5,10,40
30,Fail,47,34,0,18,29
30,Success,48,39,0,12,36
30,Fail,41,40,2,17,24
30,Success,44,42,0,13,31
30,Success,59,28,0,12,47
30,Success,52,36,2,10,42
30,Success,49,37,2,12,37
30,Success,50,33,0,17,33
30,Fail,43,39,0,16,27
30,Success,46,38,0,14,32
30,Success,52,30,3,15,37
30,Success,48,38,0,12,36
30,Success,48,31,0,17,31
30,Success,46,33,0,13,33
30,Success,50,38,0,12,38
30,Success,44,35,9,12,32
30,Success,46,35,11,8,38
30,Fail,43,42,0,14,29
30,Success,43,35,11,11,32
30,Success,46,38,0,14,32
30,Success,49,41,0,6,43
30,Success,50,32,3,15,35
30,Success,49,32,2,17,32
30,Success,48,43,0,9,39
30,Success,42,47,1,10,32
30,Fail,40,42,7,11,29
30,Success,48,39,0,7,41
30,Success,46,35,8,11,35
30,Fail,42,39,0,13,29
30,Fail,42,45,0,13,29
30,Success,49,43,1,7,42
30,Success,56,32,0,10,46
30,Success,51,35,0,11,40
30,Fail,37,45,0,18,19
30,Fail,42,37,0,17,25
30,Fail,42,34,6,18,24
30,Success,47,38,3,12,35
30,Success,43,44,3,10,33
30,Success,57,33,2,8,49
30,Fail,38,39,3,20,18
30,Success,51,37,1,11,40
30,Success,55,34,0,11,44
30,Success,50,36,5,9,41
30,Success,55,36,2,7,48
30,Success,50,33,0,15,35
30,Success,49,33,5,13,36
30,Success,52,34,4,10,42
30,Success,46,37,0,13,33
30,Success,51,34,0,15,36
30,Success,48,33,7,12,36
30,Success,45,38,9,8,37
30,Success,42,43,4,11,31
30,Success,46,33,7,14,32
30,Success,46,41,0,11,35
30,Success,50,41,0,9,41
30,Success,53,35,1,11,42
30,Success,44,41,5,10,34
30,Success,47,40,0,13,34
30,Success,48,34,0,16,32
30,Success,48,33,0,18,30
30,Success,50,36,0,14,36
30,Success,50,35,1,14,36
30,Success,50,40,3,7,43
30,Success,46,33,11,10,36
30,Fail,47,31,4,18,29
30,Success,52,36,0,11,41
30,Success,52,35,6,7,45
30,Success,53,35,0,10,43
30,Success,45,41,0,13,32
30,Fail,47,28,0,20,27
30,Success,59,30,0,10,49
30,Success,47,41,0,12,35
30,Fail,43,29,0,21,22
30,Success,54,33,0,13,41
30,Success,61,29,0,9,52
30,Success,44,43,2,11,33
30,Success,44,42,5,9,35
30,Success,50,35,0,13,37
30,Fail,44,32,4,20,24
30,Success,39,46,7,8,31
30,Success,52,33,0,14,38
30,Success,47,32,7,14,33
30,Success,55,36,0,9,46
30,Success,49,36,0,14,35
30,Success,50,35,0,10,40
30,Success,51,29,0,14,37
30,Success,45,40,5,10,35
30,Success,54,32,0,10,44
30,Success,54,33,1,12,42
30,Fail,44,38,3,15,29
30,Success,50,33,0,14,36
30,Success,53,29,0,8,45
30,Fail,43,27,9,21,22
30,Success,52,33,0,11,41
30,Success,46,40,3,11,35
30,Success,54,38,0,6,48
30,Success,50,30,0,13,37
30,Success,52,28,7,13,39
30,Success,51,43,0,6,45
30,Fail,47,33,0,18,29
30,Success,53,30,2,15,38
30,Success,50,33,0,17,33
30,Success,44,41,0,14,30
30,Success,54,34,1,11,43
30,Success,44,37,0,12,32
30,Success,52,34,0,8,44
30,Success,49,34,0,9,40
30,Success,52,33,3,12,40
30,Fail,41,40,0,15,26
30,Fail,47,28,6,19,28
30,Success,41,52,0,5,36
30,Success,54,31,0,11,43
30,Fail,45,33,3,19,26
30,Success,49,33,5,13,36
30,Success,53,36,0,9,44
30,Success,53,33,2,12,41
30,Success,45,38,3,14,31
30,Success,48,37,3,12,36
30,Success,50,24,11,15,35
30,Fail,47,30,0,18,29
30,Success,47,34,8,11,36
30,Success,44,37,9,10,34
30,Success,44,36,0,13,31
30,Success,52,30,0,17,35
30,Success,44,40,3,13,31
30,Fail,42,42,0,16,26
30,Success,46,41,3,10,36
30,Success,46,30,8,16,30
30,Success,49,43,0,8,41
30,Success,49,35,1,15,34
30,Fail,45,34,0,19,26
30,Success,51,32,3,14,37
30,Success,53,28,5,14,39
30,Success,48,35,0,17,31
30,Success,53,31,0,8,45
30,Success,49,41,0,7,42
30,Success,52,33,0,14,38
30,Success,53,38,0,7,46
30,Fail,46,34,3,17,29
30,Success,50,26,9,15,35
30,Success,48,38,0,13,35
30,Success,43,43,0,12,31
30,Success,47,42,0,10,37
30,Success,49,32,8,11,38
30,Success,58,37,0,4,54
30,Success,47,44,1,8,39
30,Success,50,38,0,12,38
30,Success,46,37,11,6,40
30,Fail,46,33,0,17,29
30,Success,49,32,4,15,34
30,Success,45,40,0,14,31
30,Success,52,29,0,15,37
30,Success,51,38,0,10,41
30,Success,48,36,0,13,35
30,Fail,44,35,6,15,29
30,Success,47,33,5,15,32
30,Success,49,32,0,14,35
30,Success,47,37,4,12,35
30,Fail,42,42,0,15,27
30,Success,42,36,11,11,31
30,Success,49,35,0,9,40
30,Success,49,33,5,13,36
30,Success,48,36,0,12,36
30,Success,54,32,0,12,42
30,Success,52,30,0,13,39
30,Success,51,34,6,9,42
30,Success,49,34,6,11,38
30,Success,46,39,0,11,35
30,Success,51,29,4,16,35
30,Fail,42,43,1,14,28
30,Fail,39,31,18,12,27
30,Success,46,38,0,14,32
30,Success,62,31,0,4,58
30,Success,52,40,3,5,47
30,Success,51,38,2,9,42
30,Success,52,39,2,7,45
30,Success,60,28,4,8,52
30,Success,49,35,0,15,34
30,Success,56,37,1,6,50
30,Success,46,39,5,10,36
30,Fail,42,44,0,13,29
30,Success,46,28,10,16,30
30,Fail,41,34,7,18,23
30,Fail,41,37,3,19,22
30,Success,46,40,0,13,33
30,Success,50,32,8,10,40
30,Success,52,27,7,14,38
30,Success,48,32,5,15,33
30,Success,48,34,3,15,33
30,Success,44,26,16,14,30
30,Success,49,39,5,7,42
30,Success,50,36,0,13,37
30,Fail,41,36,0,14,27
30,Success,47,32,8,13,34
30,Success,48,37,4,11,37
30,Success,47,34,0,12,35
30,Success,54,35,0,9,45
30,Success,47,36,4,13,34
30,Success,47,40,3,10,37
30,Success,51,38,2,9,42
30,Success,48,43,1,8,40
30,Fail,45,29,10,16,29
30,Success,51,22,0,17,34
30,Success,57,28,0,15,42
30,Success,45,39,0,11,34
30,Success,49,34,0,13,36
30,Success,51,33,0,13,38
30,Success,48,36,0,15,33
30,Success,49,32,0,15,34
30,Success,53,34,0,10,43
30,Success,45,40,0,15,30
30,Success,52,30,0,14,38
30,Success,44,35,10,11,33
30,Success,50,31,1,18,32
30,Success,58,29,1,12,46
30,Success,38,41,14,7,31
30,Success,45,33,0,15,30
30,Success,45,33,8,14,31
30,Fail,37,38,0,15,22
30,Success,50,39,2,9,41
30,Success,46,36,0,13,33
30,Fail,46,35,0,18,28
30,Fail,43,30,11,16,27
30,Fail,40,45,0,14,26
30,Success,54,39,0,6,48
30,Success,56,31,1,12,44
30,Success,51,32,0,14,37
30,Success,46,37,0,11,35
30,Success,55,32,5,8,47
30,Success,46,35,0,16,30
30,Success,53,34,0,12,41
30,Success,47,39,3,11,36
30,Fail,40,41,2,17,23
30,Success,45,43,0,7,38
30,Success,52,37,3,8,44
30,Success,47,26,0,17,30
30,Success,44,42,2,12,32
30,Success,51,32,3,14,37
30,Success,49,38,0,10,39
30,Success,46,39,3,12,34
30,Success,49,38,0,13,36
30,Success,47,41,0,12,35
30,Success,49,40,0,7,42
30,Success,50,42,0,8,42
30,Success,54,33,0,10,44
30,Success,50,39,0,9,41
30,Success,53,32,0,14,39
30,Success,48,32,5,15,33
30,Success,50,39,0,8,42
30,Success,53,31,2,14,39
30,Success,45,38,0,13,32
30,Success,45,39,3,13,32
30,Fail,44,30,10,16,28
30,Success,45,37,3,15,30
30,Success,45,36,0,14,31
30,Success,43,43,0,12,31
30,Success,54,34,2,10,44
30,Success,50,41,0,5,45
30,Success,47,35,0,15,32
30,Fail,44,40,0,16,28
30,Success,53,27,0,10,43
30,Success,52,32,1,15,37
30,Success,50,31,4,15,35
30,Success,48,36,1,15,33
30,Fail,45,33,0,20,25
30,Fail,39,40,5,16,23
30,Success,51,29,4,16,35
30,Success,48,38,3,11,37
30,Success,48,35,0,17,31
30,Success,47,38,1,14,33
30,Fail,41,36,0,14,27
30,Success,47,36,7,10,37
30,Success,45,34,9,12,33
30,Success,49,36,0,11,38
30,Success,48,36,1,15,33
30,Success,45,40,1,14,31
30,Fail,44,36,0,17,27
30,Fail,39,43,6,12,27
30,Success,52,36,0,11,41
30,Success,50,33,3,14,36
30,Fail,42,35,8,15,27
30,Success,46,36,3,15,31
30,Success,50,35,1,14,36
30,Fail,38,44,7,11,27
30,Success,49,37,0,13,36
30,Success,43,37,9,11,32
30,Success,51,39,2,8,43
30,Success,47,40,0,12,35
30,Fail,40,36,5,19,21
30,Success,53,34,0,7,46
30,Success,60,29,3,8,52
30,Success,44,36,6,14,30
30,Success,49,35,2,14,35
30,Success,48,35,0,13,35
30,Success,48,34,0,14,34
30,Success,53,34,0,13,40
30,Success,48,31,0,17,31
30,Fail,42,40,0,14,28
30,Success,49,35,2,14,35
30,Success,54,38,0,7,47
30,Success,49,34,6,11,38
30,Success,49,33,0,16,33
30,Success,54,31,0,13,41
30,Success,47,36,1,16,31
30,Success,53,33,4,10,43
30,Success,44,41,1,14,30
30,Success,50,38,2,10,40
30,Success,50,31,0,16,34
30,Success,46,37,1,16,30
30,Success,56,27,6,11,45
30,Success,42,42,4,12,30
30,Fail,42,39,4,15,27
30,Fail,38,30,18,14,24
30,Success,48,34,0,13,35
30,Success,47,38,0,12,35
30,Success,52,31,1,16,36
30,Success,48,27,9,16,32
30,Success,45,35,0,15,30
30,Success,43,41,4,12,31
30,Fail,40,27,12,21,19
30,Success,50,31,3,16,34
30,Success,49,37,0,12,37
30,Success,47,41,0,11,36
30,Success,51,37,0,11,40
30,Success,49,30,0,16,33
30,Success,58,22,0,12,46
30,Success,54,32,0,7,47
30,Success,46,39,3,12,34
30,Success,49,36,2,13,36
30,Success,50,38,0,9,41
30,Fail,41,35,9,15,26
30,Success,47,35,0,12,35
30,Success,55,30,0,12,43
30,Success,45,42,0,8,37
30,Success,48,35,7,10,38
30,Fail,40,38,0,16,24
30,Success,46,24,0,15,31
30,Success,44,42,4,10,34
30,Success,48,35,1,16,32
30,Success,53,33,5,9,44
30,Success,49,31,0,14,35
30,Success,50,38,1,11,39
30,Success,51,39,0,8,43
30,Success,43,41,3,13,30
30,Success,51,35,5,9,42
30,Success,46,46,0,7,39
30,Success,45,43,2,10,35
30,Fail,37,43,7,13,24
30,Fail,42,37,0,15,27
30,Success,46,38,4,12,34
30,Fail,42,35,0,18,24
30,Success,48,38,2,12,36
30,Success,46,39,7,8,38
30,Fail,45,36,2,17,28
30,Success,43,43,1,13,30
30,Success,50,35,2,13,37
30,Success,43,46,3,8,35
30,Success,51,36,0,7,44
30,Success,51,35,7,7,44
30,Success,43,46,0,10,33
30,Success,48,35,8,9,39
30,Success,49,38,1,12,37
30,Success,52,27,6,15,37
30,Success,54,32,0,14,40
30,Fail,37,38,0,15,22
30,Fail,44,38,0,17,27
30,Fail,44,33,0,17,27
30,Success,49,36,1,14,35
30,Success,54,34,0,10,44
30,Fail,45,37,0,17,28
30,Success,44,37,0,12,32
30,Success,46,33,8,13,33
30,Success,47,31,0,17,30
30,Success,47,37,0,13,34
30,Success,45,39,0,14,31
30,Success,47,36,7,10,37
30,Success,49,35,2,14,35
30,Success,53,30,1,16,37
30,Success,44,43,6,7,37
30,Success,44,37,10,9,35
30,Success,49,31,5,15,34
30,Success,57,30,0,13,44
30,Success,54,36,2,8,46
30,Success,49,38,5,8,41
30,Success,51,34,3,12,39
30,Fail,46,31,0,21,25
30,Success,48,34,0,14,34
30,Fail,43,34,9,14,29
30,Success,51,36,1,12,39
30,Success,52,26,0,9,43
30,Success,40,41,9,10,30
30,Success,44,42,0,11,33
30,Success,46,37,6,11,35
30,Fail,43,30,8,19,24
30,Success,53,34,5,8,45
30,Success,50,31,0,14,36
30,Success,50,35,0,13,37
30,Fail,41,31,13,15,26
30,Success,52,40,0,5,47
30,Success,49,32,0,16,33
30,Success,48,37,3,12,36
30,Success,45,45,1,9,36
30,Success,44,42,0,10,34
30,Success,54,32,0,13,41
30,Success,56,32,0,10,46
30,Success,44,40,0,11,33
30,Fail,45,33,0,18,27
30,Success,60,20,0,15,45
30,Success,46,41,0,10,36
30,Success,51,37,4,8,43
30,Success,45,33,10,12,33
30,Success,53,31,2,14,39
30,Success,45,38,4,13,32
30,Success,55,31,0,10,45
30,Fail,42,33,5,20,22
30,Fail,37,45,5,13,24
30,Fail,43,38,2,17,26
30,Success,51,38,2,9,42
30,Fail,41,45,0,14,27
30,Success,49,33,2,16,33
30,Success,48,36,0,11,37
30,Success,53,30,0,13,40
30,Success,53,33,0,14,39
30,Fail,42,40,4,14,28
30,Success,47,37,5,11,36
30,Fail,43,29,0,15,28
30,Fail,41,34,0,21,20
30,Fail,48,28,0,19,29
30,Success,54,33,4,9,45
30,Fail,43,32,0,19,24
30,Success,48,35,4,13,35
30,Success,52,43,0,5,47
30,Success,51,37,0,11,40
30,Success,46,35,0,10,36
30,Fail,44,37,0,15,29
30,Fail,40,36,0,19,21
30,Fail,40,40,0,12,28
30,Success,45,38,5,12,33
30,Success,44,46,0,8,36
30,Success,51,33,0,10,41
30,Success,49,31,11,9,40
30,Fail,41,35,2,22,19
30,Success,51,30,10,9,42
30,Fail,38,37,9,16,22
30,Success,55,35,0,7,48
30,Success,55,31,0,12,43
30,Success,47,39,2,12,35
30,Success,42,48,3,7,35
30,Success,44,36,0,14,30
30,Success,53,25,0,12,41
30,Fail,44,34,0,15,29
30,Success,45,35,6,14,31
30,Success,46,23,17,14,32
30,Success,46,35,3,16,30
30,Success,52,24,11,13,39
30,Success,49,40,0,9,40
30,Success,48,42,0,8,40
30,Success,44,43,0,11,33
30,Fail,43,42,1,14,29
30,Success,46,36,6,12,34
30,Success,59,29,5,7,52
30,Success,53,28,0,14,39
30,Fail,44,37,0,17,27
30,Success,47,38,5,10,37
30,Success,54,34,0,10,44
30,Success,54,29,8,9,45
30,Success,42,48,0,8,34
30,Success,48,35,1,16,32
30,Success,52,36,0,12,40
30,Fail,38,38,6,18,20
30,Success,52,26,6,16,36
30,Success,45,36,5,14,31
30,Success,48,31,3,18,30
30,Success,50,34,1,15,35
30,Success,46,41,3,10,36
30,Success,46,36,3,15,31
30,Fail,43,36,4,17,26
30,Success,51,39,2,8,43
30,Fail,42,38,0,16,26
30,Success,48,33,4,15,33
30,Success,46,32,14,8,38
30,Success,55,29,0,14,41
30,Success,49,31,5,15,34
30,Success,45,34,0,15,30
30,Success,46,39,2,13,33
30,Fail,43,37,0,17,26
30,Fail,43,38,0,17,26
30,Success,48,31,0,17,31
30,Success,46,37,0,15,31
30,Fail,44,36,0,15,29
30,Success,55,34,0,10,45
30,Fail,44,39,0,15,29
30,Fail,44,33,0,16,28
30,Success,50,34,0,16,34
30,Success,52,32,0,16,36
30,Success,46,32,0,16,30
30,Fail,45,30,0,17,28
30,Success,49,35,0,11,38
30,Fail,40,36,10,14,26
30,Success,49,35,0,16,33
30,Success,48,34,4,14,34
30,Fail,35,41,0,21,14
30,Success,47,36,0,9,38
30,Success,51,38,0,9,42
30,Fail,40,30,0,19,21
30,Success,43,38,0,9,34
30,Success,52,30,0,15,37
30,Fail,48,30,0,20,28
30,Success,51,28,4,17,34
30,Success,47,35,5,13,34
30,Success,53,33,0,8,45
30,Success,48,26,0,14,34
30,Success,48,34,7,11,37
30,Success,45,38,2,15,30
30,Success,51,31,0,10,41
30,Fail,44,35,1,20,24
30,Success,49,37,0,10,39
30,Success,47,37,0,14,33
30,Success,48,38,0,12,36
30,Success,54,36,0,10,44
30,Success,52,32,4,12,40
30,Fail,46,35,1,18,28
30,Success,52,34,1,13,39
30,Success,50,35,0,12,38
30,Success,51,35,0,10,41
30,Success,44,38,0,13,31
30,Success,47,34,0,15,32
30,Fail,40,42,2,16,24
30,Success,54,29,0,15,39
30,Fail,39,31,12,18,21
30,Success,48,39,0,8,40
30,Fail,37,43,4,16,21
30,Success,57,31,0,11,46
30,Success,50,41,3,6,44
30,Success,50,31,9,10,40
30,Success,45,30,0,12,33
30,Fail,44,38,3,15,29
30,Fail,34,37,0,15,19
30,Success,56,34,3,7,49
30,Success,46,37,0,15,31
30,Success,47,26,15,12,35
30,Fail,39,35,13,13,26
30,Success,47,40,2,11,36
30,Fail,41,42,5,12,29
30,Success,50,35,0,15,35
30,Success,58,29,0,12,46
30,Success,50,35,0,13,37
30,Success,52,32,6,10,42
30,Success,46,34,6,14,32
30,Success,45,34,7,14,31
30,Fail,43,36,0,19,24
30,Success,47,34,0,11,36
30,Success,49,38,0,11,38
30,Success,51,37,0,12,39
30,Success,56,35,0,9,47
30,Success,50,31,8,11,39
30,Success,45,32,8,15,30
30,Success,46,34,9,11,35
30,Fail,41,40,0,19,22
30,Fail,36,41,0,12,24
30,Fail,43,30,0,18,25
30,Success,46,35,4,15,31
30,Success,48,36,6,10,38
30,Fail,44,30,0,22,22
30,Success,48,37,1,14,34
30,Success,47,37,0,13,34
30,Success,49,37,0,14,35
30,Fail,49,26,4,21,28
30,Success,45,43,0,11,34
30,Success,50,33,0,15,35
30,Success,54,33,0,11,43
30,Fail,43,38,3,16,27
30,Fail,44,27,0,21,23
30,Fail,39,44,0,10,29
30,Success,54,27,2,17,37
30,Success,50,41,6,3,47
30,Success,47,41,0,7,40
30,Fail,40,42,4,14,26
30,Fail,44,38,3,15,29
30,Success,53,37,5,5,48
30,Fail,43,32,0,17,26
30,Success,49,37,0,14,35
30,Success,46,40,0,14,32
30,Fail,46,30,6,18,28
30,Success,50,34,3,13,37
30,Success,49,27,0,15,34
30,Success,59,29,0,7,52
30,Fail,46,24,0,19,27
30,Success,48,37,1,14,34
30,Success,50,40,0,10,40
30,Success,57,30,0,13,44
30,Success,49,30,0,16,33
30,Success,52,35,2,11,41
30,Success,45,34,0,12,33
30,Success,51,32,1,16,35
30,Success,51,37,3,9,42
30,Fail,40,37,6,17,23
30,Fail,43,40,3,14,29
30,Success,46,36,6,12,34
30,Fail,41,41,0,17,24
30,Success,48,38,3,11,37
30,Success,54,30,7,9,45
30,Success,53,36,2,9,44
30,Success,47,40,2,11,36
30,Success,50,33,0,13,37
30,Success,55,29,4,12,43
30,Success,44,43,0,13,31
30,Success,52,36,0,11,41
30,Success,48,37,0,14,34
30,Success,53,32,4,11,42
30,Success,50,35,3,12,38
30,Success,46,33,0,11,35
30,Fail,42,34,11,13,29
30,Success,50,33,5,12,38
30,Success,49,35,2,14,35
30,Success,53,29,4,14,39
30,Success,52,36,1,11,41
30,Fail,43,41,2,14,29
30,Success,45,37,6,12,33
30,Success,53,36,2,9,44
30,Success,50,35,7,8,42
30,Success,44,39,0,8,36
30,Success,45,45,0,8,37
30,Success,52,27,3,18,34
30,Success,48,40,0,9,39
30,Success,46,46,0,8,38
30,Success,52,30,6,12,40
30,Success,48,38,0,11,37
30,Success,45,30,0,12,33
30,Success,49,46,1,4,45
30,Success,44,33,0,13,31
30,Success,47,34,3,16,31
30,Success,46,37,0,13,33
30,Success,54,33,0,13,41
30,Success,58,35,1,6,52
30,Success,47,38,0,13,34
30,Success,51,32,4,13,38
30,Success,52,30,0,13,39
30,Success,50,34,0,9,41
30,Success,52,30,0,17,35
30,Success,47,28,0,15,32
30,Success,45,39,4,12,33
30,Success,50,35,3,12,38
30,Success,57,31,0,9,48
30,Success,46,31,13,10,36
30,Fail,41,35,0,14,27
30,Success,44,38,9,9,35
30,Success,49,40,3,8,41
30,Success,54,35,1,10,44
30,Success,52,29,0,13,39
30,Success,47,32,7,14,33
30,Fail,45,35,0,20,25
30,Fail,45,36,0,17,28
30,Fail,42,37,4,17,25
30,Success,49,39,0,10,39
30,Success,43,39,0,11,32
30,Success,48,40,5,7,41
30,Success,47,34,2,17,30
30,Success,53,25,0,16,37
30,Success,49,33,8,10,39
30,Success,47,33,0,15,32
30,Success,51,36,3,10,41
30,Fail,42,42,2,14,28
30,Fail,44,33,6,17,27
30,Success,54,32,1,13,41
30,Success,53,34,0,12,41
30,Success,47,31,10,12,35
30,Success,50,39,0,11,39
30,Success,46,36,3,15,31
30,Fail,37,47,5,11,26
30,Success,44,38,5,13,31
30,Fail,45,36,3,16,29
30,Success,43,36,11,10,33
30,Success,57,34,0,7,50
30,Success,54,33,0,12,42
30,Success,56,26,0,17,39
30,Success,46,36,0,11,35
30,Success,49,37,3,11,38
30,Success,45,42,5,8,37
30,Success,54,32,4,10,44
30,Fail,42,39,2,17,25
30,Fail,38,45,0,12,26
30,Success,52,33,4,11,41
30,Success,52,40,2,6,46
30,Success,44,38,7,11,33
30,Success,47,32,4,17,30
30,Success,45,43,0,12,33
30,Fail,42,33,0,17,25
30,Success,51,35,2,12,39
30,Success,57,26,8,9,48
30,Fail,38,34,10,18,20
30,Success,57,34,0,9,48
30,Success,54,37,3,6,48
30,Success,48,37,4,11,37
30,Success,55,33,0,11,44
30,Fail,44,37,4,15,29
30,Success,46,42,0,8,38
30,Success,48,33,0,11,37
30,Fail,44,40,1,15,29
30,Success,50,34,5,11,39
30,Success,56,36,1,7,49
30,Success,49,35,0,11,38
30,Success,45,43,0,9,36
30,Success,48,31,0,17,31
30,Success,51,33,0,13,38
30,Success,52,35,7,6,46
30,Success,54,36,0,10,44
30,Success,46,34,9,11,35
30,Fail,39,39,5,17,22
30,Success,51,35,0,9,42
30,Success,57,35,1,7,50
30,Success,43,44,2,11,32
30,Success,51,34,0,14,37
30,Success,50,36,6,8,42
30,Success,55,31,0,14,41
30,Success,46,35,5,14,32
30,Success,45,42,1,12,33
30,Success,50,37,0,10,40
30,Success,52,38,1,9,43
30,Fail,46,33,0,17,29
30,Fail,41,43,0,12,29
30,Success,50,33,1,16,34
30,Fail,39,42,0,18,21
30,Success,56,37,0,7,49
30,Success,51,36,3,10,41
30,Success,53,36,0,6,47
30,Success,46,31,9,14,32
30,Success,52,30,7,11,41
30,Success,50,31,6,13,37
30,Success,47,38,0,11,36
30,Success,49,39,1,11,38
30,Success,56,33,0,10,46
30,Success,43,46,3,8,35
30,Success,47,32,0,15,32
30,Success,51,39,3,7,44
30,Success,54,30,0,14,40
30,Success,47,39,0,11,36
30,Success,45,33,11,11,34
30,Success,50,35,1,14,36
30,Success,45,38,0,9,36
30,Success,47,39,4,10,37
30,Fail,37,39,0,19,18
30,Success,56,34,0,9,47
30,Success,47,36,0,17,30
30,Fail,42,36,0,15,27
30,Success,47,38,0,12,35
30,Success,51,28,4,17,34
30,Fail,42,41,0,13,29
30,Success,52,34,0,14,38
30,Fail,46,36,0,17,29
30,Success,54,31,0,9,45
30,Success,50,32,10,8,42
30,Success,48,41,0,7,41
30,Success,46,38,6,10,36
30,Success,45,39,0,14,31
30,Success,48,37,0,12,36
30,Success,56,38,0,4,52
30,Fail,41,37,4,18,23
30,Success,48,29,7,16,32
30,Success,53,24,4,19,34
30,Fail,43,35,0,18,25
30,Fail,40,42,2,16,24
30,Success,48,41,0,11,37
30,Fail,47,32,2,19,28
30,Success,49,37,0,12,37
30,Success,52,40,0,7,45
30,Success,49,36,1,14,35
30,Success,49,29,0,18,31
30,Success,49,36,0,12,37
30,Success,52,36,3,9,43
30,Fail,38,38,4,20,18
30,Success,45,40,6,9,36
30,Fail,38,34,8,20,18
30,Success,44,41,0,10,34
30,Success,50,34,0,9,41
30,Success,55,31,2,12,43
30,Success,55,28,0,17,38
30,Success,51,33,0,10,41
30,Success,49,32,0,12,37
30,Success,49,33,1,17,32
30,Success,43,39,5,13,30
30,Success,48,32,10,10,38
30,Success,45,30,10,15,30
30,Success,54,28,0,12,42
30,Success,46,35,0,10,36
30,Success,45,33,0,13,32
30,Success,50,34,7,9,41
30,Success,49,29,0,13,36
30,Success,52,35,1,12,40
30,Success,50,37,1,12,38
30,Success,54,31,3,12,42
30,Success,51,35,0,11,40
30,Success,43,38,7,12,31
30,Success,51,37,0,10,41
30,Fail,43,42,0,14,29
30,Success,51,31,0,15,36
30,Success,43,33,0,12,31
30,Success,52,28,8,12,40
30,Success,50,37,0,7,43
30,Success,51,35,5,9,42
30,Success,56,32,4,8,48
30,Success,52,36,0,11,41
30,Success,50,36,0,11,39
30,Fail,44,34,5,17,27
30,Success,46,42,0,12,34
30,Fail,44,37,2,17,27
30,Success,53,33,3,11,42
30,Fail,44,40,0,15,29
30,Success,55,30,5,10,45
30,Success,48,32,9,11,37
30,Fail,45,38,1,16,29
30,Success,52,38,4,6,46
30,Success,49,36,5,10,39
30,Fail,43,37,0,14,29
30,Success,50,34,4,12,38
30,Fail,43,38,0,14,29
30,Success,53,35,1,11,42
30,Fail,35,40,0,11,24
30,Success,48,27,12,13,35
30,Success,57,38,2,3,54
30,Success,43,40,6,11,32
30,Success,42,40,8,10,32
30,Success,54,38,0,8,46
30,Success,49,40,1,10,39
30,Success,56,27,4,13,43
30,Success,51,30,2,17,34
30,Success,50,39,0,9,41
30,Success,53,35,4,8,45
30,Success,48,33,8,11,37
30,Fail,40,40,0,16,24
30,Success,44,38,5,13,31
30,Success,46,42,1,11,35
30,Success,49,38,2,11,38
30,Fail,43,33,0,17,26
30,Success,47,34,0,10,37
30,Success,54,36,2,8,46
30,Fail,44,33,0,16,28
30,Success,46,38,6,10,36
30,Success,49,29,6,16,33
30,Success,54,24,0,16,38
30,Success,54,30,7,9,45
30,Fail,36,45,8,11,25
30,Success,55,33,0,8,47
30,Success,46,38,0,16,30
30,Success,47,36,0,14,33
30,Success,49,42,0,5,44
30,Success,48,40,0,8,40
30,Success,47,37,6,10,37
30,Success,50,32,6,12,38
30,Success,57,32,6,5,52
30,Success,46,43,0,7,39
30,Success,48,38,1,13,35
30,Success,52,35,0,12,40
30,Success,45,41,0,11,34
30,Success,52,34,0,13,39
30,Success,46,35,0,16,30
30,Success,53,35,4,8,45
30,Success,47,29,7,17,30
30,Success,60,32,1,7,53
30,Success,52,33,2,13,39
30,Fail,44,38,0,16,28
30,Success,46,39,3,12,34
30,Success,47,37,0,14,33
30,Fail,43,40,0,17,26
30,Fail,41,38,7,14,27
30,Fail,41,31,0,16,25
30,Success,53,32,3,12,41
30,Success,49,37,0,10,39
30,Success,51,31,4,14,37
30,Success,51,39,2,8,43
30,Fail,43,36,0,15,28
30,Success,53,36,2,9,44
30,Success,51,29,0,11,40
30,Success,47,37,2,14,33
30,Success,51,39,0,8,43
30,Success,57,29,3,11,46
30,Success,47,38,4,11,36
30,Fail,41,45,1,13,28
30,Success,51,36,3,10,41
30,Fail,41,34,0,17,24
30,Fail,40,43,0,15,25
30,Fail,45,38,0,17,28
30,Success,53,29,0,17,36
30,Success,48,34,1,17,31
30,Success,46,37,0,9,37
30,Success,48,35,0,11,37
30,Success,49,34,0,13,36
30,Success,53,36,4,7,46
30,Success,50,34,0,7,43
30,Success,52,32,2,14,38
30,Success,45,41,5,9,36
30,Success,47,35,0,14,33
30,Success,44,37,10,9,35
30,Success,42,34,0,10,32
30,Success,47,35,0,13,34
30,Success,43,39,6,12,31
30,Success,48,36,0,15,33
30,Success,45,35,0,14,31
30,Success,51,34,0,12,39
30,Success,50,41,0,9,41
30,Fail,39,49,0,11,28
30,Success,45,36,0,11,34
30,Fail,42,42,2,14,28
30,Success,50,37,0,12,38
30,Success,58,31,0,11,47
30,Success,50,34,4,12,38
30,Success,51,36,2,11,40
30,Success,47,40,0,9,38
30,Success,59,33,3,5,54
30,Success,52,30,0,16,36
30,Success,50,34,4,12,38
30,Success,47,41,4,8,39
30,Success,54,32,2,12,42
30,Success,50,37,0,13,37
30,Success,48,41,5,6,42
30,Success,51,36,2,11,40
30,Success,47,43,0,8,39
30,Success,46,37,6,11,35
30,Success,43,44,0,13,30
30,Success,46,40,0,14,32
30,Success,56,36,0,7,49
30,Success,45,42,1,12,33
30,Success,55,33,2,10,45
30,Success,44,33,0,11,33
30,Success,47,41,0,9,38
30,Success,45,27,0,15,30
30,Success,55,33,0,11,44
30,Success,48,24,11,17,31
30,Success,48,38,2,12,36
30,Success,59,27,0,12,47
30,Success,53,33,0,10,43
30,Success,49,35,6,10,39
30,Success,55,34,0,10,45
30,Success,46,34,0,14,32
30,Success,44,37,8,11,33
30,Success,49,36,0,9,40
30,Success,49,37,4,10,39
30,Success,44,38,7,11,33
30,Success,49,42,1,8,41
30,Success,53,36,0,11,42
30,Success,53,38,0,9,44
30,Success,48,36,0,15,33
30,Fail,42,35,4,19,23
30,Success,52,38,1,9,43
30,Success,50,36,5,9,41
30,Success,49,37,0,12,37
30,Success,56,28,0,10,46
30,Success,50,33,0,16,34
30,Success,48,38,1,13,35
30,Success,55,35,0,9,46
30,Success,46,43,1,10,36
30,Success,53,37,1,9,44
30,Fail,39,45,0,15,24
30,Fail,40,39,6,15,25
30,Fail,42,32,11,15,27
30,Success,50,36,7,7,43
30,Success,49,39,4,8,41
30,Success,58,35,1,6,52
30,Success,51,30,9,10,41
30,Success,49,38,0,11,38
30,Success,40,45,6,9,31
30,Success,55,37,0,8,47
30,Success,46,39,0,14,32
30,Success,51,36,0,13,38
30,Fail,41,35,0,23,18
30,Success,48,35,3,14,34
30,Fail,45,30,5,20,25
30,Success,48,31,0,18,30
30,Success,60,27,2,11,49
30,Success,52,37,1,10,42
30,Success,51,35,0,14,37
30,Success,46,33,7,14,32
30,Fail,44,35,2,19,25
30,Fail,39,37,0,11,28
30,Fail,41,36,0,12,29
30,Fail,47,35,0,18,29
30,Success,49,43,1,7,42
30,Success,45,37,0,11,34
30,Success,49,36,5,10,39
30,Success,47,40,1,12,35
30,Success,45,40,0,15,30
30,Success,48,39,2,11,37
30,Success,54,36,0,8,46
30,Success,48,33,2,17,31
30,Fail,44,34,0,19,25
30,Success,54,36,0,8,46
30,Success,54,26,10,10,44
30,Fail,45,37,2,16,29
30,Success,47,29,0,17,30
30,Success,47,41,2,10,37
30,Success,47,33,0,15,32
30,Fail,44,34,2,20,24
30,Success,48,35,7,10,38
30,Success,51,36,0,10,41
30,Success,46,46,0,7,39
30,Success,51,38,1,10,41
30,Success,45,40,0,10,35
30,Success,54,34,1,11,43
30,Success,50,38,1,11,39
30,Success,45,40,4,11,34
30,Fail,42,34,0,15,27
30,Success,46,40,3,11,35
30,Success,48,39,2,11,37
30,Success,50,33,10,7,43
30,Success,47,38,0,11,36
30,Success,48,32,0,13,35
30,Fail,45,27,8,20,25
30,Fail,39,39,0,15,24
30,Success,51,36,0,12,39
30,Success,52,34,2,12,40
30,Success,50,28,0,14,36
30,Success,47,37,0,10,37
30,Fail,47,34,0,18,29
30,Success,47,36,0,14,33
30,Success,49,32,3,16,33
30,Success,45,29,0,12,33
30,Success,53,38,0,9,44
30,Success,54,31,5,10,44
30,Success,47,42,0,10,37
30,Success,58,32,1,9,49
30,Fail,41,40,0,17,24
30,Fail,45,34,0,18,27
30,Success,48,25,0,16,32
30,Success,49,36,3,12,37
30,Success,51,39,0,10,41
30,Success,46,38,4,12,34
30,Success,49,43,1,7,42
30,Fail,46,36,0,18,28
30,Success,53,38,0,7,46
30,Success,50,36,0,12,38
30,Success,54,24,9,13,41
30,Success,49,31,10,10,39
30,Success,50,40,3,7,43
30,Success,55,31,0,9,46
30,Success,49,38,0,9,40
30,Success,47,37,0,12,35
30,Success,48,38,4,10,38
30,Success,50,40,0,10,40
30,Success,47,36,4,13,34
30,Success,48,37,0,9,39
30,Success,49,32,2,17,32
30,Success,46,40,2,12,34
30,Fail,46,28,0,20,26
30,Fail,46,34,0,19,27
30,Success,48,31,6,15,33
30,Success,45,31,10,14,31
30,Fail,38,38,3,21,17
30,Success,45,30,0,13,32
30,Success,49,35,2,14,35
30,Fail,39,44,0,11,28
30,Fail,39,37,0,17,22
30,Success,51,34,1,14,37
30,Success,47,43,0,8,39
30,Success,47,39,1,13,34
30,Success,48,38,3,11,37
30,Success,56,26,7,11,45
30,Success,50,34,0,13,37
30,Success,49,36,1,14,35
30,Success,47,38,4,11,36
30,Success,50,36,1,13,37
30,Success,48,32,0,8,40
30,Success,52,36,1,11,41
30,Success,48,28,0,18,30
30,Success,43,43,2,12,31
30,Success,47,38,0,10,37
30,Success,50,35,0,10,40
30,Success,44,45,1,10,34
30,Success,55,34,0,11,44
30,Fail,43,36,0,14,29
30,Success,44,34,8,14,30
30,Success,47,36,6,11,36
30,Success,53,31,0,12,41
30,Success,47,39,0,9,38
30,Success,50,38,1,11,39
30,Fail,42,40,0,15,27
30,Success,45,38,5,12,33
30,Success,50,37,0,8,42
30,Success,49,29,10,12,37
30,Fail,40,44,4,12,28
30,Success,51,33,6,10,41
30,Fail,44,35,5,16,28
30,Fail,41,38,0,13,28
30,Success,50,31,0,17,33
30,Success,46,36,9,9,37
30,Success,44,42,0,9,35
30,Success,46,33,0,11,35
30,Success,49,35,0,13,36
30,Success,49,27,0,14,35
30,Fail,41,44,3,12,29
30,Success,53,37,0,9,44
30,Fail,39,37,0,18,21
30,Success,61,25,0,13,48
30,Fail,45,32,0,19,26
30,Success,51,36,0,11,40
30,Success,50,34,4,12,38
30,Success,44,40,4,12,32
30,Success,43,36,0,13,30
30,Success,50,35,3,12,38
30,Success,42,48,0,8,34
30,Fail,34,41,4,21,13
30,Success,52,35,1,12,40
30,Success,50,31,0,18,32
30,Success,46,40,4,10,36
30,Fail,39,44,3,14,25
30,Success,51,35,3,11,40
30,Success,54,33,2,11,43
30,Success,47,30,0,16,31
30,Success,40,41,11,8,32
30,Success,54,36,2,8,46
30,Success,49,29,0,13,36
30,Fail,46,33,0,17,29
30,Success,50,34,0,8,42
30,Success,49,38,0,11,38
30,Fail,40,34,7,19,21
30,Fail,43,37,0,15,28
30,Success,45,41,0,10,35
30,Success,61,31,0,8,53
30,Success,47,42,0,10,37
30,Fail,45,34,0,18,27
30,Success,58,27,0,15,43
30,Fail,42,41,0,14,28
30,Success,44,43,3,10,34
30,Success,53,32,6,9,44
30,Fail,42,42,3,13,29
30,Fail,46,30,5,19,27
30,Success,54,33,0,10,44
30,Success,54,28,3,15,39
30,Success,43,37,11,9,34
30,Success,49,31,0,17,32
30,Success,49,37,0,9,40
30,Success,47,33,9,11,36
30,Success,52,26,0,9,43
30,Success,48,34,0,11,37
30,Success,50,40,2,8,42
30,Success,47,35,1,17,30
30,Fail,44,40,0,15,29
30,Success,44,40,0,12,32
30,Success,43,41,8,8,35
30,Success,44,47,0,8,36
30,Success,53,31,0,8,45
30,Success,46,36,0,12,34
30,Success,51,35,0,11,40
30,Success,50,40,2,8,42
30,Success,48,34,0,11,37
30,Success,45,32,9,14,31
30,Success,44,38,0,9,35
30,Success,49,32,5,14,35
30,Success,52,36,4,8,44
30,Success,56,28,12,4,52
30,Success,49,32,1,18,31
30,Success,42,40,0,9,33
30,Success,47,38,2,13,34
30,Success,48,36,4,12,36
30,Success,52,34,0,14,38
30,Success,47,36,11,6,41
30,Success,49,39,0,9,40
30,Success,54,26,10,10,44
30,Success,49,33,0,18,31
30,Success,49,41,2,8,41
30,Success,51,36,1,12,39
30,Success,49,36,3,12,37
30,Success,49,33,0,12,37
30,Success,48,32,2,18,30
30,Success,51,31,5,13,38
30,Success,51,29,5,15,36
30,Success,51,29,0,16,35
30,Success,50,39,0,7,43
30,Fail,41,41,4,14,27
30,Success,43,45,3,9,34
30,Success,40,39,0,10,30
30,Fail,45,36,1,18,27
30,Success,47,37,3,13,34
30,Success,48,41,0,8,40
30,Success,45,37,6,12,33
30,Success,51,39,2,8,43
30,Success,51,32,0,17,34
30,Success,47,36,0,8,39
30,Success,54,33,0,13,41
30,Success,54,28,6,12,42
30,Success,48,37,3,12,36
30,Success,47,38,0,11,36
30,Success,54,33,0,11,43
30,Success,51,27,0,15,36
30,Success,46,34,0,12,34
30,Success,50,33,6,11,39
30,Success,55,30,0,11,44
30,Success,48,32,0,15,33
30,Success,49,28,8,15,34
30,Success,49,40,5,6,43
30,Success,58,32,2,8,50
30,Success,45,41,0,12,33
30,Success,53,36,0,10,43
30,Success,47,39,0,13,34
30,Success,50,36,0,9,41
30,Success,48,37,0,8,40
30,Success,48,43,6,3,45
30,Success,48,34,0,12,36
30,Success,51,34,0,13,38
30,Success,47,35,0,14,33
30,Success,46,39,2,13,33
30,Success,47,40,3,10,37
30,Success,51,35,2,12,39
30,Success,57,38,0,5,52
30,Success,49,33,0,14,35
30,Success,54,29,0,12,42
30,Success,48,30,0,16,32
30,Fail,39,38,0,13,26
30,Success,48,27,9,16,32
30,Success,52,29,3,16,36
30,Success,50,31,0,13,37
30,Fail,38,38,5,19,19
30,Success,46,39,3,12,34
30,Success,47,39,1,13,34
30,Success,51,32,7,10,41
30,Fail,43,33,9,15,28
30,Success,48,37,0,15,33
30,Success,50,33,0,17,33
30,Success,53,34,0,9,44
30,Success,53,35,0,10,43
30,Fail,46,33,0,20,26
30,Fail,40,39,0,14,26
30,Fail,42,41,0,13,29
30,Success,49,38,1,12,37
30,Success,50,33,4,13,37
30,Success,53,35,0,12,41
30,Success,50,35,2,13,37
30,Success,49,33,0,14,35
30,Success,47,41,5,7,40
30,Success,43,40,0,11,32
30,Success,55,29,0,15,40
30,Fail,43,35,0,20,23
30,Fail,39,41,5,15,24
30,Success,51,35,3,11,40
30,Success,53,37,1,9,44
30,Success,49,36,0,10,39
30,Success,44,41,0,13,31
30,Fail,43,35,4,18,25
30,Success,42,36,0,10,32
30,Success,49,31,0,13,36
30,Fail,42,37,0,14,28
30,Success,43,46,1,10,33
30,Success,50,37,2,11,39
30,Fail,42,34,7,17,25
30,Success,48,36,3,13,35
30,Success,47,37,0,13,34
30,Success,44,39,0,13,31
30,Success,52,28,0,14,38
30,Success,45,34,8,13,32
30,Success,45,36,4,15,30
30,Success,47,35,2,16,31
30,Success,49,37,0,13,36
30,Success,50,37,0,13,37
30,Fail,41,38,0,19,22
30,Success,44,38,4,14,30
30,Success,47,29,0,16,31
30,Success,47,33,0,9,38
30,Success,44,35,0,13,31
30,Success,55,33,3,9,46
30,Success,46,40,2,12,34
30,Success,43,44,1,12,31
30,Success,49,34,0,15,34
30,Success,54,34,1,11,43
30,Success,54,34,1,11,43
30,Success,43,44,0,10,33
30,Success,50,31,0,9,41
30,Success,44,41,0,12,32
30,Success,49,36,6,9,40
30,Success,46,40,2,12,34
30,Success,55,35,0,8,47
30,Success,51,37,2,10,41
30,Success,47,34,4,15,32
30,Success,53,36,0,11,42
30,Fail,46,33,4,17,29
30,Success,57,30,0,12,45
30,Success,52,34,9,5,47
30,Fail,42,39,0,13,29
30,Success,47,37,9,7,40
30,Success,49,40,2,9,40
30,Success,48,35,7,10,38
30,Success,44,38,0,12,32
30,Success,49,32,0,14,35
30,Success,49,38,1,12,37
30,Fail,41,38,0,17,24
30,Success,49,35,0,5,44
30,Fail,43,35,5,17,26
30,Success,49,35,0,13,36
30,Success,54,33,0,7,47
30,Success,53,34,0,13,40
30,Success,48,36,0,13,35
30,Success,47,36,5,12,35
30,Fail,43,33,0,20,23
30,Success,47,32,0,15,32
30,Fail,44,30,0,20,24
30,Success,47,33,7,13,34
30,Fail,41,35,0,14,27
30,Success,45,37,0,13,32
30,Success,45,35,0,15,30
30,Success,48,33,8,11,37
30,Success,45,38,2,15,30
30,Success,42,41,6,11,31
30,Success,43,41,0,11,32
30,Success,48,39,1,12,36
30,Success,50,34,3,13,37
30,Success,43,39,0,8,35
30,Success,49,32,3,16,33
30,Success,53,37,1,9,44
30,Success,47,35,3,15,32
30,Fail,37,44,0,17,20
30,Success,47,38,0,12,35
30,Success,50,34,4,12,38
30,Success,51,36,6,7,44
30,Success,55,35,0,10,45
30,Success,44,41,0,12,32
30,Success,48,36,0,14,34
30,Success,43,43,0,13,30
30,Success,52,29,0,10,42
30,Success,46,41,2,11,35
30,Success,45,42,0,11,34
30,Fail,36,41,11,12,24
30,Success,49,35,2,14,35
30,Success,43,35,11,11,32
30,Success,45,35,0,11,34
30,Success,51,28,0,15,36
30,Success,46,34,6,14,32
30,Success,51,34,0,15,36
30,Success,49,32,0,17,32
30,Success,51,37,0,11,40
30,Fail,38,34,9,19,19
30,Success,54,28,8,10,44
30,Success,47,41,1,11,36
30,Success,56,29,0,14,42
30,Success,58,27,4,11,47
30,Success,57,26,0,16,41
30,Fail,45,29,0,17,28
30,Success,49,35,1,15,34
30,Fail,47,31,3,19,28
30,Success,51,36,4,9,42
30,Fail,44,34,6,16,28
30,Success,51,36,0,10,41
30,Success,53,21,11,15,38
30,Fail,45,35,0,17,28
30,Fail,45,36,3,16,29
30,Success,51,39,3,7,44
30,Success,56,26,7,11,45
30,Success,51,35,0,13,38
30,Success,48,35,8,9,39
30,Fail,44,29,9,18,26
30,Success,48,36,0,14,34
30,Success,53,31,5,11,42
30,Success,46,30,9,15,31
30,Success,50,35,3,12,38
30,Fail,41,35,6,18,23
30,Success,49,38,0,13,36
30,Success,51,28,0,18,33
30,Fail,40,45,0,11,29
30,Success,46,37,0,15,31
30,Success,50,28,0,15,35
30,Fail,41,40,6,13,28
30,Success,46,41,0,10,36
30,Fail,44,35,0,18,26
30,Fail,44,31,9,16,28
30,Success,45,43,5,7,38
30,Success,47,39,0,12,35
30,Success,45,40,0,14,31
30,Success,49,35,0,13,36
30,Fail,38,49,4,9,29
30,Fail,43,39,0,18,25
30,Success,48,35,3,14,34
30,Success,51,38,0,8,43
30,Success,49,37,0,11,38
30,Fail,40,35,6,19,21
30,Fail,40,34,0,18,22
30,Fail,44,34,1,21,23
30,Success,43,40,0,10,33
30,Fail,40,40,3,17,23
30,Success,50,37,0,13,37
30,Success,50,35,2,13,37
30,Success,51,32,4,13,38
30,Fail,42,38,0,16,26
30,Success,47,34,0,13,34
30,Success,52,33,0,11,41
30,Success,51,33,3,13,38
30,Success,46,41,0,12,34
30,Success,50,30,8,12,38
30,Success,54,37,0,8,46
30,Success,50,40,1,9,41
30,Fail,43,31,0,16,27
30,Success,52,40,0,8,44
30,Success,50,35,0,13,37
30,Fail,40,41,0,12,28
30,Success,48,40,0,12,36
30,Success,53,29,5,13,40
30,Success,46,31,10,13,33
30,Success,52,35,0,12,40
30,Success,56,33,2,9,47
30,Fail,45,33,0,18,27
30,Fail,38,46,5,11,27
30,Success,47,33,7,13,34
30,Fail,37,47,8,8,29
30,Success,45,39,3,13,32
30,Fail,40,44,0,12,28
30,Success,49,41,1,9,40
30,Success,48,39,0,11,37
30,Success,47,36,4,13,34
30,Success,49,36,0,13,36
30,Success,48,43,0,6,42
30,Success,58,28,2,12,46
30,Success,54,34,0,9,45
30,Success,47,38,4,11,36
30,Success,44,39,0,12,32
30,Success,53,35,0,10,43
30,Success,50,31,6,13,37
30,Success,50,36,4,10,40
30,Success,51,33,2,14,37
30,Fail,42,32,0,18,24
30,Success,57,23,7,13,44
30,Success,50,33,0,13,37
30,Fail,45,31,0,18,27
30,Success,42,42,0,11,31
30,Fail,42,33,0,19,23
30,Success,52,36,4,8,44
30,Fail,34,48,0,14,20
30,Success,46,42,3,9,37
30,Fail,42,32,0,19,23
30,Success,49,30,2,19,30
30,Fail,47,27,0,18,29
30,Success,44,40,0,14,30
30,Success,55,32,6,7,48
30,Success,49,26,0,14,35
30,Success,43,48,0,6,37
30,Success,47,41,0,9,38
30,Success,47,39,0,12,35
30,Success,54,35,0,11,43
30,Success,49,41,0,10,39
30,Success,47,40,0,12,35
30,Success,49,33,7,11,38
30,Success,52,28,0,8,44
30,Success,56,38,1,5,51
30,Success,44,41,0,12,32
30,Success,52,34,0,13,39
30,Fail,46,27,9,18,28
30,Success,47,39,0,4,43
30,Success,51,31,0,13,38
30,Success,53,28,0,16,37
30,Success,54,35,0,8,46
30,Success,52,29,0,11,41
30,Success,50,31,0,14,36
30,Success,48,33,0,10,38
30,Fail,42,40,0,16,26
30,Success,49,36,0,10,39
30,Success,45,36,9,10,35
30,Success,46,38,0,14,32
30,Success,47,33,0,14,33
30,Success,43,41,0,9,34
30,Fail,38,30,0,19,19
30,Success,46,39,1,14,32
30,Success,45,45,1,9,36
30,Success,50,35,0,14,36
30,Success,49,34,6,11,38
30,Success,50,37,0,9,41
30,Fail,42,38,6,14,28
30,Success,48,38,0,14,34
30,Success,47,38,0,13,34
30,Success,45,33,0,15,30
30,Success,51,34,0,10,41
30,Success,46,40,1,13,33
30,Success,52,44,0,4,48
30,Success,43,42,5,10,33
30,Success,51,36,1,12,39
30,Success,47,36,4,13,34
30,Success,49,32,0,15,34
30,Success,51,38,0,8,43
30,Success,52,28,0,14,38
30,Success,46,38,0,11,35
30,Success,46,39,3,12,34
30,Success,49,37,0,12,37
30,Fail,43,34,0,19,24
30,Success,52,36,0,10,42
30,Success,48,35,0,12,36
30,Success,46,33,5,16,30
30,Fail,39,43,3,15,24
30,Success,47,33,5,15,32
30,Success,44,41,1,14,30
30,Success,49,39,3,9,40
30,Success,49,31,0,12,37
30,Success,53,38,1,8,45
30,Fail,43,39,0,15,28
30,Success,53,31,5,11,42
30,Success,51,37,0,12,39
30,Success,51,42,0,4,47
30,Success,51,29,0,18,33
30,Success,44,37,7,12,32
30,Success,46,41,2,11,35
30,Success,44,42,0,11,33
30,Fail,45,38,0,17,28
30,Success,52,37,1,10,42
30,Success,48,38,5,9,39
30,Success,45,38,5,12,33
30,Fail,41,39,0,17,24
30,Success,46,42,0,12,34
30,Success,52,35,0,10,42
30,Success,56,24,0,11,45
30,Success,47,40,3,10,37
30,Fail,42,35,3,20,22
30,Success,46,39,0,13,33
30,Success,50,35,5,10,40
30,Success,51,32,0,13,38
30,Success,58,32,0,10,48
30,Success,45,43,6,6,39
30,Fail,44,34,0,15,29
30,Success,48,31,0,13,35
30,Success,47,35,3,15,32
30,Success,49,33,0,15,34
30,Success,51,34,0,10,41
30,Fail,44,39,0,15,29
30,Success,49,27,0,16,33
30,Success,49,39,0,12,37
30,Success,49,37,1,13,36
30,Success,46,35,7,12,34
30,Success,57,32,0,9,48
30,Fail,43,33,0,16,27
30,Success,42,42,0,12,30
30,Success,49,31,5,15,34
30,Success,48,38,4,10,38
30,Success,51,33,5,11,40
30,Success,49,32,7,12,37
30,Success,50,38,0,8,42
30,Fail,46,31,0,17,29
30,Success,47,39,0,12,35
30,Success,51,33,0,9,42
30,Success,48,35,0,13,35
30,Success,52,34,4,10,42
30,Success,46,41,3,10,36
30,Success,46,36,0,12,34
30,Success,56,29,0,10,46
30,Fail,44,30,11,15,29
30,Fail,43,34,4,19,24
30,Success,48,31,0,16,32
30,Success,55,27,0,11,44
30,Success,52,39,3,6,46
30,Fail,39,40,0,10,29
30,Success,51,39,0,10,41
30,Fail,44,37,0,16,28
30,Fail,42,35,8,15,27
30,Success,58,27,0,12,46
30,Fail,39,31,0,16,23
30,Success,45,36,0,15,30
30,Fail,40,36,5,19,21
30,Success,52,39,0,9,43
30,Success,49,31,0,13,36
30,Success,47,41,1,11,36
30,Success,46,32,7,15,31
30,Fail,41,42,0,12,29
30,Success,49,36,0,14,35
30,Success,50,32,5,13,37
30,Success,47,29,0,13,34
30,Success,53,34,2,11,42
30,Success,50,32,0,16,34
30,Success,54,33,4,9,45
30,Success,42,37,0,12,30
30,Success,50,38,0,12,38
30,Success,48,38,2,12,36
30,Success,57,24,5,14,43
30,Success,48,39,0,11,37
30,Success,50,29,5,16,34
30,Fail,45,35,3,17,28
30,Success,59,27,0,13,46
30,Success,49,37,1,13,36
30,Success,50,31,0,12,38
30,Success,54,33,0,12,42
30,Success,48,38,0,14,34
30,Success,57,27,0,15,42
30,Success,51,34,0,14,37
30,Success,44,39,5,12,32
30,Fail,40,29,0,18,22
30,Success,53,35,0,9,44
30,Success,47,33,3,17,30
30,Fail,46,33,0,18,28
30,Success,51,33,0,11,40
30,Success,51,37,0,11,40
30,Success,52,34,0,14,38
30,Success,47,31,6,16,31
30,Success,45,41,7,7,38
30,Success,45,39,0,12,33
30,Success,46,39,4,11,35
30,Success,56,29,0,10,46
30,Fail,40,38,0,16,24
30,Fail,44,29,6,21,23
30,Success,42,44,4,10,32
30,Success,52,37,0,10,42
30,Success,52,33,1,14,38
30,Fail,41,33,0,18,23
30,Fail,42,34,0,16,26
30,Success,48,32,0,14,34
30,Success,43,44,0,8,35
30,Success,50,33,4,13,37
30,Success,47,35,0,16,31
30,Success,52,29,0,14,38
30,Success,48,33,3,16,32
30,Success,55,34,1,10,45
30,Success,50,36,0,12,38
30,Success,44,35,0,14,30
30,Success,51,31,1,17,34
30,Success,47,39,2,12,35
30,Fail,40,42,0,17,23
30,Success,53,31,0,15,38
30,Success,52,35,0,9,43
30,Fail,43,39,3,15,28
30,Fail,40,35,0,18,22
30,Success,44,41,3,12,32
30,Success,51,37,0,11,40
30,Success,46,29,0,13,33
30,Success,44,39,0,11,33
30,Success,43,37,0,11,32
30,Fail,44,32,6,18,26
30,Success,50,37,0,8,42
30,Success,50,34,0,9,41
30,Success,52,26,0,20,32
30,Success,46,39,0,14,32
30,Success,46,38,0,15,31
30,Success,54,33,0,11,43
30,Success,47,42,0,10,37
30,Success,50,34,0,16,34
30,Success,53,41,0,6,47
30,Success,46,38,0,13,33
30,Success,49,40,0,10,39
30,Success,55,33,0,10,45
30,Success,45,38,0,14,31
30,Fail,48,31,0,20,28
30,Success,55,29,3,13,42
30,Success,48,40,0,11,37
30,Success,55,36,0,8,47
30,Success,58,35,0,6,52
30,Success,46,35,7,12,34
30,Success,55,32,0,13,42
30,Success,52,36,1,11,41
30,Success,48,38,3,11,37
30,Success,51,37,0,8,43
30,Success,55,28,0,15,40
30,Success,53,31,0,15,38
30,Success,50,34,0,11,39
30,Success,45,44,0,9,36
30,Fail,44,36,4,16,28
30,Success,48,36,0,12,36
30,Success,50,41,1,8,42
30,Success,50,37,4,9,41
30,Success,51,39,3,7,44
30,Success,48,39,4,9,39
30,Success,52,35,2,11,41
30,Success,47,37,2,14,33
30,Success,52,30,2,16,36
30,Success,53,32,2,13,40
30,Success,46,38,4,12,34
30,Fail,41,39,7,13,28
30,Success,49,30,10,11,38
30,Success,46,39,0,13,33
30,Success,50,33,3,14,36
30,Fail,45,35,0,18,27
30,Fail,48,32,0,19,29
30,Success,57,28,0,12,45
30,Success,46,38,0,12,34
30,Success,49,34,0,16,33
30,Success,49,40,2,9,40
30,Success,54,34,1,11,43
30,Success,52,37,0,8,44
30,Success,48,33,0,13,35
30,Success,41,48,0,9,32
30,Success,47,30,15,8,39
30,Fail,45,28,7,20,25
30,Success,57,27,2,14,43
30,Success,54,33,1,12,42
30,Success,56,31,0,13,43
30,Fail,46,34,0,17,29
30,Fail,44,36,3,17,27
30,Success,59,30,0,11,48
30,Success,49,41,2,8,41
30,Success,53,33,3,11,42
30,Success,55,35,0,9,46
30,Success,51,40,4,5,46
30,Success,44,48,0,5,39
30,Success,43,42,2,13,30
30,Fail,45,30,0,16,29
30,Success,45,42,1,12,33
30,Success,48,38,0,11,37
30,Success,54,39,0,7,47
30,Success,46,38,1,15,31
30,Success,49,36,3,12,37
30,Success,55,36,0,6,49
30,Success,48,30,0,14,34
30,Success,48,34,0,13,35
30,Success,47,34,8,11,36
30,Success,50,31,1,18,32
30,Success,50,35,1,14,36
30,Success,53,34,0,12,41
30,Success,53,32,4,11,42
30,Success,46,37,0,12,34
30,Success,53,36,0,10,43
30,Success,47,30,6,17,30
30,Success,50,35,5,10,40
30,Success,49,39,1,11,38
30,Fail,40,38,7,15,25
30,Success,49,37,0,13,36
30,Success,46,32,0,16,30
30,Success,47,36,0,13,34
30,Fail,40,47,0,12,28
30,Success,53,31,0,12,41
30,Success,52,34,4,10,42
30,Success,51,36,3,10,41
30,Success,47,34,5,14,33
30,Success,44,39,0,14,30
30,Success,50,40,0,9,41
30,Success,49,42,0,6,43
30,Fail,43,38,5,14,29
30,Success,50,34,5,11,39
30,Success,49,31,7,13,36
30,Success,55,29,1,15,40
30,Success,54,32,0,14,40
30,Success,53,38,0,7,46
30,Fail,39,44,5,12,27
30,Success,60,28,0,10,50
30,Success,50,37,0,9,41
30,Success,52,34,0,13,39
30,Success,53,29,2,16,37
30,Success,52,39,0,9,43
30,Success,46,38,6,10,36
30,Success,47,32,0,17,30
30,Fail,42,41,0,14,28
30,Success,52,31,0,10,42
30,Success,47,38,0,14,33
30,Success,47,35,10,8,39
30,Success,46,38,2,14,32
30,Fail,47,30,0,19,28
30,Success,50,41,2,7,43
30,Success,54,28,0,16,38
30,Fail,41,41,0,16,25
30,Success,45,35,0,13,32
30,Success,47,34,0,17,30
30,Fail,43,31,11,15,28
30,Success,48,37,3,12,36
30,Fail,43,33,0,19,24
30,Fail,45,34,0,20,25
30,Success,48,40,1,11,37
30,Success,53,28,0,14,39
30,Success,52,34,0,12,40
30,Success,48,40,1,11,37
30,Success,51,33,3,13,38
30,Fail,42,30,0,20,22
30,Fail,44,37,1,18,26
30,Fail,38,40,0,17,21
30,Success,53,32,0,12,41
30,Success,50,35,0,9,41
30,Success,48,36,0,10,38
30,Success,47,33,0,14,33
30,Success,48,39,0,11,37
30,Success,50,35,0,12,38
30,Success,51,33,0,12,39
30,Success,54,26,3,17,37
30,Fail,44,41,0,15,29
30,Fail,39,44,0,15,24
30,Success,50,39,0,10,40
30,Success,45,33,0,12,33
30,Success,43,42,0,11,32
30,Success,54,34,0,9,45
30,Success,48,40,0,12,36
30,Success,48,43,3,6,42
30,Success,49,29,4,18,31
30,Success,51,30,0,11,40
30,Success,48,39,0,11,37
30,Success,54,28,4,14,40
30,Success,56,35,0,9,47
30,Success,41,41,0,11,30
30,Success,54,34,0,10,44
30,Fail,40,38,0,19,21
30,Success,45,40,2,13,32
30,Success,41,33,16,10,31
30,Success,41,46,2,11,30
30,Success,52,40,0,8,44
30,Success,46,36,0,16,30
30,Fail,42,41,0,13,29
30,Success,49,37,2,12,37
30,Success,49,41,0,9,40
30,Fail,40,45,0,15,25
30,Success,45,32,0,15,30
30,Success,51,34,1,14,37
30,Success,48,28,7,17,31
30,Fail,47,30,4,19,28
30,Success,51,37,0,9,42
30,Success,49,36,4,11,38
30,Success,51,40,0,9,42
30,Success,52,42,1,5,47
30,Success,48,32,0,7,41
30,Success,47,34,2,17,30
30,Success,48,29,9,14,34
30,Success,48,38,0,12,36
30,Success,48,37,0,13,35
30,Success,48,32,3,17,31
30,Success,48,39,2,11,37
30,Success,45,46,0,9,36
30,Fail,42,36,0,15,27
30,Success,49,38,4,9,40
30,Success,49,39,0,12,37
30,Success,49,35,3,13,36
30,Success,45,38,0,8,37
30,Success,51,37,0,12,39
30,Fail,45,25,10,20,25
30,Success,53,33,0,10,43
30,Success,51,30,0,14,37
30,Success,45,45,0,10,35
30,Fail,41,33,0,19,22
30,Fail,41,37,6,16,25
30,Success,48,40,0,11,37
30,Success,51,33,4,12,39
30,Success,55,32,3,10,45
30,Success,48,40,0,10,38
30,Success,44,45,2,9,35
30,Success,43,46,5,6,37
30,Success,46,38,0,10,36
30,Success,46,33,6,15,31
30,Fail,42,33,10,15,27
30,Success,56,31,0,11,45
30,Success,49,30,0,11,38
30,Success,47,35,0,13,34
30,Success,53,30,0,16,37
30,Fail,43,40,1,16,27
30,Success,54,34,0,11,43
30,Success,54,26,0,12,42
30,Success,45,36,0,12,33
30,Success,51,40,0,9,42
30,Success,42,42,0,9,33
30,Success,53,29,2,16,37
30,Success,39,42,0,9,30
30,Success,52,41,1,6,46
30,Success,47,34,8,11,36
30,Fail,38,43,6,13,25
30,Success,46,32,8,14,32
30,Success,58,30,0,8,50
30,Success,48,33,0,12,36
30,Success,48,30,6,16,32
30,Success,41,44,0,10,31
30,Success,44,38,4,14,30
30,Success,54,33,2,11,43
30,Success,51,38,2,9,42
30,Success,53,38,0,8,45
30,Success,48,33,0,14,34
30,Success,47,40,1,12,35
30,Success,50,35,0,12,38
30,Success,45,39,7,9,36
30,Success,52,36,0,11,41
30,Success,51,35,2,12,39
30,Success,54,35,3,8,46
30,Fail,45,34,0,16,29
30,Success,47,37,0,15,32
30,Fail,42,30,0,18,24
30,Success,53,36,1,10,43
30,Success,54,38,0,8,46
30,Success,51,33,5,11,40
30,Success,54,27,0,11,43
30,Success,44,42,3,11,33
30,Success,47,31,0,11,36
30,Success,56,28,5,11,45
30,Fail,42,37,0,15,27
30,Success,45,38,6,11,34
30,Success,44,44,0,9,35
30,Success,46,39,8,7,39
30,Success,47,35,0,11,36
30,Success,47,34,2,17,30
30,Fail,44,34,0,15,29
30,Success,53,29,0,11,42
30,Fail,42,41,0,13,29
30,Success,49,34,0,14,35
30,Success,52,36,3,9,43
30,Success,52,33,5,10,42
30,Success,50,35,3,12,38
30,Success,55,32,4,9,46
30,Fail,42,35,0,15,27
30,Fail,45,37,0,18,27
30,Success,51,33,0,14,37
30,Success,48,38,0,10,38
30,Success,48,30,11,11,37
30,Success,49,41,1,9,40
30,Success,48,41,0,7,41
30,Success,62,26,0,11,51
30,Success,43,41,8,8,35
30,Fail,46,26,0,17,29
30,Fail,46,36,1,17,29
30,Success,46,42,2,10,36
30,Success,52,34,0,13,39
30,Fail,45,36,1,18,27
30,Success,50,28,2,20,30
30,Success,49,38,0,11,38
30,Success,49,39,0,12,37
30,Success,51,31,5,13,38
30,Fail,41,44,3,12,29
30,Success,44,38,0,12,32
30,Success,53,30,5,12,41
30,Success,53,34,0,13,40
30,Success,46,35,0,16,30
30,Success,55,33,0,7,48
30,Success,53,28,9,10,43
30,Success,43,41,0,11,32
30,Success,48,37,0,14,34
30,Success,45,39,0,8,37
30,Success,47,38,0,10,37
30,Success,47,33,5,15,32
30,Success,48,34,0,12,36
30,Success,47,40,0,13,34
30,Success,48,37,0,13,35
30,Success,48,42,1,9,39
30,Success,59,22,9,10,49
30,Success,47,34,0,16,31
30,Success,41,36,0,11,30
30,Success,54,33,0,10,44
30,Success,48,41,0,11,37
30,Success,45,31,0,15,30
30,Success,46,39,1,14,32
30,Success,49,38,0,9,40
30,Success,49,34,0,16,33
30,Success,49,35,0,14,35
30,Success,44,44,0,12,32
30,Success,42,48,0,8,34
30,Success,50,36,0,13,37
30,Success,51,36,2,11,40
30,Success,57,37,1,5,52
30,Success,50,37,2,11,39
30,Success,48,36,3,13,35
30,Success,49,34,1,16,33
30,Success,56,31,1,12,44
30,Success,53,40,0,6,47
30,Success,53,32,0,13,40
30,Success,44,37,0,13,31
30,Fail,42,33,0,18,24
30,Success,55,30,0,14,41
30,Success,48,36,3,13,35
30,Success,50,36,0,9,41
30,Fail,37,41,3,19,18
30,Fail,42,42,0,13,29
30,Success,44,47,2,7,37
30,Success,44,45,1,10,34
30,Success,44,37,0,10,34
30,Success,54,38,0,7,47
30,Success,56,40,0,4,52
30,Fail,36,41,0,13,23
30,Success,44,40,4,12,32
30,Success,46,42,3,9,37
30,Fail,43,34,0,15,28
30,Success,44,37,0,12,32
30,Success,46,37,0,11,35
30,Fail,39,42,0,13,26
30,Success,48,39,5,8,40
30,Success,48,33,0,17,31
30,Success,52,38,0,8,44
30,Fail,42,41,0,15,27
30,Fail,41,36,0,17,24
30,Success,47,34,0,16,31
30,Success,64,27,0,9,55
30,Fail,37,41,4,18,19
30,Success,42,43,3,12,30
30,Success,50,32,0,14,36
30,Success,48,32,2,18,30
30,Success,49,34,1,16,33
30,Success,55,35,0,9,46
30,Success,51,30,5,14,37
30,Fail,42,29,8,21,21
30,Success,59,29,0,12,47
30,Success,48,42,3,7,41
30,Success,51,34,0,15,36
30,Fail,43,31,12,14,29
30,Fail,42,32,4,22,20
30,Success,47,37,0,12,35
30,Success,53,35,0,12,41
30,Success,48,38,2,12,36
30,Success,53,31,2,14,39
30,Success,43,41,0,11,32
30,Success,46,42,2,10,36
30,Fail,43,38,1,18,25
30,Success,51,37,4,8,43
30,Success,55,35,4,6,49
30,Success,43,41,3,13,30
30,Success,53,33,0,13,40
30,Success,55,26,0,16,39
30,Success,51,35,1,13,38
30,Success,57,30,0,13,44
30,Success,44,35,7,14,30
30,Success,50,37,0,10,40
30,Success,49,40,0,5,44
30,Success,55,31,1,13,42
30,Success,48,35,6,11,37
30,Success,44,31,0,14,30
30,Success,48,40,1,11,37
30,Fail,44,34,7,15,29
30,Success,43,38,0,13,30
30,Success,58,33,0,9,49
30,Success,45,42,6,7,38
30,Success,44,40,0,13,31
30,Fail,38,42,4,16,22
30,Success,52,31,6,11,41
30,Success,52,40,0,7,45
30,Success,49,35,3,13,36
30,Success,55,32,0,9,46
30,Success,52,34,0,11,41
30,Success,43,42,0,12,31
30,Success,49,45,1,5,44
30,Success,44,34,12,10,34
30,Success,52,33,0,7,45
30,Success,48,36,0,9,39
30,Success,47,40,0,9,38
30,Success,46,38,0,14,32
30,Fail,45,37,0,16,29
30,Success,46,36,0,14,32
30,Fail,45,27,11,17,28
30,Success,50,30,0,18,32
30,Success,55,30,2,13,42
30,Fail,37,45,2,16,21
30,Success,46,32,10,12,34
30,Success,55,31,2,12,43
30,Fail,44,32,0,15,29
30,Success,46,41,0,13,33
30,Success,52,35,3,10,42
30,Success,39,47,6,8,31
30,Success,52,34,0,12,40
30,Fail,42,42,0,14,28
30,Success,49,33,0,10,39
30,Fail,42,42,0,15,27
30,Success,52,36,4,8,44
30,Success,51,39,4,6,45
30,Success,47,39,0,11,36
30,Fail,42,42,1,15,27
30,Fail,48,31,1,20,28
30,Success,48,34,6,12,36
30,Fail,38,42,6,14,24
30,Success,42,49,0,9,33
30,Fail,41,44,0,12,29
30,Success,48,36,4,12,36
30,Success,47,35,0,16,31
30,Success,47,40,3,10,37
30,Success,45,38,0,11,34
30,Success,52,34,0,10,42
30,Success,47,36,2,15,32
30,Fail,39,40,7,14,25
30,Success,51,30,2,17,34
30,Success,48,38,3,11,37
30,Success,45,37,5,13,32
30,Success,51,34,1,14,37
30,Fail,41,35,0,23,18
30,Success,39,52,6,3,36
30,Success,52,32,2,14,38
30,Success,57,30,4,9,48
30,Success,49,37,2,12,37
30,Success,50,29,8,13,37
30,Success,44,44,0,11,33
30,Fail,45,32,0,17,28
30,Success,47,37,1,15,32
30,Fail,42,33,8,17,25
30,Success,48,35,6,11,37
30,Success,52,35,4,9,43
30,Fail,39,40,2,19,20
30,Success,53,33,1,13,40
30,Success,52,35,0,12,40
30,Success,47,32,0,15,32
30,Success,50,39,0,8,42
30,Success,48,40,0,11,37
30,Success,44,37,0,12,32
30,Success,49,39,3,9,40
30,Success,51,36,0,8,43
30,Success,57,34,0,9,48
30,Success,50,32,7,11,39
30,Success,47,39,0,13,34
30,Success,41,46,2,11,30
30,Fail,41,39,0,17,24
30,Success,46,38,0,13,33
30,Success,51,33,1,15,36
30,Success,48,31,4,17,31
30,Success,48,37,0,13,35
30,Success,50,37,3,10,40
30,Fail,45,37,0,17,28
30,Success,54,37,0,9,45
30,Success,52,38,0,8,44
30,Success,47,33,4,16,31
30,Fail,39,42,5,14,25
30,Success,45,40,6,9,36
30,Success,47,39,4,10,37
30,Success,54,27,1,18,36
30,Success,51,31,3,15,36
30,Success,54,33,0,9,45
30,Success,50,33,0,16,34
30,Success,51,28,0,12,39
30,Success,55,25,4,16,39
30,Success,53,34,0,11,42
30,Success,47,41,1,11,36
30,Success,57,24,0,15,42
30,Success,50,28,4,18,32
30,Success,49,32,0,14,35
30,Fail,42,43,0,15,27
30,Success,49,37,1,13,36
30,Success,45,42,0,13,32
30,Success,44,41,2,13,31
30,Success,48,33,0,16,32
30,Success,57,26,2,15,42
30,Fail,41,32,8,19,22
30,Success,49,38,6,7,42
30,Success,46,35,0,14,32
30,Success,43,38,7,12,31
30,Fail,39,34,0,16,23
30,Success,48,40,2,10,38
30,Success,58,29,4,9,49
30,Success,53,33,0,11,42
30,Success,46,38,0,9,37
30,Success,48,38,0,10,38
30,Success,48,33,7,12,36
30,Fail,41,38,0,16,25
30,Success,51,34,0,7,44
30,Success,48,34,4,14,34
30,Success,58,33,0,6,52
30,Success,58,31,0,10,48
30,Fail,42,36,6,16,26
30,Success,51,32,0,12,39
30,Success,45,42,4,9,36
30,Success,47,39,4,10,37
30,Success,44,41,1,14,30
30,Success,47,28,0,14,33
30,Success,47,35,8,10,37
30,Success,48,36,0,10,38
30,Success,54,33,2,11,43
30,Success,53,36,0,10,43
30,Fail,38,44,2,16,22
30,Success,47,39,2,12,35
30,Success,47,37,0,16,31
30,Fail,35,44,8,13,22
30,Success,47,34,4,15,32
30,Success,51,30,0,11,40
30,Success,49,38,0,10,39
30,Success,47,38,0,12,35
30,Success,43,39,0,11,32
30,Success,52,38,2,8,44
30,Success,49,28,0,15,34
30,Success,44,38,6,12,32
30,Success,47,38,0,13,34
30,Success,51,33,7,9,42
30,Success,46,39,0,14,32
30,Fail,42,35,0,14,28
30,Success,47,40,0,10,37
30,Success,49,33,0,14,35
30,Success,50,30,4,16,34
30,Success,48,32,8,12,36
30,Success,57,28,4,11,46
30,Success,51,39,0,9,42
30,Fail,45,34,5,16,29
30,Success,58,30,0,12,46
30,Success,53,36,1,10,43
30,Success,53,37,0,10,43
30,Success,52,32,3,13,39
30,Success,48,41,0,9,39
30,Success,46,31,0,11,35
30,Success,50,35,0,9,41
30,Success,44,32,0,11,33
30,Success,50,35,0,15,35
30,Fail,46,34,0,20,26
30,Success,45,40,3,12,33
30,Success,47,40,1,12,35
30,Fail,40,39,0,11,29
30,Fail,45,27,0,19,26
30,Success,49,36,1,14,35
30,Success,47,45,2,6,41
30,Fail,45,30,6,19,26
30,Success,50,36,0,10,40
30,Success,43,38,0,12,31
30,Success,51,37,2,10,41
30,Success,51,34,1,14,37
30,Success,49,43,1,7,42
30,Success,59,26,0,11,48
30,Fail,44,33,1,22,22
30,Success,54,32,0,9,45
30,Success,46,36,5,13,33
30,Fail,43,40,3,14,29
30,Success,52,37,3,8,44
30,Success,47,38,0,14,33
30,Success,45,37,0,14,31
30,Success,44,39,8,9,35
30,Success,52,39,0,7,45
30,Success,53,39,3,5,48
30,Success,54,35,5,6,48
30,Fail,48,29,3,20,28
30,Fail,45,34,5,16,29
30,Fail,40,34,0,14,26
30,Success,52,36,4,8,44
30,Success,48,42,0,10,38
30,Success,49,30,0,16,33
30,Success,50,31,6,13,37
30,Fail,42,42,3,13,29
30,Success,50,35,2,13,37
30,Success,52,39,1,8,44
30,Success,51,32,1,16,35
30,Success,47,32,0,13,34
30,Fail,41,36,0,16,25
30,Success,54,31,0,9,45
30,Fail,41,41,0,18,23
30,Success,47,42,0,9,38
30,Success,46,36,0,16,30
30,Success,51,36,1,12,39
30,Fail,43,38,5,14,29
30,Success,51,39,0,10,41
30,Success,51,31,4,14,37
30,Success,47,37,0,15,32
30,Success,47,41,0,9,38
30,Success,47,34,0,16,31
30,Success,41,43,0,8,33
30,Success,47,38,3,12,35
30,Success,56,24,7,13,43
30,Success,47,36,5,12,35
30,Success,48,34,0,15,33
30,Success,51,36,0,10,41
30,Success,54,35,0,9,45
30,Success,47,36,5,12,35
30,Success,53,22,12,13,40
30,Success,44,41,1,14,30
30,Success,50,34,3,13,37
30,Success,46,36,0,12,34
30,Success,51,36,1,12,39
30,Fail,38,38,0,16,22
30,Success,51,37,3,9,42
30,Success,46,36,0,15,31
30,Success,52,23,0,20,32
30,Success,46,34,0,13,33
30,Success,49,35,0,14,35
30,Fail,44,31,8,17,27
30,Success,50,40,0,9,41
30,Fail,36,43,10,11,25
30,Success,46,38,0,15,31
30,Success,46,36,4,14,32
30,Fail,39,39,4,18,21
30,Success,49,31,4,16,33
30,Success,45,38,8,9,36
30,Success,48,39,2,11,37
30,Success,48,42,0,6,42
30,Fail,37,37,10,16,21
30,Success,49,37,0,12,37
30,Success,50,35,0,12,38
30,Success,48,38,0,11,37
30,Success,50,28,0,14,36
30,Success,49,33,0,17,32
30,Fail,36,37,14,13,23
30,Success,51,37,0,12,39
30,Fail,43,38,0,16,27
30,Success,49,34,0,9,40
30,Success,52,32,0,11,41
30,Success,49,29,7,15,34
30,Success,47,30,9,14,33
30,Success,50,30,5,15,35
30,Success,53,38,0,8,45
30,Success,47,35,0,11,36
30,Success,51,35,2,12,39
30,Success,51,37,4,8,43
30,Fail,44,31,8,17,27
30,Success,53,28,5,14,39
30,Success,51,32,8,9,42
30,Success,50,33,0,11,39
30,Fail,43,37,0,17,26
30,Success,51,30,1,18,33
30,Success,46,37,0,15,31
30,Fail,41,33,0,15,26
30,Success,43,36,0,13,30
30,Success,47,38,5,10,37
30,Success,54,27,5,14,40
30,Fail,43,30,9,18,25
30,Success,44,36,8,12,32
30,Success,47,41,3,9,38
30,Success,45,36,0,13,32
30,Success,49,38,5,8,41
30,Success,48,28,0,14,34
30,Success,50,28,0,13,37
30,Fail,39,38,0,13,26
30,Success,47,37,2,14,33
30,Success,52,37,0,7,45
30,Fail,47,32,0,19,28
30,Success,49,35,7,9,40
30,Success,50,41,0,9,41
30,Success,56,33,0,11,45
30,Success,55,33,3,9,46
30,Success,54,31,1,14,40
30,Success,55,31,0,10,45
30,Success,51,37,1,11,40
30,Fail,43,39,3,15,28
30,Success,50,38,0,12,38
30,Success,50,36,0,12,38
30,Success,43,40,0,12,31
30,Success,48,33,5,14,34
30,Fail,43,35,0,17,26
30,Success,43,40,0,13,30
30,Success,50,36,2,12,38
30,Success,45,38,0,13,32
30,Success,52,36,4,8,44
30,Success,62,28,1,9,53
30,Success,49,36,0,15,34
30,Success,54,30,3,13,41
30,Success,50,33,0,14,36
30,Success,54,37,0,8,46
30,Success,43,32,13,12,31
30,Success,48,33,0,15,33
30,Success,49,37,4,10,39
30,Success,48,41,2,9,39
30,Success,48,42,1,9,39
30,Success,51,32,2,15,36
30,Success,49,37,2,12,37
30,Success,47,32,7,14,33
30,Success,46,42,0,9,37
30,Success,45,40,0,13,32
30,Success,52,35,1,12,40
30,Fail,44,32,0,17,27
30,Fail,47,33,2,18,29
30,Success,50,35,3,12,38
30,Success,45,37,0,15,30
30,Success,48,31,0,15,33
30,Fail,40,44,0,11,29
30,Success,51,35,3,11,40
30,Success,59,29,1,11,48
30,Success,41,48,0,11,30
30,Fail,38,42,8,12,26
30,Success,47,41,1,11,36
30,Success,46,41,4,9,37
30,Success,49,34,3,14,35
30,Success,48,27,0,14,34
30,Success,45,33,10,12,33
30,Success,53,32,0,11,42
30,Success,49,29,10,12,37
30,Fail,46,34,2,18,28
30,Fail,41,33,3,23,18
30,Success,43,47,0,10,33
30,Fail,43,40,0,16,27
30,Success,51,33,0,13,38
30,Success,53,30,5,12,41
30,Success,46,36,0,12,34
30,Success,52,30,4,14,38
30,Success,46,34,0,10,36
30,Success,44,37,6,13,31
30,Success,51,38,0,11,40
30,Success,47,39,0,10,37
30,Success,45,39,0,14,31
30,Success,52,29,0,12,40
30,Success,47,39,0,14,33
30,Success,52,32,5,11,41
30,Success,47,37,4,12,35
30,Success,53,31,4,12,41
30,Success,53,37,0,10,43
30,Fail,42,38,5,15,27
30,Success,47,39,0,10,37
30,Success,47,41,0,9,38
30,Success,50,30,0,11,39
30,Success,46,38,2,14,32
30,Success,48,35,0,15,33
30,Success,46,39,2,13,33
30,Success,54,31,4,11,43
30,Success,52,38,1,9,43
30,Success,50,29,0,17,33
30,Success,45,32,0,15,30
30,Fail,39,33,10,18,21
30,Fail,42,41,1,16,26
30,Success,55,29,4,12,43
30,Success,47,35,0,16,31
30,Success,52,32,7,9,43
30,Fail,41,38,0,19,22
30,Success,52,34,0,10,42
30,Success,46,34,0,11,35
30,Success,49,32,0,16,33
30,Fail,44,37,2,17,27
30,Success,49,34,6,11,38
30,Success,59,26,0,9,50
30,Success,54,30,0,9,45
30,Fail,45,33,0,20,25
30,Success,54,31,0,10,44
30,Fail,46,34,0,17,29
30,Success,47,38,2,13,34
30,Success,49,33,5,13,36
30,Success,45,36,7,12,33
30,Success,53,32,0,13,40
30,Success,48,38,4,10,38
30,Success,46,35,0,14,32
30,Fail,41,39,7,13,28
30,Success,54,33,0,9,45
30,Success,50,35,0,12,38
30,Fail,43,34,0,17,26
30,Success,55,32,2,11,44
30,Success,49,39,4,8,41
30,Fail,43,37,0,18,25
30,Fail,43,34,4,19,24
30,Success,54,33,5,8,46
30,Success,48,33,0,15,33
30,Success,54,27,0,19,35
30,Success,48,37,6,9,39
30,Success,54,34,0,7,47
30,Success,45,34,7,14,31
30,Success,50,34,1,15,35
30,Success,49,33,0,13,36
30,Fail,38,45,4,13,25
30,Success,52,29,0,13,39
30,Success,48,34,5,13,35
30,Fail,43,38,5,14,29
30,Fail,35,35,0,21,14
30,Success,50,35,6,9,41
30,Success,52,32,0,10,42
30,Success,49,40,0,10,39
30,Success,44,44,2,10,34
30,Success,44,44,0,12,32
30,Success,49,37,0,14,35
30,Success,57,32,0,10,47
30,Success,47,34,5,14,33
30,Success,46,38,3,13,33
30,Success,49,32,6,13,36
30,Success,51,30,0,19,32
30,Success,59,31,1,9,50
30,Success,52,36,2,10,42
30,Success,51,30,0,12,39
30,Success,47,39,4,10,37
30,Fail,41,35,0,19,22
30,Fail,43,33,8,16,27
30,Success,55,36,0,7,48
30,Success,57,27,0,15,42
30,Success,48,43,0,6,42
30,Fail,44,39,0,17,27
30,Success,42,38,9,11,31
30,Success,50,37,0,8,42
30,Fail,41,42,0,16,25
30,Success,46,35,4,15,31
30,Success,46,35,3,16,30
30,Fail,44,37,3,16,28
30,Success,54,33,3,10,44
30,Success,49,38,0,12,37
30,Success,46,41,3,10,36
30,Fail,46,32,2,20,26
30,Success,52,32,0,11,41
30,Success,57,31,1,11,46
30,Fail,43,31,0,14,29
30,Fail,41,46,1,12,29
30,Success,56,32,2,10,46
30,Fail,45,34,5,16,29
30,Success,51,36,0,13,38
30,Fail,39,34,3,24,15
30,Success,49,34,10,7,42
30,Success,50,30,6,14,36
30,Success,51,26,5,18,33
30,Success,51,32,9,8,43
30,Success,46,39,3,12,34
30,Success,45,40,3,12,33
30,Success,54,28,0,13,41
30,Success,49,36,0,11,38
30,Success,54,31,5,10,44
30,Fail,39,46,1,14,25
30,Fail,40,40,0,11,29
30,Success,50,36,4,10,40
30,Fail,44,35,0,19,25
30,Success,49,37,4,10,39
30,Fail,46,26,0,22,24
30,Success,54,30,0,12,42
30,Success,53,32,0,14,39
30,Fail,44,37,0,15,29
30,Success,45,39,3,13,32
30,Fail,44,36,3,17,27
30,Success,48,36,4,12,36
30,Success,51,32,0,17,34
30,Success,50,38,0,11,39
30,Success,44,43,0,10,34
30,Success,54,35,0,11,43
30,Success,46,26,0,16,30
30,Success,45,42,0,12,33
30,Success,47,36,4,13,34
30,Success,49,32,2,17,32
30,Success,51,34,0,13,38
30,Success,52,36,0,9,43
30,Success,50,36,5,9,41
30,Fail,42,40,0,14,28
30,Success,57,32,1,10,47
30,Success,50,29,0,16,34
30,Success,51,29,0,14,37
30,Success,48,36,4,12,36
30,Success,48,39,0,11,37
30,Success,43,42,3,12,31
30,Success,48,34,0,13,35
30,Fail,44,36,0,15,29
30,Success,43,38,6,13,30
30,Success,52,31,2,15,37
30,Success,55,33,0,7,48
30,Fail,44,35,0,19,25
30,Success,44,38,4,14,30
30,Success,52,30,0,14,38
30,Success,48,31,9,12,36
30,Success,48,36,0,7,41
30,Fail,40,41,3,16,24
30,Success,49,32,0,11,38
30,Success,45,33,9,13,32
30,Fail,46,35,0,18,28
30,Fail,44,39,1,16,28
30,Success,50,37,0,9,41
30,Success,52,38,0,10,42
30,Fail,42,30,0,16,26
30,Success,55,39,0,6,49
30,Success,59,31,0,10,49
30,Success,46,35,6,13,33
30,Success,52,40,0,7,45
30,Success,57,29,0,11,46
30,Success,56,31,1,12,44
30,Success,44,43,1,12,32
30,Success,41,39,0,11,30
30,Success,44,43,2,11,33
30,Success,46,40,1,13,33
30,Success,50,35,0,12,38
30,Success,44,40,5,11,33
30,Fail,42,44,1,13,29
30,Success,43,42,3,12,31
30,Fail,44,38,0,18,26
30,Fail,42,39,6,13,29
30,Success,54,30,8,8,46
30,Success,51,38,0,11,40
30,Success,57,30,2,11,46
30,Fail,39,42,0,18,21
30,Success,46,36,2,16,30
30,Success,53,31,3,13,40
30,Success,47,35,3,15,32
30,Success,48,38,0,9,39
30,Success,57,34,3,6,51
30,Success,51,38,3,8,43
30,Success,51,38,0,11,40
30,Fail,42,44,0,14,28
30,Success,45,28,14,13,32
30,Success,56,32,2,10,46
30,Success,50,38,4,8,42
30,Success,45,37,0,11,34
30,Success,49,44,0,7,42
30,Success,46,37,4,13,33
30,Success,45,39,0,14,31
30,Success,56,30,4,10,46
30,Success,50,37,2,11,39
30,Success,53,35,2,10,43
30,Success,52,40,1,7,45
30,Success,55,31,0,11,44
30,Success,52,37,0,11,41
30,Success,50,34,5,11,39
30,Success,53,32,6,9,44
30,Success,45,35,5,15,30
30,Success,50,28,7,15,35
30,Success,54,31,7,8,46
30,Success,45,44,1,10,35
30,Success,44,36,6,14,30
30,Fail,42,35,2,21,21
30,Success,46,40,0,13,33
30,Success,52,32,0,10,42
30,Success,49,37,0,11,38
30,Success,50,37,1,12,38
30,Success,51,29,0,12,39
30,Success,56,34,4,6,50
30,Success,53,38,0,7,46
30,Success,44,44,0,12,32
30,Success,47,33,4,16,31
30,Success,49,27,0,18,31
30,Fail,39,34,0,17,22
30,Success,55,34,1,10,45
30,Success,50,30,0,15,35
30,Success,49,30,0,15,34
30,Fail,40,30,0,22,18
30,Success,55,29,3,13,42
30,Success,54,35,0,10,44
30,Success,50,38,1,11,39
30,Success,55,23,11,11,44
30,Success,45,44,0,11,34
30,Success,52,39,0,8,44
30,Success,45,40,3,12,33
30,Success,48,40,4,8,40
30,Fail,42,40,0,15,27
30,Success,60,31,0,9,51
30,Success,49,34,7,10,39
30,Success,47,40,0,11,36
30,Success,52,34,2,12,40
30,Success,46,40,3,11,35
30,Success,50,35,2,13,37
30,Success,50,32,0,16,34
30,Success,45,38,6,11,34
30,Success,48,40,0,11,37
30,Success,49,38,3,10,39
30,Success,41,42,8,9,32
30,Success,47,39,0,11,36
30,Success,49,31,10,10,39
30,Success,51,32,6,11,40
30,Success,45,41,0,13,32
30,Success,55,32,1,12,43
30,Success,51,33,1,15,36
30,Fail,42,39,0,17,25
30,Fail,40,31,0,17,23
30,Success,44,33,9,14,30
30,Success,54,38,2,6,48
30,Success,41,47,1,11,30
30,Success,48,36,1,15,33
30,Success,43,36,8,13,30
30,Success,44,42,2,12,32
30,Success,45,34,0,15,30
30,Success,55,31,6,8,47
30,Success,54,32,0,14,40
30,Success,53,32,0,13,40
30,Success,44,37,0,12,32
30,Success,48,38,0,11,37
30,Success,51,37,1,11,40
30,Success,51,28,0,10,41
30,Success,52,31,0,13,39
30,Success,53,34,3,10,43
30,Success,47,37,0,14,33
30,Success,52,31,5,12,40
30,Success,49,35,0,11,38
30,Success,50,36,3,11,39
30,Success,50,33,0,15,35
30,Success,46,32,7,15,31
30,Success,44,42,1,13,31
30,Success,45,41,3,11,34
30,Success,44,39,0,13,31
30,Success,44,32,11,13,31
30,Success,44,44,3,9,35
30,Success,51,29,5,15,36
30,Fail,41,36,4,19,22
30,Success,46,34,5,15,31
30,Fail,42,38,0,17,25
30,Success,46,37,0,14,32
30,Success,47,39,0,13,34
30,Fail,44,39,1,16,28
30,Success,42,41,0,9,33
30,Success,49,33,4,14,35
30,Success,51,36,0,6,45
30,Success,54,35,3,8,46
30,Success,50,34,1,15,35
30,Fail,45,32,0,19,26
30,Success,44,43,0,8,36
30,Success,53,32,7,8,45
30,Success,48,33,0,18,30
30,Success,46,36,0,10,36
30,Success,47,38,0,10,37
30,Success,44,35,8,13,31
30,Fail,40,37,6,17,23
30,Fail,46,31,0,17,29
30,Success,49,36,0,14,35
30,Fail,40,36,10,14,26
30,Success,54,32,2,12,42
30,Success,45,37,8,10,35
30,Fail,43,38,0,17,26
30,Success,50,37,0,5,45
30,Fail,40,38,0,18,22
30,Fail,44,37,2,17,27
30,Success,56,30,0,10,46
30,Success,47,38,4,11,36
30,Fail,44,38,0,18,26
30,Fail,39,40,0,18,21
30,Success,50,34,0,14,36
30,Fail,42,37,0,14,28
30,Success,53,40,2,5,48
30,Success,52,40,0,8,44
30,Success,48,37,4,11,37
30,Success,49,39,0,9,40
30,Fail,40,32,0,21,19
30,Success,48,40,0,7,41
30,Fail,38,47,4,11,27
30,Success,50,42,1,7,43
30,Success,50,32,8,10,40
30,Success,47,38,3,12,35
30,Success,55,32,0,8,47
30,Success,46,32,0,16,30
30,Success,47,34,0,17,30
30,Success,52,27,0,16,36
30,Success,55,27,0,16,39
30,Success,52,34,6,8,44
30,Success,51,33,0,10,41
30,Success,47,39,1,13,34
30,Success,56,24,0,16,40
30,Success,53,29,5,13,40
30,Fail,44,37,0,16,28
30,Success,60,31,2,7,53
30,Fail,44,37,3,16,28
30,Success,53,28,0,12,41
30,Success,45,42,1,12,33
30,Success,50,38,6,6,44
30,Success,47,41,0,11,36
30,Fail,43,29,0,18,25
30,Fail,41,35,10,14,27
30,Success,46,40,0,14,32
30,Success,47,35,3,15,32
30,Success,52,33,5,10,42
30,Fail,38,51,0,10,28
30,Success,48,37,5,10,38
30,Success,54,35,2,9,45
30,Success,56,32,2,10,46
30,Success,44,38,0,12,32
30,Fail,41,38,0,13,28
30,Fail,41,43,0,14,27
30,Success,49,38,0,12,37
30,Success,47,39,2,12,35
30,Fail,42,40,1,17,25
30,Success,55,31,2,12,43
30,Fail,43,41,0,16,27
30,Success,46,37,0,14,32
30,Success,52,33,2,13,39
30,Fail,44,39,2,15,29
30,Success,48,37,0,10,38
30,Success,52,29,0,10,42
30,Success,49,37,0,12,37
30,Fail,40,41,0,16,24
30,Success,44,44,1,11,33
30,Success,48,38,0,11,37
30,Success,54,35,4,7,47
30,Success,49,33,0,6,43
30,Success,48,37,0,10,38
30,Success,53,32,2,13,40
30,Success,42,46,0,8,34
30,Success,45,32,8,15,30
30,Success,53,31,5,11,42
30,Success,48,40,3,9,39
30,Success,55,33,2,10,45
30,Success,45,44,0,10,35
30,Fail,42,38,0,17,25
30,Success,52,35,0,10,42
30,Success,43,43,0,12,31
30,Fail,42,37,0,13,29
30,Success,56,35,0,7,49
30,Success,54,28,0,10,44
30,Success,51,30,9,10,41
30,Success,47,33,7,13,34
30,Fail,44,30,4,22,22
30,Success,47,31,0,13,34
30,Success,51,35,0,12,39
30,Success,57,29,0,11,46
30,Success,49,37,0,9,40
30,Success,49,31,0,12,37
30,Success,55,30,6,9,46
30,Success,45,38,3,14,31
30,Success,51,35,2,12,39
30,Success,43,33,0,12,31
30,Success,52,36,0,11,41
30,Success,46,38,0,9,37
30,Success,44,35,0,13,31
30,Success,51,36,0,10,41
30,Success,58,29,0,10,48
30,Fail,46,33,1,20,26
30,Success,54,38,0,7,47
30,Success,46,38,3,13,33
30,Fail,47,29,6,18,29
30,Success,47,36,3,14,33
30,Success,46,35,6,13,33
30,Success,53,38,0,8,45
30,Success,45,44,3,8,37
30,Success,55,33,3,9,46
30,Success,54,34,0,9,45
30,Success,47,39,2,12,35
30,Success,49,37,2,12,37
30,Success,43,43,0,12,31
30,Success,50,39,3,8,42
30,Success,45,36,0,15,30
30,Success,57,36,0,5,52
30,Fail,37,40,9,14,23
30,Success,46,41,0,12,34
30,Fail,37,50,1,12,25
30,Success,47,37,0,15,32
30,Success,51,30,0,18,33
30,Fail,46,30,0,23,23
30,Success,43,36,0,12,31
30,Success,43,38,0,13,30
30,Success,45,40,1,14,31
30,Success,51,38,0,11,40
30,Success,55,24,0,17,38
30,Success,45,41,0,13,32
30,Success,54,31,0,9,45
30,Success,49,34,2,15,34
30,Success,48,32,0,17,31
30,Success,49,32,0,16,33
30,Fail,43,38,0,15,28
30,Success,49,41,1,9,40
30,Fail,46,32,0,20,26
30,Success,54,33,0,10,44
30,Success,48,40,0,7,41
30,Success,47,36,0,14,33
30,Success,52,33,6,9,43
30,Fail,39,38,7,16,23
30,Success,49,36,1,14,35
30,Success,55,33,1,11,44
30,Success,53,36,0,9,44
30,Success,49,39,0,10,39
30,Success,44,40,3,13,31
30,Success,52,36,0,10,42
30,Success,45,36,0,15,30
30,Fail,42,37,0,17,25
30,Success,44,44,2,10,34
30,Success,48,36,0,16,32
30,Success,51,34,0,14,37
30,Success,49,36,2,13,36
30,Success,54,34,0,12,42
30,Success,47,41,1,11,36
30,Fail,41,38,0,13,28
30,Success,51,31,5,13,38
30,Success,45,36,5,14,31
30,Success,52,24,12,12,40
30,Success,51,35,0,11,40
30,Success,47,38,0,15,32
30,Success,52,36,2,10,42
30,Fail,43,43,0,14,29
30,Fail,41,40,4,15,26
30,Success,45,38,3,14,31
30,Success,53,29,5,13,40
30,Success,56,29,0,11,45
30,Fail,36,44,11,9,27
30,Success,44,34,0,14,30
30,Success,53,32,0,15,38
30,Success,45,37,0,14,31
30,Fail,40,39,0,13,27
30,Success,48,40,0,11,37
30,Fail,46,33,0,18,28
30,Fail,41,36,7,16,25
30,Success,43,40,0,12,31
30,Fail,39,39,0,19,20
30,Success,57,31,0,10,47
30,Success,50,39,2,9,41
30,Success,48,37,0,10,38
30,Fail,39,44,1,16,23
30,Fail,42,41,0,15,27
30,Success,50,30,5,15,35
30,Success,49,37,0,12,37
30,Success,53,24,10,13,40
30,Success,50,41,0,9,41
30,Success,53,35,0,9,44
30,Fail,43,35,4,18,25
30,Success,41,42,6,11,30
30,Success,50,35,6,9,41
30,Success,46,37,3,14,32
30,Success,44,39,0,11,33
30,Success,53,28,9,10,43
30,Success,48,35,0,16,32
30,Success,55,30,4,11,44
30,Success,49,37,0,11,38
30,Success,61,31,0,8,53
30,Fail,42,38,0,16,26
30,Fail,40,34,0,17,23
30,Fail,40,39,5,16,24
30,Success,50,34,8,8,42
30,Success,44,39,0,13,31
30,Fail,39,40,0,18,21
30,Success,47,37,0,14,33
30,Fail,41,33,7,19,22
30,Success,47,45,0,7,40
30,Success,54,30,2,14,40
30,Success,55,34,1,10,45
30,Fail,39,37,10,14,25
30,Success,47,38,2,13,34
30,Success,52,41,1,6,46
30,Fail,48,32,1,19,29
30,Success,50,40,3,7,43
30,Fail,47,28,4,21,26
30,Success,48,43,0,9,39
30,Success,44,40,7,9,35
30,Success,58,33,1,8,50
30,Success,51,36,0,13,38
30,Success,46,43,0,11,35
30,Success,50,35,7,8,42
30,Success,50,27,7,16,34
30,Success,49,40,0,11,38
30,Success,47,31,6,16,31
30,Fail,43,37,0,15,28
30,Success,52,39,0,6,46
30,Success,51,40,0,9,42
30,Success,52,35,3,10,42
30,Success,47,32,7,14,33
30,Success,48,38,0,8,40
30,Success,47,35,0,13,34
30,Success,51,37,1,11,40
30,Success,45,35,0,13,32
30,Fail,45,35,4,16,29
30,Success,53,32,2,13,40
30,Fail,38,45,0,16,22
30,Fail,41,40,0,16,25
30,Success,44,44,2,10,34
30,Success,50,29,0,19,31
30,Success,52,35,5,8,44
30,Success,46,43,4,7,39
30,Success,61,28,0,9,52
30,Success,46,35,5,14,32
30,Success,45,36,0,14,31
30,Success,50,41,0,8,42
30,Fail,45,33,0,18,27
30,Success,57,33,0,10,47
30,Success,47,34,4,15,32
30,Fail,44,30,0,16,28
30,Success,52,35,0,10,42
30,Success,52,38,0,8,44
30,Success,50,34,1,15,35
30,Fail,42,39,2,17,25
30,Fail,41,42,4,13,28
30,Success,42,41,0,10,32
30,Success,58,36,0,6,52
30,Success,50,40,0,6,44
30,Success,55,30,0,9,46
30,Success,48,37,3,12,36
30,Success,52,37,0,9,43
30,Fail,48,28,0,19,29
30,Success,49,36,0,15,34
30,Success,50,33,1,16,34
30,Success,49,36,0,15,34
30,Success,51,31,0,13,38
30,Success,53,30,0,13,40
30,Success,54,33,1,12,42
30,Success,47,37,0,15,32
30,Success,44,34,9,13,31
30,Success,53,34,2,11,42
30,Success,52,28,0,17,35
30,Success,48,34,0,17,31
30,Success,44,42,0,13,31
30,Success,48,40,0,11,37
30,Success,48,30,5,17,31
30,Success,48,29,6,17,31
30,Fail,44,37,2,17,27
30,Fail,43,35,0,16,27
30,Success,47,34,3,16,31
30,Success,51,32,8,9,42
30,Success,40,39,12,9,31
30,Success,47,36,5,12,35
30,Fail,46,28,0,18,28
30,Success,56,28,0,16,40
30,Success,52,35,0,7,45
30,Success,51,31,8,10,41
30,Success,50,35,0,13,37
30,Success,55,32,5,8,47
30,Success,43,40,4,13,30
30,Success,51,33,4,12,39
30,Success,48,34,2,16,32
30,Success,50,34,0,16,34
30,Success,41,48,0,9,32
30,Success,51,35,1,13,38
30,Success,53,31,0,15,38
30,Success,48,38,2,12,36
30,Success,47,31,9,13,34
30,Success,45,41,4,10,35
30,Success,48,34,0,11,37
30,Success,44,46,2,8,36
30,Success,47,37,0,12,35
30,Fail,41,39,6,14,27
30,Success,53,33,0,13,40
30,Success,55,36,0,4,51
30,Success,47,30,7,16,31
30,Success,44,43,4,9,35
30,Success,54,33,0,7,47
30,Fail,37,33,0,16,21
30,Success,51,29,0,10,41
30,Success,45,43,1,11,34
30,Success,50,25,0,16,34
30,Success,49,36,0,13,36
30,Success,48,36,3,13,35
30,Success,62,29,0,9,53
30,Success,46,38,5,11,35
30,Success,47,38,0,10,37
30,Success,52,35,1,12,40
30,Success,46,39,3,12,34
30,Success,51,27,6,16,35
30,Fail,40,35,12,13,27
30,Success,47,36,0,14,33
30,Success,48,37,7,8,40
30,Success,52,33,0,10,42
30,Success,46,36,0,14,32
30,Success,43,40,7,10,33
30,Success,50,33,0,9,41
30,Success,46,40,1,13,33
30,Success,49,38,1,12,37
30,Success,48,33,6,13,35
30,Fail,42,36,0,13,29
30,Success,46,39,1,14,32
30,Success,53,36,4,7,46
30,Fail,46,34,3,17,29
30,Fail,43,36,0,14,29
30,Success,52,34,5,9,43
30,Success,55,30,6,9,46
30,Fail,44,32,0,16,28
30,Success,52,34,0,8,44
30,Success,51,28,0,19,32
30,Success,54,34,1,11,43
30,Success,46,41,0,10,36
30,Success,46,39,6,9,37
30,Success,48,37,1,14,34
30,Success,54,37,1,8,46
30,Success,56,31,2,11,45
30,Success,50,35,0,14,36
30,Fail,41,32,0,15,26
30,Fail,44,35,0,18,26
30,Fail,43,41,0,15,28
30,Success,50,38,0,10,40
30,Fail,46,36,0,18,28
30,Success,51,37,0,7,44
30,Success,53,35,0,9,44
30,Success,48,29,6,17,31
30,Success,49,41,0,9,40
30,Success,49,38,0,11,38
30,Fail,45,33,6,16,29
30,Success,44,38,4,14,30
30,Fail,41,45,0,13,28
30,Fail,41,28,13,18,23
30,Success,44,41,0,12,32
30,Success,58,32,0,10,48
30,Fail,41,34,0,18,23
30,Success,56,34,4,6,50
30,Success,47,36,3,14,33
30,Success,46,41,0,10,36
30,Success,50,34,0,12,38
30,Success,44,44,0,12,32
30,Success,50,32,7,11,39
30,Success,52,33,0,14,38
30,Success,53,33,1,13,40
30,Success,46,38,0,10,36
30,Success,48,40,3,9,39
30,Fail,39,41,9,11,28
30,Success,48,34,0,13,35
30,Success,50,32,3,15,35
30,Success,48,32,0,16,32
30,Fail,43,36,4,17,26
30,Success,49,36,2,13,36
30,Success,43,41,0,11,32
30,Success,46,37,4,13,33
30,Success,44,33,0,12,32
30,Success,47,38,0,15,32
30,Success,51,37,0,9,42
30,Success,48,34,0,13,35
30,Success,48,35,0,14,34
30,Success,51,39,0,7,44
30,Success,49,32,0,13,36
30,Success,50,36,1,13,37
30,Success,47,37,6,10,37
30,Success,47,41,3,9,38
30,Success,48,39,2,11,37
30,Fail,42,39,2,17,25
30,Success,44,44,0,12,32
30,Success,52,36,3,9,43
30,Success,51,38,1,10,41
30,Success,50,37,0,12,38
30,Success,53,29,1,17,36
30,Success,46,33,0,15,31
30,Success,52,34,1,13,39
30,Fail,44,27,7,22,22
30,Success,53,37,0,9,44
30,Fail,42,36,0,13,29
30,Success,57,31,0,8,49
30,Success,47,41,1,11,36
30,Success,53,35,5,7,46
30,Success,52,31,0,14,38
30,Success,48,43,1,8,40
30,Success,48,40,0,10,38
30,Success,47,38,0,11,36
30,Success,44,40,0,13,31
30,Success,44,41,0,12,32
30,Success,44,37,6,13,31
30,Success,55,30,0,15,40
30,Success,50,39,0,11,39
30,Success,50,32,8,10,40
30,Success,53,33,0,13,40
30,Success,52,30,5,13,39
30,Success,53,34,0,9,44
30,Success,49,40,2,9,40
30,Success,48,37,1,14,34
30,Success,49,32,3,16,33
30,Success,48,36,0,12,36
30,Success,46,30,0,14,32
30,Success,49,32,2,17,32
30,Fail,45,33,0,20,25
30,Success,49,37,2,12,37
30,Success,54,32,4,10,44
30,Success,49,40,0,10,39
30,Success,48,39,0,12,36
30,Success,53,36,0,11,42
30,Success,49,38,0,12,37
30,Fail,41,43,2,14,27
30,Fail,43,36,0,18,25
30,Fail,41,39,0,15,26
30,Fail,43,33,7,17,26
30,Success,50,35,1,14,36
30,Fail,43,39,2,16,27
30,Success,49,34,0,12,37
30,Success,49,38,1,12,37
30,Fail,36,31,0,20,16
30,Success,47,33,3,17,30
30,Success,44,43,0,12,32
30,Success,49,39,2,10,39
30,Success,45,42,0,11,34
30,Success,47,35,1,17,30
30,Success,51,40,0,7,44
30,Fail,47,24,10,19,28
30,Fail,42,31,0,21,21
30,Success,50,35,1,14,36
30,Fail,39,45,0,12,27
30,Success,54,34,0,10,44
30,Success,46,42,5,7,39
30,Success,49,30,6,15,34
30,Success,44,31,0,13,31
30,Success,42,39,0,9,33
30,Fail,43,37,5,15,28
30,Success,47,42,2,9,38
30,Success,47,38,0,15,32
30,Success,49,32,12,7,42
30,Success,49,35,0,11,38
30,Success,55,33,2,10,45
30,Success,46,38,0,13,33
30,Success,52,38,0,9,43
30,Success,48,36,0,10,38
30,Success,59,30,0,10,49
30,Success,52,35,0,8,44
30,Success,45,37,7,11,34
30,Success,47,32,0,17,30
30,Success,60,20,0,13,47
30,Success,48,31,0,14,34
30,Success,45,38,0,13,32
30,Success,49,41,1,9,40
30,Success,48,35,3,14,34
30,Fail,48,32,1,19,29
30,Success,46,31,12,11,35
30,Success,52,37,0,10,42
30,Success,47,39,6,8,39
30,Success,56,31,4,9,47
30,Success,52,39,0,9,43
30,Success,48,30,0,10,38
30,Success,47,36,5,12,35
30,Success,44,42,1,13,31
30,Success,47,39,0,13,34
30,Success,50,31,7,12,38
30,Success,58,30,3,9,49
30,Success,47,43,0,7,40
30,Success,55,33,6,6,49
30,Fail,43,39,0,18,25
30,Success,54,32,0,10,44
30,Success,54,35,0,11,43
30,Fail,42,41,2,15,27
30,Success,48,41,2,9,39
30,Fail,49,28,0,23,26
30,Success,50,38,0,10,40
30,Success,60,29,1,10,50
30,Success,53,35,2,10,43
30,Success,52,37,0,10,42
30,Success,49,42,0,7,42
30,Success,50,41,3,6,44
30,Fail,50,25,0,22,28
30,Fail,41,41,0,12,29
30,Success,52,33,5,10,42
30,Success,46,37,7,10,36
30,Success,50,31,1,18,32
30,Fail,45,31,0,17,28
30,Success,51,40,2,7,44
30,Success,53,30,2,15,38
30,Success,47,43,0,10,37
30,Fail,36,39,0,18,18
30,Fail,44,34,4,18,26
30,Success,42,41,0,11,31
30,Success,51,39,1,9,42
30,Success,53,22,9,16,37
30,Success,51,37,3,9,42
30,Success,50,40,0,10,40
30,Fail,48,28,5,19,29
30,Success,47,40,0,9,38
30,Success,42,43,0,12,30
30,Success,48,41,0,10,38
30,Success,53,35,0,6,47
30,Success,53,32,0,13,40
30,Success,52,32,5,11,41
30,Success,50,39,0,11,39
30,Success,49,35,1,15,34
30,Success,47,38,10,5,42
30,Success,53,34,2,11,42
30,Fail,43,33,0,17,26
30,Success,46,38,3,13,33
30,Success,55,31,5,9,46
30,Success,48,34,2,16,32
30,Success,47,35,0,17,30
30,Success,47,36,5,12,35
30,Success,47,39,2,12,35
30,Success,49,32,3,16,33
30,Success,52,36,3,9,43
30,Success,44,35,0,14,30
30,Success,40,48,5,7,33
30,Success,50,36,0,13,37
30,Success,58,28,1,13,45
30,Success,55,31,2,12,43
30,Fail,42,36,0,14,28
30,Fail,44,32,0,15,29
30,Fail,42,39,6,13,29
30,Fail,42,39,3,16,26
30,Success,45,40,7,8,37
30,Success,50,42,0,6,44
30,Success,48,39,0,13,35
30,Success,53,35,0,10,43
30,Success,49,37,5,9,40
30,Success,54,33,6,7,47
30,Success,55,31,5,9,46
30,Success,49,36,0,14,35
30,Fail,38,39,5,18,20
30,Fail,43,30,0,17,26
30,Success,44,45,0,11,33
30,Success,47,44,0,9,38
30,Success,52,37,2,9,43
30,Success,50,39,0,9,41
30,Success,55,39,0,6,49
30,Success,47,41,2,10,37
30,Success,48,41,0,10,38
30,Success,47,37,6,10,37
30,Success,47,36,4,13,34
30,Success,56,29,5,10,46
30,Success,58,32,0,7,51
30,Success,50,35,0,14,36
30,Success,48,39,1,12,36
30,Success,43,38,7,12,31
30,Success,53,31,7,9,44
30,Success,47,39,2,12,35
30,Success,48,35,0,7,41
30,Fail,47,32,0,18,29
30,Success,52,34,2,12,40
30,Success,49,35,1,15,34
30,Success,56,31,4,9,47
30,Success,50,37,0,11,39
30,Fail,38,38,6,18,20
30,Fail,35,36,10,19,16
30,Fail,40,39,0,19,21
30,Success,50,35,0,14,36
30,Fail,40,37,9,14,26
30,Success,48,41,1,10,38
30,Success,45,39,5,11,34
30,Success,50,39,0,11,39
30,Fail,41,40,6,13,28
30,Success,50,38,0,8,42
30,Success,44,44,0,9,35
30,Success,48,38,2,12,36
30,Success,50,34,0,9,41
30,Success,54,35,0,11,43
30,Fail,45,36,0,17,28
30,Fail,46,37,0,17,29
30,Success,47,35,4,14,33
30,Fail,42,40,4,14,28
30,Success,45,41,0,10,35
30,Success,50,34,0,9,41
30,Success,49,34,0,13,36
30,Success,49,36,0,10,39
30,Success,49,39,0,12,37
30,Success,61,26,0,11,50
30,Success,44,39,0,12,32
30,Fail,46,32,0,17,29
30,Success,46,44,0,9,37
30,Success,44,34,11,11,33
30,Success,51,37,4,8,43
30,Fail,40,40,2,18,22
30,Success,44,41,0,11,33
30,Fail,43,37,5,15,28
30,Success,53,34,3,10,43
30,Success,49,26,12,13,36
30,Fail,45,30,5,20,25
30,Success,47,33,5,15,32
30,Fail,44,39,1,16,28
30,Success,48,36,0,13,35
30,Success,50,31,0,13,37
30,Success,47,37,0,15,32
30,Success,54,32,0,13,41
30,Success,51,30,10,9,42
30,Success,52,30,0,17,35
30,Success,50,36,6,8,42
30,Success,43,34,11,12,31
30,Fail,40,39,0,14,26
30,Success,48,36,0,13,35
30,Success,56,33,0,10,46
30,Success,48,36,8,8,40
30,Success,65,27,0,6,59
30,Success,50,34,1,15,35
30,Success,53,35,0,10,43
30,Fail,43,42,0,15,28
30,Fail,43,40,3,14,29
30,Success,52,36,0,10,42
30,Success,47,33,0,10,37
30,Success,53,35,0,12,41
30,Fail,48,33,0,19,29
30,Success,56,27,0,11,45
30,Success,60,27,0,13,47
30,Success,54,32,0,12,42
30,Success,47,36,9,8,39
30,Success,54,34,0,8,46
30,Success,49,35,0,10,39
30,Fail,40,35,9,16,24
30,Success,54,34,0,12,42
30,Success,52,35,3,10,42
30,Success,49,32,3,16,33
30,Success,49,39,0,12,37
30,Success,45,40,5,10,35
30,Success,53,38,2,7,46
30,Success,47,34,7,12,35
30,Success,47,28,14,11,36
30,Success,49,32,0,12,37
30,Fail,45,37,0,18,27
30,Success,52,33,2,13,39
30,Fail,38,43,0,15,23
30,Success,46,35,5,14,32
30,Success,45,40,3,12,33
30,Fail,41,41,4,14,27
30,Success,48,41,1,10,38
30,Success,43,38,9,10,33
30,Success,46,38,2,14,32
30,Fail,44,40,0,16,28
30,Success,55,35,0,8,47
30,Fail,39,34,16,11,28
30,Success,55,31,0,13,42
30,Fail,39,42,4,15,24
30,Success,51,37,2,10,41
30,Success,49,31,0,19,30
30,Success,48,36,0,14,34
30,Success,53,30,0,17,36
30,Success,55,39,0,5,50
30,Success,47,39,0,7,40
30,Success,45,35,9,11,34
30,Success,53,32,0,14,39
30,Success,46,41,0,9,37
30,Success,56,33,1,10,46
30,Success,51,27,5,17,34
30,Success,47,34,3,16,31
30,Success,45,40,0,13,32
30,Success,49,30,6,15,34
30,Fail,45,37,0,18,27
30,Success,52,33,0,7,45
30,Success,46,39,0,8,38
30,Success,57,31,0,11,46
30,Success,48,37,0,13,35
30,Fail,41,36,1,22,19
30,Success,48,38,0,11,37
30,Fail,42,31,0,16,26
30,Success,50,31,12,7,43
30,Success,47,35,1,17,30
30,Fail,45,37,1,17,28
30,Success,53,38,2,7,46
30,Success,53,38,0,7,46
30,Success,49,38,0,12,37
30,Success,46,36,0,13,33
30,Success,49,32,2,17,32
30,Success,46,35,0,16,30
30,Success,51,35,1,13,38
30,Success,54,29,0,12,42
30,Success,51,38,0,11,40
30,Success,44,41,0,13,31
30,Fail,46,34,1,19,27
30,Success,49,38,0,9,40
30,Success,59,27,0,9,50
30,Success,51,31,5,13,38
30,Success,44,34,0,12,32
30,Fail,37,43,0,11,26
30,Success,46,36,0,14,32
30,Success,55,30,3,12,43
30,Success,49,32,0,15,34
30,Success,50,36,3,11,39
30,Success,49,33,0,14,35
30,Success,49,31,0,18,31
30,Success,50,28,8,14,36
30,Fail,34,40,11,15,19
30,Success,45,40,1,14,31
30,Success,47,43,0,10,37
30,Success,48,37,6,9,39
30,Success,55,33,0,10,45
30,Success,48,29,0,17,31
30,Success,51,39,0,8,43
30,Success,51,33,0,15,36
30,Success,45,39,0,14,31
30,Success,49,34,0,17,32
30,Success,52,32,1,15,37
30,Success,55,33,4,8,47
30,Success,55,34,1,10,45
30,Success,49,34,0,13,36
30,Success,55,35,0,10,45
30,Success,51,36,0,13,38
30,Fail,38,40,0,17,21
30,Fail,32,40,7,21,11
30,Success,50,35,7,8,42
30,Success,47,37,5,11,36
30,Success,51,40,0,9,42
30,Fail,38,51,0,9,29
30,Success,43,35,12,10,33
30,Fail,44,34,6,16,28
30,Success,50,30,0,10,40
30,Success,46,37,5,12,34
30,Success,48,38,4,10,38
30,Success,44,38,0,11,33
30,Success,47,36,0,11,36
30,Success,45,34,0,10,35
30,Fail,40,40,0,17,23
30,Success,48,37,0,13,35
30,Fail,46,37,0,17,29
30,Success,51,36,6,7,44
30,Success,48,37,1,14,34
30,Fail,48,30,0,19,29
30,Fail,36,42,6,16,20
30,Success,56,29,0,13,43
30,Success,48,40,0,10,38
30,Success,52,30,0,16,36
30,Success,48,35,0,15,33
30,Success,54,30,4,12,42
30,Fail,44,37,0,18,26
30,Success,50,37,0,12,38
30,Success,46,38,2,14,32
30,Fail,42,31,12,15,27
30,Fail,39,42,0,15,24
30,Success,50,36,0,11,39
30,Success,51,37,3,9,42
30,Success,48,34,0,15,33
30,Success,46,38,3,13,33
30,Success,49,36,5,10,39
30,Success,52,35,0,12,40
30,Success,45,38,4,13,32
30,Success,46,37,6,11,35
30,Success,57,32,0,11,46
30,Success,57,37,0,5,52
30,Success,44,45,0,9,35
30,Success,50,36,3,11,39
30,Success,52,35,0,13,39
30,Success,49,33,0,8,41
30,Fail,41,39,0,16,25
30,Success,47,40,0,13,34
30,Success,45,37,4,14,31
30,Fail,44,39,0,15,29
30,Success,49,33,0,11,38
30,Success,51,35,2,12,39
30,Success,48,36,0,15,33
30,Fail,43,36,1,20,23
30,Success,44,44,0,7,37
30,Success,48,30,7,15,33
30,Success,52,32,1,15,37
30,Success,51,37,0,12,39
30,Fail,42,30,0,22,20
30,Fail,43,36,0,15,28
30,Success,43,35,10,12,31
30,Fail,42,39,0,19,23
30,Success,57,20,0,15,42
30,Success,46,33,0,14,32
30,Success,47,29,0,16,31
30,Success,44,43,0,11,33
30,Success,49,41,0,10,39
30,Fail,47,25,0,20,27
30,Success,53,29,4,14,39
30,Success,51,30,5,14,37
30,Success,50,35,0,13,37
30,Success,49,33,0,18,31
30,Success,47,34,0,12,35
30,Success,45,48,1,6,39
30,Success,49,34,9,8,41
30,Success,48,31,5,16,32
30,Success,49,30,3,18,31
30,Success,43,39,5,13,30
30,Success,50,38,2,10,40
30,Success,44,36,8,12,32
30,Success,42,37,10,11,31
30,Fail,45,33,0,21,24
30,Success,42,36,0,12,30
30,Success,49,40,3,8,41
30,Success,45,34,0,15,30
30,Success,49,29,0,14,35
30,Success,43,36,9,12,31
30,Success,45,44,0,11,34
30,Success,48,39,0,12,36
30,Success,50,39,1,10,40
30,Fail,41,42,0,16,25
30,Success,50,30,0,14,36
30,Success,50,28,0,15,35
30,Fail,45,32,7,16,29
30,Success,46,38,1,15,31
30,Success,49,34,2,15,34
30,Success,54,36,2,8,46
30,Success,50,44,0,6,44
30,Success,51,31,5,13,38
30,Success,49,26,8,17,32
30,Success,47,35,0,14,33
30,Fail,39,41,0,18,21
30,Success,45,35,8,12,33
30,Fail,44,33,0,18,26
30,Success,49,39,3,9,40
30,Success,49,38,3,10,39
30,Success,49,28,7,16,33
30,Fail,41,40,4,15,26
30,Success,51,39,4,6,45
30,Success,54,28,8,10,44
30,Fail,40,41,4,15,25
30,Success,49,33,0,7,42
30,Success,56,31,0,12,44
30,Fail,43,37,0,17,26
30,Success,51,28,7,14,37
30,Fail,42,43,0,14,28
30,Success,51,38,3,8,43
30,Success,51,35,0,11,40
30,Success,60,23,0,14,46
30,Success,55,38,0,7,48
30,Success,50,32,0,18,32
30,Success,55,31,6,8,47
30,Fail,40,40,2,18,22
30,Success,47,37,0,13,34
30,Success,53,39,0,6,47
30,Success,50,39,0,8,42
30,Success,49,32,0,15,34
30,Fail,45,36,0,16,29
30,Fail,45,31,0,19,26
30,Fail,42,44,1,13,29
30,Fail,38,35,7,20,18
30,Success,43,45,2,10,33
30,Success,52,30,0,17,35
30,Fail,39,36,14,11,28
30,Success,54,32,0,10,44
30,Success,46,32,6,16,30
30,Success,45,39,0,14,31
30,Fail,44,28,12,16,28
30,Success,48,38,1,13,35
30,Success,50,27,8,15,35
30,Success,47,39,0,12,35
30,Success,49,36,0,12,37
30,Success,48,37,0,13,35
30,Success,52,30,0,16,36
30,Success,50,32,0,12,38
30,Fail,38,39,8,15,23
30,Success,47,36,0,8,39
30,Success,50,34,5,11,39
30,Success,58,29,0,9,49
30,Success,50,32,0,12,38
30,Success,45,33,8,14,31
30,Success,48,36,0,13,35
30,Fail,44,33,0,19,25
30,Success,50,34,0,11,39
30,Success,53,38,1,8,45
30,Fail,45,36,1,18,27
30,Success,52,38,1,9,43
30,Success,56,36,4,4,52
30,Success,51,36,6,7,44
30,Fail,40,41,5,14,26
30,Success,48,35,1,16,32
30,Success,53,32,0,12,41
30,Fail,39,45,0,14,25
30,Success,48,41,2,9,39
30,Success,43,43,1,13,30
30,Fail,42,35,0,17,25
30,Success,46,34,0,13,33
30,Success,46,46,3,5,41
30,Fail,45,37,2,16,29
30,Success,46,35,0,14,32
30,Success,48,37,0,14,34
30,Success,47,33,0,11,36
30,Fail,43,41,2,14,29
30,Fail,41,41,5,13,28
30,Fail,40,34,7,19,21
30,Success,43,38,7,12,31
30,Success,47,32,9,12,35
30,Success,49,35,6,10,39
30,Success,54,31,0,15,39
30,Success,48,37,1,14,34
30,Success,48,35,6,11,37
30,Fail,40,45,2,13,27
30,Success,46,39,3,12,34
30,Success,52,27,0,13,39
30,Success,47,40,3,10,37
30,Fail,45,34,1,20,25
30,Success,59,36,0,5,54
30,Success,53,36,4,7,46
30,Success,47,41,1,11,36
30,Success,46,35,11,8,38
30,Success,47,37,0,12,35
30,Success,47,30,0,14,33
30,Fail,40,42,4,14,26
30,Success,56,28,0,14,42
30,Success,46,43,0,10,36
30,Success,50,36,4,10,40
30,Success,54,40,0,6,48
30,Success,41,46,3,10,31
30,Success,57,28,0,9,48
30,Success,49,33,0,11,38
30,Success,46,37,4,13,33
30,Success,45,35,7,13,32
30,Success,47,31,5,17,30
30,Success,43,43,0,12,31
30,Success,55,38,2,5,50
30,Success,50,34,0,13,37
30,Success,52,33,4,11,41
30,Success,49,32,3,16,33
30,Fail,46,34,2,18,28
30,Success,41,45,0,11,30
30,Fail,44,35,4,17,27
30,Success,50,31,7,12,38
30,Success,46,34,4,16,30
30,Fail,37,44,0,17,20
30,Success,53,35,0,12,41
30,Success,46,36,10,8,38
30,Success,44,41,9,6,38
30,Success,43,30,0,11,32
30,Fail,39,41,0,15,24
30,Success,50,37,0,9,41
30,Success,48,36,0,12,36
30,Success,49,39,0,12,37
30,Fail,40,39,0,13,27
30,Success,51,34,0,7,44
30,Fail,42,41,2,15,27
30,Success,44,35,10,11,33
30,Fail,39,41,0,15,24
30,Fail,39,34,0,13,26
30,Success,55,32,0,9,46
30,Success,53,31,0,13,40
30,Success,49,37,0,14,35
30,Success,51,36,0,11,40
30,Success,51,37,0,11,40
30,Success,52,36,1,11,41
30,Fail,40,41,4,15,25
30,Fail,44,34,7,15,29
30,Fail,43,35,5,17,26
30,Success,48,39,2,11,37
30,Fail,39,42,1,18,21
30,Success,47,35,2,16,31
30,Fail,40,35,12,13,27
30,Success,52,37,0,5,47
30,Success,51,33,2,14,37
30,Success,44,40,5,11,33
30,Fail,42,31,3,24,18
30,Success,49,31,0,18,31
30,Success,46,37,2,15,31
30,Success,56,33,0,11,45
30,Fail,40,45,0,13,27
30,Fail,45,33,6,16,29
30,Success,55,31,5,9,46
30,Success,46,35,6,13,33
30,Fail,43,34,0,18,25
30,Success,44,37,5,14,30
30,Fail,42,32,0,17,25
30,Fail,44,34,0,21,23
30,Success,52,37,1,10,42
30,Fail,43,34,0,20,23
30,Success,42,31,0,12,30
30,Success,44,40,4,12,32
30,Success,46,38,7,9,37
30,Success,48,34,0,15,33
30,Success,50,34,3,13,37
30,Success,48,34,0,11,37
30,Fail,43,36,6,15,28
30,Success,53,29,1,17,36
30,Success,48,34,0,12,36
30,Success,46,33,0,16,30
30,Success,47,32,0,16,31
30,Success,46,35,0,16,30
30,Success,52,34,1,13,39
30,Success,52,26,0,15,37
30,Success,51,37,0,9,42
30,Success,47,46,1,6,41
30,Success,50,32,6,12,38
30,Success,50,37,0,12,38
30,Success,50,31,2,17,33
30,Success,43,44,2,11,32
30,Fail,39,42,0,10,29
30,Success,47,36,3,14,33
30,Success,52,27,8,13,39
30,Success,48,37,4,11,37
30,Fail,41,38,0,13,28
30,Success,51,35,0,13,38
30,Success,51,35,1,13,38
30,Success,45,31,11,13,32
30,Fail,43,37,0,19,24
30,Success,53,28,0,17,36
30,Success,49,32,2,17,32
30,Success,45,40,0,13,32
30,Success,51,32,0,9,42
30,Success,50,35,2,13,37
30,Fail,39,34,12,15,24
30,Fail,42,35,9,14,28
30,Success,49,36,0,15,34
30,Success,55,38,0,6,49
30,Success,48,39,0,12,36
30,Success,48,34,2,16,32
30,Success,46,38,4,12,34
30,Success,50,33,6,11,39
30,Success,50,34,5,11,39
30,Success,50,34,2,14,36
30,Success,53,37,3,7,46
30,Fail,47,32,0,19,28
30,Success,46,35,8,11,35
30,Success,44,40,0,11,33
30,Success,48,38,4,10,38
30,Success,47,37,0,14,33
30,Success,45,42,4,9,36
30,Fail,39,35,0,16,23
30,Success,51,29,0,14,37
30,Success,52,26,0,16,36
30,Fail,44,35,4,17,27
30,Success,52,36,1,11,41
30,Success,46,39,0,10,36
30,Success,54,38,0,8,46
30,Success,47,31,8,14,33
30,Success,47,40,1,12,35
30,Success,49,34,4,13,36
30,Fail,43,38,0,18,25
30,Success,50,31,5,14,36
30,Fail,46,34,2,18,28
30,Success,51,40,0,7,44
30,Success,48,39,0,10,38
30,Fail,46,31,0,17,29
30,Success,52,37,0,9,43
30,Success,52,30,0,12,40
30,Success,47,37,0,11,36
30,Success,48,36,0,16,32
30,Fail,44,39,1,16,28
30,Success,47,40,0,13,34
30,Fail,44,34,0,21,23
30,Success,46,35,9,10,36
30,Success,47,34,7,12,35
30,Success,52,34,0,12,40
30,Success,50,35,0,12,38
30,Success,44,43,0,8,36
30,Success,49,39,0,12,37
30,Success,45,33,9,13,32
30,Success,60,26,0,13,47
30,Success,44,40,2,14,30
30,Success,49,39,0,11,38
30,Success,43,44,0,13,30
30,Fail,44,41,0,15,29
30,Success,50,33,4,13,37
30,Success,45,41,2,12,33
30,Success,50,35,0,13,37
30,Success,50,39,0,10,40
30,Success,57,32,1,10,47
30,Success,47,35,0,16,31
30,Success,54,29,0,14,40
30,Success,44,34,8,14,30
30,Success,52,29,4,15,37
30,Success,42,45,2,11,31
30,Success,52,29,0,16,36
30,Success,45,37,0,15,30
30,Success,48,43,0,8,40
30,Success,50,35,1,14,36
30,Success,50,33,5,12,38
30,Success,50,31,0,14,36
30,Success,49,31,6,14,35
30,Fail,41,32,7,20,21
30,Fail,45,31,2,22,23
30,Success,60,27,1,12,48
30,Success,51,26,0,13,38
30,Success,53,31,0,10,43
30,Success,50,32,9,9,41
30,Success,51,32,4,13,38
30,Success,55,30,2,13,42
30,Fail,44,33,0,23,21
30,Fail,41,39,0,15,26
30,Success,49,36,0,11,38
30,Success,49,34,7,10,39
30,Success,55,37,0,8,47
30,Success,49,35,4,12,37
30,Success,56,34,0,9,47
30,Success,55,33,0,10,45
30,Success,51,31,0,12,39
30,Fail,41,37,5,17,24
30,Fail,39,36,0,17,22
30,Fail,43,35,4,18,25
30,Success,50,32,0,13,37
30,Success,48,39,0,9,39
30,Success,51,33,0,11,40
30,Fail,44,34,0,18,26
30,Success,48,40,0,11,37
30,Success,51,27,0,18,33
30,Success,51,37,0,7,44
30,Fail,41,37,8,14,27
30,Success,42,45,0,12,30
30,Success,49,31,0,10,39
30,Success,42,44,0,10,32
30,Fail,39,35,14,12,27
30,Success,48,44,1,7,41
30,Success,55,38,0,6,49
30,Success,47,36,1,16,31
30,Success,51,37,4,8,43
30,Success,52,31,0,15,37
30,Fail,45,29,9,17,28
30,Success,49,38,0,12,37
30,Fail,39,36,0,18,21
30,Fail,40,38,7,15,25
30,Success,51,36,0,12,39
30,Success,56,30,0,10,46
30,Success,46,44,0,8,38
30,Success,45,37,0,15,30
30,Fail,43,40,0,15,28
30,Success,48,41,0,10,38
30,Success,53,29,0,17,36
30,Fail,45,33,0,21,24
30,Success,46,32,7,15,31
30,Fail,43,40,2,15,28
30,Success,45,39,0,12,33
30,Success,46,40,0,11,35
30,Success,52,34,3,11,41
30,Success,46,39,1,14,32
30,Success,47,32,0,11,36
30,Fail,43,36,4,17,26
30,Success,47,36,2,15,32
30,Success,52,34,0,13,39
30,Success,51,32,0,8,43
30,Success,50,39,1,10,40
30,Success,56,34,0,10,46
30,Success,45,39,0,8,37
30,Fail,43,39,0,16,27
30,Success,49,33,6,12,37
30,Success,45,41,6,8,37
30,Success,48,40,1,11,37
30,Fail,43,36,6,15,28
30,Success,49,33,3,15,34
30,Success,48,38,0,11,37
30,Success,61,31,1,7,54
30,Fail,45,35,0,16,29
30,Success,47,36,0,14,33
30,Success,44,38,0,14,30
30,Fail,46,32,0,20,26
30,Success,54,31,1,14,40
30,Success,54,31,1,14,40
30,Success,44,43,7,6,38
30,Success,52,39,0,8,44
30,Success,48,36,5,11,37
30,Success,46,37,9,8,38
30,Fail,38,39,10,13,25
30,Fail,43,34,9,14,29
30,Fail,43,32,4,21,22
30,Success,48,35,0,13,35
30,Fail,41,32,7,20,21
30,Success,55,32,0,10,45
30,Success,46,38,1,15,31
30,Success,51,32,0,10,41
30,Success,52,27,10,11,41
30,Success,50,36,1,13,37
30,Success,52,34,3,11,41
30,Success,46,33,0,16,30
30,Success,49,39,0,12,37
30,Success,52,34,1,13,39
30,Success,42,46,0,11,31
30,Success,56,32,1,11,45
30,Fail,41,39,0,18,23
30,Success,53,33,0,12,41
30,Fail,40,38,0,16,24
30,Success,50,38,0,8,42
30,Success,44,38,9,9,35
30,Success,48,39,0,10,38
30,Success,46,39,0,13,33
30,Fail,42,35,8,15,27
30,Success,55,34,0,10,45
30,Success,45,37,0,12,33
30,Success,48,35,6,11,37
30,Success,51,35,0,8,43
30,Success,46,36,0,16,30
30,Success,50,41,1,8,42
30,Success,45,37,5,13,32
30,Success,52,28,0,15,37
30,Success,46,40,0,7,39
30,Success,47,31,7,15,32
30,Success,49,32,1,18,31
30,Success,50,35,2,13,37
30,Success,51,35,0,11,40
30,Success,52,31,0,9,43
30,Success,42,43,0,11,31
30,Success,48,35,3,14,34
30,Success,50,34,0,15,35
30,Success,48,36,0,13,35
30,Success,48,39,0,7,41
30,Success,56,30,0,12,44
30,Fail,40,39,3,18,22
30,Success,46,34,0,14,32
30,Success,53,37,2,8,45
30,Success,50,37,0,13,37
30,Success,54,33,0,11,43
30,Success,58,33,1,8,50
30,Success,44,34,0,14,30
30,Success,45,38,0,13,32
30,Fail,38,43,0,13,25
30,Fail,41,37,0,19,22
30,Success,46,36,0,15,31
30,Success,46,38,2,14,32
30,Success,54,38,1,7,47
30,Fail,44,33,8,15,29
30,Success,52,34,1,13,39
30,Success,45,39,4,12,33
30,Success,43,43,0,12,31
30,Success,51,35,1,13,38
30,Success,46,35,6,13,33
30,Success,50,37,0,11,39
30,Success,49,26,0,13,36
30,Success,49,33,6,12,37
30,Success,45,42,0,10,35
30,Fail,35,44,0,12,23
30,Success,49,35,2,14,35
30,Success,50,36,0,14,36
30,Success,55,37,0,8,47
30,Fail,45,38,0,17,28
30,Success,45,38,0,14,31
30,Success,51,33,1,15,36
30,Success,51,35,0,14,37
30,Success,47,34,0,11,36
30,Success,52,36,3,9,43
30,Success,53,30,9,8,45
30,Success,49,39,4,8,41
30,Fail,42,41,0,15,27
30,Success,59,29,0,9,50
30,Success,46,42,1,11,35
30,Success,48,33,0,15,33
30,Success,45,35,0,14,31
30,Success,48,34,8,10,38
30,Success,54,36,0,10,44
30,Success,49,35,0,11,38
30,Success,59,28,0,10,49
30,Success,55,31,2,12,43
30,Success,45,36,6,13,32
30,Success,49,33,1,17,32
30,Success,44,44,2,10,34
30,Fail,41,38,0,15,26
30,Success,49,32,7,12,37
30,Fail,34,40,0,18,16
30,Success,58,26,8,8,50
30,Success,44,36,7,13,31
30,Fail,44,35,4,17,27
30,Success,47,41,1,11,36
30,Success,54,33,1,12,42
30,Success,50,33,2,15,35
30,Fail,42,36,0,16,26
30,Success,48,38,1,13,35
30,Success,47,41,1,11,36
30,Success,52,36,0,12,40
30,Success,51,26,7,16,35
30,Success,53,33,0,12,41
30,Success,54,34,0,11,43
30,Success,48,33,3,16,32
30,Success,49,37,0,12,37
30,Success,47,38,4,11,36
30,Success,46,34,0,15,31
30,Success,50,34,0,16,34
30,Success,48,30,4,18,30
30,Success,51,32,0,11,40
30,Success,42,35,0,11,31
30,Fail,46,32,0,17,29
30,Fail,44,36,3,17,27
30,Success,47,33,0,13,34
30,Success,49,37,0,8,41
30,Success,50,32,0,14,36
30,Fail,41,34,0,22,19
30,Success,51,35,0,12,39
30,Success,48,33,0,12,36
30,Success,52,33,0,13,39
30,Success,47,37,2,14,33
30,Success,51,37,0,11,40
30,Success,57,34,0,9,48
30,Success,46,33,0,11,35
30,Success,45,40,4,11,34
30,Success,55,33,0,9,46
30,Fail,44,38,0,16,28
30,Success,51,37,2,10,41
30,Success,45,31,10,14,31
30,Success,45,36,0,13,32
30,Fail,43,39,0,16,27
30,Fail,39,32,9,20,19
30,Success,53,29,4,14,39
30,Success,49,38,2,11,38
30,Success,46,44,1,9,37
30,Fail,38,42,0,14,24
30,Fail,45,34,3,18,27
30,Success,55,31,6,8,47
30,Success,44,33,0,12,32
30,Success,51,35,0,13,38
30,Fail,45,36,0,18,27
30,Success,54,35,4,7,47
30,Success,48,34,0,10,38
30,Success,41,41,0,9,32
30,Success,51,32,5,12,39
30,Success,47,32,0,10,37
30,Success,54,31,2,13,41
30,Success,53,35,2,10,43
30,Success,52,34,0,8,44
30,Success,51,39,0,10,41
30,Success,56,33,2,9,47
30,Success,47,32,0,16,31
30,Fail,43,42,0,14,29
30,Fail,44,30,0,20,24
30,Fail,41,39,0,14,27
30,Success,52,39,0,8,44
30,Fail,44,32,0,18,26
30,Success,41,48,4,7,34
30,Success,47,43,4,6,41
30,Success,48,28,0,10,38
30,Success,45,45,4,6,39
30,Success,45,40,1,14,31
30,Success,51,36,0,13,38
30,Success,53,36,3,8,45
30,Success,49,36,6,9,40
30,Success,52,34,6,8,44
30,Success,52,32,6,10,42
30,Fail,40,44,0,13,27
30,Success,50,34,0,12,38
30,Success,44,41,0,13,31
30,Success,42,50,0,6,36
30,Success,53,34,5,8,45
30,Success,50,35,0,11,39
30,Success,46,36,0,13,33
30,Success,45,35,0,9,36
30,Success,53,32,2,13,40
30,Success,53,29,5,13,40
30,Fail,46,32,5,17,29
30,Fail,41,29,15,15,26
30,Success,48,31,0,13,35
30,Success,50,34,0,13,37
30,Fail,41,34,9,16,25
30,Success,52,36,3,9,43
30,Success,48,41,3,8,40
30,Success,49,37,2,12,37
30,Success,51,30,7,12,39
30,Success,43,44,2,11,32
30,Success,47,34,2,17,30
30,Success,47,37,3,13,34
30,Fail,42,43,2,13,29
30,Success,44,42,9,5,39
30,Success,46,35,4,15,31
30,Success,49,36,0,14,35
30,Success,50,37,0,12,38
30,Success,47,32,7,14,33
30,Success,45,39,6,10,35
30,Success,49,43,0,7,42
30,Success,48,42,1,9,39
30,Success,52,32,0,15,37
30,Success,53,37,1,9,44
30,Success,48,40,1,11,37
30,Success,49,34,0,12,37
30,Fail,37,36,0,21,16
30,Success,49,29,10,12,37
30,Success,47,42,0,11,36
30,Success,51,38,0,10,41
30,Success,42,37,9,12,30
30,Fail,42,42,0,13,29
30,Success,47,36,5,12,35
30,Success,44,31,0,14,30
30,Fail,47,28,7,18,29
30,Success,51,37,1,11,40
30,Success,43,39,6,12,31
30,Success,50,32,0,15,35
30,Fail,44,37,0,16,28
30,Success,47,38,0,15,32
30,Fail,46,28,0,19,27
30,Success,52,33,0,12,40
30,Success,48,37,0,15,33
30,Success,54,27,0,13,41
30,Success,54,35,4,7,47
30,Success,47,31,12,10,37
30,Fail,43,32,0,21,22
30,Success,48,34,4,14,34
30,Success,46,35,0,15,31
30,Success,49,31,7,13,36
30,Success,49,35,0,10,39
30,Success,53,34,6,7,46
30,Success,53,38,2,7,46
30,Success,50,38,0,9,41
30,Fail,45,34,4,17,28
30,Success,48,34,6,12,36
30,Success,49,32,0,13,36
30,Fail,45,28,0,16,29
30,Success,47,35,0,11,36
30,Success,49,29,6,16,33
30,Success,42,42,0,11,31
30,Success,50,35,3,12,38
30,Success,51,32,4,13,38
30,Success,52,32,2,14,38
30,Success,50,31,8,11,39
30,Success,44,39,0,14,30
30,Success,48,38,5,9,39
30,Success,49,36,0,9,40
30,Success,48,34,2,16,32
30,Success,48,32,0,12,36
30,Success,51,35,0,13,38
30,Fail,42,32,6,20,22
30,Success,51,32,0,14,37
30,Success,53,29,0,10,43
30,Success,50,32,0,10,40
30,Fail,47,30,0,20,27
30,Fail,41,38,4,17,24
30,Success,46,39,3,12,34
30,Success,58,29,5,8,50
30,Success,56,32,0,11,45
30,Fail,46,36,0,17,29
30,Success,52,31,4,13,39
30,Success,47,38,3,12,35
30,Success,45,42,1,12,33
30,Success,49,37,1,13,36
30,Success,55,34,4,7,48
30,Success,48,37,5,10,38
30,Success,47,37,0,13,34
30,Success,47,28,0,15,32
30,Success,45,40,8,7,38
30,Fail,37,46,6,11,26
30,Success,49,36,1,14,35
30,Success,51,33,3,13,38
30,Fail,43,41,1,15,28
30,Fail,43,39,1,17,26
30,Success,51,37,0,12,39
30,Success,55,26,0,12,43
30,Success,55,34,0,11,44
30,Fail,43,33,0,14,29
30,Success,48,43,4,5,43
30,Success,44,42,0,12,32
30,Success,52,31,2,15,37
30,Success,45,41,0,9,36
30,Success,48,30,0,14,34
30,Success,49,36,0,11,38
30,Success,48,32,5,15,33
30,Success,58,31,0,9,49
30,Success,45,38,3,14,31
30,Success,49,36,0,15,34
30,Success,50,30,0,13,37
30,Success,48,35,0,10,38
30,Success,46,41,0,13,33
30,Fail,31,35,16,18,13
30,Fail,43,39,0,15,28
30,Success,50,36,0,13,37
30,Success,44,37,5,14,30
30,Fail,47,33,0,20,27
30,Success,46,40,0,14,32
30,Success,47,33,8,12,35
30,Success,53,38,3,6,47
30,Success,45,43,3,9,36
30,Success,49,36,0,10,39
30,Success,50,40,1,9,41
30,Success,47,34,0,16,31
30,Success,48,31,7,14,34
30,Success,52,33,0,13,39
30,Success,53,35,4,8,45
30,Success,46,38,0,11,35
30,Success,50,39,0,9,41
30,Success,53,41,0,5,48
30,Success,43,38,7,12,31
30,Success,52,34,0,13,39
30,Success,50,36,0,11,39
30,Success,49,31,0,16,33
30,Success,48,37,5,10,38
30,Success,50,36,4,10,40
30,Success,48,42,0,9,39
30,Fail,42,40,0,14,28
30,Fail,39,38,0,17,22
30,Success,47,43,3,7,40
30,Success,50,36,0,10,40
30,Success,42,47,0,8,34
30,Fail,41,35,0,12,29
30,Success,48,31,0,15,33
30,Success,51,38,4,7,44
30,Success,51,38,0,7,44
30,Success,51,30,0,12,39
30,Success,44,40,3,13,31
30,Success,48,36,0,16,32
30,Success,49,34,5,12,37
30,Success,43,44,0,12,31
30,Success,55,30,3,12,43
30,Fail,45,36,0,16,29
30,Success,44,32,10,14,30
30,Fail,47,34,0,19,28
30,Success,46,32,0,15,31
30,Success,56,28,0,10,46
30,Success,43,40,5,12,31
30,Fail,43,39,0,14,29
30,Success,50,40,2,8,42
30,Success,59,28,0,10,49
30,Fail,46,28,0,21,25
30,Success,51,37,0,11,40
30,Success,51,35,3,11,40
30,Success,45,42,0,12,33
30,Success,50,31,0,17,33
30,Success,56,30,2,12,44
30,Fail,41,42,0,15,26
30,Success,45,37,0,13,32
30,Success,48,34,0,15,33
30,Success,51,36,1,12,39
30,Success,52,29,5,14,38
30,Success,48,32,0,14,34
30,Success,49,35,0,11,38
30,Success,53,31,0,11,42
30,Success,46,40,0,8,38
30,Success,59,24,0,16,43
30,Fail,45,35,4,16,29
30,Success,50,26,0,20,30
30,Success,53,38,3,6,47
30,Success,47,39,0,12,35
30,Success,51,33,3,13,38
30,Success,44,35,9,12,32
30,Fail,40,38,9,13,27
30,Success,48,38,0,13,35
30,Success,44,39,0,11,33
30,Success,50,42,1,7,43
30,Success,51,32,0,12,39
30,Success,54,31,0,14,40
30,Fail,42,40,0,16,26
30,Success,45,34,10,11,34
30,Success,46,32,0,13,33
30,Fail,45,29,0,20,25
30,Success,53,36,1,10,43
30,Success,54,41,1,4,50
30,Fail,42,40,2,16,26
30,Success,51,35,0,8,43
30,Success,48,28,6,18,30
30,Success,49,32,0,12,37
30,Fail,42,33,0,15,27
30,Success,43,44,0,10,33
30,Fail,47,26,0,18,29
30,Success,53,34,0,13,40
30,Success,53,30,1,16,37
30,Success,50,34,6,10,40
30,Success,49,28,10,13,36
30,Success,50,35,0,11,39
30,Fail,41,39,5,15,26
30,Success,53,29,1,17,36
30,Success,57,36,0,6,51
30,Success,55,31,0,12,43
30,Fail,41,41,0,17,24
30,Success,46,33,6,15,31
30,Success,50,41,0,8,42
30,Success,50,34,0,12,38
30,Fail,38,38,11,13,25
30,Success,54,39,0,7,47
30,Success,41,44,5,10,31
30,Fail,42,39,0,18,24
30,Success,44,45,0,11,33
30,Success,50,26,0,11,39
30,Success,44,38,6,12,32
30,Success,41,46,0,9,32
30,Success,48,35,4,13,35
30,Success,57,29,0,8,49
30,Success,47,38,0,14,33
30,Success,51,33,0,14,37
30,Success,49,34,3,14,35
30,Success,52,33,8,7,45
30,Fail,40,44,3,13,27
30,Success,48,28,0,17,31
30,Success,53,41,0,6,47
30,Success,45,39,0,12,33
30,Success,56,28,0,16,40
30,Success,55,36,2,7,48
30,Success,44,31,0,14,30
30,Success,49,36,3,12,37
30,Fail,43,33,8,16,27
30,Success,49,36,0,12,37
30,Success,48,39,4,9,39
30,Success,44,44,0,9,35
30,Success,55,34,1,10,45
30,Fail,41,33,0,16,25
30,Fail,38,34,14,14,24
30,Success,43,33,13,11,32
30,Success,46,37,0,16,30
30,Fail,42,36,0,17,25
30,Fail,44,31,10,15,29
30,Success,41,47,0,10,31
30,Success,46,38,5,11,35
30,Fail,42,38,0,18,24
30,Fail,42,36,0,16,26
30,Success,55,34,0,11,44
30,Success,52,37,0,11,41
30,Success,47,34,0,13,34
30,Success,60,28,1,11,49
30,Success,50,37,1,12,38
30,Success,49,36,0,11,38
30,Success,49,35,5,11,38
30,Success,57,33,5,5,52
30,Success,44,38,0,13,31
30,Success,53,29,0,13,40
30,Success,45,33,7,15,30
30,Success,50,33,0,15,35
30,Success,51,32,0,16,35
30,Success,45,36,7,12,33
30,Success,51,28,3,18,33
30,Success,49,41,0,9,40
30,Success,51,37,0,9,42
30,Success,46,36,0,14,32
30,Success,44,42,0,11,33
30,Success,47,37,0,16,31
30,Fail,43,38,2,17,26
30,Fail,37,40,0,18,19
30,Success,53,37,1,9,44
30,Success,48,37,3,12,36
30,Success,51,38,0,10,41
30,Success,47,37,1,15,32
30,Success,43,38,8,11,32
30,Success,52,34,0,14,38
30,Success,52,28,5,15,37
30,Success,49,34,0,15,34
30,Success,53,33,0,10,43
30,Success,48,36,0,11,37
30,Success,50,33,0,11,39
30,Fail,34,36,12,18,16
30,Success,47,42,0,7,40
30,Success,44,42,0,14,30
30,Success,49,38,0,12,37
30,Fail,41,35,0,14,27
30,Fail,46,33,3,18,28
30,Fail,43,36,3,18,25
30,Success,45,38,0,15,30
30,Success,48,44,0,8,40
30,Fail,43,37,0,19,24
30,Fail,40,45,2,13,27
30,Fail,42,37,7,14,28
30,Success,56,29,5,10,46
30,Success,46,39,0,13,33
30,Success,58,32,0,8,50
30,Success,51,35,0,7,44
30,Success,53,36,1,10,43
30,Fail,43,37,6,14,29
30,Fail,40,30,9,21,19
30,Success,52,37,3,8,44
30,Success,46,40,0,14,32
30,Success,47,36,0,12,35
30,Success,50,31,4,15,35
30,Success,48,35,0,10,38
30,Success,50,34,4,12,38
30,Success,50,37,2,11,39
30,Fail,42,33,0,19,23
30,Success,47,37,4,12,35
30,Success,49,42,0,9,40
30,Success,47,41,2,10,37
30,Success,51,33,0,10,41
30,Success,50,35,5,10,40
30,Success,45,40,2,13,32
30,Success,50,31,0,10,40
30,Success,47,34,0,16,31
30,Fail,41,33,9,17,24
30,Success,48,39,3,10,38
30,Success,46,38,3,13,33
30,Success,49,33,6,12,37
30,Success,47,45,1,7,40
30,Fail,41,41,4,14,27
30,Success,54,35,2,9,45
30,Success,50,36,1,13,37
30,Success,44,39,0,14,30
30,Success,50,33,0,11,39
30,Success,57,26,6,11,46
30,Success,51,33,3,13,38
30,Success,44,39,0,8,36
30,Success,45,40,0,15,30
30,Fail,41,40,5,14,27
30,Success,52,33,0,13,39
30,Success,52,33,6,9,43
30,Success,46,40,9,5,41
30,Success,58,34,0,8,50
30,Success,51,34,1,14,37
30,Success,53,32,4,11,42
30,Success,55,40,0,5,50
30,Fail,39,43,2,16,23
30,Success,53,34,0,11,42
30,Success,54,30,0,14,40
30,Success,48,39,3,10,38
30,Success,52,30,3,15,37
30,Success,47,36,4,13,34
30,Fail,43,43,0,14,29
30,Fail,47,29,0,21,26
30,Success,56,33,0,7,49
30,Success,48,40,5,7,41
30,Success,51,28,0,14,37
30,Success,41,40,8,11,30
30,Success,48,33,0,15,33
30,Success,53,29,0,13,40
30,Success,51,35,2,12,39
30,Success,55,30,0,13,42
30,Success,52,34,0,10,42
30,Fail,45,37,1,17,28
30,Success,52,31,0,17,35
30,Fail,49,24,7,20,29
30,Success,51,33,5,11,40
30,Success,42,40,0,11,31
30,Success,48,34,0,14,34
30,Success,45,44,0,11,34
30,Success,49,34,0,17,32
30,Success,51,35,0,14,37
30,Success,43,40,4,13,30
30,Success,50,37,0,13,37
30,Success,52,33,1,14,38
30,Success,53,33,1,13,40
30,Success,55,29,5,11,44
30,Success,51,36,5,8,43
30,Fail,43,34,9,14,29
30,Success,55,34,4,7,48
30,Success,48,34,0,13,35
30,Success,45,37,0,14,31
30,Fail,43,36,0,14,29
30,Success,42,43,0,10,32
30,Success,56,32,3,9,47
30,Success,45,43,1,11,34
30,Success,46,43,0,11,35
30,Success,47,43,0,6,41
30,Fail,40,46,3,11,29
30,Success,61,31,2,6,55
30,Success,48,40,1,11,37
30,Success,49,39,0,11,38
30,Success,49,32,1,18,31
30,Success,55,32,2,11,44
30,Success,46,41,0,11,35
30,Success,48,39,4,9,39
30,Success,41,44,4,11,30
30,Success,48,45,1,6,42
30,Success,55,28,0,14,41
30,Success,44,35,0,14,30
30,Success,45,40,0,13,32
30,Success,50,33,9,8,42
30,Success,49,41,0,9,40
30,Success,49,34,0,16,33
30,Success,45,35,0,14,31
30,Success,42,36,0,11,31
30,Success,48,38,0,11,37
30,Success,44,38,4,14,30
30,Success,47,33,7,13,34
30,Success,56,29,0,15,41
30,Success,48,38,0,7,41
30,Success,51,33,9,7,44
30,Success,52,33,0,14,38
30,Fail,41,28,9,22,19
30,Success,48,38,7,7,41
30,Success,55,35,0,10,45
30,Fail,40,33,4,23,17
30,Success,47,32,0,16,31
30,Success,46,30,0,10,36
30,Success,47,39,6,8,39
30,Success,50,38,4,8,42
30,Success,48,39,0,13,35
30,Success,47,35,0,17,30
30,Fail,45,34,0,16,29
30,Fail,44,37,0,17,27
30,Success,57,29,0,10,47
30,Success,46,31,7,16,30
30,Fail,45,37,0,17,28
30,Success,52,36,0,10,42
30,Fail,43,37,4,16,27
30,Success,49,30,0,14,35
30,Success,48,36,2,14,34
30,Success,48,37,0,12,36
30,Success,47,35,0,17,30
30,Success,48,37,0,12,36
30,Fail,40,36,0,12,28
30,Success,53,34,0,11,42
30,Success,48,35,3,14,34
30,Success,46,34,0,13,33
30,Success,51,42,0,7,44
30,Success,52,35,4,9,43
30,Success,53,36,1,10,43
30,Success,45,36,0,15,30
30,Success,49,37,1,13,36
30,Success,51,33,0,9,42
30,Success,51,35,0,14,37
30,Success,49,36,2,13,36
30,Success,46,33,6,15,31
30,Success,52,28,0,13,39
30,Fail,44,38,2,16,28
30,Fail,43,41,2,14,29
30,Fail,41,41,2,16,25
30,Success,49,39,1,11,38
30,Success,49,36,1,14,35
30,Success,52,34,0,13,39
30,Success,49,39,2,10,39
30,Fail,44,33,0,21,23
30,Success,55,32,3,10,45
30,Success,45,39,6,10,35
30,Success,51,36,0,11,40
30,Success,42,42,6,10,32
30,Success,44,35,9,12,32
30,Success,49,31,7,13,36
30,Success,47,35,0,16,31
30,Fail,45,34,2,19,26
30,Success,50,34,5,11,39
30,Success,47,42,1,10,37
30,Fail,39,38,5,18,21
30,Fail,45,35,3,17,28
30,Success,48,42,0,10,38
30,Success,46,37,3,14,32
30,Success,49,34,1,16,33
30,Fail,39,37,10,14,25
30,Success,45,40,0,12,33
30,Success,43,42,0,10,33
30,Success,50,35,0,10,40
30,Success,51,36,0,13,38
30,Success,51,31,0,14,37
30,Success,53,38,0,9,44
30,Success,46,43,1,10,36
30,Success,48,29,0,16,32
30,Success,50,34,0,10,40
30,Success,48,38,0,7,41
30,Success,49,42,0,8,41
30,Success,51,34,7,8,43
30,Success,47,35,0,17,30
30,Success,55,35,0,8,47
30,Success,46,43,2,9,37
30,Success,48,33,2,17,31
30,Success,51,38,1,10,41
30,Fail,41,39,0,16,25
30,Success,44,42,0,10,34
30,Success,54,29,0,10,44
30,Success,51,40,1,8,43
30,Success,48,35,0,11,37
30,Success,43,43,1,13,30
30,Success,48,37,0,8,40
30,Success,46,40,0,8,38
30,Fail,43,35,5,17,26
30,Success,49,37,4,10,39
30,Success,45,47,1,7,38
30,Fail,44,35,0,17,27
30,Fail,47,27,8,18,29
30,Success,50,38,0,9,41
30,Success,48,42,0,9,39
30,Success,53,31,3,13,40
30,Success,53,34,0,5,48
30,Fail,38,41,7,14,24
30,Success,46,35,0,16,30
30,Success,52,34,0,14,38
30,Success,45,40,0,13,32
30,Success,48,30,0,16,32
30,Success,47,39,3,11,36
30,Fail,48,29,0,20,28
30,Success,52,34,4,10,42
30,Success,54,29,5,12,42
30,Success,49,36,2,13,36
30,Fail,43,35,0,19,24
30,Success,52,34,0,14,38
30,Success,49,37,0,10,39
30,Success,47,43,1,9,38
30,Success,56,31,6,7,49
30,Success,57,31,1,11,46
30,Success,55,31,2,12,43
30,Success,46,40,1,13,33
30,Success,49,34,0,14,35
30,Fail,38,42,1,19,19
30,Success,54,29,9,8,46
30,Success,52,31,0,16,36
30,Success,48,38,1,13,35
30,Fail,43,36,0,18,25
30,Success,52,32,5,11,41
30,Success,49,44,0,7,42
30,Success,45,37,4,14,31
30,Success,56,28,0,14,42
30,Success,52,34,0,11,41
30,Success,54,35,0,10,44
30,Fail,42,41,3,14,28
30,Fail,42,33,5,20,22
30,Success,46,34,0,13,33
30,Success,51,32,0,11,40
30,Fail,38,39,0,14,24
30,Success,50,35,3,12,38
30,Success,47,38,6,9,38
30,Fail,41,44,0,13,28
30,Success,52,35,2,11,41
30,Success,43,38,0,12,31
30,Fail,41,36,4,19,22
30,Fail,36,37,0,17,19
30,Success,55,32,3,10,45
30,Success,54,30,0,12,42
30,Success,53,34,3,10,43
30,Success,46,28,11,15,31
30,Fail,45,37,0,17,28
30,Success,46,42,0,10,36
30,Success,51,33,0,13,38
30,Success,44,44,2,10,34
30,Success,56,32,3,9,47
30,Fail,41,42,4,13,28
30,Success,51,32,5,12,39
30,Success,51,33,0,10,41
30,Success,47,34,0,14,33
30,Success,48,38,2,12,36
30,Success,51,31,0,16,35
30,Success,51,41,0,8,43
30,Success,47,39,0,9,38
30,Success,47,38,0,10,37
30,Success,51,34,3,12,39
30,Success,57,31,2,10,47
30,Fail,40,40,6,14,26
30,Fail,44,40,0,15,29
30,Success,49,36,3,12,37
30,Success,46,40,0,10,36
30,Fail,41,42,2,15,26
30,Success,56,38,0,4,52
30,Success,49,35,0,13,36
30,Success,47,36,0,12,35
30,Success,44,39,0,10,34
30,Fail,41,34,0,17,24
30,Success,55,31,1,13,42
30,Success,55,37,0,7,48
30,Success,50,29,0,16,34
30,Success,48,39,4,9,39
30,Success,47,36,0,15,32
30,Fail,40,33,6,21,19
30,Fail,42,37,7,14,28
30,Success,46,31,0,15,31
30,Success,47,37,0,11,36
30,Success,57,27,0,14,43
30,Success,44,43,4,9,35
30,Success,54,33,1,12,42
30,Success,49,34,3,14,35
30,Success,59,28,3,10,49
30,Fail,43,35,6,16,27
30,Success,49,30,0,15,34
30,Success,51,35,0,12,39
30,Fail,41,41,6,12,29
30,Success,56,28,6,10,46
30,Success,48,34,5,13,35
30,Success,47,37,0,14,33
30,Success,49,35,0,11,38
30,Success,54,32,3,11,43
30,Fail,46,32,0,19,27
30,Success,47,35,4,14,33
30,Success,51,40,0,9,42
30,Success,46,37,0,14,32
30,Success,52,33,0,14,38
30,Success,52,29,8,11,41
30,Success,48,33,0,11,37
30,Fail,38,31,0,17,21
30,Success,49,38,0,10,39
30,Success,50,34,0,15,35
30,Success,45,37,0,10,35
30,Success,48,36,1,15,33
30,Success,43,42,0,12,31
30,Fail,44,31,4,21,23
30,Success,50,44,1,5,45
30,Fail,43,38,0,14,29
30,Fail,43,35,6,16,27
30,Success,56,28,0,10,46
30,Success,46,43,0,11,35
30,Success,47,42,0,8,39
30,Success,50,38,0,12,38
30,Success,48,42,0,10,38
30,Success,53,35,1,11,42
30,Success,58,29,0,10,48
30,Success,44,30,0,13,31
30,Success,53,33,5,9,44
30,Success,46,39,6,9,37
30,Success,53,34,1,12,41
30,Success,51,37,1,11,40
30,Success,49,39,0,9,40
30,Success,46,39,0,14,32
30,Fail,38,37,10,15,23
30,Success,53,36,3,8,45
30,Success,51,33,0,14,37
30,Success,46,38,0,15,31
30,Success,55,31,0,13,42
30,Success,48,34,1,17,31
30,Success,46,40,0,12,34
30,Success,45,41,1,13,32
30,Success,58,29,0,10,48
30,Success,48,34,6,12,36
30,Success,46,36,0,10,36
30,Success,46,33,0,13,33
30,Success,46,39,0,11,35
30,Success,49,29,4,18,31
30,Fail,40,36,8,16,24
30,Success,57,33,0,10,47
30,Success,49,39,0,8,41
30,Success,47,42,2,9,38
30,Success,48,38,2,12,36
30,Success,53,33,0,10,43
30,Success,50,39,0,9,41
30,Success,51,39,2,8,43
30,Success,47,38,0,13,34
30,Fail,39,37,9,15,24
30,Success,54,32,0,13,41
30,Fail,48,29,2,21,27
30,Success,45,46,0,8,37
30,Success,49,42,0,7,42
30,Success,51,34,0,13,38
30,Success,49,30,0,16,33
30,Fail,45,36,3,16,29
30,Fail,43,36,0,15,28
30,Fail,41,45,0,14,27
30,Success,46,40,3,11,35
30,Success,52,38,0,8,44
30,Success,47,38,0,13,34
30,Success,47,36,5,12,35
30,Success,48,43,0,7,41
30,Fail,42,35,9,14,28
30,Success,45,44,3,8,37
30,Success,51,29,5,15,36
30,Fail,42,35,0,20,22
30,Fail,42,40,2,16,26
30,Success,46,36,7,11,35
30,Fail,42,42,0,13,29
30,Success,51,34,6,9,42
30,Success,47,30,0,16,31
30,Success,49,25,10,16,33
30,Success,44,45,0,11,33
30,Fail,40,40,0,11,29
30,Success,46,38,1,15,31
30,Success,50,37,1,12,38
30,Success,54,33,0,9,45
30,Success,50,38,1,11,39
30,Fail,46,34,0,18,28
30,Success,48,35,6,11,37
30,Success,53,38,0,9,44
30,Fail,40,42,0,18,22
30,Success,44,42,4,10,34
30,Success,48,34,1,17,31
30,Fail,44,37,0,15,29
30,Success,49,33,1,17,32
30,Fail,38,33,8,21,17
30,Success,47,33,0,9,38
30,Success,48,35,0,12,36
30,Fail,44,38,0,15,29
30,Success,49,34,0,15,34
30,Success,51,28,0,13,38
30,Success,44,37,7,12,32
30,Success,50,39,0,7,43
30,Success,49,36,0,11,38
30,Success,53,36,3,8,45
30,Success,51,33,0,8,43
30,Fail,42,42,0,15,27
30,Success,50,33,6,11,39
30,Success,44,33,9,14,30
30,Success,46,39,3,12,34
30,Fail,39,37,11,13,26
30,Success,54,25,9,12,42
30,Success,55,36,1,8,47
30,Success,50,40,0,7,43
30,Success,47,36,4,13,34
30,Fail,45,33,0,18,27
30,Success,53,36,3,8,45
30,Success,54,31,0,12,42
30,Success,53,32,0,15,38
30,Success,45,43,0,8,37
30,Success,49,41,0,10,39
30,Success,51,35,7,7,44
30,Success,44,39,0,8,36
30,Success,48,41,0,8,40
30,Success,47,39,2,12,35
30,Success,48,39,6,7,41
30,Success,56,31,3,10,46
30,Success,47,39,5,9,38
30,Success,50,34,0,16,34
30,Fail,40,39,4,17,23
30,Success,52,39,0,4,48
30,Success,52,38,2,8,44
30,Success,44,44,0,12,32
30,Success,44,39,0,9,35
30,Success,44,38,8,10,34
30,Success,52,26,0,15,37
30,Success,47,40,0,9,38
30,Success,52,38,0,10,42
30,Fail,47,33,2,18,29
30,Success,51,31,6,12,39
30,Success,46,38,0,14,32
30,Success,55,36,0,5,50
30,Success,52,29,0,16,36
30,Success,44,45,0,9,35
30,Success,51,36,1,12,39
30,Success,50,34,0,13,37
30,Success,50,35,5,10,40
30,Fail,46,35,0,19,27
30,Fail,46,36,1,17,29
30,Success,49,40,3,8,41
30,Success,55,27,0,16,39
30,Success,58,33,0,7,51
30,Success,45,39,5,11,34
30,Success,59,29,2,10,49
30,Success,47,39,0,12,35
30,Success,48,35,6,11,37
30,Success,45,38,2,15,30
30,Success,47,33,5,15,32
30,Success,46,28,14,12,34
30,Success,57,29,0,13,44
30,Fail,49,30,0,20,29
30,Fail,45,34,0,17,28
30,Fail,44,39,0,15,29
30,Success,46,41,4,9,37
30,Fail,42,38,4,16,26
30,Success,52,37,4,7,45
30,Success,44,38,8,10,34
30,Success,44,40,3,13,31
30,Fail,42,35,0,20,22
30,Success,46,29,0,15,31
30,Success,48,36,0,14,34
30,Success,51,31,0,14,37
30,Success,50,31,2,17,33
30,Success,53,28,1,18,35
30,Success,55,38,0,7,48
30,Success,51,36,5,8,43
30,Success,44,40,0,14,30
30,Fail,40,35,0,22,18
30,Fail,44,32,9,15,29
30,Success,58,28,1,13,45
30,Success,53,32,3,12,41
30,Success,49,41,0,8,41
30,Fail,38,43,0,12,26
30,Success,56,33,2,9,47
30,Success,47,38,3,12,35
30,Success,50,37,0,9,41
30,Fail,44,30,0,19,25
30,Success,48,37,0,12,36
30,Success,51,42,0,5,46
30,Success,57,30,2,11,46
30,Success,52,32,9,7,45
30,Success,43,40,7,10,33
30,Fail,38,38,7,17,21
30,Success,45,40,5,10,35
30,Success,47,39,0,12,35
30,Fail,46,31,0,19,27
30,Success,47,39,4,10,37
30,Success,45,38,0,12,33
30,Fail,42,40,0,13,29
30,Success,50,39,0,7,43
30,Success,49,32,1,18,31
30,Success,50,37,2,11,39
30,Success,52,36,3,9,43
30,Success,43,39,0,12,31
30,Success,47,39,0,11,36
30,Fail,41,43,0,15,26
30,Success,55,26,10,9,46
30,Success,46,40,2,12,34
30,Success,46,34,0,13,33
30,Success,49,37,0,12,37
30,Fail,40,37,0,14,26
30,Success,46,41,6,7,39
30,Success,48,41,0,9,39
30,Success,53,36,1,10,43
30,Success,46,39,4,11,35
30,Success,52,29,0,16,36
30,Success,49,38,4,9,40
30,Success,47,31,7,15,32
30,Success,53,33,4,10,43
30,Success,45,36,0,14,31
30,Fail,41,36,0,15,26
30,Success,58,29,0,11,47
30,Success,52,29,0,13,39
30,Success,49,39,0,11,38
30,Fail,42,43,2,13,29
30,Success,51,35,1,13,38
30,Success,56,27,0,9,47
30,Fail,36,30,0,19,17
30,Success,48,31,5,16,32
30,Success,50,37,4,9,41
30,Success,49,36,6,9,40
30,Fail,46,37,0,17,29
30,Fail,41,38,1,20,21
30,Fail,40,35,0,18,22
30,Success,51,38,0,8,43
30,Success,48,31,0,18,30
30,Success,46,38,3,13,33
30,Fail,42,27,0,16,26
30,Success,55,27,5,13,42
30,Success,53,36,0,11,42
30,Success,51,28,0,19,32
30,Success,54,32,2,12,42
30,Success,49,45,0,5,44
30,Success,51,28,6,15,36
30,Success,44,38,0,11,33
30,Success,52,36,1,11,41
30,Success,51,33,4,12,39
30,Success,55,39,0,6,49
30,Success,51,35,2,12,39
30,Success,44,36,0,14,30
30,Success,46,39,6,9,37
30,Success,48,36,0,10,38
30,Success,52,33,0,15,37
30,Success,44,38,0,12,32
30,Success,53,41,2,4,49
30,Fail,45,32,5,18,27
30,Success,47,45,0,7,40
30,Success,49,34,0,15,34
30,Success,53,26,4,17,36
30,Fail,44,38,0,16,28
30,Success,55,34,0,11,44
30,Success,45,36,0,11,34
30,Fail,41,39,2,18,23
30,Success,51,38,0,10,41
30,Success,49,34,7,10,39
30,Success,48,36,5,11,37
30,Success,60,33,0,6,54
30,Success,43,43,1,13,30
30,Fail,45,29,0,19,26
30,Success,44,38,8,10,34
30,Success,45,35,0,14,31
30,Success,51,40,2,7,44
30,Success,58,28,3,11,47
30,Success,55,33,0,8,47
30,Fail,44,39,2,15,29
30,Success,47,35,0,15,32
30,Success,45,39,0,12,33
30,Success,52,29,0,10,42
30,Success,53,38,0,9,44
30,Success,53,36,0,11,42
30,Success,49,41,0,9,40
30,Success,51,34,2,13,38
30,Success,49,35,0,14,35
30,Fail,40,34,0,14,26
30,Success,54,35,1,10,44
30,Success,53,36,0,11,42
30,Success,49,40,0,9,40
30,Success,51,34,0,15,36
30,Success,52,39,0,9,43
30,Fail,41,43,1,15,26
30,Success,49,34,2,15,34
30,Success,43,37,0,13,30
30,Success,50,30,5,15,35
30,Success,47,36,6,11,36
30,Success,55,31,0,14,41
30,Success,48,36,0,15,33
30,Success,52,35,0,8,44
30,Success,49,29,0,17,32
30,Fail,44,36,0,17,27
30,Fail,44,39,0,16,28
30,Success,50,35,0,11,39
30,Fail,40,41,0,15,25
30,Success,51,33,0,13,38
30,Success,59,30,0,8,51
30,Success,47,30,8,15,32
30,Success,46,40,6,8,38
30,Fail,39,41,4,16,23
30,Success,50,35,0,12,38
30,Success,46,39,6,9,37
30,Success,48,34,0,12,36
30,Success,51,39,1,9,42
30,Success,48,36,0,13,35
30,Success,52,33,0,10,42
30,Success,47,38,0,14,33
30,Success,50,37,0,10,40
30,Fail,41,36,9,14,27
30,Success,55,37,0,6,49
30,Success,48,34,0,16,32
30,Success,55,36,0,4,51
30,Success,51,31,4,14,37
30,Success,41,50,0,9,32
30,Success,47,41,0,9,38
30,Success,54,33,0,13,41
30,Success,47,36,2,15,32
30,Success,43,44,2,11,32
30,Success,50,30,0,17,33
30,Fail,38,40,3,19,19
30,Success,50,36,1,13,37
30,Success,41,40,0,11,30
30,Success,53,38,3,6,47
30,Success,50,38,2,10,40
30,Success,59,35,1,5,54
30,Success,48,42,2,8,40
30,Success,45,39,0,15,30
30,Success,51,44,0,4,47
30,Success,49,38,2,11,38
30,Success,49,33,5,13,36
30,Success,49,37,3,11,38
30,Success,42,37,0,11,31
30,Success,55,24,6,15,40
30,Fail,45,33,0,18,27
30,Success,49,37,0,14,35
30,Success,47,38,0,10,37
30,Success,50,30,0,12,38
30,Success,49,41,0,8,41
30,Success,52,34,3,11,41
30,Success,54,37,1,8,46
30,Fail,44,36,0,17,27
30,Success,52,33,0,12,40
30,Success,49,30,10,11,38
30,Success,47,36,6,11,36
30,Success,54,29,0,15,39
30,Success,53,33,2,12,41
30,Success,53,34,1,12,41
30,Success,45,39,0,11,34
30,Success,42,43,6,9,33
30,Success,51,31,7,11,40
30,Success,57,31,0,11,46
30,Success,57,35,0,5,52
30,Fail,43,35,0,21,22
30,Success,45,35,0,9,36
30,Success,56,29,0,12,44
30,Success,51,33,0,14,37
30,Success,47,34,0,12,35
30,Success,53,36,0,11,42
30,Fail,45,32,0,20,25
30,Success,44,36,7,13,31
30,Success,45,42,2,11,34
30,Success,46,36,2,16,30
30,Success,55,33,0,9,46
30,Success,48,33,8,11,37
30,Success,44,36,6,14,30
30,Success,56,32,4,8,48
30,Success,47,39,0,7,40
30,Fail,41,33,0,15,26
30,Success,49,32,8,11,38
30,Fail,43,39,3,15,28
30,Success,57,34,0,8,49
30,Success,46,35,0,13,33
30,Success,51,28,0,16,35
30,Fail,44,40,0,15,29
30,Success,50,43,0,7,43
30,Success,46,34,11,9,37
30,Success,49,34,0,14,35
30,Success,49,43,0,8,41
30,Fail,43,27,0,15,28
30,Success,49,32,0,17,32
30,Success,43,43,0,10,33
30,Success,45,40,4,11,34
30,Success,47,35,0,15,32
30,Success,47,36,0,12,35
30,Success,51,32,0,12,39
30,Success,53,29,8,10,43
30,Fail,41,35,0,14,27
30,Success,53,40,0,7,46
30,Success,48,41,0,9,39
30,Success,49,35,4,12,37
30,Success,48,26,0,15,33
30,Success,47,36,1,16,31
30,Success,52,34,1,13,39
30,Success,53,33,0,11,42
30,Success,47,39,0,14,33
30,Success,46,38,0,14,32
30,Success,52,32,0,16,36
30,Success,52,28,1,19,33
30,Success,48,36,0,16,32
30,Success,50,38,0,11,39
30,Success,41,46,0,10,31
30,Fail,38,38,0,21,17
30,Fail,41,37,5,17,24
30,Success,47,41,1,11,36
30,Success,46,46,1,7,39
30,Success,50,41,0,6,44
30,Fail,43,35,6,16,27
30,Success,49,30,0,15,34
30,Success,49,35,0,16,33
30,Fail,41,44,2,13,28
30,Success,54,32,0,14,40
30,Success,47,40,1,12,35
30,Success,46,33,0,14,32
30,Success,44,42,0,11,33
30,Fail,45,33,5,17,28
30,Success,48,38,4,10,38
30,Success,51,35,4,10,41
30,Success,46,30,11,13,33
30,Success,55,30,4,11,44
30,Success,47,34,0,7,40
30,Fail,44,38,1,17,27
30,Success,58,25,5,12,46
30,Success,50,35,0,7,43
30,Success,44,38,4,14,30
30,Success,56,28,1,15,41
30,Success,48,39,0,11,37
30,Fail,41,45,0,13,28
30,Success,49,29,0,16,33
30,Success,48,40,0,12,36
30,Fail,43,41,1,15,28
30,Success,50,32,0,16,34
30,Success,47,30,10,13,34
30,Success,47,35,0,13,34
30,Fail,42,38,4,16,26
30,Success,47,40,0,8,39
30,Success,46,35,0,16,30
30,Fail,45,33,4,18,27
30,Success,55,33,0,11,44
30,Fail,42,42,0,16,26
30,Success,48,38,0,11,37
30,Success,60,27,2,11,49
30,Success,47,35,7,11,36
30,Success,48,40,0,8,40
30,Success,46,38,0,8,38
30,Success,58,31,3,8,50
30,Success,50,34,0,10,40
30,Success,48,40,0,12,36
30,Fail,47,25,5,23,24
30,Success,53,30,0,14,39
30,Success,46,37,0,12,34
30,Success,52,28,2,18,34
30,Success,48,33,0,17,31
30,Fail,39,43,0,16,23
30,Success,52,37,3,8,44
30,Success,52,37,4,7,45
30,Fail,44,33,0,17,27
30,Success,55,31,4,10,45
30,Success,50,36,0,13,37
30,Success,50,35,2,13,37
30,Success,51,42,0,7,44
30,Success,48,38,0,10,38
30,Success,45,39,0,9,36
30,Success,47,39,2,12,35
30,Success,44,43,0,11,33
30,Success,51,33,0,15,36
30,Success,44,36,0,8,36
30,Success,45,36,5,14,31
30,Success,46,35,7,12,34
30,Fail,39,34,0,20,19
30,Success,53,35,4,8,45
30,Success,48,38,1,13,35
30,Fail,43,34,5,18,25
30,Success,47,44,0,8,39
30,Success,47,39,0,13,34
30,Success,47,37,1,15,32
30,Success,45,37,0,14,31
30,Success,48,38,3,11,37
30,Success,51,28,0,16,35
30,Success,56,29,1,14,42
30,Success,46,38,0,15,31
30,Success,44,36,7,13,31
30,Success,55,35,0,7,48
30,Success,51,43,0,6,45
30,Success,49,32,6,13,36
30,Success,48,38,7,7,41
30,Success,51,38,0,10,41
30,Success,44,41,3,12,32
30,Success,43,42,5,10,33
30,Fail,41,31,0,16,25
30,Success,53,37,1,9,44
30,Success,57,36,0,5,52
30,Fail,45,31,6,18,27
30,Success,49,36,0,9,40
30,Success,50,37,3,10,40
30,Success,50,40,5,5,45
30,Success,48,41,0,8,40
30,Fail,41,30,11,18,23
30,Success,54,27,3,16,38
30,Success,44,44,1,11,33
30,Success,50,39,0,10,40
30,Success,44,32,12,12,32
30,Success,49,42,0,9,40
30,Success,45,38,0,11,34
30,Success,48,37,6,9,39
30,Fail,45,38,0,16,29
30,Success,61,32,4,3,58
30,Success,45,43,2,10,35
30,Success,47,41,0,10,37
30,Success,46,35,0,13,33
30,Success,56,33,0,9,47
30,Success,47,29,10,14,33
30,Fail,45,35,4,16,29
30,Success,44,37,5,14,30
30,Success,48,38,1,13,35
30,Success,49,39,1,11,38
30,Success,47,32,0,16,31
30,Success,52,34,3,11,41
30,Success,44,35,0,14,30
30,Success,49,38,0,11,38
30,Success,48,37,7,8,40
30,Success,46,33,5,16,30
30,Success,47,39,8,6,41
30,Success,51,37,0,9,42
30,Success,51,43,0,6,45
30,Success,53,34,0,12,41
30,Success,43,36,0,8,35
30,Fail,43,33,4,20,23
30,Fail,37,38,0,18,19
30,Success,51,37,0,7,44
30,Success,48,39,0,10,38
30,Fail,45,33,3,19,26
30,Fail,45,34,4,17,28
30,Fail,43,31,0,24,19
30,Fail,42,38,0,13,29
30,Success,57,36,0,7,50
30,Success,46,37,0,13,33
30,Fail,36,39,9,16,20
30,Success,52,37,0,9,43
30,Fail,45,31,5,19,26
30,Success,46,39,5,10,36
30,Success,52,27,0,15,37
30,Success,49,36,0,12,37
30,Success,47,33,0,17,30
30,Success,48,35,0,15,33
30,Success,44,41,0,12,32
30,Success,50,40,0,10,40
30,Success,48,33,2,17,31
30,Success,51,32,4,13,38
30,Success,50,36,1,13,37
30,Success,46,39,0,13,33
30,Success,49,35,0,16,33
30,Success,51,35,5,9,42
30,Success,43,42,0,6,37
30,Success,52,38,2,8,44
30,Success,49,39,0,11,38
30,Success,47,33,5,15,32
30,Success,52,30,0,15,37
30,Success,48,36,2,14,34
30,Success,50,41,0,9,41
30,Success,45,40,0,15,30
30,Success,48,28,11,13,35
30,Success,50,39,1,10,40
30,Success,48,40,0,9,39
30,Fail,40,32,0,22,18
30,Fail,40,41,0,17,23
30,Fail,42,41,0,13,29
30,Success,55,28,0,12,43
30,Success,50,36,2,12,38
30,Success,50,36,3,11,39
30,Success,46,34,0,15,31
30,Success,49,32,0,19,30
30,Success,56,33,2,9,47
30,Success,45,32,8,15,30
30,Success,51,32,0,13,38
30,Success,45,36,5,14,31
30,Success,51,36,1,12,39
30,Success,51,39,3,7,44
30,Success,46,39,2,13,33
30,Success,52,32,0,9,43
30,Success,53,31,0,11,42
30,Success,56,34,2,8,48
30,Success,41,37,13,9,32
30,Success,49,40,0,11,38
30,Success,49,30,0,16,33
30,Success,52,38,0,8,44
30,Success,52,37,0,9,43
30,Success,52,38,1,9,43
30,Success,51,33,0,13,38
30,Success,47,37,0,14,33
30,Success,45,40,0,11,34
30,Success,53,29,3,15,38
30,Success,48,39,2,11,37
30,Fail,42,37,0,14,28
30,Fail,42,38,0,14,28
30,Success,47,40,0,11,36
30,Fail,37,43,7,13,24
30,Success,47,40,3,10,37
30,Success,48,33,0,11,37
30,Success,49,38,3,10,39
30,Success,52,33,0,7,45
30,Fail,45,34,3,18,27
30,Fail,40,38,0,16,24
30,Success,53,30,1,16,37
30,Success,53,34,0,10,43
30,Success,48,32,6,14,34
30,Success,51,28,0,11,40
30,Success,49,27,0,17,32
30,Success,46,33,0,12,34
30,Success,58,30,3,9,49
30,Success,49,35,0,12,37
30,Success,53,34,0,11,42
30,Success,47,32,7,14,33
30,Success,45,39,7,9,36
30,Fail,48,28,5,19,29
30,Success,43,36,0,13,30
30,Success,50,37,0,11,39
30,Success,48,36,2,14,34
30,Success,48,34,4,14,34
30,Success,57,30,2,11,46
30,Fail,39,40,0,14,25
30,Fail,43,35,0,16,27
30,Success,51,38,7,4,47
30,Fail,37,35,8,20,17
30,Success,48,35,0,16,32
30,Success,42,35,14,9,33
30,Success,43,35,0,9,34
30,Fail,42,42,0,16,26
30,Success,55,28,1,16,39
30,Fail,38,43,10,9,29
30,Success,46,41,4,9,37
30,Success,44,39,0,14,30
30,Fail,47,24,10,19,28
30,Success,51,33,0,9,42
30,Success,56,33,4,7,49
30,Success,51,38,1,10,41
30,Success,49,42,0,9,40
30,Success,48,40,0,8,40
30,Fail,43,39,0,14,29
30,Success,45,47,0,8,37
30,Success,52,34,1,13,39
30,Success,44,40,0,14,30
30,Success,50,39,0,8,42
30,Success,48,33,6,13,35
30,Success,45,40,0,13,32
30,Success,51,33,0,16,35
30,Success,52,39,0,8,44
30,Success,48,31,5,16,32
30,Success,41,50,0,8,33
30,Success,51,26,4,19,32
30,Fail,43,41,0,15,28
30,Success,52,27,2,19,33
30,Success,59,34,0,7,52
30,Success,50,33,0,10,40
30,Success,44,44,0,9,35
30,Success,51,28,6,15,36
30,Success,43,39,0,11,32
30,Success,49,39,0,6,43
30,Fail,40,45,0,11,29
30,Success,45,38,2,15,30
30,Success,50,38,0,12,38
30,Success,47,38,0,15,32
30,Success,43,40,5,12,31
30,Success,49,36,8,7,42
30,Success,48,31,5,16,32
30,Success,48,34,0,18,30
30,Success,44,38,9,9,35
30,Success,46,38,2,14,32
30,Success,47,40,0,13,34
30,Success,51,32,0,14,37
30,Fail,42,29,0,19,23
30,Success,47,40,1,12,35
30,Success,45,30,0,15,30
30,Success,48,37,1,14,34
30,Success,51,33,0,11,40
30,Success,47,37,0,15,32
30,Success,50,39,0,9,41
30,Success,52,34,0,6,46
30,Success,48,34,0,18,30
30,Fail,42,36,0,15,27
30,Success,46,41,0,10,36
30,Success,49,38,0,12,37
30,Success,46,40,3,11,35
30,Success,64,27,1,8,56
30,Fail,40,34,6,20,20
30,Success,47,36,5,12,35
30,Success,49,34,0,14,35
30,Success,43,43,0,11,32
30,Success,55,35,0,10,45
30,Success,51,31,0,12,39
30,Success,48,35,0,14,34
30,Success,57,30,0,9,48
30,Success,53,32,0,12,41
30,Fail,44,39,0,17,27
30,Fail,37,38,0,15,22
30,Success,49,33,0,13,36
30,Success,43,39,0,12,31
30,Success,48,35,5,12,36
30,Success,45,37,5,13,32
30,Fail,45,36,3,16,29
30,Success,47,35,12,6,41
30,Fail,44,34,2,20,24
30,Success,53,27,6,14,39
30,Success,50,35,2,13,37
30,Success,51,37,0,11,40
30,Fail,43,35,7,15,28
30,Fail,45,37,0,16,29
30,Success,56,30,5,9,47
30,Success,49,37,0,8,41
30,Success,49,39,2,10,39
30,Success,50,34,0,13,37
30,Success,52,30,7,11,41
30,Success,48,37,3,12,36
30,Success,45,33,8,14,31
30,Success,43,33,0,12,31
30,Success,45,35,5,15,30
30,Fail,44,31,0,15,29
30,Success,51,32,0,8,43
30,Success,50,35,3,12,38
30,Success,59,30,0,10,49
30,Success,46,42,0,12,34
30,Success,52,37,4,7,45
30,Success,48,34,0,15,33
30,Fail,42,40,0,15,27
30,Success,50,35,0,13,37
30,Success,47,37,3,13,34
30,Success,47,35,0,9,38
30,Success,51,32,8,9,42
30,Fail,38,46,6,10,28
30,Success,48,37,1,14,34
30,Fail,43,38,2,17,26
30,Success,49,35,0,14,35
30,Success,48,28,0,13,35
30,Success,56,34,1,9,47
30,Success,47,33,0,15,32
30,Success,50,25,0,15,35
30,Success,51,29,7,13,38
30,Fail,46,35,1,18,28
30,Success,41,40,0,10,31
30,Success,43,44,1,12,31
30,Success,52,39,1,8,44
30,Success,50,36,0,13,37
30,Success,48,39,0,13,35
30,Success,52,30,0,10,42
30,Success,46,35,0,11,35
30,Success,53,28,0,17,36
30,Success,48,36,1,15,33
30,Fail,37,48,4,11,26
30,Success,48,39,1,12,36
30,Fail,41,38,0,14,27
30,Success,51,29,0,17,34
30,Success,49,34,0,12,37
30,Success,45,37,3,15,30
30,Success,49,35,0,15,34
30,Success,48,36,0,11,37
30,Success,47,35,7,11,36
30,Success,52,39,0,9,43
30,Success,48,34,0,12,36
30,Success,45,37,0,13,32
30,Fail,42,31,0,21,21
30,Success,48,41,3,8,40
30,Success,47,38,1,14,33
30,Fail,38,39,0,17,21
30,Fail,46,31,5,18,28
30,Success,49,38,0,13,36
30,Success,44,38,4,14,30
30,Success,52,33,2,13,39
30,Success,51,34,0,10,41
30,Success,48,36,0,10,38
30,Fail,42,37,0,18,24
30,Success,49,39,0,9,40
30,Success,46,43,3,8,38
30,Success,48,36,4,12,36
30,Success,43,37,0,12,31
30,Success,56,34,1,9,47
30,Success,54,32,0,11,43
30,Success,51,35,4,10,41
30,Success,45,32,10,13,32
30,Success,52,38,0,10,42
30,Success,51,30,0,16,35
30,Fail,42,40,0,18,24
30,Success,45,34,0,14,31
30,Success,57,29,3,11,46
30,Fail,42,36,0,20,22
30,Success,51,35,2,12,39
30,Fail,43,31,0,15,28
30,Success,52,36,1,11,41
30,Success,44,44,0,9,35
30,Success,53,36,0,5,48
30,Success,58,33,0,9,49
30,Success,51,38,0,9,42
30,Success,46,31,7,16,30
30,Success,48,25,10,17,31
30,Success,53,38,0,7,46
30,Fail,48,27,0,21,27
30,Fail,42,31,0,17,25
30,Success,53,33,0,13,40
30,Success,51,35,0,10,41
30,Success,47,38,2,13,34
30,Success,49,37,2,12,37
30,Success,46,42,0,9,37
30,Success,45,29,12,14,31
30,Success,45,32,9,14,31
30,Success,47,31,0,10,37
30,Success,49,37,6,8,41
30,Success,48,39,0,12,36
30,Success,52,30,2,16,36
30,Success,49,37,2,12,37
30,Success,53,31,2,14,39
30,Success,54,30,0,14,40
30,Success,61,27,0,10,51
30,Success,47,43,0,10,37
30,Success,46,30,0,14,32
30,Success,45,41,3,11,34
30,Fail,45,35,0,16,29
30,Success,49,34,3,14,35
30,Success,49,35,0,8,41
30,Success,52,31,0,15,37
30,Success,45,40,0,15,30
30,Success,44,36,0,13,31
30,Success,54,34,0,12,42
30,Success,44,41,1,14,30
30,Success,50,37,0,13,37
30,Fail,43,40,3,14,29
30,Fail,40,38,7,15,25
30,Fail,44,37,0,19,25
30,Success,49,37,2,12,37
30,Success,49,37,2,12,37
30,Success,51,39,0,10,41
30,Success,47,41,1,11,36
30,Success,60,28,4,8,52
30,Fail,45,35,4,16,29
30,Fail,43,39,0,14,29
30,Success,51,39,0,7,44
40,Fail,43,39,10,8,35
40,Fail,45,34,10,11,34
40,Success,50,35,0,9,41
40,Success,52,38,0,7,45
40,Fail,48,38,0,14,34
40,Fail,47,32,0,17,30
40,Success,52,36,0,12,40
40,Fail,50,37,1,12,38
40,Fail,44,31,7,18,26
40,Success,54,34,3,9,45
40,Fail,45,34,7,14,31
40,Fail,45,40,0,14,31
40,Fail,44,39,1,16,28
40,Success,51,37,3,9,42
40,Fail,48,35,0,16,32
40,Success,52,36,0,10,42
40,Fail,41,48,3,8,33
40,Fail,46,39,5,10,36
40,Fail,46,41,3,10,36
40,Fail,50,35,0,12,38
40,Success,54,31,0,12,42
40,Fail,39,39,0,21,18
40,Success,55,35,0,10,45
40,Fail,44,29,11,16,28
40,Fail,52,32,0,14,38
40,Success,50,34,7,9,41
40,Fail,40,40,0,19,21
40,Success,55,30,2,13,42
40,Fail,50,28,0,15,35
40,Fail,50,33,0,16,34
40,Fail,47,37,0,9,38
40,Success,55,34,0,10,45
40,Fail,49,37,0,13,36
40,Success,51,36,2,11,40
40,Fail,53,30,1,16,37
40,Fail,52,29,4,15,37
40,Fail,42,31,0,18,24
40,Fail,50,36,0,14,36
40,Success,54,36,0,9,45
40,Fail,48,41,0,11,37
40,Fail,48,39,0,13,35
40,Fail,50,30,0,14,36
40,Fail,45,40,0,11,34
40,Fail,44,42,2,12,32
40,Success,50,40,0,9,41
40,Success,52,31,0,10,42
40,Fail,49,34,7,10,39
40,Fail,42,43,2,13,29
40,Fail,47,35,0,12,35
40,Success,49,45,1,5,44
40,Fail,50,34,0,14,36
40,Fail,49,27,6,18,31
40,Fail,43,29,0,15,28
40,Fail,48,32,0,15,33
40,Fail,48,39,1,12,36
40,Fail,48,35,2,15,33
40,Fail,49,31,0,18,31
40,Fail,41,37,5,17,24
40,Fail,46,37,4,13,33
40,Fail,37,40,3,20,17
40,Fail,49,32,4,15,34
40,Success,51,37,0,10,41
40,Fail,44,36,6,14,30
40,Fail,47,36,1,16,31
40,Fail,46,37,9,8,38
40,Success,50,37,4,9,41
40,Fail,46,36,3,15,31
40,Success,54,31,1,14,40
40,Fail,44,39,2,15,29
40,Fail,44,42,0,11,33
40,Success,54,31,3,12,42
40,Fail,47,32,0,21,26
40,Fail,46,35,8,11,35
40,Fail,49,37,0,12,37
40,Fail,55,26,1,18,37
40,Fail,51,36,0,12,39
40,Fail,50,37,0,13,37
40,Fail,45,30,0,16,29
40,Fail,39,46,0,14,25
40,Success,60,35,0,5,55
40,Fail,50,28,1,21,29
40,Fail,41,43,3,13,28
40,Fail,44,37,0,16,28
40,Success,55,29,0,13,42
40,Success,50,35,5,10,40
40,Fail,38,42,14,6,32
40,Fail,41,36,0,16,25
40,Fail,53,32,0,14,39
40,Fail,49,38,0,13,36
40,Fail,50,33,6,11,39
40,Fail,52,33,0,14,38
40,Fail,50,34,0,16,34
40,Fail,44,28,7,21,23
40,Success,51,37,0,10,41
40,Fail,49,35,0,16,33
40,Success,53,32,2,13,40
40,Success,60,25,6,9,51
40,Fail,48,37,3,12,36
40,Fail,43,33,8,16,27
40,Success,63,28,0,8,55
40,Fail,54,28,0,15,39
40,Success,54,27,0,13,41
40,Success,52,37,0,11,41
40,Success,54,30,4,12,42
40,Success,58,33,2,7,51
40,Success,55,30,0,14,41
40,Fail,49,37,0,12,37
40,Fail,50,31,2,17,33
40,Fail,51,33,0,12,39
40,Fail,48,33,2,17,31
40,Fail,40,35,0,15,25
40,Fail,45,41,0,10,35
40,Fail,50,32,3,15,35
40,Success,54,36,0,8,46
40,Fail,47,39,0,9,38
40,Fail,47,28,7,18,29
40,Fail,46,37,3,14,32
40,Fail,46,38,0,15,31
40,Fail,46,39,0,13,33
40,Fail,46,41,1,12,34
40,Fail,47,40,0,12,35
40,Fail,44,39,8,9,35
40,Fail,46,39,0,12,34
40,Success,51,39,0,10,41
40,Fail,36,35,12,17,19
40,Success,62,30,4,4,58
40,Success,51,39,1,9,42
40,Fail,45,42,3,10,35
40,Fail,49,39,2,10,39
40,Success,54,33,0,12,42
40,Success,56,34,2,8,48
40,Success,48,40,7,5,43
40,Fail,43,37,0,15,28
40,Fail,45,37,1,17,28
40,Fail,42,39,0,15,27
40,Fail,45,30,0,16,29
40,Success,53,39,2,6,47
40,Success,52,35,2,11,41
40,Fail,42,40,9,9,33
40,Fail,44,40,0,12,32
40,Fail,48,36,0,13,35
40,Fail,44,31,7,18,26
40,Fail,45,33,0,14,31
40,Success,51,35,0,8,43
40,Fail,39,42,0,11,28
40,Fail,38,43,3,16,22
40,Fail,47,37,4,12,35
40,Success,59,28,1,12,47
40,Fail,44,35,10,11,33
40,Fail,46,36,0,14,32
40,Fail,38,45,0,10,28
40,Fail,49,37,0,13,36
40,Fail,47,35,0,17,30
40,Fail,47,36,5,12,35
40,Success,50,41,0,9,41
40,Success,53,30,0,13,40
40,Success,49,41,0,6,43
40,Fail,44,40,0,9,35
40,Fail,45,35,0,11,34
40,Fail,49,34,0,16,33
40,Fail,43,38,0,12,31
40,Fail,48,33,0,18,30
40,Success,47,42,0,6,41
40,Fail,45,36,4,15,30
40,Fail,49,35,0,16,33
40,Fail,52,30,3,15,37
40,Success,50,39,1,10,40
40,Fail,41,40,0,14,27
40,Fail,44,35,6,15,29
40,Fail,48,31,3,18,30
40,Success,52,32,4,12,40
40,Fail,47,33,12,8,39
40,Fail,52,33,2,13,39
40,Success,53,35,0,12,41
40,Fail,42,40,3,15,27
40,Success,58,24,7,11,47
40,Fail,47,37,0,11,36
40,Fail,48,34,7,11,37
40,Fail,48,34,7,11,37
40,Fail,45,45,1,9,36
40,Fail,44,32,0,18,26
40,Success,50,37,0,8,42
40,Fail,46,37,4,13,33
40,Fail,45,37,0,15,30
40,Fail,42,40,4,14,28
40,Fail,42,40,3,15,27
40,Success,55,36,0,5,50
40,Fail,46,33,5,16,30
40,Fail,47,35,0,15,32
40,Fail,50,36,0,14,36
40,Fail,48,34,6,12,36
40,Fail,49,30,4,17,32
40,Success,58,28,6,8,50
40,Fail,40,40,9,11,29
40,Success,59,26,4,11,48
40,Fail,46,38,0,12,34
40,Fail,43,44,1,12,31
40,Success,49,39,0,7,42
40,Fail,41,37,11,11,30
40,Fail,49,36,0,13,36
40,Success,48,33,0,7,41
40,Fail,39,40,1,20,19
40,Success,50,34,0,9,41
40,Fail,44,39,5,12,32
40,Success,60,34,2,4,56
40,Success,53,31,4,12,41
40,Fail,42,37,0,16,26
40,Fail,49,33,2,16,33
40,Fail,48,31,0,16,32
40,Fail,45,44,0,11,34
40,Fail,49,34,6,11,38
40,Fail,42,34,9,15,27
40,Fail,48,38,0,11,37
40,Fail,46,32,0,16,30
40,Success,50,37,3,10,40
40,Success,54,36,1,9,45
40,Fail,50,31,0,16,34
40,Fail,40,46,4,10,30
40,Fail,50,32,0,12,38
40,Fail,44,37,2,17,27
40,Fail,44,34,6,16,28
40,Success,50,37,3,10,40
40,Fail,45,34,0,10,35
40,Fail,50,37,2,11,39
40,Fail,42,34,0,15,27
40,Fail,52,25,0,13,39
40,Fail,46,38,5,11,35
40,Success,56,26,5,13,43
40,Fail,44,26,12,18,26
40,Fail,46,26,15,13,33
40,Success,51,28,0,11,40
40,Fail,48,29,0,17,31
40,Success,50,37,3,10,40
40,Success,51,37,4,8,43
40,Fail,51,35,0,14,37
40,Fail,51,34,2,13,38
40,Fail,49,38,0,12,37
40,Fail,49,38,1,12,37
40,Fail,51,31,5,13,38
40,Fail,44,34,11,11,33
40,Success,55,24,0,13,42
40,Fail,49,32,7,12,37
40,Fail,50,31,0,17,33
40,Fail,47,41,0,10,37
40,Fail,43,40,9,8,35
40,Fail,47,33,4,16,31
40,Fail,48,36,5,11,37
40,Fail,41,38,0,14,27
40,Success,55,35,0,9,46
40,Fail,35,36,0,24,11
40,Fail,48,30,6,16,32
40,Fail,54,28,0,18,36
40,Fail,49,36,0,11,38
40,Success,52,36,0,12,40
40,Success,54,30,3,13,41
40,Fail,45,39,0,13,32
40,Fail,48,36,1,15,33
40,Fail,48,35,0,17,31
40,Fail,49,38,0,13,36
40,Fail,47,35,5,13,34
40,Fail,51,31,0,15,36
40,Fail,52,33,0,15,37
40,Fail,48,37,0,15,33
40,Fail,50,33,1,16,34
40,Success,49,40,0,9,40
40,Fail,46,33,8,13,33
40,Fail,48,35,0,14,34
40,Fail,54,30,1,15,39
40,Fail,45,37,0,16,29
40,Success,53,38,1,8,45
40,Success,54,32,3,11,43
40,Fail,43,43,0,14,29
40,Success,57,26,4,13,44
40,Fail,50,33,0,14,36
40,Fail,41,40,4,15,26
40,Fail,45,43,2,10,35
40,Fail,37,43,0,13,24
40,Fail,43,40,6,11,32
40,Fail,45,41,0,9,36
40,Fail,45,35,0,17,28
40,Fail,41,33,0,17,24
40,Success,53,34,0,11,42
40,Success,51,36,0,10,41
40,Fail,48,33,2,17,31
40,Fail,46,38,5,11,35
40,Fail,50,37,0,12,38
40,Success,53,35,0,10,43
40,Fail,46,37,0,10,36
40,Fail,44,41,0,9,35
40,Fail,43,34,5,18,25
40,Fail,49,39,0,10,39
40,Fail,47,37,2,14,33
40,Fail,45,37,0,11,34
40,Fail,45,40,2,13,32
40,Success,50,32,0,9,41
40,Fail,46,36,7,11,35
40,Fail,50,33,5,12,38
40,Fail,41,37,7,15,26
40,Fail,51,33,0,12,39
40,Fail,47,33,0,14,33
40,Success,54,28,0,14,40
40,Fail,51,33,1,15,36
40,Fail,43,41,2,14,29
40,Fail,51,34,0,14,37
40,Fail,45,39,0,15,30
40,Fail,43,34,4,19,24
40,Success,52,32,0,11,41
40,Fail,45,36,4,15,30
40,Fail,47,39,4,10,37
40,Fail,45,27,0,15,30
40,Fail,44,38,8,10,34
40,Fail,47,38,0,15,32
40,Fail,44,34,0,17,27
40,Success,54,31,5,10,44
40,Fail,43,39,0,13,30
40,Fail,50,35,3,12,38
40,Fail,49,30,0,10,39
40,Fail,45,40,3,12,33
40,Success,53,30,0,9,44
40,Fail,48,31,0,21,27
40,Success,53,33,0,8,45
40,Fail,49,31,5,15,34
40,Fail,50,35,0,15,35
40,Fail,45,38,1,16,29
40,Fail,47,38,0,13,34
40,Success,46,47,0,6,40
40,Fail,47,40,1,12,35
40,Fail,48,40,1,11,37
40,Fail,44,41,2,13,31
40,Fail,48,35,0,13,35
40,Fail,50,32,0,17,33
40,Fail,48,35,8,9,39
40,Fail,50,30,0,12,38
40,Fail,47,39,0,14,33
40,Success,52,33,0,5,47
40,Success,52,39,0,5,47
40,Fail,49,35,0,14,35
40,Fail,49,31,0,16,33
40,Success,56,32,0,7,49
40,Fail,48,32,0,11,37
40,Success,53,31,5,11,42
40,Fail,51,24,8,17,34
40,Fail,44,35,6,15,29
40,Fail,48,32,3,17,31
40,Fail,42,37,0,17,25
40,Success,56,36,0,6,50
40,Fail,48,34,3,15,33
40,Fail,44,40,5,11,33
40,Fail,49,30,0,15,34
40,Fail,47,32,7,14,33
40,Success,50,37,0,6,44
40,Fail,51,34,0,14,37
40,Fail,37,45,0,18,19
40,Fail,47,38,3,12,35
40,Fail,45,42,1,12,33
40,Fail,44,40,0,11,33
40,Fail,47,30,2,21,26
40,Fail,48,27,6,19,29
40,Fail,46,34,0,17,29
40,Fail,43,37,0,17,26
40,Fail,47,37,0,14,33
40,Success,48,43,1,8,40
40,Fail,44,32,7,17,27
40,Fail,49,32,0,12,37
40,Success,51,33,0,9,42
40,Fail,48,41,1,10,38
40,Success,51,36,0,11,40
40,Fail,41,44,0,11,30
40,Fail,40,39,7,14,26
40,Fail,48,37,2,13,35
40,Success,50,39,4,7,43
40,Fail,49,32,0,12,37
40,Success,55,30,0,13,42
40,Fail,44,36,0,12,32
40,Fail,47,34,0,19,28
40,Fail,48,42,1,9,39
40,Fail,50,34,3,13,37
40,Fail,42,32,0,17,25
40,Fail,46,32,0,19,27
40,Success,61,29,3,7,54
40,Success,53,35,3,9,44
40,Fail,51,35,0,12,39
40,Fail,51,28,0,14,37
40,Fail,52,30,0,14,38
40,Fail,48,35,6,11,37
40,Fail,50,37,2,11,39
40,Fail,48,42,0,9,39
40,Success,49,36,0,9,40
40,Fail,50,35,1,14,36
40,Fail,43,31,10,16,27
40,Fail,49,35,2,14,35
40,Fail,44,37,0,13,31
40,Success,53,31,0,12,41
40,Fail,43,42,0,9,34
40,Fail,48,38,0,12,36
40,Success,49,39,5,7,42
40,Fail,41,40,5,14,27
40,Success,52,34,4,10,42
40,Fail,47,39,2,12,35
40,Fail,51,26,0,12,39
40,Fail,45,36,0,8,37
40,Success,55,39,1,5,50
40,Fail,47,34,7,12,35
40,Fail,45,39,8,8,37
40,Fail,48,34,0,17,31
40,Fail,51,32,0,14,37
40,Fail,43,39,0,13,30
40,Fail,42,37,3,18,24
40,Fail,42,43,4,11,31
40,Success,53,32,0,10,43
40,Fail,48,34,0,16,32
40,Success,49,42,0,9,40
40,Fail,46,38,0,12,34
40,Success,49,43,3,5,44
40,Fail,51,30,0,12,39
40,Fail,44,36,0,14,30
40,Fail,47,33,0,15,32
40,Success,60,31,0,9,51
40,Fail,43,39,0,9,34
40,Success,55,28,0,14,41
40,Fail,49,32,7,12,37
40,Fail,46,32,9,13,33
40,Fail,46,41,0,12,34
40,Fail,44,34,7,15,29
40,Success,53,27,0,13,40
40,Fail,50,31,0,17,33
40,Fail,42,32,8,18,24
40,Fail,47,36,4,13,34
40,Fail,45,36,7,12,33
40,Fail,49,32,3,16,33
40,Fail,36,34,0,12,24
40,Success,53,31,0,11,42
40,Fail,37,36,0,15,22
40,Success,49,43,0,7,42
40,Success,48,31,13,8,40
40,Success,53,33,1,13,40
40,Fail,51,35,0,12,39
40,Fail,49,33,0,16,33
40,Fail,40,34,0,15,25
40,Fail,47,41,3,9,38
40,Fail,46,36,4,14,32
40,Fail,40,36,0,12,28
40,Fail,44,39,0,15,29
40,Success,51,39,0,10,41
40,Fail,46,36,0,13,33
40,Fail,50,35,2,13,37
40,Fail,49,35,0,11,38
40,Fail,46,31,6,17,29
40,Fail,42,44,0,11,31
40,Fail,46,35,0,17,29
40,Fail,50,36,0,14,36
40,Fail,44,28,0,19,25
40,Fail,48,33,9,10,38
40,Fail,41,39,2,18,23
40,Fail,46,34,2,18,28
40,Fail,44,42,0,11,33
40,Success,53,37,0,10,43
40,Fail,48,39,1,12,36
40,Fail,50,35,0,14,36
40,Fail,47,33,0,10,37
40,Fail,46,35,7,12,34
40,Success,52,31,0,11,41
40,Fail,44,39,5,12,32
40,Fail,48,33,0,15,33
40,Fail,46,36,0,12,34
40,Fail,48,38,1,13,35
40,Fail,48,36,4,12,36
40,Success,52,33,0,11,41
40,Fail,47,39,0,12,35
40,Fail,49,31,0,17,32
40,Fail,46,38,0,12,34
40,Success,55,33,0,12,43
40,Success,60,29,2,9,51
40,Fail,51,32,0,12,39
40,Fail,40,40,5,15,25
40,Success,49,39,3,9,40
40,Fail,47,40,0,11,36
40,Fail,48,39,2,11,37
40,Success,52,36,2,10,42
40,Success,50,38,4,8,42
40,Success,48,42,0,7,41
40,Fail,52,34,0,14,38
40,Fail,48,34,0,13,35
40,Fail,50,35,2,13,37
40,Success,52,38,0,10,42
40,Success,51,36,2,11,40
40,Fail,41,42,0,14,27
40,Fail,47,36,4,13,34
40,Fail,41,45,0,12,29
40,Success,50,40,0,9,41
40,Fail,50,33,3,14,36
40,Fail,51,31,6,12,39
40,Fail,44,29,15,12,32
40,Fail,48,38,2,12,36
40,Fail,52,29,0,17,35
40,Fail,50,32,0,15,35
40,Success,51,31,0,11,40
40,Fail,41,35,3,21,20
40,Fail,48,36,0,15,33
40,Fail,43,42,0,15,28
40,Success,55,35,0,9,46
40,Fail,49,34,0,11,38
40,Fail,49,32,8,11,38
40,Fail,45,34,0,16,29
40,Fail,47,40,0,11,36
40,Fail,41,31,12,16,25
40,Fail,55,22,0,18,37
40,Fail,48,33,4,15,33
40,Fail,43,41,7,9,34
40,Fail,50,31,8,11,39
40,Fail,43,39,0,15,28
40,Fail,49,34,3,14,35
40,Fail,46,31,0,16,30
40,Fail,42,45,2,11,31
40,Success,55,34,0,11,44
40,Success,51,34,0,9,42
40,Fail,48,37,5,10,38
40,Fail,41,44,1,14,27
40,Fail,44,38,0,11,33
40,Success,54,36,0,9,45
40,Success,54,38,0,2,52
40,Fail,52,34,1,13,39
40,Fail,42,47,0,8,34
40,Success,57,35,2,6,51
40,Success,51,38,0,9,42
40,Fail,49,39,0,12,37
40,Fail,38,36,0,14,24
40,Fail,42,46,0,10,32
40,Success,57,30,0,8,49
40,Fail,45,35,0,14,31
40,Fail,50,32,0,15,35
40,Fail,48,32,0,16,32
40,Fail,42,38,8,12,30
40,Fail,49,34,0,13,36
40,Success,54,33,0,12,42
40,Fail,46,33,9,12,34
40,Fail,43,37,0,18,25
40,Fail,54,27,0,15,39
40,Fail,41,35,11,13,28
40,Fail,48,37,0,14,34
40,Fail,39,41,0,12,27
40,Success,50,37,0,10,40
40,Fail,41,40,0,14,27
40,Fail,50,29,0,14,36
40,Fail,43,43,0,13,30
40,Success,56,29,2,13,43
40,Fail,47,38,0,11,36
40,Fail,38,42,0,12,26
40,Fail,44,37,2,17,27
40,Success,51,37,1,11,40
40,Fail,48,37,0,15,33
40,Fail,47,40,3,10,37
40,Fail,48,38,1,13,35
40,Fail,46,42,2,10,36
40,Fail,51,30,0,15,36
40,Fail,51,30,4,15,36
40,Fail,50,33,5,12,38
40,Fail,52,32,3,13,39
40,Fail,52,28,0,19,33
40,Fail,41,34,5,20,21
40,Success,51,38,0,10,41
40,Fail,40,39,0,16,24
40,Fail,43,37,0,14,29
40,Fail,44,39,0,13,31
40,Success,50,38,0,8,42
40,Fail,48,41,2,9,39
40,Fail,51,30,3,16,35
40,Fail,42,42,2,14,28
40,Success,53,38,0,7,46
40,Fail,43,39,0,16,27
40,Fail,47,37,0,13,34
40,Fail,49,34,0,16,33
40,Success,51,35,0,10,41
40,Success,48,42,2,8,40
40,Fail,48,30,0,13,35
40,Fail,49,35,0,13,36
40,Fail,52,32,3,13,39
40,Fail,39,40,0,17,22
40,Fail,49,36,2,13,36
40,Fail,42,31,10,17,25
40,Fail,42,37,8,13,29
40,Fail,45,29,0,23,22
40,Fail,48,33,0,12,36
40,Success,59,28,0,11,48
40,Success,54,33,3,10,44
40,Fail,42,41,1,16,26
40,Success,49,40,0,8,41
40,Success,55,30,1,14,41
40,Fail,44,43,0,9,35
40,Success,57,34,5,4,53
40,Success,56,31,0,13,43
40,Fail,48,41,2,9,39
40,Fail,54,31,0,15,39
40,Fail,45,39,0,14,31
40,Fail,50,30,0,15,35
40,Fail,49,33,0,17,32
40,Fail,45,36,0,17,28
40,Success,54,34,3,9,45
40,Fail,42,41,3,14,28
40,Fail,48,34,0,18,30
40,Fail,49,35,0,12,37
40,Fail,49,32,2,17,32
40,Fail,49,37,2,12,37
40,Fail,47,37,1,15,32
40,Fail,44,40,4,12,32
40,Fail,45,41,0,11,34
40,Fail,45,41,5,9,36
40,Fail,39,48,0,7,32
40,Fail,49,30,0,13,36
40,Fail,49,37,0,14,35
40,Success,50,35,0,6,44
40,Fail,48,39,2,11,37
40,Fail,44,45,1,10,34
40,Fail,51,32,0,15,36
40,Success,51,40,0,6,45
40,Fail,49,26,12,13,36
40,Success,51,33,8,8,43
40,Success,55,30,4,11,44
40,Fail,44,40,2,14,30
40,Fail,47,36,0,13,34
40,Fail,40,42,0,14,26
40,Fail,55,27,1,17,38
40,Fail,47,32,9,12,35
40,Success,54,31,0,13,41
40,Fail,44,37,6,13,31
40,Success,55,30,9,6,49
40,Fail,45,42,0,12,33
40,Fail,49,32,0,13,36
40,Fail,45,36,7,12,33
40,Success,53,42,0,5,48
40,Success,50,39,0,10,40
40,Fail,46,38,0,16,30
40,Fail,40,40,6,14,26
40,Fail,45,33,0,13,32
40,Fail,48,30,0,13,35
40,Success,55,32,2,11,44
40,Fail,49,32,8,11,38
40,Success,60,33,0,7,53
40,Fail,47,35,2,16,31
40,Success,51,39,0,10,41
40,Fail,47,38,2,13,34
40,Fail,48,39,0,12,36
40,Success,49,41,0,8,41
40,Success,52,33,3,12,40
40,Fail,51,31,0,12,39
40,Fail,51,24,13,12,39
40,Fail,44,33,0,19,25
40,Fail,44,35,0,8,36
40,Fail,49,34,0,16,33
40,Fail,50,36,1,13,37
40,Fail,44,38,0,18,26
40,Fail,45,32,0,13,32
40,Fail,49,35,0,10,39
40,Success,53,39,2,6,47
40,Fail,53,31,2,14,39
40,Fail,47,33,0,19,28
40,Success,53,32,0,11,42
40,Success,53,39,0,8,45
40,Fail,45,43,0,9,36
40,Fail,43,38,0,10,33
40,Success,54,31,1,14,40
40,Fail,48,32,0,15,33
40,Fail,42,41,0,16,26
40,Fail,42,40,0,13,29
40,Fail,49,39,0,12,37
40,Fail,50,32,0,15,35
40,Fail,52,33,0,13,39
40,Fail,43,35,10,12,31
40,Fail,50,27,5,18,32
40,Success,48,40,4,8,40
40,Fail,40,41,2,17,23
40,Fail,44,39,4,13,31
40,Fail,49,38,0,12,37
40,Fail,51,36,0,13,38
40,Fail,52,33,0,15,37
40,Fail,48,31,9,12,36
40,Success,54,38,1,7,47
40,Success,49,34,0,9,40
40,Fail,49,37,2,12,37
40,Fail,40,38,9,13,27
40,Fail,48,31,0,14,34
40,Fail,48,39,1,12,36
40,Fail,44,34,9,13,31
40,Fail,46,28,0,14,32
40,Fail,52,33,2,13,39
40,Fail,41,39,0,12,29
40,Fail,49,34,6,11,38
40,Fail,43,34,6,17,26
40,Fail,47,33,6,14,33
40,Success,55,31,1,13,42
40,Success,56,34,0,10,46
40,Fail,45,38,2,15,30
40,Fail,44,42,3,11,33
40,Success,51,39,0,10,41
40,Success,52,40,1,7,45
40,Fail,52,31,0,17,35
40,Fail,49,32,0,15,34
40,Fail,40,43,0,14,26
40,Success,51,38,0,8,43
40,Fail,52,31,0,15,37
40,Fail,44,34,7,15,29
40,Fail,44,37,5,14,30
40,Fail,44,39,0,13,31
40,Success,53,39,2,6,47
40,Success,51,36,2,11,40
40,Success,53,32,0,11,42
40,Fail,46,45,0,7,39
40,Fail,45,35,4,16,29
40,Fail,44,44,2,10,34
40,Fail,47,44,1,8,39
40,Fail,41,47,1,11,30
40,Success,51,35,0,11,40
40,Success,53,34,1,12,41
40,Success,51,36,0,11,40
40,Fail,38,37,0,14,24
40,Fail,48,39,2,11,37
40,Success,51,41,0,6,45
40,Fail,42,37,7,14,28
40,Fail,40,43,0,13,27
40,Fail,50,32,6,12,38
40,Fail,46,35,8,11,35
40,Fail,48,37,0,12,36
40,Success,55,27,7,11,44
40,Fail,51,32,0,12,39
40,Fail,47,35,1,17,30
40,Success,52,39,2,7,45
40,Fail,46,36,0,12,34
40,Fail,42,43,1,14,28
40,Fail,45,41,0,11,34
40,Fail,45,31,0,20,25
40,Success,53,35,1,11,42
40,Success,49,40,0,9,40
40,Success,53,31,0,11,42
40,Fail,43,37,0,17,26
40,Fail,44,33,0,18,26
40,Success,53,29,5,13,40
40,Fail,46,35,0,18,28
40,Fail,48,38,0,11,37
40,Fail,39,33,14,14,25
40,Fail,39,48,0,12,27
40,Fail,47,34,0,12,35
40,Fail,39,37,0,16,23
40,Success,50,28,0,10,40
40,Fail,46,30,4,20,26
40,Fail,46,36,10,8,38
40,Fail,49,35,0,14,35
40,Fail,50,38,0,11,39
40,Fail,49,33,4,14,35
40,Fail,44,35,7,14,30
40,Fail,48,34,6,12,36
40,Fail,51,35,0,14,37
40,Success,50,39,0,8,42
40,Fail,43,38,13,6,37
40,Fail,49,32,6,13,36
40,Success,57,36,2,5,52
40,Fail,45,41,3,11,34
40,Success,49,40,0,8,41
40,Fail,46,37,5,12,34
40,Fail,46,26,0,13,33
40,Fail,45,42,7,6,39
40,Fail,44,38,0,15,29
40,Success,55,34,0,10,45
40,Fail,48,35,0,14,34
40,Fail,51,28,4,17,34
40,Fail,40,36,0,8,32
40,Fail,49,34,3,14,35
40,Fail,54,27,0,19,35
40,Fail,47,36,0,14,33
40,Fail,42,37,0,14,28
40,Fail,45,37,4,14,31
40,Fail,46,34,3,17,29
40,Success,54,35,0,10,44
40,Fail,44,48,0,7,37
40,Fail,42,38,5,15,27
40,Success,54,32,2,12,42
40,Success,51,37,2,10,41
40,Fail,41,41,0,17,24
40,Success,49,35,9,7,42
40,Success,51,34,4,11,40
40,Success,53,34,0,12,41
40,Fail,38,43,7,12,26
40,Fail,45,34,0,20,25
40,Fail,50,37,0,12,38
40,Fail,45,38,2,15,30
40,Fail,46,34,3,17,29
40,Success,48,39,0,7,41
40,Fail,42,40,8,10,32
40,Fail,47,31,7,15,32
40,Fail,48,34,0,13,35
40,Success,51,29,0,10,41
40,Fail,48,31,0,15,33
40,Success,57,37,0,4,53
40,Fail,50,32,0,11,39
40,Fail,50,25,9,16,34
40,Fail,43,45,0,11,32
40,Fail,50,36,1,13,37
40,Fail,51,34,3,12,39
40,Success,54,37,0,8,46
40,Fail,49,41,0,10,39
40,Fail,49,38,1,12,37
40,Success,54,32,7,7,47
40,Success,55,35,0,9,46
40,Success,49,41,0,9,40
40,Success,55,31,5,9,46
40,Fail,45,31,0,14,31
40,Fail,52,32,0,13,39
40,Fail,48,25,0,16,32
40,Success,50,40,0,10,40
40,Success,51,37,0,10,41
40,Fail,48,32,5,15,33
40,Success,51,38,0,11,40
40,Fail,46,39,4,11,35
40,Fail,40,37,8,15,25
40,Fail,46,40,0,12,34
40,Success,54,33,0,11,43
40,Success,48,34,0,7,41
40,Success,52,37,0,11,41
40,Success,55,32,3,10,45
40,Fail,36,33,12,19,17
40,Fail,47,35,0,17,30
40,Fail,43,38,0,15,28
40,Fail,39,46,0,13,26
40,Fail,48,27,5,20,28
40,Fail,48,38,0,12,36
40,Fail,48,37,3,12,36
40,Success,64,26,2,8,56
40,Fail,42,34,0,16,26
40,Fail,45,32,6,17,28
40,Fail,49,38,2,11,38
40,Fail,49,40,0,11,38
40,Fail,44,33,0,16,28
40,Success,57,33,0,9,48
40,Success,53,32,2,13,40
40,Success,52,36,1,11,41
40,Fail,42,36,7,15,27
40,Fail,45,40,6,9,36
40,Fail,50,30,0,14,36
40,Fail,51,28,0,16,35
40,Fail,44,38,0,11,33
40,Fail,49,38,0,13,36
40,Fail,50,33,0,12,38
40,Fail,48,32,0,10,38
40,Fail,49,32,6,13,36
40,Fail,36,44,9,11,25
40,Fail,42,31,8,19,23
40,Fail,51,32,0,12,39
40,Fail,44,37,0,12,32
40,Fail,40,36,4,20,20
40,Fail,45,31,5,19,26
40,Fail,46,36,0,14,32
40,Fail,41,36,0,14,27
40,Fail,52,32,0,13,39
40,Fail,50,30,0,16,34
40,Success,52,40,0,8,44
40,Success,53,35,0,11,42
40,Fail,46,37,5,12,34
40,Fail,47,31,0,15,32
40,Fail,52,35,0,13,39
40,Fail,46,39,2,13,33
40,Fail,46,39,5,10,36
40,Fail,47,35,4,14,33
40,Fail,40,35,8,17,23
40,Success,51,39,0,9,42
40,Fail,49,30,0,12,37
40,Fail,45,36,0,12,33
40,Success,54,30,4,12,42
40,Fail,47,41,4,8,39
40,Success,52,37,0,8,44
40,Fail,48,36,0,13,35
40,Fail,47,40,1,12,35
40,Fail,48,35,3,14,34
40,Success,52,34,0,10,42
40,Success,54,31,0,13,41
40,Fail,44,36,0,16,28
40,Fail,40,43,0,11,29
40,Success,51,37,1,11,40
40,Fail,47,39,0,12,35
40,Fail,40,37,0,15,25
40,Fail,45,33,6,16,29
40,Fail,46,40,0,13,33
40,Fail,49,36,0,10,39
40,Fail,51,32,0,14,37
40,Fail,47,35,3,15,32
40,Fail,47,40,0,10,37
40,Fail,49,30,0,17,32
40,Fail,50,39,0,11,39
40,Fail,44,40,3,13,31
40,Fail,47,37,0,14,33
40,Success,57,30,0,12,45
40,Fail,47,43,1,9,38
40,Success,52,35,1,12,40
40,Fail,40,45,4,11,29
40,Fail,43,39,4,14,29
40,Fail,48,35,0,13,35
40,Fail,45,34,0,16,29
40,Fail,41,29,0,16,25
40,Success,58,31,0,10,48
40,Fail,50,38,1,11,39
40,Success,54,38,0,7,47
40,Fail,48,37,0,15,33
40,Fail,49,39,0,11,38
40,Fail,46,41,0,10,36
40,Fail,48,38,0,13,35
40,Fail,49,33,0,17,32
40,Fail,46,34,10,10,36
40,Fail,47,33,4,16,31
40,Success,50,38,2,10,40
40,Fail,44,31,0,24,20
40,Fail,48,33,0,12,36
40,Fail,52,31,2,15,37
40,Success,55,35,0,10,45
40,Fail,45,39,1,15,30
40,Fail,37,38,7,18,19
40,Fail,49,33,6,12,37
40,Fail,44,33,0,19,25
40,Fail,43,42,6,9,34
40,Fail,47,34,0,16,31
40,Fail,47,40,0,9,38
40,Fail,44,36,6,14,30
40,Success,58,30,0,12,46
40,Fail,47,34,0,14,33
40,Success,56,38,0,5,51
40,Fail,46,32,0,17,29
40,Fail,43,33,0,18,25
40,Success,54,36,0,8,46
40,Fail,46,31,11,12,34
40,Success,53,36,0,8,45
40,Fail,45,36,0,12,33
40,Fail,46,36,4,14,32
40,Fail,46,39,5,10,36
40,Fail,45,27,8,20,25
40,Fail,48,34,4,14,34
40,Fail,42,35,9,14,28
40,Fail,47,42,1,10,37
40,Fail,45,37,5,13,32
40,Fail,48,39,4,9,39
40,Fail,38,34,14,14,24
40,Success,53,33,0,11,42
40,Success,54,36,2,8,46
40,Success,51,33,10,6,45
40,Fail,51,34,0,15,36
40,Fail,41,43,2,14,27
40,Success,55,39,0,6,49
40,Success,52,37,3,8,44
40,Fail,44,35,5,16,28
40,Success,55,37,0,7,48
40,Fail,47,38,0,13,34
40,Fail,48,33,4,15,33
40,Success,55,32,0,13,42
40,Fail,47,44,0,8,39
40,Fail,41,38,0,14,27
40,Fail,41,37,0,12,29
40,Fail,51,34,1,14,37
40,Success,53,26,8,13,40
40,Fail,51,28,0,19,32
40,Fail,51,30,5,14,37
40,Success,51,34,0,9,42
40,Success,51,30,0,10,41
40,Fail,46,39,0,14,32
40,Fail,46,35,8,11,35
40,Success,55,29,4,12,43
40,Fail,45,42,0,10,35
40,Fail,51,31,3,15,36
40,Fail,47,35,5,13,34
40,Fail,47,30,8,15,32
40,Fail,51,31,0,17,34
40,Fail,52,29,0,13,39
40,Fail,44,42,0,14,30
40,Fail,53,29,4,14,39
40,Fail,43,45,2,10,33
40,Fail,47,41,4,8,39
40,Fail,42,36,2,20,22
40,Fail,51,32,0,12,39
40,Fail,43,39,0,16,27
40,Fail,47,31,0,18,29
40,Fail,46,39,2,13,33
40,Success,55,34,0,10,45
40,Fail,49,35,0,15,34
40,Fail,49,38,1,12,37
40,Success,51,36,3,10,41
40,Fail,47,38,0,12,35
40,Fail,49,32,0,10,39
40,Fail,42,46,5,7,35
40,Fail,40,34,6,20,20
40,Fail,40,33,0,18,22
40,Fail,35,39,7,19,16
40,Success,53,36,3,8,45
40,Fail,49,30,0,13,36
40,Fail,50,36,0,14,36
40,Fail,51,35,1,13,38
40,Fail,51,30,3,16,35
40,Success,50,34,8,8,42
40,Success,53,37,1,9,44
40,Fail,48,30,9,13,35
40,Fail,47,36,6,11,36
40,Fail,53,24,7,16,37
40,Success,52,35,2,11,41
40,Fail,44,37,0,12,32
40,Fail,45,41,0,11,34
40,Fail,39,43,0,17,22
40,Fail,49,39,0,12,37
40,Fail,54,30,1,15,39
40,Fail,50,34,0,11,39
40,Fail,46,38,8,8,38
40,Fail,49,35,0,14,35
40,Fail,47,39,0,14,33
40,Fail,47,42,2,9,38
40,Fail,43,36,0,14,29
40,Fail,48,28,0,19,29
40,Fail,51,35,0,13,38
40,Fail,52,29,2,17,35
40,Success,51,36,4,9,42
40,Fail,49,35,4,12,37
40,Fail,46,39,1,14,32
40,Fail,43,43,0,6,37
40,Fail,53,28,0,14,39
40,Fail,45,36,0,17,28
40,Fail,47,39,4,10,37
40,Fail,46,44,2,8,38
40,Fail,44,40,0,12,32
40,Success,51,36,4,9,42
40,Success,56,35,3,6,50
40,Fail,49,31,7,13,36
40,Success,51,38,1,10,41
40,Fail,52,33,2,13,39
40,Fail,46,39,0,14,32
40,Fail,48,36,5,11,37
40,Success,61,32,2,5,56
40,Fail,49,36,2,13,36
40,Success,52,30,7,11,41
40,Fail,46,39,0,7,39
40,Fail,48,37,3,12,36
40,Fail,50,32,1,17,33
40,Fail,48,37,5,10,38
40,Fail,41,37,0,14,27
40,Fail,47,33,7,13,34
40,Fail,41,35,7,17,24
40,Fail,42,45,2,11,31
40,Success,60,23,8,9,51
40,Fail,44,34,0,16,28
40,Fail,49,30,3,18,31
40,Fail,48,31,0,17,31
40,Fail,37,42,0,20,17
40,Fail,48,37,4,11,37
40,Fail,51,35,2,12,39
40,Success,64,21,4,11,53
40,Fail,46,33,0,12,34
40,Success,52,34,3,11,41
40,Success,51,37,0,10,41
40,Fail,46,36,6,12,34
40,Fail,47,42,0,10,37
40,Fail,48,42,1,9,39
40,Fail,41,38,4,17,24
40,Fail,43,39,0,15,28
40,Fail,47,39,1,13,34
40,Success,49,44,1,6,43
40,Success,50,37,0,10,40
40,Fail,43,39,9,9,34
40,Fail,44,32,0,17,27
40,Fail,45,36,8,11,34
40,Success,52,36,4,8,44
40,Fail,49,37,2,12,37
40,Fail,46,38,4,12,34
40,Fail,44,41,0,12,32
40,Fail,46,39,3,12,34
40,Success,52,34,2,12,40
40,Fail,47,37,2,14,33
40,Fail,50,31,0,14,36
40,Fail,45,42,0,11,34
40,Fail,50,35,0,14,36
40,Fail,43,36,7,14,29
40,Success,52,38,2,8,44
40,Success,57,30,0,11,46
40,Fail,51,30,2,17,34
40,Fail,49,32,6,13,36
40,Fail,52,29,0,16,36
40,Fail,46,39,5,10,36
40,Success,51,33,6,10,41
40,Fail,45,40,0,13,32
40,Fail,45,34,0,12,33
40,Fail,46,31,0,13,33
40,Success,50,39,0,9,41
40,Success,58,34,0,7,51
40,Fail,48,33,6,13,35
40,Fail,49,30,0,15,34
40,Fail,50,36,1,13,37
40,Fail,46,43,2,9,37
40,Fail,38,26,16,20,18
40,Fail,47,34,0,19,28
40,Fail,46,40,1,13,33
40,Fail,44,33,6,17,27
40,Fail,46,44,2,8,38
40,Fail,44,36,0,16,28
40,Success,53,34,3,10,43
40,Success,51,38,0,9,42
40,Fail,48,28,0,13,35
40,Fail,50,33,3,14,36
40,Fail,45,37,0,17,28
40,Fail,48,38,3,11,37
40,Success,53,34,2,11,42
40,Fail,47,36,0,12,35
40,Fail,48,35,0,16,32
40,Fail,48,38,0,12,36
40,Fail,44,38,4,14,30
40,Success,54,32,0,14,40
40,Success,53,36,0,11,42
40,Fail,51,34,3,12,39
40,Fail,47,39,0,14,33
40,Success,59,25,0,9,50
40,Fail,49,37,1,13,36
40,Fail,46,36,0,11,35
40,Fail,40,35,0,15,25
40,Fail,47,39,3,11,36
40,Fail,48,32,5,15,33
40,Fail,52,29,6,13,39
40,Fail,42,43,7,8,34
40,Success,55,35,3,7,48
40,Fail,43,34,0,17,26
40,Fail,48,31,0,16,32
40,Fail,41,34,6,19,22
40,Fail,38,46,0,14,24
40,Success,53,33,1,13,40
40,Fail,50,34,4,12,38
40,Fail,46,36,0,14,32
40,Fail,46,39,1,14,32
40,Fail,47,33,7,13,34
40,Fail,46,41,2,11,35
40,Fail,49,36,0,12,37
40,Fail,49,33,2,16,33
40,Fail,43,41,3,13,30
40,Fail,49,36,0,13,36
40,Fail,41,35,4,20,21
40,Fail,47,31,10,12,35
40,Success,55,32,3,10,45
40,Success,52,31,0,9,43
40,Fail,51,30,0,13,38
40,Fail,43,31,11,15,28
40,Fail,44,41,0,15,29
40,Fail,43,43,1,13,30
40,Fail,44,33,0,16,28
40,Fail,47,37,0,16,31
40,Fail,41,32,8,19,22
40,Success,53,32,0,11,42
40,Success,56,25,0,9,47
40,Fail,48,37,1,14,34
40,Fail,52,30,5,13,39
40,Fail,49,31,1,19,30
40,Fail,45,32,7,16,29
40,Fail,49,34,0,16,33
40,Fail,38,34,13,15,23
40,Fail,48,33,2,17,31
40,Fail,43,39,0,18,25
40,Fail,39,45,3,13,26
40,Fail,45,28,9,18,27
40,Fail,49,29,4,18,31
40,Fail,46,42,0,11,35
40,Fail,49,35,3,13,36
40,Fail,45,42,0,13,32
40,Fail,40,40,0,14,26
40,Fail,47,36,7,10,37
40,Fail,48,33,2,17,31
40,Success,53,34,4,9,44
40,Fail,45,36,0,11,34
40,Success,50,34,0,9,41
40,Fail,44,37,0,18,26
40,Success,55,35,1,9,46
40,Success,50,40,1,9,41
40,Success,53,33,0,13,40
40,Fail,47,36,6,11,36
40,Success,54,30,3,13,41
40,Fail,54,28,3,15,39
40,Success,55,34,2,9,46
40,Fail,49,38,0,12,37
40,Fail,47,40,4,9,38
40,Fail,47,37,0,14,33
40,Success,52,36,0,11,41
40,Fail,40,46,0,12,28
40,Fail,48,32,0,18,30
40,Success,50,40,0,10,40
40,Success,50,31,0,7,43
40,Fail,50,30,0,20,30
40,Fail,42,38,6,14,28
40,Fail,42,34,10,14,28
40,Fail,46,40,0,13,33
40,Fail,47,34,0,19,28
40,Fail,49,37,0,14,35
40,Success,54,34,0,10,44
40,Fail,49,31,3,17,32
40,Fail,46,33,0,14,32
40,Fail,40,45,1,14,26
40,Fail,45,37,1,17,28
40,Success,56,23,0,11,45
40,Success,48,41,5,6,42
40,Fail,43,38,6,13,30
40,Fail,47,31,9,13,34
40,Fail,52,32,0,15,37
40,Fail,49,39,2,10,39
40,Fail,54,26,0,16,38
40,Success,56,28,4,12,44
40,Success,49,36,6,9,40
40,Fail,45,40,0,11,34
40,Success,52,37,1,10,42
40,Fail,49,40,1,10,39
40,Fail,45,30,0,19,26
40,Fail,47,38,4,11,36
40,Fail,47,35,0,10,37
40,Fail,44,42,2,12,32
40,Success,52,29,10,9,43
40,Fail,51,29,3,17,34
40,Fail,36,44,0,14,22
40,Fail,40,35,0,15,25
40,Success,51,35,0,9,42
40,Fail,49,32,6,13,36
40,Fail,44,42,3,11,33
40,Fail,43,40,0,16,27
40,Success,53,39,0,7,46
40,Fail,45,36,0,15,30
40,Fail,47,42,0,10,37
40,Fail,52,34,0,14,38
40,Fail,49,29,5,17,32
40,Fail,44,42,0,11,33
40,Success,56,26,8,10,46
40,Success,62,29,0,7,55
40,Fail,45,40,0,13,32
40,Fail,46,36,5,13,33
40,Fail,46,21,0,19,27
40,Success,50,36,5,9,41
40,Fail,44,43,2,11,33
40,Success,52,35,0,8,44
40,Fail,49,29,9,13,36
40,Fail,51,31,4,14,37
40,Fail,46,35,0,15,31
40,Fail,42,47,0,8,34
40,Fail,41,37,2,20,21
40,Fail,50,33,0,16,34
40,Fail,43,40,4,13,30
40,Success,53,33,4,10,43
40,Fail,42,36,0,16,26
40,Fail,49,36,0,11,38
40,Fail,47,33,0,17,30
40,Fail,49,39,2,10,39
40,Success,57,28,7,8,49
40,Fail,44,32,11,13,31
40,Success,52,33,3,12,40
40,Fail,41,40,0,10,31
40,Success,56,35,1,8,48
40,Fail,47,40,3,10,37
40,Fail,48,42,0,9,39
40,Fail,42,37,5,16,26
40,Fail,41,45,0,11,30
40,Fail,50,37,0,11,39
40,Fail,40,44,0,15,25
40,Fail,47,38,1,14,33
40,Fail,46,31,7,16,30
40,Fail,50,35,2,13,37
40,Success,51,36,3,10,41
40,Success,59,24,4,13,46
40,Fail,50,35,1,14,36
40,Success,54,29,0,11,43
40,Fail,48,28,0,16,32
40,Fail,46,40,1,13,33
40,Fail,46,34,0,17,29
40,Fail,41,39,6,14,27
40,Fail,43,39,2,16,27
40,Fail,49,39,2,10,39
40,Success,56,32,0,11,45
40,Success,51,40,0,7,44
40,Fail,46,33,0,17,29
40,Fail,47,41,0,9,38
40,Fail,43,43,3,11,32
40,Success,54,30,2,14,40
40,Fail,47,37,0,13,34
40,Fail,46,37,4,13,33
40,Fail,40,36,12,12,28
40,Success,51,31,7,11,40
40,Success,57,30,2,11,46
40,Fail,43,36,9,12,31
40,Fail,48,33,5,14,34
40,Fail,46,35,5,14,32
40,Fail,48,29,6,17,31
40,Success,54,30,5,11,43
40,Fail,47,30,9,14,33
40,Success,58,32,0,10,48
40,Fail,49,35,0,13,36
40,Success,53,33,2,12,41
40,Fail,48,36,0,11,37
40,Fail,40,36,0,15,25
40,Success,51,41,0,8,43
40,Success,50,40,0,6,44
40,Fail,50,31,8,11,39
40,Success,52,35,0,10,42
40,Fail,50,26,0,11,39
40,Success,56,33,0,10,46
40,Fail,48,32,0,14,34
40,Fail,45,36,0,14,31
40,Fail,48,41,2,9,39
40,Fail,50,33,0,17,33
40,Fail,40,38,0,15,25
40,Fail,48,34,0,9,39
40,Fail,49,22,12,17,32
40,Fail,50,31,0,16,34
40,Success,54,32,0,13,41
40,Fail,45,40,1,14,31
40,Fail,42,48,5,5,37
40,Fail,44,41,3,12,32
40,Success,49,38,6,7,42
40,Success,52,34,5,9,43
40,Success,54,36,2,8,46
40,Success,58,31,0,8,50
40,Success,52,38,0,10,42
40,Fail,48,34,8,10,38
40,Fail,46,43,1,10,36
40,Success,61,32,0,6,55
40,Fail,48,33,0,16,32
40,Success,50,41,0,8,42
40,Fail,51,35,2,12,39
40,Success,55,29,0,14,41
40,Fail,52,34,1,13,39
40,Fail,48,41,2,9,39
40,Fail,51,28,0,17,34
40,Fail,44,33,8,15,29
40,Fail,46,36,0,10,36
40,Success,57,33,2,8,49
40,Fail,50,32,6,12,38
40,Fail,49,36,0,11,38
40,Fail,46,37,3,14,32
40,Fail,45,38,1,16,29
40,Fail,44,39,0,12,32
40,Success,50,40,2,8,42
40,Fail,44,42,0,7,37
40,Success,54,34,0,11,43
40,Fail,47,26,5,22,25
40,Success,56,26,0,10,46
40,Fail,49,35,1,15,34
40,Success,56,30,4,10,46
40,Fail,50,33,0,16,34
40,Fail,51,36,0,12,39
40,Success,56,32,0,11,45
40,Fail,47,35,1,17,30
40,Fail,42,32,11,15,27
40,Success,48,42,0,8,40
40,Success,56,32,0,12,44
40,Fail,49,37,0,10,39
40,Fail,48,32,6,14,34
40,Success,58,31,5,6,52
40,Fail,52,33,0,13,39
40,Fail,44,37,0,16,28
40,Fail,48,34,1,17,31
40,Fail,48,31,5,16,32
40,Fail,40,44,0,9,31
40,Fail,49,34,3,14,35
40,Fail,48,34,0,14,34
40,Fail,41,41,1,17,24
40,Success,49,32,0,9,40
40,Fail,43,36,0,15,28
40,Success,55,35,1,9,46
40,Fail,34,48,0,11,23
40,Fail,46,35,3,16,30
40,Fail,48,21,0,19,29
40,Fail,46,33,0,17,29
40,Success,56,30,0,8,48
40,Success,55,28,2,15,40
40,Success,53,37,0,10,43
40,Fail,46,36,0,14,32
40,Fail,41,45,0,12,29
40,Fail,49,41,0,10,39
40,Fail,50,34,1,15,35
40,Success,49,41,0,9,40
40,Fail,45,41,4,10,35
40,Fail,43,36,0,17,26
40,Success,55,34,0,7,48
40,Success,51,33,5,11,40
40,Fail,43,39,0,11,32
40,Success,56,32,0,10,46
40,Fail,53,30,0,14,39
40,Success,55,32,2,11,44
40,Fail,51,35,2,12,39
40,Fail,42,39,0,16,26
40,Fail,53,29,1,17,36
40,Success,53,31,5,11,42
40,Fail,51,33,1,15,36
40,Fail,43,47,2,8,35
40,Fail,46,33,6,15,31
40,Fail,40,39,3,18,22
40,Fail,48,41,0,9,39
40,Fail,50,35,3,12,38
40,Fail,38,40,7,15,23
40,Fail,40,40,0,14,26
40,Fail,48,30,0,10,38
40,Fail,51,35,0,13,38
40,Fail,50,34,0,12,38
40,Fail,46,42,1,11,35
40,Fail,47,30,0,16,31
40,Fail,44,40,0,15,29
40,Fail,44,32,0,20,24
40,Success,51,36,0,11,40
40,Fail,47,33,0,18,29
40,Fail,46,38,0,15,31
40,Fail,46,34,0,14,32
40,Fail,45,32,7,16,29
40,Fail,45,36,0,17,28
40,Success,55,36,1,8,47
40,Success,54,30,6,10,44
40,Fail,46,38,4,12,34
40,Fail,50,30,9,11,39
40,Success,60,28,3,9,51
40,Fail,47,35,0,16,31
40,Fail,44,40,0,13,31
40,Fail,48,40,2,10,38
40,Fail,46,33,0,18,28
40,Fail,42,38,4,16,26
40,Fail,53,31,2,14,39
40,Fail,40,38,0,17,23
40,Fail,42,29,9,20,22
40,Fail,44,37,0,16,28
40,Fail,48,30,5,17,31
40,Fail,43,38,9,10,33
40,Fail,45,37,0,11,34
40,Success,56,32,2,10,46
40,Success,55,39,0,5,50
40,Success,53,39,3,5,48
40,Fail,46,39,5,10,36
40,Success,53,35,0,12,41
40,Success,50,34,0,7,43
40,Success,53,33,0,13,40
40,Fail,37,47,5,11,26
40,Fail,50,31,3,16,34
40,Success,56,36,0,8,48
40,Fail,48,39,3,10,38
40,Fail,51,27,10,12,39
40,Fail,49,32,0,19,30
40,Fail,44,31,7,18,26
40,Fail,49,39,1,11,38
40,Success,51,39,0,10,41
40,Success,52,37,0,9,43
40,Fail,44,41,3,12,32
40,Fail,48,39,1,12,36
40,Success,58,28,3,11,47
40,Fail,48,31,9,12,36
40,Fail,46,33,3,18,28
40,Fail,48,33,0,17,31
40,Success,53,35,0,11,42
40,Fail,49,33,4,14,35
40,Success,57,34,2,7,50
40,Fail,46,38,0,12,34
40,Fail,39,41,8,12,27
40,Fail,50,32,0,15,35
40,Fail,46,35,8,11,35
40,Fail,50,33,0,12,38
40,Fail,43,35,5,17,26
40,Fail,45,39,2,14,31
40,Fail,50,37,0,11,39
40,Success,53,35,1,11,42
40,Fail,43,42,6,9,34
40,Fail,45,41,0,11,34
40,Fail,50,30,4,16,34
40,Fail,48,42,0,9,39
40,Fail,50,37,0,11,39
40,Fail,42,35,0,20,22
40,Success,50,31,0,9,41
40,Fail,46,41,0,12,34
40,Fail,46,40,0,12,34
40,Success,51,38,0,11,40
40,Fail,40,47,0,13,27
40,Fail,46,40,0,13,33
40,Fail,46,38,0,9,37
40,Success,50,39,0,9,41
40,Fail,51,32,0,15,36
40,Fail,37,43,11,9,28
40,Fail,42,36,0,15,27
40,Fail,52,32,2,14,38
40,Fail,46,41,3,10,36
40,Success,51,37,0,11,40
40,Success,59,27,0,12,47
40,Fail,46,43,0,9,37
40,Fail,41,38,5,16,25
40,Fail,41,41,5,13,28
40,Success,51,33,8,8,43
40,Fail,44,37,4,15,29
40,Fail,43,37,5,15,28
40,Fail,44,40,0,13,31
40,Fail,39,44,0,11,28
40,Fail,41,40,0,17,24
40,Success,48,41,3,8,40
40,Fail,45,36,0,14,31
40,Fail,34,38,0,22,12
40,Fail,43,36,0,18,25
40,Fail,46,39,6,9,37
40,Success,56,33,0,7,49
40,Fail,50,35,0,14,36
40,Fail,41,38,7,14,27
40,Success,51,37,0,11,40
40,Fail,40,47,2,11,29
40,Success,52,32,4,12,40
40,Fail,44,41,5,10,34
40,Fail,44,32,0,18,26
40,Fail,42,37,0,21,21
40,Fail,39,38,7,16,23
40,Fail,51,33,0,15,36
40,Success,50,38,2,10,40
40,Fail,49,35,0,10,39
40,Fail,49,39,0,12,37
40,Fail,43,36,7,14,29
40,Fail,41,34,6,19,22
40,Fail,46,37,1,16,30
40,Fail,50,38,0,11,39
40,Success,56,33,1,10,46
40,Success,52,32,6,10,42
40,Fail,45,31,0,16,29
40,Success,48,40,6,6,42
40,Fail,45,35,0,10,35
40,Fail,46,27,5,22,24
40,Fail,46,39,0,11,35
40,Fail,46,37,0,14,32
40,Success,52,31,0,12,40
40,Success,61,26,0,10,51
40,Fail,48,29,6,17,31
40,Success,56,32,5,7,49
40,Fail,49,34,5,12,37
40,Success,51,39,0,10,41
40,Fail,48,34,2,16,32
40,Fail,50,33,0,13,37
40,Fail,42,34,6,18,24
40,Fail,41,31,0,19,22
40,Fail,53,28,0,17,36
40,Success,53,36,1,10,43
40,Success,52,32,0,11,41
40,Fail,48,37,1,14,34
40,Fail,44,35,0,17,27
40,Success,52,34,2,12,40
40,Success,51,40,1,8,43
40,Fail,46,36,2,16,30
40,Fail,48,37,2,13,35
40,Fail,43,37,0,15,28
40,Fail,51,31,4,14,37
40,Success,55,31,0,12,43
40,Fail,45,34,0,10,35
40,Success,55,30,6,9,46
40,Fail,45,34,0,11,34
40,Fail,42,37,0,15,27
40,Success,56,28,0,16,40
40,Fail,48,35,0,11,37
40,Success,52,33,0,11,41
40,Success,53,35,0,7,46
40,Fail,50,29,6,15,35
40,Fail,40,45,2,13,27
40,Fail,40,39,1,20,20
40,Fail,51,33,2,14,37
40,Success,52,36,0,12,40
40,Fail,46,37,5,12,34
40,Fail,48,40,0,10,38
40,Success,54,34,0,9,45
40,Fail,51,34,0,12,39
40,Fail,50,32,0,16,34
40,Success,52,36,0,10,42
40,Fail,49,37,0,14,35
40,Success,52,35,3,10,42
40,Fail,53,21,5,21,32
40,Fail,50,33,0,12,38
40,Fail,47,34,0,16,31
40,Fail,40,42,8,10,30
40,Fail,50,38,1,11,39
40,Fail,45,34,0,17,28
40,Success,53,38,0,8,45
40,Fail,45,37,0,11,34
40,Fail,47,36,0,12,35
40,Fail,46,38,1,15,31
40,Success,51,36,0,11,40
40,Fail,39,40,0,18,21
40,Fail,47,30,0,12,35
40,Fail,43,38,0,18,25
40,Fail,49,38,0,11,38
40,Fail,50,37,0,12,38
40,Success,53,39,1,7,46
40,Fail,49,41,0,10,39
40,Fail,47,38,0,15,32
40,Fail,51,30,0,17,34
40,Fail,43,37,3,17,26
40,Fail,39,43,6,12,27
40,Fail,46,42,0,10,36
40,Fail,49,34,6,11,38
40,Fail,50,37,0,12,38
40,Fail,48,35,0,10,38
40,Fail,48,39,0,11,37
40,Fail,47,37,3,13,34
40,Success,56,33,0,9,47
40,Success,56,32,4,8,48
40,Fail,39,34,14,13,26
40,Fail,50,29,9,12,38
40,Fail,43,33,0,11,32
40,Fail,48,31,0,13,35
40,Fail,50,33,5,12,38
40,Fail,47,34,6,13,34
40,Fail,42,36,0,18,24
40,Success,53,35,0,9,44
40,Fail,45,39,4,12,33
40,Fail,44,37,6,13,31
40,Fail,43,37,0,13,30
40,Fail,44,40,0,10,34
40,Success,57,29,4,10,47
40,Fail,44,40,0,13,31
40,Fail,42,37,5,16,26
40,Fail,40,35,5,20,20
40,Fail,50,36,3,11,39
40,Fail,48,38,0,14,34
40,Fail,45,42,0,11,34
40,Success,54,26,7,13,41
40,Fail,42,43,0,13,29
40,Fail,50,30,3,17,33
40,Fail,52,33,2,13,39
40,Success,51,40,0,8,43
40,Success,57,23,0,15,42
40,Fail,43,44,2,11,32
40,Success,52,32,0,11,41
40,Success,54,31,4,11,43
40,Fail,50,31,3,16,34
40,Fail,39,34,10,17,22
40,Fail,46,39,2,13,33
40,Fail,43,36,1,20,23
40,Success,54,40,0,6,48
40,Fail,47,38,0,13,34
40,Fail,44,39,0,9,35
40,Success,50,35,7,8,42
40,Fail,49,35,4,12,37
40,Success,51,40,0,6,45
40,Success,54,36,0,9,45
40,Fail,43,37,0,13,30
40,Fail,53,30,0,15,38
40,Success,55,30,5,10,45
40,Fail,49,33,5,13,36
40,Fail,44,41,0,13,31
40,Fail,37,38,0,20,17
40,Success,50,39,1,10,40
40,Fail,51,37,0,12,39
40,Fail,49,31,4,16,33
40,Fail,42,41,0,9,33
40,Success,51,33,0,11,40
40,Fail,49,33,4,14,35
40,Fail,45,41,0,14,31
40,Fail,50,29,0,17,33
40,Fail,42,39,0,17,25
40,Fail,46,37,0,13,33
40,Fail,48,36,0,14,34
40,Success,52,37,4,7,45
40,Fail,48,34,3,15,33
40,Fail,45,45,1,9,36
40,Fail,44,35,0,13,31
40,Success,58,30,0,7,51
40,Fail,36,39,4,21,15
40,Fail,52,31,1,16,36
40,Fail,49,35,0,16,33
40,Fail,47,41,0,11,36
40,Success,49,37,0,7,42
40,Fail,51,29,2,18,33
40,Fail,47,39,2,12,35
40,Success,53,37,1,9,44
40,Success,53,35,2,10,43
40,Fail,50,31,4,15,35
40,Fail,46,43,0,9,37
40,Fail,46,35,0,14,32
40,Success,53,31,0,11,42
40,Fail,49,35,0,16,33
40,Fail,43,37,3,17,26
40,Success,50,41,0,3,47
40,Fail,51,28,6,15,36
40,Success,53,33,0,13,40
40,Fail,43,33,0,15,28
40,Success,53,34,3,10,43
40,Success,61,27,0,7,54
40,Fail,45,37,0,14,31
40,Fail,49,31,2,18,31
40,Fail,45,36,6,13,32
40,Fail,46,34,11,9,37
40,Success,50,31,10,9,41
40,Fail,49,34,0,13,36
40,Fail,49,40,0,11,38
40,Fail,39,31,9,21,18
40,Fail,46,31,0,16,30
40,Fail,44,35,2,19,25
40,Fail,51,29,6,14,37
40,Fail,46,34,4,16,30
40,Fail,46,38,0,12,34
40,Fail,48,35,6,11,37
40,Success,52,35,0,12,40
40,Fail,36,36,0,16,20
40,Fail,44,33,0,12,32
40,Fail,41,38,0,17,24
40,Fail,51,33,2,14,37
40,Fail,43,32,0,13,30
40,Success,53,36,0,10,43
40,Success,57,29,3,11,46
40,Success,50,35,0,8,42
40,Success,52,33,3,12,40
40,Fail,45,33,0,17,28
40,Fail,55,26,0,18,37
40,Fail,44,36,0,20,24
40,Fail,42,35,9,14,28
40,Fail,42,43,0,12,30
40,Fail,45,39,5,11,34
40,Fail,44,43,0,11,33
40,Fail,42,44,3,11,31
40,Fail,45,35,2,18,27
40,Success,56,33,0,9,47
40,Fail,55,27,0,17,38
40,Success,53,36,0,10,43
40,Fail,45,33,0,16,29
40,Success,50,38,0,10,40
40,Fail,40,39,6,15,25
40,Success,48,43,1,8,40
40,Fail,49,35,3,13,36
40,Fail,44,36,7,13,31
40,Fail,44,39,5,12,32
40,Fail,50,31,5,14,36
40,Fail,43,44,2,11,32
40,Success,52,27,10,11,41
40,Fail,46,34,7,13,33
40,Fail,46,32,0,13,33
40,Success,58,33,0,9,49
40,Fail,45,33,8,14,31
40,Fail,42,37,2,19,23
40,Fail,49,33,8,10,39
40,Success,58,35,1,6,52
40,Fail,47,34,2,17,30
40,Fail,41,34,6,19,22
40,Success,58,28,0,11,47
40,Fail,53,29,0,17,36
40,Fail,46,35,0,13,33
40,Success,51,33,0,11,40
40,Fail,44,44,3,9,35
40,Fail,43,40,0,11,32
40,Fail,48,35,4,13,35
40,Fail,42,27,0,16,26
40,Success,50,37,5,8,42
40,Fail,45,43,3,9,36
40,Fail,50,34,0,16,34
40,Fail,50,31,5,14,36
40,Fail,48,36,0,16,32
40,Fail,48,36,0,16,32
40,Fail,45,37,7,11,34
40,Success,55,34,0,10,45
40,Fail,45,40,0,13,32
40,Fail,48,37,0,9,39
40,Fail,50,32,0,17,33
40,Success,55,37,2,6,49
40,Success,54,33,0,10,44
40,Fail,44,43,4,9,35
40,Fail,47,28,0,14,33
40,Fail,47,30,6,17,30
40,Fail,49,39,0,11,38
40,Fail,53,27,6,14,39
40,Fail,44,36,0,16,28
40,Fail,45,41,0,12,33
40,Fail,51,30,0,12,39
40,Success,53,36,2,9,44
40,Fail,39,35,13,13,26
40,Fail,45,39,0,15,30
40,Fail,45,34,11,10,35
40,Fail,49,33,3,15,34
40,Fail,48,40,1,11,37
40,Fail,48,40,3,9,39
40,Fail,49,37,0,14,35
40,Fail,41,38,0,17,24
40,Success,50,42,0,7,43
40,Fail,47,38,5,10,37
40,Fail,51,35,2,12,39
40,Fail,45,38,0,16,29
40,Fail,51,37,0,12,39
40,Fail,47,35,0,14,33
40,Fail,49,37,0,14,35
40,Success,57,32,2,9,48
40,Fail,52,22,6,20,32
40,Fail,45,44,3,8,37
40,Fail,49,35,3,13,36
40,Fail,43,39,0,17,26
40,Fail,51,33,2,14,37
40,Success,55,33,0,12,43
40,Fail,49,37,3,11,38
40,Fail,44,41,0,12,32
40,Fail,41,42,7,10,31
40,Fail,44,41,4,11,33
40,Fail,49,29,0,13,36
40,Fail,49,37,0,10,39
40,Fail,47,32,0,16,31
40,Success,54,33,2,11,43
40,Fail,51,32,0,15,36
40,Fail,44,36,0,15,29
40,Fail,45,43,0,11,34
40,Fail,49,37,0,13,36
40,Fail,50,37,0,13,37
40,Fail,47,37,0,16,31
40,Fail,49,36,0,10,39
40,Fail,40,37,0,14,26
40,Fail,42,42,4,12,30
40,Success,51,33,8,8,43
40,Fail,51,35,0,12,39
40,Fail,44,41,0,11,33
40,Success,51,39,1,9,42
40,Success,51,38,4,7,44
40,Fail,38,38,0,19,19
40,Success,50,40,1,9,41
40,Fail,47,35,5,13,34
40,Success,51,38,0,11,40
40,Success,57,33,0,10,47
40,Fail,42,40,6,12,30
40,Success,51,39,2,8,43
40,Fail,48,34,1,17,31
40,Success,53,36,1,10,43
40,Fail,43,37,0,13,30
40,Fail,47,33,6,14,33
40,Fail,43,42,0,14,29
40,Fail,49,34,2,15,34
40,Fail,51,30,6,13,38
40,Fail,47,38,2,13,34
40,Fail,44,38,0,11,33
40,Fail,47,40,3,10,37
40,Fail,50,31,5,14,36
40,Fail,47,41,4,8,39
40,Fail,47,34,0,18,29
40,Fail,48,30,5,17,31
40,Fail,48,41,0,10,38
40,Fail,45,35,4,16,29
40,Fail,49,33,6,12,37
40,Fail,51,27,5,17,34
40,Success,55,37,2,6,49
40,Fail,46,38,8,8,38
40,Success,51,37,0,10,41
40,Fail,45,35,4,16,29
40,Fail,49,31,3,17,32
40,Success,53,32,3,12,41
40,Success,53,35,0,11,42
40,Fail,49,35,4,12,37
40,Fail,48,37,5,10,38
40,Fail,47,39,6,8,39
40,Fail,46,41,0,10,36
40,Fail,42,40,6,12,30
40,Fail,44,36,0,16,28
40,Fail,49,35,2,14,35
40,Fail,47,33,1,19,28
40,Fail,49,35,2,14,35
40,Success,53,32,7,8,45
40,Fail,47,35,0,16,31
40,Success,52,35,0,11,41
40,Fail,44,44,3,9,35
40,Success,53,34,5,8,45
40,Fail,47,40,0,13,34
40,Fail,44,35,9,12,32
40,Fail,48,30,0,16,32
40,Fail,52,35,0,13,39
40,Fail,48,38,0,11,37
40,Success,55,32,0,10,45
40,Fail,43,32,9,16,27
40,Success,53,35,0,11,42
40,Success,51,39,2,8,43
40,Fail,45,37,0,15,30
40,Fail,47,34,0,15,32
40,Fail,41,33,0,16,25
40,Fail,48,37,0,13,35
40,Fail,48,34,6,12,36
40,Fail,45,35,0,13,32
40,Fail,50,25,6,19,31
40,Fail,44,34,3,19,25
40,Fail,52,31,0,17,35
40,Fail,50,34,1,15,35
40,Success,55,34,0,10,45
40,Fail,40,34,6,20,20
40,Fail,48,36,0,12,36
40,Fail,48,35,0,17,31
40,Fail,47,40,2,11,36
40,Fail,50,32,0,14,36
40,Fail,42,33,12,13,29
40,Fail,44,34,0,16,28
40,Success,52,35,0,10,42
40,Fail,40,42,6,12,28
40,Fail,46,40,2,12,34
40,Fail,40,48,3,9,31
40,Fail,40,39,2,19,21
40,Fail,48,36,0,16,32
40,Fail,46,43,0,9,37
40,Success,62,27,0,11,51
40,Fail,48,34,0,11,37
40,Success,50,31,9,10,40
40,Fail,46,35,0,17,29
40,Fail,48,33,0,15,33
40,Fail,36,39,0,18,18
40,Fail,46,44,0,9,37
40,Fail,51,28,0,16,35
40,Fail,41,38,0,16,25
40,Success,56,29,6,9,47
40,Fail,53,32,1,14,39
40,Fail,47,39,1,13,34
40,Success,59,26,3,12,47
40,Fail,43,39,5,13,30
40,Success,50,38,0,8,42
40,Fail,44,38,6,12,32
40,Fail,50,29,6,15,35
40,Fail,40,41,0,13,27
40,Success,51,36,0,11,40
40,Fail,52,32,0,14,38
40,Fail,52,35,0,13,39
40,Fail,48,39,0,12,36
40,Fail,49,31,0,11,38
40,Fail,49,33,3,15,34
40,Fail,49,36,1,14,35
40,Fail,48,35,4,13,35
40,Fail,38,39,6,17,21
40,Fail,46,36,6,12,34
40,Fail,48,37,2,13,35
40,Fail,49,33,3,15,34
40,Fail,42,37,0,15,27
40,Fail,41,47,0,10,31
40,Fail,44,39,0,12,32
40,Success,52,35,0,10,42
40,Fail,47,30,0,20,27
40,Fail,52,30,0,14,38
40,Fail,43,35,3,19,24
40,Fail,47,40,0,11,36
40,Fail,45,43,0,12,33
40,Fail,37,41,3,19,18
40,Fail,51,33,3,13,38
40,Fail,43,40,0,11,32
40,Fail,37,45,4,14,23
40,Success,55,34,2,9,46
40,Fail,40,35,0,15,25
40,Success,54,30,0,12,42
40,Fail,42,42,0,15,27
40,Fail,45,32,9,14,31
40,Fail,47,32,2,19,28
40,Fail,49,31,3,17,32
40,Fail,44,39,0,16,28
40,Fail,48,30,8,14,34
40,Fail,43,38,0,15,28
40,Fail,37,44,3,16,21
40,Success,51,33,0,9,42
40,Success,51,37,0,11,40
40,Fail,48,30,0,18,30
40,Fail,43,35,10,12,31
40,Fail,47,38,0,13,34
40,Fail,50,34,0,15,35
40,Fail,47,40,2,11,36
40,Fail,47,40,1,12,35
40,Fail,43,43,0,13,30
40,Fail,45,41,0,14,31
40,Fail,43,34,5,18,25
40,Success,53,37,1,9,44
40,Success,57,28,2,13,44
40,Success,50,42,1,7,43
40,Fail,47,33,8,12,35
40,Fail,45,39,8,8,37
40,Fail,45,39,0,10,35
40,Fail,45,31,0,18,27
40,Fail,46,39,1,14,32
40,Fail,43,34,8,15,28
40,Fail,48,34,0,14,34
40,Fail,43,40,0,17,26
40,Fail,50,29,9,12,38
40,Fail,46,41,1,12,34
40,Fail,42,39,9,10,32
40,Fail,41,40,10,9,32
40,Fail,41,33,0,16,25
40,Fail,44,43,0,13,31
40,Success,51,32,7,10,41
40,Fail,47,39,0,11,36
40,Success,52,33,3,12,40
40,Fail,47,41,0,12,35
40,Fail,51,31,0,17,34
40,Fail,46,32,11,11,35
40,Fail,46,44,0,10,36
40,Fail,47,40,3,10,37
40,Fail,45,42,2,11,34
40,Fail,41,35,0,18,23
40,Fail,51,36,1,12,39
40,Fail,45,41,2,12,33
40,Fail,52,34,0,13,39
40,Fail,47,34,0,15,32
40,Success,56,31,0,11,45
40,Success,52,37,0,10,42
40,Fail,47,35,2,16,31
40,Fail,46,35,6,13,33
40,Success,48,37,0,6,42
40,Fail,30,46,0,16,14
40,Success,50,41,0,6,44
40,Fail,48,36,5,11,37
40,Fail,39,45,0,13,26
40,Fail,50,30,0,16,34
40,Fail,47,42,0,10,37
40,Fail,45,36,8,11,34
40,Fail,46,38,0,10,36
40,Success,50,42,1,7,43
40,Fail,46,45,1,8,38
40,Fail,41,40,8,11,30
40,Fail,48,33,1,18,30
40,Success,55,30,0,14,41
40,Success,52,32,0,12,40
40,Fail,40,48,1,11,29
40,Fail,47,36,0,10,37
40,Success,51,35,0,10,41
40,Fail,38,41,2,19,19
40,Fail,42,31,0,16,26
40,Fail,48,36,7,9,39
40,Success,52,35,2,11,41
40,Success,52,38,0,8,44
40,Fail,44,45,3,8,36
40,Fail,48,35,0,16,32
40,Success,53,33,3,11,42
40,Fail,45,40,1,14,31
40,Fail,48,38,1,13,35
40,Fail,44,37,3,16,28
40,Success,51,33,0,8,43
40,Fail,41,47,1,11,30
40,Fail,48,35,0,16,32
40,Success,56,32,0,9,47
40,Fail,42,37,8,13,29
40,Fail,49,30,0,14,35
40,Fail,42,40,3,15,27
40,Fail,47,32,0,12,35
40,Fail,48,39,3,10,38
40,Fail,44,38,2,16,28
40,Fail,46,38,3,13,33
40,Success,53,35,3,9,44
40,Success,55,38,0,7,48
40,Success,53,34,0,11,42
40,Success,52,32,4,12,40
40,Fail,46,40,4,10,36
40,Fail,47,32,0,16,31
40,Fail,49,34,7,10,39
40,Success,47,46,1,6,41
40,Fail,45,41,4,10,35
40,Fail,40,38,4,18,22
40,Success,48,41,3,8,40
40,Fail,46,36,2,16,30
40,Fail,49,35,2,14,35
40,Fail,44,37,6,13,31
40,Success,49,38,4,9,40
40,Fail,43,37,0,15,28
40,Success,51,34,0,10,41
40,Fail,42,41,5,12,30
40,Success,52,34,9,5,47
40,Fail,47,41,3,9,38
40,Fail,46,40,2,12,34
40,Success,59,30,3,8,51
40,Fail,50,33,0,12,38
40,Fail,42,39,0,18,24
40,Fail,48,35,0,13,35
40,Fail,47,40,0,8,39
40,Fail,51,31,5,13,38
40,Fail,42,38,0,13,29
40,Fail,47,39,0,14,33
40,Success,53,37,0,8,45
40,Fail,44,35,13,8,36
40,Fail,43,37,5,15,28
40,Fail,44,33,4,19,25
40,Fail,45,36,0,17,28
40,Fail,40,48,0,11,29
40,Fail,52,27,0,13,39
40,Fail,46,35,0,12,34
40,Fail,43,44,0,13,30
40,Fail,53,32,0,15,38
40,Success,51,43,0,5,46
40,Fail,49,37,2,12,37
40,Fail,50,28,9,13,37
40,Success,55,27,0,12,43
40,Fail,43,40,1,16,27
40,Fail,35,44,0,16,19
40,Success,54,31,3,12,42
40,Fail,50,33,4,13,37
40,Success,57,35,1,7,50
40,Success,50,43,0,7,43
40,Fail,45,41,0,11,34
40,Success,53,35,0,11,42
40,Success,51,41,1,7,44
40,Fail,51,34,0,14,37
40,Fail,46,38,0,13,33
40,Success,51,39,2,8,43
40,Fail,47,40,0,11,36
40,Fail,49,35,0,14,35
40,Fail,47,39,1,13,34
40,Fail,47,36,2,15,32
40,Fail,47,34,0,8,39
40,Fail,55,27,2,16,39
40,Fail,45,35,0,10,35
40,Success,50,44,0,6,44
40,Success,60,27,0,8,52
40,Success,52,36,0,10,42
40,Fail,49,33,0,17,32
40,Fail,45,35,3,17,28
40,Fail,51,29,8,12,39
40,Success,53,35,2,10,43
40,Fail,50,31,0,11,39
40,Fail,49,39,1,11,38
40,Success,52,34,0,4,48
40,Fail,46,32,0,17,29
40,Success,57,34,5,4,53
40,Fail,44,31,9,16,28
40,Success,53,34,0,13,40
40,Success,52,36,2,10,42
40,Fail,48,39,1,12,36
40,Success,57,28,2,13,44
40,Success,54,30,6,10,44
40,Fail,45,39,0,12,33
40,Fail,43,38,5,14,29
40,Fail,52,24,0,19,33
40,Success,51,35,5,9,42
40,Fail,46,38,4,12,34
40,Fail,47,33,0,14,33
40,Fail,51,28,0,17,34
40,Success,48,38,8,6,42
40,Fail,47,36,2,15,32
40,Fail,46,43,0,10,36
40,Fail,47,31,0,15,32
40,Fail,37,38,8,17,20
40,Fail,45,42,0,7,38
40,Fail,45,34,0,18,27
40,Success,52,36,0,12,40
40,Fail,45,40,0,10,35
40,Fail,48,35,0,13,35
40,Success,52,37,1,10,42
40,Fail,44,27,10,19,25
40,Fail,48,30,0,12,36
40,Fail,49,29,11,11,38
40,Fail,41,39,4,16,25
40,Fail,44,41,1,14,30
40,Fail,47,38,0,12,35
40,Fail,45,44,3,8,37
40,Fail,40,44,0,12,28
40,Fail,44,38,0,12,32
40,Fail,47,33,0,19,28
40,Fail,46,40,3,11,35
40,Fail,43,41,4,12,31
40,Fail,42,36,0,14,28
40,Success,52,28,12,8,44
40,Fail,47,38,0,11,36
40,Fail,48,34,1,17,31
40,Fail,44,43,0,5,39
40,Fail,45,41,0,14,31
40,Success,55,28,8,9,46
40,Fail,44,38,3,15,29
40,Fail,47,36,0,15,32
40,Success,54,38,0,8,46
40,Success,53,31,0,12,41
40,Fail,43,38,7,12,31
40,Success,52,37,0,9,43
40,Fail,49,37,0,12,37
40,Success,47,41,5,7,40
40,Fail,50,28,0,11,39
40,Success,51,37,0,9,42
40,Success,56,33,2,9,47
40,Fail,43,35,9,13,30
40,Fail,41,42,5,12,29
40,Fail,50,37,0,13,37
40,Success,51,36,2,11,40
40,Fail,50,32,0,15,35
40,Fail,48,37,0,11,37
40,Success,49,39,0,9,40
40,Fail,44,34,0,17,27
40,Fail,41,33,7,19,22
40,Fail,46,30,6,18,28
40,Fail,39,31,0,17,22
40,Fail,51,36,0,12,39
40,Success,49,36,0,7,42
40,Fail,54,25,3,18,36
40,Fail,51,32,2,15,36
40,Fail,47,38,0,15,32
40,Fail,41,40,0,18,23
40,Fail,42,44,0,10,32
40,Fail,42,38,0,18,24
40,Fail,45,37,2,16,29
40,Fail,51,30,0,12,39
40,Success,54,36,4,6,48
40,Success,51,32,0,11,40
40,Success,57,32,0,10,47
40,Fail,53,32,1,14,39
40,Fail,47,35,0,15,32
40,Fail,45,44,0,9,36
40,Fail,48,37,0,11,37
40,Fail,47,35,5,13,34
40,Fail,50,30,0,20,30
40,Fail,47,31,0,14,33
40,Success,53,33,0,9,44
40,Success,49,40,0,9,40
40,Fail,48,34,1,17,31
40,Fail,38,38,5,19,19
40,Success,58,33,1,8,50
40,Fail,51,33,0,13,38
40,Fail,52,31,3,14,38
40,Fail,43,32,8,17,26
40,Fail,47,36,0,16,31
40,Fail,46,37,0,11,35
40,Success,56,38,0,5,51
40,Fail,44,35,7,14,30
40,Fail,47,31,12,10,37
40,Fail,45,36,0,13,32
40,Success,49,36,6,9,40
40,Success,52,32,0,10,42
40,Fail,49,38,3,10,39
40,Fail,48,37,0,9,39
40,Success,51,41,0,8,43
40,Success,55,34,0,11,44
40,Fail,44,42,0,11,33
40,Fail,48,36,2,14,34
40,Success,54,35,1,10,44
40,Fail,47,41,0,12,35
40,Success,49,39,0,6,43
40,Fail,48,31,5,16,32
40,Success,53,36,0,11,42
40,Fail,46,38,0,13,33
40,Success,52,36,0,9,43
40,Fail,41,45,1,13,28
40,Fail,53,27,0,14,39
40,Fail,48,34,0,18,30
40,Success,53,33,0,11,42
40,Fail,43,41,0,14,29
40,Fail,45,33,0,15,30
40,Fail,43,35,5,17,26
40,Fail,43,42,0,13,30
40,Fail,48,43,0,9,39
40,Fail,44,34,7,15,29
40,Success,53,35,0,12,41
40,Fail,46,34,5,15,31
40,Fail,44,43,3,10,34
40,Fail,46,42,0,12,34
40,Fail,53,29,0,18,35
40,Success,55,32,0,12,43
40,Fail,50,33,5,12,38
40,Success,51,40,0,8,43
40,Fail,39,43,3,15,24
40,Fail,43,31,0,15,28
40,Fail,48,38,0,14,34
40,Fail,49,33,6,12,37
40,Success,54,30,5,11,43
40,Fail,51,36,1,12,39
40,Fail,37,42,3,18,19
40,Success,52,36,2,10,42
40,Fail,40,41,2,17,23
40,Fail,48,32,0,17,31
40,Success,54,36,0,8,46
40,Fail,47,36,6,11,36
40,Fail,49,36,0,12,37
40,Success,54,35,2,9,45
40,Fail,41,43,7,9,32
40,Fail,45,36,8,11,34
40,Success,48,40,0,8,40
40,Success,54,37,0,9,45
40,Fail,44,37,0,10,34
40,Fail,45,25,0,17,28
40,Success,51,39,2,8,43
40,Fail,52,34,0,14,38
40,Fail,38,38,0,21,17
40,Success,52,37,0,10,42
40,Fail,42,47,4,7,35
40,Fail,42,32,0,16,26
40,Fail,51,32,3,14,37
40,Success,59,24,2,15,44
40,Fail,49,34,0,12,37
40,Fail,49,37,0,12,37
40,Fail,45,24,13,18,27
40,Fail,45,40,3,12,33
40,Fail,45,36,3,16,29
40,Fail,40,35,0,17,23
40,Fail,44,41,0,9,35
40,Fail,49,38,1,12,37
40,Fail,42,35,8,15,27
40,Success,54,35,0,10,44
40,Fail,37,35,0,17,20
40,Fail,43,30,8,19,24
40,Fail,46,37,3,14,32
40,Success,52,37,0,11,41
40,Fail,42,35,0,15,27
40,Fail,49,31,0,13,36
40,Fail,41,44,9,6,35
40,Fail,50,37,0,11,39
40,Fail,42,39,11,8,34
40,Success,55,34,4,7,48
40,Fail,44,35,8,13,31
40,Fail,47,41,0,10,37
40,Success,52,33,0,9,43
40,Fail,49,36,0,14,35
40,Success,49,42,0,9,40
40,Success,57,29,5,9,48
40,Fail,42,41,6,11,31
40,Fail,43,43,1,13,30
40,Success,54,31,6,9,45
40,Fail,50,35,1,14,36
40,Fail,39,45,6,10,29
40,Fail,43,31,0,14,29
40,Fail,46,42,1,11,35
40,Fail,49,35,3,13,36
40,Fail,49,34,5,12,37
40,Success,52,29,8,11,41
40,Success,52,39,0,9,43
40,Fail,40,43,0,15,25
40,Fail,47,29,0,23,24
40,Fail,47,33,0,14,33
40,Success,51,40,0,9,42
40,Success,54,31,2,13,41
40,Fail,42,40,0,10,32
40,Fail,53,28,5,14,39
40,Fail,42,39,0,13,29
40,Fail,45,41,3,11,34
40,Fail,48,35,0,15,33
40,Fail,42,42,0,12,30
40,Fail,44,40,3,13,31
40,Fail,44,39,0,13,31
40,Fail,43,31,6,20,23
40,Success,52,38,1,9,43
40,Fail,49,38,3,10,39
40,Success,57,27,0,15,42
40,Fail,48,37,2,13,35
40,Fail,52,33,0,13,39
40,Fail,49,32,6,13,36
40,Success,60,21,0,12,48
40,Fail,47,43,2,8,39
40,Fail,49,36,0,14,35
40,Fail,52,34,0,13,39
40,Fail,47,37,0,13,34
40,Fail,47,33,0,17,30
40,Fail,49,37,0,12,37
40,Success,49,37,0,7,42
40,Success,56,26,0,14,42
40,Success,53,33,1,13,40
40,Fail,51,36,0,13,38
40,Fail,50,32,0,15,35
40,Fail,47,34,0,11,36
40,Fail,41,46,0,13,28
40,Fail,38,43,0,14,24
40,Fail,44,38,7,11,33
40,Success,52,32,4,12,40
40,Fail,47,37,2,14,33
40,Fail,43,34,0,19,24
40,Fail,48,40,0,9,39
40,Fail,45,29,0,12,33
40,Fail,42,45,0,10,32
40,Success,58,27,8,7,51
40,Fail,50,32,6,12,38
40,Fail,49,38,0,13,36
40,Fail,50,31,0,14,36
40,Fail,47,39,0,12,35
40,Fail,45,33,5,17,28
40,Fail,48,41,2,9,39
40,Fail,47,32,0,14,33
40,Success,53,32,2,13,40
40,Fail,47,38,1,14,33
40,Fail,48,33,2,17,31
40,Fail,49,35,0,11,38
40,Success,59,31,0,9,50
40,Success,53,32,3,12,41
40,Fail,45,36,1,18,27
40,Fail,47,34,0,13,34
40,Fail,50,36,0,12,38
40,Fail,51,37,0,12,39
40,Fail,41,36,12,11,30
40,Fail,47,34,0,15,32
40,Fail,45,37,0,16,29
40,Fail,48,32,1,19,29
40,Fail,47,34,0,9,38
40,Fail,38,41,6,15,23
40,Success,48,41,3,8,40
40,Fail,46,40,3,11,35
40,Fail,45,37,0,11,34
40,Success,53,38,0,8,45
40,Success,52,34,2,12,40
40,Success,53,34,0,8,45
40,Fail,42,32,0,16,26
40,Fail,49,39,0,12,37
40,Success,58,34,0,8,50
40,Fail,49,32,0,16,33
40,Fail,47,36,0,10,37
40,Fail,48,38,0,9,39
40,Fail,47,37,0,14,33
40,Success,51,39,0,4,47
40,Fail,48,35,0,13,35
40,Fail,44,38,3,15,29
40,Success,52,32,7,9,43
40,Success,58,28,0,13,45
40,Fail,54,27,0,15,39
40,Fail,48,38,2,12,36
40,Success,57,34,0,9,48
40,Fail,40,42,5,13,27
40,Success,54,30,3,13,41
40,Fail,48,31,1,20,28
40,Fail,46,38,1,15,31
40,Fail,47,29,0,17,30
40,Fail,46,34,7,13,33
40,Fail,46,27,0,16,30
40,Success,50,40,0,9,41
40,Fail,47,40,0,9,38
40,Fail,46,39,7,8,38
40,Fail,48,37,2,13,35
40,Fail,51,34,1,14,37
40,Success,56,31,0,12,44
40,Fail,49,40,0,10,39
40,Fail,47,36,0,12,35
40,Success,46,36,0,5,41
40,Fail,47,36,2,15,32
40,Success,58,29,0,13,45
40,Fail,48,38,0,13,35
40,Fail,50,37,0,13,37
40,Fail,48,40,0,10,38
40,Fail,36,37,0,20,16
40,Fail,43,39,3,15,28
40,Fail,45,38,0,16,29
40,Fail,40,45,1,14,26
40,Fail,46,37,0,10,36
40,Success,55,36,0,9,46
40,Success,49,43,0,6,43
40,Fail,44,38,4,14,30
40,Success,49,37,0,9,40
40,Fail,45,39,0,11,34
40,Fail,39,37,5,19,20
40,Success,51,39,0,9,42
40,Success,57,32,0,10,47
40,Fail,47,31,9,13,34
40,Fail,45,36,0,16,29
40,Fail,44,36,0,12,32
40,Fail,41,37,0,20,21
40,Fail,47,42,0,11,36
40,Fail,47,34,8,11,36
40,Fail,37,34,12,17,20
40,Fail,50,32,5,13,37
40,Success,48,41,4,7,41
40,Fail,48,35,0,15,33
40,Success,46,49,2,3,43
40,Success,56,33,0,10,46
40,Fail,46,37,1,16,30
40,Fail,44,38,1,17,27
40,Fail,49,26,9,16,33
40,Success,54,35,4,7,47
40,Fail,51,36,0,12,39
40,Success,54,35,3,8,46
40,Fail,50,36,3,11,39
40,Fail,46,39,5,10,36
40,Success,48,44,1,7,41
40,Fail,46,40,0,14,32
40,Fail,38,37,0,20,18
40,Fail,47,37,0,14,33
40,Fail,46,39,0,11,35
40,Fail,47,41,2,10,37
40,Fail,42,46,0,11,31
40,Fail,49,35,0,15,34
40,Success,51,37,4,8,43
40,Fail,50,34,2,14,36
40,Fail,50,30,8,12,38
40,Fail,45,38,6,11,34
40,Fail,44,36,6,14,30
40,Success,53,37,0,9,44
40,Fail,51,31,3,15,36
40,Fail,39,35,8,18,21
40,Fail,47,35,3,15,32
40,Fail,44,42,0,14,30
40,Fail,44,36,0,14,30
40,Success,53,36,0,11,42
40,Fail,45,37,0,13,32
40,Success,55,35,0,9,46
40,Success,52,31,0,12,40
40,Fail,43,47,0,8,35
40,Fail,41,33,8,18,23
40,Fail,49,37,1,13,36
40,Fail,43,36,8,13,30
40,Fail,41,46,6,7,34
40,Fail,45,39,0,15,30
40,Fail,44,35,4,17,27
40,Fail,43,36,7,14,29
40,Success,55,31,0,10,45
40,Success,57,32,0,10,47
40,Fail,46,38,0,14,32
40,Fail,44,41,4,11,33
40,Success,62,30,4,4,58
40,Fail,44,37,0,12,32
40,Success,52,33,0,12,40
40,Success,53,31,4,12,41
40,Fail,49,32,3,16,33
40,Fail,47,37,8,8,39
40,Fail,49,33,5,13,36
40,Success,53,36,0,11,42
40,Fail,47,31,4,18,29
40,Fail,51,31,0,14,37
40,Fail,49,32,0,18,31
40,Success,52,33,5,10,42
40,Fail,51,36,1,12,39
40,Fail,49,37,3,11,38
40,Success,57,31,0,10,47
40,Fail,51,33,2,14,37
40,Fail,45,36,0,10,35
40,Fail,45,36,0,10,35
40,Fail,43,36,0,15,28
40,Success,51,37,0,9,42
40,Fail,48,36,4,12,36
40,Fail,45,33,3,19,26
40,Fail,43,43,1,13,30
40,Fail,47,32,0,11,36
40,Fail,45,27,0,17,28
40,Success,51,34,5,10,41
40,Fail,38,44,0,16,22
40,Fail,50,36,0,14,36
40,Fail,50,32,0,18,32
40,Fail,44,28,11,17,27
40,Fail,37,31,0,20,17
40,Success,54,34,5,7,47
40,Fail,48,34,0,12,36
40,Success,60,21,0,8,52
40,Fail,41,42,4,13,28
40,Fail,42,45,2,11,31
40,Fail,42,41,9,8,34
40,Success,52,35,3,10,42
40,Fail,47,34,2,17,30
40,Fail,46,37,0,14,32
40,Success,51,33,7,9,42
40,Success,54,37,0,7,47
40,Success,56,30,0,13,43
40,Fail,53,31,2,14,39
40,Fail,47,34,0,16,31
40,Success,55,30,3,12,43
40,Fail,49,31,0,17,32
40,Fail,40,40,3,17,23
40,Success,51,37,2,10,41
40,Fail,45,39,5,11,34
40,Fail,44,37,7,12,32
40,Fail,37,40,0,20,17
40,Fail,39,35,0,18,21
40,Fail,47,30,0,23,24
40,Fail,46,36,5,13,33
40,Fail,43,42,0,15,28
40,Fail,43,40,4,13,30
40,Fail,47,31,0,18,29
40,Success,49,43,1,7,42
40,Fail,46,39,0,10,36
40,Success,49,42,0,9,40
40,Fail,45,39,5,11,34
40,Fail,44,41,0,15,29
40,Fail,41,43,6,10,31
40,Success,53,36,2,9,44
40,Fail,42,34,9,15,27
40,Fail,43,46,1,10,33
40,Fail,51,36,0,12,39
40,Fail,48,36,4,12,36
40,Fail,44,32,9,15,29
40,Fail,45,36,9,10,35
40,Fail,51,30,0,12,39
40,Fail,46,40,0,10,36
40,Fail,46,38,3,13,33
40,Success,54,31,0,10,44
40,Fail,52,33,0,13,39
40,Fail,43,39,0,14,29
40,Success,52,32,0,8,44
40,Success,55,31,0,14,41
40,Fail,40,36,0,15,25
40,Fail,45,37,2,16,29
40,Fail,53,31,0,14,39
40,Fail,50,33,3,14,36
40,Success,55,35,0,10,45
40,Fail,46,40,0,13,33
40,Fail,47,38,0,14,33
40,Fail,42,38,0,14,28
40,Fail,44,37,10,9,35
40,Fail,46,33,0,14,32
40,Success,53,38,0,9,44
40,Fail,48,37,2,13,35
40,Fail,47,39,0,14,33
40,Fail,48,36,0,14,34
40,Fail,48,41,0,10,38
40,Fail,42,36,7,15,27
40,Fail,40,32,0,17,23
40,Success,54,32,0,10,44
40,Fail,46,38,0,16,30
40,Fail,45,41,4,10,35
40,Fail,50,35,0,14,36
40,Fail,48,38,3,11,37
40,Fail,42,37,6,15,27
40,Fail,47,31,0,12,35
40,Fail,47,38,0,13,34
40,Fail,46,35,6,13,33
40,Fail,47,31,0,15,32
40,Fail,47,35,0,18,29
40,Fail,44,40,0,10,34
40,Fail,48,38,4,10,38
40,Fail,41,36,0,17,24
40,Fail,47,41,0,10,37
40,Fail,51,34,0,13,38
40,Fail,46,34,0,12,34
40,Fail,44,36,0,19,25
40,Fail,49,32,8,11,38
40,Fail,49,34,0,17,32
40,Fail,43,27,12,18,25
40,Fail,46,35,0,13,33
40,Success,51,41,2,6,45
40,Success,51,32,0,11,40
40,Fail,42,38,0,15,27
40,Success,60,32,0,8,52
40,Success,55,28,8,9,46
40,Fail,44,41,1,14,30
40,Success,51,31,0,11,40
40,Success,59,33,0,7,52
40,Fail,45,39,0,11,34
40,Fail,46,35,6,13,33
40,Fail,48,34,0,11,37
40,Fail,47,33,5,15,32
40,Fail,45,43,3,9,36
40,Fail,45,40,0,11,34
40,Success,48,36,0,8,40
40,Success,55,33,0,12,43
40,Fail,48,40,0,12,36
40,Fail,48,37,0,14,34
40,Success,52,37,0,10,42
40,Fail,44,32,0,13,31
40,Fail,46,35,3,16,30
40,Success,51,34,5,10,41
40,Fail,50,34,0,13,37
40,Fail,47,37,0,13,34
40,Fail,42,41,0,11,31
40,Fail,47,39,4,10,37
40,Fail,47,34,0,12,35
40,Success,52,40,0,6,46
40,Fail,44,37,0,13,31
40,Fail,41,41,0,18,23
40,Fail,47,38,0,12,35
40,Success,51,38,0,11,40
40,Fail,46,28,8,18,28
40,Success,54,33,0,9,45
40,Fail,48,34,4,14,34
40,Fail,45,37,0,16,29
40,Fail,50,35,0,11,39
40,Fail,46,31,0,15,31
40,Fail,50,27,0,14,36
40,Fail,47,32,4,17,30
40,Fail,54,24,0,20,34
40,Fail,42,37,6,15,27
40,Fail,50,38,1,11,39
40,Success,50,33,7,10,40
40,Success,51,31,0,9,42
40,Fail,46,40,0,9,37
40,Success,51,38,0,9,42
40,Success,51,40,2,7,44
40,Fail,45,37,0,17,28
40,Fail,45,37,0,15,30
40,Success,55,33,5,7,48
40,Success,54,33,0,13,41
40,Fail,48,34,0,14,34
40,Fail,44,40,1,15,29
40,Fail,39,40,3,18,21
40,Fail,51,30,0,17,34
40,Success,49,41,2,8,41
40,Fail,42,41,0,12,30
40,Fail,43,43,0,11,32
40,Fail,49,34,3,14,35
40,Fail,47,37,0,13,34
40,Success,55,35,1,9,46
40,Fail,48,32,6,14,34
40,Fail,39,53,5,3,36
40,Fail,48,30,7,15,33
40,Fail,47,35,0,17,30
40,Success,52,34,0,8,44
40,Fail,44,41,1,14,30
40,Fail,51,32,0,12,39
40,Fail,40,37,7,16,24
40,Success,51,33,0,11,40
40,Success,55,32,0,8,47
40,Fail,44,39,3,14,30
40,Success,55,36,0,7,48
40,Success,52,37,1,10,42
40,Fail,48,33,0,12,36
40,Fail,44,43,0,10,34
40,Fail,49,26,12,13,36
40,Fail,47,34,8,11,36
40,Fail,44,41,0,14,30
40,Success,51,36,2,11,40
40,Fail,47,35,0,8,39
40,Fail,44,42,3,11,33
40,Fail,47,42,0,9,38
40,Fail,48,30,0,13,35
40,Success,54,32,0,13,41
40,Fail,46,39,1,14,32
40,Success,49,37,0,9,40
40,Fail,48,35,3,14,34
40,Fail,41,40,0,15,26
40,Fail,48,38,2,12,36
40,Fail,49,37,0,11,38
40,Fail,44,39,5,12,32
40,Fail,49,40,0,10,39
40,Fail,45,40,0,13,32
40,Fail,48,29,0,18,30
40,Success,52,36,0,10,42
40,Fail,50,30,0,19,31
40,Success,56,30,2,12,44
40,Fail,46,30,0,17,29
40,Fail,47,41,0,12,35
40,Fail,48,34,0,12,36
40,Fail,51,33,0,12,39
40,Success,47,43,3,7,40
40,Success,49,41,0,7,42
40,Fail,41,40,9,10,31
40,Success,55,32,0,8,47
40,Success,57,33,1,9,48
40,Fail,45,40,0,15,30
40,Fail,45,42,0,8,37
40,Fail,52,33,2,13,39
40,Fail,52,26,6,16,36
40,Success,56,32,0,11,45
40,Success,49,35,0,8,41
40,Fail,42,39,0,14,28
40,Fail,48,35,0,12,36
40,Success,53,37,1,9,44
40,Success,50,40,1,9,41
40,Success,51,32,6,11,40
40,Success,50,40,0,9,41
40,Success,51,33,5,11,40
40,Success,55,30,2,13,42
40,Success,47,46,0,7,40
40,Success,54,33,0,13,41
40,Fail,40,41,8,11,29
40,Fail,35,34,0,19,16
40,Fail,37,37,0,10,27
40,Success,54,32,0,14,40
40,Fail,44,38,1,17,27
40,Fail,40,38,8,14,26
40,Fail,46,37,0,11,35
40,Success,53,34,0,13,40
40,Success,53,34,0,11,42
40,Fail,41,40,7,12,29
40,Fail,47,39,3,11,36
40,Fail,48,32,0,14,34
40,Success,53,35,1,11,42
40,Success,53,38,0,8,45
40,Fail,43,36,0,17,26
40,Fail,44,29,6,21,23
40,Fail,48,27,0,17,31
40,Success,53,35,3,9,44
40,Fail,49,35,0,13,36
40,Fail,41,35,10,14,27
40,Success,57,31,4,8,49
40,Success,54,32,0,10,44
40,Fail,49,34,7,10,39
40,Fail,49,33,5,13,36
40,Fail,49,33,5,13,36
40,Success,51,35,0,10,41
40,Fail,47,38,6,9,38
40,Fail,52,32,0,14,38
40,Fail,45,37,0,17,28
40,Fail,43,38,2,17,26
40,Fail,47,35,4,14,33
40,Fail,46,37,5,12,34
40,Fail,41,38,0,13,28
40,Fail,48,39,0,9,39
40,Fail,46,36,0,13,33
40,Fail,52,31,0,14,38
40,Fail,41,31,0,25,16
40,Fail,40,32,11,17,23
40,Success,52,36,0,12,40
40,Success,52,31,6,11,41
40,Success,54,39,0,6,48
40,Fail,49,34,0,10,39
40,Fail,46,37,1,16,30
40,Success,51,37,0,9,42
40,Fail,41,45,0,14,27
40,Fail,46,32,0,15,31
40,Success,55,36,0,8,47
40,Success,50,38,0,9,41
40,Fail,49,35,0,12,37
40,Fail,44,38,3,15,29
40,Fail,40,35,4,21,19
40,Fail,48,35,0,10,38
40,Fail,49,38,0,13,36
40,Fail,41,33,14,12,29
40,Fail,50,32,0,15,35
40,Fail,44,38,0,10,34
40,Fail,46,38,0,9,37
40,Success,51,36,3,10,41
40,Success,49,36,0,9,40
40,Fail,42,38,0,15,27
40,Fail,48,34,5,13,35
40,Success,55,32,5,8,47
40,Success,54,32,3,11,43
40,Success,53,40,3,4,49
40,Success,51,37,0,10,41
40,Fail,45,36,3,16,29
40,Fail,51,29,0,18,33
40,Fail,42,31,12,15,27
40,Fail,42,36,6,16,26
40,Fail,50,35,2,13,37
40,Success,51,33,6,10,41
40,Fail,52,34,0,14,38
40,Fail,45,45,0,8,37
40,Fail,47,37,0,11,36
40,Success,52,35,0,11,41
40,Success,59,35,0,6,53
40,Fail,48,32,4,16,32
40,Success,52,34,0,12,40
40,Fail,48,30,0,20,28
40,Fail,50,34,0,16,34
40,Fail,50,34,0,11,39
40,Success,53,41,0,4,49
40,Success,50,34,8,8,42
40,Fail,45,35,0,17,28
40,Fail,49,38,3,10,39
40,Fail,45,36,0,13,32
40,Fail,49,34,0,12,37
40,Fail,49,34,2,15,34
40,Fail,45,42,1,12,33
40,Fail,50,32,0,13,37
40,Success,52,32,0,12,40
40,Success,50,35,5,10,40
40,Fail,45,35,0,14,31
40,Success,57,29,2,12,45
40,Fail,48,40,0,11,37
40,Fail,45,32,0,20,25
40,Success,50,38,4,8,42
40,Fail,39,37,7,17,22
40,Fail,45,31,6,18,27
40,Fail,49,30,0,14,35
40,Fail,50,38,0,11,39
40,Fail,49,36,0,11,38
40,Fail,46,35,3,16,30
40,Success,59,27,2,12,47
40,Fail,47,36,0,12,35
40,Fail,51,30,2,17,34
40,Fail,51,31,0,12,39
40,Fail,44,35,6,15,29
40,Fail,45,36,2,17,28
40,Success,55,25,5,15,40
40,Fail,48,33,0,17,31
40,Fail,48,33,0,13,35
40,Success,50,33,0,8,42
40,Success,54,31,0,9,45
40,Fail,46,40,0,11,35
40,Fail,49,31,0,20,29
40,Fail,42,31,8,19,23
40,Success,58,26,5,11,47
40,Fail,44,37,9,10,34
40,Fail,50,30,0,17,33
40,Fail,47,37,3,13,34
40,Fail,44,45,4,7,37
40,Fail,47,33,6,14,33
40,Fail,43,40,3,14,29
40,Fail,43,32,10,15,28
40,Fail,49,38,1,12,37
40,Fail,50,32,0,18,32
40,Success,53,33,0,12,41
40,Success,53,29,8,10,43
40,Fail,46,45,0,9,37
40,Fail,48,37,0,14,34
40,Fail,49,36,0,11,38
40,Fail,49,38,0,12,37
40,Success,53,32,2,13,40
40,Fail,42,36,6,16,26
40,Success,50,39,0,10,40
40,Success,50,35,0,9,41
40,Fail,48,42,0,9,39
40,Fail,46,42,0,10,36
40,Fail,46,38,6,10,36
40,Success,53,36,0,11,42
40,Success,54,34,4,8,46
40,Fail,51,37,0,12,39
40,Success,53,33,0,12,41
40,Fail,44,38,0,11,33
40,Fail,45,29,17,9,36
40,Fail,44,34,6,16,28
40,Fail,44,33,5,18,26
40,Success,51,35,0,10,41
40,Fail,47,38,3,12,35
40,Fail,51,36,1,12,39
40,Success,55,38,2,5,50
40,Success,53,37,0,7,46
40,Fail,46,38,6,10,36
40,Fail,46,34,0,13,33
40,Success,53,33,1,13,40
40,Fail,44,38,0,15,29
40,Fail,47,38,0,12,35
40,Fail,48,34,0,14,34
40,Success,55,28,0,14,41
40,Fail,53,30,0,14,39
40,Fail,48,40,0,9,39
40,Fail,45,29,0,14,31
40,Fail,52,32,0,16,36
40,Fail,51,30,0,16,35
40,Fail,49,30,5,16,33
40,Success,51,39,0,10,41
40,Fail,45,43,0,12,33
40,Fail,52,32,2,14,38
40,Fail,37,45,2,16,21
40,Success,51,37,1,11,40
40,Fail,39,39,9,13,26
40,Fail,48,33,0,12,36
40,Fail,50,36,0,14,36
40,Fail,41,32,12,15,26
40,Success,50,41,0,8,42
40,Fail,47,33,0,13,34
40,Fail,37,33,0,19,18
40,Success,48,42,0,8,40
40,Success,56,32,1,11,45
40,Fail,37,39,5,19,18
40,Fail,46,28,12,14,32
40,Fail,39,44,2,15,24
40,Success,53,32,4,11,42
40,Fail,51,27,0,17,34
40,Fail,51,33,0,15,36
40,Fail,51,32,0,15,36
40,Fail,44,41,0,7,37
40,Fail,48,36,3,13,35
40,Fail,51,35,0,13,38
40,Fail,43,29,14,14,29
40,Fail,47,29,0,19,28
40,Fail,49,29,7,15,34
40,Success,51,38,0,9,42
40,Fail,51,27,0,13,38
40,Fail,52,28,0,16,36
40,Fail,48,40,1,11,37
40,Fail,49,33,5,13,36
40,Success,52,38,0,8,44
40,Fail,51,31,0,15,36
40,Success,50,36,4,10,40
40,Fail,42,40,0,16,26
40,Success,51,37,0,11,40
40,Fail,40,39,8,13,27
40,Fail,45,42,0,13,32
40,Success,55,35,1,9,46
40,Success,52,23,13,12,40
40,Success,52,34,5,9,43
40,Fail,48,31,10,11,37
40,Fail,43,36,0,19,24
40,Fail,49,33,3,15,34
40,Fail,44,44,2,10,34
40,Success,52,33,0,8,44
40,Fail,46,43,0,10,36
40,Fail,45,35,0,20,25
40,Success,49,39,0,7,42
40,Success,59,29,1,11,48
40,Success,57,29,3,11,46
40,Success,48,37,0,8,40
40,Success,55,33,0,7,48
40,Fail,48,36,2,14,34
40,Fail,40,37,8,15,25
40,Fail,47,38,0,14,33
40,Fail,44,35,0,14,30
40,Fail,47,38,1,14,33
40,Fail,51,33,0,16,35
40,Fail,45,31,11,13,32
40,Fail,48,34,6,12,36
40,Success,53,30,0,13,40
40,Fail,47,32,2,19,28
40,Success,51,37,4,8,43
40,Fail,51,35,1,13,38
40,Success,61,21,0,12,49
40,Fail,42,37,7,14,28
40,Fail,48,30,4,18,30
40,Fail,42,39,0,12,30
40,Fail,47,35,5,13,34
40,Success,55,36,2,7,48
40,Fail,41,40,1,18,23
40,Fail,45,32,0,18,27
40,Success,50,34,0,7,43
40,Fail,49,28,12,11,38
40,Fail,51,31,0,14,37
40,Success,56,32,0,8,48
40,Fail,40,39,0,16,24
40,Fail,48,37,3,12,36
40,Success,48,42,3,7,41
40,Fail,47,36,4,13,34
40,Fail,45,35,7,13,32
40,Fail,52,32,2,14,38
40,Success,54,36,0,9,45
40,Fail,45,39,0,15,30
40,Success,53,29,10,8,45
40,Success,52,30,6,12,40
40,Fail,45,34,0,19,26
40,Fail,46,37,0,14,32
40,Fail,47,34,0,16,31
40,Fail,47,32,4,17,30
40,Fail,43,39,8,10,33
40,Success,52,31,9,8,44
40,Success,53,34,1,12,41
40,Fail,51,37,0,12,39
40,Fail,48,28,3,21,27
40,Fail,45,35,0,15,30
40,Fail,36,44,0,15,21
40,Fail,47,31,0,17,30
40,Success,56,29,1,14,42
40,Fail,49,40,1,10,39
40,Success,55,32,0,11,44
40,Success,57,32,0,11,46
40,Success,59,29,4,8,51
40,Fail,50,35,0,12,38
40,Fail,46,29,11,14,32
40,Fail,48,25,0,21,27
40,Success,49,35,10,6,43
40,Fail,50,35,0,14,36
40,Fail,42,36,3,19,23
40,Fail,46,42,0,10,36
40,Success,50,37,0,7,43
40,Fail,39,30,16,15,24
40,Fail,46,39,0,10,36
40,Fail,49,36,0,10,39
40,Fail,43,31,7,19,24
40,Fail,48,35,0,13,35
40,Fail,47,34,5,14,33
40,Fail,42,38,4,16,26
40,Fail,45,30,0,16,29
40,Success,50,37,0,10,40
40,Fail,44,40,3,13,31
40,Fail,46,36,2,16,30
40,Fail,44,34,0,16,28
40,Success,55,33,4,8,47
40,Fail,50,32,0,14,36
40,Success,51,31,0,10,41
40,Fail,44,30,0,14,30
40,Fail,48,35,0,17,31
40,Fail,47,41,0,10,37
40,Fail,43,40,0,15,28
40,Fail,46,36,0,16,30
40,Success,52,33,0,11,41
40,Fail,41,37,0,15,26
40,Success,53,36,0,7,46
40,Success,54,35,2,9,45
40,Fail,48,34,9,9,39
40,Fail,47,34,0,14,33
40,Fail,45,40,0,14,31
40,Fail,50,35,0,12,38
40,Fail,39,50,0,7,32
40,Fail,48,35,5,12,36
40,Fail,39,33,0,15,24
40,Success,56,30,0,12,44
40,Fail,51,35,0,13,38
40,Success,51,34,0,11,40
40,Fail,39,42,3,16,23
40,Fail,46,35,3,16,30
40,Fail,51,35,0,13,38
40,Fail,46,37,0,16,30
40,Success,54,32,2,12,42
40,Success,51,38,3,8,43
40,Fail,51,31,0,14,37
40,Fail,44,37,1,18,26
40,Fail,51,31,0,13,38
40,Fail,50,32,0,17,33
40,Fail,48,36,5,11,37
40,Fail,49,33,0,15,34
40,Fail,46,34,3,17,29
40,Success,55,34,1,10,45
40,Success,51,38,2,9,42
40,Success,52,35,0,10,42
40,Fail,46,36,0,16,30
40,Fail,52,33,2,13,39
40,Success,52,26,10,12,40
40,Fail,50,33,0,15,35
40,Success,50,38,4,8,42
40,Success,61,32,1,6,55
40,Fail,48,39,1,12,36
40,Fail,49,26,0,15,34
40,Fail,55,27,2,16,39
40,Fail,42,45,0,11,31
40,Fail,41,36,9,14,27
40,Success,50,39,2,9,41
40,Fail,46,33,0,16,30
40,Fail,50,35,0,13,37
40,Success,53,31,3,13,40
40,Fail,45,36,0,16,29
40,Success,51,37,0,11,40
40,Fail,41,27,0,21,20
40,Success,50,31,0,10,40
40,Fail,46,38,5,11,35
40,Success,50,36,7,7,43
40,Fail,52,20,0,24,28
40,Success,55,30,0,15,40
40,Success,52,33,0,10,42
40,Success,52,33,6,9,43
40,Fail,45,42,0,13,32
40,Fail,37,43,0,11,26
40,Fail,49,32,6,13,36
40,Fail,46,42,0,8,38
40,Fail,49,33,2,16,33
40,Fail,43,37,0,18,25
40,Success,54,37,0,8,46
40,Fail,43,38,0,14,29
40,Fail,44,31,0,15,29
40,Fail,49,34,0,14,35
40,Fail,47,30,8,15,32
40,Fail,45,42,5,8,37
40,Fail,50,36,0,13,37
40,Fail,41,33,3,23,18
40,Fail,44,42,0,14,30
40,Fail,51,35,1,13,38
40,Success,51,34,0,11,40
40,Success,56,37,0,6,50
40,Fail,40,42,12,6,34
40,Fail,37,46,3,14,23
40,Success,54,37,2,7,47
40,Success,52,35,0,8,44
40,Success,54,30,3,13,41
40,Success,56,29,0,8,48
40,Fail,37,42,0,13,24
40,Fail,47,34,0,18,29
40,Fail,40,48,1,11,29
40,Fail,46,41,0,10,36
40,Success,54,31,1,14,40
40,Fail,42,38,0,15,27
40,Success,56,31,6,7,49
40,Fail,47,37,0,15,32
40,Fail,43,41,3,13,30
40,Fail,45,40,6,9,36
40,Fail,48,39,1,12,36
40,Success,58,32,0,10,48
40,Success,53,34,0,12,41
40,Success,58,36,0,5,53
40,Success,53,40,2,5,48
40,Fail,36,37,0,17,19
40,Success,49,38,0,9,40
40,Fail,44,46,0,6,38
40,Fail,46,46,1,7,39
40,Success,48,38,0,8,40
40,Fail,44,39,2,15,29
40,Fail,51,29,0,17,34
40,Success,53,35,0,11,42
40,Success,50,38,0,6,44
40,Success,52,37,0,10,42
40,Fail,47,33,5,15,32
40,Fail,47,34,0,18,29
40,Fail,47,30,8,15,32
40,Fail,39,39,0,15,24
40,Fail,48,35,0,11,37
40,Success,56,36,0,8,48
40,Success,53,39,2,6,47
40,Fail,45,39,0,9,36
40,Fail,43,38,0,17,26
40,Success,51,37,0,10,41
40,Fail,46,36,0,12,34
40,Success,53,38,0,8,45
40,Success,52,33,4,11,41
40,Success,52,38,3,7,45
40,Fail,46,41,1,12,34
40,Success,51,35,0,11,40
40,Fail,42,37,3,18,24
40,Fail,47,36,4,13,34
40,Fail,47,39,2,12,35
40,Fail,45,34,7,14,31
40,Fail,51,33,0,13,38
40,Fail,41,48,0,5,36
40,Fail,46,35,5,14,32
40,Fail,49,36,0,13,36
40,Fail,51,31,5,13,38
40,Fail,50,35,0,14,36
40,Fail,43,44,0,11,32
40,Fail,51,31,0,13,38
40,Fail,48,33,7,12,36
40,Fail,42,41,0,14,28
40,Fail,50,37,0,12,38
40,Success,55,37,0,8,47
40,Fail,42,36,0,16,26
40,Success,56,31,0,9,47
40,Success,48,47,0,5,43
40,Fail,46,41,1,12,34
40,Fail,50,35,0,13,37
40,Fail,47,35,2,16,31
40,Success,54,30,5,11,43
40,Success,50,33,8,9,41
40,Fail,52,34,0,13,39
40,Success,50,41,2,7,43
40,Fail,49,38,2,11,38
40,Success,56,29,0,11,45
40,Fail,48,39,0,13,35
40,Success,52,35,0,12,40
40,Fail,47,35,0,12,35
40,Fail,48,38,1,13,35
40,Fail,49,35,5,11,38
40,Fail,39,45,0,16,23
40,Fail,47,43,0,10,37
40,Fail,50,35,0,14,36
40,Fail,46,36,0,11,35
40,Fail,42,35,0,19,23
40,Fail,44,36,7,13,31
40,Fail,52,34,0,14,38
40,Fail,50,33,2,15,35
40,Fail,44,40,5,11,33
40,Fail,43,44,1,12,31
40,Fail,37,35,15,13,24
40,Success,50,38,0,9,41
40,Fail,49,37,0,11,38
40,Fail,47,35,6,12,35
40,Fail,47,33,0,16,31
40,Fail,44,31,4,21,23
40,Fail,51,31,4,14,37
40,Fail,48,36,0,9,39
40,Success,56,29,5,10,46
40,Success,51,39,0,10,41
40,Success,56,26,0,13,43
40,Fail,44,35,4,17,27
40,Success,52,39,2,7,45
40,Success,51,38,0,8,43
40,Fail,48,39,1,12,36
40,Fail,51,34,0,15,36
40,Fail,47,31,0,16,31
40,Success,48,45,3,4,44
40,Fail,42,37,5,16,26
40,Success,56,28,0,15,41
40,Success,50,34,0,9,41
40,Fail,44,37,6,13,31
40,Fail,44,38,5,13,31
40,Fail,53,33,0,14,39
40,Success,56,28,10,6,50
40,Fail,51,32,0,15,36
40,Fail,41,43,0,8,33
40,Success,50,34,0,10,40
40,Fail,47,31,9,13,34
40,Fail,50,30,0,14,36
40,Fail,42,37,7,14,28
40,Success,53,32,4,11,42
40,Success,50,40,0,8,42
40,Fail,40,41,1,18,22
40,Fail,51,30,6,13,38
40,Fail,51,36,0,12,39
40,Fail,44,35,0,14,30
40,Fail,43,26,0,23,20
40,Fail,47,38,0,13,34
40,Fail,50,28,0,14,36
40,Success,51,38,0,11,40
40,Fail,45,40,1,14,31
40,Success,56,32,0,11,45
40,Fail,43,40,0,11,32
40,Success,51,38,0,11,40
40,Fail,42,49,1,8,34
40,Fail,49,36,2,13,36
40,Fail,41,41,0,11,30
40,Fail,50,32,0,14,36
40,Success,51,42,0,3,48
40,Fail,41,34,14,11,30
40,Fail,49,34,0,14,35
40,Success,52,36,0,11,41
40,Fail,37,40,0,17,20
40,Fail,46,35,0,16,30
40,Fail,47,35,8,10,37
40,Fail,49,31,0,12,37
40,Fail,47,34,9,10,37
40,Success,50,38,3,9,41
40,Fail,35,39,0,20,15
40,Fail,47,31,2,20,27
40,Fail,42,34,5,19,23
40,Fail,49,28,8,15,34
40,Fail,50,27,10,13,37
40,Fail,49,38,3,10,39
40,Fail,41,42,0,7,34
40,Fail,37,47,0,14,23
40,Fail,45,44,0,8,37
40,Fail,42,30,0,18,24
40,Fail,50,31,6,13,37
40,Fail,40,36,11,13,27
40,Fail,44,38,0,14,30
40,Fail,43,42,2,13,30
40,Fail,49,34,5,12,37
40,Fail,44,39,0,13,31
40,Fail,35,37,9,19,16
40,Fail,47,26,0,17,30
40,Success,53,33,1,13,40
40,Success,53,36,1,10,43
40,Fail,48,38,0,12,36
40,Success,54,34,0,12,42
40,Fail,48,29,14,9,39
40,Fail,42,34,0,17,25
40,Success,59,33,1,7,52
40,Fail,47,26,13,14,33
40,Success,61,27,0,9,52
40,Success,55,27,0,11,44
40,Fail,47,38,0,9,38
40,Success,52,40,1,7,45
40,Fail,51,29,6,14,37
40,Success,49,42,1,8,41
40,Fail,45,38,0,13,32
40,Fail,46,32,8,14,32
40,Fail,39,40,4,17,22
40,Fail,40,39,7,14,26
40,Fail,45,41,1,13,32
40,Fail,51,35,0,14,37
40,Fail,46,40,0,12,34
40,Fail,52,26,7,15,37
40,Fail,43,45,1,11,32
40,Success,49,37,0,9,40
40,Fail,46,41,0,13,33
40,Fail,47,37,0,14,33
40,Fail,46,40,3,11,35
40,Fail,39,38,0,16,23
40,Fail,39,41,0,12,27
40,Fail,49,32,0,13,36
40,Success,54,30,0,13,41
40,Fail,43,34,7,16,27
40,Success,55,35,4,6,49
40,Fail,51,30,3,16,35
40,Fail,41,39,4,16,25
40,Fail,45,44,0,10,35
40,Fail,53,33,0,14,39
40,Fail,43,36,0,13,30
40,Fail,49,32,7,12,37
40,Fail,41,45,3,11,30
40,Fail,45,41,0,9,36
40,Success,54,39,0,7,47
40,Fail,44,28,15,13,31
40,Fail,45,35,0,13,32
40,Fail,49,31,10,10,39
40,Fail,42,31,0,19,23
40,Fail,47,43,1,9,38
40,Success,55,30,1,14,41
40,Fail,49,31,0,11,38
40,Success,53,34,0,12,41
40,Success,51,34,0,9,42
40,Success,54,37,0,7,47
40,Fail,49,40,0,10,39
40,Fail,45,33,9,13,32
40,Fail,46,39,0,15,31
40,Fail,44,41,3,12,32
40,Fail,48,40,2,10,38
40,Fail,46,41,0,13,33
40,Fail,47,35,5,13,34
40,Fail,45,39,10,6,39
40,Success,52,36,1,11,41
40,Fail,39,36,0,15,24
40,Fail,45,34,0,14,31
40,Success,50,34,0,10,40
40,Fail,44,39,4,13,31
40,Success,52,36,1,11,41
40,Fail,52,33,0,13,39
40,Success,52,33,8,7,45
40,Success,52,36,2,10,42
40,Success,49,44,0,7,42
40,Fail,46,39,0,13,33
40,Fail,42,37,7,14,28
40,Success,51,35,0,9,42
40,Fail,46,32,12,10,36
40,Success,54,34,0,7,47
40,Fail,49,37,1,13,36
40,Fail,46,38,3,13,33
40,Fail,47,32,5,16,31
40,Fail,52,31,0,13,39
40,Fail,47,35,0,14,33
40,Fail,48,33,5,14,34
40,Success,56,33,1,10,46
40,Fail,40,37,13,10,30
40,Fail,52,31,2,15,37
40,Fail,41,34,0,19,22
40,Fail,46,42,2,10,36
40,Fail,47,31,0,13,34
40,Success,55,31,1,13,42
40,Fail,48,38,3,11,37
40,Success,52,33,0,10,42
40,Fail,45,35,0,18,27
40,Fail,43,36,0,15,28
40,Fail,44,43,0,9,35
40,Fail,47,33,7,13,34
40,Fail,49,37,2,12,37
40,Fail,43,40,0,13,30
40,Fail,39,46,1,14,25
40,Fail,41,40,5,14,27
40,Fail,43,38,3,16,27
40,Fail,38,40,7,15,23
40,Success,52,36,0,11,41
40,Success,55,33,0,10,45
40,Success,56,34,0,7,49
40,Fail,47,33,2,18,29
40,Success,50,39,0,9,41
40,Fail,46,32,0,15,31
40,Success,48,42,0,8,40
40,Fail,45,36,3,16,29
40,Success,52,38,1,9,43
40,Success,53,36,0,10,43
40,Success,53,34,0,9,44
40,Fail,42,36,0,21,21
40,Fail,44,34,3,19,25
40,Success,54,33,0,12,42
40,Fail,47,39,0,12,35
40,Fail,46,38,5,11,35
40,Fail,42,41,1,16,26
40,Success,52,25,13,10,42
40,Fail,41,44,0,15,26
40,Fail,46,34,0,10,36
40,Fail,46,40,0,14,32
40,Success,53,37,0,6,47
40,Fail,49,34,0,16,33
40,Fail,41,38,0,17,24
40,Success,52,36,2,10,42
40,Fail,42,35,0,10,32
40,Fail,48,33,0,16,32
40,Fail,49,38,1,12,37
40,Fail,49,32,0,17,32
40,Fail,46,38,3,13,33
40,Success,50,39,0,8,42
40,Fail,43,37,1,19,24
40,Success,57,34,0,9,48
40,Fail,48,32,0,14,34
40,Success,56,32,0,12,44
40,Fail,54,26,4,16,38
40,Fail,46,44,0,10,36
40,Fail,42,46,3,9,33
40,Fail,48,33,5,14,34
40,Fail,45,31,12,12,33
40,Fail,46,34,0,15,31
40,Fail,50,34,3,13,37
40,Fail,49,34,0,12,37
40,Fail,45,37,11,7,38
40,Fail,44,41,0,14,30
40,Fail,45,30,0,12,33
40,Fail,42,35,10,13,29
40,Fail,42,34,0,16,26
40,Fail,51,36,0,12,39
40,Success,56,29,0,11,45
40,Fail,47,34,5,14,33
40,Success,49,31,11,9,40
40,Fail,51,33,3,13,38
40,Fail,53,27,0,19,34
40,Fail,43,35,0,17,26
40,Fail,45,30,0,20,25
40,Fail,45,33,0,19,26
40,Fail,50,38,1,11,39
40,Fail,43,42,5,10,33
40,Fail,49,30,7,14,35
40,Fail,53,28,4,15,38
40,Fail,42,42,0,11,31
40,Fail,48,35,0,17,31
40,Fail,42,38,0,12,30
40,Fail,46,38,0,16,30
40,Success,52,32,0,12,40
40,Success,55,33,0,9,46
40,Fail,49,40,1,10,39
40,Fail,46,38,0,14,32
40,Success,53,39,4,4,49
40,Fail,45,33,0,13,32
40,Fail,47,39,4,10,37
40,Fail,47,29,10,14,33
40,Fail,45,39,2,14,31
40,Fail,50,33,3,14,36
40,Success,50,42,1,7,43
40,Fail,38,40,0,11,27
40,Success,48,39,0,7,41
40,Fail,39,37,0,21,18
40,Fail,49,38,0,12,37
40,Fail,50,35,2,13,37
40,Fail,47,33,5,15,32
40,Fail,50,25,13,12,38
40,Fail,47,29,0,17,30
40,Fail,47,38,4,11,36
40,Fail,48,39,2,11,37
40,Success,46,48,0,5,41
40,Success,53,37,0,9,44
40,Fail,48,31,0,11,37
40,Success,54,33,1,12,42
40,Success,57,32,0,11,46
40,Fail,45,36,0,16,29
40,Success,49,37,5,9,40
40,Success,50,38,0,10,40
40,Success,51,37,0,10,41
40,Fail,46,39,2,13,33
40,Fail,52,32,1,15,37
40,Success,50,35,6,9,41
40,Fail,49,32,0,17,32
40,Fail,48,35,0,16,32
40,Success,54,36,0,10,44
40,Fail,42,38,6,14,28
40,Fail,48,37,0,12,36
40,Fail,47,36,0,15,32
40,Fail,49,38,1,12,37
40,Fail,52,35,0,13,39
40,Fail,46,35,9,10,36
40,Fail,49,36,0,15,34
40,Fail,41,39,0,11,30
40,Fail,42,34,0,17,25
40,Fail,43,32,4,21,22
40,Success,52,35,0,8,44
40,Fail,55,26,3,16,39
40,Fail,44,43,0,12,32
40,Fail,52,28,0,13,39
40,Fail,48,36,1,15,33
40,Success,57,26,6,11,46
40,Success,52,35,1,12,40
40,Fail,48,28,0,14,34
40,Fail,47,30,6,17,30
40,Fail,46,36,6,12,34
40,Fail,48,33,4,15,33
40,Fail,44,42,3,11,33
40,Success,54,32,0,12,42
40,Fail,47,42,0,10,37
40,Success,49,38,4,9,40
40,Fail,51,33,0,13,38
40,Success,57,30,2,11,46
40,Fail,51,32,1,16,35
40,Success,50,36,0,10,40
40,Fail,38,47,0,12,26
40,Success,51,37,1,11,40
40,Fail,52,27,0,18,34
40,Fail,48,36,6,10,38
40,Fail,43,35,5,17,26
40,Fail,43,39,0,15,28
40,Fail,47,35,3,15,32
40,Fail,48,31,0,11,37
40,Fail,48,30,5,17,31
40,Fail,48,40,0,12,36
40,Fail,47,42,1,10,37
40,Fail,43,45,2,10,33
40,Success,53,27,8,12,41
40,Success,50,38,0,8,42
40,Fail,48,41,0,9,39
40,Success,52,31,0,10,42
40,Fail,39,38,0,18,21
40,Success,58,28,0,12,46
40,Fail,47,43,0,9,38
40,Success,56,33,0,10,46
40,Fail,49,39,0,12,37
40,Fail,37,47,0,13,24
40,Fail,50,37,1,12,38
40,Fail,44,42,0,11,33
40,Success,52,36,2,10,42
40,Fail,46,36,0,16,30
40,Success,51,39,0,10,41
40,Success,55,30,8,7,48
40,Fail,51,36,0,13,38
40,Fail,51,35,0,13,38
40,Fail,37,50,0,12,25
40,Fail,46,36,0,18,28
40,Success,58,30,1,11,47
40,Fail,47,39,3,11,36
40,Fail,47,34,0,16,31
40,Fail,45,41,0,12,33
40,Fail,51,37,0,12,39
40,Fail,44,36,3,17,27
40,Success,53,31,0,12,41
40,Success,47,41,0,6,41
40,Fail,46,37,5,12,34
40,Fail,46,40,5,9,37
40,Fail,46,39,3,12,34
40,Fail,44,38,3,15,29
40,Fail,47,36,4,13,34
40,Fail,42,38,7,13,29
40,Fail,47,38,0,15,32
40,Fail,43,34,5,18,25
40,Fail,41,36,8,15,26
40,Fail,44,35,9,12,32
40,Fail,46,41,0,12,34
40,Fail,47,30,0,15,32
40,Fail,43,32,8,17,26
40,Success,55,29,0,14,41
40,Success,50,37,4,9,41
40,Fail,48,34,0,12,36
40,Success,58,28,1,13,45
40,Fail,45,34,5,16,29
40,Fail,44,37,0,19,25
40,Fail,45,38,6,11,34
40,Fail,42,41,0,8,34
40,Fail,49,33,4,14,35
40,Fail,50,34,5,11,39
40,Fail,45,38,2,15,30
40,Success,55,31,0,12,43
40,Fail,44,41,0,12,32
40,Success,54,37,0,9,45
40,Fail,45,43,0,11,34
40,Fail,51,35,0,13,38
40,Fail,47,41,2,10,37
40,Fail,47,37,0,8,39
40,Success,55,36,0,7,48
40,Success,55,36,1,8,47
40,Fail,40,36,0,14,26
40,Fail,45,40,0,13,32
40,Fail,48,36,3,13,35
40,Fail,45,34,10,11,34
40,Fail,50,38,0,12,38
40,Fail,39,28,0,20,19
40,Fail,50,32,0,13,37
40,Fail,43,36,9,12,31
40,Fail,41,38,0,16,25
40,Fail,49,36,0,13,36
40,Fail,44,39,0,17,27
40,Fail,51,31,6,12,39
40,Fail,51,34,0,13,38
40,Fail,45,37,7,11,34
40,Fail,40,41,0,14,26
40,Fail,47,38,0,14,33
40,Fail,48,39,1,12,36
40,Fail,45,30,12,13,32
40,Fail,46,32,0,14,32
40,Success,53,31,8,8,45
40,Fail,43,39,5,13,30
40,Fail,46,37,0,12,34
40,Fail,45,43,2,10,35
40,Fail,46,36,0,10,36
40,Fail,46,36,8,10,36
40,Fail,46,41,0,12,34
40,Fail,50,38,1,11,39
40,Fail,42,35,0,15,27
40,Fail,49,35,1,15,34
40,Success,55,31,3,11,44
40,Fail,44,39,5,12,32
40,Fail,44,41,0,13,31
40,Fail,51,32,1,16,35
40,Fail,49,33,3,15,34
40,Fail,44,31,7,18,26
40,Fail,46,35,2,17,29
40,Fail,37,41,2,20,17
40,Success,50,41,1,8,42
40,Fail,49,34,0,17,32
40,Fail,46,43,0,7,39
40,Success,55,33,0,9,46
40,Fail,35,35,8,22,13
40,Fail,50,34,0,13,37
40,Fail,47,41,0,10,37
40,Fail,46,37,1,16,30
40,Success,50,35,0,8,42
40,Fail,49,35,5,11,38
40,Success,55,35,1,9,46
40,Fail,40,37,9,14,26
40,Success,52,28,0,12,40
40,Fail,49,32,4,15,34
40,Fail,48,34,0,16,32
40,Fail,42,40,0,13,29
40,Fail,42,33,4,21,21
40,Success,50,28,14,8,42
40,Fail,48,37,6,9,39
40,Fail,46,36,0,10,36
40,Fail,44,34,7,15,29
40,Fail,51,36,0,12,39
40,Fail,49,31,10,10,39
40,Success,55,27,8,10,45
40,Fail,45,35,6,14,31
40,Fail,44,27,0,16,28
40,Success,54,33,1,12,42
40,Fail,35,37,14,14,21
40,Fail,50,36,0,13,37
40,Fail,45,41,0,11,34
40,Fail,49,33,0,10,39
40,Fail,40,34,0,21,19
40,Success,56,33,4,7,49
40,Fail,46,37,5,12,34
40,Fail,40,36,11,13,27
40,Fail,42,38,0,18,24
40,Fail,47,37,0,15,32
40,Fail,41,39,4,16,25
40,Fail,41,38,0,15,26
40,Fail,49,31,0,16,33
40,Fail,48,35,3,14,34
40,Fail,43,42,7,8,35
40,Fail,46,27,0,22,24
40,Fail,45,36,0,18,27
40,Success,59,30,3,8,51
40,Fail,49,34,0,13,36
40,Fail,52,32,3,13,39
40,Success,50,38,4,8,42
40,Fail,46,37,0,14,32
40,Fail,49,35,0,14,35
40,Fail,43,35,0,13,30
40,Fail,46,32,6,16,30
40,Success,50,39,4,7,43
40,Fail,50,36,0,14,36
40,Success,57,31,0,12,45
40,Fail,48,38,4,10,38
40,Fail,47,35,0,9,38
40,Fail,51,33,0,12,39
40,Fail,46,39,0,15,31
40,Fail,46,39,0,11,35
40,Fail,48,39,1,12,36
40,Fail,43,43,4,10,33
40,Success,56,26,0,7,49
40,Fail,43,43,0,8,35
40,Fail,42,33,0,21,21
40,Fail,49,34,2,15,34
40,Fail,42,36,6,16,26
40,Fail,46,39,0,13,33
40,Fail,48,37,3,12,36
40,Fail,43,42,4,11,32
40,Fail,54,28,0,15,39
40,Success,55,34,1,10,45
40,Fail,47,38,0,15,32
40,Success,53,33,0,10,43
40,Fail,43,37,4,16,27
40,Success,51,40,0,5,46
40,Fail,44,41,2,13,31
40,Fail,36,42,0,15,21
40,Success,51,35,0,11,40
40,Success,50,38,0,9,41
40,Fail,49,30,0,14,35
40,Success,58,28,0,10,48
40,Fail,51,30,0,15,36
40,Success,50,40,0,7,43
40,Success,54,35,2,9,45
40,Fail,43,40,0,16,27
40,Fail,49,34,0,13,36
40,Fail,45,30,0,15,30
40,Fail,44,38,9,9,35
40,Success,51,34,0,8,43
40,Fail,44,37,0,19,25
40,Success,49,40,6,5,44
40,Success,52,37,0,7,45
40,Success,52,32,0,11,41
40,Fail,42,45,0,8,34
40,Fail,38,43,7,12,26
40,Success,58,29,0,11,47
40,Fail,49,41,0,10,39
40,Fail,50,37,0,13,37
40,Fail,43,27,11,19,24
40,Success,56,30,2,12,44
40,Fail,40,46,4,10,30
40,Success,51,41,2,6,45
40,Fail,45,42,2,11,34
40,Fail,45,42,2,11,34
40,Success,50,42,0,8,42
40,Fail,47,38,2,13,34
40,Success,53,29,0,13,40
40,Fail,47,41,4,8,39
40,Success,56,32,0,12,44
40,Success,48,40,0,8,40
40,Fail,50,33,0,16,34
40,Success,52,35,4,9,43
40,Fail,46,44,0,10,36
40,Fail,53,33,0,14,39
40,Fail,46,41,2,11,35
40,Success,53,29,5,13,40
40,Fail,45,33,0,13,32
40,Fail,44,40,1,15,29
40,Fail,50,27,0,11,39
40,Success,52,32,8,8,44
40,Success,52,36,0,12,40
40,Success,51,39,0,7,44
40,Fail,46,30,0,16,30
40,Fail,42,42,3,13,29
40,Success,53,37,0,9,44
40,Fail,51,28,5,16,35
40,Success,52,40,0,5,47
40,Fail,40,41,0,12,28
40,Success,55,31,0,9,46
40,Fail,47,38,0,9,38
40,Fail,44,40,0,14,30
40,Fail,45,32,0,17,28
40,Fail,44,42,0,10,34
40,Fail,47,40,2,11,36
40,Fail,46,35,0,11,35
40,Fail,53,32,1,14,39
40,Success,50,35,0,9,41
40,Fail,47,36,0,16,31
40,Fail,47,33,4,16,31
40,Fail,45,43,0,11,34
40,Fail,45,39,7,9,36
40,Success,50,38,0,8,42
40,Success,52,33,0,10,42
40,Fail,46,38,0,10,36
40,Fail,45,35,2,18,27
40,Fail,44,28,0,15,29
40,Fail,43,44,0,12,31
40,Success,50,38,0,10,40
40,Fail,50,32,3,15,35
40,Success,57,33,0,10,47
40,Fail,50,37,2,11,39
40,Fail,49,36,0,14,35
40,Fail,44,36,7,13,31
40,Fail,49,35,3,13,36
40,Fail,41,33,0,18,23
40,Fail,46,42,2,10,36
40,Success,52,31,5,12,40
40,Fail,47,40,0,13,34
40,Fail,47,25,0,19,28
40,Fail,39,47,0,13,26
40,Fail,43,46,3,8,35
40,Success,51,34,5,10,41
40,Fail,49,33,7,11,38
40,Fail,42,45,1,12,30
40,Fail,43,40,2,15,28
40,Fail,51,30,6,13,38
40,Fail,49,38,0,13,36
40,Fail,46,30,0,16,30
40,Success,54,33,0,9,45
40,Fail,40,45,0,15,25
40,Success,50,40,2,8,42
40,Fail,50,36,0,13,37
40,Fail,49,30,0,14,35
40,Fail,49,28,0,17,32
40,Fail,48,37,0,9,39
40,Fail,44,44,0,9,35
40,Success,50,37,4,9,41
40,Fail,42,43,0,12,30
40,Fail,52,31,0,13,39
40,Success,54,30,0,12,42
40,Success,51,37,2,10,41
40,Fail,45,37,0,11,34
40,Success,50,37,0,9,41
40,Fail,45,39,2,14,31
40,Success,49,36,0,9,40
40,Fail,49,34,5,12,37
40,Fail,51,35,0,12,39
40,Fail,45,43,0,9,36
40,Success,54,32,0,10,44
40,Fail,48,32,0,15,33
40,Fail,43,34,0,15,28
40,Fail,44,37,0,18,26
40,Success,54,34,1,11,43
40,Success,52,35,0,11,41
40,Fail,47,39,2,12,35
40,Success,54,31,4,11,43
40,Fail,46,30,8,16,30
40,Fail,51,30,0,18,33
40,Fail,52,27,0,13,39
40,Fail,52,34,0,13,39
40,Fail,45,39,0,14,31
40,Fail,39,33,12,16,23
40,Fail,50,34,0,15,35
40,Fail,49,34,2,15,34
40,Fail,47,37,0,11,36
40,Success,49,41,0,8,41
40,Fail,42,39,0,14,28
40,Fail,42,40,1,17,25
40,Fail,49,32,2,17,32
40,Success,58,27,1,14,44
40,Fail,47,41,1,11,36
40,Fail,49,35,0,14,35
40,Fail,50,33,0,17,33
40,Fail,45,35,0,15,30
40,Fail,48,32,0,14,34
40,Fail,40,37,0,12,28
40,Fail,40,36,0,12,28
40,Fail,47,40,0,13,34
40,Fail,49,34,0,11,38
40,Success,50,37,4,9,41
40,Fail,43,32,0,13,30
40,Success,50,34,7,9,41
40,Success,52,38,0,7,45
40,Fail,45,37,4,14,31
40,Success,56,36,0,5,51
40,Fail,44,45,0,10,34
40,Fail,46,42,0,11,35
40,Fail,44,33,0,13,31
40,Fail,43,39,0,12,31
40,Fail,44,38,0,15,29
40,Success,54,34,0,11,43
40,Fail,50,32,7,11,39
40,Success,52,37,0,8,44
40,Fail,40,42,2,16,24
40,Fail,48,37,0,14,34
40,Fail,43,37,0,11,32
40,Fail,40,41,1,18,22
40,Success,58,32,1,9,49
40,Fail,51,36,0,13,38
40,Fail,47,38,3,12,35
40,Success,51,35,0,10,41
40,Fail,42,39,6,13,29
40,Fail,50,38,0,11,39
40,Fail,52,30,0,18,34
40,Fail,47,41,4,8,39
40,Fail,42,37,10,11,31
40,Success,53,32,2,13,40
40,Fail,44,40,0,14,30
40,Fail,46,36,8,10,36
40,Fail,48,39,0,12,36
40,Fail,47,37,0,11,36
40,Fail,49,28,8,15,34
40,Fail,48,31,5,16,32
40,Success,57,30,4,9,48
40,Success,54,28,0,14,40
40,Fail,50,34,0,14,36
40,Success,54,31,0,11,43
40,Fail,47,38,0,12,35
40,Success,56,28,0,11,45
40,Fail,49,39,0,10,39
40,Success,53,35,6,6,47
40,Fail,43,30,6,21,22
40,Fail,45,30,0,16,29
40,Success,50,38,0,10,40
40,Fail,48,40,0,12,36
40,Fail,45,42,3,10,35
40,Fail,49,33,0,16,33
40,Fail,46,37,4,13,33
40,Fail,50,35,2,13,37
40,Success,52,33,0,12,40
40,Fail,42,37,5,16,26
40,Success,53,36,2,9,44
40,Fail,48,39,0,13,35
40,Success,56,34,0,9,47
40,Fail,50,36,0,14,36
40,Fail,39,37,0,13,26
40,Fail,40,39,9,12,28
40,Fail,48,32,0,15,33
40,Fail,46,41,3,10,36
40,Success,53,35,4,8,45
40,Fail,48,32,0,14,34
40,Fail,47,29,0,20,27
40,Fail,44,33,8,15,29
40,Fail,46,36,1,17,29
40,Fail,48,27,0,16,32
40,Fail,46,36,0,12,34
40,Fail,48,39,4,9,39
40,Fail,47,36,0,12,35
40,Success,54,36,0,10,44
40,Success,51,38,2,9,42
40,Fail,48,40,2,10,38
40,Fail,48,35,0,14,34
40,Success,56,33,0,10,46
40,Fail,46,35,6,13,33
40,Success,51,34,0,11,40
40,Success,51,39,0,10,41
40,Success,48,36,9,7,41
40,Fail,47,34,2,17,30
40,Fail,47,37,0,8,39
40,Fail,42,39,4,15,27
40,Fail,46,34,4,16,30
40,Fail,40,42,5,13,27
40,Fail,50,31,5,14,36
40,Success,54,32,0,10,44
40,Success,53,35,1,11,42
40,Success,52,31,0,9,43
40,Fail,43,33,6,18,25
40,Fail,47,37,4,12,35
40,Fail,44,40,3,13,31
40,Success,58,29,0,12,46
40,Fail,43,39,0,13,30
40,Success,53,31,4,12,41
40,Fail,43,36,0,15,28
40,Success,53,32,2,13,40
40,Fail,46,33,0,16,30
40,Success,51,40,0,9,42
40,Fail,48,30,6,16,32
40,Fail,48,38,0,12,36
40,Fail,40,40,0,16,24
40,Success,55,28,0,10,45
40,Fail,49,33,0,12,37
40,Fail,41,41,0,17,24
40,Fail,38,40,9,13,25
40,Fail,46,39,2,13,33
40,Fail,45,33,0,17,28
40,Success,52,31,0,9,43
40,Fail,46,43,0,10,36
40,Fail,52,32,0,14,38
40,Fail,43,34,3,20,23
40,Fail,51,31,5,13,38
40,Fail,44,42,0,7,37
40,Fail,39,43,0,17,22
40,Fail,43,43,0,12,31
40,Fail,49,32,4,15,34
40,Fail,41,36,0,19,22
40,Success,60,24,0,11,49
40,Fail,47,29,0,18,29
40,Fail,47,37,0,13,34
40,Fail,47,28,6,19,28
40,Fail,46,41,0,11,35
40,Fail,47,26,0,19,28
40,Success,48,37,7,8,40
40,Success,57,28,0,8,49
40,Fail,44,35,3,18,26
40,Fail,49,37,4,10,39
40,Success,54,33,0,13,41
40,Success,51,35,0,11,40
40,Success,54,31,0,11,43
40,Fail,46,35,0,13,33
40,Fail,52,30,0,14,38
40,Success,51,34,7,8,43
40,Fail,49,32,2,17,32
40,Fail,50,34,0,14,36
40,Fail,44,34,8,14,30
40,Success,55,31,0,8,47
40,Fail,45,38,0,15,30
40,Fail,46,31,7,16,30
40,Success,53,34,2,11,42
40,Fail,42,35,0,17,25
40,Fail,44,43,0,11,33
40,Fail,42,41,11,6,36
40,Fail,45,36,0,14,31
40,Fail,47,33,4,16,31
40,Fail,48,36,6,10,38
40,Fail,50,36,0,12,38
40,Success,55,28,10,7,48
40,Fail,43,39,0,17,26
40,Fail,43,37,0,11,32
40,Fail,37,49,2,12,25
40,Success,51,37,0,9,42
40,Fail,41,40,0,11,30
40,Fail,51,30,0,12,39
40,Fail,49,37,0,12,37
40,Fail,53,30,3,14,39
40,Fail,46,33,0,13,33
40,Fail,47,41,1,11,36
40,Fail,49,30,5,16,33
40,Fail,49,36,0,12,37
40,Fail,47,36,0,14,33
40,Fail,46,37,4,13,33
40,Fail,44,38,0,13,31
40,Success,52,34,0,12,40
40,Fail,47,33,10,10,37
40,Fail,50,32,0,17,33
40,Fail,49,30,8,13,36
40,Success,51,35,0,11,40
40,Fail,48,32,0,13,35
40,Fail,46,38,0,11,35
40,Success,52,37,0,11,41
40,Fail,48,32,8,12,36
40,Fail,47,37,0,16,31
40,Fail,40,39,0,15,25
40,Fail,47,34,0,14,33
40,Fail,35,40,15,10,25
40,Fail,45,36,8,11,34
40,Fail,44,35,0,17,27
40,Fail,51,35,0,13,38
40,Fail,46,38,0,12,34
40,Fail,49,34,0,12,37
40,Fail,47,40,0,13,34
40,Fail,43,41,5,11,32
40,Fail,50,31,0,14,36
40,Fail,47,33,0,13,34
40,Fail,43,35,5,17,26
40,Fail,47,31,0,14,33
40,Fail,43,43,0,10,33
40,Success,51,37,0,9,42
40,Fail,44,39,1,16,28
40,Fail,50,34,0,13,37
40,Success,53,34,3,10,43
40,Fail,42,46,0,12,30
40,Fail,52,29,0,16,36
40,Fail,51,29,0,16,35
40,Fail,44,37,4,15,29
40,Success,55,34,0,7,48
40,Success,52,33,3,12,40
40,Fail,46,36,2,16,30
40,Fail,48,38,4,10,38
40,Fail,50,35,2,13,37
40,Fail,47,30,9,14,33
40,Fail,43,44,0,13,30
40,Success,56,31,0,10,46
40,Fail,51,31,0,18,33
40,Fail,48,43,0,9,39
40,Fail,45,34,4,17,28
40,Fail,40,45,0,12,28
40,Fail,47,31,8,14,33
40,Fail,42,36,8,14,28
40,Success,50,38,2,10,40
40,Fail,46,39,0,13,33
40,Success,52,31,0,11,41
40,Fail,41,37,0,20,21
40,Fail,48,36,2,14,34
40,Fail,43,42,1,14,29
40,Fail,49,37,0,12,37
40,Fail,50,35,4,11,39
40,Fail,50,33,3,14,36
40,Fail,45,33,0,12,33
40,Fail,48,35,0,12,36
40,Fail,47,37,0,12,35
40,Fail,47,41,1,11,36
40,Fail,49,36,2,13,36
40,Fail,46,29,0,22,24
40,Fail,45,41,0,13,32
40,Success,58,28,6,8,50
40,Success,56,30,0,12,44
40,Fail,51,29,8,12,39
40,Fail,45,39,0,16,29
40,Fail,44,42,0,8,36
40,Success,56,30,0,12,44
40,Fail,47,34,0,17,30
40,Fail,50,32,0,11,39
40,Fail,50,31,7,12,38
40,Fail,44,31,12,13,31
40,Fail,43,35,0,17,26
40,Fail,46,37,4,13,33
40,Fail,39,45,0,13,26
40,Success,54,33,0,8,46
40,Fail,45,36,0,16,29
40,Fail,42,41,7,10,32
40,Fail,48,30,0,10,38
40,Fail,48,35,1,16,32
40,Fail,43,29,11,17,26
40,Fail,44,43,0,11,33
40,Fail,44,36,3,17,27
40,Fail,47,34,10,9,38
40,Success,54,34,0,11,43
40,Fail,49,36,4,11,38
40,Success,53,38,1,8,45
40,Fail,51,30,0,15,36
40,Fail,49,28,0,11,38
40,Fail,50,32,3,15,35
40,Fail,47,41,3,9,38
40,Fail,43,37,6,14,29
40,Fail,47,29,8,16,31
40,Fail,47,31,0,16,31
40,Fail,47,37,0,12,35
40,Fail,49,30,11,10,39
40,Fail,44,48,0,7,37
40,Fail,48,34,0,12,36
40,Success,49,39,6,6,43
40,Fail,51,27,0,16,35
40,Fail,40,42,0,15,25
40,Success,53,34,5,8,45
40,Fail,45,32,0,12,33
40,Fail,43,41,6,10,33
40,Fail,45,45,0,10,35
40,Fail,49,31,6,14,35
40,Fail,46,33,6,15,31
40,Fail,48,35,0,11,37
40,Success,53,41,1,5,48
40,Fail,44,43,0,13,31
40,Success,51,37,0,11,40
40,Fail,50,31,7,12,38
40,Fail,38,39,6,17,21
40,Success,54,29,4,13,41
40,Fail,48,37,0,12,36
40,Fail,51,28,9,12,39
40,Fail,48,37,2,13,35
40,Fail,47,36,2,15,32
40,Success,50,40,3,7,43
40,Success,55,29,0,13,42
40,Fail,45,38,4,13,32
40,Fail,47,36,0,12,35
40,Fail,48,32,5,15,33
40,Fail,40,42,4,14,26
40,Fail,44,34,7,15,29
40,Fail,46,37,2,15,31
40,Fail,46,39,0,15,31
40,Success,55,31,8,6,49
40,Fail,50,33,2,15,35
40,Fail,43,42,3,12,31
40,Fail,48,32,9,11,37
40,Fail,46,32,5,17,29
40,Success,55,39,0,6,49
40,Fail,51,35,0,14,37
40,Fail,39,38,12,11,28
40,Fail,47,44,0,8,39
40,Fail,49,38,2,11,38
40,Fail,48,38,0,14,34
40,Fail,45,40,0,15,30
40,Fail,40,43,0,15,25
40,Success,54,33,0,12,42
40,Success,54,34,0,10,44
40,Fail,45,35,0,9,36
40,Fail,42,42,0,14,28
40,Success,59,27,1,13,46
40,Fail,44,30,14,12,32
40,Fail,42,33,13,12,30
40,Fail,49,27,3,21,28
40,Fail,46,41,0,11,35
40,Fail,50,35,1,14,36
40,Fail,42,36,0,14,28
40,Fail,42,37,0,19,23
40,Fail,46,35,7,12,34
40,Fail,48,36,2,14,34
40,Fail,47,36,0,17,30
40,Fail,47,38,0,13,34
40,Success,51,35,4,10,41
40,Fail,46,38,0,14,32
40,Fail,47,32,0,13,34
40,Success,49,27,15,9,40
40,Success,50,36,0,6,44
40,Fail,49,35,0,10,39
40,Fail,42,37,3,18,24
40,Fail,50,29,6,15,35
40,Fail,49,41,0,10,39
40,Success,61,23,0,13,48
40,Fail,53,25,0,16,37
40,Fail,49,34,0,12,37
40,Fail,49,30,1,20,29
40,Success,47,46,0,7,40
40,Success,52,32,0,11,41
40,Fail,49,35,0,13,36
40,Fail,43,41,4,12,31
40,Fail,50,30,0,16,34
40,Fail,40,41,0,15,25
40,Fail,45,42,1,12,33
40,Fail,46,34,5,15,31
40,Success,50,37,4,9,41
40,Fail,51,32,5,12,39
40,Success,50,40,7,3,47
40,Success,47,43,0,7,40
40,Fail,47,36,3,14,33
40,Success,50,33,7,10,40
40,Fail,46,36,3,15,31
40,Success,52,32,0,10,42
40,Fail,44,38,6,12,32
40,Fail,44,40,9,7,37
40,Fail,49,34,0,14,35
40,Fail,51,37,0,12,39
40,Fail,43,38,2,17,26
40,Fail,39,36,0,17,22
40,Fail,43,36,0,17,26
40,Fail,49,33,4,14,35
40,Fail,46,40,3,11,35
40,Success,53,35,0,11,42
40,Fail,47,31,12,10,37
40,Fail,45,33,0,14,31
40,Success,54,32,0,13,41
40,Fail,44,39,0,11,33
40,Fail,48,29,5,18,30
40,Fail,43,34,0,11,32
40,Fail,49,36,0,13,36
40,Fail,48,36,4,12,36
40,Fail,41,36,0,15,26
40,Fail,46,38,0,16,30
40,Fail,48,37,0,13,35
40,Fail,50,34,0,11,39
40,Success,60,34,0,5,55
40,Fail,44,38,5,13,31
40,Success,51,42,0,7,44
40,Fail,44,44,0,9,35
40,Fail,41,39,3,17,24
40,Fail,48,37,2,13,35
40,Fail,43,37,0,19,24
40,Fail,42,38,9,11,31
40,Fail,42,39,0,15,27
40,Success,54,30,0,10,44
40,Success,51,36,3,10,41
40,Fail,49,31,5,15,34
40,Fail,45,39,0,11,34
40,Success,51,34,0,8,43
40,Fail,44,37,3,16,28
40,Fail,43,31,0,19,24
40,Fail,47,38,1,14,33
40,Fail,46,35,5,14,32
40,Fail,47,34,0,16,31
40,Fail,52,32,2,14,38
40,Success,55,29,0,12,43
40,Success,55,35,2,8,47
40,Fail,37,44,3,16,21
40,Fail,51,29,6,14,37
40,Success,52,36,5,7,45
40,Fail,33,35,0,19,14
40,Fail,50,34,5,11,39
40,Fail,43,40,0,15,28
40,Fail,49,31,0,14,35
40,Success,47,39,0,7,40
40,Success,51,37,3,9,42
40,Success,57,26,9,8,49
40,Fail,47,36,4,13,34
40,Success,50,36,5,9,41
40,Fail,46,37,0,13,33
40,Fail,48,40,2,10,38
40,Fail,46,39,0,11,35
40,Fail,45,37,0,14,31
40,Fail,45,39,1,15,30
40,Fail,51,32,0,16,35
40,Success,62,27,1,10,52
40,Fail,48,40,0,11,37
40,Fail,47,35,6,12,35
40,Success,53,32,0,12,41
40,Success,52,32,6,10,42
40,Fail,51,36,0,13,38
40,Fail,48,33,0,19,29
40,Success,56,31,0,8,48
40,Fail,50,31,0,11,39
40,Fail,49,32,6,13,36
40,Fail,43,33,0,12,31
40,Fail,47,38,0,11,36
40,Fail,41,43,0,16,25
40,Fail,42,40,0,9,33
40,Fail,46,36,0,16,30
40,Fail,48,35,0,13,35
40,Success,59,30,5,6,53
40,Fail,46,33,6,15,31
40,Fail,45,39,3,13,32
40,Success,52,37,3,8,44
40,Fail,53,27,6,14,39
40,Fail,49,35,0,16,33
40,Fail,41,40,0,16,25
40,Fail,41,35,0,18,23
40,Success,56,32,0,11,45
40,Fail,52,31,2,15,37
40,Success,53,40,2,5,48
40,Fail,47,36,5,12,35
40,Success,52,37,0,11,41
40,Success,52,37,0,9,43
40,Fail,47,40,0,9,38
40,Fail,46,35,5,14,32
40,Fail,51,27,0,16,35
40,Fail,38,50,1,11,27
40,Fail,43,39,7,11,32
40,Fail,43,41,2,14,29
40,Fail,43,36,10,11,32
40,Success,52,38,2,8,44
40,Fail,49,36,5,10,39
40,Success,52,36,5,7,45
40,Fail,49,36,1,14,35
40,Fail,48,35,0,13,35
40,Fail,52,31,0,13,39
40,Success,56,32,0,5,51
40,Fail,42,39,4,15,27
40,Fail,46,41,4,9,37
40,Fail,48,28,7,17,31
40,Fail,48,32,0,17,31
40,Fail,42,35,9,14,28
40,Fail,45,37,0,14,31
40,Fail,45,35,0,18,27
40,Fail,44,32,0,13,31
40,Fail,51,31,0,12,39
40,Success,53,39,2,6,47
40,Fail,52,34,0,14,38
40,Success,52,39,0,9,43
40,Fail,47,42,0,9,38
40,Fail,46,32,0,20,26
40,Fail,47,24,7,22,25
40,Success,53,35,1,11,42
40,Fail,48,36,0,12,36
40,Fail,47,38,0,13,34
40,Success,53,28,7,12,41
40,Fail,45,43,2,10,35
40,Fail,45,30,2,23,22
40,Fail,50,31,7,12,38
40,Fail,48,41,0,11,37
40,Fail,45,42,1,12,33
40,Fail,42,39,2,17,25
40,Fail,49,38,0,10,39
40,Fail,51,31,0,17,34
40,Fail,47,39,2,12,35
40,Success,56,34,0,9,47
40,Fail,44,28,0,19,25
40,Fail,42,41,6,11,31
40,Fail,49,35,3,13,36
40,Fail,50,31,0,14,36
40,Fail,39,34,0,18,21
40,Success,53,32,3,12,41
40,Fail,47,30,7,16,31
40,Fail,51,35,1,13,38
40,Fail,44,38,0,12,32
40,Success,49,36,0,9,40
40,Success,53,32,2,13,40
40,Fail,45,39,4,12,33
40,Fail,48,39,0,13,35
40,Success,49,40,4,7,42
40,Fail,45,36,0,12,33
40,Fail,43,44,0,9,34
40,Fail,46,30,5,19,27
40,Fail,47,35,1,17,30
40,Fail,43,36,6,15,28
40,Fail,43,41,6,10,33
40,Success,52,33,6,9,43
40,Fail,47,38,2,13,34
40,Fail,52,28,0,17,35
40,Fail,39,39,0,13,26
40,Fail,42,37,8,13,29
40,Fail,50,34,0,11,39
40,Fail,43,36,0,18,25
40,Fail,48,29,7,16,32
40,Fail,46,36,0,18,28
40,Fail,52,34,1,13,39
40,Fail,49,34,2,15,34
40,Fail,37,41,0,14,23
40,Fail,43,40,0,9,34
40,Success,52,38,2,8,44
40,Fail,54,28,2,16,38
40,Fail,49,37,2,12,37
40,Fail,47,40,0,13,34
40,Fail,48,36,7,9,39
40,Fail,43,42,5,10,33
40,Fail,42,39,0,15,27
40,Success,51,34,6,9,42
40,Fail,45,42,0,13,32
40,Fail,44,41,0,15,29
40,Fail,46,35,5,14,32
40,Fail,49,33,5,13,36
40,Success,59,34,2,5,54
40,Success,53,30,0,13,40
40,Fail,40,39,0,13,27
40,Fail,44,41,0,12,32
40,Fail,41,34,7,18,23
40,Fail,48,37,0,13,35
40,Fail,51,30,0,17,34
40,Fail,51,32,2,15,36
40,Fail,45,38,0,16,29
40,Success,50,40,1,9,41
40,Success,53,34,0,11,42
40,Fail,35,44,8,13,22
40,Success,51,41,0,7,44
40,Fail,42,36,9,13,29
40,Fail,51,33,0,13,38
40,Success,51,37,2,10,41
40,Fail,44,30,10,16,28
40,Success,55,31,0,8,47
40,Fail,45,31,7,17,28
40,Fail,51,33,0,14,37
40,Fail,49,35,2,14,35
40,Fail,45,41,0,11,34
40,Fail,42,40,0,17,25
40,Fail,43,45,1,11,32
40,Fail,42,36,0,15,27
40,Fail,43,38,0,17,26
40,Fail,52,27,3,18,34
40,Fail,49,38,0,12,37
40,Fail,48,33,0,11,37
40,Fail,40,36,5,19,21
40,Success,52,33,6,9,43
40,Fail,49,32,4,15,34
40,Fail,49,34,0,13,36
40,Fail,47,33,7,13,34
40,Fail,45,41,3,11,34
40,Fail,46,37,5,12,34
40,Fail,46,41,2,11,35
40,Success,52,29,8,11,41
40,Success,51,30,8,11,40
40,Fail,51,34,0,13,38
40,Fail,51,30,2,17,34
40,Fail,46,41,0,10,36
40,Fail,45,33,0,17,28
40,Success,51,32,0,7,44
40,Fail,46,36,0,12,34
40,Fail,45,34,6,15,30
40,Fail,47,37,4,12,35
40,Fail,51,27,0,16,35
40,Fail,49,35,0,10,39
40,Fail,43,42,0,15,28
40,Fail,46,38,0,9,37
40,Success,53,32,0,13,40
40,Fail,43,38,0,12,31
40,Fail,48,34,0,11,37
40,Success,53,30,0,13,40
40,Fail,49,29,0,21,28
40,Success,49,37,0,8,41
40,Fail,45,38,0,11,34
40,Fail,45,42,0,13,32
40,Fail,48,32,9,11,37
40,Fail,46,29,13,12,34
40,Success,55,35,1,9,46
40,Fail,45,44,4,7,38
40,Fail,47,32,9,12,35
40,Fail,41,42,1,16,25
40,Success,53,36,0,8,45
40,Fail,50,35,0,13,37
40,Fail,35,45,0,15,20
40,Fail,47,36,0,16,31
40,Fail,50,34,0,13,37
40,Success,56,29,0,12,44
40,Fail,48,40,0,11,37
40,Fail,49,28,0,12,37
40,Success,51,36,4,9,42
40,Fail,46,44,0,9,37
40,Success,51,31,9,9,42
40,Success,48,44,0,8,40
40,Fail,39,46,2,13,26
40,Fail,50,31,0,13,37
40,Success,50,36,0,8,42
40,Fail,47,36,0,13,34
40,Success,54,35,4,7,47
40,Fail,47,36,0,12,35
40,Fail,46,26,0,17,29
40,Success,52,38,6,4,48
40,Success,48,33,0,8,40
40,Fail,37,41,7,15,22
40,Fail,35,40,10,15,20
40,Fail,52,31,0,14,38
40,Fail,47,38,5,10,37
40,Fail,46,38,0,11,35
40,Fail,43,30,0,18,25
40,Fail,44,37,6,13,31
40,Fail,47,34,9,10,37
40,Fail,50,36,1,13,37
40,Fail,45,42,0,13,32
40,Success,54,33,0,11,43
40,Fail,47,31,0,14,33
40,Fail,44,37,6,13,31
40,Fail,49,31,0,10,39
40,Fail,51,34,3,12,39
40,Success,51,37,3,9,42
40,Fail,48,34,0,13,35
40,Success,54,37,1,8,46
40,Fail,46,34,0,9,37
40,Fail,46,36,0,14,32
40,Fail,49,28,8,15,34
40,Fail,46,30,8,16,30
40,Fail,42,29,0,21,21
40,Fail,39,41,0,12,27
40,Fail,46,30,11,13,33
40,Fail,45,38,0,15,30
40,Fail,44,37,4,15,29
40,Success,59,28,0,7,52
40,Fail,42,36,10,12,30
40,Success,58,29,0,8,50
40,Fail,49,36,0,15,34
40,Success,51,30,0,10,41
40,Success,51,36,0,11,40
40,Fail,49,28,0,16,33
40,Success,53,36,1,10,43
40,Fail,38,31,0,24,14
40,Fail,41,38,8,13,28
40,Fail,49,38,3,10,39
40,Fail,49,32,2,17,32
40,Fail,45,31,11,13,32
40,Fail,46,34,0,12,34
40,Fail,43,38,3,16,27
40,Success,58,33,0,7,51
40,Success,47,40,6,7,40
40,Fail,48,35,0,12,36
40,Fail,47,38,0,11,36
40,Fail,46,38,3,13,33
40,Fail,44,34,9,13,31
40,Fail,47,43,2,8,39
40,Fail,34,48,0,16,18
40,Success,53,34,0,9,44
40,Success,50,35,0,9,41
40,Fail,43,35,0,13,30
40,Fail,50,29,0,20,30
40,Fail,52,32,3,13,39
40,Fail,47,36,3,14,33
40,Fail,48,38,0,12,36
40,Fail,46,37,8,9,37
40,Fail,40,41,2,17,23
40,Fail,38,39,12,11,27
40,Fail,51,34,0,12,39
40,Success,53,30,4,13,40
40,Fail,42,38,0,13,29
40,Success,52,32,0,12,40
40,Fail,49,35,2,14,35
40,Fail,50,35,1,14,36
40,Success,55,32,0,13,42
40,Fail,51,29,0,14,37
40,Success,60,21,7,12,48
40,Fail,51,36,0,12,39
40,Fail,51,34,0,12,39
40,Success,51,37,0,10,41
40,Fail,50,35,0,12,38
40,Fail,44,41,0,10,34
40,Success,50,35,7,8,42
40,Fail,43,47,1,9,34
40,Success,53,37,0,5,48
40,Success,53,29,0,10,43
40,Fail,44,37,0,13,31
40,Success,48,43,2,7,41
40,Success,55,29,5,11,44
40,Fail,48,37,0,13,35
40,Fail,40,37,11,12,28
40,Fail,36,44,0,15,21
40,Fail,42,40,5,13,29
40,Fail,46,38,7,9,37
40,Fail,45,36,0,19,26
40,Fail,54,24,5,17,37
40,Success,52,36,2,10,42
40,Fail,43,38,0,13,30
40,Fail,47,39,0,9,38
40,Fail,44,42,2,12,32
40,Fail,43,37,0,11,32
40,Success,53,34,1,12,41
40,Fail,48,37,2,13,35
40,Success,57,31,0,12,45
40,Success,50,41,0,9,41
40,Fail,51,36,1,12,39
40,Fail,43,36,5,16,27
40,Success,54,30,4,12,42
40,Fail,48,41,0,9,39
40,Fail,43,38,5,14,29
40,Fail,51,30,1,18,33
40,Fail,47,36,3,14,33
40,Fail,48,36,3,13,35
40,Success,55,35,2,8,47
40,Fail,45,36,0,19,26
40,Fail,50,34,0,14,36
40,Success,52,36,0,6,46
40,Fail,45,40,3,12,33
40,Success,57,29,2,12,45
40,Fail,49,34,0,11,38
40,Success,59,32,3,6,53
40,Fail,38,42,5,15,23
40,Success,52,31,5,12,40
40,Fail,48,37,0,12,36
40,Fail,50,32,5,13,37
40,Success,52,37,0,11,41
40,Fail,40,37,7,16,24
40,Fail,51,31,0,14,37
40,Success,58,35,0,6,52
40,Fail,44,40,6,10,34
40,Success,57,26,6,11,46
40,Fail,47,33,0,14,33
40,Fail,50,35,2,13,37
40,Fail,41,46,0,12,29
40,Fail,41,33,0,9,32
40,Fail,40,36,12,12,28
40,Fail,45,40,0,10,35
40,Fail,48,34,4,14,34
40,Fail,44,38,4,14,30
40,Success,56,30,3,11,45
40,Fail,48,27,0,19,29
40,Fail,45,37,0,16,29
40,Fail,46,30,4,20,26
40,Fail,49,36,0,12,37
40,Fail,45,43,1,11,34
40,Success,50,40,0,10,40
40,Fail,44,39,0,13,31
40,Fail,46,37,4,13,33
40,Fail,47,31,0,14,33
40,Success,51,36,0,9,42
40,Fail,46,40,5,9,37
40,Fail,48,38,0,11,37
40,Fail,44,36,3,17,27
40,Success,57,30,1,12,45
40,Fail,52,30,0,15,37
40,Fail,50,36,0,11,39
40,Fail,51,31,6,12,39
40,Success,52,39,0,9,43
40,Fail,47,38,0,13,34
40,Fail,38,41,4,17,21
40,Success,55,31,1,13,42
40,Fail,49,36,3,12,37
40,Fail,47,34,0,12,35
40,Fail,50,31,6,13,37
40,Fail,40,38,9,13,27
40,Fail,44,39,0,12,32
40,Success,52,32,4,12,40
40,Fail,40,37,6,17,23
40,Fail,45,45,2,8,37
40,Fail,52,32,0,14,38
40,Fail,43,36,7,14,29
40,Fail,52,30,0,13,39
40,Fail,46,36,0,14,32
40,Success,51,28,10,11,40
40,Success,52,28,0,12,40
40,Fail,54,31,0,15,39
40,Fail,48,38,3,11,37
40,Fail,50,36,2,12,38
40,Fail,51,25,8,16,35
40,Fail,48,35,0,13,35
40,Fail,43,32,7,18,25
40,Fail,47,40,2,11,36
40,Fail,42,35,14,9,33
40,Fail,48,39,2,11,37
40,Fail,49,28,4,19,30
40,Success,54,30,11,5,49
40,Fail,50,38,0,12,38
40,Success,60,29,1,10,50
40,Fail,51,34,0,13,38
40,Fail,46,34,4,16,30
40,Success,53,33,0,11,42
40,Fail,49,36,3,12,37
40,Fail,47,33,12,8,39
40,Success,49,41,0,8,41
40,Fail,43,37,0,12,31
40,Fail,49,34,0,15,34
40,Fail,47,31,10,12,35
40,Fail,48,33,0,14,34
40,Fail,45,33,0,14,31
40,Success,52,35,2,11,41
40,Success,54,33,0,13,41
40,Fail,47,32,0,12,35
40,Fail,43,40,4,13,30
40,Fail,46,36,0,12,34
40,Success,53,35,3,9,44
40,Fail,47,34,0,13,34
40,Fail,44,35,0,14,30
40,Success,58,29,0,9,49
40,Fail,48,25,0,13,35
40,Success,61,31,0,8,53
40,Fail,45,38,0,10,35
40,Fail,51,32,0,15,36
40,Fail,46,40,0,11,35
40,Fail,42,33,0,12,30
40,Fail,44,43,0,12,32
40,Success,55,36,0,6,49
40,Success,51,32,7,10,41
40,Success,51,39,0,7,44
40,Success,50,36,4,10,40
40,Fail,45,35,0,15,30
40,Success,51,30,0,9,42
40,Fail,48,37,1,14,34
40,Success,54,35,0,9,45
40,Fail,48,39,0,11,37
40,Fail,46,34,0,11,35
40,Fail,43,34,0,8,35
40,Fail,46,43,0,11,35
40,Success,51,36,0,11,40
40,Fail,48,37,0,11,37
40,Fail,50,33,6,11,39
40,Fail,49,35,6,10,39
40,Success,49,42,0,9,40
40,Fail,49,33,5,13,36
40,Fail,43,27,8,22,21
40,Success,51,30,10,9,42
40,Success,53,37,0,9,44
40,Success,57,31,0,12,45
40,Fail,46,36,3,15,31
40,Fail,45,41,1,13,32
40,Success,56,35,0,9,47
40,Fail,51,35,0,14,37
40,Fail,38,39,6,17,21
40,Fail,47,33,9,11,36
40,Fail,40,45,1,14,26
40,Fail,48,33,8,11,37
40,Fail,44,40,0,10,34
40,Success,49,44,1,6,43
40,Fail,44,30,0,18,26
40,Fail,40,29,17,14,26
40,Fail,41,36,1,22,19
40,Success,54,32,1,13,41
40,Fail,43,40,3,14,29
40,Success,52,31,7,10,42
40,Fail,45,37,0,14,31
40,Fail,43,37,0,16,27
40,Fail,42,40,0,10,32
40,Success,57,31,1,11,46
40,Success,51,37,1,11,40
40,Fail,47,34,0,13,34
40,Fail,46,41,0,10,36
40,Fail,51,33,1,15,36
40,Fail,46,33,2,19,27
40,Fail,43,39,4,14,29
40,Fail,39,39,4,18,21
40,Fail,50,36,0,14,36
40,Fail,37,50,3,10,27
40,Fail,48,33,3,16,32
40,Fail,45,38,0,7,38
40,Fail,42,44,0,10,32
40,Success,49,41,1,9,40
40,Fail,47,34,0,13,34
40,Success,53,39,0,7,46
40,Fail,44,34,6,16,28
40,Fail,48,34,0,17,31
40,Fail,37,42,3,18,19
40,Fail,54,28,0,15,39
40,Fail,47,37,1,15,32
40,Success,56,30,0,13,43
40,Fail,46,34,0,15,31
40,Success,53,34,0,11,42
40,Fail,51,33,4,12,39
40,Fail,39,47,0,14,25
40,Success,50,41,0,7,43
40,Fail,45,35,0,10,35
40,Success,53,32,5,10,43
40,Fail,47,39,0,13,34
40,Fail,49,36,0,13,36
40,Fail,50,32,0,15,35
40,Fail,50,33,0,15,35
40,Success,51,34,0,9,42
40,Fail,47,30,0,15,32
40,Fail,45,41,2,12,33
40,Fail,48,28,9,15,33
40,Fail,44,42,4,10,34
40,Fail,44,40,0,10,34
40,Fail,47,31,4,18,29
40,Success,56,36,1,7,49
40,Fail,42,37,8,13,29
40,Fail,51,29,0,13,38
40,Success,53,33,1,13,40
40,Success,48,39,0,6,42
40,Fail,51,29,0,12,39
40,Success,54,34,0,11,43
40,Fail,50,36,1,13,37
40,Fail,47,40,1,12,35
40,Fail,51,28,0,16,35
40,Success,54,35,0,9,45
40,Fail,49,32,0,11,38
40,Fail,44,41,0,11,33
40,Success,59,31,0,9,50
40,Fail,50,32,3,15,35
40,Success,53,28,0,12,41
40,Fail,43,42,5,10,33
40,Success,51,32,6,11,40
40,Fail,45,35,3,17,28
40,Success,53,37,0,10,43
40,Success,50,41,0,7,43
40,Fail,46,40,0,13,33
40,Success,54,35,0,8,46
40,Fail,47,36,0,12,35
40,Fail,49,31,0,13,36
40,Fail,48,43,0,9,39
40,Fail,43,32,0,17,26
40,Fail,52,28,0,19,33
40,Success,50,37,4,9,41
40,Fail,45,36,4,15,30
40,Success,52,36,2,10,42
40,Fail,42,42,0,11,31
40,Fail,48,36,0,10,38
40,Fail,48,37,0,12,36
40,Fail,50,37,0,13,37
40,Success,54,38,0,8,46
40,Success,51,38,3,8,43
40,Fail,51,34,0,12,39
40,Fail,45,42,2,11,34
40,Fail,46,33,0,18,28
40,Fail,45,40,5,10,35
40,Fail,51,31,3,15,36
40,Fail,49,37,0,14,35
40,Fail,44,39,0,13,31
40,Fail,45,36,0,19,26
40,Fail,44,36,2,18,26
40,Fail,43,43,2,12,31
40,Fail,42,39,0,15,27
40,Fail,46,37,2,15,31
40,Fail,45,36,0,7,38
40,Success,51,38,1,10,41
40,Fail,47,32,0,11,36
40,Fail,47,39,0,13,34
40,Fail,51,34,0,12,39
40,Fail,45,31,0,18,27
40,Fail,46,40,0,11,35
40,Fail,52,30,2,16,36
40,Fail,42,40,0,15,27
40,Success,51,35,3,11,40
40,Success,48,44,0,6,42
40,Fail,48,35,6,11,37
40,Success,54,33,0,13,41
40,Fail,47,43,2,8,39
40,Fail,40,34,4,22,18
40,Fail,43,34,0,16,27
40,Fail,51,33,0,15,36
40,Fail,41,42,7,10,31
40,Success,53,35,0,6,47
40,Fail,48,30,3,19,29
40,Success,46,33,0,6,40
40,Fail,47,38,2,13,34
40,Fail,41,31,9,19,22
40,Fail,50,34,0,16,34
40,Success,47,48,1,4,43
40,Fail,43,33,4,20,23
40,Fail,44,31,7,18,26
40,Success,54,29,0,14,40
40,Fail,49,35,6,10,39
40,Fail,47,42,1,10,37
40,Fail,43,38,0,19,24
40,Fail,51,34,0,12,39
40,Success,56,32,3,9,47
40,Success,57,30,0,12,45
40,Success,50,39,0,10,40
40,Fail,45,37,3,15,30
40,Fail,48,31,0,11,37
40,Success,55,29,2,14,41
40,Fail,45,35,6,14,31
40,Fail,40,39,6,15,25
40,Success,48,41,3,8,40
40,Success,53,34,1,12,41
40,Fail,51,29,0,16,35
40,Fail,45,39,0,12,33
40,Fail,51,30,0,16,35
40,Fail,50,35,2,13,37
40,Fail,47,42,1,10,37
40,Fail,48,32,0,14,34
40,Fail,46,38,1,15,31
40,Fail,39,35,0,11,28
40,Success,51,35,0,11,40
40,Success,57,29,4,10,47
40,Fail,52,32,2,14,38
40,Fail,42,38,4,16,26
40,Fail,44,38,0,17,27
40,Success,49,42,2,7,42
40,Success,49,42,0,9,40
40,Fail,48,36,0,15,33
40,Success,55,31,0,12,43
40,Success,51,38,1,10,41
40,Fail,48,37,0,13,35
40,Success,48,36,8,8,40
40,Fail,50,33,0,14,36
40,Success,46,44,7,3,43
40,Fail,50,28,10,12,38
40,Fail,46,39,0,9,37
40,Fail,37,42,0,19,18
40,Fail,50,27,2,21,29
40,Fail,49,32,1,18,31
40,Success,56,32,0,11,45
40,Success,59,26,0,10,49
40,Fail,45,39,1,15,30
40,Fail,48,33,8,11,37
40,Fail,45,42,1,12,33
40,Fail,46,41,0,13,33
40,Success,53,36,0,6,47
40,Fail,44,43,0,11,33
40,Fail,47,38,0,11,36
40,Fail,44,44,3,9,35
40,Fail,51,25,10,14,37
40,Fail,51,33,0,13,38
40,Success,50,33,8,9,41
40,Fail,47,39,1,13,34
40,Success,52,37,0,10,42
40,Fail,55,27,2,16,39
40,Fail,42,37,0,16,26
40,Fail,38,31,0,18,20
40,Fail,42,42,0,10,32
40,Fail,49,28,11,12,37
40,Success,59,30,0,9,50
40,Success,55,32,1,12,43
40,Fail,49,34,0,12,37
40,Fail,51,32,0,15,36
40,Fail,45,35,0,14,31
40,Fail,53,28,2,17,36
40,Success,54,36,0,9,45
40,Fail,51,31,0,16,35
40,Success,59,28,0,12,47
40,Fail,41,40,0,12,29
40,Fail,48,33,7,12,36
40,Fail,41,39,0,14,27
40,Success,55,37,0,8,47
40,Fail,46,31,11,12,34
40,Fail,47,25,12,16,31
40,Success,52,36,0,8,44
40,Fail,45,39,2,14,31
40,Fail,52,34,0,13,39
40,Success,51,33,7,9,42
40,Success,60,29,2,9,51
40,Fail,51,29,8,12,39
40,Fail,52,31,4,13,39
40,Fail,47,25,9,19,28
40,Success,53,28,0,12,41
40,Fail,50,31,0,11,39
40,Success,53,30,4,13,40
40,Fail,48,29,0,16,32
40,Fail,43,33,0,18,25
40,Fail,41,34,5,20,21
40,Success,53,35,0,11,42
40,Fail,48,33,0,13,35
40,Fail,43,36,12,9,34
40,Fail,52,30,2,16,36
40,Fail,46,39,0,15,31
40,Fail,52,29,3,16,36
40,Fail,36,37,8,19,17
40,Fail,39,35,0,12,27
40,Success,50,41,0,7,43
40,Fail,45,43,0,8,37
40,Fail,48,36,0,12,36
40,Fail,51,30,0,14,37
40,Fail,49,33,5,13,36
40,Fail,50,30,0,18,32
40,Success,52,36,0,11,41
40,Fail,45,29,0,16,29
40,Success,50,37,4,9,41
40,Fail,48,30,0,13,35
40,Fail,52,34,0,13,39
40,Success,45,50,0,4,41
40,Fail,39,34,0,17,22
40,Success,53,37,4,6,47
40,Success,52,36,0,12,40
40,Fail,48,33,0,14,34
40,Fail,47,38,0,11,36
40,Fail,48,29,0,17,31
40,Success,53,35,0,9,44
40,Fail,41,39,0,19,22
40,Fail,47,38,0,12,35
40,Fail,51,35,1,13,38
40,Success,50,35,0,8,42
40,Success,54,33,0,11,43
40,Success,56,27,4,13,43
40,Fail,48,31,9,12,36
40,Success,50,32,0,8,42
40,Fail,49,28,7,16,33
40,Fail,48,29,9,14,34
40,Fail,51,34,0,15,36
40,Fail,47,35,0,17,30
40,Fail,45,31,9,15,30
40,Fail,44,43,5,8,36
40,Fail,45,29,14,12,33
40,Fail,49,37,0,10,39
40,Success,50,34,0,6,44
40,Fail,51,32,0,16,35
40,Fail,46,35,7,12,34
40,Fail,42,44,5,9,33
40,Success,54,33,3,10,44
40,Fail,46,42,0,12,34
40,Success,57,27,3,13,44
40,Fail,51,34,2,13,38
40,Fail,42,45,1,12,30
40,Fail,51,35,1,13,38
40,Fail,49,34,0,15,34
40,Fail,46,43,0,9,37
40,Success,56,31,0,8,48
40,Fail,48,38,0,13,35
40,Fail,45,40,0,13,32
40,Fail,44,40,5,11,33
40,Fail,48,37,0,14,34
40,Fail,46,40,5,9,37
40,Fail,41,48,0,11,30
40,Fail,49,35,5,11,38
40,Success,51,32,0,11,40
40,Fail,50,35,2,13,37
40,Fail,49,31,0,18,31
40,Success,52,35,1,12,40
40,Fail,48,30,0,15,33
40,Success,56,28,0,8,48
40,Fail,44,33,5,18,26
40,Fail,46,40,2,12,34
40,Success,50,33,0,10,40
40,Fail,41,41,0,11,30
40,Fail,49,32,4,15,34
40,Fail,46,40,1,13,33
40,Fail,45,39,0,15,30
40,Fail,45,42,0,8,37
40,Fail,38,35,9,18,20
40,Success,49,43,0,8,41
40,Fail,47,39,0,12,35
40,Fail,44,39,5,12,32
40,Success,54,26,0,12,42
40,Success,59,25,4,12,47
40,Fail,43,34,8,15,28
40,Success,50,37,3,10,40
40,Fail,39,37,8,16,23
40,Success,52,30,9,9,43
40,Fail,41,36,0,21,20
40,Fail,37,41,9,13,24
40,Fail,51,32,0,15,36
40,Success,55,34,2,9,46
40,Fail,45,43,0,12,33
40,Fail,50,39,0,11,39
40,Fail,36,42,0,13,23
40,Fail,45,40,0,12,33
40,Success,51,39,0,10,41
40,Success,54,39,0,6,48
40,Fail,55,24,0,17,38
40,Fail,47,40,0,12,35
40,Fail,44,35,0,16,28
40,Success,53,37,0,7,46
40,Fail,38,36,9,17,21
40,Fail,44,37,9,10,34
40,Fail,50,33,6,11,39
40,Success,54,34,0,11,43
40,Fail,44,44,0,12,32
40,Fail,31,40,0,23,8
40,Fail,44,33,6,17,27
40,Fail,42,46,0,12,30
40,Fail,43,33,0,19,24
40,Fail,44,35,1,20,24
40,Success,51,39,0,9,42
40,Fail,47,30,6,17,30
40,Fail,43,47,0,8,35
40,Fail,45,40,0,12,33
40,Fail,48,33,4,15,33
40,Success,58,29,0,12,46
40,Success,55,29,4,12,43
40,Success,53,39,0,7,46
40,Success,52,36,0,12,40
40,Fail,41,33,0,14,27
40,Success,53,30,0,5,48
40,Fail,41,34,8,17,24
40,Success,52,33,5,10,42
40,Fail,41,40,0,18,23
40,Fail,50,35,0,12,38
40,Fail,52,32,0,14,38
40,Fail,46,39,1,14,32
40,Fail,45,34,8,13,32
40,Fail,49,32,4,15,34
40,Success,53,34,0,11,42
40,Fail,46,36,5,13,33
40,Success,52,38,1,9,43
40,Success,55,30,5,10,45
40,Success,52,35,0,11,41
40,Fail,50,33,6,11,39
40,Success,51,35,3,11,40
40,Success,53,37,0,9,44
40,Fail,43,38,0,14,29
40,Fail,51,34,0,14,37
40,Fail,47,42,0,11,36
40,Fail,47,35,0,15,32
40,Success,52,35,0,9,43
40,Fail,39,49,1,11,28
40,Fail,47,33,11,9,38
40,Success,50,42,0,8,42
40,Success,56,31,0,13,43
40,Success,51,38,0,11,40
40,Fail,47,35,0,13,34
40,Fail,43,35,9,13,30
40,Success,54,32,0,12,42
40,Fail,52,29,0,14,38
40,Fail,49,32,1,18,31
40,Fail,50,31,3,16,34
40,Fail,44,36,2,18,26
40,Success,49,43,0,6,43
40,Fail,50,31,0,16,34
40,Fail,44,36,0,9,35
40,Success,58,33,1,8,50
40,Fail,38,39,11,12,26
40,Fail,45,31,8,16,29
40,Fail,46,36,0,13,33
40,Fail,42,34,10,14,28
40,Fail,52,31,1,16,36
40,Success,49,41,0,9,40
40,Success,53,31,0,11,42
40,Success,51,36,6,7,44
40,Success,54,33,3,10,44
40,Fail,48,36,0,15,33
40,Fail,49,36,0,14,35
40,Fail,48,38,4,10,38
40,Success,51,37,1,11,40
40,Fail,43,42,2,13,30
40,Fail,48,32,5,15,33
40,Fail,49,34,2,15,34
40,Fail,47,36,0,10,37
40,Success,52,29,7,12,40
40,Fail,50,32,0,15,35
40,Fail,44,29,12,15,29
40,Success,54,39,1,6,48
40,Fail,47,38,0,12,35
40,Success,50,44,0,6,44
40,Fail,45,32,8,15,30
40,Fail,43,34,8,15,28
40,Fail,48,33,10,9,39
40,Success,51,37,2,10,41
40,Success,54,28,0,14,40
40,Fail,46,45,0,8,38
40,Fail,51,31,2,16,35
40,Fail,47,35,6,12,35
40,Success,56,36,0,8,48
40,Fail,43,37,0,11,32
40,Success,49,40,0,9,40
40,Success,56,28,0,16,40
40,Success,53,25,9,13,40
40,Success,53,35,0,7,46
40,Success,54,32,0,10,44
40,Fail,46,36,0,17,29
40,Fail,47,34,0,15,32
40,Success,52,35,0,7,45
40,Fail,42,38,0,18,24
40,Fail,39,41,0,12,27
40,Fail,48,39,0,11,37
40,Success,56,27,2,15,41
40,Fail,45,36,2,17,28
40,Fail,47,42,2,9,38
40,Fail,41,33,0,15,26
40,Fail,48,39,0,9,39
40,Fail,48,39,0,9,39
40,Success,57,29,0,13,44
40,Success,50,39,0,10,40
40,Success,52,34,2,12,40
40,Fail,41,43,3,13,28
40,Fail,52,29,5,14,38
40,Fail,47,42,3,8,39
40,Fail,44,38,2,16,28
40,Fail,44,31,0,19,25
40,Fail,45,38,0,13,32
40,Fail,49,38,0,11,38
40,Fail,45,34,0,13,32
40,Fail,45,36,6,13,32
40,Fail,44,37,0,15,29
40,Success,54,30,2,14,40
40,Fail,43,44,3,10,33
40,Success,56,33,0,11,45
40,Fail,45,36,0,12,33
40,Fail,48,32,0,15,33
40,Fail,41,45,0,9,32
40,Success,52,34,3,11,41
40,Fail,41,40,1,18,23
40,Fail,51,37,0,12,39
40,Fail,45,41,0,12,33
40,Fail,47,40,4,9,38
40,Fail,51,33,0,12,39
40,Fail,43,34,0,15,28
40,Success,53,36,0,9,44
40,Fail,50,29,0,17,33
40,Fail,49,36,0,14,35
40,Fail,48,33,9,10,38
40,Fail,45,40,1,14,31
40,Fail,49,39,0,12,37
40,Fail,44,38,4,14,30
40,Fail,45,38,0,13,32
40,Success,54,36,3,7,47
40,Fail,34,40,0,16,18
40,Fail,45,40,3,12,33
40,Success,53,37,0,9,44
40,Fail,51,32,4,13,38
40,Success,56,31,0,11,45
40,Fail,44,38,0,18,26
40,Fail,43,35,0,17,26
40,Fail,48,31,0,12,36
40,Success,51,40,3,6,45
40,Fail,44,42,1,13,31
40,Success,51,33,6,10,41
40,Fail,47,32,4,17,30
40,Fail,45,36,0,19,26
40,Success,54,31,1,14,40
40,Fail,39,42,4,15,24
40,Fail,44,29,10,17,27
40,Fail,42,42,2,14,28
40,Fail,47,37,0,13,34
40,Fail,46,31,7,16,30
40,Fail,48,37,0,14,34
40,Success,53,37,3,7,46
40,Fail,44,36,0,9,35
40,Fail,47,35,0,10,37
40,Fail,50,34,5,11,39
40,Fail,43,38,3,16,27
40,Fail,44,43,0,10,34
40,Fail,47,36,2,15,32
40,Fail,38,39,0,13,25
40,Fail,46,32,0,16,30
40,Fail,44,38,0,12,32
40,Fail,49,31,0,19,30
40,Fail,51,34,3,12,39
40,Fail,43,37,0,11,32
40,Success,55,35,2,8,47
40,Fail,48,32,2,18,30
40,Fail,50,33,3,14,36
40,Fail,44,37,8,11,33
40,Fail,51,33,4,12,39
40,Fail,36,43,0,15,21
40,Fail,50,28,0,21,29
40,Success,53,31,3,13,40
40,Fail,42,45,3,10,32
40,Success,55,34,0,3,52
40,Success,47,38,0,6,41
40,Fail,43,42,0,13,30
40,Fail,46,34,0,7,39
40,Fail,44,42,1,13,31
40,Fail,45,36,5,14,31
40,Fail,44,34,3,19,25
40,Fail,45,34,4,17,28
40,Fail,43,37,0,20,23
40,Fail,36,33,10,21,15
40,Success,55,31,2,12,43
40,Fail,51,36,1,12,39
40,Fail,42,44,2,12,30
40,Fail,45,39,5,11,34
40,Fail,48,33,7,12,36
40,Fail,44,36,0,15,29
40,Success,53,36,0,10,43
40,Fail,49,37,1,13,36
40,Fail,42,42,2,14,28
40,Success,56,32,0,12,44
40,Fail,48,38,0,14,34
40,Fail,47,33,7,13,34
40,Fail,47,32,10,11,36
40,Fail,52,29,4,15,37
40,Success,53,35,0,12,41
40,Success,52,36,0,11,41
40,Fail,36,39,5,20,16
40,Fail,40,39,4,17,23
40,Fail,47,35,0,12,35
40,Fail,50,36,0,14,36
40,Fail,43,37,9,11,32
40,Fail,46,37,3,14,32
40,Fail,45,36,0,13,32
40,Fail,46,36,0,13,33
40,Success,53,38,2,7,46
40,Fail,44,40,4,12,32
40,Fail,45,34,5,16,29
40,Fail,45,37,5,13,32
40,Fail,54,26,0,18,36
40,Fail,45,26,10,19,26
40,Fail,45,35,0,17,28
40,Fail,47,37,0,16,31
40,Fail,46,39,2,13,33
40,Fail,49,32,0,16,33
40,Fail,48,35,6,11,37
40,Fail,37,41,8,14,23
40,Fail,52,32,0,13,39
40,Fail,43,39,0,14,29
40,Fail,44,37,6,13,31
40,Fail,44,44,0,6,38
40,Fail,39,39,12,10,29
40,Success,53,35,1,11,42
40,Fail,39,40,6,15,24
40,Fail,43,40,0,13,30
40,Fail,49,33,0,13,36
40,Success,51,36,0,7,44
40,Fail,46,31,0,11,35
40,Fail,47,37,0,15,32
40,Fail,45,43,0,12,33
40,Fail,47,43,1,9,38
40,Fail,48,38,1,13,35
40,Success,55,31,1,13,42
40,Fail,46,42,0,10,36
40,Fail,38,43,8,11,27
40,Success,55,30,6,9,46
40,Fail,48,39,2,11,37
40,Fail,44,40,6,10,34
40,Fail,51,34,0,13,38
40,Success,50,39,0,10,40
40,Success,47,40,7,6,41
40,Fail,42,42,0,14,28
40,Fail,50,36,0,14,36
40,Fail,45,40,0,12,33
40,Fail,48,36,7,9,39
40,Fail,41,36,5,18,23
40,Success,60,28,2,10,50
40,Success,56,32,2,10,46
40,Fail,53,29,0,15,38
40,Success,58,33,0,8,50
40,Success,57,33,0,10,47
40,Fail,50,34,0,12,38
40,Fail,45,32,3,20,25
40,Fail,47,42,0,9,38
40,Fail,50,33,5,12,38
40,Fail,41,42,0,15,26
40,Fail,51,34,0,13,38
40,Fail,47,40,0,11,36
40,Fail,51,28,0,15,36
40,Success,51,38,1,10,41
40,Success,53,31,0,10,43
40,Success,48,39,7,6,42
40,Fail,48,38,0,13,35
40,Fail,49,30,0,18,31
40,Fail,47,40,1,12,35
40,Fail,47,34,4,15,32
40,Fail,47,37,5,11,36
40,Fail,47,36,7,10,37
40,Fail,47,33,0,14,33
40,Fail,46,38,1,15,31
40,Fail,48,31,7,14,34
40,Fail,49,37,4,10,39
40,Fail,46,32,10,12,34
40,Fail,46,40,1,13,33
40,Fail,45,42,1,12,33
40,Fail,42,38,6,14,28
40,Fail,44,32,0,19,25
40,Fail,48,36,5,11,37
40,Success,50,40,2,8,42
40,Fail,44,37,10,9,35
40,Success,51,42,1,6,45
40,Fail,42,41,0,12,30
40,Fail,46,37,5,12,34
40,Success,58,31,0,10,48
40,Fail,45,37,0,13,32
40,Success,51,40,0,9,42
40,Success,51,39,0,6,45
40,Fail,40,42,0,16,24
40,Fail,45,45,0,10,35
40,Success,57,30,0,13,44
40,Success,56,33,0,9,47
40,Fail,51,32,0,12,39
40,Success,53,37,3,7,46
40,Fail,45,36,4,15,30
40,Fail,50,33,3,14,36
40,Fail,45,36,0,10,35
40,Fail,43,32,13,12,31
40,Fail,49,35,0,11,38
40,Fail,43,36,0,10,33
40,Fail,50,38,1,11,39
40,Fail,44,36,3,17,27
40,Fail,50,37,0,12,38
40,Fail,42,34,0,16,26
40,Success,50,41,0,9,41
40,Success,54,34,1,11,43
40,Fail,46,38,0,14,32
40,Fail,45,31,0,21,24
40,Fail,41,34,0,19,22
40,Fail,38,51,3,8,30
40,Fail,46,36,0,10,36
40,Fail,49,30,8,13,36
40,Fail,40,41,2,17,23
40,Success,50,37,3,10,40
40,Fail,51,30,1,18,33
40,Fail,40,37,0,11,29
40,Success,52,33,0,10,42
40,Fail,46,38,6,10,36
40,Fail,37,41,0,19,18
40,Fail,45,44,0,9,36
40,Fail,49,35,0,14,35
40,Success,53,32,3,12,41
40,Fail,43,42,4,11,32
40,Fail,54,28,2,16,38
40,Fail,44,29,2,25,19
40,Fail,45,29,0,14,31
40,Success,54,28,0,11,43
40,Fail,40,36,10,14,26
40,Fail,45,31,0,21,24
40,Success,49,34,8,9,40
40,Fail,45,40,1,14,31
40,Fail,38,43,0,16,22
40,Fail,47,38,0,14,33
40,Fail,46,37,0,11,35
40,Fail,48,37,0,12,36
40,Success,54,33,0,12,42
40,Fail,49,27,0,22,27
40,Fail,43,40,0,11,32
40,Fail,46,41,3,10,36
40,Fail,51,34,0,13,38
40,Fail,43,40,1,16,27
40,Fail,43,30,0,15,28
40,Fail,47,31,0,17,30
40,Fail,47,39,1,13,34
40,Fail,50,34,1,15,35
40,Fail,50,36,0,13,37
40,Fail,49,37,2,12,37
40,Success,54,31,1,14,40
40,Fail,43,35,8,14,29
40,Success,47,37,9,7,40
40,Fail,48,30,0,15,33
40,Fail,49,30,0,12,37
40,Fail,47,36,0,12,35
40,Fail,41,40,5,14,27
40,Success,49,43,1,7,42
40,Fail,41,33,6,20,21
40,Success,51,37,0,11,40
40,Fail,46,39,7,8,38
40,Fail,44,35,0,12,32
40,Success,49,44,0,6,43
40,Success,54,32,0,14,40
40,Fail,47,29,0,17,30
40,Fail,42,35,0,15,27
40,Success,59,33,2,6,53
40,Success,56,32,0,5,51
40,Fail,45,32,9,14,31
40,Fail,38,38,0,15,23
40,Fail,50,34,0,14,36
40,Success,55,35,0,8,47
40,Fail,47,34,6,13,34
40,Fail,47,32,5,16,31
40,Fail,50,31,7,12,38
40,Fail,45,42,2,11,34
40,Fail,45,47,1,7,38
40,Fail,48,31,11,10,38
40,Success,57,28,0,11,46
40,Success,56,31,0,13,43
40,Fail,44,36,7,13,31
40,Fail,49,37,0,10,39
40,Fail,46,36,0,10,36
40,Fail,49,41,0,10,39
40,Fail,46,40,0,12,34
40,Fail,38,42,0,17,21
40,Fail,45,39,0,16,29
40,Fail,50,27,0,13,37
40,Fail,43,35,0,15,28
40,Success,54,31,0,9,45
40,Success,59,27,3,11,48
40,Fail,45,41,3,11,34
40,Success,51,35,3,11,40
40,Fail,49,32,9,10,39
40,Fail,48,34,0,11,37
40,Fail,50,33,0,11,39
40,Fail,48,37,4,11,37
40,Fail,46,35,0,11,35
40,Fail,51,29,0,14,37
40,Success,59,29,0,9,50
40,Fail,49,34,7,10,39
40,Fail,44,33,0,19,25
40,Success,55,30,0,13,42
40,Fail,47,39,1,13,34
40,Success,52,35,0,9,43
40,Fail,44,40,0,13,31
40,Fail,42,37,0,20,22
40,Fail,45,43,0,11,34
40,Success,53,30,4,13,40
40,Fail,39,43,0,12,27
40,Success,49,38,4,9,40
40,Fail,45,37,4,14,31
40,Fail,45,46,1,8,37
40,Fail,40,41,0,16,24
40,Fail,46,33,7,14,32
40,Success,58,22,0,15,43
40,Fail,47,40,0,11,36
40,Success,49,35,0,8,41
40,Fail,39,37,7,17,22
40,Fail,40,42,2,16,24
40,Fail,52,26,0,14,38
40,Fail,42,32,13,13,29
40,Fail,49,33,0,16,33
40,Fail,45,37,0,18,27
40,Fail,51,31,0,16,35
40,Fail,39,33,9,19,20
40,Success,52,38,0,7,45
40,Success,54,33,3,10,44
40,Fail,46,34,2,18,28
40,Fail,45,39,4,12,33
40,Success,49,42,0,7,42
40,Fail,42,34,0,15,27
40,Success,52,31,0,8,44
40,Fail,51,32,0,12,39
40,Fail,46,40,0,13,33
40,Fail,44,40,4,12,32
40,Fail,43,34,5,18,25
40,Fail,38,42,10,10,28
40,Fail,49,32,0,18,31
40,Fail,48,35,0,13,35
40,Fail,43,35,1,21,22
40,Fail,42,35,0,16,26
40,Fail,48,35,0,11,37
40,Fail,43,37,4,16,27
40,Success,53,30,0,12,41
40,Fail,45,36,1,18,27
40,Fail,49,36,0,15,34
40,Fail,47,38,1,14,33
40,Fail,53,31,2,14,39
40,Fail,45,38,5,12,33
40,Success,52,36,0,9,43
40,Fail,49,31,0,13,36
40,Success,51,40,0,9,42
40,Fail,51,35,2,12,39
40,Fail,48,42,0,9,39
40,Fail,42,40,0,17,25
40,Fail,48,34,0,12,36
40,Fail,53,31,1,15,38
40,Fail,46,33,0,13,33
40,Fail,47,32,0,17,30
40,Fail,47,26,8,19,28
40,Fail,51,35,0,12,39
40,Fail,50,38,0,12,38
40,Fail,47,35,0,13,34
40,Success,51,36,4,9,42
40,Success,51,31,0,11,40
40,Fail,50,35,3,12,38
40,Fail,46,41,0,11,35
40,Success,60,29,5,6,54
40,Fail,49,36,0,11,38
40,Fail,49,36,0,14,35
40,Success,50,37,0,10,40
40,Fail,49,36,0,14,35
40,Fail,35,48,2,15,20
40,Success,51,32,0,10,41
40,Fail,54,31,0,15,39
40,Fail,50,33,0,15,35
40,Fail,49,34,1,16,33
40,Success,53,38,0,9,44
40,Fail,52,33,0,15,37
40,Fail,45,40,3,12,33
40,Fail,44,43,5,8,36
40,Fail,43,40,0,10,33
40,Fail,47,39,2,12,35
40,Fail,46,37,4,13,33
40,Fail,44,45,0,11,33
40,Fail,49,35,1,15,34
40,Fail,48,38,0,10,38
40,Success,50,39,4,7,43
40,Success,57,33,1,9,48
40,Success,55,30,0,14,41
40,Success,50,37,0,8,42
40,Fail,44,42,0,9,35
40,Success,51,33,0,9,42
40,Success,54,30,0,12,42
40,Fail,51,29,0,12,39
40,Fail,38,39,6,17,21
40,Fail,46,39,0,15,31
40,Fail,42,40,0,17,25
40,Success,48,43,1,8,40
40,Success,54,39,0,7,47
40,Fail,44,37,8,11,33
40,Fail,43,36,1,20,23
40,Success,52,32,4,12,40
40,Fail,39,39,8,14,25
40,Fail,48,33,0,16,32
40,Fail,53,31,1,15,38
40,Fail,44,32,8,16,28
40,Fail,49,33,0,14,35
40,Success,52,33,0,12,40
40,Fail,45,39,0,12,33
40,Fail,49,36,3,12,37
40,Success,50,40,0,9,41
40,Fail,48,38,0,11,37
40,Success,54,33,3,10,44
40,Success,52,30,0,11,41
40,Fail,49,35,0,10,39
40,Fail,50,29,0,18,32
40,Fail,42,46,0,11,31
40,Success,53,37,4,6,47
40,Fail,41,42,3,14,27
40,Fail,39,39,0,15,24
40,Fail,49,28,9,14,35
40,Fail,40,40,0,12,28
40,Fail,49,30,0,15,34
40,Fail,44,39,3,14,30
40,Fail,48,33,0,16,32
40,Success,58,35,0,6,52
40,Fail,48,32,6,14,34
40,Success,53,36,2,9,44
40,Fail,51,36,1,12,39
40,Fail,47,37,4,12,35
40,Fail,48,38,0,9,39
40,Fail,50,39,0,11,39
40,Fail,46,37,0,13,33
40,Success,53,27,0,13,40
40,Success,52,34,2,12,40
40,Fail,44,34,0,13,31
40,Fail,41,38,4,17,24
40,Success,53,34,6,7,46
40,Fail,51,34,0,12,39
40,Fail,49,34,1,16,33
40,Fail,46,43,0,10,36
40,Fail,37,34,0,23,14
40,Success,54,33,1,12,42
40,Fail,44,45,0,10,34
40,Success,54,29,3,14,40
40,Success,53,34,0,11,42
40,Fail,45,41,3,11,34
40,Fail,50,34,0,16,34
40,Fail,50,33,0,17,33
40,Success,50,32,9,9,41
40,Fail,46,38,0,13,33
40,Fail,44,41,0,8,36
40,Fail,48,29,0,16,32
40,Fail,46,38,0,10,36
40,Fail,50,30,3,17,33
40,Fail,45,38,2,15,30
40,Fail,42,38,0,11,31
40,Fail,42,40,5,13,29
40,Fail,48,35,0,11,37
40,Fail,43,40,0,14,29
40,Success,57,32,0,9,48
40,Fail,47,40,3,10,37
40,Fail,37,43,7,13,24
40,Success,51,33,5,11,40
40,Fail,47,36,0,16,31
40,Fail,48,36,0,16,32
40,Fail,46,38,0,12,34
40,Fail,41,37,9,13,28
40,Fail,49,36,2,13,36
40,Success,51,39,2,8,43
40,Fail,48,41,1,10,38
40,Fail,51,30,0,14,37
40,Fail,49,34,2,15,34
40,Fail,42,40,0,16,26
40,Success,53,37,3,7,46
40,Fail,44,32,11,13,31
40,Fail,44,37,0,12,32
40,Fail,46,34,0,15,31
40,Fail,41,40,4,15,26
40,Fail,43,34,0,15,28
40,Fail,42,38,0,16,26
40,Fail,50,34,1,15,35
40,Success,57,33,2,8,49
40,Success,51,36,0,9,42
40,Fail,38,36,9,17,21
40,Fail,53,32,1,14,39
40,Success,56,28,0,13,43
40,Success,53,32,5,10,43
40,Fail,46,35,4,15,31
40,Success,50,36,0,9,41
40,Fail,51,32,0,17,34
40,Fail,49,41,0,10,39
40,Fail,48,33,0,13,35
40,Fail,39,43,4,14,25
40,Fail,50,32,0,13,37
40,Fail,48,38,1,13,35
40,Success,58,27,1,14,44
40,Fail,48,31,0,17,31
40,Fail,48,36,0,14,34
40,Fail,47,36,6,11,36
40,Success,59,30,0,7,52
40,Success,53,33,0,9,44
40,Fail,45,38,7,10,35
40,Fail,50,36,0,12,38
40,Fail,47,41,0,9,38
40,Fail,43,36,0,15,28
40,Fail,50,32,0,13,37
40,Fail,44,35,3,18,26
40,Fail,51,32,0,17,34
40,Fail,50,36,0,11,39
40,Fail,42,41,0,12,30
40,Fail,51,33,0,12,39
40,Fail,47,41,1,11,36
40,Success,54,32,0,11,43
40,Fail,39,33,0,17,22
40,Success,51,34,5,10,41
40,Success,53,34,0,10,43
40,Success,54,32,2,12,42
40,Success,50,36,4,10,40
40,Fail,47,34,5,14,33
40,Fail,47,40,5,8,39
40,Success,55,33,1,11,44
40,Fail,52,35,0,13,39
40,Fail,46,36,2,16,30
40,Fail,51,35,0,14,37
40,Fail,47,40,0,12,35
40,Success,56,27,3,14,42
40,Fail,46,34,0,15,31
40,Fail,47,36,0,14,33
40,Fail,48,38,0,11,37
40,Fail,45,38,0,17,28
40,Fail,40,39,0,11,29
40,Fail,44,31,3,22,22
40,Fail,49,34,0,10,39
40,Success,51,33,9,7,44
40,Success,53,31,5,11,42
40,Fail,46,38,0,14,32
40,Fail,52,31,0,14,38
40,Fail,48,34,0,17,31
40,Success,54,33,5,8,46
40,Fail,42,38,0,16,26
40,Fail,44,34,0,15,29
40,Success,50,34,0,10,40
40,Fail,51,32,2,15,36
40,Fail,45,37,0,14,31
40,Fail,41,39,0,15,26
40,Fail,42,43,3,12,30
40,Fail,50,34,0,15,35
40,Fail,49,36,0,15,34
40,Fail,42,41,5,12,30
40,Fail,44,33,11,12,32
40,Fail,47,33,0,18,29
40,Success,57,31,2,10,47
40,Fail,47,37,6,10,37
40,Success,49,41,1,9,40
40,Fail,47,38,0,12,35
40,Success,54,35,0,10,44
40,Fail,46,36,0,16,30
40,Fail,48,36,4,12,36
40,Fail,44,38,0,14,30
40,Fail,46,40,1,13,33
40,Fail,46,32,0,19,27
40,Fail,45,38,0,13,32
40,Fail,46,41,0,13,33
40,Success,51,36,0,9,42
40,Fail,47,37,7,9,38
40,Fail,54,29,0,16,38
40,Fail,46,38,6,10,36
40,Success,50,37,0,10,40
40,Fail,43,40,1,16,27
40,Success,54,30,0,13,41
40,Fail,49,38,0,10,39
40,Success,51,36,0,11,40
40,Fail,47,36,6,11,36
40,Fail,47,32,0,17,30
40,Fail,40,43,1,16,24
40,Success,59,34,0,7,52
40,Fail,45,38,8,9,36
40,Fail,46,40,0,13,33
40,Success,56,32,1,11,45
40,Fail,49,34,0,13,36
40,Fail,46,36,8,10,36
40,Success,55,33,1,11,44
40,Success,54,36,1,9,45
40,Fail,50,35,0,15,35
40,Fail,48,41,1,10,38
40,Fail,49,37,0,10,39
40,Fail,45,45,0,10,35
40,Success,54,33,0,7,47
40,Fail,44,34,0,15,29
40,Fail,47,32,0,15,32
40,Success,53,30,5,12,41
40,Fail,52,29,3,16,36
40,Success,52,31,5,12,40
40,Success,50,41,1,8,42
40,Success,58,27,0,15,43
40,Fail,46,39,0,12,34
40,Fail,45,36,5,14,31
40,Success,53,29,5,13,40
40,Fail,45,38,1,16,29
40,Fail,50,37,1,12,38
40,Fail,50,33,1,16,34
40,Success,53,30,6,11,42
40,Fail,47,37,5,11,36
40,Fail,44,43,0,12,32
40,Success,49,41,1,9,40
40,Success,60,25,8,7,53
40,Fail,52,30,0,13,39
40,Fail,51,31,1,17,34
40,Fail,42,36,6,16,26
40,Fail,47,33,0,15,32
40,Success,52,31,11,6,46
40,Success,54,36,0,10,44
40,Fail,45,34,0,17,28
40,Fail,49,30,0,15,34
40,Fail,50,35,0,11,39
40,Fail,48,38,0,14,34
40,Fail,43,34,0,15,28
40,Success,51,35,0,10,41
40,Success,56,36,0,7,49
40,Fail,47,36,7,10,37
40,Fail,53,32,0,14,39
40,Fail,51,33,1,15,36
40,Success,56,29,8,7,49
40,Fail,52,30,3,15,37
40,Fail,43,45,0,6,37
40,Success,52,34,4,10,42
40,Fail,47,40,0,12,35
40,Fail,47,42,0,10,37
40,Fail,42,40,3,15,27
40,Success,52,35,5,8,44
40,Fail,43,37,0,15,28
40,Fail,37,37,0,15,22
40,Success,51,34,0,11,40
40,Fail,49,32,0,14,35
40,Fail,51,31,5,13,38
40,Success,49,44,0,6,43
40,Fail,46,32,6,16,30
40,Fail,49,31,0,15,34
40,Success,50,36,8,6,44
40,Success,52,39,0,9,43
40,Success,55,29,0,11,44
40,Fail,43,36,0,13,30
40,Fail,42,48,2,8,34
40,Fail,44,37,0,16,28
40,Fail,46,28,0,14,32
40,Fail,42,37,8,13,29
40,Fail,43,41,1,15,28
40,Success,59,29,0,11,48
40,Fail,44,43,0,7,37
40,Success,54,34,1,11,43
40,Fail,49,29,4,18,31
40,Success,58,26,5,11,47
40,Success,54,38,0,7,47
40,Fail,42,41,0,16,26
40,Success,49,37,0,9,40
40,Fail,42,35,0,15,27
40,Success,50,35,6,9,41
40,Fail,49,32,0,18,31
40,Fail,41,37,3,19,22
40,Fail,47,33,7,13,34
40,Fail,45,38,7,10,35
40,Fail,42,33,0,16,26
40,Fail,52,32,3,13,39
40,Fail,52,32,0,15,37
40,Fail,32,45,7,16,16
40,Success,54,32,2,12,42
40,Fail,51,28,7,14,37
40,Success,53,30,0,12,41
40,Fail,49,36,0,13,36
40,Success,55,33,3,9,46
40,Fail,49,32,0,19,30
40,Fail,49,36,3,12,37
40,Success,52,34,5,9,43
40,Success,56,29,0,10,46
40,Fail,51,33,0,12,39
40,Fail,52,26,0,17,35
40,Fail,39,43,0,18,21
40,Success,56,29,0,14,42
40,Fail,42,38,0,15,27
40,Fail,47,28,7,18,29
40,Fail,45,29,0,17,28
40,Success,56,33,2,9,47
40,Fail,44,33,0,15,29
40,Success,52,35,0,12,40
40,Fail,43,36,0,16,27
40,Fail,49,35,0,10,39
40,Fail,51,34,3,12,39
40,Fail,45,38,0,9,36
40,Fail,52,30,1,17,35
40,Fail,55,27,1,17,38
40,Fail,48,40,1,11,37
40,Fail,49,35,4,12,37
40,Fail,48,39,1,12,36
40,Fail,50,32,0,14,36
40,Fail,41,38,0,14,27
40,Fail,45,35,0,13,32
40,Success,54,30,2,14,40
40,Fail,50,32,0,15,35
40,Fail,50,34,4,12,38
40,Fail,36,34,0,21,15
40,Fail,50,32,0,17,33
40,Success,52,39,0,8,44
40,Fail,47,32,0,11,36
40,Success,57,31,0,11,46
40,Fail,52,31,4,13,39
40,Fail,48,40,1,11,37
40,Fail,47,39,0,13,34
40,Success,48,37,8,7,41
40,Fail,43,37,2,18,25
40,Fail,46,32,8,14,32
40,Success,49,40,0,7,42
40,Success,54,32,0,13,41
40,Fail,45,39,2,14,31
40,Success,50,36,0,10,40
40,Fail,44,42,0,10,34
40,Fail,45,33,9,13,32
40,Fail,45,41,3,11,34
40,Fail,44,37,3,16,28
40,Fail,54,26,3,17,37
40,Fail,46,39,0,11,35
40,Success,52,38,1,9,43
40,Fail,51,31,0,15,36
40,Success,50,41,0,9,41
40,Fail,52,33,1,14,38
40,Fail,46,33,0,15,31
40,Success,52,37,1,10,42
40,Fail,45,39,4,12,33
40,Success,51,34,0,7,44
40,Fail,42,40,3,15,27
40,Fail,50,34,4,12,38
40,Fail,48,39,0,13,35
40,Fail,40,50,0,7,33
40,Fail,39,45,0,14,25
40,Fail,50,34,2,14,36
40,Fail,48,32,2,18,30
40,Success,58,25,7,10,48
40,Fail,45,30,6,19,26
40,Fail,48,39,0,13,35
40,Fail,50,31,0,15,35
40,Fail,44,32,0,17,27
40,Fail,43,32,13,12,31
40,Fail,47,42,0,9,38
40,Success,51,39,2,8,43
40,Fail,44,32,0,14,30
40,Success,51,35,3,11,40
40,Fail,47,34,5,14,33
40,Fail,43,33,6,18,25
40,Fail,41,36,0,19,22
40,Fail,45,41,0,12,33
40,Fail,48,37,0,11,37
40,Fail,42,37,3,18,24
40,Success,57,30,5,8,49
40,Success,57,37,0,4,53
40,Fail,52,32,0,13,39
40,Fail,43,40,4,13,30
40,Success,60,30,1,9,51
40,Fail,42,40,0,14,28
40,Fail,50,35,3,12,38
40,Fail,43,37,0,20,23
40,Fail,48,41,1,10,38
40,Success,54,35,2,9,45
40,Fail,45,40,7,8,37
40,Fail,48,41,2,9,39
40,Fail,51,34,1,14,37
40,Fail,46,33,2,19,27
40,Fail,42,40,5,13,29
40,Fail,44,43,0,13,31
40,Success,53,32,2,13,40
40,Success,52,34,0,10,42
40,Success,52,32,0,9,43
40,Fail,46,40,0,9,37
40,Fail,40,42,6,12,28
40,Fail,42,42,0,13,29
40,Fail,47,40,1,12,35
40,Fail,47,36,0,10,37
40,Success,49,42,1,8,41
40,Fail,45,40,0,14,31
40,Fail,40,43,3,14,26
40,Success,50,33,9,8,42
40,Fail,47,31,9,13,34
40,Success,53,41,0,6,47
40,Fail,48,29,0,13,35
40,Success,52,37,0,11,41
40,Fail,49,31,1,19,30
40,Fail,43,45,0,12,31
40,Success,55,33,0,7,48
40,Fail,55,28,1,16,39
40,Fail,48,35,0,14,34
40,Fail,47,39,0,13,34
40,Fail,47,33,0,14,33
40,Fail,52,29,4,15,37
40,Fail,38,32,14,16,22
40,Fail,43,36,0,13,30
40,Fail,44,34,0,13,31
40,Fail,42,41,5,12,30
40,Success,52,30,8,10,42
40,Success,52,33,5,10,42
40,Fail,47,35,0,9,38
40,Fail,44,43,0,9,35
40,Success,54,30,0,13,41
40,Fail,50,22,9,19,31
40,Fail,48,32,0,19,29
40,Fail,50,30,1,19,31
40,Success,55,26,4,15,40
40,Fail,51,35,1,13,38
40,Fail,47,35,0,15,32
40,Success,57,35,0,8,49
40,Fail,47,34,2,17,30
40,Fail,49,36,0,11,38
40,Fail,50,31,0,14,36
40,Success,52,35,4,9,43
40,Success,53,32,6,9,44
40,Fail,47,34,0,14,33
40,Fail,47,41,0,12,35
40,Fail,44,40,0,16,28
40,Success,53,36,0,11,42
40,Fail,48,36,0,12,36
40,Fail,42,34,11,13,29
40,Fail,40,45,1,14,26
40,Fail,42,40,4,14,28
40,Success,52,36,0,10,42
40,Success,57,28,3,12,45
40,Success,55,30,0,12,43
40,Fail,49,35,0,13,36
40,Fail,45,34,0,13,32
40,Fail,49,37,0,11,38
40,Fail,48,36,4,12,36
40,Fail,49,35,6,10,39
40,Success,52,38,0,7,45
40,Fail,39,39,7,15,24
40,Fail,40,33,5,22,18
40,Fail,39,44,0,13,26
40,Success,58,30,0,11,47
40,Success,53,32,7,8,45
40,Success,49,39,0,8,41
40,Success,48,40,0,7,41
40,Fail,42,33,0,22,20
40,Success,51,42,0,6,45
40,Fail,51,36,0,12,39
40,Fail,47,34,2,17,30
40,Fail,45,42,0,13,32
40,Fail,45,39,3,13,32
40,Fail,41,41,0,16,25
40,Fail,47,36,0,17,30
40,Fail,47,37,0,15,32
40,Success,52,36,2,10,42
40,Fail,50,35,0,13,37
40,Fail,53,26,2,19,34
40,Success,57,29,0,8,49
40,Fail,45,38,0,16,29
40,Fail,47,40,0,11,36
40,Fail,48,37,0,13,35
40,Success,50,39,0,10,40
40,Fail,46,36,0,17,29
40,Fail,49,32,0,13,36
40,Success,51,34,6,9,42
40,Fail,48,30,0,18,30
40,Success,50,39,0,10,40
40,Fail,42,33,7,18,24
40,Fail,48,34,1,17,31
40,Success,48,38,0,8,40
40,Fail,39,46,2,13,26
40,Success,57,32,1,10,47
40,Success,50,36,0,9,41
40,Fail,48,29,0,17,31
40,Fail,43,33,6,18,25
40,Success,53,36,0,8,45
40,Fail,50,37,0,13,37
40,Success,50,34,0,9,41
40,Fail,48,40,2,10,38
40,Success,56,34,1,9,47
40,Fail,47,35,6,12,35
40,Fail,48,36,0,10,38
40,Fail,49,35,1,15,34
40,Fail,50,30,3,17,33
40,Success,53,40,0,7,46
40,Fail,47,37,0,16,31
40,Success,54,23,11,12,42
40,Success,54,30,8,8,46
40,Fail,49,32,4,15,34
40,Success,54,27,0,14,40
40,Fail,42,43,0,11,31
40,Fail,47,39,0,10,37
40,Success,54,33,0,13,41
40,Success,53,36,0,9,44
40,Fail,49,27,11,13,36
40,Fail,43,41,0,12,31
40,Fail,44,36,2,18,26
40,Fail,48,34,1,17,31
40,Fail,45,34,6,15,30
40,Fail,43,38,5,14,29
40,Fail,40,42,4,14,26
40,Fail,46,32,0,14,32
40,Fail,42,38,0,16,26
40,Fail,37,40,7,16,21
40,Fail,46,40,2,12,34
40,Fail,41,41,0,15,26
40,Success,53,35,0,11,42
40,Fail,47,42,0,8,39
40,Fail,47,39,0,11,36
40,Fail,46,35,4,15,31
40,Fail,45,32,0,18,27
40,Success,49,34,0,8,41
40,Fail,48,32,1,19,29
40,Success,54,35,0,10,44
40,Fail,45,31,0,19,26
40,Fail,49,36,0,13,36
40,Success,55,28,3,14,41
40,Fail,48,35,6,11,37
40,Success,53,32,5,10,43
40,Fail,48,34,7,11,37
40,Fail,47,31,0,14,33
40,Fail,46,36,0,17,29
40,Success,51,38,0,10,41
40,Fail,44,32,5,19,25
40,Fail,44,43,2,11,33
40,Success,53,33,8,6,47
40,Fail,44,35,5,16,28
40,Success,52,31,0,12,40
40,Fail,48,30,3,19,29
40,Success,52,35,0,11,41
40,Success,57,34,1,8,49
40,Fail,49,36,0,15,34
40,Fail,53,32,1,14,39
40,Fail,51,30,5,14,37
40,Fail,52,32,0,15,37
40,Fail,48,34,0,16,32
40,Fail,52,31,2,15,37
40,Fail,46,43,0,10,36
40,Fail,48,38,3,11,37
40,Fail,47,41,0,11,36
40,Success,54,34,1,11,43
40,Fail,48,37,0,13,35
40,Success,53,39,0,8,45
40,Fail,50,31,1,18,32
40,Success,50,42,3,5,45
40,Fail,48,33,0,10,38
40,Fail,49,29,0,15,34
40,Fail,42,42,5,11,31
40,Fail,45,36,8,11,34
40,Fail,50,38,0,12,38
40,Fail,45,39,4,12,33
40,Fail,49,35,0,11,38
40,Fail,49,40,0,11,38
40,Fail,50,34,0,11,39
40,Success,52,40,1,7,45
40,Fail,50,31,0,15,35
40,Fail,44,36,0,13,31
40,Fail,41,46,2,11,30
40,Fail,46,35,4,15,31
40,Success,57,28,2,13,44
40,Fail,43,35,6,16,27
40,Success,50,39,2,9,41
40,Fail,47,33,0,16,31
40,Fail,43,40,0,15,28
40,Fail,48,26,0,14,34
40,Success,52,34,0,10,42
40,Fail,44,39,4,13,31
40,Fail,45,40,3,12,33
40,Success,57,33,0,8,49
40,Fail,50,36,2,12,38
40,Fail,48,38,0,9,39
40,Fail,47,43,0,9,38
40,Success,52,32,6,10,42
40,Fail,42,40,0,16,26
40,Fail,49,36,4,11,38
40,Fail,43,39,0,10,33
40,Fail,47,35,6,12,35
40,Fail,43,34,9,14,29
40,Fail,48,36,6,10,38
40,Fail,48,34,5,13,35
40,Success,54,32,0,14,40
40,Success,53,32,0,12,41
40,Success,50,34,7,9,41
40,Success,51,29,0,10,41
40,Fail,50,34,2,14,36
40,Success,53,31,0,9,44
40,Fail,47,39,2,12,35
40,Success,60,31,0,9,51
40,Fail,46,36,8,10,36
40,Fail,39,44,0,14,25
40,Success,52,35,1,12,40
40,Success,55,29,0,13,42
40,Fail,42,41,0,16,26
40,Fail,47,32,2,19,28
40,Fail,51,32,0,13,38
40,Fail,48,39,2,11,37
40,Fail,47,37,8,8,39
40,Success,54,32,0,11,43
40,Fail,52,32,0,13,39
40,Fail,46,38,0,14,32
40,Fail,50,33,0,15,35
40,Fail,47,36,3,14,33
40,Fail,46,40,0,7,39
40,Fail,41,41,0,14,27
40,Fail,50,37,1,12,38
40,Fail,45,41,0,11,34
40,Fail,45,38,6,11,34
40,Success,52,40,0,8,44
40,Fail,46,46,0,8,38
40,Success,62,28,2,8,54
40,Fail,41,40,9,10,31
40,Fail,42,40,0,16,26
40,Fail,47,38,5,10,37
40,Success,52,34,4,10,42
40,Fail,46,36,0,14,32
40,Fail,51,36,0,13,38
40,Fail,50,34,1,15,35
40,Success,57,29,0,9,48
40,Fail,42,35,0,18,24
40,Fail,39,38,0,21,18
40,Fail,52,30,2,16,36
40,Success,53,33,0,12,41
40,Fail,47,33,5,15,32
40,Success,49,39,0,8,41
40,Fail,48,32,6,14,34
40,Fail,46,37,4,13,33
40,Fail,52,26,8,14,38
40,Fail,42,39,0,14,28
40,Fail,44,40,3,13,31
40,Fail,47,37,0,15,32
40,Fail,42,34,0,17,25
40,Fail,45,30,0,16,29
40,Fail,48,37,0,14,34
40,Success,56,30,0,12,44
40,Fail,48,38,0,11,37
40,Success,50,33,0,9,41
40,Fail,45,41,4,10,35
40,Fail,47,32,10,11,36
40,Fail,48,40,2,10,38
40,Fail,44,44,0,10,34
40,Success,52,35,2,11,41
40,Success,54,31,1,14,40
40,Fail,50,32,2,16,34
40,Fail,43,43,2,12,31
40,Success,51,37,6,6,45
40,Fail,44,39,4,13,31
40,Fail,49,30,0,14,35
40,Fail,42,34,0,13,29
40,Fail,47,39,0,12,35
40,Fail,47,35,5,13,34
40,Success,56,33,0,7,49
40,Success,55,28,0,12,43
40,Fail,53,29,2,16,37
40,Success,49,35,7,9,40
40,Success,58,29,2,11,47
40,Fail,43,38,8,11,32
40,Fail,51,25,7,17,34
40,Fail,39,38,0,13,26
40,Success,50,40,2,8,42
40,Fail,45,34,0,15,30
40,Fail,47,39,1,13,34
40,Fail,34,57,0,8,26
40,Fail,48,35,0,15,33
40,Success,53,36,0,11,42
40,Success,57,28,0,11,46
40,Fail,42,32,6,20,22
40,Fail,49,29,0,18,31
40,Success,49,43,1,7,42
40,Fail,49,36,1,14,35
40,Fail,51,33,0,15,36
40,Success,51,38,0,11,40
40,Fail,46,42,4,8,38
40,Success,50,41,0,8,42
40,Success,50,38,3,9,41
40,Fail,46,35,8,11,35
40,Fail,49,33,0,14,35
40,Fail,46,36,9,9,37
40,Success,52,34,5,9,43
40,Success,53,32,4,11,42
40,Success,61,32,2,5,56
40,Fail,45,35,0,13,32
40,Fail,49,33,6,12,37
40,Success,64,28,0,7,57
40,Fail,48,29,0,16,32
40,Fail,46,33,4,17,29
40,Success,56,24,0,13,43
40,Success,57,31,0,11,46
40,Fail,47,34,0,10,37
40,Success,52,37,0,10,42
40,Success,51,38,3,8,43
40,Fail,43,36,7,14,29
40,Fail,47,33,0,19,28
40,Success,49,36,7,8,41
40,Success,49,38,7,6,43
40,Fail,44,36,0,14,30
40,Fail,47,36,1,16,31
40,Success,50,37,3,10,40
40,Success,55,34,0,11,44
40,Success,52,41,2,5,47
40,Fail,46,31,0,18,28
40,Success,52,35,1,12,40
40,Fail,47,39,0,14,33
40,Fail,49,32,3,16,33
40,Fail,44,32,8,16,28
40,Fail,47,39,0,13,34
40,Fail,46,37,9,8,38
40,Fail,48,35,0,13,35
40,Success,57,33,0,10,47
40,Fail,44,41,0,13,31
40,Fail,41,35,0,13,28
40,Fail,48,34,0,12,36
40,Success,50,38,0,7,43
40,Success,51,35,3,11,40
40,Fail,46,29,6,19,27
40,Success,55,34,0,6,49
40,Fail,47,34,0,12,35
40,Success,54,34,1,11,43
40,Success,51,38,1,10,41
40,Success,53,35,0,12,41
40,Fail,46,37,4,13,33
40,Fail,48,39,0,12,36
40,Fail,46,33,0,19,27
40,Fail,49,36,0,12,37
40,Success,53,32,2,13,40
40,Fail,41,44,3,12,29
40,Fail,48,34,5,13,35
40,Success,50,42,1,7,43
40,Fail,45,39,2,14,31
40,Fail,39,41,6,14,25
40,Fail,47,36,0,13,34
40,Success,53,36,0,10,43
40,Fail,48,33,0,9,39
40,Fail,49,38,0,13,36
40,Fail,49,33,1,17,32
40,Fail,49,31,5,15,34
40,Success,52,34,0,10,42
40,Fail,45,39,0,11,34
40,Success,54,34,0,7,47
40,Fail,50,36,0,12,38
40,Fail,40,43,3,14,26
40,Fail,48,31,11,10,38
40,Fail,44,45,0,9,35
40,Fail,47,38,0,13,34
40,Success,50,31,0,9,41
40,Success,49,39,3,9,40
40,Fail,39,40,0,13,26
40,Fail,48,39,3,10,38
40,Fail,48,35,0,12,36
40,Fail,52,32,3,13,39
40,Fail,43,31,5,21,22
40,Success,53,32,0,9,44
40,Fail,49,37,0,13,36
40,Success,54,36,0,8,46
40,Fail,48,35,0,12,36
40,Fail,47,39,3,11,36
40,Fail,52,34,0,13,39
40,Success,53,31,3,13,40
40,Success,56,31,0,12,44
40,Success,50,38,0,7,43
40,Success,50,35,6,9,41
40,Success,50,39,3,8,42
40,Fail,48,33,6,13,35
40,Fail,45,36,0,17,28
40,Fail,40,39,6,15,25
40,Fail,48,39,1,12,36
40,Fail,46,42,0,10,36
40,Success,53,38,0,6,47
40,Success,52,32,5,11,41
40,Fail,48,34,1,17,31
40,Success,49,38,4,9,40
40,Success,50,40,0,10,40
40,Success,49,38,4,9,40
40,Success,51,39,1,9,42
40,Fail,41,38,0,17,24
40,Fail,49,34,7,10,39
40,Fail,46,36,5,13,33
40,Fail,43,50,0,7,36
40,Fail,50,35,0,13,37
40,Fail,45,38,7,10,35
40,Fail,50,31,0,15,35
40,Fail,43,37,0,14,29
40,Fail,48,39,0,12,36
40,Fail,49,29,0,14,35
40,Fail,47,39,3,11,36
40,Fail,47,36,4,13,34
40,Fail,45,37,8,10,35
40,Success,53,35,2,10,43
40,Fail,49,36,0,12,37
40,Fail,48,35,0,16,32
40,Fail,49,41,0,10,39
40,Fail,47,38,0,13,34
40,Fail,47,39,0,8,39
40,Fail,50,33,0,11,39
40,Fail,52,28,0,14,38
40,Fail,51,35,0,12,39
40,Success,57,35,0,6,51
40,Fail,44,40,0,13,31
40,Fail,46,35,0,17,29
40,Success,50,43,1,6,44
40,Fail,47,37,0,15,32
40,Fail,45,44,0,11,34
40,Fail,50,30,0,12,38
40,Fail,49,32,5,14,35
40,Fail,43,27,0,13,30
40,Fail,53,32,1,14,39
40,Fail,44,42,0,13,31
40,Success,51,37,5,7,44
40,Fail,40,33,0,16,24
40,Fail,44,36,0,10,34
40,Fail,51,30,5,14,37
40,Fail,42,38,0,17,25
40,Success,56,29,0,15,41
40,Success,55,33,0,9,46
40,Success,54,29,0,12,42
40,Fail,48,37,0,11,37
40,Success,56,27,7,10,46
40,Fail,47,34,7,12,35
40,Success,52,38,0,10,42
40,Fail,50,30,8,12,38
40,Success,53,35,0,12,41
40,Fail,48,31,8,13,35
40,Fail,51,32,0,16,35
40,Success,46,42,0,6,40
40,Success,52,33,0,10,42
40,Fail,44,38,0,15,29
40,Fail,41,35,9,15,26
40,Fail,41,42,0,12,29
40,Success,55,29,0,13,42
40,Fail,46,37,4,13,33
40,Success,57,27,3,13,44
40,Success,55,33,1,11,44
40,Fail,48,40,0,12,36
40,Fail,50,36,2,12,38
40,Success,52,38,0,7,45
40,Fail,46,39,0,14,32
40,Fail,48,34,3,15,33
40,Fail,46,34,3,17,29
40,Fail,46,35,2,17,29
40,Fail,45,37,6,12,33
40,Fail,46,39,0,7,39
40,Success,53,38,0,9,44
40,Success,55,33,5,7,48
40,Fail,42,39,4,15,27
40,Success,60,24,0,15,45
40,Success,53,34,2,11,42
40,Fail,42,40,0,11,31
40,Fail,50,32,0,12,38
40,Fail,45,32,9,14,31
40,Fail,44,32,0,20,24
40,Success,53,36,2,9,44
40,Fail,49,31,0,16,33
40,Success,52,37,0,7,45
40,Fail,45,34,0,14,31
40,Fail,43,47,0,9,34
40,Fail,49,33,0,14,35
40,Fail,42,39,0,18,24
40,Fail,49,39,0,11,38
40,Success,51,32,0,9,42
40,Success,53,35,0,12,41
40,Fail,49,37,0,13,36
40,Fail,45,39,6,10,35
40,Fail,46,33,7,14,32
40,Fail,43,31,10,16,27
40,Fail,44,38,0,17,27
40,Fail,49,37,0,13,36
40,Fail,49,38,0,12,37
40,Success,56,31,4,9,47
40,Fail,46,40,0,13,33
40,Fail,45,36,0,12,33
40,Fail,46,39,4,11,35
40,Fail,47,38,6,9,38
40,Success,52,31,0,10,42
40,Fail,38,35,8,19,19
40,Fail,45,40,0,12,33
40,Fail,43,37,0,11,32
40,Fail,46,35,0,19,27
40,Fail,49,34,0,11,38
40,Fail,46,36,0,9,37
40,Fail,47,29,7,17,30
40,Fail,46,40,0,7,39
40,Fail,46,41,4,9,37
40,Fail,47,38,5,10,37
40,Fail,42,35,0,14,28
40,Fail,44,42,1,13,31
40,Fail,48,27,0,13,35
40,Success,53,32,0,13,40
40,Fail,48,36,4,12,36
40,Fail,49,34,0,12,37
40,Fail,49,40,1,10,39
40,Fail,49,28,8,15,34
40,Fail,44,32,4,20,24
40,Fail,41,35,14,10,31
40,Fail,49,35,0,16,33
40,Success,51,31,0,9,42
40,Success,53,35,0,12,41
40,Fail,39,38,0,11,28
40,Fail,49,35,0,10,39
40,Fail,54,30,1,15,39
40,Fail,47,43,0,10,37
40,Success,48,44,0,7,41
40,Fail,48,31,2,19,29
40,Fail,42,36,5,17,25
40,Fail,46,31,0,17,29
40,Success,51,36,5,8,43
40,Fail,43,34,0,19,24
40,Fail,45,35,8,12,33
40,Success,54,31,0,12,42
40,Fail,41,45,2,12,29
40,Fail,46,29,2,23,23
40,Fail,46,41,2,11,35
40,Success,52,31,6,11,41
40,Fail,50,30,0,12,38
40,Fail,46,36,2,16,30
40,Fail,48,35,6,11,37
40,Fail,51,33,1,15,36
40,Fail,52,32,0,15,37
40,Fail,45,39,0,13,32
40,Fail,38,47,8,7,31
40,Fail,50,32,4,14,36
40,Fail,44,43,0,12,32
40,Fail,46,40,6,8,38
40,Success,53,32,0,12,41
40,Fail,41,38,10,11,30
40,Fail,52,30,4,14,38
40,Fail,50,31,6,13,37
40,Fail,46,37,0,12,34
40,Fail,50,29,10,11,39
40,Fail,45,38,0,12,33
40,Fail,47,39,4,10,37
40,Fail,42,37,5,16,26
40,Fail,45,43,0,11,34
40,Fail,45,32,0,19,26
40,Fail,49,33,1,17,32
40,Fail,47,37,3,13,34
40,Fail,45,34,0,12,33
40,Success,50,39,0,8,42
40,Fail,48,36,4,12,36
40,Success,52,40,1,7,45
40,Success,58,33,0,8,50
40,Fail,46,35,3,16,30
40,Success,60,28,0,11,49
40,Fail,46,34,5,15,31
40,Fail,48,35,2,15,33
40,Success,51,33,0,10,41
40,Success,57,33,0,8,49
40,Fail,45,39,0,11,34
40,Fail,50,36,1,13,37
40,Success,53,34,2,11,42
40,Fail,51,32,0,14,37
40,Fail,46,44,1,9,37
40,Fail,49,36,5,10,39
40,Fail,45,35,5,15,30
40,Fail,45,30,6,19,26
40,Fail,49,30,6,15,34
40,Fail,47,38,0,14,33
40,Success,54,32,6,8,46
40,Success,52,36,0,12,40
40,Fail,42,44,0,13,29
40,Fail,49,34,2,15,34
40,Fail,46,37,3,14,32
40,Success,50,35,5,10,40
40,Success,53,31,0,13,40
40,Fail,47,44,1,8,39
40,Success,56,30,0,13,43
40,Fail,48,35,0,11,37
40,Fail,51,30,5,14,37
40,Fail,46,40,2,12,34
40,Fail,45,43,0,10,35
40,Success,56,28,1,15,41
40,Fail,36,46,0,18,18
40,Success,53,32,0,13,40
40,Fail,44,37,1,18,26
40,Fail,43,36,9,12,31
40,Fail,47,43,1,9,38
40,Fail,47,39,5,9,38
40,Fail,39,37,0,16,23
40,Fail,45,40,2,13,32
40,Success,59,25,0,14,45
40,Fail,45,32,0,11,34
40,Fail,42,45,0,13,29
40,Fail,48,37,0,15,33
40,Fail,47,40,0,9,38
40,Success,55,35,0,10,45
40,Fail,44,35,0,15,29
40,Fail,47,35,1,17,30
40,Fail,49,34,0,10,39
40,Fail,44,38,6,12,32
40,Success,49,41,3,7,42
40,Fail,43,27,9,21,22
40,Fail,49,33,5,13,36
40,Fail,47,34,0,19,28
40,Fail,42,44,5,9,33
40,Fail,46,31,0,11,35
40,Success,54,35,1,10,44
40,Success,56,32,0,10,46
40,Success,53,38,0,9,44
40,Success,47,38,8,7,40
40,Fail,46,36,0,13,33
40,Success,57,29,0,11,46
40,Fail,50,33,2,15,35
40,Fail,52,32,3,13,39
40,Fail,48,39,0,13,35
40,Fail,47,30,7,16,31
40,Success,51,36,3,10,41
40,Fail,48,29,0,20,28
40,Success,51,31,13,5,46
40,Fail,48,34,0,9,39
40,Fail,52,27,2,19,33
40,Fail,48,32,1,19,29
40,Fail,52,31,0,16,36
40,Fail,44,37,5,14,30
40,Success,51,33,8,8,43
40,Fail,48,37,1,14,34
40,Success,49,35,0,8,41
40,Fail,49,36,4,11,38
40,Fail,47,31,0,13,34
40,Fail,46,37,3,14,32
40,Fail,51,35,2,12,39
40,Fail,49,31,0,15,34
40,Fail,48,28,0,16,32
40,Fail,46,45,2,7,39
40,Fail,48,34,0,12,36
40,Fail,46,38,0,12,34
40,Fail,45,41,2,12,33
40,Fail,40,37,0,13,27
40,Fail,49,30,4,17,32
40,Success,51,30,0,11,40
40,Fail,43,40,1,16,27
40,Fail,45,38,0,12,33
40,Fail,50,37,2,11,39
40,Success,51,35,0,8,43
40,Fail,48,36,0,11,37
40,Fail,47,37,0,14,33
40,Success,52,32,4,12,40
40,Fail,48,33,3,16,32
40,Success,51,33,5,11,40
40,Fail,43,40,0,11,32
40,Success,52,31,5,12,40
40,Success,53,34,0,8,45
40,Success,53,34,0,10,43
40,Success,55,29,1,15,40
40,Fail,47,44,0,9,38
40,Fail,39,33,0,17,22
40,Fail,48,42,0,9,39
40,Fail,43,33,9,15,28
40,Fail,45,41,0,13,32
40,Fail,52,31,2,15,37
40,Fail,47,36,1,16,31
40,Fail,51,35,0,14,37
40,Fail,45,40,4,11,34
40,Fail,46,34,0,17,29
40,Fail,41,41,4,14,27
40,Fail,45,36,0,15,30
40,Success,51,39,4,6,45
40,Fail,49,26,13,12,37
40,Fail,50,29,9,12,38
40,Fail,53,30,0,14,39
40,Fail,46,39,0,10,36
40,Fail,42,36,1,21,21
40,Fail,40,38,0,16,24
40,Fail,51,27,0,12,39
40,Success,53,32,8,7,46
40,Fail,45,39,2,14,31
40,Fail,42,37,3,18,24
40,Fail,43,41,3,13,30
40,Success,51,38,0,8,43
40,Success,53,34,1,12,41
40,Fail,48,31,6,15,33
40,Success,54,34,0,11,43
40,Fail,45,43,1,11,34
40,Success,53,31,3,13,40
40,Fail,47,37,0,12,35
40,Fail,45,34,0,6,39
40,Fail,47,26,0,16,31
40,Fail,41,37,0,15,26
40,Fail,45,37,2,16,29
40,Fail,47,36,4,13,34
40,Fail,51,32,3,14,37
40,Fail,46,36,0,13,33
40,Success,53,35,1,11,42
40,Fail,48,39,0,12,36
40,Fail,49,35,3,13,36
40,Fail,47,37,6,10,37
40,Fail,49,39,0,11,38
40,Fail,48,35,3,14,34
40,Success,54,35,0,8,46
40,Success,55,27,0,12,43
40,Fail,43,45,4,8,35
40,Success,54,34,0,12,42
40,Success,55,31,1,13,42
40,Success,49,39,0,7,42
40,Fail,50,34,3,13,37
40,Fail,50,34,1,15,35
40,Fail,43,39,0,15,28
40,Fail,40,37,1,22,18
40,Fail,43,34,0,14,29
40,Fail,49,28,6,17,32
40,Fail,42,39,0,14,28
40,Fail,49,36,4,11,38
40,Success,57,32,0,9,48
40,Fail,46,35,0,18,28
40,Fail,49,36,4,11,38
40,Success,52,39,0,8,44
40,Fail,45,35,0,16,29
40,Fail,41,36,0,15,26
40,Fail,48,37,0,14,34
40,Fail,47,40,0,9,38
40,Fail,48,30,0,14,34
40,Fail,52,30,0,17,35
40,Fail,42,40,0,12,30
40,Success,50,37,0,9,41
40,Success,52,36,5,7,45
40,Success,56,34,2,8,48
40,Fail,45,32,7,16,29
40,Fail,45,41,0,11,34
40,Success,51,30,9,10,41
40,Success,53,38,2,7,46
40,Fail,43,39,0,13,30
40,Fail,42,40,0,12,30
40,Fail,45,46,0,7,38
40,Fail,46,39,3,12,34
40,Success,56,28,3,13,43
40,Fail,43,41,5,11,32
40,Fail,45,34,0,11,34
40,Fail,41,39,0,19,22
40,Fail,44,43,0,9,35
40,Fail,53,27,0,15,38
40,Fail,43,45,2,10,33
40,Fail,41,39,4,16,25
40,Success,52,38,1,9,43
40,Fail,47,36,6,11,36
40,Success,50,38,2,10,40
40,Fail,46,39,4,11,35
40,Fail,46,39,0,10,36
40,Fail,39,42,1,18,21
40,Fail,49,36,0,14,35
40,Fail,48,38,1,13,35
40,Fail,38,40,4,18,20
40,Fail,48,35,0,11,37
40,Success,55,36,2,7,48
40,Success,50,37,6,7,43
40,Fail,52,35,0,13,39
40,Fail,46,29,12,13,33
40,Fail,48,33,4,15,33
40,Success,56,27,0,8,48
40,Fail,48,36,0,12,36
40,Success,49,30,13,8,41
40,Fail,43,36,6,15,28
40,Fail,45,37,0,10,35
40,Success,51,35,5,9,42
40,Fail,43,42,1,14,29
40,Fail,44,36,0,13,31
40,Fail,52,31,4,13,39
40,Success,52,37,0,10,42
40,Success,52,38,0,10,42
40,Success,51,39,4,6,45
40,Fail,46,38,0,13,33
40,Success,56,36,2,6,50
40,Success,54,31,5,10,44
40,Fail,45,36,3,16,29
40,Fail,44,34,0,19,25
40,Success,60,30,0,10,50
40,Success,52,28,8,12,40
40,Fail,43,38,0,14,29
40,Success,51,41,0,7,44
40,Fail,50,35,0,12,38
40,Fail,45,33,0,14,31
40,Fail,43,42,0,15,28
40,Success,53,30,10,7,46
40,Fail,48,36,5,11,37
40,Fail,45,37,0,12,33
40,Fail,53,29,0,14,39
40,Fail,46,36,2,16,30
40,Fail,52,31,0,16,36
40,Success,52,36,3,9,43
40,Fail,40,45,0,10,30
40,Fail,49,39,2,10,39
40,Fail,44,37,0,12,32
40,Fail,45,37,2,16,29
40,Fail,42,39,0,11,31
40,Fail,48,35,3,14,34
40,Fail,40,34,0,18,22
40,Fail,49,39,0,12,37
40,Fail,49,29,0,14,35
40,Fail,52,31,0,13,39
40,Fail,47,38,0,12,35
40,Success,50,41,0,8,42
40,Success,55,37,0,7,48
40,Fail,41,37,5,17,24
40,Fail,41,40,0,13,28
40,Success,48,39,7,6,42
40,Fail,51,31,2,16,35
40,Success,56,37,0,7,49
40,Fail,43,39,0,18,25
40,Success,56,31,2,11,45
40,Fail,49,37,0,12,37
40,Success,54,33,5,8,46
40,Fail,45,43,3,9,36
40,Success,56,27,0,10,46
40,Fail,45,39,2,14,31
40,Fail,42,36,0,15,27
40,Success,50,34,0,9,41
40,Fail,43,35,0,20,23
40,Fail,44,38,6,12,32
40,Success,50,40,0,7,43
40,Fail,46,35,5,14,32
40,Fail,51,29,0,15,36
40,Fail,47,33,5,15,32
40,Fail,47,27,0,15,32
40,Success,56,32,0,11,45
40,Fail,43,32,0,19,24
40,Fail,49,32,0,18,31
40,Fail,53,26,3,18,35
40,Fail,49,39,1,11,38
40,Fail,48,32,7,13,35
40,Success,54,34,3,9,45
40,Fail,45,43,1,11,34
40,Success,53,33,0,13,40
40,Fail,50,30,0,14,36
40,Fail,51,36,1,12,39
40,Fail,46,40,1,13,33
40,Fail,45,35,2,18,27
40,Fail,48,31,9,12,36
40,Fail,47,30,10,13,34
40,Success,56,29,9,6,50
40,Fail,50,35,4,11,39
40,Fail,47,39,0,14,33
40,Fail,52,30,1,17,35
40,Fail,52,30,0,16,36
40,Success,51,35,7,7,44
40,Success,55,29,0,13,42
40,Fail,44,40,0,11,33
40,Success,51,27,0,11,40
40,Fail,42,35,3,20,22
40,Fail,49,36,0,12,37
40,Success,54,33,4,9,45
40,Fail,42,34,6,18,24
40,Fail,45,39,0,15,30
40,Success,51,33,0,11,40
40,Fail,43,38,0,18,25
40,Fail,46,41,5,8,38
40,Fail,49,36,3,12,37
40,Fail,40,38,0,16,24
40,Fail,44,34,0,16,28
40,Fail,51,33,0,13,38
40,Fail,47,33,0,17,30
40,Fail,50,32,0,17,33
40,Fail,45,37,0,17,28
40,Fail,47,29,12,12,35
40,Fail,43,40,0,14,29
40,Success,56,25,0,15,41
40,Fail,47,33,0,19,28
40,Success,50,35,0,9,41
40,Success,50,36,0,10,40
40,Fail,40,37,0,22,18
40,Fail,49,37,0,12,37
40,Success,55,38,0,7,48
40,Success,51,32,0,9,42
40,Fail,49,29,0,16,33
40,Fail,48,38,0,14,34
40,Success,51,38,0,9,42
40,Fail,49,34,0,17,32
40,Fail,44,38,3,15,29
40,Fail,47,34,6,13,34
40,Success,51,35,0,9,42
40,Fail,42,43,1,14,28
40,Fail,51,36,1,12,39
40,Success,51,38,0,9,42
40,Fail,41,40,0,17,24
40,Fail,51,31,0,16,35
40,Fail,46,38,0,10,36
40,Fail,44,39,3,14,30
40,Fail,49,29,0,12,37
40,Success,60,26,6,8,52
40,Fail,53,32,0,14,39
40,Fail,39,43,4,14,25
40,Fail,45,40,4,11,34
40,Fail,48,34,4,14,34
40,Success,55,37,0,8,47
40,Fail,49,34,4,13,36
40,Success,51,32,0,11,40
40,Success,52,33,7,8,44
40,Fail,44,39,0,17,27
40,Success,54,31,5,10,44
40,Fail,43,34,0,12,31
40,Fail,39,36,0,14,25
40,Fail,43,36,0,16,27
40,Fail,43,40,0,11,32
40,Fail,46,40,0,9,37
40,Fail,45,43,0,12,33
40,Success,49,39,0,9,40
40,Fail,44,30,0,13,31
40,Fail,43,35,0,15,28
40,Success,54,36,0,9,45
40,Fail,49,38,1,12,37
40,Success,55,30,0,11,44
40,Fail,45,38,0,14,31
40,Fail,42,36,5,17,25
40,Fail,46,34,0,13,33
40,Success,48,44,0,8,40
40,Fail,43,35,0,17,26
40,Success,52,34,3,11,41
40,Fail,48,34,0,15,33
40,Fail,46,36,8,10,36
40,Fail,46,30,0,19,27
40,Fail,38,37,0,15,23
40,Fail,40,45,2,13,27
40,Fail,47,34,4,15,32
40,Success,51,37,2,10,41
40,Fail,50,30,8,12,38
40,Success,53,33,0,11,42
40,Success,55,26,5,14,41
40,Fail,41,43,0,13,28
40,Fail,38,45,5,12,26
40,Fail,46,37,1,16,30
40,Success,51,37,0,8,43
40,Fail,42,47,2,9,33
40,Fail,48,35,0,16,32
40,Fail,45,30,10,15,30
40,Success,54,32,0,13,41
40,Success,51,31,0,7,44
40,Fail,46,35,3,16,30
40,Success,48,37,0,6,42
40,Fail,52,29,0,15,37
40,Success,54,31,1,14,40
40,Fail,42,35,9,14,28
40,Fail,44,38,4,14,30
40,Fail,46,32,0,17,29
40,Fail,41,35,0,16,25
40,Fail,46,44,0,10,36
40,Success,53,30,0,13,40
40,Success,51,30,8,11,40
40,Fail,43,36,0,13,30
40,Fail,50,39,0,11,39
40,Fail,43,38,4,15,28
40,Fail,41,41,1,17,24
40,Success,52,34,7,7,45
40,Fail,47,30,0,14,33
40,Fail,41,39,5,15,26
40,Fail,48,34,0,11,37
40,Success,52,36,3,9,43
40,Success,46,46,2,6,40
40,Fail,47,38,0,9,38
40,Fail,51,35,0,14,37
40,Success,54,35,0,11,43
40,Fail,40,42,0,11,29
40,Fail,43,34,0,17,26
40,Fail,49,34,2,15,34
40,Fail,44,37,0,11,33
40,Success,51,38,0,11,40
40,Success,51,38,0,11,40
40,Fail,42,44,0,5,37
40,Fail,47,38,3,12,35
40,Fail,47,35,1,17,30
40,Fail,49,33,7,11,38
40,Fail,47,33,0,14,33
40,Success,54,37,3,6,48
40,Fail,48,37,1,14,34
40,Fail,48,38,0,11,37
40,Fail,48,35,0,9,39
40,Fail,43,33,7,17,26
40,Fail,46,35,0,12,34
40,Fail,48,34,0,12,36
40,Fail,45,37,4,14,31
40,Fail,51,31,0,14,37
40,Success,50,37,4,9,41
40,Success,53,40,0,6,47
40,Fail,50,35,0,14,36
40,Success,54,30,4,12,42
40,Fail,42,41,0,15,27
40,Fail,47,36,3,14,33
40,Success,51,38,0,11,40
40,Success,58,30,0,11,47
40,Success,52,36,2,10,42
40,Fail,50,30,7,13,37
40,Fail,51,26,8,15,36
40,Fail,42,36,4,18,24
40,Fail,50,35,2,13,37
40,Fail,44,36,2,18,26
40,Fail,43,41,5,11,32
40,Fail,46,31,7,16,30
40,Fail,45,38,3,14,31
40,Fail,53,28,3,16,37
40,Success,55,37,2,6,49
40,Success,57,30,0,9,48
40,Fail,47,33,10,10,37
40,Fail,44,44,0,9,35
40,Fail,44,42,0,12,32
40,Success,55,28,7,10,45
40,Success,53,29,6,12,41
40,Fail,50,32,0,11,39
40,Fail,50,28,7,15,35
40,Fail,51,32,3,14,37
40,Fail,42,44,4,10,32
40,Success,53,32,0,12,41
40,Success,54,38,0,4,50
40,Fail,41,37,5,17,24
40,Fail,48,31,0,19,29
40,Fail,44,38,7,11,33
40,Success,55,37,1,7,48
40,Fail,46,41,4,9,37
40,Success,49,41,0,8,41
40,Fail,46,40,6,8,38
40,Fail,52,30,0,14,38
40,Fail,50,37,0,11,39
40,Success,54,37,0,8,46
40,Fail,50,30,8,12,38
40,Fail,44,37,0,18,26
40,Fail,45,38,3,14,31
40,Fail,40,34,8,18,22
40,Fail,46,30,13,11,35
40,Fail,50,36,1,13,37
40,Fail,50,35,0,14,36
40,Fail,43,38,0,12,31
40,Success,56,29,0,11,45
40,Fail,43,39,8,10,33
40,Fail,52,33,1,14,38
40,Fail,47,36,0,11,36
40,Fail,46,35,0,18,28
40,Fail,47,35,4,14,33
40,Fail,46,41,0,9,37
40,Fail,44,39,2,15,29
40,Success,51,35,3,11,40
40,Fail,42,44,0,12,30
40,Success,55,33,0,12,43
40,Fail,52,25,8,15,37
40,Fail,40,36,3,21,19
40,Success,53,32,0,8,45
40,Fail,51,26,9,14,37
40,Fail,48,34,0,10,38
40,Fail,42,37,0,14,28
40,Fail,47,33,5,15,32
40,Fail,51,35,0,12,39
40,Fail,46,34,0,16,30
40,Success,50,40,0,9,41
40,Fail,39,40,0,13,26
40,Fail,45,38,0,12,33
40,Fail,49,38,2,11,38
40,Fail,49,37,0,12,37
40,Fail,52,26,7,15,37
40,Success,55,32,7,6,49
40,Fail,52,31,1,16,36
40,Fail,48,42,1,9,39
40,Fail,49,38,0,12,37
40,Success,50,42,0,6,44
40,Fail,49,31,10,10,39
40,Success,56,34,0,10,46
40,Fail,41,35,9,15,26
40,Success,55,32,0,11,44
40,Success,57,29,5,9,48
40,Fail,49,31,4,16,33
40,Fail,46,39,3,12,34
40,Fail,50,35,0,13,37
40,Fail,42,40,3,15,27
40,Fail,45,34,6,15,30
40,Fail,46,41,1,12,34
40,Success,49,42,1,8,41
40,Success,54,32,0,10,44
40,Success,52,35,0,9,43
40,Fail,51,31,0,15,36
40,Fail,38,25,0,19,19
40,Fail,50,37,0,12,38
40,Success,55,33,0,11,44
40,Success,52,34,0,12,40
40,Fail,49,37,0,13,36
40,Success,56,27,3,14,42
40,Fail,49,34,5,12,37
40,Fail,46,40,0,11,35
40,Fail,43,43,0,13,30
40,Fail,48,32,0,20,28
40,Fail,45,41,3,11,34
40,Fail,38,45,0,8,30
40,Success,55,31,0,11,44
40,Fail,43,43,0,9,34
40,Fail,41,41,0,11,30
40,Fail,44,40,5,11,33
40,Fail,44,41,0,11,33
40,Fail,48,37,4,11,37
40,Success,54,37,0,8,46
40,Fail,46,34,7,13,33
40,Fail,45,34,10,11,34
40,Fail,48,39,0,10,38
40,Success,51,32,6,11,40
40,Fail,50,31,0,18,32
40,Fail,47,37,0,12,35
40,Success,52,37,3,8,44
40,Fail,48,31,2,19,29
40,Fail,51,34,0,13,38
40,Fail,48,38,3,11,37
40,Success,56,33,0,11,45
40,Success,53,30,0,10,43
40,Fail,44,40,2,14,30
40,Success,59,33,0,8,51
40,Fail,47,34,0,16,31
40,Fail,42,41,3,14,28
40,Fail,47,37,0,10,37
40,Fail,48,32,3,17,31
40,Success,53,40,1,6,47
40,Fail,46,37,9,8,38
40,Fail,51,35,0,14,37
40,Fail,48,38,3,11,37
40,Fail,46,42,0,9,37
40,Fail,51,36,1,12,39
40,Fail,42,39,3,16,26
40,Success,52,31,0,12,40
40,Fail,50,28,7,15,35
40,Fail,46,37,5,12,34
40,Success,49,41,5,5,44
40,Fail,49,34,2,15,34
40,Fail,48,32,7,13,35
40,Fail,46,33,6,15,31
40,Fail,42,37,0,18,24
40,Success,54,32,4,10,44
40,Success,55,34,0,11,44
40,Fail,45,40,0,14,31
40,Success,53,31,4,12,41
40,Fail,50,39,0,11,39
40,Fail,45,40,1,14,31
40,Success,55,34,1,10,45
40,Success,51,39,3,7,44
40,Success,49,40,0,5,44
40,Fail,49,36,2,13,36
40,Fail,46,35,0,14,32
40,Fail,41,40,0,18,23
40,Success,54,28,9,9,45
40,Fail,45,34,3,18,27
40,Fail,49,35,0,16,33
40,Success,56,29,0,11,45
40,Fail,43,45,0,12,31
40,Fail,46,38,5,11,35
40,Fail,46,40,0,12,34
40,Success,49,40,0,8,41
40,Fail,40,35,12,13,27
40,Fail,48,35,0,15,33
40,Fail,48,36,0,12,36
40,Success,54,32,0,11,43
40,Fail,46,37,0,16,30
40,Success,51,36,0,11,40
40,Fail,46,35,0,13,33
40,Success,60,29,0,9,51
40,Fail,45,33,0,17,28
40,Fail,46,39,5,10,36
40,Fail,38,41,0,16,22
40,Fail,45,38,0,14,31
40,Fail,48,37,6,9,39
40,Fail,49,34,3,14,35
40,Success,51,36,2,11,40
40,Fail,50,32,5,13,37
40,Fail,46,34,7,13,33
40,Fail,44,40,0,10,34
40,Fail,45,35,8,12,33
40,Fail,46,33,0,13,33
40,Fail,47,40,2,11,36
40,Fail,42,36,6,16,26
40,Fail,35,37,11,17,18
40,Fail,45,40,0,14,31
40,Fail,47,40,1,12,35
40,Fail,49,36,0,12,37
40,Fail,45,36,5,14,31
40,Fail,38,42,10,10,28
40,Fail,46,42,0,12,34
40,Fail,39,38,0,13,26
40,Fail,43,37,0,13,30
40,Fail,44,40,3,13,31
40,Fail,37,36,0,15,22
40,Fail,50,39,0,11,39
40,Fail,37,42,7,14,23
40,Fail,45,42,0,12,33
40,Fail,44,40,0,14,30
40,Fail,46,37,0,14,32
40,Success,57,31,0,10,47
40,Fail,37,41,1,21,16
40,Success,55,30,0,13,42
40,Fail,43,30,13,14,29
40,Fail,46,35,7,12,34
40,Fail,45,35,6,14,31
40,Success,51,34,0,11,40
40,Fail,51,29,0,12,39
40,Fail,49,34,0,12,37
40,Fail,45,41,1,13,32
40,Fail,48,34,2,16,32
40,Fail,44,35,0,14,30
40,Success,48,41,0,8,40
40,Fail,48,39,2,11,37
40,Fail,48,38,0,14,34
40,Fail,47,27,7,19,28
40,Fail,45,36,0,18,27
40,Fail,52,26,6,16,36
40,Fail,45,34,0,16,29
40,Fail,41,38,5,16,25
40,Success,49,41,0,9,40
40,Fail,49,35,0,14,35
40,Fail,45,40,0,9,36
40,Success,49,41,0,6,43
40,Fail,44,33,0,14,30
40,Fail,45,33,6,16,29
40,Fail,49,40,0,10,39
40,Success,58,30,0,9,49
40,Success,52,38,0,10,42
40,Fail,48,25,0,17,31
40,Fail,48,36,0,14,34
40,Fail,46,33,9,12,34
40,Success,56,30,0,13,43
40,Success,55,31,0,13,42
40,Fail,42,41,5,12,30
40,Success,49,32,11,8,41
40,Fail,51,36,0,12,39
40,Fail,43,29,0,22,21
40,Fail,42,38,10,10,32
40,Fail,51,30,1,18,33
40,Fail,48,38,0,14,34
40,Fail,50,35,0,14,36
40,Success,54,32,0,13,41
40,Fail,52,34,0,13,39
40,Fail,45,25,0,15,30
40,Fail,49,28,6,17,32
40,Success,56,31,2,11,45
40,Fail,47,32,11,10,37
40,Fail,48,31,11,10,38
40,Fail,42,46,0,6,36
40,Success,52,32,0,11,41
40,Success,52,40,1,7,45
40,Fail,48,38,0,14,34
40,Fail,41,38,0,12,29
40,Success,54,29,3,14,40
40,Fail,41,45,5,9,32
40,Fail,43,50,2,5,38
40,Success,51,36,3,10,41
40,Fail,45,36,4,15,30
40,Fail,46,38,0,14,32
40,Fail,51,36,0,12,39
40,Fail,47,30,0,18,29
40,Fail,53,29,0,15,38
40,Fail,46,37,0,17,29
40,Success,50,39,1,10,40
40,Success,49,35,0,9,40
40,Fail,43,38,1,18,25
40,Fail,47,39,0,13,34
40,Success,53,39,0,8,45
40,Fail,47,35,7,11,36
40,Success,54,35,2,9,45
40,Fail,48,34,5,13,35
40,Success,59,20,0,11,48
40,Fail,50,33,5,12,38
40,Fail,48,38,5,9,39
40,Fail,43,38,0,16,27
40,Fail,50,35,3,12,38
40,Fail,46,37,3,14,32
40,Fail,51,31,0,16,35
40,Fail,42,46,2,10,32
40,Fail,44,31,5,20,24
40,Fail,45,38,0,12,33
40,Success,51,33,6,10,41
40,Success,54,32,0,11,43
40,Fail,50,31,0,12,38
40,Fail,44,33,8,15,29
40,Success,55,37,0,6,49
40,Success,54,26,7,13,41
40,Success,52,32,0,11,41
40,Success,52,34,4,10,42
40,Fail,50,29,7,14,36
40,Success,52,31,0,11,41
40,Fail,47,42,2,9,38
40,Fail,47,37,4,12,35
40,Fail,42,43,0,13,29
40,Fail,42,42,1,15,27
40,Fail,45,35,0,16,29
40,Fail,45,35,0,13,32
40,Fail,38,39,0,20,18
40,Fail,49,35,5,11,38
40,Fail,50,31,3,16,34
40,Success,51,36,0,5,46
40,Fail,47,32,0,15,32
40,Fail,47,35,0,14,33
40,Fail,47,39,0,8,39
40,Fail,48,37,0,10,38
40,Fail,45,32,0,15,30
40,Fail,54,28,2,16,38
40,Success,49,42,0,9,40
40,Success,52,34,3,11,41
40,Fail,47,39,0,10,37
40,Fail,49,34,0,11,38
40,Success,51,36,5,8,43
40,Fail,38,40,0,15,23
40,Fail,45,29,8,18,27
40,Fail,48,36,0,13,35
40,Fail,41,41,4,14,27
40,Fail,44,34,2,20,24
40,Success,51,34,4,11,40
40,Fail,46,40,1,13,33
40,Fail,42,43,0,8,34
40,Fail,47,36,0,15,32
40,Fail,41,40,0,13,28
40,Fail,51,36,1,12,39
40,Fail,49,34,0,17,32
40,Fail,38,33,0,18,20
40,Fail,47,38,2,13,34
40,Fail,50,34,0,14,36
40,Fail,43,43,0,12,31
40,Fail,47,44,0,9,38
40,Success,50,39,0,10,40
40,Fail,44,35,0,13,31
40,Fail,43,37,5,15,28
40,Fail,52,33,1,14,38
40,Fail,46,39,0,11,35
40,Fail,46,40,7,7,39
40,Success,60,23,0,12,48
40,Fail,45,38,9,8,37
40,Fail,49,36,4,11,38
40,Fail,47,39,0,8,39
40,Fail,47,34,0,14,33
40,Fail,42,41,5,12,30
40,Fail,40,41,2,17,23
40,Fail,48,39,1,12,36
40,Success,56,36,3,5,51
40,Fail,42,41,6,11,31
40,Success,54,34,0,12,42
40,Success,53,31,3,13,40
40,Fail,44,31,0,18,26
40,Fail,49,35,0,12,37
40,Fail,48,36,1,15,33
40,Fail,50,33,0,14,36
40,Success,51,37,0,8,43
40,Fail,45,32,0,15,30
40,Fail,50,33,0,12,38
40,Success,52,34,0,10,42
40,Success,50,39,0,10,40
40,Success,49,37,0,9,40
40,Fail,49,30,0,12,37
40,Fail,49,34,2,15,34
40,Fail,45,33,0,14,31
40,Fail,42,39,7,12,30
40,Fail,40,36,9,15,25
40,Fail,45,37,0,11,34
40,Success,49,42,0,8,41
40,Fail,49,34,0,14,35
40,Fail,50,30,0,17,33
40,Fail,43,40,0,17,26
40,Fail,48,39,1,12,36
40,Fail,50,34,3,13,37
40,Fail,47,43,0,10,37
40,Fail,38,43,7,12,26
40,Fail,51,35,2,12,39
40,Fail,47,35,0,13,34
40,Fail,45,37,3,15,30
40,Success,53,32,0,13,40
40,Success,54,36,0,9,45
40,Fail,47,39,5,9,38
40,Fail,49,39,0,10,39
40,Fail,48,37,0,9,39
40,Success,53,34,0,10,43
40,Fail,51,28,5,16,35
40,Fail,44,35,3,18,26
40,Fail,40,41,5,14,26
40,Success,49,45,0,6,43
40,Success,53,31,0,10,43
40,Fail,52,31,2,15,37
40,Fail,47,37,6,10,37
40,Fail,44,37,0,14,30
40,Success,53,35,5,7,46
40,Fail,48,32,8,12,36
40,Fail,41,36,0,17,24
40,Success,47,39,8,6,41
40,Success,56,27,8,9,47
40,Fail,42,40,0,14,28
40,Fail,43,37,9,11,32
40,Success,48,33,0,6,42
40,Success,53,33,0,10,43
40,Fail,47,36,4,13,34
40,Fail,48,42,1,9,39
40,Fail,43,37,7,13,30
40,Success,52,36,0,9,43
40,Fail,44,32,6,18,26
40,Success,50,39,3,8,42
40,Success,53,34,0,13,40
40,Fail,50,30,5,15,35
40,Fail,49,35,5,11,38
40,Fail,47,37,0,16,31
40,Fail,38,41,6,15,23
40,Success,55,32,1,12,43
40,Fail,50,34,0,13,37
40,Fail,50,35,2,13,37
40,Fail,37,38,0,15,22
40,Fail,51,30,5,14,37
40,Fail,51,34,2,13,38
40,Success,55,30,0,14,41
40,Fail,46,36,2,16,30
40,Fail,44,30,0,14,30
40,Fail,38,46,0,14,24
40,Success,52,32,5,11,41
40,Success,52,32,0,12,40
40,Fail,48,40,0,9,39
40,Success,52,32,0,8,44
40,Fail,38,40,0,15,23
40,Success,53,34,0,9,44
40,Fail,40,40,0,11,29
40,Fail,46,32,0,19,27
40,Fail,49,35,0,15,34
40,Fail,46,42,0,12,34
40,Fail,43,36,0,17,26
40,Fail,49,37,0,14,35
40,Success,51,37,0,7,44
40,Success,57,33,0,8,49
40,Success,50,36,6,8,42
40,Fail,56,27,0,17,39
40,Fail,42,37,3,18,24
40,Fail,52,27,0,15,37
40,Fail,44,31,0,16,28
40,Fail,45,40,0,13,32
40,Success,56,30,0,14,42
40,Fail,44,41,1,14,30
40,Fail,44,36,0,15,29
40,Fail,47,37,0,14,33
40,Fail,45,34,2,19,26
40,Success,53,36,0,11,42
40,Fail,50,34,0,13,37
40,Fail,48,40,0,11,37
40,Fail,38,38,8,16,22
40,Fail,48,25,8,19,29
40,Success,49,41,1,9,40
40,Fail,41,39,0,15,26
40,Fail,47,27,0,20,27
40,Fail,46,34,6,14,32
40,Fail,41,33,0,17,24
40,Fail,48,36,4,12,36
40,Fail,45,38,5,12,33
40,Success,51,32,9,8,43
40,Success,51,38,0,6,45
40,Fail,45,33,9,13,32
40,Fail,43,40,0,10,33
40,Fail,35,40,0,18,17
40,Fail,40,38,0,16,24
40,Fail,40,25,0,14,26
40,Success,49,39,6,6,43
40,Fail,47,34,0,13,34
40,Success,52,36,5,7,45
40,Fail,50,36,1,13,37
40,Fail,49,32,2,17,32
40,Fail,40,29,15,16,24
40,Success,54,32,0,14,40
40,Success,53,33,0,12,41
40,Fail,52,30,4,14,38
40,Fail,47,35,0,13,34
40,Fail,43,42,0,11,32
40,Fail,40,42,8,10,30
40,Fail,48,38,5,9,39
40,Success,54,36,0,8,46
40,Fail,45,42,0,13,32
40,Fail,47,33,0,13,34
40,Fail,46,38,3,13,33
40,Success,55,30,0,15,40
40,Fail,54,26,0,17,37
40,Success,51,35,4,10,41
40,Success,52,37,0,8,44
40,Fail,50,36,3,11,39
40,Fail,41,38,0,10,31
40,Fail,45,35,0,17,28
40,Fail,45,35,12,8,37
40,Success,54,35,0,10,44
40,Fail,43,41,0,14,29
40,Fail,39,37,0,20,19
40,Fail,43,39,8,10,33
40,Fail,50,28,0,15,35
40,Fail,49,35,0,16,33
40,Fail,51,27,10,12,39
40,Success,53,35,1,11,42
40,Fail,39,38,0,14,25
40,Fail,45,36,3,16,29
40,Fail,43,34,0,18,25
40,Fail,50,29,8,13,37
40,Fail,51,33,0,16,35
40,Fail,47,34,0,15,32
40,Fail,50,36,0,13,37
40,Success,50,41,5,4,46
40,Fail,49,39,2,10,39
40,Fail,51,33,0,15,36
40,Fail,45,40,0,15,30
40,Fail,48,36,0,14,34
40,Fail,48,40,3,9,39
40,Fail,43,40,0,11,32
40,Fail,48,33,5,14,34
40,Success,54,32,2,12,42
40,Fail,48,35,0,15,33
40,Fail,40,40,0,17,23
40,Success,57,30,0,13,44
40,Success,53,37,3,7,46
40,Fail,48,35,3,14,34
40,Fail,48,37,0,9,39
40,Fail,43,39,0,12,31
40,Fail,46,27,9,18,28
40,Success,52,37,0,9,43
40,Fail,46,43,0,9,37
40,Success,57,30,2,11,46
40,Fail,43,41,0,10,33
40,Fail,44,38,1,17,27
40,Fail,46,35,1,18,28
40,Fail,47,33,0,15,32
40,Fail,51,37,0,12,39
40,Fail,46,39,0,11,35
40,Success,50,38,2,10,40
40,Success,52,34,0,10,42
40,Success,52,36,5,7,45
40,Fail,50,34,0,16,34
40,Fail,52,33,0,15,37
40,Fail,49,31,8,12,37
40,Fail,45,36,0,16,29
40,Fail,46,37,9,8,38
40,Fail,46,30,0,13,33
40,Fail,50,34,0,11,39
40,Fail,49,33,0,11,38
40,Fail,49,36,0,13,36
40,Success,50,38,3,9,41
40,Fail,43,35,0,22,21
40,Fail,42,41,0,10,32
40,Fail,49,34,5,12,37
40,Success,49,40,0,8,41
40,Success,53,39,0,8,45
40,Fail,46,35,9,10,36
40,Fail,46,39,0,12,34
40,Fail,49,34,1,16,33
40,Fail,48,40,2,10,38
40,Fail,48,37,0,12,36
40,Fail,44,43,0,11,33
40,Fail,43,35,0,15,28
40,Fail,42,38,7,13,29
40,Success,53,29,0,12,41
40,Success,53,32,4,11,42
40,Fail,52,29,0,13,39
40,Fail,46,39,2,13,33
40,Success,53,33,0,11,42
40,Success,55,36,0,7,48
40,Fail,45,36,5,14,31
40,Fail,45,36,7,12,33
40,Success,54,39,0,4,50
40,Fail,48,41,0,10,38
40,Fail,51,31,3,15,36
40,Fail,45,40,1,14,31
40,Fail,51,29,0,15,36
40,Success,55,30,0,12,43
40,Fail,48,37,0,14,34
40,Fail,47,35,0,14,33
40,Fail,52,35,0,13,39
40,Fail,51,33,4,12,39
40,Fail,47,42,0,10,37
40,Fail,49,26,9,16,33
40,Fail,41,39,5,15,26
40,Fail,47,37,3,13,34
40,Fail,40,39,8,13,27
40,Success,51,40,0,8,43
40,Fail,47,36,3,14,33
40,Success,53,32,0,13,40
40,Fail,47,34,5,14,33
40,Fail,50,34,0,16,34
40,Fail,51,37,0,12,39
40,Fail,48,30,0,15,33
40,Fail,51,30,0,16,35
40,Success,59,27,0,13,46
40,Fail,42,38,3,17,25
40,Fail,42,38,4,16,26
40,Fail,47,35,0,13,34
40,Fail,44,44,2,10,34
40,Fail,49,28,6,17,32
40,Success,53,34,5,8,45
40,Fail,46,37,0,17,29
40,Success,53,31,0,10,43
40,Success,59,33,0,7,52
40,Fail,52,33,1,14,38
40,Success,50,36,0,10,40
40,Fail,52,32,1,15,37
40,Success,58,25,0,12,46
40,Fail,47,35,3,15,32
40,Fail,46,35,10,9,37
40,Fail,43,36,0,19,24
40,Fail,44,36,0,14,30
40,Fail,45,37,3,15,30
40,Success,56,38,0,6,50
40,Fail,51,34,3,12,39
40,Success,53,35,0,10,43
40,Fail,45,40,0,12,33
40,Fail,46,39,0,13,33
40,Fail,45,37,0,18,27
40,Success,54,36,0,8,46
40,Fail,38,44,8,10,28
40,Success,53,33,0,10,43
40,Fail,45,42,0,12,33
40,Fail,47,38,0,10,37
40,Fail,47,39,0,8,39
40,Success,56,31,2,11,45
40,Success,52,34,0,9,43
40,Fail,48,37,3,12,36
40,Fail,48,38,0,13,35
40,Fail,49,41,0,10,39
40,Fail,51,31,0,13,38
40,Fail,46,34,0,16,30
40,Fail,51,33,2,14,37
40,Success,59,34,2,5,54
40,Success,54,31,0,14,40
40,Fail,53,25,6,16,37
40,Fail,41,39,0,17,24
40,Success,53,32,2,13,40
40,Fail,45,43,1,11,34
40,Fail,49,32,9,10,39
40,Fail,51,30,0,18,33
40,Fail,41,35,9,15,26
40,Fail,44,29,0,19,25
40,Fail,50,36,0,13,37
40,Fail,43,40,4,13,30
40,Fail,44,32,0,16,28
40,Fail,45,33,0,21,24
40,Fail,52,31,2,15,37
40,Fail,41,41,4,14,27
40,Success,53,34,0,8,45
40,Fail,48,39,0,12,36
40,Fail,52,31,0,17,35
40,Success,59,32,2,7,52
40,Fail,43,46,0,11,32
40,Fail,45,31,7,17,28
40,Success,53,27,7,13,40
40,Success,51,33,0,9,42
40,Success,56,38,0,6,50
40,Fail,46,41,0,11,35
40,Fail,49,34,0,14,35
40,Fail,47,33,9,11,36
40,Fail,43,37,0,7,36
40,Success,52,34,0,12,40
40,Success,51,39,0,5,46
40,Fail,51,26,11,12,39
40,Fail,48,29,0,15,33
40,Fail,47,38,2,13,34
40,Success,54,33,2,11,43
40,Fail,45,43,0,11,34
40,Fail,46,35,0,15,31
40,Fail,45,37,0,11,34
40,Fail,46,38,4,12,34
40,Success,56,35,0,8,48
40,Fail,54,30,0,15,39
40,Success,50,37,5,8,42
40,Fail,47,38,6,9,38
40,Fail,46,28,13,13,33
40,Success,54,32,0,12,42
40,Fail,47,40,0,10,37
40,Success,52,36,0,11,41
40,Success,48,41,4,7,41
40,Fail,42,40,6,12,30
40,Fail,47,38,0,12,35
40,Fail,50,33,0,17,33
40,Fail,48,34,4,14,34
40,Fail,39,40,0,17,22
40,Fail,47,30,0,16,31
40,Fail,48,39,1,12,36
40,Fail,46,38,0,10,36
40,Success,56,37,0,5,51
40,Fail,46,43,1,10,36
40,Fail,44,32,13,11,33
40,Fail,51,34,3,12,39
40,Fail,44,34,5,17,27
40,Fail,39,42,0,17,22
40,Fail,38,43,0,15,23
40,Fail,52,31,0,13,39
40,Fail,46,42,0,11,35
40,Fail,48,39,0,12,36
40,Fail,50,36,0,14,36
40,Fail,46,39,0,13,33
40,Success,53,38,1,8,45
40,Fail,49,35,2,14,35
40,Success,55,30,0,10,45
40,Fail,46,35,8,11,35
40,Fail,44,45,0,8,36
40,Fail,48,30,5,17,31
40,Fail,43,35,0,15,28
40,Fail,44,34,8,14,30
40,Fail,47,36,0,17,30
40,Fail,47,30,0,15,32
40,Fail,45,35,0,15,30
40,Fail,42,39,7,12,30
40,Success,55,29,0,14,41
40,Success,47,40,8,5,42
40,Fail,45,42,0,10,35
40,Fail,49,37,0,13,36
40,Success,56,36,2,6,50
40,Fail,46,34,2,18,28
40,Fail,47,39,2,12,35
40,Success,52,32,7,9,43
40,Success,55,30,0,13,42
40,Fail,49,34,1,16,33
40,Success,57,31,0,11,46
40,Success,50,40,3,7,43
40,Success,50,38,3,9,41
40,Fail,51,31,6,12,39
40,Fail,45,33,8,14,31
40,Fail,49,36,0,11,38
40,Success,50,39,0,10,40
40,Fail,46,36,6,12,34
40,Fail,46,37,4,13,33
40,Fail,46,36,4,14,32
40,Fail,50,35,1,14,36
40,Fail,45,36,0,14,31
40,Fail,42,36,7,15,27
40,Fail,48,39,1,12,36
40,Success,54,36,1,9,45
40,Fail,43,39,0,13,30
40,Success,56,24,0,13,43
40,Success,54,32,4,10,44
40,Fail,49,32,3,16,33
40,Fail,47,35,0,13,34
40,Fail,51,28,0,16,35
40,Fail,45,44,0,10,35
40,Fail,52,31,3,14,38
40,Success,54,30,7,9,45
40,Success,57,36,0,5,52
40,Fail,50,36,0,14,36
40,Fail,44,43,3,10,34
40,Fail,46,39,2,13,33
40,Fail,44,43,2,11,33
40,Success,53,33,0,13,40
40,Success,52,35,3,10,42
40,Fail,45,30,0,18,27
40,Success,53,31,0,10,43
40,Success,51,38,0,9,42
40,Fail,49,33,0,18,31
40,Fail,47,37,0,10,37
40,Fail,50,33,3,14,36
40,Success,49,41,0,8,41
40,Fail,45,37,0,11,34
40,Fail,48,34,2,16,32
40,Fail,48,37,0,15,33
40,Success,58,25,3,14,44
40,Fail,41,35,0,20,21
40,Fail,39,41,5,15,24
40,Fail,49,36,0,12,37
40,Fail,44,28,13,15,29
40,Fail,41,46,1,12,29
40,Success,52,34,6,8,44
40,Fail,50,39,0,11,39
40,Fail,47,38,5,10,37
40,Success,50,41,1,8,42
40,Fail,41,44,1,14,27
40,Success,49,42,0,5,44
40,Success,52,34,2,12,40
40,Fail,42,40,9,9,33
40,Fail,51,31,6,12,39
40,Fail,41,41,5,13,28
40,Fail,46,33,5,16,30
40,Fail,50,29,3,18,32
40,Success,52,34,0,10,42
40,Fail,50,33,0,15,35
40,Fail,51,35,0,14,37
40,Fail,50,35,0,11,39
40,Fail,44,41,6,9,35
40,Fail,51,31,0,15,36
40,Fail,42,38,0,16,26
40,Fail,45,40,3,12,33
40,Fail,46,41,3,10,36
40,Success,52,34,0,11,41
40,Fail,43,45,2,10,33
40,Fail,44,36,0,10,34
40,Fail,43,42,0,15,28
40,Fail,48,29,7,16,32
40,Fail,52,30,3,15,37
40,Fail,49,28,11,12,37
40,Fail,46,37,0,12,34
40,Fail,33,42,0,14,19
40,Fail,48,38,1,13,35
40,Fail,45,39,0,11,34
40,Fail,47,38,1,14,33
40,Fail,50,37,0,13,37
40,Fail,49,34,0,16,33
40,Success,50,42,0,8,42
40,Fail,41,41,0,16,25
40,Fail,50,33,6,11,39
40,Fail,47,38,0,15,32
40,Success,54,33,0,13,41
40,Fail,52,24,8,16,36
40,Fail,48,32,10,10,38
40,Fail,45,36,0,12,33
40,Success,52,34,0,10,42
40,Fail,44,34,0,15,29
40,Success,55,22,10,13,42
40,Success,55,35,0,9,46
40,Fail,45,38,0,17,28
40,Fail,44,36,4,16,28
40,Fail,48,34,0,16,32
40,Success,54,31,4,11,43
40,Fail,40,34,7,19,21
40,Fail,50,29,9,12,38
40,Success,58,30,0,11,47
40,Fail,46,30,7,17,29
40,Fail,43,38,5,14,29
40,Success,52,33,0,10,42
40,Fail,52,31,4,13,39
40,Fail,51,34,0,15,36
40,Fail,45,40,2,13,32
40,Fail,44,36,0,12,32
40,Fail,45,33,3,19,26
40,Fail,50,32,5,13,37
40,Fail,44,39,3,14,30
40,Fail,50,34,4,12,38
40,Success,59,24,0,10,49
40,Success,52,37,2,9,43
40,Fail,49,36,0,15,34
40,Success,57,29,1,13,44
40,Success,55,36,3,6,49
40,Fail,51,37,0,12,39
40,Fail,49,36,0,11,38
40,Fail,42,34,8,16,26
40,Fail,48,31,6,15,33
40,Fail,49,35,3,13,36
40,Success,52,34,2,12,40
40,Fail,51,28,5,16,35
40,Fail,47,31,0,16,31
40,Fail,41,36,0,11,30
40,Fail,51,33,0,14,37
40,Success,54,31,1,14,40
40,Fail,50,35,1,14,36
40,Fail,49,34,3,14,35
40,Fail,41,39,4,16,25
40,Success,53,30,5,12,41
40,Fail,48,36,0,13,35
40,Fail,51,35,1,13,38
40,Success,51,36,0,10,41
40,Success,52,34,0,11,41
40,Success,57,32,0,10,47
40,Fail,46,35,0,15,31
40,Success,51,35,0,11,40
40,Fail,49,38,0,10,39
40,Fail,42,43,0,12,30
40,Success,51,38,0,9,42
40,Fail,46,32,0,14,32
40,Fail,43,42,0,15,28
40,Success,54,30,0,11,43
40,Fail,44,34,0,19,25
40,Fail,46,40,2,12,34
40,Fail,44,37,3,16,28
40,Success,52,35,2,11,41
40,Success,50,40,1,9,41
40,Success,51,42,1,6,45
40,Fail,46,36,0,10,36
40,Fail,42,36,0,12,30
40,Fail,48,34,0,13,35
40,Fail,45,36,0,16,29
40,Fail,45,36,0,13,32
40,Fail,45,34,0,13,32
40,Success,56,33,0,11,45
40,Fail,49,28,4,19,30
40,Fail,46,32,0,13,33
40,Fail,45,43,1,11,34
40,Fail,52,31,0,15,37
40,Fail,53,30,3,14,39
40,Fail,39,42,6,13,26
40,Success,52,36,0,10,42
40,Fail,51,27,7,15,36
40,Success,53,29,0,11,42
40,Fail,46,38,3,13,33
40,Fail,43,40,0,11,32
40,Fail,47,28,13,12,35
40,Fail,51,33,3,13,38
40,Success,54,30,0,10,44
40,Fail,49,38,1,12,37
40,Fail,48,32,0,9,39
40,Success,55,29,3,13,42
40,Fail,48,36,0,10,38
40,Success,55,36,0,8,47
40,Fail,49,29,0,17,32
40,Fail,48,36,3,13,35
40,Fail,38,35,5,22,16
40,Fail,43,34,0,15,28
40,Fail,38,30,0,24,14
40,Fail,47,32,7,14,33
40,Success,55,31,0,11,44
40,Fail,42,32,8,18,24
40,Fail,47,37,0,12,35
40,Fail,47,33,9,11,36
40,Fail,44,47,1,8,36
40,Success,56,25,3,16,40
40,Fail,48,35,5,12,36
40,Fail,48,35,0,17,31
40,Success,52,35,0,9,43
40,Fail,43,40,0,13,30
40,Success,57,27,3,13,44
40,Fail,46,43,0,10,36
40,Fail,50,32,0,13,37
40,Fail,51,33,2,14,37
40,Success,51,36,0,11,40
40,Fail,46,35,5,14,32
40,Fail,44,33,0,16,28
40,Success,56,29,3,12,44
40,Success,55,29,0,6,49
40,Fail,44,37,3,16,28
40,Success,55,38,1,6,49
40,Fail,50,29,0,18,32
40,Fail,43,45,3,9,34
40,Success,52,33,0,8,44
40,Fail,54,24,0,15,39
40,Fail,45,42,3,10,35
40,Fail,46,30,0,17,29
40,Fail,47,36,4,13,34
40,Fail,44,27,0,19,25
40,Success,56,31,3,10,46
40,Fail,50,34,3,13,37
40,Fail,45,37,2,16,29
40,Fail,47,37,0,9,38
40,Fail,49,33,0,12,37
40,Success,53,32,3,12,41
40,Fail,47,43,0,8,39
40,Fail,45,40,0,10,35
40,Fail,49,33,0,16,33
40,Fail,50,37,0,13,37
40,Fail,51,34,0,13,38
40,Fail,45,39,2,14,31
40,Fail,39,39,0,17,22
40,Fail,49,35,0,15,34
40,Fail,47,38,3,12,35
40,Success,56,37,1,6,50
40,Fail,45,30,13,12,33
40,Success,47,43,0,6,41
40,Fail,47,39,5,9,38
40,Fail,46,30,0,17,29
40,Fail,42,40,8,10,32
40,Fail,46,38,0,14,32
40,Success,48,36,0,7,41
40,Fail,52,31,0,15,37
40,Fail,53,31,0,16,37
40,Fail,49,27,4,20,29
40,Fail,47,38,0,13,34
40,Fail,48,31,6,15,33
40,Fail,45,35,0,14,31
40,Success,52,40,0,8,44
40,Fail,52,28,0,14,38
40,Success,57,32,2,9,48
40,Success,55,35,1,9,46
40,Success,50,41,2,7,43
40,Fail,48,36,4,12,36
40,Fail,50,32,0,18,32
40,Fail,45,40,2,13,32
40,Success,53,37,0,10,43
40,Fail,44,33,0,15,29
40,Fail,45,40,1,14,31
40,Success,49,43,2,6,43
40,Fail,49,31,2,18,31
40,Success,51,36,0,8,43
40,Fail,52,26,0,14,38
40,Fail,48,35,2,15,33
40,Success,52,32,6,10,42
40,Success,53,33,0,11,42
40,Success,50,40,0,9,41
40,Fail,42,35,17,6,36
40,Fail,43,33,4,20,23
40,Fail,47,38,0,12,35
40,Success,49,35,0,8,41
40,Fail,48,37,0,15,33
40,Fail,47,36,0,12,35
40,Fail,46,39,0,12,34
40,Success,56,30,3,11,45
40,Fail,48,38,0,10,38
40,Fail,50,36,3,11,39
40,Fail,51,34,1,14,37
40,Success,54,33,4,9,45
40,Success,48,41,3,8,40
40,Success,52,35,0,12,40
40,Fail,48,40,0,9,39
40,Fail,49,34,5,12,37
40,Success,62,30,0,6,56
40,Fail,48,32,2,18,30
40,Fail,45,40,0,14,31
40,Fail,51,32,0,12,39
40,Fail,49,33,0,18,31
40,Fail,48,39,0,11,37
40,Fail,51,36,0,13,38
40,Fail,49,33,8,10,39
40,Fail,50,29,0,14,36
40,Fail,42,44,2,12,30
40,Fail,46,36,5,13,33
40,Fail,49,35,0,13,36
40,Fail,44,39,3,14,30
40,Success,61,25,0,12,49
40,Success,59,28,0,9,50
40,Fail,44,43,1,12,32
40,Success,54,29,0,12,42
40,Fail,41,42,0,12,29
40,Fail,50,39,0,11,39
40,Fail,41,31,0,15,26
40,Fail,43,42,4,11,32
40,Success,51,36,2,11,40
40,Fail,50,37,2,11,39
40,Fail,47,40,2,11,36
40,Fail,47,39,4,10,37
40,Fail,48,40,1,11,37
40,Success,53,34,3,10,43
40,Success,54,37,0,9,45
40,Fail,52,33,1,14,38
40,Fail,47,34,4,15,32
40,Fail,46,40,0,13,33
40,Fail,41,38,5,16,25
40,Fail,41,43,8,8,33
40,Fail,50,35,4,11,39
40,Success,54,38,0,8,46
40,Fail,47,34,7,12,35
40,Success,52,38,0,10,42
40,Fail,47,33,0,17,30
40,Success,50,38,0,8,42
40,Fail,44,41,2,13,31
40,Success,54,34,7,5,49
40,Fail,46,40,0,13,33
40,Fail,44,42,0,13,31
40,Fail,44,35,0,16,28
40,Fail,49,34,0,13,36
40,Fail,43,36,0,16,27
40,Fail,51,29,6,14,37
40,Fail,43,36,10,11,32
40,Fail,48,31,0,13,35
40,Success,49,36,0,9,40
40,Fail,48,33,0,12,36
40,Fail,53,30,0,17,36
40,Success,52,37,2,9,43
40,Fail,50,33,6,11,39
40,Fail,49,32,3,16,33
40,Fail,48,41,2,9,39
40,Fail,47,40,3,10,37
40,Success,59,27,1,13,46
40,Fail,46,38,1,15,31
40,Fail,50,38,1,11,39
40,Fail,48,33,0,16,32
40,Fail,45,40,3,12,33
40,Fail,45,37,4,14,31
40,Fail,48,34,8,10,38
40,Fail,48,42,1,9,39
40,Fail,38,42,3,17,21
40,Fail,43,34,0,12,31
40,Fail,49,41,0,10,39
40,Fail,45,33,8,14,31
40,Fail,50,32,7,11,39
40,Success,49,39,0,9,40
40,Success,57,32,3,8,49
40,Fail,52,33,0,13,39
40,Fail,39,33,0,18,21
40,Success,56,34,1,9,47
40,Fail,47,38,0,13,34
40,Fail,52,34,0,13,39
40,Success,54,31,5,10,44
40,Fail,42,38,7,13,29
40,Fail,40,41,6,13,27
40,Fail,46,40,2,12,34
40,Fail,46,35,6,13,33
40,Fail,46,37,6,11,35
40,Success,51,32,0,9,42
40,Fail,40,36,12,12,28
40,Fail,46,38,0,14,32
40,Success,55,31,5,9,46
40,Fail,47,34,5,14,33
40,Success,54,36,3,7,47
40,Fail,46,43,0,9,37
40,Success,51,41,0,7,44
40,Fail,47,35,3,15,32
40,Fail,53,28,0,15,38
40,Success,55,32,0,12,43
40,Fail,45,34,0,19,26
40,Fail,48,38,1,13,35
40,Fail,43,33,11,13,30
40,Success,54,32,2,12,42
40,Fail,44,43,0,12,32
40,Success,52,34,0,12,40
40,Fail,44,38,8,10,34
40,Fail,45,34,2,19,26
40,Fail,49,36,5,10,39
40,Fail,41,44,2,13,28
40,Success,51,31,8,10,41
40,Fail,43,32,0,16,27
40,Success,54,37,3,6,48
40,Fail,44,38,6,12,32
40,Fail,51,30,0,15,36
40,Fail,45,42,0,8,37
40,Fail,43,39,0,15,28
40,Success,58,30,0,9,49
40,Fail,48,37,3,12,36
40,Fail,43,34,8,15,28
40,Success,53,33,3,11,42
40,Success,57,32,0,7,50
40,Success,54,32,1,13,41
40,Fail,42,38,8,12,30
40,Success,54,34,0,10,44
40,Fail,48,37,0,11,37
40,Fail,50,29,0,16,34
40,Fail,48,33,0,16,32
40,Fail,45,35,0,17,28
40,Fail,41,33,0,22,19
40,Success,53,32,3,12,41
40,Success,54,34,6,6,48
40,Fail,53,30,0,15,38
40,Fail,45,38,0,15,30
40,Fail,48,32,3,17,31
40,Fail,46,39,1,14,32
40,Fail,37,36,0,22,15
40,Fail,46,39,4,11,35
40,Fail,45,31,9,15,30
40,Fail,50,31,5,14,36
40,Success,56,33,0,11,45
40,Success,56,34,0,5,51
40,Fail,44,42,4,10,34
40,Success,49,39,0,9,40
40,Fail,41,36,0,13,28
40,Fail,47,36,5,12,35
40,Success,48,44,0,8,40
40,Fail,47,30,0,22,25
40,Fail,42,44,3,11,31
40,Fail,48,33,0,16,32
40,Fail,47,38,4,11,36
40,Fail,42,40,0,16,26
40,Fail,46,37,1,16,30
40,Success,53,34,2,11,42
40,Fail,43,43,0,11,32
40,Fail,40,43,13,4,36
40,Fail,50,28,0,16,34
40,Fail,43,37,0,13,30
40,Fail,51,31,0,12,39
40,Fail,45,37,3,15,30
40,Success,52,36,0,11,41
40,Fail,47,32,4,17,30
40,Success,52,36,0,8,44
40,Fail,45,33,0,11,34
40,Fail,48,31,0,17,31
40,Success,55,30,4,11,44
40,Fail,51,34,0,14,37
40,Fail,49,37,0,10,39
40,Fail,48,33,0,16,32
40,Fail,47,38,7,8,39
40,Fail,45,36,4,15,30
40,Success,51,39,0,9,42
40,Fail,44,33,6,17,27
40,Success,55,39,0,4,51
40,Fail,48,34,0,18,30
40,Fail,51,35,1,13,38
40,Success,52,37,0,8,44
40,Success,51,40,0,9,42
40,Fail,49,34,3,14,35
40,Fail,42,43,6,9,33
40,Fail,44,36,0,19,25
40,Success,49,40,2,9,40
40,Fail,42,34,9,15,27
40,Fail,46,43,0,8,38
40,Success,51,34,6,9,42
40,Fail,40,42,0,17,23
40,Fail,52,27,4,17,35
40,Success,49,41,0,8,41
40,Fail,49,33,6,12,37
40,Success,52,34,5,9,43
40,Success,53,28,0,11,42
40,Success,47,44,2,7,40
40,Fail,51,34,0,15,36
40,Fail,50,36,3,11,39
40,Fail,46,35,5,14,32
40,Success,52,38,0,10,42
40,Fail,49,32,6,13,36
40,Success,56,29,3,12,44
40,Fail,42,28,0,20,22
40,Fail,46,34,0,12,34
40,Success,57,35,2,6,51
40,Fail,44,33,0,14,30
40,Fail,44,41,0,15,29
40,Success,51,37,0,11,40
40,Fail,51,30,7,12,39
40,Fail,47,41,0,12,35
40,Fail,47,36,0,12,35
40,Fail,44,39,3,14,30
40,Fail,43,38,0,15,28
40,Success,60,27,0,8,52
40,Fail,47,33,0,16,31
40,Fail,46,34,0,14,32
40,Success,50,37,0,8,42
40,Fail,41,38,0,8,33
40,Fail,44,38,0,14,30
40,Fail,48,37,2,13,35
40,Fail,39,42,6,13,26
40,Fail,47,43,0,9,38
40,Success,56,31,0,11,45
40,Fail,49,32,0,19,30
40,Fail,46,32,0,21,25
40,Fail,44,33,4,19,25
40,Fail,42,36,0,9,33
40,Fail,46,38,3,13,33
40,Fail,43,34,0,12,31
40,Fail,42,47,1,10,32
40,Fail,47,35,0,15,32
40,Fail,47,37,4,12,35
40,Fail,52,31,0,13,39
40,Success,52,38,0,10,42
40,Fail,46,36,0,16,30
40,Fail,42,40,7,11,31
40,Success,49,39,0,9,40
40,Success,51,37,0,11,40
40,Fail,42,37,0,16,26
40,Fail,41,39,7,13,28
40,Fail,39,37,0,16,23
40,Success,54,33,4,9,45
40,Fail,44,37,0,12,32
40,Fail,48,38,3,11,37
40,Fail,50,33,5,12,38
40,Success,50,40,0,8,42
40,Fail,46,41,0,12,34
40,Fail,43,34,0,16,27
40,Fail,47,34,0,12,35
40,Success,54,29,7,10,44
40,Fail,49,35,6,10,39
40,Success,49,37,7,7,42
40,Fail,46,42,0,12,34
40,Fail,41,35,9,15,26
40,Success,57,33,0,10,47
40,Fail,41,37,0,12,29
40,Fail,48,35,0,12,36
40,Fail,45,38,3,14,31
40,Success,48,42,0,8,40
40,Fail,45,43,2,10,35
40,Fail,46,41,1,12,34
40,Fail,48,37,0,10,38
40,Fail,48,35,0,15,33
40,Fail,43,37,0,11,32
40,Fail,43,40,12,5,38
40,Success,56,33,1,10,46
40,Fail,44,38,3,15,29
40,Fail,42,37,0,20,22
40,Fail,46,41,0,11,35
40,Fail,46,33,9,12,34
40,Fail,46,39,3,12,34
40,Success,56,32,2,10,46
40,Fail,46,43,2,9,37
40,Fail,48,32,0,14,34
40,Fail,48,35,0,17,31
40,Fail,43,46,2,9,34
40,Fail,50,32,0,15,35
40,Fail,38,48,0,14,24
40,Fail,45,31,5,19,26
40,Success,57,24,9,10,47
40,Fail,41,47,0,11,30
40,Fail,47,38,2,13,34
40,Fail,50,34,0,11,39
40,Fail,49,38,1,12,37
40,Success,52,37,2,9,43
40,Fail,50,31,8,11,39
40,Fail,47,39,4,10,37
40,Success,56,30,0,10,46
40,Fail,45,31,9,15,30
40,Success,56,30,0,13,43
40,Fail,46,36,1,17,29
40,Fail,49,35,6,10,39
40,Fail,34,40,0,23,11
40,Fail,51,36,0,13,38
40,Fail,46,40,0,10,36
40,Fail,49,36,1,14,35
40,Fail,38,33,10,19,19
40,Fail,52,25,0,18,34
40,Fail,46,41,2,11,35
40,Success,54,38,0,5,49
40,Fail,48,37,0,13,35
40,Fail,44,32,0,24,20
40,Fail,52,32,0,13,39
40,Fail,42,32,0,13,29
40,Fail,49,38,0,13,36
40,Fail,53,31,0,15,38
40,Fail,48,37,0,13,35
40,Fail,45,38,0,13,32
40,Success,56,32,2,10,46
40,Fail,38,37,6,19,19
40,Fail,47,31,0,20,27
40,Fail,47,36,0,13,34
40,Fail,53,30,3,14,39
40,Fail,48,34,0,13,35
40,Fail,46,43,0,8,38
40,Fail,37,43,0,10,27
40,Fail,44,37,0,13,31
40,Fail,47,34,2,17,30
40,Fail,43,42,1,14,29
40,Fail,47,37,2,14,33
40,Fail,47,40,4,9,38
40,Success,51,35,5,9,42
40,Fail,49,39,0,11,38
40,Fail,48,41,2,9,39
40,Success,55,27,3,15,40
40,Fail,46,39,0,13,33
40,Fail,49,25,0,19,30
40,Fail,39,43,7,11,28
40,Fail,49,40,1,10,39
40,Fail,46,29,0,19,27
40,Fail,49,32,0,15,34
40,Fail,47,39,1,13,34
40,Fail,46,39,1,14,32
40,Success,54,32,2,12,42
40,Fail,47,40,2,11,36
40,Success,52,35,0,12,40
40,Success,52,37,2,9,43
40,Success,51,36,3,10,41
40,Fail,45,38,0,9,36
40,Fail,44,39,2,15,29
40,Fail,47,36,8,9,38
40,Fail,44,29,0,17,27
40,Fail,48,35,4,13,35
40,Fail,52,31,0,16,36
40,Success,50,41,0,9,41
40,Fail,46,31,8,15,31
40,Success,52,35,0,9,43
40,Fail,50,32,0,16,34
40,Fail,46,41,0,11,35
40,Fail,48,37,4,11,37
40,Success,53,29,0,11,42
40,Fail,46,40,0,11,35
40,Fail,43,37,0,19,24
40,Fail,46,38,1,15,31
40,Success,49,34,9,8,41
40,Fail,47,30,9,14,33
40,Fail,49,31,5,15,34
40,Success,53,34,1,12,41
40,Success,50,34,6,10,40
40,Fail,44,30,13,13,31
40,Fail,44,35,0,19,25
40,Success,51,38,2,9,42
40,Fail,51,33,2,14,37
40,Fail,52,32,0,14,38
40,Fail,46,40,2,12,34
40,Success,54,31,2,13,41
40,Success,58,34,0,7,51
40,Success,54,32,0,10,44
40,Fail,45,40,3,12,33
40,Fail,49,38,3,10,39
40,Fail,48,38,1,13,35
40,Success,52,36,0,11,41
40,Success,51,36,2,11,40
40,Success,54,35,2,9,45
40,Fail,42,40,6,12,30
40,Fail,48,25,0,15,33
40,Fail,47,38,0,12,35
40,Fail,52,25,10,13,39
40,Success,52,38,0,10,42
40,Fail,48,39,1,12,36
40,Fail,47,39,2,12,35
40,Success,60,26,1,13,47
40,Success,58,30,0,12,46
40,Success,54,31,3,12,42
40,Fail,50,31,1,18,32
40,Fail,48,32,7,13,35
40,Fail,42,36,1,21,21
40,Success,52,38,2,8,44
40,Success,50,40,0,10,40
40,Fail,45,39,2,14,31
40,Fail,52,33,1,14,38
40,Success,56,31,7,6,50
40,Fail,49,33,0,11,38
40,Fail,47,41,0,11,36
40,Fail,45,33,11,11,34
40,Fail,48,34,0,15,33
40,Fail,37,40,0,18,19
40,Fail,49,37,4,10,39
40,Fail,46,37,0,9,37
40,Fail,48,32,0,17,31
40,Fail,40,41,0,17,23
40,Fail,48,37,5,10,38
40,Fail,43,39,3,15,28
40,Success,52,32,6,10,42
40,Fail,48,39,0,12,36
40,Fail,47,28,0,16,31
40,Fail,48,33,0,15,33
40,Success,57,28,1,14,43
40,Fail,41,33,7,19,22
40,Fail,47,35,0,11,36
40,Success,51,41,0,8,43
40,Success,53,33,0,10,43
40,Success,56,33,0,9,47
40,Fail,47,38,0,12,35
40,Fail,46,42,1,11,35
40,Success,50,38,4,8,42
40,Fail,41,43,0,14,27
40,Success,54,32,0,12,42
40,Fail,44,36,0,16,28
40,Fail,44,41,3,12,32
40,Success,55,29,3,13,42
40,Fail,51,36,1,12,39
40,Success,52,33,5,10,42
40,Fail,45,40,4,11,34
40,Fail,44,37,3,16,28
40,Fail,44,37,0,14,30
40,Success,56,32,0,8,48
40,Fail,46,40,0,12,34
40,Fail,48,34,6,12,36
40,Fail,38,42,0,16,22
40,Success,57,33,0,7,50
40,Fail,43,42,2,13,30
40,Success,53,33,0,13,40
40,Success,50,40,1,9,41
40,Success,56,29,4,11,45
40,Fail,45,29,12,14,31
40,Success,58,30,1,11,47
40,Success,49,36,0,8,41
40,Fail,48,35,0,17,31
40,Fail,52,31,0,17,35
40,Success,53,34,2,11,42
40,Fail,43,39,0,12,31
40,Fail,43,33,2,22,21
40,Fail,48,37,0,12,36
40,Fail,38,45,4,13,25
40,Fail,45,37,5,13,32
40,Success,49,42,2,7,42
40,Fail,43,42,0,12,31
40,Success,51,37,0,10,41
40,Fail,46,40,0,13,33
40,Fail,50,33,0,12,38
40,Fail,45,40,3,12,33
40,Success,52,34,0,11,41
40,Fail,48,35,0,11,37
40,Success,53,34,0,12,41
40,Fail,48,27,0,16,32
40,Success,55,32,1,12,43
40,Fail,46,38,0,13,33
40,Success,49,38,5,8,41
40,Fail,49,37,0,12,37
40,Success,56,28,1,15,41
40,Fail,45,32,4,19,26
40,Fail,39,36,0,8,31
40,Fail,46,40,4,10,36
40,Fail,46,34,0,15,31
40,Fail,48,42,0,9,39
40,Fail,45,37,0,8,37
40,Fail,49,33,0,11,38
40,Fail,46,36,2,16,30
40,Fail,43,40,5,12,31
40,Fail,41,44,0,12,29
40,Fail,46,33,0,17,29
40,Success,56,25,0,14,42
40,Success,49,38,0,9,40
40,Fail,50,30,0,13,37
40,Fail,46,37,0,13,33
40,Success,56,27,0,11,45
40,Success,57,27,3,13,44
40,Success,50,37,0,8,42
40,Fail,46,41,3,10,36
40,Fail,48,36,3,13,35
40,Fail,46,40,0,14,32
40,Success,53,33,2,12,41
40,Success,55,32,0,11,44
40,Success,54,32,0,9,45
40,Fail,49,39,0,10,39
40,Fail,44,41,0,10,34
40,Fail,50,36,3,11,39
40,Fail,45,32,0,23,22
40,Fail,49,33,8,10,39
40,Success,54,37,1,8,46
40,Success,53,31,5,11,42
40,Fail,47,36,0,10,37
40,Success,53,39,0,8,45
40,Success,52,31,5,12,40
40,Fail,39,39,0,17,22
40,Fail,45,40,2,13,32
40,Success,55,35,0,9,46
40,Fail,47,35,2,16,31
40,Fail,52,28,7,13,39
40,Fail,44,37,0,15,29
40,Fail,46,31,5,18,28
40,Fail,49,35,2,14,35
40,Fail,46,38,0,15,31
40,Fail,40,45,0,14,26
40,Success,52,35,3,10,42
40,Fail,41,40,0,12,29
40,Fail,47,34,0,14,33
40,Success,56,31,0,10,46
40,Fail,50,34,0,13,37
40,Fail,52,29,5,14,38
40,Fail,47,35,1,17,30
40,Fail,41,38,3,18,23
40,Fail,47,37,0,13,34
40,Fail,45,27,0,24,21
40,Fail,48,35,6,11,37
40,Fail,42,42,0,12,30
40,Fail,47,40,3,10,37
40,Fail,51,32,0,17,34
40,Fail,45,33,0,18,27
40,Success,52,34,3,11,41
40,Fail,45,32,0,19,26
40,Success,50,36,5,9,41
40,Fail,46,39,0,8,38
40,Fail,50,33,5,12,38
40,Fail,52,28,0,17,35
40,Fail,47,41,0,11,36
40,Fail,48,39,1,12,36
40,Fail,41,40,0,14,27
40,Fail,50,38,0,12,38
40,Fail,50,35,0,11,39
40,Fail,46,38,0,14,32
40,Fail,48,33,0,14,34
40,Success,58,28,0,13,45
40,Fail,49,38,1,12,37
40,Fail,50,36,0,14,36
40,Fail,45,44,3,8,37
40,Success,52,30,9,9,43
40,Fail,48,38,5,9,39
40,Fail,52,34,1,13,39
40,Fail,49,35,0,15,34
40,Fail,44,38,0,11,33
40,Success,51,38,1,10,41
40,Fail,50,29,0,19,31
40,Success,53,35,2,10,43
40,Success,54,32,0,9,45
40,Fail,47,33,0,18,29
40,Fail,45,40,0,13,32
40,Fail,40,39,1,20,20
40,Success,51,35,3,11,40
40,Fail,44,38,0,14,30
40,Success,50,34,9,7,43
40,Fail,53,28,0,17,36
40,Success,53,35,0,10,43
40,Success,47,43,3,7,40
40,Fail,52,31,1,16,36
40,Fail,43,36,1,20,23
40,Fail,38,45,1,16,22
40,Fail,48,33,0,14,34
40,Fail,51,28,0,19,32
40,Fail,52,33,2,13,39
40,Success,54,33,1,12,42
40,Success,49,29,0,9,40
40,Fail,45,32,0,16,29
40,Success,50,37,6,7,43
40,Fail,50,31,1,18,32
40,Fail,43,38,4,15,28
40,Success,56,32,1,11,45
40,Fail,52,31,0,15,37
40,Fail,47,37,0,12,35
40,Fail,49,32,0,13,36
40,Fail,44,38,0,14,30
40,Fail,42,36,0,19,23
40,Success,53,25,0,10,43
40,Fail,49,37,3,11,38
40,Fail,35,37,10,18,17
40,Fail,49,30,6,15,34
40,Fail,44,37,0,9,35
40,Fail,47,31,0,20,27
40,Success,52,37,0,9,43
40,Fail,50,33,5,12,38
40,Fail,50,34,4,12,38
40,Success,53,34,2,11,42
40,Fail,44,42,0,14,30
40,Fail,43,43,3,11,32
40,Fail,42,38,0,19,23
40,Success,52,38,0,9,43
40,Fail,48,37,0,11,37
40,Success,52,30,7,11,41
40,Success,56,38,0,3,53
40,Fail,46,39,2,13,33
40,Fail,37,38,0,13,24
40,Fail,53,28,5,14,39
40,Success,58,28,3,11,47
40,Fail,48,33,0,14,34
40,Fail,45,36,7,12,33
40,Fail,44,37,6,13,31
40,Fail,46,39,0,14,32
40,Fail,47,33,8,12,35
40,Fail,45,39,0,10,35
40,Fail,51,33,2,14,37
40,Fail,49,35,0,15,34
40,Fail,44,42,1,13,31
40,Success,54,27,10,9,45
40,Fail,45,44,0,11,34
40,Fail,49,34,0,12,37
40,Fail,45,41,0,14,31
40,Fail,49,37,0,10,39
40,Success,58,27,8,7,51
40,Fail,48,36,0,15,33
40,Fail,50,30,0,11,39
40,Fail,44,34,7,15,29
40,Success,53,34,5,8,45
40,Fail,42,46,0,10,32
40,Success,55,33,2,10,45
40,Fail,51,36,0,13,38
40,Fail,46,33,0,13,33
40,Fail,52,30,0,17,35
40,Fail,48,31,0,13,35
40,Success,56,35,0,7,49
40,Success,51,37,0,11,40
40,Fail,43,38,0,12,31
40,Success,51,34,0,11,40
40,Fail,37,49,0,12,25
40,Fail,44,30,7,19,25
40,Fail,42,34,0,14,28
40,Success,50,36,5,9,41
40,Success,52,27,10,11,41
40,Fail,45,36,0,12,33
40,Fail,51,30,2,17,34
40,Fail,47,43,2,8,39
40,Fail,40,37,0,21,19
40,Fail,50,28,0,15,35
40,Fail,40,41,6,13,27
40,Success,47,43,4,6,41
40,Fail,48,37,0,10,38
40,Fail,47,37,3,13,34
40,Fail,45,34,0,13,32
40,Success,52,34,3,11,41
40,Fail,44,39,0,11,33
40,Fail,47,33,0,15,32
40,Fail,45,42,0,10,35
40,Fail,41,41,5,13,28
40,Fail,50,35,2,13,37
40,Fail,50,32,0,12,38
40,Fail,49,41,0,10,39
40,Success,53,38,2,7,46
40,Fail,47,33,2,18,29
40,Success,52,36,0,9,43
40,Fail,50,34,0,12,38
40,Fail,47,36,3,14,33
40,Fail,49,36,1,14,35
40,Success,51,41,0,8,43
40,Fail,47,36,4,13,34
40,Fail,47,39,0,9,38
40,Fail,45,37,0,13,32
40,Fail,46,42,0,12,34
40,Success,56,29,0,11,45
40,Fail,50,33,2,15,35
40,Fail,49,32,0,13,36
40,Fail,45,39,6,10,35
40,Fail,46,34,0,15,31
40,Success,51,36,0,9,42
40,Fail,47,36,0,8,39
40,Success,52,37,0,8,44
40,Fail,45,37,4,14,31
40,Success,54,39,2,5,49
40,Fail,46,34,0,18,28
40,Fail,49,37,2,12,37
40,Fail,51,37,0,12,39
40,Fail,47,35,0,15,32
40,Fail,54,29,1,16,38
40,Fail,48,33,6,13,35
40,Fail,54,25,0,18,36
40,Success,53,33,0,13,40
40,Fail,50,34,0,11,39
40,Fail,50,35,0,12,38
40,Fail,48,32,5,15,33
40,Fail,46,36,0,13,33
40,Fail,39,40,6,15,24
40,Success,54,31,3,12,42
40,Fail,49,37,0,13,36
40,Success,54,34,3,9,45
40,Success,53,28,0,11,42
40,Success,51,33,6,10,41
40,Fail,42,41,0,10,32
40,Fail,46,34,0,13,33
40,Fail,45,33,0,17,28
40,Fail,46,33,0,15,31
40,Fail,50,27,0,14,36
40,Success,56,35,1,8,48
40,Success,52,32,5,11,41
40,Fail,49,38,0,13,36
40,Fail,49,41,0,10,39
40,Success,59,31,2,8,51
40,Fail,46,32,0,17,29
40,Fail,49,33,4,14,35
40,Fail,49,32,6,13,36
40,Fail,50,38,0,11,39
40,Fail,48,31,0,17,31
40,Success,52,37,2,9,43
40,Success,51,40,0,9,42
40,Fail,49,29,6,16,33
40,Success,49,41,3,7,42
40,Fail,44,42,3,11,33
40,Fail,53,25,8,14,39
40,Success,54,30,0,12,42
40,Fail,49,35,6,10,39
40,Fail,41,42,3,14,27
40,Fail,44,40,0,12,32
40,Success,50,37,3,10,40
40,Fail,47,37,6,10,37
40,Success,50,39,2,9,41
40,Fail,41,40,0,14,27
40,Fail,44,35,0,18,26
40,Fail,49,37,0,13,36
40,Fail,45,37,0,16,29
40,Fail,47,31,1,21,26
40,Fail,49,36,4,11,38
40,Success,52,36,3,9,43
40,Fail,52,31,0,16,36
40,Fail,44,39,4,13,31
40,Fail,41,38,0,13,28
40,Fail,43,42,0,11,32
40,Success,50,32,0,9,41
40,Fail,48,36,0,15,33
40,Fail,46,35,6,13,33
40,Success,51,40,0,8,43
40,Fail,49,33,0,14,35
40,Success,54,32,5,9,45
40,Fail,40,41,0,14,26
40,Success,52,39,1,8,44
40,Fail,42,39,10,9,33
40,Fail,51,33,0,16,35
40,Success,51,39,1,9,42
40,Fail,45,35,0,12,33
40,Success,52,36,4,8,44
40,Success,54,31,2,13,41
40,Fail,47,35,0,15,32
40,Fail,49,31,2,18,31
40,Fail,41,40,0,10,31
40,Fail,42,39,0,12,30
40,Fail,52,33,0,13,39
40,Success,54,35,0,8,46
40,Fail,43,40,0,14,29
40,Success,49,41,3,7,42
40,Success,55,31,0,5,50
40,Fail,40,42,2,16,24
40,Fail,43,32,0,16,27
40,Fail,49,36,4,11,38
40,Success,50,33,0,10,40
40,Success,51,36,3,10,41
40,Fail,45,36,0,14,31
40,Success,60,28,0,9,51
40,Fail,43,41,8,8,35
40,Fail,48,32,0,20,28
40,Fail,50,32,4,14,36
40,Fail,49,32,8,11,38
40,Fail,52,26,0,19,33
40,Fail,45,40,1,14,31
40,Fail,48,24,7,21,27
40,Fail,46,35,0,17,29
40,Fail,45,46,0,8,37
40,Fail,46,31,10,13,33
40,Fail,42,36,0,20,22
40,Fail,47,33,0,12,35
40,Success,57,29,4,10,47
40,Fail,45,39,0,8,37
40,Fail,48,37,3,12,36
40,Fail,45,35,5,15,30
40,Success,51,36,0,8,43
40,Fail,44,38,11,7,37
40,Fail,46,41,0,11,35
40,Success,51,38,3,8,43
40,Fail,49,38,1,12,37
40,Fail,43,39,3,15,28
40,Fail,45,44,0,10,35
40,Fail,42,36,0,14,28
40,Fail,47,38,5,10,37
40,Fail,50,33,3,14,36
40,Fail,38,40,0,17,21
40,Fail,51,32,0,15,36
40,Fail,47,36,0,13,34
40,Fail,41,45,0,14,27
40,Fail,51,25,0,18,33
40,Success,50,39,2,9,41
40,Fail,45,35,7,13,32
40,Fail,43,34,11,12,31
40,Fail,42,41,0,17,25
40,Fail,46,25,14,15,31
40,Success,49,37,0,5,44
40,Success,53,38,0,8,45
40,Success,57,35,0,7,50
40,Fail,40,44,0,14,26
40,Success,52,38,1,9,43
40,Success,57,26,4,13,44
40,Fail,52,29,0,15,37
40,Success,56,27,4,13,43
40,Fail,48,33,7,12,36
40,Fail,42,40,0,17,25
40,Fail,49,38,0,10,39
40,Fail,44,40,0,15,29
40,Success,58,31,0,11,47
40,Fail,47,34,0,19,28
40,Fail,45,34,0,11,34
40,Fail,45,39,0,8,37
40,Fail,47,40,5,8,39
40,Success,56,35,1,8,48
40,Fail,51,31,3,15,36
40,Fail,41,35,0,20,21
40,Fail,50,31,0,15,35
40,Fail,45,38,4,13,32
40,Fail,48,32,0,17,31
40,Fail,43,32,0,20,23
40,Fail,43,39,0,16,27
40,Success,50,40,0,8,42
40,Fail,45,35,6,14,31
40,Fail,45,37,3,15,30
40,Fail,51,36,0,12,39
40,Fail,46,37,0,12,34
40,Fail,47,36,0,14,33
40,Fail,46,41,2,11,35
40,Success,56,31,0,11,45
40,Success,52,33,6,9,43
40,Fail,42,44,0,13,29
40,Success,56,31,0,10,46
40,Success,53,37,0,8,45
40,Fail,44,41,3,12,32
40,Fail,49,26,7,18,31
40,Fail,48,36,5,11,37
40,Success,51,38,0,10,41
40,Fail,39,41,4,16,23
40,Fail,42,33,8,17,25
40,Fail,50,39,0,11,39
40,Fail,45,33,0,15,30
40,Success,55,32,2,11,44
40,Success,55,34,0,6,49
40,Fail,39,40,12,9,30
40,Fail,49,40,1,10,39
40,Fail,45,39,3,13,32
40,Success,53,31,3,13,40
40,Fail,40,40,3,17,23
40,Fail,40,34,8,18,22
40,Fail,45,39,4,12,33
40,Fail,32,40,0,17,15
40,Fail,41,40,9,10,31
40,Fail,43,31,10,16,27
40,Fail,46,35,2,17,29
40,Fail,50,32,0,14,36
40,Fail,51,34,0,13,38
40,Success,55,32,3,10,45
40,Fail,49,34,0,12,37
40,Success,57,29,7,7,50
40,Success,52,36,0,12,40
40,Fail,44,40,0,12,32
40,Fail,50,33,0,13,37
40,Success,55,38,1,6,49
40,Success,53,33,2,12,41
40,Fail,50,28,0,16,34
40,Success,52,34,2,12,40
40,Success,53,33,0,6,47
40,Fail,43,29,0,17,26
40,Fail,49,34,7,10,39
40,Fail,48,37,0,14,34
40,Fail,43,42,0,13,30
40,Fail,49,32,4,15,34
40,Fail,44,38,0,14,30
40,Fail,50,35,4,11,39
40,Fail,43,40,5,12,31
40,Fail,51,34,3,12,39
40,Fail,47,33,0,14,33
40,Fail,52,27,1,20,32
40,Fail,42,41,0,15,27
40,Fail,50,32,4,14,36
40,Fail,40,38,0,13,27
40,Fail,44,42,2,12,32
40,Success,49,41,1,9,40
40,Fail,43,36,4,17,26
40,Fail,51,34,2,13,38
40,Fail,53,28,0,14,39
40,Fail,44,39,0,17,27
40,Fail,52,29,6,13,39
40,Fail,45,37,0,11,34
40,Fail,46,31,8,15,31
40,Success,58,23,3,16,42
40,Fail,48,35,3,14,34
40,Fail,45,32,2,21,24
40,Fail,49,35,0,16,33
40,Fail,46,35,1,18,28
40,Fail,46,30,11,13,33
40,Success,55,34,2,9,46
40,Success,52,37,0,11,41
40,Fail,48,35,0,17,31
40,Fail,51,33,0,13,38
40,Fail,53,26,0,14,39
40,Fail,45,34,8,13,32
40,Fail,48,36,0,14,34
40,Fail,47,34,7,12,35
40,Fail,43,47,0,10,33
40,Fail,53,31,2,14,39
40,Fail,48,38,4,10,38
40,Success,52,34,2,12,40
40,Fail,47,30,3,20,27
40,Fail,42,25,0,22,20
40,Fail,46,44,1,9,37
40,Fail,43,32,8,17,26
40,Fail,40,33,0,26,14
40,Fail,41,39,10,10,31
40,Fail,52,33,0,15,37
40,Fail,49,34,4,13,36
40,Fail,49,35,1,15,34
40,Fail,48,35,2,15,33
40,Fail,45,37,0,17,28
40,Fail,41,36,9,14,27
40,Fail,48,31,3,18,30
40,Fail,44,30,3,23,21
40,Success,52,33,0,8,44
40,Fail,50,35,0,13,37
40,Fail,46,32,10,12,34
40,Fail,40,42,0,12,28
40,Fail,42,43,0,10,32
40,Fail,49,41,0,10,39
40,Fail,50,33,4,13,37
40,Fail,48,36,0,16,32
40,Success,49,43,0,8,41
40,Fail,46,36,3,15,31
40,Fail,41,40,6,13,28
40,Success,50,37,4,9,41
40,Fail,45,38,0,12,33
40,Fail,45,36,0,16,29
40,Success,58,31,0,8,50
40,Fail,46,37,1,16,30
40,Fail,45,38,6,11,34
40,Success,50,37,5,8,42
40,Fail,47,40,1,12,35
40,Success,53,34,1,12,41
40,Fail,44,36,0,17,27
40,Fail,46,36,0,14,32
40,Success,62,26,0,12,50
40,Success,49,35,8,8,41
40,Success,56,35,0,6,50
40,Fail,51,25,8,16,35
40,Fail,50,35,0,14,36
40,Success,53,33,3,11,42
40,Fail,50,36,0,13,37
40,Fail,50,34,3,13,37
40,Success,52,30,0,11,41
40,Success,51,36,3,10,41
40,Success,55,34,0,10,45
40,Success,51,32,0,11,40
40,Fail,46,43,0,9,37
40,Fail,52,31,2,15,37
40,Fail,44,35,0,14,30
40,Fail,42,45,0,10,32
40,Fail,52,30,0,13,39
40,Success,51,35,0,9,42
40,Fail,45,30,0,16,29
40,Fail,50,24,0,19,31
40,Fail,50,37,0,12,38
40,Fail,47,41,0,9,38
40,Fail,47,33,5,15,32
40,Fail,51,24,0,19,32
40,Fail,50,29,4,17,33
40,Fail,51,32,0,15,36
40,Fail,47,38,7,8,39
40,Success,49,41,1,9,40
40,Fail,47,35,2,16,31
40,Fail,43,38,9,10,33
40,Fail,38,37,0,15,23
40,Success,50,38,2,10,40
40,Success,54,35,1,10,44
40,Fail,46,44,0,10,36
40,Fail,45,41,0,9,36
40,Fail,51,31,6,12,39
40,Success,51,36,2,11,40
40,Fail,48,28,7,17,31
40,Success,56,30,0,12,44
40,Fail,48,36,0,15,33
40,Fail,47,33,0,11,36
40,Fail,44,40,0,13,31
40,Fail,44,39,0,15,29
40,Fail,50,35,0,13,37
40,Fail,44,45,0,11,33
40,Success,54,35,1,10,44
40,Fail,48,26,0,17,31
40,Success,53,34,0,6,47
40,Fail,50,34,1,15,35
40,Fail,42,39,4,15,27
40,Fail,50,36,0,12,38
40,Success,55,25,0,12,43
40,Fail,47,30,0,14,33
40,Fail,48,31,9,12,36
40,Fail,50,35,1,14,36
40,Success,55,34,3,8,47
40,Fail,48,31,0,13,35
40,Fail,44,43,6,7,37
40,Success,54,33,1,12,42
40,Fail,39,36,8,17,22
40,Fail,46,36,3,15,31
40,Fail,48,36,0,15,33
40,Fail,46,41,3,10,36
40,Fail,50,31,0,14,36
40,Fail,44,28,0,19,25
40,Fail,44,37,0,12,32
40,Success,54,33,1,12,42
40,Success,59,34,0,6,53
40,Fail,42,42,0,15,27
40,Success,50,36,6,8,42
40,Fail,47,32,0,15,32
40,Fail,35,38,5,22,13
40,Success,51,33,0,10,41
40,Fail,41,36,6,17,24
40,Success,57,31,1,11,46
40,Success,53,37,0,9,44
40,Success,47,41,0,7,40
40,Success,54,33,3,10,44
40,Fail,42,40,0,15,27
40,Fail,47,32,6,15,32
40,Fail,47,37,1,15,32
40,Fail,43,30,0,14,29
40,Fail,49,37,0,12,37
40,Fail,47,40,3,10,37
40,Success,57,34,0,9,48
40,Fail,44,40,5,11,33
40,Fail,42,44,4,10,32
40,Fail,42,39,4,15,27
40,Success,53,33,0,10,43
40,Fail,47,32,6,15,32
40,Fail,51,36,0,13,38
40,Fail,46,38,0,13,33
40,Fail,46,33,5,16,30
40,Fail,39,43,5,13,26
40,Fail,42,34,0,13,29
40,Fail,50,35,0,12,38
40,Fail,50,29,0,16,34
40,Fail,45,33,3,19,26
40,Fail,46,42,0,8,38
40,Success,51,37,3,9,42
40,Fail,42,42,0,11,31
40,Success,53,37,1,9,44
40,Fail,48,33,4,15,33
40,Success,54,33,0,13,41
40,Success,50,38,3,9,41
40,Fail,44,33,14,9,35
40,Fail,45,34,7,14,31
40,Fail,49,33,0,17,32
40,Fail,45,33,0,18,27
40,Fail,50,30,1,19,31
40,Success,55,29,6,10,45
40,Success,52,35,0,12,40
40,Success,58,32,1,9,49
40,Fail,48,42,1,9,39
40,Fail,42,35,0,11,31
40,Fail,45,37,0,17,28
40,Fail,47,32,5,16,31
40,Fail,46,31,0,15,31
40,Fail,47,39,0,11,36
40,Fail,48,27,0,23,25
40,Fail,44,36,0,17,27
40,Success,58,32,0,9,49
40,Success,54,33,3,10,44
40,Success,51,32,10,7,44
40,Fail,50,36,0,12,38
40,Success,54,32,1,13,41
40,Success,51,41,0,7,44
40,Fail,48,40,0,10,38
40,Fail,46,38,0,14,32
40,Success,50,37,5,8,42
40,Fail,49,36,0,11,38
40,Fail,50,32,0,13,37
40,Fail,52,35,0,13,39
40,Fail,48,41,1,10,38
40,Fail,42,34,11,13,29
40,Success,57,38,0,5,52
40,Fail,44,41,0,12,32
40,Fail,52,33,0,13,39
40,Fail,53,29,0,16,37
40,Fail,52,31,4,13,39
40,Fail,50,27,0,16,34
40,Success,49,36,0,5,44
40,Fail,46,40,0,13,33
40,Fail,50,35,0,13,37
40,Fail,41,44,0,11,30
40,Fail,44,34,9,13,31
40,Fail,45,39,0,16,29
40,Fail,41,38,0,21,20
40,Fail,46,35,3,16,30
40,Success,56,34,0,9,47
40,Fail,39,34,0,15,24
40,Fail,40,38,3,19,21
40,Fail,51,31,0,12,39
40,Success,53,34,0,9,44
40,Fail,43,40,0,10,33
40,Fail,49,36,2,13,36
40,Fail,43,34,13,10,33
40,Success,55,31,0,10,45
40,Fail,45,38,5,12,33
40,Fail,39,44,4,13,26
40,Fail,45,37,0,17,28
40,Fail,45,40,0,15,30
40,Fail,42,46,1,11,31
40,Success,53,34,0,11,42
40,Fail,46,36,0,14,32
40,Fail,49,38,2,11,38
40,Fail,45,27,6,22,23
40,Fail,52,34,1,13,39
40,Fail,49,39,0,11,38
40,Fail,45,35,9,11,34
40,Fail,44,40,0,10,34
40,Fail,45,44,1,10,35
40,Fail,44,41,1,14,30
40,Success,53,35,0,7,46
40,Fail,52,34,1,13,39
40,Fail,47,38,0,13,34
40,Fail,46,35,0,15,31
40,Fail,41,35,9,15,26
40,Success,53,34,0,13,40
40,Fail,50,29,0,14,36
40,Success,58,30,5,7,51
40,Success,47,42,4,7,40
40,Success,53,38,2,7,46
40,Success,50,37,0,9,41
40,Fail,46,34,4,16,30
40,Fail,45,36,0,8,37
40,Success,48,43,1,8,40
40,Success,52,35,0,6,46
40,Fail,49,37,0,12,37
40,Fail,40,36,6,18,22
40,Success,52,38,1,9,43
40,Fail,47,41,0,11,36
40,Fail,47,40,0,10,37
40,Fail,49,37,3,11,38
40,Success,53,33,3,11,42
40,Fail,42,32,5,21,21
40,Success,54,32,4,10,44
40,Fail,41,35,0,17,24
40,Fail,52,31,0,14,38
40,Fail,48,32,0,15,33
40,Fail,44,35,6,15,29
40,Fail,50,37,0,12,38
40,Fail,49,33,0,14,35
40,Fail,40,40,0,15,25
40,Fail,46,38,4,12,34
40,Success,54,30,3,13,41
40,Fail,43,46,3,8,35
40,Success,54,30,2,14,40
40,Success,51,42,0,6,45
40,Fail,41,44,0,15,26
40,Success,49,37,0,8,41
40,Fail,50,28,0,13,37
40,Fail,48,40,0,9,39
40,Fail,43,43,2,12,31
40,Success,55,34,0,10,45
40,Fail,44,40,0,11,33
40,Success,54,36,0,10,44
40,Fail,49,28,9,14,35
40,Fail,43,36,0,19,24
40,Fail,46,37,1,16,30
40,Fail,47,32,6,15,32
40,Fail,43,37,8,12,31
40,Success,52,34,0,11,41
40,Fail,43,36,0,13,30
40,Fail,42,35,7,16,26
40,Fail,45,40,0,11,34
40,Success,51,35,0,10,41
40,Fail,47,40,0,11,36
40,Fail,46,34,1,19,27
40,Success,56,36,4,4,52
40,Fail,42,37,9,12,30
40,Success,53,27,0,11,42
40,Fail,48,32,0,16,32
40,Fail,46,40,0,10,36
40,Success,53,32,0,13,40
40,Fail,48,37,0,15,33
40,Fail,47,40,1,12,35
40,Fail,47,35,0,18,29
40,Fail,50,31,5,14,36
40,Fail,51,26,0,12,39
40,Fail,46,39,5,10,36
40,Fail,43,37,6,14,29
40,Success,54,37,0,7,47
40,Success,54,34,0,10,44
40,Fail,39,42,0,11,28
40,Success,50,39,2,9,41
40,Fail,52,30,2,16,36
40,Success,53,32,0,11,42
40,Success,58,28,0,10,48
40,Fail,47,34,0,11,36
40,Fail,43,42,0,15,28
40,Success,52,37,0,10,42
40,Success,53,35,0,12,41
40,Fail,47,35,0,12,35
40,Success,53,30,0,11,42
40,Success,49,23,20,8,41
40,Fail,49,28,7,16,33
40,Fail,47,35,0,13,34
40,Fail,48,32,0,12,36
40,Fail,47,29,0,18,29
40,Fail,49,39,1,11,38
40,Fail,47,37,0,15,32
40,Fail,45,38,0,11,34
40,Success,51,38,0,11,40
40,Fail,42,39,0,12,30
40,Fail,44,27,0,22,22
40,Fail,42,36,5,17,25
40,Success,49,42,0,8,41
40,Success,53,34,1,12,41
40,Fail,49,39,2,10,39
40,Success,52,38,0,9,43
40,Fail,44,34,0,15,29
40,Fail,49,37,4,10,39
40,Success,52,36,0,12,40
40,Success,55,34,3,8,47
40,Success,54,31,0,11,43
40,Fail,50,33,4,13,37
40,Fail,45,31,0,21,24
40,Fail,46,30,0,11,35
40,Fail,48,35,4,13,35
40,Fail,49,34,5,12,37
40,Fail,47,35,4,14,33
40,Fail,45,37,4,14,31
40,Fail,52,28,5,15,37
40,Success,51,40,1,8,43
40,Success,54,35,3,8,46
40,Fail,46,38,0,11,35
40,Success,51,35,0,11,40
40,Fail,49,38,1,12,37
40,Fail,50,29,9,12,38
40,Fail,49,33,5,13,36
40,Fail,47,32,0,20,27
40,Success,52,35,0,10,42
40,Fail,49,36,4,11,38
40,Fail,43,38,6,13,30
40,Fail,49,36,0,12,37
40,Fail,47,37,0,13,34
40,Fail,52,34,1,13,39
40,Fail,47,36,0,10,37
40,Fail,42,36,0,16,26
40,Fail,46,33,2,19,27
40,Success,53,30,4,13,40
40,Fail,46,42,0,8,38
40,Fail,44,39,4,13,31
40,Fail,43,39,4,14,29
40,Fail,48,36,0,12,36
40,Fail,49,35,0,14,35
40,Fail,49,36,0,13,36
40,Fail,44,40,0,15,29
40,Fail,47,37,0,16,31
40,Success,53,33,0,9,44
40,Success,47,44,0,7,40
40,Fail,45,34,0,13,32
40,Success,53,36,0,11,42
40,Fail,45,28,11,16,29
40,Fail,45,36,6,13,32
40,Fail,42,45,0,11,31
40,Success,56,30,3,11,45
40,Fail,40,44,2,14,26
40,Fail,47,44,0,9,38
40,Fail,49,34,0,10,39
40,Fail,46,36,2,16,30
40,Fail,42,39,2,17,25
40,Fail,45,31,6,18,27
40,Fail,51,32,5,12,39
40,Fail,42,30,9,19,23
40,Fail,44,44,0,10,34
40,Fail,50,35,0,14,36
40,Success,48,38,0,8,40
40,Success,51,34,0,11,40
40,Fail,51,31,0,17,34
40,Fail,43,41,0,14,29
40,Fail,41,36,8,15,26
40,Fail,44,35,3,18,26
40,Success,53,37,0,10,43
40,Success,51,34,4,11,40
40,Fail,44,38,0,10,34
40,Fail,50,34,1,15,35
40,Fail,47,36,3,14,33
40,Fail,44,27,17,12,32
40,Fail,46,43,0,11,35
40,Success,52,32,0,11,41
40,Success,50,37,0,9,41
40,Success,52,35,0,6,46
40,Fail,48,33,6,13,35
40,Success,52,38,0,9,43
40,Fail,44,29,0,20,24
40,Fail,46,42,0,11,35
40,Fail,45,29,0,16,29
40,Fail,49,36,2,13,36
40,Fail,48,38,0,14,34
40,Fail,48,27,0,22,26
40,Fail,45,45,0,10,35
40,Fail,54,30,0,15,39
40,Success,52,37,0,8,44
40,Fail,48,34,9,9,39
40,Fail,46,38,1,15,31
40,Fail,40,40,0,20,20
40,Fail,49,35,0,13,36
40,Fail,43,31,12,14,29
40,Success,54,33,2,11,43
40,Fail,52,33,2,13,39
40,Fail,46,32,6,16,30
40,Fail,46,35,5,14,32
40,Fail,46,36,0,17,29
40,Fail,47,29,0,18,29
40,Success,57,28,0,13,44
40,Fail,50,30,4,16,34
40,Fail,48,33,5,14,34
40,Fail,41,37,0,15,26
40,Fail,44,40,0,12,32
40,Fail,51,34,0,15,36
40,Success,54,39,0,6,48
40,Fail,51,27,0,13,38
40,Fail,42,39,8,11,31
40,Fail,45,43,0,10,35
40,Success,58,33,0,7,51
40,Fail,53,30,2,15,38
40,Fail,43,43,0,12,31
40,Success,51,37,0,11,40
40,Fail,45,41,0,14,31
40,Fail,52,31,0,14,38
40,Success,53,33,0,11,42
40,Fail,51,35,1,13,38
40,Success,56,32,1,11,45
40,Fail,49,32,5,14,35
40,Success,53,35,2,10,43
40,Fail,49,34,2,15,34
40,Success,54,33,3,10,44
40,Fail,43,40,0,17,26
40,Success,52,32,4,12,40
40,Fail,49,40,0,11,38
40,Fail,44,36,0,16,28
40,Fail,43,41,4,12,31
40,Fail,45,32,0,22,23
40,Success,55,39,2,4,51
40,Success,55,33,2,10,45
40,Fail,47,36,0,13,34
40,Fail,49,32,4,15,34
40,Fail,51,33,4,12,39
40,Fail,44,35,0,12,32
40,Fail,41,36,0,16,25
40,Success,52,33,0,12,40
40,Success,53,29,0,10,43
40,Success,50,40,1,9,41
40,Fail,43,40,0,17,26
40,Fail,45,43,0,11,34
40,Fail,48,39,0,13,35
40,Fail,42,39,5,14,28
40,Fail,50,38,0,11,39
40,Success,51,33,0,10,41
40,Fail,46,33,3,18,28
40,Success,56,35,0,8,48
40,Fail,43,33,0,18,25
40,Fail,50,30,0,12,38
40,Fail,45,36,0,14,31
40,Fail,47,36,3,14,33
40,Fail,47,39,0,14,33
40,Fail,47,30,0,18,29
40,Success,60,27,0,12,48
40,Fail,48,35,4,13,35
40,Fail,45,31,10,14,31
40,Success,50,31,0,10,40
40,Fail,44,41,0,14,30
40,Fail,41,43,2,14,27
40,Fail,45,31,0,23,22
40,Success,51,35,0,9,42
40,Fail,42,34,5,19,23
40,Fail,45,35,0,15,30
40,Fail,43,35,0,12,31
40,Success,55,32,0,13,42
40,Fail,43,40,2,15,28
40,Fail,48,35,3,14,34
40,Fail,40,38,0,17,23
40,Fail,41,41,6,12,29
40,Fail,42,36,0,18,24
40,Fail,45,36,0,14,31
40,Success,52,30,7,11,41
40,Fail,46,39,0,14,32
40,Fail,46,39,4,11,35
40,Fail,50,31,4,15,35
40,Fail,44,42,0,13,31
40,Fail,45,37,0,14,31
40,Fail,42,37,9,12,30
40,Success,50,40,1,9,41
40,Fail,45,40,0,12,33
40,Fail,45,35,2,18,27
40,Fail,47,32,3,18,29
40,Success,54,32,1,13,41
40,Success,60,31,0,7,53
40,Fail,38,49,1,12,26
40,Fail,46,31,0,14,32
40,Fail,45,38,5,12,33
40,Fail,45,36,0,16,29
40,Fail,46,43,1,10,36
40,Fail,42,36,0,18,24
40,Fail,42,42,5,11,31
40,Fail,45,39,3,13,32
40,Fail,39,40,0,10,29
40,Fail,38,38,0,11,27
40,Fail,47,37,2,14,33
40,Fail,54,30,1,15,39
40,Fail,51,31,0,16,35
40,Fail,39,27,8,26,13
40,Fail,45,36,3,16,29
40,Success,53,36,4,7,46
40,Fail,47,33,4,16,31
40,Fail,48,39,0,11,37
40,Fail,46,31,9,14,32
40,Success,58,28,1,13,45
40,Success,53,33,0,12,41
40,Success,55,34,0,11,44
40,Fail,42,40,0,10,32
40,Fail,48,39,2,11,37
40,Fail,52,33,1,14,38
40,Fail,47,33,0,15,32
40,Success,51,38,0,9,42
40,Fail,39,38,5,18,21
40,Fail,52,30,4,14,38
40,Fail,40,43,0,14,26
40,Fail,38,44,0,12,26
40,Success,56,27,0,12,44
40,Fail,48,34,4,14,34
40,Success,55,34,2,9,46
40,Fail,45,35,0,18,27
40,Fail,48,41,1,10,38
40,Fail,52,32,2,14,38
40,Fail,48,42,0,10,38
40,Fail,42,36,7,15,27
40,Fail,48,41,0,9,39
40,Success,49,40,3,8,41
40,Fail,44,39,0,16,28
40,Fail,42,39,4,15,27
40,Success,56,31,2,11,45
40,Fail,52,30,2,16,36
40,Success,54,34,4,8,46
40,Success,54,29,3,14,40
40,Fail,42,39,0,16,26
40,Fail,45,39,0,13,32
40,Fail,48,33,0,16,32
40,Success,51,34,5,10,41
40,Fail,48,32,0,12,36
40,Fail,47,41,3,9,38
40,Fail,48,36,0,15,33
40,Fail,47,38,0,8,39
40,Success,52,38,0,9,43
40,Fail,49,37,1,13,36
40,Success,49,40,2,9,40
40,Fail,43,35,0,13,30
40,Fail,46,41,0,12,34
40,Fail,46,36,5,13,33
40,Fail,43,30,9,18,25
40,Success,57,28,0,14,43
40,Fail,42,34,0,16,26
40,Fail,46,37,6,11,35
40,Success,48,46,0,5,43
40,Fail,37,41,8,14,23
40,Fail,45,34,0,17,28
40,Fail,47,36,0,15,32
40,Fail,49,31,0,15,34
40,Fail,43,37,0,14,29
40,Fail,51,26,11,12,39
40,Success,54,34,6,6,48
40,Fail,42,44,0,13,29
40,Fail,45,38,0,14,31
40,Fail,46,31,11,12,34
40,Fail,46,34,0,15,31
40,Fail,49,40,0,11,38
40,Success,50,40,0,9,41
40,Fail,45,37,0,9,36
40,Fail,42,38,0,12,30
40,Success,52,33,0,11,41
40,Fail,45,37,0,14,31
40,Success,54,37,1,8,46
40,Fail,50,32,0,17,33
40,Success,53,25,0,9,44
40,Success,49,40,0,9,40
40,Success,52,36,2,10,42
40,Success,58,34,0,8,50
40,Success,56,26,4,14,42
40,Fail,40,44,0,14,26
40,Fail,49,36,4,11,38
40,Fail,45,34,0,12,33
40,Fail,48,38,0,11,37
40,Fail,51,36,0,13,38
40,Fail,43,38,4,15,28
40,Fail,40,41,3,16,24
40,Fail,48,34,0,18,30
40,Success,51,37,0,5,46
40,Fail,48,33,5,14,34
40,Success,53,32,0,11,42
40,Fail,49,35,3,13,36
40,Fail,46,40,2,12,34
40,Fail,50,35,3,12,38
40,Success,45,45,5,5,40
40,Success,53,30,0,10,43
40,Success,50,39,0,10,40
40,Fail,54,29,0,16,38
40,Fail,49,35,1,15,34
40,Fail,50,36,3,11,39
40,Fail,52,30,3,15,37
40,Success,52,38,0,9,43
40,Fail,51,34,2,13,38
40,Fail,48,39,1,12,36
40,Fail,43,32,0,12,31
40,Fail,38,44,0,11,27
40,Fail,46,40,0,13,33
40,Success,49,33,9,9,40
40,Success,51,41,0,7,44
40,Fail,47,33,3,17,30
40,Fail,47,34,5,14,33
40,Success,52,30,0,12,40
40,Fail,44,36,0,20,24
40,Fail,48,38,0,9,39
40,Fail,41,45,0,8,33
40,Fail,48,30,0,16,32
40,Success,54,29,0,14,40
40,Fail,44,35,0,18,26
40,Success,52,38,2,8,44
40,Fail,46,37,5,12,34
40,Fail,47,40,1,12,35
40,Fail,52,34,0,13,39
40,Fail,46,36,0,14,32
40,Fail,46,31,11,12,34
40,Success,52,38,0,7,45
40,Fail,54,28,3,15,39
40,Fail,52,34,0,14,38
40,Fail,50,30,6,14,36
40,Fail,43,35,0,19,24
40,Fail,49,30,8,13,36
40,Fail,49,35,0,12,37
40,Success,52,33,6,9,43
40,Fail,45,36,7,12,33
40,Success,58,30,1,11,47
40,Fail,43,40,3,14,29
40,Fail,47,34,0,11,36
40,Fail,52,25,0,14,38
40,Fail,39,43,0,15,24
40,Fail,47,36,6,11,36
40,Fail,48,39,0,13,35
40,Fail,42,38,0,18,24
40,Success,52,33,5,10,42
40,Success,54,33,0,12,42
40,Fail,50,38,0,12,38
40,Fail,46,37,0,14,32
40,Fail,41,40,6,13,28
40,Fail,47,36,4,13,34
40,Fail,38,41,0,14,24
40,Fail,48,32,0,17,31
40,Fail,44,31,0,19,25
40,Fail,50,37,2,11,39
40,Fail,50,34,3,13,37
40,Fail,39,46,6,9,30
40,Success,54,37,0,6,48
40,Fail,51,31,6,12,39
40,Fail,46,32,0,19,27
40,Fail,41,30,0,20,21
40,Fail,41,42,0,17,24
40,Fail,51,32,0,15,36
40,Fail,43,40,0,15,28
40,Fail,50,39,0,11,39
40,Fail,49,26,0,18,31
40,Fail,38,37,6,19,19
40,Fail,46,31,0,20,26
40,Fail,47,32,3,18,29
40,Success,50,39,0,10,40
40,Fail,45,32,11,12,33
40,Fail,49,28,10,13,36
40,Fail,43,36,2,19,24
40,Fail,50,33,0,14,36
40,Fail,51,33,0,14,37
40,Fail,47,41,4,8,39
40,Success,48,38,6,8,40
40,Fail,48,26,0,16,32
40,Fail,44,39,0,14,30
40,Fail,45,34,0,17,28
40,Fail,44,38,0,13,31
40,Fail,47,38,6,9,38
40,Success,53,34,3,10,43
40,Success,54,33,0,11,43
40,Fail,46,39,0,11,35
40,Fail,42,41,0,11,31
40,Success,54,30,0,12,42
40,Success,50,40,0,10,40
40,Success,57,33,0,10,47
40,Success,50,41,0,8,42
40,Success,49,39,3,9,40
40,Fail,47,36,0,12,35
40,Fail,46,30,12,12,34
40,Fail,46,44,0,10,36
40,Success,49,39,3,9,40
40,Fail,43,42,2,13,30
40,Fail,48,38,0,14,34
40,Fail,50,33,0,14,36
40,Fail,47,38,0,13,34
40,Fail,44,44,1,11,33
40,Fail,48,32,5,15,33
40,Fail,44,45,1,10,34
40,Fail,47,33,3,17,30
40,Fail,47,37,1,15,32
40,Fail,44,40,0,9,35
40,Fail,45,36,0,12,33
40,Fail,41,35,10,14,27
40,Fail,46,34,0,17,29
40,Fail,45,40,4,11,34
40,Fail,49,32,0,15,34
40,Fail,47,42,1,10,37
40,Fail,46,37,0,10,36
40,Fail,46,41,0,10,36
40,Success,49,34,8,9,40
40,Fail,43,38,0,15,28
40,Fail,44,42,2,12,32
40,Success,53,35,0,10,43
40,Fail,44,34,0,19,25
40,Fail,50,35,3,12,38
40,Success,54,33,0,13,41
40,Fail,44,34,0,14,30
40,Success,59,32,0,9,50
40,Fail,37,44,6,13,24
40,Fail,46,37,0,14,32
40,Fail,49,36,0,10,39
40,Fail,47,33,10,10,37
40,Fail,46,37,8,9,37
40,Fail,51,36,0,12,39
40,Fail,47,35,0,17,30
40,Fail,49,39,0,12,37
40,Fail,40,43,7,10,30
40,Fail,51,37,0,12,39
40,Fail,49,32,0,16,33
40,Fail,49,36,3,12,37
40,Fail,48,30,6,16,32
40,Success,52,35,2,11,41
40,Fail,47,38,7,8,39
40,Fail,49,36,0,11,38
40,Fail,48,40,0,11,37
40,Fail,47,35,0,11,36
40,Success,53,32,5,10,43
40,Success,53,34,0,12,41
40,Success,53,36,0,11,42
40,Success,52,34,3,11,41
40,Fail,45,35,0,18,27
40,Fail,44,40,5,11,33
40,Fail,43,38,0,15,28
40,Fail,46,34,0,15,31
40,Fail,46,35,0,15,31
40,Fail,46,35,0,13,33
40,Fail,36,42,7,15,21
40,Fail,45,36,3,16,29
40,Fail,47,42,0,11,36
40,Fail,40,32,12,16,24
40,Success,55,26,10,9,46
40,Fail,49,33,2,16,33
40,Fail,50,31,1,18,32
40,Fail,49,36,0,13,36
40,Fail,40,37,0,15,25
40,Success,50,36,6,8,42
40,Fail,39,37,1,23,16
40,Success,53,31,0,13,40
40,Fail,47,29,10,14,33
40,Success,55,33,3,9,46
40,Success,50,38,4,8,42
40,Fail,50,36,1,13,37
40,Fail,47,37,1,15,32
40,Fail,43,39,0,10,33
40,Fail,45,41,0,14,31
40,Fail,44,43,0,13,31
40,Fail,49,36,3,12,37
40,Success,58,31,0,11,47
40,Fail,46,34,0,15,31
40,Success,58,28,7,7,51
40,Success,56,33,5,6,50
40,Fail,47,37,0,15,32
40,Fail,45,28,11,16,29
40,Fail,49,35,5,11,38
40,Fail,51,33,3,13,38
40,Success,50,33,0,10,40
40,Fail,50,32,0,16,34
40,Fail,48,34,2,16,32
40,Success,50,36,0,7,43
40,Fail,44,42,0,9,35
40,Fail,47,42,0,11,36
40,Success,53,36,2,9,44
40,Fail,50,32,4,14,36
40,Fail,44,41,0,15,29
40,Fail,50,30,9,11,39
40,Fail,47,39,0,12,35
40,Fail,46,27,0,17,29
40,Success,52,39,0,9,43
40,Fail,43,39,5,13,30
40,Fail,42,42,0,11,31
40,Success,52,35,2,11,41
40,Fail,51,31,6,12,39
40,Fail,41,40,4,15,26
40,Fail,44,34,0,12,32
40,Fail,43,42,2,13,30
40,Fail,42,43,0,14,28
40,Fail,45,34,6,15,30
40,Success,53,37,1,9,44
40,Fail,47,39,3,11,36
40,Fail,52,30,4,14,38
40,Success,55,34,0,8,47
40,Fail,47,42,0,11,36
40,Fail,45,38,0,12,33
40,Fail,47,38,0,11,36
40,Fail,46,35,4,15,31
40,Success,53,35,5,7,46
40,Fail,46,37,5,12,34
40,Success,52,35,0,6,46
40,Fail,46,33,0,20,26
40,Success,53,39,0,8,45
40,Fail,48,38,0,14,34
40,Success,55,35,0,10,45
40,Fail,47,43,0,10,37
40,Fail,49,32,2,17,32
40,Fail,41,34,8,17,24
40,Fail,47,37,0,12,35
40,Fail,48,32,4,16,32
40,Fail,44,38,0,13,31
40,Fail,49,27,0,21,28
40,Success,56,34,1,9,47
40,Fail,39,40,0,17,22
40,Success,49,37,6,8,41
40,Fail,53,32,1,14,39
40,Fail,37,37,4,22,15
40,Fail,42,29,0,13,29
40,Fail,43,40,4,13,30
40,Success,53,34,3,10,43
40,Fail,50,32,5,13,37
40,Fail,49,39,2,10,39
40,Fail,50,34,0,13,37
40,Fail,46,39,0,12,34
40,Success,56,32,0,9,47
40,Fail,52,30,0,18,34
40,Fail,52,30,4,14,38
40,Fail,48,40,0,11,37
40,Fail,50,31,6,13,37
40,Fail,51,32,0,12,39
40,Success,56,35,0,8,48
40,Success,56,32,3,9,47
40,Fail,45,33,0,11,34
40,Fail,47,28,6,19,28
40,Fail,47,41,0,11,36
40,Fail,50,32,6,12,38
40,Fail,48,28,9,15,33
40,Success,53,31,6,10,43
40,Success,57,31,0,10,47
40,Fail,44,39,0,15,29
40,Fail,49,34,6,11,38
40,Success,55,33,0,11,44
40,Fail,50,27,0,20,30
40,Fail,52,30,0,14,38
40,Fail,49,31,3,17,32
40,Fail,44,42,0,12,32
40,Fail,44,34,9,13,31
40,Fail,41,40,0,17,24
40,Success,63,24,0,8,55
40,Fail,39,37,5,19,20
40,Success,51,34,0,9,42
40,Success,50,29,11,10,40
40,Fail,49,40,1,10,39
40,Fail,39,35,0,16,23
40,Success,52,26,10,12,40
40,Fail,44,34,4,18,26
40,Success,54,32,0,14,40
40,Fail,49,37,0,10,39
40,Fail,49,40,0,11,38
40,Fail,42,44,6,8,34
40,Fail,47,39,0,11,36
40,Fail,42,35,0,14,28
40,Fail,45,32,0,14,31
40,Fail,45,34,0,14,31
40,Fail,50,38,0,11,39
40,Fail,42,37,10,11,31
40,Fail,46,34,0,14,32
40,Fail,47,38,0,11,36
40,Fail,46,28,7,19,27
40,Fail,50,35,2,13,37
40,Fail,49,32,0,14,35
40,Fail,43,40,0,10,33
40,Fail,46,31,7,16,30
40,Fail,46,34,0,13,33
40,Fail,46,30,7,17,29
40,Fail,47,33,0,10,37
40,Fail,49,35,4,12,37
40,Fail,52,32,0,14,38
40,Fail,49,38,2,11,38
40,Fail,42,35,0,16,26
40,Success,53,34,0,11,42
40,Fail,44,31,14,11,33
40,Fail,46,39,2,13,33
40,Fail,43,40,0,11,32
40,Fail,48,25,10,17,31
40,Fail,47,36,0,14,33
40,Fail,45,43,0,12,33
40,Fail,50,33,0,14,36
40,Fail,43,37,0,14,29
40,Fail,38,42,0,12,26
40,Fail,51,36,1,12,39
40,Fail,47,31,0,15,32
40,Fail,52,32,1,15,37
40,Fail,49,36,0,12,37
40,Fail,48,25,8,19,29
40,Fail,48,38,3,11,37
40,Fail,43,38,4,15,28
40,Fail,49,29,0,20,29
40,Success,55,32,1,12,43
40,Fail,44,38,0,14,30
40,Fail,36,44,0,18,18
40,Fail,51,34,3,12,39
40,Fail,44,37,4,15,29
40,Fail,49,39,2,10,39
40,Fail,50,37,0,11,39
40,Fail,49,32,4,15,34
40,Fail,44,38,0,15,29
40,Fail,46,40,0,11,35
40,Fail,47,41,3,9,38
40,Success,54,34,0,12,42
40,Fail,50,32,0,16,34
40,Fail,42,33,0,15,27
40,Fail,46,34,1,19,27
40,Fail,51,35,0,14,37
40,Fail,48,33,4,15,33
40,Fail,48,39,0,9,39
40,Fail,45,40,1,14,31
40,Fail,47,37,0,12,35
40,Fail,43,43,3,11,32
40,Success,57,30,3,10,47
40,Fail,50,37,2,11,39
40,Fail,44,45,0,7,37
40,Fail,47,36,0,12,35
40,Fail,47,33,0,8,39
40,Fail,45,42,4,9,36
40,Success,56,31,2,11,45
40,Success,50,35,0,10,40
40,Fail,43,38,0,19,24
40,Success,52,39,1,8,44
40,Fail,42,35,7,16,26
40,Fail,44,37,10,9,35
40,Success,50,39,0,10,40
40,Fail,48,34,4,14,34
40,Success,51,38,0,11,40
40,Fail,46,37,6,11,35
40,Fail,49,34,7,10,39
40,Fail,48,37,3,12,36
40,Fail,44,42,0,12,32
40,Fail,47,35,0,13,34
40,Success,61,28,2,9,52
40,Fail,39,36,0,12,27
40,Fail,50,37,1,12,38
40,Success,54,38,2,6,48
40,Success,50,40,1,9,41
40,Success,54,35,0,8,46
40,Fail,47,37,0,13,34
40,Success,49,31,0,9,40
40,Success,53,32,0,9,44
40,Fail,49,39,0,11,38
40,Fail,45,33,9,13,32
40,Success,53,33,0,12,41
40,Fail,47,34,4,15,32
40,Fail,48,38,0,14,34
40,Fail,33,39,4,24,9
40,Fail,47,25,0,16,31
40,Fail,43,35,0,13,30
40,Fail,45,34,11,10,35
40,Success,53,34,0,13,40
40,Success,54,33,5,8,46
40,Success,51,37,0,10,41
40,Fail,43,38,4,15,28
40,Fail,44,35,0,17,27
40,Fail,45,38,1,16,29
40,Fail,40,42,3,15,25
40,Fail,43,39,0,14,29
40,Fail,46,33,3,18,28
40,Fail,41,32,0,15,26
40,Success,62,28,0,9,53
40,Success,54,33,0,12,42
40,Fail,48,36,0,11,37
40,Fail,43,28,0,18,25
40,Fail,53,32,1,14,39
40,Fail,48,37,2,13,35
40,Success,52,34,0,12,40
40,Fail,48,35,0,13,35
40,Fail,52,27,0,21,31
40,Fail,46,38,0,13,33
40,Fail,46,26,0,16,30
40,Success,52,37,2,9,43
40,Success,51,39,1,9,42
40,Success,54,33,0,11,43
40,Fail,44,31,0,19,25
40,Fail,50,36,1,13,37
40,Fail,39,38,6,17,22
40,Fail,43,39,3,15,28
40,Fail,50,33,4,13,37
40,Fail,45,38,0,15,30
40,Fail,47,44,0,9,38
40,Fail,36,40,0,17,19
40,Success,50,34,7,9,41
40,Fail,50,36,1,13,37
40,Fail,52,30,5,13,39
40,Fail,46,29,0,16,30
40,Success,55,37,0,7,48
40,Fail,35,43,6,16,19
40,Success,55,32,1,12,43
40,Fail,53,24,8,15,38
40,Fail,43,39,0,11,32
40,Fail,48,33,3,16,32
40,Fail,44,35,0,18,26
40,Fail,47,32,0,14,33
40,Fail,46,37,1,16,30
40,Fail,47,33,0,18,29
40,Fail,49,33,0,14,35
40,Fail,54,28,3,15,39
40,Success,50,39,0,10,40
40,Success,52,28,0,9,43
40,Success,58,35,1,6,52
40,Success,51,33,5,11,40
40,Fail,40,42,5,13,27
40,Success,50,34,0,8,42
40,Fail,42,37,0,18,24
40,Fail,51,36,1,12,39
40,Fail,49,37,0,13,36
40,Fail,48,33,7,12,36
40,Fail,45,41,5,9,36
40,Fail,47,39,0,13,34
40,Fail,49,33,3,15,34
40,Success,61,34,0,5,56
40,Fail,47,30,6,17,30
40,Fail,45,34,3,18,27
40,Fail,50,36,3,11,39
40,Fail,47,35,0,11,36
40,Fail,39,36,0,16,23
40,Fail,48,34,0,13,35
40,Success,51,37,2,10,41
40,Success,56,30,0,10,46
40,Fail,43,44,0,13,30
40,Success,53,26,8,13,40
40,Fail,46,38,1,15,31
40,Success,57,33,0,10,47
40,Success,50,41,0,9,41
40,Fail,51,30,4,15,36
40,Success,58,36,0,6,52
40,Success,54,31,1,14,40
40,Fail,47,37,0,11,36
40,Fail,50,33,2,15,35
40,Fail,46,36,3,15,31
40,Fail,51,36,0,12,39
40,Fail,41,37,6,16,25
40,Fail,49,30,0,19,30
40,Fail,49,34,3,14,35
40,Success,52,35,4,9,43
40,Fail,47,36,0,15,32
40,Fail,46,37,5,12,34
40,Success,54,36,1,9,45
40,Fail,42,40,5,13,29
40,Fail,46,38,0,12,34
40,Fail,49,32,3,16,33
40,Success,57,34,0,8,49
40,Fail,51,33,0,14,37
40,Fail,40,38,0,8,32
40,Success,51,36,0,11,40
40,Fail,51,32,0,15,36
40,Success,55,36,1,8,47
40,Success,49,42,0,9,40
40,Fail,47,36,0,9,38
40,Fail,45,28,0,16,29
40,Fail,46,36,5,13,33
40,Fail,44,39,0,11,33
40,Fail,38,44,0,17,21
40,Fail,44,43,0,9,35
40,Fail,49,30,0,10,39
40,Success,55,35,1,9,46
40,Fail,46,34,5,15,31
40,Fail,52,32,0,16,36
40,Fail,43,33,7,17,26
40,Fail,45,32,0,10,35
40,Success,49,33,9,9,40
40,Success,58,37,0,5,53
40,Success,50,36,4,10,40
40,Fail,48,35,3,14,34
40,Fail,51,33,4,12,39
40,Fail,40,45,2,13,27
40,Fail,47,35,0,8,39
40,Success,54,36,2,8,46
40,Fail,45,36,0,15,30
40,Success,52,27,12,9,43
40,Fail,49,31,4,16,33
40,Fail,44,37,0,16,28
40,Fail,49,37,0,10,39
40,Fail,43,46,0,8,35
40,Fail,48,38,0,10,38
40,Fail,43,41,5,11,32
40,Success,48,37,8,7,41
40,Success,52,36,3,9,43
40,Fail,44,32,9,15,29
40,Fail,46,37,5,12,34
40,Fail,49,31,0,15,34
40,Fail,46,40,2,12,34
40,Success,51,38,0,11,40
40,Fail,52,31,0,15,37
40,Fail,48,42,1,9,39
40,Success,50,36,5,9,41
40,Fail,47,36,8,9,38
40,Fail,49,32,2,17,32
40,Fail,47,36,0,16,31
40,Fail,47,41,2,10,37
40,Fail,47,39,1,13,34
40,Fail,45,42,7,6,39
40,Fail,47,38,0,12,35
40,Success,49,38,5,8,41
40,Success,51,36,4,9,42
40,Fail,42,37,7,14,28
40,Success,54,35,2,9,45
40,Fail,43,40,0,12,31
40,Fail,47,34,0,13,34
40,Fail,49,38,3,10,39
40,Success,51,38,1,10,41
40,Success,51,36,0,9,42
40,Fail,55,24,4,17,38
40,Fail,43,47,3,7,36
40,Fail,45,42,0,11,34
40,Fail,49,32,0,13,36
40,Success,52,32,4,12,40
40,Success,54,35,0,10,44
40,Fail,49,34,0,14,35
40,Fail,44,33,0,9,35
40,Fail,44,38,5,13,31
40,Fail,47,34,5,14,33
40,Fail,37,41,8,14,23
40,Success,50,34,6,10,40
40,Fail,52,33,0,15,37
40,Success,55,29,2,14,41
40,Fail,45,39,0,9,36
40,Fail,49,31,7,13,36
40,Fail,39,45,3,13,26
40,Fail,50,39,0,11,39
40,Success,52,35,0,12,40
40,Fail,48,38,3,11,37
40,Fail,47,35,0,15,32
40,Success,52,39,0,9,43
40,Fail,48,36,5,11,37
40,Fail,39,35,6,20,19
40,Fail,42,37,0,14,28
40,Success,51,31,10,8,43
40,Fail,40,43,5,12,28
40,Fail,49,34,4,13,36
40,Fail,43,41,0,9,34
40,Fail,51,37,0,12,39
40,Fail,44,41,4,11,33
40,Fail,48,29,4,19,29
40,Success,56,31,1,12,44
40,Success,55,33,0,10,45
40,Success,53,33,0,12,41
40,Success,56,32,1,11,45
40,Fail,46,34,9,11,35
40,Success,55,27,3,15,40
40,Fail,43,46,0,11,32
40,Fail,50,37,0,12,38
40,Success,56,37,0,5,51
40,Success,55,30,0,12,43
40,Fail,45,38,0,13,32
40,Fail,45,37,0,15,30
40,Success,53,29,0,10,43
40,Fail,47,33,0,13,34
40,Fail,42,32,0,18,24
40,Fail,42,36,9,13,29
40,Fail,47,37,1,15,32
40,Success,49,43,0,8,41
40,Fail,45,47,0,8,37
40,Success,58,33,0,8,50
40,Fail,49,32,0,16,33
40,Fail,44,43,0,12,32
40,Fail,43,37,0,19,24
40,Fail,48,27,0,13,35
40,Fail,44,41,5,10,34
40,Fail,42,42,0,15,27
40,Fail,51,31,4,14,37
40,Fail,48,38,0,14,34
40,Fail,49,34,0,12,37
40,Success,51,33,0,11,40
40,Success,59,31,0,10,49
40,Fail,48,37,4,11,37
40,Fail,49,33,0,11,38
40,Fail,46,43,3,8,38
40,Fail,51,36,0,13,38
40,Fail,46,34,8,12,34
40,Success,49,38,0,9,40
40,Fail,44,34,8,14,30
40,Fail,45,29,0,26,19
40,Fail,37,41,2,20,17
40,Success,52,36,0,8,44
40,Fail,50,35,0,14,36
40,Success,52,35,1,12,40
40,Success,49,39,0,8,41
40,Success,54,36,0,8,46
40,Fail,44,41,5,10,34
40,Fail,44,43,0,13,31
40,Fail,49,38,0,10,39
40,Fail,46,36,0,14,32
40,Fail,43,48,0,8,35
40,Fail,47,36,3,14,33
40,Fail,47,43,0,9,38
40,Fail,50,32,2,16,34
40,Fail,48,28,0,13,35
40,Success,54,32,7,7,47
40,Fail,47,33,3,17,30
40,Success,58,34,0,8,50
40,Success,52,33,0,11,41
40,Fail,42,47,0,10,32
40,Success,52,32,0,10,42
40,Fail,45,36,5,14,31
40,Fail,47,35,0,12,35
40,Fail,43,37,0,17,26
40,Fail,49,31,3,17,32
40,Fail,53,27,0,16,37
40,Fail,44,30,0,15,29
40,Success,54,30,2,14,40
40,Fail,47,37,5,11,36
40,Fail,49,37,0,13,36
40,Success,49,42,0,8,41
40,Success,53,33,3,11,42
40,Success,55,28,3,14,41
40,Fail,48,36,0,12,36
40,Fail,43,40,0,8,35
40,Fail,48,32,3,17,31
40,Success,51,41,0,7,44
40,Success,55,35,2,8,47
40,Success,56,34,2,8,48
40,Fail,49,33,7,11,38
40,Fail,52,34,0,13,39
40,Success,50,38,0,4,46
40,Fail,46,34,0,16,30
40,Fail,47,40,2,11,36
40,Success,55,32,1,12,43
40,Fail,51,36,1,12,39
40,Fail,49,37,2,12,37
40,Fail,43,35,0,15,28
40,Fail,43,39,7,11,32
40,Success,54,37,2,7,47
40,Success,50,34,0,8,42
40,Success,55,25,8,12,43
40,Fail,50,35,2,13,37
40,Fail,49,33,0,17,32
40,Fail,46,34,0,18,28
40,Fail,48,36,5,11,37
40,Fail,47,32,5,16,31
40,Success,54,28,0,11,43
40,Fail,42,41,0,11,31
40,Fail,50,36,0,13,37
40,Fail,46,40,1,13,33
40,Success,55,32,0,11,44
40,Fail,49,31,8,12,37
40,Success,53,33,5,9,44
40,Success,53,30,0,13,40
40,Fail,41,38,7,14,27
40,Fail,49,34,7,10,39
40,Fail,39,35,0,13,26
40,Fail,45,26,14,15,30
40,Fail,48,36,0,12,36
40,Fail,51,34,3,12,39
40,Fail,43,38,6,13,30
40,Fail,44,37,2,17,27
40,Fail,43,37,9,11,32
40,Success,52,32,4,12,40
40,Fail,47,37,1,15,32
40,Fail,48,37,0,14,34
40,Fail,49,33,4,14,35
40,Fail,48,34,0,15,33
40,Fail,49,38,1,12,37
40,Fail,53,31,0,15,38
40,Fail,43,34,0,13,30
40,Fail,48,34,0,13,35
50,Fail,55,31,6,8,47
50,Fail,50,38,1,11,39
50,Fail,52,30,0,16,36
50,Fail,45,38,0,14,31
50,Fail,52,32,1,15,37
50,Fail,43,29,0,17,26
50,Fail,49,30,0,12,37
50,Fail,44,44,5,7,37
50,Fail,46,40,0,12,34
50,Fail,45,36,7,12,33
50,Fail,46,44,0,10,36
50,Fail,50,35,2,13,37
50,Fail,36,42,2,20,16
50,Fail,47,35,0,12,35
50,Fail,51,34,7,8,43
50,Fail,50,30,11,9,41
50,Fail,51,32,6,11,40
50,Fail,40,42,4,14,26
50,Fail,57,30,1,12,45
50,Fail,48,29,14,9,39
50,Fail,52,28,0,17,35
50,Fail,39,44,0,12,27
50,Fail,52,38,0,10,42
50,Fail,46,39,0,13,33
50,Fail,44,34,7,15,29
50,Fail,50,33,0,12,38
50,Fail,43,37,3,17,26
50,Fail,58,26,0,13,45
50,Fail,49,35,0,12,37
50,Fail,43,40,6,11,32
50,Fail,55,31,0,11,44
50,Fail,46,36,0,14,32
50,Fail,46,36,4,14,32
50,Fail,45,34,0,13,32
50,Fail,42,41,0,12,30
50,Fail,50,32,0,14,36
50,Fail,52,33,0,12,40
50,Fail,50,38,0,9,41
50,Fail,45,39,2,14,31
50,Fail,49,36,3,12,37
50,Fail,44,35,9,12,32
50,Fail,42,36,6,16,26
50,Fail,43,40,0,12,31
50,Fail,42,36,0,16,26
50,Fail,50,38,4,8,42
50,Fail,49,41,2,8,41
50,Fail,54,33,6,7,47
50,Fail,51,36,0,9,42
50,Fail,43,32,7,18,25
50,Fail,45,40,0,9,36
50,Fail,50,31,0,14,36
50,Success,58,31,0,8,50
50,Fail,52,35,2,11,41
50,Fail,53,34,4,9,44
50,Fail,44,30,13,13,31
50,Fail,48,34,0,15,33
50,Fail,42,42,0,12,30
50,Fail,55,25,0,19,36
50,Fail,47,42,0,10,37
50,Fail,50,30,0,14,36
50,Fail,54,32,0,14,40
50,Fail,45,39,2,14,31
50,Fail,34,39,0,22,12
50,Fail,46,33,0,17,29
50,Fail,48,34,5,13,35
50,Fail,44,41,0,15,29
50,Fail,53,33,3,11,42
50,Fail,50,27,0,14,36
50,Fail,54,32,0,12,42
50,Fail,49,36,0,13,36
50,Fail,50,38,2,10,40
50,Fail,51,33,2,14,37
50,Fail,55,27,0,14,41
50,Fail,52,31,0,14,38
50,Fail,48,33,7,12,36
50,Fail,48,30,0,14,34
50,Fail,45,41,2,12,33
50,Fail,56,29,2,13,43
50,Fail,51,40,0,9,42
50,Fail,46,39,6,9,37
50,Fail,47,32,5,16,31
50,Fail,43,35,3,19,24
50,Fail,50,24,0,21,29
50,Fail,50,33,0,17,33
50,Fail,44,38,0,12,32
50,Fail,51,40,0,8,43
50,Fail,51,31,0,16,35
50,Fail,54,31,0,10,44
50,Fail,47,43,0,10,37
50,Fail,52,33,5,10,42
50,Fail,49,38,0,8,41
50,Fail,47,31,6,16,31
50,Fail,46,39,0,10,36
50,Fail,48,39,2,11,37
50,Fail,55,32,0,13,42
50,Fail,47,38,0,11,36
50,Fail,47,44,0,9,38
50,Fail,45,38,1,16,29
50,Fail,55,34,0,10,45
50,Fail,49,43,0,6,43
50,Fail,52,39,0,9,43
50,Fail,48,36,0,8,40
50,Fail,47,37,0,16,31
50,Fail,48,36,2,14,34
50,Fail,42,38,0,13,29
50,Fail,41,44,0,10,31
50,Fail,47,36,0,16,31
50,Fail,46,37,0,11,35
50,Fail,43,41,0,12,31
50,Fail,51,42,0,7,44
50,Fail,58,28,0,13,45
50,Fail,45,37,0,10,35
50,Fail,56,31,2,11,45
50,Fail,49,30,0,14,35
50,Fail,49,30,0,14,35
50,Fail,47,28,0,15,32
50,Fail,54,32,0,10,44
50,Fail,47,33,0,11,36
50,Fail,44,38,0,10,34
50,Fail,52,36,2,10,42
50,Fail,45,31,0,17,28
50,Fail,49,37,0,9,40
50,Fail,43,45,0,11,32
50,Fail,54,28,2,16,38
50,Fail,51,36,0,9,42
50,Fail,53,29,1,17,36
50,Fail,48,37,0,15,33
50,Fail,47,28,10,15,32
50,Fail,46,35,0,11,35
50,Fail,50,32,0,17,33
50,Fail,51,32,4,13,38
50,Fail,51,39,0,9,42
50,Fail,44,42,3,11,33
50,Fail,41,41,0,14,27
50,Fail,49,33,5,13,36
50,Fail,43,33,0,13,30
50,Fail,52,36,1,11,41
50,Fail,52,32,0,12,40
50,Fail,53,33,1,13,40
50,Fail,47,39,0,10,37
50,Fail,49,30,0,12,37
50,Fail,52,35,0,11,41
50,Fail,50,32,3,15,35
50,Fail,51,28,6,15,36
50,Fail,48,34,0,13,35
50,Fail,49,40,0,9,40
50,Fail,52,36,0,12,40
50,Fail,50,32,0,15,35
50,Fail,48,38,2,12,36
50,Fail,44,37,7,12,32
50,Fail,48,39,0,12,36
50,Fail,41,41,0,12,29
50,Fail,40,37,0,13,27
50,Fail,55,35,0,7,48
50,Fail,46,38,0,13,33
50,Fail,44,39,0,13,31
50,Fail,45,44,0,11,34
50,Fail,41,32,0,20,21
50,Fail,48,35,4,13,35
50,Fail,49,35,2,14,35
50,Fail,52,35,0,10,42
50,Fail,52,37,0,10,42
50,Fail,47,41,0,9,38
50,Fail,50,31,8,11,39
50,Fail,49,37,3,11,38
50,Fail,55,30,0,9,46
50,Fail,50,37,2,11,39
50,Fail,43,29,0,17,26
50,Fail,51,36,0,9,42
50,Fail,53,35,3,9,44
50,Fail,50,35,0,11,39
50,Fail,57,34,1,8,49
50,Fail,46,40,0,14,32
50,Fail,50,40,0,6,44
50,Success,59,26,0,8,51
50,Fail,47,33,5,15,32
50,Fail,39,45,0,13,26
50,Fail,52,36,1,11,41
50,Fail,46,41,1,12,34
50,Fail,52,32,0,12,40
50,Fail,52,29,3,16,36
50,Fail,48,38,0,12,36
50,Fail,49,39,0,9,40
50,Fail,48,38,4,10,38
50,Fail,50,38,3,9,41
50,Fail,39,46,0,12,27
50,Fail,54,33,3,10,44
50,Fail,56,36,0,8,48
50,Fail,49,40,0,10,39
50,Fail,46,30,6,18,28
50,Fail,55,33,0,12,43
50,Fail,47,35,0,16,31
50,Fail,42,39,5,14,28
50,Fail,52,36,0,8,44
50,Fail,44,38,0,14,30
50,Fail,50,31,5,14,36
50,Fail,48,29,3,20,28
50,Fail,46,34,0,13,33
50,Fail,43,42,0,14,29
50,Fail,51,34,0,14,37
50,Fail,43,34,6,17,26
50,Fail,55,31,0,14,41
50,Fail,50,33,8,9,41
50,Fail,49,32,0,10,39
50,Fail,49,36,4,11,38
50,Fail,48,29,6,17,31
50,Fail,50,38,0,12,38
50,Fail,55,35,0,9,46
50,Fail,48,32,0,16,32
50,Fail,44,40,3,13,31
50,Fail,47,42,0,6,41
50,Fail,54,37,1,8,46
50,Fail,47,38,2,13,34
50,Fail,48,28,5,19,29
50,Fail,43,41,1,15,28
50,Fail,40,50,0,8,32
50,Fail,51,35,4,10,41
50,Fail,48,34,10,8,40
50,Fail,48,37,0,12,36
50,Fail,46,36,0,13,33
50,Fail,56,30,0,14,42
50,Fail,46,39,6,9,37
50,Success,55,37,4,4,51
50,Fail,49,30,0,15,34
50,Fail,48,32,0,16,32
50,Fail,52,36,0,11,41
50,Fail,48,34,1,17,31
50,Fail,46,35,0,12,34
50,Fail,48,35,0,11,37
50,Fail,50,35,0,12,38
50,Fail,49,39,0,8,41
50,Fail,53,26,0,13,40
50,Fail,46,39,5,10,36
50,Fail,56,29,7,8,48
50,Fail,52,37,0,9,43
50,Fail,43,36,0,18,25
50,Fail,58,30,1,11,47
50,Fail,53,38,0,9,44
50,Fail,53,31,5,11,42
50,Fail,48,36,1,15,33
50,Fail,51,35,7,7,44
50,Fail,41,33,0,15,26
50,Fail,48,37,0,13,35
50,Fail,50,30,0,12,38
50,Fail,47,36,7,10,37
50,Fail,52,37,0,9,43
50,Fail,57,34,0,8,49
50,Fail,51,35,0,14,37
50,Fail,43,33,9,15,28
50,Fail,44,38,0,11,33
50,Fail,43,37,3,17,26
50,Fail,46,33,0,12,34
50,Fail,46,39,0,13,33
50,Fail,47,33,5,15,32
50,Fail,54,33,2,11,43
50,Fail,54,27,0,16,38
50,Fail,46,38,1,15,31
50,Fail,36,40,10,14,22
50,Fail,49,35,0,15,34
50,Fail,46,38,0,12,34
50,Fail,56,34,3,7,49
50,Fail,43,35,3,19,24
50,Fail,48,33,3,16,32
50,Success,56,34,0,5,51
50,Fail,52,33,0,10,42
50,Fail,42,36,3,19,23
50,Fail,41,40,0,14,27
50,Fail,52,33,2,13,39
50,Fail,44,32,0,17,27
50,Fail,48,35,0,14,34
50,Fail,52,28,3,17,35
50,Fail,52,31,3,14,38
50,Fail,40,36,4,20,20
50,Fail,49,33,7,11,38
50,Fail,49,36,0,13,36
50,Fail,47,39,0,12,35
50,Fail,51,34,2,13,38
50,Fail,53,32,4,11,42
50,Fail,45,35,4,16,29
50,Fail,53,38,0,9,44
50,Fail,47,42,1,10,37
50,Fail,43,36,5,16,27
50,Fail,53,37,3,7,46
50,Success,59,33,0,6,53
50,Fail,43,41,5,11,32
50,Fail,46,31,0,15,31
50,Fail,47,41,0,8,39
50,Fail,44,38,9,9,35
50,Fail,46,26,8,20,26
50,Fail,47,38,5,10,37
50,Fail,44,31,0,14,30
50,Fail,48,34,0,12,36
50,Fail,50,39,0,10,40
50,Fail,50,35,0,12,38
50,Fail,51,36,0,9,42
50,Fail,51,34,0,12,39
50,Fail,43,35,0,16,27
50,Fail,50,37,0,11,39
50,Fail,52,27,0,13,39
50,Fail,52,40,0,8,44
50,Fail,43,38,0,17,26
50,Fail,46,38,2,14,32
50,Fail,47,36,0,10,37
50,Fail,46,44,0,9,37
50,Fail,51,35,0,11,40
50,Fail,47,37,1,15,32
50,Fail,41,34,10,15,26
50,Fail,49,39,2,10,39
50,Fail,43,36,6,15,28
50,Fail,53,35,0,11,42
50,Fail,50,37,0,13,37
50,Fail,50,27,2,21,29
50,Fail,44,35,0,14,30
50,Fail,45,34,0,15,30
50,Fail,36,38,11,15,21
50,Fail,45,33,2,20,25
50,Fail,56,30,1,13,43
50,Fail,39,44,7,10,29
50,Fail,42,39,0,15,27
50,Fail,57,33,0,9,48
50,Fail,45,42,0,9,36
50,Fail,45,40,1,14,31
50,Fail,45,38,0,12,33
50,Fail,43,35,0,11,32
50,Fail,50,41,2,7,43
50,Fail,49,31,3,17,32
50,Fail,45,42,0,11,34
50,Fail,49,35,0,13,36
50,Fail,55,29,0,10,45
50,Fail,46,37,3,14,32
50,Fail,41,43,6,10,31
50,Fail,50,38,1,11,39
50,Fail,53,38,4,5,48
50,Fail,49,31,6,14,35
50,Fail,53,38,0,8,45
50,Fail,44,32,11,13,31
50,Fail,47,37,0,15,32
50,Fail,49,34,0,8,41
50,Fail,51,34,3,12,39
50,Fail,46,35,12,7,39
50,Fail,40,42,0,13,27
50,Fail,48,29,2,21,27
50,Fail,46,37,8,9,37
50,Fail,43,30,0,18,25
50,Fail,50,32,0,17,33
50,Fail,51,30,0,13,38
50,Fail,46,35,0,17,29
50,Fail,45,36,0,14,31
50,Fail,46,38,0,14,32
50,Fail,47,40,2,11,36
50,Fail,46,39,2,13,33
50,Fail,50,32,6,12,38
50,Fail,51,31,0,15,36
50,Fail,50,27,5,18,32
50,Fail,45,41,2,12,33
50,Fail,45,38,8,9,36
50,Fail,46,39,0,13,33
50,Fail,52,36,0,10,42
50,Fail,48,34,0,17,31
50,Fail,50,31,1,18,32
50,Fail,53,30,0,13,40
50,Fail,43,38,7,12,31
50,Fail,51,27,7,15,36
50,Fail,47,34,0,11,36
50,Fail,49,32,0,13,36
50,Fail,45,38,7,10,35
50,Fail,42,42,1,15,27
50,Fail,48,36,3,13,35
50,Fail,48,36,6,10,38
50,Fail,40,41,7,12,28
50,Fail,53,42,0,5,48
50,Fail,52,27,0,16,36
50,Fail,53,34,0,11,42
50,Fail,42,41,0,16,26
50,Fail,58,31,2,9,49
50,Fail,51,39,1,9,42
50,Fail,48,35,7,10,38
50,Fail,45,34,0,14,31
50,Fail,48,34,3,15,33
50,Fail,46,35,5,14,32
50,Fail,47,36,9,8,39
50,Fail,49,43,0,7,42
50,Fail,54,29,0,10,44
50,Fail,43,32,0,17,26
50,Fail,43,37,0,17,26
50,Fail,41,37,0,16,25
50,Fail,51,32,3,14,37
50,Fail,51,33,3,13,38
50,Fail,40,42,0,15,25
50,Fail,50,35,1,14,36
50,Fail,52,40,2,6,46
50,Fail,46,40,1,13,33
50,Fail,50,36,0,10,40
50,Fail,54,27,0,14,40
50,Fail,50,40,2,8,42
50,Fail,47,32,0,11,36
50,Fail,47,40,0,10,37
50,Fail,45,37,0,13,32
50,Fail,44,32,0,21,23
50,Fail,48,33,8,11,37
50,Success,61,27,0,10,51
50,Fail,41,43,4,12,29
50,Fail,44,44,2,10,34
50,Fail,53,32,0,13,40
50,Fail,55,34,2,9,46
50,Fail,57,30,1,12,45
50,Fail,36,35,0,21,15
50,Fail,48,30,0,15,33
50,Fail,47,38,1,14,33
50,Fail,56,29,0,14,42
50,Fail,48,32,2,18,30
50,Fail,46,28,12,14,32
50,Fail,45,41,2,12,33
50,Fail,46,38,0,11,35
50,Fail,51,36,2,11,40
50,Fail,44,37,0,17,27
50,Fail,52,36,3,9,43
50,Fail,47,30,0,17,30
50,Fail,41,45,0,14,27
50,Fail,47,35,2,16,31
50,Fail,38,42,6,14,24
50,Fail,47,37,5,11,36
50,Fail,48,32,0,17,31
50,Fail,50,33,4,13,37
50,Fail,50,36,0,13,37
50,Fail,48,38,6,8,40
50,Fail,43,34,8,15,28
50,Fail,47,31,0,17,30
50,Fail,49,40,2,9,40
50,Success,59,30,0,9,50
50,Fail,50,34,0,16,34
50,Fail,49,36,0,12,37
50,Fail,44,37,7,12,32
50,Fail,41,35,5,19,22
50,Fail,55,28,4,13,42
50,Fail,54,29,0,12,42
50,Fail,47,37,2,14,33
50,Fail,45,35,3,17,28
50,Fail,49,30,0,17,32
50,Fail,56,30,4,10,46
50,Fail,48,32,0,19,29
50,Fail,44,32,0,22,22
50,Fail,48,33,0,17,31
50,Fail,54,29,4,13,41
50,Fail,48,39,0,12,36
50,Fail,52,35,1,12,40
50,Fail,49,34,6,11,38
50,Fail,52,33,0,15,37
50,Success,60,32,0,8,52
50,Fail,48,40,0,11,37
50,Fail,51,38,3,8,43
50,Fail,54,34,1,11,43
50,Fail,46,34,0,14,32
50,Success,62,23,0,8,54
50,Fail,55,33,0,12,43
50,Fail,48,35,5,12,36
50,Fail,49,38,0,13,36
50,Fail,50,31,9,10,40
50,Fail,46,37,0,13,33
50,Fail,50,36,0,10,40
50,Fail,57,30,2,11,46
50,Fail,48,35,6,11,37
50,Fail,48,35,0,10,38
50,Fail,45,37,0,14,31
50,Fail,49,36,1,14,35
50,Fail,48,30,8,14,34
50,Fail,48,24,0,23,25
50,Fail,42,31,0,14,28
50,Fail,55,29,3,13,42
50,Fail,52,38,3,7,45
50,Fail,50,31,6,13,37
50,Fail,50,33,0,13,37
50,Fail,51,35,2,12,39
50,Fail,49,39,1,11,38
50,Fail,52,36,3,9,43
50,Fail,48,37,0,9,39
50,Fail,49,35,2,14,35
50,Fail,43,40,4,13,30
50,Fail,49,35,0,12,37
50,Fail,47,30,0,19,28
50,Fail,51,36,4,9,42
50,Fail,56,33,0,10,46
50,Fail,45,34,8,13,32
50,Fail,45,34,10,11,34
50,Fail,50,30,4,16,34
50,Fail,45,36,4,15,30
50,Fail,45,37,6,12,33
50,Fail,52,34,0,11,41
50,Fail,47,32,9,12,35
50,Fail,41,38,0,16,25
50,Fail,42,43,0,13,29
50,Fail,46,39,7,8,38
50,Fail,38,39,11,12,26
50,Fail,48,43,1,8,40
50,Fail,44,38,4,14,30
50,Fail,47,29,0,15,32
50,Fail,51,36,0,12,39
50,Fail,43,36,8,13,30
50,Fail,54,34,1,11,43
50,Fail,46,34,0,10,36
50,Fail,52,28,2,18,34
50,Fail,44,33,0,14,30
50,Fail,42,40,0,16,26
50,Fail,48,39,0,12,36
50,Fail,51,38,1,10,41
50,Fail,49,30,0,15,34
50,Fail,51,35,0,12,39
50,Fail,52,31,0,10,42
50,Fail,55,35,2,8,47
50,Fail,49,30,11,10,39
50,Fail,46,35,0,11,35
50,Fail,42,31,14,13,29
50,Fail,49,37,0,11,38
50,Fail,49,37,0,13,36
50,Fail,53,28,0,9,44
50,Fail,45,39,4,12,33
50,Fail,55,34,0,9,46
50,Fail,52,30,3,15,37
50,Fail,47,31,0,16,31
50,Fail,44,35,0,19,25
50,Fail,45,36,7,12,33
50,Fail,49,40,0,7,42
50,Fail,47,31,0,10,37
50,Fail,46,41,5,8,38
50,Fail,52,35,2,11,41
50,Fail,42,41,5,12,30
50,Fail,51,34,0,14,37
50,Fail,42,35,0,20,22
50,Fail,47,31,0,15,32
50,Fail,50,31,7,12,38
50,Fail,47,38,0,13,34
50,Fail,47,35,2,16,31
50,Fail,44,36,3,17,27
50,Fail,54,28,0,9,45
50,Fail,45,40,0,13,32
50,Fail,48,32,8,12,36
50,Fail,45,27,0,20,25
50,Fail,52,32,0,12,40
50,Fail,49,34,6,11,38
50,Fail,42,47,0,11,31
50,Fail,42,42,3,13,29
50,Fail,47,39,0,11,36
50,Fail,37,38,18,7,30
50,Fail,44,34,9,13,31
50,Fail,48,33,2,17,31
50,Fail,52,29,6,13,39
50,Fail,48,31,0,11,37
50,Fail,52,28,6,14,38
50,Fail,42,37,0,17,25
50,Fail,47,35,0,15,32
50,Fail,38,43,5,14,24
50,Fail,45,37,0,16,29
50,Fail,49,32,7,12,37
50,Fail,50,34,0,15,35
50,Fail,44,42,2,12,32
50,Fail,59,27,0,14,45
50,Fail,53,33,0,6,47
50,Fail,42,44,2,12,30
50,Fail,50,35,0,10,40
50,Success,54,38,4,4,50
50,Fail,49,26,4,21,28
50,Fail,41,46,1,12,29
50,Fail,43,41,0,16,27
50,Fail,44,43,0,13,31
50,Fail,43,39,0,14,29
50,Fail,44,36,11,9,35
50,Fail,53,34,0,8,45
50,Fail,49,39,3,9,40
50,Fail,41,39,0,15,26
50,Fail,48,43,0,9,39
50,Fail,46,43,0,11,35
50,Fail,49,42,0,9,40
50,Fail,55,35,2,8,47
50,Fail,47,36,3,14,33
50,Fail,49,42,2,7,42
50,Fail,55,34,0,7,48
50,Fail,47,38,2,13,34
50,Fail,55,30,7,8,47
50,Fail,51,28,0,11,40
50,Success,61,26,0,9,52
50,Fail,49,30,7,14,35
50,Fail,45,40,0,13,32
50,Fail,51,35,0,13,38
50,Fail,43,41,1,15,28
50,Fail,43,34,0,15,28
50,Fail,58,29,2,11,47
50,Fail,55,32,0,10,45
50,Fail,55,32,1,12,43
50,Fail,56,31,4,9,47
50,Fail,46,38,3,13,33
50,Fail,51,35,5,9,42
50,Fail,54,34,0,10,44
50,Fail,38,46,0,13,25
50,Fail,50,32,4,14,36
50,Fail,34,44,0,11,23
50,Fail,53,30,0,16,37
50,Fail,50,35,0,14,36
50,Fail,54,35,0,10,44
50,Fail,47,37,0,9,38
50,Fail,52,34,0,12,40
50,Fail,49,39,0,11,38
50,Fail,47,34,6,13,34
50,Fail,53,31,1,15,38
50,Fail,42,47,0,7,35
50,Fail,47,41,2,10,37
50,Fail,52,34,0,11,41
50,Fail,53,36,0,11,42
50,Fail,46,31,7,16,30
50,Fail,41,35,0,17,24
50,Fail,48,40,5,7,41
50,Fail,50,29,8,13,37
50,Fail,40,46,4,10,30
50,Fail,48,31,3,18,30
50,Fail,46,35,8,11,35
50,Fail,49,34,0,12,37
50,Fail,42,43,0,12,30
50,Fail,39,44,10,7,32
50,Fail,47,41,0,11,36
50,Fail,44,42,3,11,33
50,Fail,47,39,0,14,33
50,Fail,46,33,7,14,32
50,Fail,49,29,0,15,34
50,Fail,49,27,6,18,31
50,Fail,44,40,3,13,31
50,Success,59,31,0,7,52
50,Fail,43,34,10,13,30
50,Fail,48,33,7,12,36
50,Fail,52,32,8,8,44
50,Fail,48,32,7,13,35
50,Fail,51,37,2,10,41
50,Fail,52,34,0,13,39
50,Fail,41,37,0,17,24
50,Fail,43,41,5,11,32
50,Fail,53,27,0,14,39
50,Fail,55,34,0,11,44
50,Fail,54,31,4,11,43
50,Fail,45,34,0,15,30
50,Fail,50,34,0,13,37
50,Fail,51,33,0,12,39
50,Fail,47,40,0,11,36
50,Fail,52,33,1,14,38
50,Fail,49,36,0,12,37
50,Fail,55,27,7,11,44
50,Fail,44,43,2,11,33
50,Fail,55,27,8,10,45
50,Fail,38,36,0,22,16
50,Fail,44,37,0,11,33
50,Fail,46,36,10,8,38
50,Fail,51,35,2,12,39
50,Fail,51,29,0,10,41
50,Fail,44,37,0,16,28
50,Fail,53,31,2,14,39
50,Fail,50,38,3,9,41
50,Fail,48,36,0,9,39
50,Fail,46,38,0,14,32
50,Fail,49,34,0,16,33
50,Fail,39,38,0,22,17
50,Fail,45,39,4,12,33
50,Fail,50,37,5,8,42
50,Fail,46,35,0,9,37
50,Fail,48,36,0,13,35
50,Fail,52,38,0,8,44
50,Fail,50,34,0,14,36
50,Fail,46,37,0,14,32
50,Fail,50,28,9,13,37
50,Fail,53,34,0,9,44
50,Fail,51,36,2,11,40
50,Fail,47,37,0,11,36
50,Fail,52,33,0,10,42
50,Fail,39,42,0,15,24
50,Fail,54,30,2,14,40
50,Fail,54,34,0,11,43
50,Fail,43,39,7,11,32
50,Fail,47,36,2,15,32
50,Fail,49,39,0,11,38
50,Fail,40,42,4,14,26
50,Fail,50,36,0,11,39
50,Fail,48,30,3,19,29
50,Success,56,37,0,5,51
50,Fail,47,34,0,12,35
50,Fail,48,35,0,12,36
50,Fail,39,36,0,15,24
50,Fail,45,42,0,11,34
50,Fail,56,30,4,10,46
50,Fail,55,33,0,10,45
50,Fail,55,30,0,12,43
50,Fail,49,41,0,8,41
50,Fail,38,43,2,17,21
50,Success,56,36,2,6,50
50,Fail,45,33,0,12,33
50,Fail,39,42,5,14,25
50,Fail,51,36,2,11,40
50,Fail,51,30,5,14,37
50,Fail,45,32,0,19,26
50,Fail,49,35,0,15,34
50,Fail,45,32,0,17,28
50,Fail,48,39,4,9,39
50,Fail,46,40,0,14,32
50,Fail,49,34,0,17,32
50,Fail,47,26,0,25,22
50,Fail,49,34,0,14,35
50,Fail,52,34,5,9,43
50,Fail,58,30,1,11,47
50,Fail,48,34,3,15,33
50,Fail,37,43,0,13,24
50,Fail,49,35,0,15,34
50,Fail,46,34,3,17,29
50,Fail,50,30,7,13,37
50,Fail,39,37,0,16,23
50,Fail,54,32,0,12,42
50,Fail,44,38,0,13,31
50,Fail,44,45,0,10,34
50,Fail,52,34,0,14,38
50,Fail,45,40,4,11,34
50,Fail,52,32,0,16,36
50,Fail,45,37,0,13,32
50,Fail,50,37,1,12,38
50,Success,57,31,5,7,50
50,Fail,46,34,0,16,30
50,Fail,45,36,0,12,33
50,Fail,46,38,0,15,31
50,Fail,47,33,0,13,34
50,Fail,55,31,0,9,46
50,Fail,45,38,6,11,34
50,Fail,49,33,0,16,33
50,Fail,50,39,0,9,41
50,Fail,41,37,0,18,23
50,Fail,46,29,0,16,30
50,Fail,48,40,0,11,37
50,Fail,40,35,6,19,21
50,Fail,48,31,0,12,36
50,Fail,53,31,0,15,38
50,Fail,54,32,3,11,43
50,Fail,48,34,7,11,37
50,Fail,50,33,4,13,37
50,Fail,52,36,6,6,46
50,Fail,41,43,0,15,26
50,Fail,44,37,1,18,26
50,Fail,41,39,0,18,23
50,Fail,47,39,0,12,35
50,Fail,55,33,0,12,43
50,Fail,56,27,0,13,43
50,Fail,51,36,0,11,40
50,Fail,42,39,0,14,28
50,Fail,50,37,0,13,37
50,Fail,51,33,4,12,39
50,Fail,50,34,0,14,36
50,Fail,45,43,2,10,35
50,Fail,43,43,3,11,32
50,Success,57,36,2,5,52
50,Fail,53,30,3,14,39
50,Fail,52,35,0,12,40
50,Fail,50,36,0,10,40
50,Fail,51,32,0,10,41
50,Fail,44,41,2,13,31
50,Fail,37,45,7,11,26
50,Fail,47,41,1,11,36
50,Fail,44,33,0,8,36
50,Fail,44,39,0,8,36
50,Fail,42,42,0,13,29
50,Fail,57,31,3,9,48
50,Fail,52,31,0,10,42
50,Fail,50,41,0,8,42
50,Fail,48,33,0,13,35
50,Fail,45,40,0,14,31
50,Fail,48,40,1,11,37
50,Fail,50,34,2,14,36
50,Fail,56,29,3,12,44
50,Fail,44,33,4,19,25
50,Fail,47,30,0,10,37
50,Fail,49,30,5,16,33
50,Fail,49,32,11,8,41
50,Fail,56,31,0,13,43
50,Fail,51,33,7,9,42
50,Fail,44,31,0,9,35
50,Fail,39,45,5,11,28
50,Fail,45,31,8,16,29
50,Fail,48,30,4,18,30
50,Fail,55,37,0,6,49
50,Fail,50,43,0,7,43
50,Fail,54,26,0,18,36
50,Fail,55,38,1,6,49
50,Fail,46,33,9,12,34
50,Fail,44,35,0,11,33
50,Fail,37,40,8,15,22
50,Fail,40,41,0,12,28
50,Fail,44,42,1,13,31
50,Fail,50,34,3,13,37
50,Fail,48,34,4,14,34
50,Fail,52,25,0,19,33
50,Fail,49,37,0,13,36
50,Fail,45,41,0,12,33
50,Fail,42,36,0,11,31
50,Fail,46,43,0,11,35
50,Fail,42,41,0,15,27
50,Fail,54,38,0,8,46
50,Success,58,34,1,7,51
50,Fail,52,35,0,13,39
50,Fail,55,33,5,7,48
50,Fail,54,32,4,10,44
50,Fail,48,28,13,11,37
50,Fail,48,38,4,10,38
50,Fail,54,31,0,14,40
50,Fail,48,37,0,9,39
50,Fail,43,41,0,14,29
50,Fail,57,28,4,11,46
50,Fail,46,35,0,11,35
50,Fail,49,34,0,14,35
50,Fail,53,29,6,12,41
50,Fail,48,40,0,12,36
50,Fail,51,31,0,12,39
50,Fail,47,34,5,14,33
50,Fail,45,40,8,7,38
50,Fail,42,43,0,13,29
50,Fail,51,32,5,12,39
50,Fail,49,37,0,13,36
50,Fail,54,34,2,10,44
50,Fail,56,30,4,10,46
50,Fail,43,33,9,15,28
50,Fail,53,35,0,7,46
50,Fail,53,28,4,15,38
50,Fail,39,43,5,13,26
50,Fail,49,35,0,13,36
50,Fail,51,31,0,9,42
50,Fail,39,40,1,20,19
50,Fail,40,45,0,6,34
50,Fail,52,22,9,17,35
50,Fail,42,38,8,12,30
50,Fail,51,27,4,18,33
50,Fail,39,37,0,12,27
50,Fail,45,38,0,13,32
50,Fail,49,36,6,9,40
50,Fail,57,27,0,10,47
50,Fail,47,37,0,11,36
50,Fail,44,38,3,15,29
50,Fail,41,34,0,17,24
50,Fail,50,36,0,12,38
50,Fail,52,29,7,12,40
50,Fail,47,38,3,12,35
50,Fail,47,37,0,14,33
50,Fail,50,32,0,13,37
50,Fail,50,36,2,12,38
50,Fail,53,33,5,9,44
50,Fail,54,36,0,10,44
50,Fail,51,34,0,10,41
50,Fail,58,33,0,9,49
50,Fail,57,30,0,9,48
50,Fail,53,34,0,11,42
50,Fail,45,43,0,11,34
50,Fail,56,33,2,9,47
50,Fail,45,45,0,8,37
50,Fail,49,40,0,9,40
50,Fail,41,42,0,12,29
50,Fail,46,38,0,11,35
50,Fail,51,35,0,12,39
50,Fail,47,42,3,8,39
50,Fail,43,44,3,10,33
50,Fail,37,48,0,14,23
50,Fail,44,33,0,10,34
50,Fail,37,30,10,23,14
50,Fail,49,31,0,18,31
50,Fail,46,37,3,14,32
50,Fail,47,38,0,13,34
50,Fail,48,31,0,17,31
50,Fail,49,40,0,9,40
50,Fail,46,31,0,14,32
50,Fail,43,41,0,14,29
50,Fail,50,39,3,8,42
50,Fail,46,33,2,19,27
50,Fail,50,29,6,15,35
50,Fail,47,36,0,13,34
50,Fail,45,41,0,11,34
50,Fail,51,27,8,14,37
50,Fail,43,38,5,14,29
50,Fail,51,38,0,10,41
50,Fail,46,35,0,14,32
50,Fail,50,39,0,5,45
50,Fail,48,31,9,12,36
50,Success,58,36,0,6,52
50,Fail,51,38,0,10,41
50,Fail,50,31,0,14,36
50,Fail,52,37,0,11,41
50,Fail,44,28,0,18,26
50,Fail,53,37,0,9,44
50,Fail,48,37,0,14,34
50,Fail,51,34,7,8,43
50,Fail,42,39,0,14,28
50,Fail,58,23,0,12,46
50,Fail,54,32,0,14,40
50,Fail,48,32,1,19,29
50,Fail,52,31,0,16,36
50,Fail,48,34,1,17,31
50,Fail,53,33,2,12,41
50,Fail,52,38,0,9,43
50,Fail,47,39,0,13,34
50,Fail,39,43,0,15,24
50,Fail,49,37,4,10,39
50,Fail,36,40,0,19,17
50,Fail,51,36,0,11,40
50,Fail,45,41,0,11,34
50,Fail,53,34,0,9,44
50,Fail,38,40,0,15,23
50,Fail,50,36,0,12,38
50,Fail,40,24,0,19,21
50,Fail,49,35,3,13,36
50,Fail,46,38,0,13,33
50,Fail,54,36,4,6,48
50,Fail,48,36,0,16,32
50,Success,61,34,0,5,56
50,Fail,53,30,0,15,38
50,Fail,43,43,0,11,32
50,Fail,53,32,5,10,43
50,Fail,42,34,0,16,26
50,Fail,51,34,0,11,40
50,Fail,52,38,2,8,44
50,Fail,45,41,0,12,33
50,Fail,50,37,0,12,38
50,Fail,50,28,0,14,36
50,Fail,51,35,4,10,41
50,Fail,47,33,0,11,36
50,Fail,46,38,5,11,35
50,Fail,46,37,5,12,34
50,Fail,51,31,0,17,34
50,Fail,53,35,2,10,43
50,Fail,48,41,0,8,40
50,Fail,51,34,0,13,38
50,Fail,42,39,1,18,24
50,Fail,44,30,0,17,27
50,Fail,47,30,9,14,33
50,Fail,45,38,0,16,29
50,Fail,54,32,0,8,46
50,Fail,38,44,3,15,23
50,Fail,44,36,0,15,29
50,Fail,48,32,0,12,36
50,Fail,43,36,0,12,31
50,Fail,49,33,0,14,35
50,Fail,42,37,0,14,28
50,Fail,46,38,7,9,37
50,Fail,43,36,9,12,31
50,Fail,54,28,0,12,42
50,Fail,41,42,4,13,28
50,Fail,51,38,2,9,42
50,Fail,49,37,0,14,35
50,Fail,47,28,8,17,30
50,Success,62,31,1,6,56
50,Fail,49,35,1,15,34
50,Fail,46,32,0,12,34
50,Fail,45,29,13,13,32
50,Fail,48,34,0,12,36
50,Fail,46,42,0,12,34
50,Fail,40,41,0,14,26
50,Fail,52,25,0,15,37
50,Fail,49,34,0,16,33
50,Fail,47,40,3,10,37
50,Fail,45,37,0,11,34
50,Fail,48,37,0,12,36
50,Fail,49,38,0,12,37
50,Fail,47,35,0,13,34
50,Fail,54,29,4,13,41
50,Fail,49,36,0,15,34
50,Fail,52,30,3,15,37
50,Fail,55,31,4,10,45
50,Fail,42,28,0,17,25
50,Fail,46,31,0,14,32
50,Fail,57,35,0,8,49
50,Fail,47,39,0,8,39
50,Fail,49,28,0,14,35
50,Fail,47,28,11,14,33
50,Fail,46,39,0,15,31
50,Fail,47,39,5,9,38
50,Fail,56,31,5,8,48
50,Fail,55,28,0,14,41
50,Fail,47,38,0,15,32
50,Fail,48,34,0,16,32
50,Fail,47,39,0,12,35
50,Fail,53,26,0,16,37
50,Fail,51,39,0,9,42
50,Fail,47,34,2,17,30
50,Fail,46,41,0,13,33
50,Fail,60,27,2,11,49
50,Fail,45,40,0,14,31
50,Fail,56,29,0,15,41
50,Fail,51,33,4,12,39
50,Fail,47,41,0,10,37
50,Fail,47,43,1,9,38
50,Fail,50,32,0,14,36
50,Fail,46,33,5,16,30
50,Fail,47,37,0,10,37
50,Fail,51,24,0,22,29
50,Fail,51,31,0,13,38
50,Fail,54,38,0,6,48
50,Fail,51,33,0,15,36
50,Fail,50,30,11,9,41
50,Fail,43,39,4,14,29
50,Fail,43,38,0,15,28
50,Fail,41,29,0,13,28
50,Fail,42,32,0,19,23
50,Fail,40,43,2,15,25
50,Fail,54,39,0,5,49
50,Fail,52,37,1,10,42
50,Fail,51,31,0,14,37
50,Fail,48,33,0,12,36
50,Fail,45,35,3,17,28
50,Fail,46,36,3,15,31
50,Fail,52,33,0,14,38
50,Fail,44,36,0,14,30
50,Fail,46,35,8,11,35
50,Fail,41,39,7,13,28
50,Fail,48,35,0,16,32
50,Fail,45,47,0,7,38
50,Fail,45,37,0,13,32
50,Fail,42,39,0,18,24
50,Fail,52,36,7,5,47
50,Success,63,29,1,7,56
50,Fail,37,43,0,13,24
50,Fail,53,39,2,6,47
50,Fail,47,36,1,16,31
50,Fail,47,38,0,14,33
50,Fail,42,43,7,8,34
50,Fail,49,28,7,16,33
50,Fail,53,31,0,11,42
50,Fail,51,31,0,14,37
50,Fail,44,41,0,15,29
50,Fail,49,36,4,11,38
50,Fail,44,41,0,12,32
50,Fail,39,37,6,18,21
50,Fail,51,38,1,10,41
50,Fail,44,41,0,13,31
50,Fail,49,37,0,10,39
50,Fail,45,36,0,19,26
50,Fail,48,29,0,14,34
50,Fail,48,37,5,10,38
50,Fail,51,41,0,6,45
50,Fail,45,39,1,15,30
50,Fail,45,33,0,14,31
50,Fail,55,32,0,13,42
50,Fail,44,36,4,16,28
50,Fail,51,34,3,12,39
50,Fail,50,32,0,12,38
50,Fail,47,38,6,9,38
50,Fail,45,38,0,14,31
50,Fail,47,35,4,14,33
50,Success,61,28,0,11,50
50,Fail,47,31,5,17,30
50,Fail,51,40,0,9,42
50,Fail,49,38,2,11,38
50,Fail,48,40,0,12,36
50,Fail,40,39,0,12,28
50,Fail,47,37,3,13,34
50,Fail,54,37,2,7,47
50,Fail,50,33,4,13,37
50,Fail,44,42,0,13,31
50,Fail,51,36,0,10,41
50,Fail,44,38,5,13,31
50,Fail,54,34,3,9,45
50,Fail,44,34,8,14,30
50,Fail,46,37,7,10,36
50,Fail,50,34,0,13,37
50,Fail,49,38,0,9,40
50,Fail,47,39,2,12,35
50,Fail,50,33,0,11,39
50,Fail,53,36,0,10,43
50,Fail,49,33,7,11,38
50,Fail,47,36,6,11,36
50,Fail,48,32,7,13,35
50,Fail,46,43,0,8,38
50,Fail,53,32,3,12,41
50,Fail,47,35,0,17,30
50,Fail,45,40,4,11,34
50,Fail,51,36,1,12,39
50,Fail,51,34,0,15,36
50,Fail,56,28,5,11,45
50,Fail,45,42,5,8,37
50,Fail,42,48,0,8,34
50,Fail,49,42,0,8,41
50,Fail,51,26,9,14,37
50,Fail,47,37,0,12,35
50,Fail,49,38,0,10,39
50,Fail,51,29,2,18,33
50,Fail,48,46,1,5,43
50,Fail,55,29,5,11,44
50,Fail,57,31,1,11,46
50,Fail,45,38,0,12,33
50,Fail,54,37,1,8,46
50,Fail,51,31,5,13,38
50,Fail,50,33,6,11,39
50,Fail,45,37,0,16,29
50,Fail,46,46,0,8,38
50,Fail,51,32,0,12,39
50,Fail,45,41,0,11,34
50,Fail,50,35,0,13,37
50,Fail,55,25,4,16,39
50,Fail,47,29,6,18,29
50,Fail,46,33,0,18,28
50,Fail,54,33,5,8,46
50,Fail,47,38,0,15,32
50,Fail,41,34,11,14,27
50,Fail,41,36,0,22,19
50,Fail,39,38,13,10,29
50,Fail,41,39,0,14,27
50,Fail,44,43,0,10,34
50,Success,58,32,0,8,50
50,Fail,48,38,2,12,36
50,Fail,52,33,0,11,41
50,Fail,56,31,0,10,46
50,Fail,49,37,0,10,39
50,Fail,53,32,6,9,44
50,Fail,44,35,2,19,25
50,Fail,50,35,0,9,41
50,Fail,54,34,0,12,42
50,Fail,48,36,0,14,34
50,Fail,41,29,0,15,26
50,Fail,50,36,1,13,37
50,Fail,59,28,0,13,46
50,Fail,47,41,0,10,37
50,Fail,53,37,2,8,45
50,Fail,52,24,0,16,36
50,Fail,42,37,9,12,30
50,Fail,52,26,0,21,31
50,Fail,53,28,7,12,41
50,Fail,46,34,0,11,35
50,Fail,52,30,4,14,38
50,Fail,52,40,0,6,46
50,Fail,35,47,9,9,26
50,Fail,54,29,0,15,39
50,Fail,49,32,0,15,34
50,Fail,52,36,0,12,40
50,Fail,46,35,7,12,34
50,Fail,48,30,5,17,31
50,Fail,49,35,0,15,34
50,Fail,49,35,0,16,33
50,Fail,48,35,2,15,33
50,Fail,48,33,0,17,31
50,Fail,49,38,0,8,41
50,Fail,43,42,2,13,30
50,Fail,40,34,0,18,22
50,Fail,50,34,0,14,36
50,Fail,45,27,11,17,28
50,Fail,45,40,4,11,34
50,Fail,48,38,3,11,37
50,Fail,49,37,0,13,36
50,Fail,54,37,0,8,46
50,Success,58,34,0,7,51
50,Fail,44,42,0,10,34
50,Fail,48,27,0,18,30
50,Fail,56,32,0,12,44
50,Fail,47,37,0,13,34
50,Fail,49,32,6,13,36
50,Fail,46,36,0,14,32
50,Fail,48,39,0,9,39
50,Fail,48,37,0,12,36
50,Fail,51,35,0,14,37
50,Fail,47,33,4,16,31
50,Fail,49,40,2,9,40
50,Fail,49,37,0,12,37
50,Fail,36,45,0,12,24
50,Fail,43,38,5,14,29
50,Fail,45,31,12,12,33
50,Fail,52,37,2,9,43
50,Fail,53,37,2,8,45
50,Fail,51,40,0,6,45
50,Fail,50,28,0,19,31
50,Fail,54,33,0,12,42
50,Fail,40,38,0,17,23
50,Fail,49,38,2,11,38
50,Fail,45,36,4,15,30
50,Fail,51,36,5,8,43
50,Fail,40,47,0,13,27
50,Fail,44,34,9,13,31
50,Fail,46,38,1,15,31
50,Fail,43,39,6,12,31
50,Fail,51,31,6,12,39
50,Fail,44,40,0,13,31
50,Fail,50,34,0,10,40
50,Fail,37,44,0,18,19
50,Fail,54,35,0,11,43
50,Fail,42,38,11,9,33
50,Fail,50,33,5,12,38
50,Fail,48,37,0,14,34
50,Fail,40,31,0,13,27
50,Fail,51,34,0,9,42
50,Fail,47,41,0,11,36
50,Fail,45,35,3,17,28
50,Fail,48,34,2,16,32
50,Fail,52,34,4,10,42
50,Fail,48,38,0,10,38
50,Fail,48,32,0,14,34
50,Fail,55,30,0,12,43
50,Fail,49,31,10,10,39
50,Fail,40,43,8,9,31
50,Fail,48,36,4,12,36
50,Fail,46,40,0,12,34
50,Fail,48,29,6,17,31
50,Fail,40,49,0,7,33
50,Fail,55,32,0,10,45
50,Fail,50,32,8,10,40
50,Fail,49,27,0,16,33
50,Fail,44,38,2,16,28
50,Fail,33,39,0,18,15
50,Fail,54,29,0,14,40
50,Fail,42,38,0,12,30
50,Fail,45,45,1,9,36
50,Fail,48,34,9,9,39
50,Fail,51,37,0,9,42
50,Fail,45,37,6,12,33
50,Fail,53,34,3,10,43
50,Fail,50,38,3,9,41
50,Fail,47,33,0,10,37
50,Fail,55,34,0,11,44
50,Fail,51,35,0,12,39
50,Fail,50,27,9,14,36
50,Fail,48,32,9,11,37
50,Fail,57,30,0,10,47
50,Fail,45,39,3,13,32
50,Fail,50,26,7,17,33
50,Fail,46,37,0,16,30
50,Fail,43,40,0,14,29
50,Fail,49,42,0,9,40
50,Fail,49,32,5,14,35
50,Fail,47,38,2,13,34
50,Fail,51,35,5,9,42
50,Fail,41,36,0,16,25
50,Fail,47,38,5,10,37
50,Fail,50,36,0,13,37
50,Fail,49,32,7,12,37
50,Fail,52,32,2,14,38
50,Fail,44,35,3,18,26
50,Fail,52,39,0,9,43
50,Fail,54,37,0,8,46
50,Fail,49,40,3,8,41
50,Fail,46,38,2,14,32
50,Fail,49,28,0,20,29
50,Fail,43,33,0,18,25
50,Fail,47,39,0,11,36
50,Fail,50,30,0,15,35
50,Success,56,36,2,6,50
50,Fail,50,34,3,13,37
50,Fail,51,37,0,12,39
50,Fail,50,32,2,16,34
50,Fail,43,45,5,7,36
50,Fail,43,41,4,12,31
50,Fail,44,42,3,11,33
50,Fail,46,35,0,15,31
50,Fail,46,37,0,12,34
50,Fail,51,38,1,10,41
50,Fail,45,38,6,11,34
50,Fail,51,33,0,12,39
50,Fail,47,30,0,20,27
50,Fail,44,42,0,10,34
50,Fail,48,34,4,14,34
50,Fail,46,33,0,15,31
50,Fail,39,43,0,14,25
50,Fail,44,31,7,18,26
50,Fail,45,36,5,14,31
50,Fail,53,32,0,8,45
50,Fail,50,40,1,9,41
50,Fail,59,27,3,11,48
50,Fail,48,39,0,13,35
50,Fail,47,34,0,16,31
50,Fail,44,35,0,13,31
50,Fail,49,33,0,16,33
50,Fail,47,39,0,11,36
50,Fail,48,37,0,14,34
50,Fail,48,38,0,13,35
50,Fail,39,38,0,16,23
50,Fail,47,32,0,14,33
50,Fail,54,34,0,10,44
50,Fail,49,31,0,14,35
50,Fail,46,27,10,17,29
50,Fail,44,40,1,15,29
50,Fail,47,39,0,13,34
50,Success,58,33,2,7,51
50,Fail,46,33,7,14,32
50,Fail,52,39,0,9,43
50,Fail,44,44,4,8,36
50,Fail,45,41,5,9,36
50,Fail,47,33,4,16,31
50,Fail,48,43,1,8,40
50,Fail,50,41,0,9,41
50,Fail,47,36,0,15,32
50,Fail,49,34,0,13,36
50,Fail,51,37,0,9,42
50,Fail,47,40,3,10,37
50,Fail,59,27,1,13,46
50,Fail,51,37,0,11,40
50,Fail,43,40,0,15,28
50,Fail,57,34,0,9,48
50,Fail,50,30,3,17,33
50,Fail,56,28,0,16,40
50,Fail,46,32,0,18,28
50,Fail,44,42,1,13,31
50,Fail,48,33,3,16,32
50,Fail,41,43,0,15,26
50,Fail,54,33,1,12,42
50,Fail,50,33,2,15,35
50,Fail,53,33,1,13,40
50,Fail,44,37,0,13,31
50,Fail,47,40,5,8,39
50,Fail,49,31,5,15,34
50,Fail,49,37,5,9,40
50,Fail,45,39,0,9,36
50,Fail,46,33,8,13,33
50,Fail,50,37,0,13,37
50,Fail,54,26,7,13,41
50,Fail,48,33,9,10,38
50,Fail,55,31,5,9,46
50,Fail,56,33,1,10,46
50,Fail,52,36,1,11,41
50,Fail,52,32,1,15,37
50,Fail,45,32,0,8,37
50,Fail,52,35,0,10,42
50,Fail,50,37,6,7,43
50,Fail,47,34,0,17,30
50,Fail,54,36,3,7,47
50,Fail,39,39,0,11,28
50,Fail,47,38,0,14,33
50,Fail,46,34,0,17,29
50,Fail,49,41,0,8,41
50,Fail,49,33,0,13,36
50,Fail,47,29,0,19,28
50,Fail,51,35,0,12,39
50,Fail,44,35,0,15,29
50,Fail,48,34,0,16,32
50,Fail,47,41,0,4,43
50,Fail,47,33,0,13,34
50,Fail,46,37,0,13,33
50,Fail,50,38,0,12,38
50,Fail,48,32,9,11,37
50,Fail,46,34,0,12,34
50,Fail,47,37,4,12,35
50,Fail,38,37,0,12,26
50,Fail,48,40,1,11,37
50,Fail,51,31,0,13,38
50,Fail,50,37,0,12,38
50,Fail,52,35,0,10,42
50,Fail,49,36,0,15,34
50,Fail,51,39,0,9,42
50,Fail,48,35,3,14,34
50,Fail,49,41,2,8,41
50,Fail,42,34,0,20,22
50,Fail,42,41,4,13,29
50,Fail,49,38,0,11,38
50,Fail,47,34,0,18,29
50,Fail,51,33,1,15,36
50,Fail,48,41,2,9,39
50,Fail,50,38,0,7,43
50,Fail,48,32,0,13,35
50,Fail,53,38,0,7,46
50,Fail,49,28,8,15,34
50,Fail,48,33,0,16,32
50,Fail,47,31,5,17,30
50,Fail,50,35,0,9,41
50,Fail,49,31,0,12,37
50,Fail,53,31,0,11,42
50,Fail,50,37,2,11,39
50,Fail,46,32,7,15,31
50,Fail,51,39,4,6,45
50,Fail,50,25,8,17,33
50,Fail,43,40,0,13,30
50,Fail,49,37,0,13,36
50,Fail,53,35,0,10,43
50,Fail,47,35,0,13,34
50,Fail,42,38,0,16,26
50,Fail,49,33,0,14,35
50,Fail,41,43,0,11,30
50,Fail,53,34,0,13,40
50,Fail,46,34,0,9,37
50,Fail,38,41,12,9,29
50,Fail,52,34,3,11,41
50,Fail,40,47,0,12,28
50,Fail,41,35,0,17,24
50,Fail,48,34,3,15,33
50,Fail,50,36,0,9,41
50,Fail,44,41,3,12,32
50,Fail,52,31,3,14,38
50,Fail,51,37,0,12,39
50,Fail,54,29,2,15,39
50,Fail,49,36,5,10,39
50,Fail,51,36,3,10,41
50,Fail,49,38,0,12,37
50,Fail,56,27,3,14,42
50,Fail,47,34,8,11,36
50,Fail,49,39,1,11,38
50,Fail,46,40,4,10,36
50,Fail,49,38,0,9,40
50,Fail,49,40,2,9,40
50,Fail,46,41,0,11,35
50,Fail,49,37,2,12,37
50,Fail,46,35,4,15,31
50,Fail,54,32,0,10,44
50,Fail,52,33,5,10,42
50,Fail,52,31,1,16,36
50,Fail,54,31,2,13,41
50,Fail,44,34,0,15,29
50,Fail,41,31,0,22,19
50,Fail,51,27,2,20,31
50,Fail,49,36,0,12,37
50,Fail,47,39,0,11,36
50,Fail,47,33,0,17,30
50,Fail,46,34,0,15,31
50,Fail,51,41,1,7,44
50,Fail,49,37,1,13,36
50,Fail,49,36,1,14,35
50,Fail,52,36,0,11,41
50,Fail,51,34,0,14,37
50,Fail,46,36,5,13,33
50,Fail,46,34,0,20,26
50,Fail,40,38,0,16,24
50,Fail,49,36,0,10,39
50,Fail,53,33,0,13,40
50,Fail,41,44,8,7,34
50,Fail,52,30,9,9,43
50,Fail,56,34,1,9,47
50,Fail,43,42,0,12,31
50,Fail,52,28,0,10,42
50,Fail,45,37,0,11,34
50,Fail,38,38,0,13,25
50,Fail,43,43,0,10,33
50,Fail,48,31,8,13,35
50,Fail,54,34,7,5,49
50,Fail,49,34,0,16,33
50,Fail,53,37,0,8,45
50,Fail,55,29,2,14,41
50,Fail,56,34,0,10,46
50,Fail,45,39,1,15,30
50,Fail,59,29,1,11,48
50,Fail,56,31,3,10,46
50,Fail,57,22,0,11,46
50,Fail,45,34,0,16,29
50,Fail,52,34,4,10,42
50,Fail,50,31,3,16,34
50,Fail,51,38,1,10,41
50,Fail,49,27,0,14,35
50,Fail,52,29,0,15,37
50,Fail,50,36,1,13,37
50,Fail,44,30,0,20,24
50,Fail,56,32,2,10,46
50,Fail,54,28,0,10,44
50,Fail,46,39,0,13,33
50,Fail,49,35,0,12,37
50,Fail,45,33,7,15,30
50,Fail,42,40,3,15,27
50,Fail,53,31,2,14,39
50,Fail,46,37,1,16,30
50,Fail,50,37,5,8,42
50,Fail,45,44,0,11,34
50,Success,55,38,0,5,50
50,Fail,44,36,4,16,28
50,Fail,49,38,4,9,40
50,Fail,50,37,0,13,37
50,Fail,48,37,1,14,34
50,Fail,44,36,4,16,28
50,Fail,52,31,3,14,38
50,Fail,46,37,6,11,35
50,Fail,41,43,5,11,30
50,Fail,49,32,4,15,34
50,Fail,38,44,1,17,21
50,Fail,40,38,0,12,28
50,Fail,51,32,7,10,41
50,Success,58,33,0,8,50
50,Fail,44,43,1,12,32
50,Fail,46,40,0,13,33
50,Fail,53,37,0,10,43
50,Fail,37,43,1,19,18
50,Fail,49,35,0,15,34
50,Fail,45,41,5,9,36
50,Fail,45,44,0,6,39
50,Fail,42,42,3,13,29
50,Fail,42,36,6,16,26
50,Fail,48,35,1,16,32
50,Fail,47,37,3,13,34
50,Fail,52,36,0,10,42
50,Fail,43,43,2,12,31
50,Fail,47,42,0,10,37
50,Fail,46,36,5,13,33
50,Fail,57,33,0,10,47
50,Fail,50,35,1,14,36
50,Fail,52,30,0,8,44
50,Fail,48,34,0,12,36
50,Fail,47,35,0,16,31
50,Fail,46,31,3,20,26
50,Fail,43,37,3,17,26
50,Fail,57,30,0,10,47
50,Fail,45,41,0,13,32
50,Fail,51,33,0,9,42
50,Fail,47,31,8,14,33
50,Fail,45,37,0,14,31
50,Fail,47,40,0,7,40
50,Fail,54,33,0,12,42
50,Fail,43,34,0,16,27
50,Fail,45,38,0,13,32
50,Fail,39,40,4,17,22
50,Fail,46,33,6,15,31
50,Fail,50,36,0,13,37
50,Fail,43,33,0,14,29
50,Fail,47,37,1,15,32
50,Fail,49,39,0,7,42
50,Fail,49,33,0,8,41
50,Fail,48,29,0,12,36
50,Fail,49,25,0,11,38
50,Fail,49,33,0,13,36
50,Fail,52,35,6,7,45
50,Fail,55,33,1,11,44
50,Fail,43,38,0,16,27
50,Fail,49,35,0,11,38
50,Fail,43,43,3,11,32
50,Fail,51,37,0,11,40
50,Fail,37,37,0,19,18
50,Fail,45,38,4,13,32
50,Fail,43,34,0,22,21
50,Fail,49,39,0,12,37
50,Fail,47,42,0,9,38
50,Fail,55,33,1,11,44
50,Fail,54,35,5,6,48
50,Fail,45,34,8,13,32
50,Fail,50,35,0,11,39
50,Fail,53,32,0,14,39
50,Fail,48,34,0,14,34
50,Fail,49,33,0,16,33
50,Fail,45,37,4,14,31
50,Fail,41,36,10,13,28
50,Fail,54,27,0,15,39
50,Fail,51,30,0,12,39
50,Fail,42,45,1,12,30
50,Fail,48,38,0,13,35
50,Fail,49,40,0,6,43
50,Fail,56,34,1,9,47
50,Fail,53,35,0,12,41
50,Fail,47,31,0,17,30
50,Fail,49,31,0,18,31
50,Fail,37,43,9,11,26
50,Fail,46,33,4,17,29
50,Fail,42,38,0,12,30
50,Fail,46,41,3,10,36
50,Fail,44,43,0,12,32
50,Fail,41,46,0,12,29
50,Fail,49,39,0,12,37
50,Fail,46,38,3,13,33
50,Fail,56,28,1,15,41
50,Fail,48,37,3,12,36
50,Fail,47,33,0,19,28
50,Fail,54,34,3,9,45
50,Fail,48,41,0,11,37
50,Fail,50,37,0,12,38
50,Fail,36,37,11,16,20
50,Fail,56,29,0,14,42
50,Fail,44,35,4,17,27
50,Fail,47,39,0,13,34
50,Fail,46,41,1,12,34
50,Fail,50,39,5,6,44
50,Fail,41,38,0,11,30
50,Fail,44,32,0,12,32
50,Fail,51,28,0,12,39
50,Fail,51,34,3,12,39
50,Fail,46,32,5,17,29
50,Fail,54,37,1,8,46
50,Fail,43,38,3,16,27
50,Fail,35,41,7,17,18
50,Fail,42,39,5,14,28
50,Success,56,39,0,5,51
50,Fail,37,30,14,19,18
50,Fail,44,34,4,18,26
50,Fail,52,36,1,11,41
50,Fail,45,40,0,11,34
50,Fail,49,30,10,11,38
50,Fail,42,40,0,18,24
50,Fail,41,43,0,15,26
50,Fail,50,41,0,7,43
50,Fail,51,25,0,19,32
50,Fail,46,40,0,8,38
50,Fail,51,35,0,10,41
50,Fail,42,40,0,13,29
50,Fail,47,40,6,7,40
50,Fail,45,37,0,11,34
50,Fail,48,34,1,17,31
50,Fail,47,33,6,14,33
50,Fail,50,40,0,6,44
50,Fail,45,31,8,16,29
50,Fail,40,40,5,15,25
50,Fail,45,40,6,9,36
50,Fail,52,37,3,8,44
50,Fail,50,35,1,14,36
50,Fail,40,40,0,12,28
50,Fail,40,35,0,19,21
50,Fail,53,35,1,11,42
50,Fail,55,33,0,7,48
50,Fail,46,36,0,11,35
50,Fail,49,38,0,12,37
50,Fail,54,35,0,9,45
50,Fail,53,37,0,8,45
50,Fail,48,33,4,15,33
50,Fail,51,29,3,17,34
50,Fail,49,38,0,7,42
50,Fail,53,39,0,8,45
50,Fail,49,40,0,9,40
50,Fail,47,37,0,12,35
50,Fail,44,36,6,14,30
50,Fail,54,39,0,7,47
50,Fail,53,32,0,11,42
50,Fail,45,34,0,17,28
50,Fail,44,40,0,12,32
50,Fail,49,36,0,11,38
50,Fail,47,38,0,11,36
50,Fail,41,41,0,16,25
50,Fail,51,37,0,11,40
50,Fail,49,41,3,7,42
50,Fail,50,27,0,17,33
50,Fail,46,27,12,15,31
50,Fail,47,41,0,7,40
50,Fail,48,32,8,12,36
50,Fail,42,33,7,18,24
50,Fail,51,33,5,11,40
50,Fail,50,33,1,16,34
50,Fail,48,35,4,13,35
50,Fail,43,47,3,7,36
50,Fail,50,39,0,11,39
50,Fail,45,39,1,15,30
50,Fail,49,31,0,13,36
50,Fail,47,34,3,16,31
50,Fail,52,33,0,13,39
50,Fail,46,38,2,14,32
50,Fail,46,39,2,13,33
50,Fail,52,39,0,9,43
50,Fail,44,39,0,13,31
50,Fail,48,36,0,14,34
50,Fail,45,41,0,9,36
50,Fail,44,38,0,12,32
50,Fail,56,33,2,9,47
50,Fail,55,33,3,9,46
50,Fail,44,34,0,11,33
50,Fail,51,32,3,14,37
50,Fail,46,42,3,9,37
50,Fail,45,34,0,10,35
50,Fail,48,32,5,15,33
50,Fail,44,38,0,16,28
50,Fail,43,33,7,17,26
50,Fail,51,33,0,9,42
50,Fail,50,37,0,12,38
50,Fail,54,36,0,10,44
50,Fail,53,26,0,18,35
50,Fail,46,35,5,14,32
50,Fail,53,32,4,11,42
50,Fail,49,38,0,9,40
50,Fail,47,36,2,15,32
50,Fail,48,37,0,15,33
50,Fail,48,35,0,10,38
50,Fail,46,42,3,9,37
50,Fail,48,37,0,15,33
50,Success,62,27,0,10,52
50,Fail,46,42,0,11,35
50,Fail,45,39,2,14,31
50,Fail,46,33,6,15,31
50,Fail,42,48,0,8,34
50,Fail,48,36,0,14,34
50,Fail,43,39,5,13,30
50,Fail,43,43,0,12,31
50,Fail,53,34,2,11,42
50,Fail,48,40,0,9,39
50,Fail,55,35,0,8,47
50,Fail,53,37,0,10,43
50,Fail,55,31,1,13,42
50,Fail,51,36,4,9,42
50,Fail,42,29,0,17,25
50,Fail,51,37,0,9,42
50,Fail,50,32,7,11,39
50,Fail,48,45,0,7,41
50,Fail,42,41,3,14,28
50,Fail,48,29,0,17,31
50,Fail,43,46,1,10,33
50,Fail,48,33,0,17,31
50,Fail,53,38,2,7,46
50,Fail,51,28,3,18,33
50,Fail,51,31,2,16,35
50,Fail,44,43,4,9,35
50,Fail,48,43,1,8,40
50,Fail,48,40,0,7,41
50,Fail,52,31,3,14,38
50,Fail,45,42,0,8,37
50,Fail,54,32,0,12,42
50,Fail,49,35,1,15,34
50,Fail,53,28,9,10,43
50,Fail,41,38,0,14,27
50,Fail,49,32,0,16,33
50,Fail,54,29,3,14,40
50,Fail,51,35,6,8,43
50,Fail,45,39,5,11,34
50,Fail,55,34,0,8,47
50,Fail,53,35,2,10,43
50,Fail,41,36,0,15,26
50,Fail,46,39,1,14,32
50,Fail,51,30,8,11,40
50,Fail,53,33,0,8,45
50,Fail,48,32,0,16,32
50,Fail,47,36,5,12,35
50,Fail,51,41,1,7,44
50,Fail,48,36,0,16,32
50,Fail,46,42,0,9,37
50,Fail,46,34,8,12,34
50,Fail,40,42,6,12,28
50,Fail,44,38,0,14,30
50,Fail,43,38,0,13,30
50,Fail,47,39,0,10,37
50,Fail,46,40,0,9,37
50,Fail,49,35,0,14,35
50,Fail,52,40,0,8,44
50,Fail,46,37,0,13,33
50,Fail,42,35,9,14,28
50,Fail,49,39,0,11,38
50,Fail,39,35,0,20,19
50,Fail,51,37,0,8,43
50,Fail,47,32,5,16,31
50,Fail,50,33,0,12,38
50,Fail,51,32,0,16,35
50,Fail,42,39,0,16,26
50,Fail,51,34,0,11,40
50,Fail,47,42,0,10,37
50,Fail,47,35,6,12,35
50,Fail,50,32,0,14,36
50,Fail,38,44,0,13,25
50,Fail,52,33,0,14,38
50,Fail,51,39,2,8,43
50,Fail,52,31,0,9,43
50,Fail,45,33,3,19,26
50,Fail,40,46,2,12,28
50,Fail,51,31,0,10,41
50,Fail,42,35,0,15,27
50,Fail,41,42,0,12,29
50,Fail,51,35,0,14,37
50,Fail,55,33,0,8,47
50,Fail,44,34,0,14,30
50,Fail,45,38,4,13,32
50,Fail,43,38,6,13,30
50,Fail,45,33,0,18,27
50,Fail,49,31,5,15,34
50,Fail,47,37,0,11,36
50,Fail,53,34,3,10,43
50,Fail,55,33,0,11,44
50,Fail,46,38,5,11,35
50,Fail,50,39,0,9,41
50,Fail,48,38,4,10,38
50,Fail,52,33,0,12,40
50,Fail,49,41,1,9,40
50,Fail,51,31,0,15,36
50,Fail,47,39,0,11,36
50,Fail,48,38,4,10,38
50,Fail,44,34,11,11,33
50,Success,59,36,0,5,54
50,Fail,43,28,10,19,24
50,Fail,51,40,0,8,43
50,Fail,53,34,0,11,42
50,Fail,56,30,2,12,44
50,Fail,44,33,0,14,30
50,Fail,55,35,3,7,48
50,Fail,47,43,1,9,38
50,Fail,36,40,0,18,18
50,Fail,46,35,0,9,37
50,Fail,46,34,0,12,34
50,Fail,45,34,4,17,28
50,Fail,50,31,0,18,32
50,Fail,45,36,11,8,37
50,Fail,50,37,0,11,39
50,Fail,49,41,4,6,43
50,Fail,48,42,2,8,40
50,Fail,54,35,0,10,44
50,Fail,47,37,0,16,31
50,Fail,39,37,0,15,24
50,Fail,45,37,0,11,34
50,Fail,47,34,2,17,30
50,Fail,55,31,0,11,44
50,Fail,44,33,5,18,26
50,Success,58,35,0,6,52
50,Fail,48,34,0,14,34
50,Fail,42,41,0,12,30
50,Fail,44,40,2,14,30
50,Fail,40,40,0,14,26
50,Fail,46,29,8,17,29
50,Fail,48,31,6,15,33
50,Fail,41,35,0,14,27
50,Fail,44,41,7,8,36
50,Fail,43,40,0,13,30
50,Fail,39,42,0,17,22
50,Fail,46,28,0,14,32
50,Fail,44,32,0,19,25
50,Fail,47,39,5,9,38
50,Success,56,36,0,5,51
50,Fail,46,30,5,19,27
50,Fail,49,28,0,19,30
50,Fail,48,40,0,11,37
50,Fail,54,25,2,19,35
50,Fail,47,41,0,11,36
50,Fail,54,36,2,8,46
50,Fail,47,37,0,13,34
50,Fail,54,25,0,15,39
50,Fail,45,47,1,7,38
50,Fail,50,34,0,14,36
50,Fail,51,34,0,10,41
50,Fail,46,29,0,13,33
50,Fail,43,38,9,10,33
50,Fail,44,36,0,15,29
50,Fail,52,34,0,9,43
50,Fail,46,36,0,16,30
50,Success,62,33,2,3,59
50,Fail,44,35,0,12,32
50,Fail,51,40,0,9,42
50,Fail,58,28,2,12,46
50,Fail,52,34,0,14,38
50,Fail,49,35,4,12,37
50,Fail,52,38,2,8,44
50,Fail,50,37,0,11,39
50,Fail,53,32,6,9,44
50,Fail,50,32,0,11,39
50,Fail,38,29,0,21,17
50,Fail,47,36,0,17,30
50,Fail,52,31,0,15,37
50,Fail,52,29,3,16,36
50,Fail,48,37,0,11,37
50,Fail,46,30,0,21,25
50,Fail,50,27,0,13,37
50,Fail,46,40,0,14,32
50,Fail,51,33,6,10,41
50,Fail,47,31,7,15,32
50,Fail,53,28,0,14,39
50,Fail,55,35,0,7,48
50,Fail,46,30,10,14,32
50,Fail,48,37,0,10,38
50,Success,60,27,0,10,50
50,Fail,47,35,2,16,31
50,Fail,58,28,0,13,45
50,Fail,50,34,0,15,35
50,Fail,43,38,5,14,29
50,Fail,47,45,0,8,39
50,Fail,49,34,1,16,33
50,Fail,52,35,2,11,41
50,Fail,50,33,0,16,34
50,Fail,50,29,0,12,38
50,Fail,44,34,4,18,26
50,Fail,55,34,0,10,45
50,Fail,44,45,0,10,34
50,Fail,49,34,7,10,39
50,Fail,47,37,2,14,33
50,Fail,55,37,1,7,48
50,Fail,45,36,4,15,30
50,Fail,46,36,0,13,33
50,Fail,53,34,5,8,45
50,Fail,47,35,1,17,30
50,Fail,44,41,0,9,35
50,Fail,57,34,0,9,48
50,Fail,49,31,0,15,34
50,Fail,51,33,0,9,42
50,Fail,53,35,0,11,42
50,Fail,50,40,0,9,41
50,Fail,49,37,0,14,35
50,Fail,58,29,2,11,47
50,Fail,46,38,3,13,33
50,Fail,49,30,0,11,38
50,Fail,46,33,0,19,27
50,Fail,48,38,1,13,35
50,Fail,45,34,4,17,28
50,Fail,46,41,0,11,35
50,Fail,52,35,0,13,39
50,Fail,49,39,0,10,39
50,Fail,43,29,0,18,25
50,Fail,38,42,0,16,22
50,Fail,41,39,5,15,26
50,Fail,48,34,0,15,33
50,Fail,50,35,6,9,41
50,Fail,57,28,1,14,43
50,Fail,46,34,0,18,28
50,Fail,47,40,0,10,37
50,Fail,51,35,0,11,40
50,Fail,50,35,0,15,35
50,Fail,38,31,17,14,24
50,Fail,45,38,0,11,34
50,Fail,53,35,0,11,42
50,Fail,49,33,0,15,34
50,Fail,47,39,0,11,36
50,Fail,51,28,4,17,34
50,Fail,48,38,1,13,35
50,Fail,57,28,0,12,45
50,Fail,47,34,8,11,36
50,Fail,48,34,0,18,30
50,Fail,41,37,6,16,25
50,Fail,52,36,1,11,41
50,Fail,43,37,3,17,26
50,Fail,47,31,0,19,28
50,Fail,55,30,0,9,46
50,Fail,53,34,4,9,44
50,Fail,54,31,0,14,40
50,Fail,54,28,0,15,39
50,Fail,52,30,0,15,37
50,Fail,39,44,7,10,29
50,Fail,49,36,1,14,35
50,Fail,44,41,0,10,34
50,Fail,50,32,0,13,37
50,Fail,47,40,0,11,36
50,Fail,44,38,7,11,33
50,Fail,45,41,1,13,32
50,Fail,54,34,0,10,44
50,Fail,41,39,0,14,27
50,Fail,48,38,2,12,36
50,Fail,48,33,0,13,35
50,Fail,51,32,0,12,39
50,Fail,45,32,8,15,30
50,Fail,50,35,0,10,40
50,Fail,49,34,0,14,35
50,Fail,49,36,0,15,34
50,Fail,55,36,1,8,47
50,Fail,46,37,0,16,30
50,Fail,46,41,2,11,35
50,Fail,50,28,5,17,33
50,Fail,44,45,1,10,34
50,Fail,48,34,0,12,36
50,Fail,45,35,0,17,28
50,Fail,44,41,3,12,32
50,Fail,51,31,0,7,44
50,Fail,49,36,2,13,36
50,Fail,43,40,6,11,32
50,Fail,44,37,0,13,31
50,Fail,49,38,3,10,39
50,Fail,38,32,0,19,19
50,Fail,52,40,0,8,44
50,Fail,43,37,0,16,27
50,Fail,50,32,7,11,39
50,Fail,38,38,3,21,17
50,Fail,54,29,7,10,44
50,Fail,45,37,4,14,31
50,Success,61,31,2,6,55
50,Fail,41,41,0,15,26
50,Fail,49,36,8,7,42
50,Fail,50,38,0,8,42
50,Fail,46,30,0,19,27
50,Fail,46,27,0,22,24
50,Fail,48,35,0,16,32
50,Fail,50,30,0,16,34
50,Fail,53,38,0,9,44
50,Fail,39,41,0,12,27
50,Fail,34,39,6,21,13
50,Fail,48,39,2,11,37
50,Fail,43,37,4,16,27
50,Fail,53,39,0,7,46
50,Fail,51,34,0,14,37
50,Fail,46,32,13,9,37
50,Fail,46,36,0,9,37
50,Fail,47,35,0,18,29
50,Fail,50,34,5,11,39
50,Fail,46,36,0,15,31
50,Fail,51,36,2,11,40
50,Fail,47,37,0,10,37
50,Fail,51,30,6,13,38
50,Fail,50,37,0,11,39
50,Fail,53,33,0,11,42
50,Fail,45,32,8,15,30
50,Fail,40,44,5,11,29
50,Fail,48,43,3,6,42
50,Fail,54,35,0,9,45
50,Fail,42,37,1,20,22
50,Fail,48,35,0,14,34
50,Fail,46,41,2,11,35
50,Fail,49,39,0,11,38
50,Fail,38,39,12,11,27
50,Fail,42,36,0,14,28
50,Fail,45,35,1,19,26
50,Fail,47,39,7,7,40
50,Fail,51,42,0,6,45
50,Fail,42,36,0,15,27
50,Fail,48,35,0,10,38
50,Fail,46,40,0,7,39
50,Fail,51,36,0,13,38
50,Fail,47,37,2,14,33
50,Fail,55,30,3,12,43
50,Fail,48,43,0,7,41
50,Fail,47,37,5,11,36
50,Fail,50,39,1,10,40
50,Fail,49,27,0,17,32
50,Fail,48,37,0,14,34
50,Fail,42,35,0,15,27
50,Fail,43,36,6,15,28
50,Fail,49,34,6,11,38
50,Fail,39,41,10,10,29
50,Fail,39,36,0,15,24
50,Fail,50,35,1,14,36
50,Fail,49,34,0,9,40
50,Fail,53,34,0,13,40
50,Fail,42,36,0,15,27
50,Fail,49,39,0,10,39
50,Fail,53,36,0,10,43
50,Fail,51,43,0,5,46
50,Fail,50,38,0,12,38
50,Fail,48,33,0,14,34
50,Fail,52,35,0,11,41
50,Fail,50,29,5,16,34
50,Fail,44,41,0,12,32
50,Fail,43,33,8,16,27
50,Fail,45,40,0,15,30
50,Fail,41,45,2,12,29
50,Fail,50,39,0,11,39
50,Fail,46,34,10,10,36
50,Fail,49,32,3,16,33
50,Fail,49,39,1,11,38
50,Fail,50,29,13,8,42
50,Fail,56,33,0,8,48
50,Fail,50,30,0,15,35
50,Fail,46,40,0,7,39
50,Fail,47,34,5,14,33
50,Fail,48,35,0,15,33
50,Fail,45,41,2,12,33
50,Fail,44,46,3,7,37
50,Fail,48,36,2,14,34
50,Fail,42,34,7,17,25
50,Fail,48,37,7,8,40
50,Fail,42,39,2,17,25
50,Fail,58,29,1,12,46
50,Fail,43,45,1,11,32
50,Success,66,24,1,9,57
50,Fail,42,39,0,17,25
50,Fail,48,41,2,9,39
50,Fail,52,36,0,12,40
50,Fail,56,34,1,9,47
50,Fail,53,34,0,13,40
50,Fail,53,30,3,14,39
50,Fail,58,33,0,9,49
50,Fail,36,43,0,12,24
50,Fail,48,35,7,10,38
50,Fail,50,33,0,15,35
50,Fail,45,38,0,16,29
50,Fail,52,34,6,8,44
50,Fail,44,38,0,15,29
50,Fail,52,29,7,12,40
50,Fail,45,36,9,10,35
50,Fail,51,37,1,11,40
50,Fail,53,37,0,10,43
50,Fail,48,37,0,14,34
50,Fail,45,41,5,9,36
50,Fail,46,37,4,13,33
50,Fail,40,44,0,13,27
50,Fail,55,31,0,14,41
50,Fail,53,33,2,12,41
50,Fail,48,36,0,11,37
50,Fail,44,36,0,16,28
50,Fail,41,45,5,9,32
50,Fail,52,37,3,8,44
50,Fail,40,38,4,18,22
50,Fail,54,32,1,13,41
50,Fail,49,38,0,9,40
50,Fail,44,33,0,15,29
50,Fail,42,40,0,17,25
50,Fail,50,39,0,6,44
50,Fail,54,30,0,12,42
50,Fail,55,32,1,12,43
50,Fail,58,28,3,11,47
50,Fail,45,36,0,12,33
50,Fail,40,45,3,12,28
50,Fail,48,34,0,18,30
50,Fail,45,43,0,12,33
50,Fail,43,46,1,10,33
50,Fail,50,35,2,13,37
50,Fail,44,34,3,19,25
50,Fail,41,41,0,15,26
50,Fail,40,38,12,10,30
50,Fail,51,23,10,16,35
50,Fail,43,37,0,16,27
50,Fail,52,33,4,11,41
50,Fail,40,38,0,19,21
50,Fail,48,42,2,8,40
50,Fail,47,36,0,12,35
50,Fail,51,34,0,15,36
50,Fail,46,33,6,15,31
50,Fail,47,40,0,12,35
50,Fail,46,40,0,9,37
50,Fail,54,33,2,11,43
50,Fail,51,32,0,15,36
50,Fail,51,29,8,12,39
50,Fail,49,37,0,13,36
50,Fail,51,39,0,8,43
50,Fail,47,33,2,18,29
50,Fail,57,28,1,14,43
50,Fail,53,34,4,9,44
50,Fail,52,32,1,15,37
50,Fail,54,26,0,20,34
50,Fail,48,26,9,17,31
50,Fail,52,35,6,7,45
50,Fail,42,33,0,17,25
50,Fail,47,43,0,10,37
50,Fail,48,40,3,9,39
50,Fail,41,37,6,16,25
50,Fail,47,34,7,12,35
50,Fail,51,32,2,15,36
50,Fail,49,36,2,13,36
50,Fail,49,29,0,12,37
50,Fail,53,31,5,11,42
50,Fail,53,32,5,10,43
50,Fail,42,39,2,17,25
50,Fail,50,33,0,13,37
50,Fail,49,31,0,15,34
50,Fail,37,40,0,22,15
50,Fail,42,39,4,15,27
50,Fail,48,35,0,15,33
50,Fail,43,35,5,17,26
50,Fail,45,41,0,13,32
50,Fail,43,45,3,9,34
50,Fail,46,41,0,12,34
50,Fail,44,36,2,18,26
50,Fail,52,37,2,9,43
50,Fail,51,37,2,10,41
50,Fail,49,36,1,14,35
50,Fail,43,39,0,11,32
50,Fail,44,34,7,15,29
50,Fail,49,36,0,9,40
50,Fail,54,38,1,7,47
50,Fail,46,37,4,13,33
50,Fail,48,38,4,10,38
50,Fail,43,40,6,11,32
50,Fail,47,39,2,12,35
50,Fail,59,25,0,15,44
50,Fail,43,39,0,11,32
50,Fail,42,32,12,14,28
50,Fail,54,31,8,7,47
50,Fail,44,37,11,8,36
50,Fail,42,35,0,12,30
50,Fail,50,31,8,11,39
50,Fail,51,34,0,11,40
50,Fail,44,33,0,16,28
50,Fail,43,43,0,9,34
50,Fail,39,33,4,24,15
50,Fail,49,29,7,15,34
50,Fail,37,46,5,12,25
50,Fail,57,30,0,11,46
50,Fail,46,40,2,12,34
50,Fail,45,41,0,10,35
50,Fail,46,31,0,20,26
50,Fail,48,33,3,16,32
50,Fail,51,37,7,5,46
50,Fail,51,30,0,17,34
50,Fail,56,29,0,15,41
50,Fail,55,24,9,12,43
50,Fail,53,35,1,11,42
50,Fail,42,38,0,11,31
50,Fail,51,37,1,11,40
50,Fail,53,35,3,9,44
50,Fail,44,38,5,13,31
50,Fail,49,32,3,16,33
50,Fail,51,38,1,10,41
50,Fail,49,32,4,15,34
50,Fail,56,29,7,8,48
50,Fail,42,40,0,16,26
50,Fail,42,42,4,12,30
50,Fail,48,31,7,14,34
50,Fail,41,36,0,11,30
50,Fail,54,28,3,15,39
50,Success,58,32,0,6,52
50,Fail,55,32,0,10,45
50,Fail,54,36,2,8,46
50,Fail,52,31,4,13,39
50,Fail,50,39,0,8,42
50,Fail,54,39,0,7,47
50,Fail,48,31,11,10,38
50,Fail,48,39,0,10,38
50,Fail,47,34,0,8,39
50,Fail,49,33,0,9,40
50,Fail,52,37,1,10,42
50,Fail,49,32,0,16,33
50,Fail,45,41,0,13,32
50,Fail,44,40,0,12,32
50,Fail,45,34,0,17,28
50,Fail,54,30,0,10,44
50,Fail,49,42,0,6,43
50,Fail,49,37,0,10,39
50,Fail,47,43,0,7,40
50,Fail,49,34,0,7,42
50,Fail,51,39,1,9,42
50,Fail,42,35,0,14,28
50,Fail,51,33,1,15,36
50,Fail,48,41,2,9,39
50,Fail,43,42,1,14,29
50,Fail,46,34,7,13,33
50,Fail,57,29,2,12,45
50,Fail,43,41,0,11,32
50,Fail,50,36,1,13,37
50,Fail,55,30,0,13,42
50,Fail,46,32,0,15,31
50,Fail,49,37,1,13,36
50,Fail,51,32,0,12,39
50,Fail,48,38,0,13,35
50,Fail,46,36,6,12,34
50,Fail,50,32,0,17,33
50,Fail,41,44,1,14,27
50,Fail,50,40,0,8,42
50,Fail,45,36,0,18,27
50,Fail,44,40,0,15,29
50,Fail,49,30,0,14,35
50,Fail,43,40,0,11,32
50,Fail,50,35,3,12,38
50,Fail,55,36,2,7,48
50,Fail,51,37,0,8,43
50,Fail,49,28,8,15,34
50,Fail,52,31,0,12,40
50,Fail,40,39,0,16,24
50,Fail,44,38,0,18,26
50,Fail,46,41,0,12,34
50,Fail,44,32,11,13,31
50,Fail,46,33,6,15,31
50,Fail,57,31,1,11,46
50,Fail,44,39,0,14,30
50,Fail,45,30,0,14,31
50,Fail,49,38,0,11,38
50,Fail,42,39,0,14,28
50,Fail,38,43,0,15,23
50,Fail,49,34,4,13,36
50,Fail,47,31,0,10,37
50,Fail,44,42,2,12,32
50,Fail,47,32,9,12,35
50,Fail,53,27,3,17,36
50,Fail,53,38,2,7,46
50,Fail,51,36,0,9,42
50,Fail,55,31,0,11,44
50,Fail,47,27,11,15,32
50,Fail,47,36,0,14,33
50,Fail,52,39,0,9,43
50,Fail,45,39,2,14,31
50,Fail,47,36,2,15,32
50,Fail,51,29,3,17,34
50,Fail,50,36,4,10,40
50,Fail,40,44,0,12,28
50,Fail,53,34,3,10,43
50,Fail,55,28,0,12,43
50,Fail,52,33,4,11,41
50,Fail,55,31,0,7,48
50,Fail,52,35,1,12,40
50,Fail,52,38,1,9,43
50,Fail,49,33,0,17,32
50,Fail,38,40,9,13,25
50,Fail,48,38,0,11,37
50,Fail,47,35,0,15,32
50,Fail,51,37,6,6,45
50,Fail,54,37,0,7,47
50,Fail,50,40,2,8,42
50,Fail,45,34,6,15,30
50,Fail,46,37,9,8,38
50,Fail,47,35,8,10,37
50,Fail,57,34,0,8,49
50,Fail,49,38,0,12,37
50,Fail,51,37,4,8,43
50,Fail,50,35,0,13,37
50,Fail,46,35,0,11,35
50,Fail,52,35,0,10,42
50,Fail,57,28,2,13,44
50,Fail,46,35,4,15,31
50,Fail,42,41,0,12,30
50,Fail,49,43,0,7,42
50,Fail,58,29,3,10,48
50,Fail,46,39,4,11,35
50,Fail,46,36,0,16,30
50,Fail,42,38,5,15,27
50,Fail,47,34,6,13,34
50,Fail,49,38,0,12,37
50,Success,58,29,5,8,50
50,Fail,43,34,8,15,28
50,Fail,53,31,3,13,40
50,Fail,44,41,0,12,32
50,Fail,57,28,0,12,45
50,Fail,57,32,2,9,48
50,Fail,43,34,11,12,31
50,Fail,47,38,0,13,34
50,Fail,50,37,3,10,40
50,Fail,50,39,5,6,44
50,Fail,55,35,3,7,48
50,Fail,54,25,9,12,42
50,Fail,54,36,0,9,45
50,Fail,57,28,4,11,46
50,Fail,52,29,4,15,37
50,Fail,47,45,0,6,41
50,Fail,48,34,3,15,33
50,Fail,51,37,2,10,41
50,Fail,54,31,0,10,44
50,Fail,50,41,0,9,41
50,Fail,50,33,4,13,37
50,Fail,54,35,0,8,46
50,Fail,50,31,0,14,36
50,Fail,45,29,9,17,28
50,Fail,58,29,0,13,45
50,Fail,45,36,0,13,32
50,Fail,49,34,0,14,35
50,Fail,41,41,2,16,25
50,Fail,54,24,0,17,37
50,Fail,49,32,0,14,35
50,Fail,42,45,1,12,30
50,Fail,53,34,1,12,41
50,Fail,55,34,0,7,48
50,Fail,51,26,9,14,37
50,Fail,50,34,0,16,34
50,Fail,47,38,4,11,36
50,Fail,46,46,0,6,40
50,Fail,41,46,0,11,30
50,Fail,50,35,1,14,36
50,Fail,49,39,3,9,40
50,Fail,36,37,10,17,19
50,Fail,46,31,0,20,26
50,Fail,51,36,1,12,39
50,Fail,51,36,0,13,38
50,Fail,55,32,0,8,47
50,Fail,47,35,6,12,35
50,Fail,49,36,0,15,34
50,Fail,53,34,2,11,42
50,Fail,48,36,2,14,34
50,Fail,52,36,0,11,41
50,Fail,52,30,0,17,35
50,Fail,49,41,0,10,39
50,Fail,57,28,2,13,44
50,Fail,48,36,7,9,39
50,Fail,55,34,0,9,46
50,Success,59,34,0,6,53
50,Fail,35,40,0,9,26
50,Fail,50,34,3,13,37
50,Fail,42,45,1,12,30
50,Fail,53,27,6,14,39
50,Fail,47,31,5,17,30
50,Fail,60,28,1,11,49
50,Fail,49,28,0,12,37
50,Fail,44,37,5,14,30
50,Fail,38,40,5,17,21
50,Fail,57,34,0,9,48
50,Fail,48,36,0,14,34
50,Fail,50,35,0,11,39
50,Fail,48,35,0,17,31
50,Fail,43,36,0,16,27
50,Fail,48,35,3,14,34
50,Fail,51,37,0,7,44
50,Fail,49,31,8,12,37
50,Fail,49,34,0,15,34
50,Fail,49,28,7,16,33
50,Fail,53,31,3,13,40
50,Fail,48,36,1,15,33
50,Fail,49,40,0,11,38
50,Fail,45,44,1,10,35
50,Fail,51,38,0,10,41
50,Fail,46,31,0,17,29
50,Fail,44,39,8,9,35
50,Fail,43,37,3,17,26
50,Fail,48,34,3,15,33
50,Fail,51,39,3,7,44
50,Fail,48,36,7,9,39
50,Fail,51,30,0,16,35
50,Fail,41,38,2,19,22
50,Fail,48,36,9,7,41
50,Fail,50,34,6,10,40
50,Fail,36,46,4,14,22
50,Fail,48,39,0,8,40
50,Fail,46,35,0,15,31
50,Fail,52,25,0,13,39
50,Fail,49,36,3,12,37
50,Fail,46,36,5,13,33
50,Fail,55,36,1,8,47
50,Fail,48,34,0,13,35
50,Fail,53,37,0,10,43
50,Fail,56,35,0,8,48
50,Fail,52,25,0,14,38
50,Fail,47,36,4,13,34
50,Fail,46,32,0,17,29
50,Fail,53,34,0,11,42
50,Fail,46,41,0,10,36
50,Fail,48,38,4,10,38
50,Fail,44,39,0,15,29
50,Fail,46,32,0,21,25
50,Fail,44,37,6,13,31
50,Fail,53,30,5,12,41
50,Fail,53,31,0,12,41
50,Fail,42,32,0,22,20
50,Fail,53,34,2,11,42
50,Fail,47,36,0,12,35
50,Fail,50,37,0,12,38
50,Fail,43,29,0,19,24
50,Fail,43,38,6,13,30
50,Fail,52,30,0,13,39
50,Fail,58,28,5,9,49
50,Fail,44,43,3,10,34
50,Fail,50,24,6,20,30
50,Fail,47,28,10,15,32
50,Fail,52,31,3,14,38
50,Fail,50,39,0,10,40
50,Fail,47,39,0,8,39
50,Fail,50,37,0,12,38
50,Fail,51,32,0,10,41
50,Fail,53,31,0,16,37
50,Success,60,31,0,9,51
50,Fail,51,38,0,10,41
50,Fail,49,28,0,21,28
50,Fail,46,41,1,12,34
50,Fail,45,34,0,16,29
50,Fail,42,34,3,21,21
50,Fail,49,37,3,11,38
50,Fail,54,33,4,9,45
50,Fail,39,34,8,19,20
50,Fail,44,35,0,14,30
50,Fail,54,29,0,15,39
50,Fail,42,36,5,17,25
50,Fail,50,37,3,10,40
50,Fail,56,32,3,9,47
50,Fail,55,33,0,11,44
50,Fail,47,31,0,11,36
50,Fail,52,35,0,11,41
50,Fail,43,40,0,16,27
50,Fail,48,36,5,11,37
50,Fail,52,36,0,10,42
50,Fail,41,41,7,11,30
50,Fail,47,34,10,9,38
50,Fail,45,38,1,16,29
50,Fail,47,39,0,14,33
50,Fail,53,26,8,13,40
50,Fail,45,37,0,14,31
50,Fail,51,38,0,11,40
50,Fail,51,35,0,8,43
50,Fail,50,34,0,14,36
50,Fail,44,35,4,17,27
50,Fail,40,38,0,15,25
50,Fail,54,35,1,10,44
50,Fail,46,41,0,12,34
50,Success,60,30,0,9,51
50,Fail,41,31,0,14,27
50,Fail,48,35,0,12,36
50,Fail,54,30,1,15,39
50,Fail,48,32,0,15,33
50,Fail,45,33,12,10,35
50,Fail,47,30,10,13,34
50,Fail,40,40,10,10,30
50,Fail,46,41,0,9,37
50,Fail,41,46,0,12,29
50,Fail,47,36,7,10,37
50,Fail,50,38,0,11,39
50,Fail,42,49,1,8,34
50,Fail,40,47,0,12,28
50,Fail,50,26,0,19,31
50,Fail,48,32,0,14,34
50,Fail,47,31,0,16,31
50,Fail,51,39,2,8,43
50,Fail,45,34,0,12,33
50,Fail,40,33,0,22,18
50,Fail,51,31,0,15,36
50,Fail,49,35,5,11,38
50,Fail,52,28,2,18,34
50,Success,61,28,3,8,53
50,Fail,53,33,0,12,41
50,Fail,41,33,10,16,25
50,Fail,51,35,0,11,40
50,Fail,42,29,0,15,27
50,Fail,52,29,0,13,39
50,Fail,49,34,0,16,33
50,Fail,46,32,0,18,28
50,Fail,42,40,0,13,29
50,Fail,50,39,3,8,42
50,Fail,52,33,3,12,40
50,Fail,46,39,0,7,39
50,Fail,45,35,0,12,33
50,Fail,54,36,1,9,45
50,Fail,48,35,7,10,38
50,Fail,50,32,4,14,36
50,Fail,48,36,1,15,33
50,Fail,46,32,10,12,34
50,Fail,51,36,2,11,40
50,Fail,54,32,0,12,42
50,Fail,43,36,5,16,27
50,Fail,46,35,0,16,30
50,Fail,53,28,10,9,44
50,Fail,46,38,5,11,35
50,Fail,44,31,0,14,30
50,Fail,47,35,1,17,30
50,Fail,48,38,0,10,38
50,Fail,51,33,2,14,37
50,Fail,52,32,4,12,40
50,Fail,51,27,0,10,41
50,Fail,45,36,0,13,32
50,Fail,44,35,0,10,34
50,Fail,44,40,8,8,36
50,Fail,50,32,0,17,33
50,Fail,49,43,0,6,43
50,Success,60,32,0,7,53
50,Fail,43,41,0,7,36
50,Fail,47,40,0,6,41
50,Fail,51,29,4,16,35
50,Fail,49,38,0,10,39
50,Fail,47,39,0,13,34
50,Fail,52,38,2,8,44
50,Fail,44,37,7,12,32
50,Fail,43,37,0,15,28
50,Fail,44,34,6,16,28
50,Fail,49,36,4,11,38
50,Fail,52,35,1,12,40
50,Fail,48,38,2,12,36
50,Fail,50,30,6,14,36
50,Fail,42,45,0,8,34
50,Fail,49,36,0,13,36
50,Fail,42,37,10,11,31
50,Fail,42,45,0,13,29
50,Fail,45,34,0,18,27
50,Fail,48,34,6,12,36
50,Fail,47,27,0,12,35
50,Fail,43,42,5,10,33
50,Fail,38,42,0,14,24
50,Fail,42,35,5,18,24
50,Fail,40,40,10,10,30
50,Fail,50,34,0,10,40
50,Fail,55,32,4,9,46
50,Fail,49,37,1,13,36
50,Fail,49,38,2,11,38
50,Fail,51,37,1,11,40
50,Fail,55,28,0,16,39
50,Fail,50,37,1,12,38
50,Fail,47,45,0,5,42
50,Fail,50,30,0,17,33
50,Fail,42,32,10,16,26
50,Fail,52,29,8,11,41
50,Success,56,36,3,5,51
50,Fail,45,34,4,17,28
50,Fail,56,31,0,10,46
50,Fail,48,39,0,13,35
50,Fail,45,40,0,11,34
50,Fail,53,36,1,10,43
50,Fail,48,34,0,17,31
50,Fail,48,36,0,11,37
50,Fail,51,33,0,11,40
50,Fail,49,34,2,15,34
50,Fail,49,32,6,13,36
50,Fail,47,41,0,10,37
50,Fail,49,34,6,11,38
50,Fail,48,31,0,16,32
50,Fail,56,28,7,9,47
50,Fail,53,38,1,8,45
50,Fail,55,31,0,9,46
50,Fail,53,36,0,8,45
50,Fail,51,35,3,11,40
50,Fail,46,36,2,16,30
50,Fail,51,33,6,10,41
50,Fail,47,31,0,17,30
50,Fail,51,32,0,13,38
50,Fail,55,34,0,11,44
50,Fail,43,40,0,15,28
50,Fail,41,35,0,10,31
50,Fail,39,38,7,16,23
50,Fail,50,36,1,13,37
50,Fail,54,32,0,9,45
50,Fail,47,38,3,12,35
50,Fail,49,32,2,17,32
50,Fail,44,38,0,15,29
50,Fail,48,39,0,9,39
50,Fail,53,34,0,11,42
50,Fail,46,38,0,14,32
50,Fail,52,28,0,12,40
50,Fail,41,46,0,11,30
50,Fail,52,39,1,8,44
50,Fail,44,37,6,13,31
50,Fail,48,36,0,15,33
50,Fail,43,38,0,16,27
50,Fail,40,40,5,15,25
50,Fail,54,36,0,8,46
50,Fail,52,32,1,15,37
50,Fail,53,37,2,8,45
50,Fail,51,30,1,18,33
50,Fail,49,37,3,11,38
50,Fail,44,41,3,12,32
50,Fail,42,31,0,16,26
50,Fail,38,40,0,15,23
50,Fail,52,33,0,14,38
50,Fail,42,33,11,14,28
50,Fail,43,37,5,15,28
50,Fail,50,36,1,13,37
50,Fail,54,27,0,17,37
50,Fail,51,34,0,10,41
50,Fail,51,31,6,12,39
50,Fail,50,34,0,9,41
50,Fail,55,30,0,15,40
50,Fail,49,29,0,17,32
50,Fail,57,31,0,11,46
50,Fail,40,47,3,10,30
50,Fail,45,37,2,16,29
50,Fail,57,31,0,11,46
50,Fail,44,34,0,14,30
50,Fail,47,40,3,10,37
50,Fail,50,36,0,9,41
50,Fail,43,39,0,11,32
50,Fail,45,34,0,11,34
50,Success,59,31,1,9,50
50,Fail,49,32,0,18,31
50,Fail,40,40,7,13,27
50,Fail,53,31,0,15,38
50,Fail,48,37,0,14,34
50,Fail,59,24,6,11,48
50,Fail,48,32,0,12,36
50,Fail,50,32,8,10,40
50,Fail,47,28,0,20,27
50,Fail,45,33,9,13,32
50,Fail,46,34,0,13,33
50,Fail,51,39,0,7,44
50,Fail,52,32,2,14,38
50,Fail,52,36,0,10,42
50,Fail,42,35,0,21,21
50,Fail,47,36,5,12,35
50,Fail,48,34,9,9,39
50,Fail,47,31,7,15,32
50,Fail,52,31,2,15,37
50,Fail,52,29,9,10,42
50,Fail,46,27,0,20,26
50,Fail,44,36,5,15,29
50,Fail,48,38,0,14,34
50,Fail,47,36,0,15,32
50,Fail,45,32,7,16,29
50,Fail,46,38,6,10,36
50,Fail,53,33,0,12,41
50,Fail,48,35,0,15,33
50,Fail,49,39,0,10,39
50,Fail,54,32,0,6,48
50,Fail,42,37,11,10,32
50,Fail,49,31,0,15,34
50,Fail,42,36,9,13,29
50,Fail,38,42,8,12,26
50,Fail,45,36,8,11,34
50,Fail,51,33,0,15,36
50,Fail,54,39,0,7,47
50,Fail,51,33,0,13,38
50,Fail,46,43,0,11,35
50,Fail,43,43,6,8,35
50,Fail,44,39,0,17,27
50,Fail,44,33,16,7,37
50,Fail,59,28,0,12,47
50,Fail,41,44,0,10,31
50,Fail,54,32,0,14,40
50,Fail,47,33,0,12,35
50,Fail,51,33,0,14,37
50,Fail,51,40,1,8,43
50,Fail,43,32,0,17,26
50,Fail,55,32,4,9,46
50,Fail,49,40,5,6,43
50,Fail,55,30,4,11,44
50,Fail,48,27,12,13,35
50,Fail,39,42,4,15,24
50,Fail,50,32,0,15,35
50,Fail,50,32,0,11,39
50,Fail,47,36,0,17,30
50,Fail,50,34,2,14,36
50,Fail,44,40,0,14,30
50,Fail,49,37,8,6,43
50,Fail,48,37,0,14,34
50,Fail,55,26,6,13,42
50,Fail,42,34,8,16,26
50,Fail,52,32,0,14,38
50,Fail,42,38,7,13,29
50,Fail,38,43,0,14,24
50,Fail,43,30,10,17,26
50,Fail,52,38,0,8,44
50,Fail,45,34,0,14,31
50,Success,60,32,0,7,53
50,Fail,52,35,0,8,44
50,Fail,45,35,2,18,27
50,Fail,40,37,15,8,32
50,Fail,42,39,7,12,30
50,Fail,42,39,0,10,32
50,Fail,44,43,0,11,33
50,Fail,53,32,0,14,39
50,Fail,45,34,0,20,25
50,Fail,44,37,0,14,30
50,Fail,49,34,0,11,38
50,Fail,52,32,0,11,41
50,Fail,50,33,0,15,35
50,Fail,42,46,1,11,31
50,Fail,42,40,0,10,32
50,Fail,45,42,1,12,33
50,Success,57,33,0,7,50
50,Fail,47,42,7,4,43
50,Fail,52,33,4,11,41
50,Fail,48,31,7,14,34
50,Fail,44,37,2,17,27
50,Fail,52,33,7,8,44
50,Fail,42,33,11,14,28
50,Fail,53,31,0,12,41
50,Fail,48,39,0,13,35
50,Fail,46,36,4,14,32
50,Fail,44,37,3,16,28
50,Fail,57,31,1,11,46
50,Fail,45,38,0,12,33
50,Fail,45,36,6,13,32
50,Fail,47,37,0,10,37
50,Fail,51,33,0,15,36
50,Fail,55,31,0,10,45
50,Fail,55,32,0,12,43
50,Fail,49,37,1,13,36
50,Fail,44,41,5,10,34
50,Fail,38,41,0,14,24
50,Fail,41,41,0,18,23
50,Fail,51,31,4,14,37
50,Fail,53,36,3,8,45
50,Fail,44,36,0,18,26
50,Fail,55,31,0,12,43
50,Fail,48,43,1,8,40
50,Fail,45,41,0,13,32
50,Fail,51,35,0,13,38
50,Fail,45,33,0,16,29
50,Fail,41,35,0,16,25
50,Fail,55,36,2,7,48
50,Fail,45,41,0,10,35
50,Fail,45,36,0,15,30
50,Fail,58,33,0,9,49
50,Fail,47,30,1,22,25
50,Fail,54,32,4,10,44
50,Fail,48,35,6,11,37
50,Fail,42,44,2,12,30
50,Fail,49,33,0,14,35
50,Fail,43,41,6,10,33
50,Fail,49,43,0,7,42
50,Fail,50,33,1,16,34
50,Fail,44,30,11,15,29
50,Fail,41,39,0,16,25
50,Fail,53,29,6,12,41
50,Fail,50,38,8,4,46
50,Fail,50,33,0,16,34
50,Fail,46,40,0,14,32
50,Fail,44,36,7,13,31
50,Fail,37,38,5,20,17
50,Fail,51,29,2,18,33
50,Fail,47,41,0,9,38
50,Fail,51,42,0,7,44
50,Fail,45,36,9,10,35
50,Fail,42,37,0,18,24
50,Fail,44,32,0,17,27
50,Fail,55,36,1,8,47
50,Fail,51,38,4,7,44
50,Fail,44,38,0,15,29
50,Fail,49,36,0,12,37
50,Fail,47,34,0,13,34
50,Fail,49,38,0,13,36
50,Fail,44,35,7,14,30
50,Fail,51,37,0,12,39
50,Fail,42,43,0,12,30
50,Fail,51,35,1,13,38
50,Fail,42,39,0,10,32
50,Fail,44,34,8,14,30
50,Fail,34,42,3,21,13
50,Fail,47,39,2,12,35
50,Fail,49,36,9,6,43
50,Fail,45,29,0,13,32
50,Fail,54,33,0,12,42
50,Fail,52,34,8,6,46
50,Fail,46,40,1,13,33
50,Fail,52,30,0,12,40
50,Fail,53,37,0,7,46
50,Fail,47,36,0,13,34
50,Fail,50,34,2,14,36
50,Fail,55,37,0,7,48
50,Fail,48,37,4,11,37
50,Fail,52,33,0,13,39
50,Fail,45,40,5,10,35
50,Fail,46,37,0,11,35
50,Fail,48,35,0,11,37
50,Fail,49,36,3,12,37
50,Fail,45,41,0,14,31
50,Fail,47,33,0,10,37
50,Fail,43,35,7,15,28
50,Fail,49,32,0,19,30
50,Fail,42,31,0,20,22
50,Fail,48,36,2,14,34
50,Fail,47,41,1,11,36
50,Fail,48,35,0,11,37
50,Fail,47,28,0,22,25
50,Fail,53,33,5,9,44
50,Fail,46,34,0,11,35
50,Fail,48,34,9,9,39
50,Fail,51,31,3,15,36
50,Fail,55,27,0,14,41
50,Fail,50,38,1,11,39
50,Fail,49,40,0,10,39
50,Fail,41,36,9,14,27
50,Fail,42,32,3,23,19
50,Fail,46,38,6,10,36
50,Fail,55,24,7,14,41
50,Fail,44,45,0,11,33
50,Fail,43,35,6,16,27
50,Fail,51,33,3,13,38
50,Fail,52,32,0,16,36
50,Fail,52,30,8,10,42
50,Fail,49,31,0,17,32
50,Fail,50,36,0,12,38
50,Fail,43,40,5,12,31
50,Fail,48,31,8,13,35
50,Fail,54,36,0,10,44
50,Fail,57,32,0,9,48
50,Fail,44,37,4,15,29
50,Fail,53,35,1,11,42
50,Fail,45,38,7,10,35
50,Fail,44,36,0,15,29
50,Fail,52,40,2,6,46
50,Fail,42,43,2,13,29
50,Fail,48,40,3,9,39
50,Fail,50,35,0,11,39
50,Fail,57,27,1,15,42
50,Fail,42,30,0,24,18
50,Fail,51,37,3,9,42
50,Fail,46,43,0,11,35
50,Fail,50,34,0,8,42
50,Fail,45,33,0,19,26
50,Fail,44,39,1,16,28
50,Fail,40,37,5,18,22
50,Fail,49,35,0,12,37
50,Fail,45,35,5,15,30
50,Fail,46,34,0,15,31
50,Fail,53,32,4,11,42
50,Fail,48,37,0,14,34
50,Fail,47,36,0,15,32
50,Fail,42,40,0,13,29
50,Fail,41,34,0,17,24
50,Fail,53,39,0,7,46
50,Fail,48,43,0,7,41
50,Fail,46,38,0,10,36
50,Fail,43,41,0,7,36
50,Fail,45,44,2,9,36
50,Fail,49,38,0,11,38
50,Fail,47,38,0,12,35
50,Fail,46,36,0,16,30
50,Fail,44,39,6,11,33
50,Fail,48,31,0,18,30
50,Fail,36,34,14,16,20
50,Fail,44,37,0,10,34
50,Fail,41,40,0,14,27
50,Fail,44,40,0,12,32
50,Fail,49,32,0,13,36
50,Fail,49,35,1,15,34
50,Fail,54,31,0,14,40
50,Fail,59,30,1,10,49
50,Fail,55,33,3,9,46
50,Fail,54,37,1,8,46
50,Fail,57,32,2,9,48
50,Fail,48,39,0,8,40
50,Fail,47,39,3,11,36
50,Fail,47,42,0,9,38
50,Fail,53,36,0,8,45
50,Fail,49,33,0,15,34
50,Fail,45,41,0,11,34
50,Fail,57,30,0,9,48
50,Fail,51,37,1,11,40
50,Fail,46,37,0,13,33
50,Fail,37,43,0,16,21
50,Fail,45,40,3,12,33
50,Fail,46,32,6,16,30
50,Fail,49,35,0,12,37
50,Fail,43,38,0,13,30
50,Fail,41,36,3,20,21
50,Fail,52,33,0,10,42
50,Fail,50,33,1,16,34
50,Success,58,31,0,8,50
50,Fail,48,37,0,11,37
50,Fail,45,32,10,13,32
50,Fail,39,38,0,15,24
50,Fail,50,36,0,11,39
50,Fail,49,31,0,18,31
50,Fail,53,31,3,13,40
50,Fail,43,40,3,14,29
50,Fail,47,32,8,13,34
50,Fail,51,31,0,9,42
50,Fail,51,44,0,5,46
50,Fail,49,40,1,10,39
50,Fail,44,35,0,15,29
50,Fail,57,30,4,9,48
50,Fail,43,32,8,17,26
50,Fail,52,33,6,9,43
50,Fail,47,36,5,12,35
50,Fail,54,32,5,9,45
50,Fail,55,31,0,8,47
50,Fail,47,42,0,10,37
50,Fail,50,40,2,8,42
50,Fail,44,43,0,10,34
50,Fail,49,36,0,11,38
50,Fail,52,34,2,12,40
50,Fail,41,35,10,14,27
50,Fail,45,40,0,14,31
50,Fail,56,31,2,11,45
50,Fail,47,33,0,13,34
50,Fail,43,45,0,9,34
50,Fail,46,37,6,11,35
50,Fail,53,32,0,13,40
50,Fail,41,38,0,15,26
50,Fail,42,38,0,14,28
50,Fail,42,40,3,15,27
50,Fail,49,34,5,12,37
50,Fail,47,42,0,8,39
50,Fail,56,31,5,8,48
50,Fail,45,31,0,18,27
50,Fail,43,39,0,16,27
50,Fail,51,33,0,16,35
50,Fail,55,31,0,14,41
50,Fail,53,38,0,9,44
50,Fail,41,40,0,13,28
50,Fail,53,31,0,14,39
50,Fail,47,34,0,15,32
50,Fail,46,38,0,14,32
50,Fail,44,32,6,18,26
50,Fail,41,40,0,19,22
50,Fail,34,31,15,20,14
50,Fail,43,35,0,10,33
50,Fail,47,38,5,10,37
50,Fail,40,35,6,19,21
50,Fail,45,38,5,12,33
50,Fail,50,33,3,14,36
50,Fail,46,34,0,14,32
50,Fail,47,29,12,12,35
50,Fail,44,34,0,11,33
50,Fail,44,43,0,11,33
50,Fail,47,36,0,11,36
50,Fail,49,34,0,17,32
50,Fail,46,42,0,11,35
50,Fail,47,31,0,14,33
50,Fail,46,27,10,17,29
50,Fail,44,39,3,14,30
50,Fail,49,26,5,20,29
50,Fail,40,43,0,14,26
50,Fail,46,32,0,19,27
50,Fail,49,29,0,19,30
50,Fail,40,40,5,15,25
50,Fail,49,39,0,12,37
50,Fail,48,35,1,16,32
50,Fail,49,37,2,12,37
50,Fail,45,32,0,11,34
50,Fail,51,36,1,12,39
50,Fail,45,33,0,13,32
50,Fail,42,34,5,19,23
50,Fail,56,32,0,8,48
50,Fail,51,27,6,16,35
50,Fail,52,34,0,13,39
50,Fail,44,35,8,13,31
50,Fail,46,35,4,15,31
50,Fail,46,30,0,14,32
50,Fail,47,33,0,12,35
50,Fail,52,38,5,5,47
50,Fail,39,35,0,14,25
50,Fail,49,37,0,10,39
50,Fail,41,40,0,18,23
50,Fail,41,45,1,13,28
50,Fail,50,32,2,16,34
50,Fail,47,44,0,9,38
50,Fail,49,30,7,14,35
50,Fail,41,42,3,14,27
50,Fail,59,27,2,12,47
50,Success,58,31,0,4,54
50,Fail,45,36,1,18,27
50,Fail,48,37,3,12,36
50,Fail,54,32,6,8,46
50,Fail,47,23,0,14,33
50,Fail,46,33,0,15,31
50,Fail,52,40,0,8,44
50,Fail,49,35,6,10,39
50,Fail,42,33,0,19,23
50,Fail,43,34,0,16,27
50,Fail,41,41,0,10,31
50,Fail,46,36,7,11,35
50,Fail,50,33,0,11,39
50,Fail,50,37,0,13,37
50,Fail,51,31,0,11,40
50,Fail,43,40,0,13,30
50,Fail,50,36,3,11,39
50,Fail,55,31,3,11,44
50,Fail,53,37,0,10,43
50,Fail,45,41,0,14,31
50,Fail,46,42,0,9,37
50,Fail,47,38,0,10,37
50,Fail,44,38,0,14,30
50,Fail,50,32,0,16,34
50,Fail,43,27,15,15,28
50,Fail,47,38,0,10,37
50,Fail,41,40,10,9,32
50,Fail,54,33,0,9,45
50,Fail,45,39,0,11,34
50,Fail,46,37,0,12,34
50,Fail,49,29,0,12,37
50,Fail,47,40,0,13,34
50,Fail,58,26,0,12,46
50,Fail,48,36,0,8,40
50,Fail,43,36,0,17,26
50,Fail,45,33,0,20,25
50,Fail,41,47,1,11,30
50,Fail,41,36,11,12,29
50,Fail,45,41,0,11,34
50,Fail,47,33,8,12,35
50,Fail,54,32,0,12,42
50,Fail,42,38,1,19,23
50,Fail,44,33,0,17,27
50,Fail,52,36,6,6,46
50,Fail,57,29,0,13,44
50,Fail,49,32,0,16,33
50,Fail,44,37,0,13,31
50,Fail,58,27,0,14,44
50,Fail,50,36,7,7,43
50,Fail,51,35,0,9,42
50,Fail,55,25,8,12,43
50,Fail,52,33,3,12,40
50,Fail,48,38,0,11,37
50,Fail,53,35,0,12,41
50,Fail,45,41,0,14,31
50,Fail,56,34,3,7,49
50,Fail,41,44,0,12,29
50,Fail,57,31,2,10,47
50,Fail,51,29,5,15,36
50,Fail,46,35,0,13,33
50,Fail,46,40,0,11,35
50,Fail,45,40,3,12,33
50,Fail,42,42,2,14,28
50,Fail,46,39,0,12,34
50,Fail,43,37,7,13,30
50,Fail,46,39,0,13,33
50,Fail,47,42,0,10,37
50,Fail,46,39,2,13,33
50,Fail,45,36,6,13,32
50,Fail,43,43,0,11,32
50,Fail,45,37,6,12,33
50,Fail,49,40,5,6,43
50,Fail,45,34,7,14,31
50,Fail,45,38,2,15,30
50,Fail,55,33,0,10,45
50,Fail,51,29,0,13,38
50,Fail,50,30,7,13,37
50,Fail,49,33,0,15,34
50,Fail,47,36,0,16,31
50,Fail,54,32,4,10,44
50,Fail,52,31,2,15,37
50,Fail,54,29,5,12,42
50,Fail,39,42,9,10,29
50,Fail,54,28,0,13,41
50,Fail,46,39,2,13,33
50,Fail,53,32,0,12,41
50,Fail,47,33,4,16,31
50,Fail,51,38,0,10,41
50,Fail,51,37,1,11,40
50,Fail,53,31,0,13,40
50,Fail,47,39,0,9,38
50,Fail,53,35,0,10,43
50,Fail,43,36,8,13,30
50,Fail,41,40,0,16,25
50,Fail,44,37,3,16,28
50,Success,60,32,0,8,52
50,Fail,48,37,4,11,37
50,Fail,46,38,1,15,31
50,Fail,49,38,0,9,40
50,Fail,40,37,6,17,23
50,Fail,47,41,1,11,36
50,Fail,43,41,0,14,29
50,Fail,47,33,7,13,34
50,Fail,43,33,8,16,27
50,Fail,38,37,0,13,25
50,Fail,42,40,3,15,27
50,Fail,53,34,0,10,43
50,Fail,47,40,2,11,36
50,Fail,53,28,0,18,35
50,Fail,38,51,0,7,31
50,Fail,48,36,0,12,36
50,Fail,50,40,1,9,41
50,Fail,58,31,1,10,48
50,Fail,51,32,1,16,35
50,Fail,49,31,0,16,33
50,Fail,44,34,6,16,28
50,Fail,45,34,10,11,34
50,Fail,49,37,0,12,37
50,Fail,48,33,3,16,32
50,Fail,42,40,3,15,27
50,Fail,51,33,5,11,40
50,Fail,36,42,9,13,23
50,Fail,48,45,3,4,44
50,Fail,53,34,0,10,43
50,Fail,47,36,0,13,34
50,Fail,41,45,0,14,27
50,Fail,51,30,1,18,33
50,Fail,53,28,5,14,39
50,Fail,56,28,0,12,44
50,Fail,54,27,0,10,44
50,Fail,44,33,11,12,32
50,Fail,44,37,0,14,30
50,Fail,44,33,9,14,30
50,Fail,50,38,0,11,39
50,Fail,48,36,0,14,34
50,Fail,51,36,2,11,40
50,Fail,50,40,1,9,41
50,Fail,44,41,2,13,31
50,Fail,52,33,0,13,39
50,Fail,47,37,3,13,34
50,Fail,50,36,2,12,38
50,Fail,46,37,0,13,33
50,Fail,31,36,13,20,11
50,Fail,51,37,0,12,39
50,Fail,33,40,0,20,13
50,Fail,55,30,0,9,46
50,Fail,55,31,0,9,46
50,Fail,54,38,3,5,49
50,Fail,43,39,0,12,31
50,Fail,50,33,1,16,34
50,Fail,43,33,10,14,29
50,Fail,44,34,0,16,28
50,Fail,49,38,3,10,39
50,Fail,52,29,6,13,39
50,Fail,42,37,2,19,23
50,Fail,42,40,9,9,33
50,Fail,49,39,3,9,40
50,Fail,47,34,0,7,40
50,Fail,41,46,0,13,28
50,Fail,45,34,5,16,29
50,Fail,55,28,0,17,38
50,Fail,49,37,0,11,38
50,Fail,48,36,6,10,38
50,Fail,46,37,0,15,31
50,Fail,43,42,0,10,33
50,Fail,44,39,0,13,31
50,Fail,45,35,1,19,26
50,Fail,52,33,1,14,38
50,Fail,51,34,0,12,39
50,Fail,44,36,0,14,30
50,Fail,47,35,6,12,35
50,Fail,47,43,0,9,38
50,Fail,44,40,0,8,36
50,Fail,57,30,3,10,47
50,Fail,55,29,0,13,42
50,Fail,46,41,4,9,37
50,Fail,54,32,1,13,41
50,Fail,39,42,1,18,21
50,Fail,47,37,0,16,31
50,Fail,53,35,1,11,42
50,Fail,52,33,4,11,41
50,Fail,49,41,0,10,39
50,Fail,48,33,0,18,30
50,Fail,58,30,1,11,47
50,Fail,52,32,0,12,40
50,Fail,47,37,0,11,36
50,Fail,51,31,0,11,40
50,Fail,51,32,4,13,38
50,Fail,40,42,0,13,27
50,Fail,50,33,0,11,39
50,Fail,54,34,4,8,46
50,Fail,48,36,2,14,34
50,Fail,38,44,0,12,26
50,Fail,40,44,3,13,27
50,Fail,48,34,0,12,36
50,Fail,44,43,0,11,33
50,Fail,47,43,0,9,38
50,Fail,45,36,0,13,32
50,Fail,50,36,0,9,41
50,Fail,47,33,3,17,30
50,Fail,54,27,2,17,37
50,Fail,54,36,0,7,47
50,Fail,42,30,6,22,20
50,Fail,45,36,5,14,31
50,Fail,40,41,6,13,27
50,Fail,41,34,10,15,26
50,Fail,42,32,0,17,25
50,Fail,48,36,3,13,35
50,Fail,47,35,0,9,38
50,Fail,52,38,0,7,45
50,Fail,56,32,0,11,45
50,Fail,42,37,2,19,23
50,Fail,50,40,0,9,41
50,Fail,44,39,1,16,28
50,Fail,58,25,8,9,49
50,Fail,53,31,5,11,42
50,Fail,41,31,6,22,19
50,Fail,47,40,0,13,34
50,Fail,53,30,0,14,39
50,Success,62,29,0,9,53
50,Fail,42,38,0,13,29
50,Fail,51,28,0,17,34
50,Fail,50,38,1,11,39
50,Fail,49,37,0,12,37
50,Fail,49,37,0,11,38
50,Fail,52,35,0,10,42
50,Fail,51,33,0,16,35
50,Fail,61,25,0,14,47
50,Fail,53,30,0,13,40
50,Fail,47,37,5,11,36
50,Success,58,33,0,8,50
50,Fail,53,33,2,12,41
50,Fail,46,35,0,14,32
50,Fail,38,44,0,13,25
50,Fail,46,37,4,13,33
50,Fail,49,29,0,15,34
50,Fail,44,39,0,13,31
50,Fail,47,30,0,16,31
50,Fail,43,37,8,12,31
50,Fail,48,32,8,12,36
50,Fail,50,35,0,9,41
50,Fail,55,34,3,8,47
50,Fail,50,26,5,19,31
50,Fail,53,29,7,11,42
50,Fail,48,31,0,19,29
50,Fail,41,39,6,14,27
50,Fail,39,33,0,14,25
50,Fail,50,27,0,11,39
50,Fail,52,31,0,15,37
50,Fail,46,40,0,13,33
50,Fail,44,42,3,11,33
50,Fail,54,34,0,12,42
50,Fail,53,35,4,8,45
50,Fail,49,29,9,13,36
50,Fail,39,35,0,17,22
50,Fail,52,34,0,12,40
50,Fail,40,35,0,15,25
50,Fail,36,38,0,19,17
50,Fail,48,33,0,18,30
50,Fail,42,42,0,11,31
50,Fail,46,33,4,17,29
50,Fail,52,36,0,10,42
50,Fail,58,29,2,11,47
50,Fail,46,36,0,16,30
50,Fail,45,35,0,20,25
50,Fail,48,41,0,10,38
50,Fail,46,42,2,10,36
50,Fail,58,28,0,13,45
50,Fail,43,37,0,13,30
50,Fail,48,39,5,8,40
50,Fail,49,42,1,8,41
50,Fail,48,39,3,10,38
50,Fail,49,33,3,15,34
50,Fail,43,35,5,17,26
50,Fail,51,31,0,15,36
50,Fail,47,40,0,11,36
50,Fail,51,36,0,11,40
50,Fail,40,35,0,22,18
50,Fail,43,44,3,10,33
50,Fail,46,37,0,9,37
50,Fail,47,43,0,9,38
50,Fail,49,38,0,13,36
50,Fail,57,32,0,10,47
50,Fail,46,37,0,12,34
50,Fail,48,36,2,14,34
50,Fail,48,29,0,13,35
50,Fail,45,41,2,12,33
50,Fail,54,35,0,11,43
50,Fail,52,36,1,11,41
50,Fail,43,43,2,12,31
50,Fail,41,38,8,13,28
50,Fail,46,39,0,13,33
50,Fail,46,30,6,18,28
50,Fail,42,35,1,22,20
50,Fail,55,32,4,9,46
50,Fail,57,35,0,8,49
50,Fail,43,42,0,15,28
50,Fail,52,35,0,13,39
50,Fail,51,30,6,13,38
50,Fail,51,39,3,7,44
50,Fail,48,37,0,15,33
50,Fail,48,42,0,10,38
50,Fail,50,30,0,10,40
50,Fail,39,33,0,12,27
50,Fail,44,37,0,9,35
50,Fail,54,36,0,8,46
50,Fail,53,31,0,16,37
50,Fail,51,35,0,12,39
50,Fail,44,39,5,12,32
50,Fail,47,37,2,14,33
50,Fail,50,37,0,12,38
50,Fail,54,35,0,10,44
50,Fail,52,35,0,10,42
50,Fail,50,36,0,12,38
50,Fail,44,46,0,10,34
50,Fail,53,34,0,13,40
50,Success,60,31,2,7,53
50,Fail,45,42,7,6,39
50,Fail,55,32,0,11,44
50,Fail,53,34,0,13,40
50,Fail,43,38,0,14,29
50,Fail,44,30,11,15,29
50,Fail,46,35,4,15,31
50,Success,57,36,0,6,51
50,Fail,54,33,0,9,45
50,Fail,50,32,0,17,33
50,Fail,42,43,0,11,31
50,Fail,40,40,0,14,26
50,Fail,50,26,5,19,31
50,Fail,47,38,0,11,36
50,Fail,52,33,0,14,38
50,Fail,46,30,0,15,31
50,Fail,45,37,7,11,34
50,Fail,56,28,0,12,44
50,Fail,50,40,0,8,42
50,Fail,43,39,0,18,25
50,Fail,49,37,0,14,35
50,Fail,49,36,0,9,40
50,Fail,50,33,2,15,35
50,Fail,46,38,6,10,36
50,Fail,45,44,1,10,35
50,Fail,48,36,0,14,34
50,Fail,50,26,0,15,35
50,Fail,45,39,0,9,36
50,Fail,45,35,7,13,32
50,Fail,49,35,0,11,38
50,Fail,52,38,0,9,43
50,Fail,43,41,0,12,31
50,Fail,43,38,4,15,28
50,Fail,51,33,0,15,36
50,Fail,48,35,4,13,35
50,Fail,46,41,0,11,35
50,Fail,49,36,0,15,34
50,Fail,46,32,6,16,30
50,Fail,44,45,0,11,33
50,Fail,45,38,0,14,31
50,Fail,50,39,3,8,42
50,Fail,49,36,0,14,35
50,Fail,48,30,0,17,31
50,Fail,48,37,2,13,35
50,Fail,48,37,0,14,34
50,Fail,48,35,7,10,38
50,Fail,50,36,1,13,37
50,Fail,51,31,5,13,38
50,Fail,51,33,4,12,39
50,Fail,49,33,0,10,39
50,Fail,52,39,0,9,43
50,Fail,49,28,12,11,38
50,Fail,50,32,0,13,37
50,Fail,38,48,0,9,29
50,Fail,41,36,2,21,20
50,Fail,47,42,0,9,38
50,Fail,53,26,1,20,33
50,Fail,52,30,0,15,37
50,Fail,48,34,1,17,31
50,Fail,45,40,0,15,30
50,Fail,39,32,0,19,20
50,Fail,56,25,5,14,42
50,Fail,50,38,0,11,39
50,Fail,55,33,0,12,43
50,Fail,48,40,0,12,36
50,Success,55,38,2,5,50
50,Fail,44,41,5,10,34
50,Fail,46,37,0,9,37
50,Fail,53,31,0,13,40
50,Fail,47,38,1,14,33
50,Fail,45,41,1,13,32
50,Fail,46,36,3,15,31
50,Fail,47,42,0,9,38
50,Fail,49,36,5,10,39
50,Fail,46,44,2,8,38
50,Fail,43,34,0,18,25
50,Fail,43,31,0,16,27
50,Fail,51,37,4,8,43
50,Success,58,36,2,4,54
50,Fail,45,39,3,13,32
50,Fail,52,30,0,18,34
50,Fail,51,30,5,14,37
50,Fail,47,34,3,16,31
50,Fail,53,32,0,13,40
50,Fail,53,34,6,7,46
50,Fail,43,39,1,17,26
50,Fail,51,40,0,8,43
50,Fail,49,31,0,12,37
50,Fail,45,28,6,21,24
50,Fail,44,42,6,8,36
50,Fail,49,36,9,6,43
50,Fail,45,37,0,9,36
50,Fail,50,35,0,12,38
50,Fail,48,39,3,10,38
50,Fail,52,29,6,13,39
50,Fail,46,25,0,23,23
50,Fail,48,34,0,12,36
50,Fail,56,34,0,9,47
50,Fail,51,33,0,12,39
50,Fail,44,47,0,9,35
50,Fail,54,27,0,11,43
50,Fail,48,33,2,17,31
50,Fail,49,38,0,11,38
50,Fail,52,33,0,8,44
50,Fail,50,33,0,12,38
50,Fail,48,37,2,13,35
50,Fail,46,34,0,10,36
50,Fail,48,32,0,10,38
50,Fail,45,42,0,7,38
50,Fail,47,41,4,8,39
50,Fail,50,38,0,9,41
50,Fail,48,36,0,11,37
50,Fail,43,34,6,17,26
50,Fail,46,40,0,13,33
50,Fail,50,39,1,10,40
50,Fail,54,31,3,12,42
50,Fail,51,34,0,12,39
50,Fail,44,40,0,16,28
50,Fail,51,35,6,8,43
50,Fail,48,40,0,11,37
50,Fail,51,33,4,12,39
50,Fail,54,26,4,16,38
50,Fail,44,34,4,18,26
50,Fail,49,41,0,8,41
50,Fail,49,38,0,9,40
50,Fail,47,36,0,12,35
50,Fail,49,37,5,9,40
50,Fail,51,37,0,9,42
50,Fail,40,34,0,20,20
50,Fail,44,36,5,15,29
50,Fail,51,32,7,10,41
50,Fail,46,36,3,15,31
50,Fail,56,33,3,8,48
50,Fail,43,37,4,16,27
50,Fail,50,36,3,11,39
50,Fail,43,41,4,12,31
50,Fail,47,44,0,9,38
50,Fail,40,40,0,18,22
50,Fail,45,35,0,11,34
50,Fail,48,34,5,13,35
50,Fail,52,32,0,14,38
50,Fail,47,26,7,20,27
50,Fail,48,39,2,11,37
50,Fail,56,35,0,9,47
50,Fail,57,33,0,9,48
50,Fail,47,33,8,12,35
50,Fail,43,39,0,14,29
50,Fail,39,38,10,13,26
50,Fail,47,43,0,10,37
50,Fail,42,34,12,12,30
50,Fail,45,39,0,8,37
50,Fail,52,26,8,14,38
50,Fail,45,33,0,16,29
50,Fail,51,37,1,11,40
50,Fail,48,38,0,11,37
50,Fail,48,38,0,10,38
50,Fail,52,35,0,10,42
50,Fail,41,36,0,19,22
50,Fail,44,33,6,17,27
50,Success,59,33,0,8,51
50,Fail,41,43,1,15,26
50,Fail,45,36,0,16,29
50,Fail,50,31,2,17,33
50,Fail,45,39,0,13,32
50,Fail,49,34,4,13,36
50,Fail,52,31,0,15,37
50,Fail,40,37,0,21,19
50,Fail,52,26,8,14,38
50,Fail,54,38,0,8,46
50,Fail,51,39,1,9,42
50,Fail,49,35,0,8,41
50,Fail,48,36,0,13,35
50,Fail,46,43,0,11,35
50,Fail,50,35,0,11,39
50,Fail,48,32,0,17,31
50,Fail,42,41,0,9,33
50,Fail,49,42,2,7,42
50,Fail,57,29,5,9,48
50,Fail,43,43,1,13,30
50,Fail,46,39,0,12,34
50,Fail,47,37,0,10,37
50,Fail,51,36,2,11,40
50,Fail,49,36,0,15,34
50,Fail,41,38,0,16,25
50,Fail,53,26,7,14,39
50,Fail,47,44,0,8,39
50,Fail,45,34,0,15,30
50,Fail,47,38,5,10,37
50,Fail,52,35,0,12,40
50,Fail,56,36,0,7,49
50,Fail,51,35,2,12,39
50,Fail,49,35,0,14,35
50,Fail,53,34,0,10,43
50,Fail,48,35,1,16,32
50,Fail,50,30,4,16,34
50,Fail,49,42,2,7,42
50,Fail,41,37,0,18,23
50,Fail,50,39,0,11,39
50,Fail,51,35,0,13,38
50,Fail,55,32,1,12,43
50,Fail,52,35,0,11,41
50,Fail,45,41,2,12,33
50,Fail,47,39,0,10,37
50,Fail,54,31,0,6,48
50,Fail,53,36,0,11,42
50,Fail,52,28,8,12,40
50,Fail,50,31,4,15,35
50,Fail,44,39,0,16,28
50,Fail,50,30,0,13,37
50,Fail,47,37,4,12,35
50,Fail,45,46,2,7,38
50,Fail,50,38,0,12,38
50,Fail,47,31,12,10,37
50,Fail,56,27,0,14,42
50,Fail,45,41,0,12,33
50,Fail,46,40,2,12,34
50,Fail,55,30,6,9,46
50,Fail,47,41,0,11,36
50,Fail,51,36,3,10,41
50,Fail,42,40,0,15,27
50,Fail,50,35,1,14,36
50,Fail,47,39,0,14,33
50,Fail,49,38,0,10,39
50,Fail,51,36,5,8,43
50,Fail,50,38,0,9,41
50,Fail,50,35,1,14,36
50,Fail,39,44,0,12,27
50,Fail,53,34,0,11,42
50,Fail,41,40,0,15,26
50,Fail,53,30,3,14,39
50,Fail,48,35,0,16,32
50,Fail,50,38,4,8,42
50,Fail,55,28,3,14,41
50,Fail,50,38,0,8,42
50,Fail,49,32,0,15,34
50,Fail,45,33,0,20,25
50,Fail,41,40,0,18,23
50,Success,56,36,2,6,50
50,Fail,44,40,0,13,31
50,Fail,48,35,0,17,31
50,Fail,43,42,0,14,29
50,Fail,48,39,5,8,40
50,Fail,48,38,0,11,37
50,Fail,52,35,8,5,47
50,Fail,41,43,0,13,28
50,Fail,52,34,4,10,42
50,Fail,52,35,1,12,40
50,Fail,51,35,1,13,38
50,Fail,50,40,0,7,43
50,Fail,52,33,4,11,41
50,Fail,39,42,0,12,27
50,Fail,51,31,0,14,37
50,Fail,48,36,0,14,34
50,Fail,50,39,4,7,43
50,Fail,52,33,5,10,42
50,Fail,51,31,0,16,35
50,Fail,46,40,1,13,33
50,Fail,48,37,0,10,38
50,Fail,54,28,0,14,40
50,Fail,47,35,2,16,31
50,Fail,48,33,5,14,34
50,Fail,41,42,2,15,26
50,Fail,45,41,0,14,31
50,Fail,44,41,6,9,35
50,Fail,47,32,0,14,33
50,Fail,49,35,0,6,43
50,Fail,53,32,2,13,40
50,Fail,46,34,2,18,28
50,Fail,48,37,0,14,34
50,Fail,49,40,0,11,38
50,Fail,47,35,3,15,32
50,Fail,50,34,0,13,37
50,Fail,48,40,0,11,37
50,Fail,43,45,5,7,36
50,Fail,46,42,0,12,34
50,Fail,48,38,3,11,37
50,Fail,46,36,3,15,31
50,Fail,46,34,2,18,28
50,Fail,37,44,0,11,26
50,Fail,43,37,0,11,32
50,Fail,42,35,11,12,30
50,Fail,48,38,2,12,36
50,Fail,48,32,0,14,34
50,Fail,37,41,0,13,24
50,Fail,44,38,0,11,33
50,Fail,44,39,0,12,32
50,Fail,50,29,10,11,39
50,Fail,46,37,0,6,40
50,Fail,47,35,0,13,34
50,Fail,43,41,7,9,34
50,Fail,41,42,2,15,26
50,Fail,42,35,12,11,31
50,Fail,46,26,0,20,26
50,Fail,48,43,0,9,39
50,Fail,47,38,1,14,33
50,Fail,45,37,7,11,34
50,Fail,40,36,0,21,19
50,Fail,47,39,0,12,35
50,Fail,46,40,0,14,32
50,Fail,44,29,0,21,23
50,Fail,49,35,3,13,36
50,Fail,49,38,4,9,40
50,Fail,48,35,6,11,37
50,Fail,42,41,4,13,29
50,Fail,56,25,0,15,41
50,Fail,45,37,0,11,34
50,Fail,55,35,0,9,46
50,Fail,49,29,0,14,35
50,Fail,50,35,0,15,35
50,Fail,44,40,3,13,31
50,Fail,48,34,0,12,36
50,Fail,55,31,3,11,44
50,Fail,50,30,0,9,41
50,Fail,46,37,2,15,31
50,Fail,49,32,0,15,34
50,Fail,50,38,3,9,41
50,Fail,42,35,6,17,25
50,Fail,49,25,10,16,33
50,Fail,39,32,13,16,23
50,Fail,44,40,0,12,32
50,Fail,47,36,2,15,32
50,Fail,54,30,3,13,41
50,Fail,49,39,0,12,37
50,Fail,43,32,0,16,27
50,Fail,49,33,0,12,37
50,Fail,43,40,4,13,30
50,Fail,45,43,0,11,34
50,Fail,49,38,1,12,37
50,Fail,45,35,7,13,32
50,Fail,50,34,5,11,39
50,Fail,44,38,0,15,29
50,Fail,49,37,1,13,36
50,Fail,48,35,0,14,34
50,Fail,51,37,4,8,43
50,Fail,49,37,3,11,38
50,Fail,50,31,0,11,39
50,Fail,55,31,0,9,46
50,Fail,49,31,0,10,39
50,Fail,44,38,3,15,29
50,Fail,51,34,6,9,42
50,Fail,47,43,2,8,39
50,Fail,44,40,0,11,33
50,Fail,54,32,1,13,41
50,Fail,40,41,0,12,28
50,Fail,47,34,3,16,31
50,Fail,46,29,0,15,31
50,Fail,42,43,1,14,28
50,Fail,57,30,1,12,45
50,Fail,40,36,7,17,23
50,Fail,58,31,0,10,48
50,Fail,52,40,0,6,46
50,Fail,48,35,9,8,40
50,Fail,48,38,3,11,37
50,Fail,49,39,0,12,37
50,Fail,46,41,0,13,33
50,Fail,50,40,2,8,42
50,Fail,47,35,5,13,34
50,Fail,46,37,0,10,36
50,Fail,41,44,2,13,28
50,Fail,47,35,3,15,32
50,Fail,51,34,0,12,39
50,Fail,52,35,0,11,41
50,Fail,48,33,0,15,33
50,Fail,43,33,5,19,24
50,Fail,49,40,0,8,41
50,Fail,48,38,2,12,36
50,Fail,45,40,0,14,31
50,Fail,45,43,0,10,35
50,Fail,48,39,0,7,41
50,Fail,55,30,2,13,42
50,Fail,47,32,0,11,36
50,Fail,45,40,0,8,37
50,Fail,51,30,0,10,41
50,Fail,51,32,0,12,39
50,Fail,48,30,4,18,30
50,Fail,39,33,0,14,25
50,Fail,42,46,2,10,32
50,Fail,52,33,0,13,39
50,Fail,53,35,0,12,41
50,Fail,43,40,0,15,28
50,Fail,47,31,0,12,35
50,Fail,47,31,7,15,32
50,Fail,49,33,3,15,34
50,Fail,44,31,4,21,23
50,Fail,52,31,4,13,39
50,Fail,42,40,10,8,34
50,Fail,52,31,2,15,37
50,Fail,48,37,0,7,41
50,Fail,46,33,6,15,31
50,Fail,50,33,8,9,41
50,Fail,43,42,0,13,30
50,Fail,48,36,0,10,38
50,Fail,46,33,3,18,28
50,Fail,50,38,0,11,39
50,Fail,51,35,0,14,37
50,Fail,50,30,0,16,34
50,Fail,46,34,0,15,31
50,Fail,52,31,0,11,41
50,Fail,50,35,0,10,40
50,Fail,54,28,6,12,42
50,Fail,42,42,0,12,30
50,Fail,48,35,0,13,35
50,Fail,46,46,0,8,38
50,Fail,43,41,2,14,29
50,Fail,52,34,3,11,41
50,Fail,52,30,0,16,36
50,Fail,50,36,0,11,39
50,Fail,52,37,2,9,43
50,Fail,43,31,0,18,25
50,Fail,45,42,5,8,37
50,Fail,47,40,3,10,37
50,Fail,42,39,0,15,27
50,Fail,51,36,0,9,42
50,Fail,52,35,1,12,40
50,Fail,48,34,2,16,32
50,Fail,52,37,0,11,41
50,Fail,44,37,8,11,33
50,Fail,48,32,0,20,28
50,Fail,50,38,1,11,39
50,Fail,45,40,2,13,32
50,Fail,48,35,1,16,32
50,Fail,44,39,2,15,29
50,Fail,49,30,0,17,32
50,Fail,48,27,12,13,35
50,Fail,41,43,5,11,30
50,Fail,40,42,0,16,24
50,Fail,54,30,4,12,42
50,Fail,50,39,0,10,40
50,Fail,54,34,0,10,44
50,Fail,42,40,7,11,31
50,Fail,47,34,0,16,31
50,Fail,42,46,1,11,31
50,Fail,55,35,0,8,47
50,Fail,55,29,0,9,46
50,Fail,45,40,0,13,32
50,Fail,50,33,0,14,36
50,Fail,59,28,0,11,48
50,Fail,50,34,0,14,36
50,Fail,47,34,0,13,34
50,Fail,49,40,0,11,38
50,Fail,52,34,0,10,42
50,Fail,49,37,0,10,39
50,Fail,53,33,0,14,39
50,Fail,54,34,0,12,42
50,Fail,43,42,5,10,33
50,Fail,48,31,0,12,36
50,Fail,47,41,0,10,37
50,Fail,51,30,7,12,39
50,Fail,49,41,0,10,39
50,Fail,44,34,0,19,25
50,Fail,53,32,0,11,42
50,Fail,47,40,2,11,36
50,Fail,47,38,5,10,37
50,Fail,51,33,4,12,39
50,Fail,48,34,0,16,32
50,Fail,51,40,1,8,43
50,Fail,51,37,0,12,39
50,Fail,52,31,6,11,41
50,Fail,41,39,0,17,24
50,Fail,50,39,0,10,40
50,Fail,43,44,0,12,31
50,Fail,48,43,0,8,40
50,Fail,47,40,0,8,39
50,Fail,47,31,0,14,33
50,Fail,53,29,0,14,39
50,Success,58,33,3,6,52
50,Fail,49,40,0,10,39
50,Success,60,26,4,10,50
50,Fail,59,22,0,13,46
50,Fail,56,29,6,9,47
50,Fail,41,36,0,16,25
50,Fail,48,38,0,12,36
50,Fail,43,40,0,14,29
50,Fail,50,32,0,12,38
50,Fail,41,37,0,22,19
50,Fail,54,32,0,10,44
50,Fail,53,32,2,13,40
50,Fail,46,41,0,8,38
50,Fail,51,35,7,7,44
50,Fail,53,32,0,14,39
50,Fail,44,37,0,13,31
50,Fail,47,38,1,14,33
50,Fail,50,33,0,14,36
50,Fail,47,37,0,16,31
50,Fail,55,38,0,6,49
50,Fail,51,36,0,11,40
50,Fail,42,35,0,17,25
50,Fail,47,36,1,16,31
50,Fail,49,41,2,8,41
50,Fail,43,32,0,18,25
50,Fail,49,34,4,13,36
50,Fail,48,36,0,16,32
50,Fail,48,33,6,13,35
50,Fail,47,33,5,15,32
50,Fail,51,27,6,16,35
50,Fail,52,34,1,13,39
50,Fail,52,38,1,9,43
50,Fail,50,28,0,18,32
50,Fail,52,34,0,12,40
50,Fail,46,36,0,11,35
50,Fail,47,35,5,13,34
50,Fail,57,29,0,11,46
50,Fail,51,31,0,14,37
50,Fail,44,47,0,9,35
50,Fail,52,32,0,16,36
50,Fail,49,38,4,9,40
50,Fail,51,25,0,18,33
50,Fail,47,30,0,17,30
50,Fail,40,40,0,16,24
50,Fail,39,39,3,19,20
50,Fail,46,33,7,14,32
50,Fail,49,34,0,12,37
50,Fail,51,33,0,15,36
50,Fail,52,37,0,11,41
50,Fail,42,32,3,23,19
50,Fail,47,34,4,15,32
50,Fail,51,37,0,10,41
50,Fail,55,34,4,7,48
50,Fail,48,30,6,16,32
50,Fail,41,29,0,21,20
50,Fail,49,34,0,13,36
50,Fail,35,39,6,20,15
50,Fail,52,30,0,15,37
50,Fail,50,39,2,9,41
50,Fail,39,43,4,14,25
50,Fail,52,32,0,10,42
50,Fail,54,34,0,8,46
50,Fail,47,36,0,12,35
50,Fail,52,39,0,9,43
50,Fail,50,38,4,8,42
50,Fail,48,32,6,14,34
50,Fail,47,38,2,13,34
50,Fail,49,35,0,15,34
50,Fail,48,34,3,15,33
50,Fail,44,39,0,16,28
50,Fail,44,34,0,16,28
50,Fail,44,42,0,10,34
50,Fail,51,41,0,7,44
50,Fail,46,30,0,13,33
50,Fail,45,36,0,17,28
50,Fail,50,32,5,13,37
50,Fail,45,38,5,12,33
50,Fail,47,31,0,17,30
50,Fail,56,34,0,9,47
50,Fail,52,30,7,11,41
50,Fail,54,32,3,11,43
50,Fail,54,35,0,11,43
50,Fail,51,36,0,12,39
50,Fail,49,41,0,7,42
50,Fail,50,38,0,8,42
50,Fail,45,39,0,7,38
50,Fail,46,41,0,9,37
50,Fail,56,35,0,9,47
50,Fail,44,43,2,11,33
50,Fail,48,34,0,11,37
50,Fail,48,40,0,10,38
50,Fail,48,40,0,9,39
50,Fail,50,39,0,10,40
50,Fail,57,32,1,10,47
50,Fail,47,42,4,7,40
50,Fail,52,36,3,9,43
50,Success,59,31,1,9,50
50,Fail,54,30,0,15,39
50,Fail,52,35,0,13,39
50,Fail,47,37,9,7,40
50,Fail,51,34,3,12,39
50,Fail,51,32,0,15,36
50,Fail,53,37,1,9,44
50,Fail,42,39,0,13,29
50,Fail,49,40,1,10,39
50,Fail,45,34,3,18,27
50,Success,61,29,0,9,52
50,Fail,55,30,0,12,43
50,Fail,46,38,0,13,33
50,Fail,57,31,0,9,48
50,Fail,51,33,0,8,43
50,Fail,48,37,0,9,39
50,Fail,50,32,0,12,38
50,Fail,51,35,0,13,38
50,Fail,40,43,0,12,28
50,Fail,46,36,4,14,32
50,Fail,50,30,0,13,37
50,Fail,48,38,0,12,36
50,Fail,51,35,0,14,37
50,Fail,44,35,7,14,30
50,Fail,48,36,0,15,33
50,Fail,46,35,0,14,32
50,Fail,41,38,0,16,25
50,Fail,48,40,0,11,37
50,Fail,51,35,2,12,39
50,Fail,52,34,2,12,40
50,Fail,50,42,1,7,43
50,Fail,42,34,0,16,26
50,Fail,42,32,7,19,23
50,Fail,47,37,5,11,36
50,Success,56,39,0,2,54
50,Fail,47,37,0,13,34
50,Fail,55,34,3,8,47
50,Fail,42,42,0,13,29
50,Fail,49,34,3,14,35
50,Fail,48,37,0,11,37
50,Fail,52,35,4,9,43
50,Fail,52,33,1,14,38
50,Fail,56,36,0,7,49
50,Fail,47,31,2,20,27
50,Fail,47,31,2,20,27
50,Fail,43,39,3,15,28
50,Fail,49,33,4,14,35
50,Fail,49,29,0,15,34
50,Fail,48,42,0,8,40
50,Fail,46,35,0,14,32
50,Fail,50,37,2,11,39
50,Fail,42,39,0,17,25
50,Fail,50,34,0,11,39
50,Fail,47,39,0,9,38
50,Fail,43,36,5,16,27
50,Fail,48,40,0,11,37
50,Fail,46,33,0,19,27
50,Fail,55,32,0,12,43
50,Fail,52,31,0,9,43
50,Fail,55,30,0,15,40
50,Fail,48,34,0,18,30
50,Fail,47,28,0,17,30
50,Success,59,32,3,6,53
50,Fail,45,32,0,12,33
50,Fail,53,34,1,12,41
50,Fail,43,37,6,14,29
50,Fail,48,38,0,12,36
50,Fail,55,33,0,7,48
50,Fail,49,36,0,13,36
50,Fail,47,36,2,15,32
50,Fail,48,38,0,10,38
50,Fail,49,31,0,19,30
50,Fail,48,37,0,11,37
50,Fail,47,33,0,12,35
50,Fail,55,31,0,14,41
50,Fail,44,36,0,15,29
50,Fail,45,45,2,8,37
50,Fail,46,26,7,21,25
50,Fail,53,37,0,8,45
50,Fail,46,33,0,17,29
50,Fail,44,36,6,14,30
50,Fail,45,35,2,18,27
50,Fail,43,38,0,16,27
50,Fail,54,35,2,9,45
50,Fail,47,34,2,17,30
50,Fail,50,35,0,14,36
50,Fail,46,37,2,15,31
50,Fail,49,39,3,9,40
50,Fail,43,40,0,15,28
50,Fail,49,35,6,10,39
50,Fail,46,42,0,11,35
50,Fail,51,29,0,9,42
50,Fail,56,30,0,10,46
50,Fail,47,34,4,15,32
50,Fail,50,38,0,10,40
50,Fail,47,35,8,10,37
50,Fail,37,41,0,17,20
50,Fail,49,32,0,12,37
50,Fail,53,29,0,18,35
50,Fail,57,32,1,10,47
50,Fail,41,32,0,15,26
50,Fail,48,35,3,14,34
50,Fail,52,32,0,16,36
50,Success,58,36,0,5,53
50,Fail,48,38,0,9,39
50,Fail,47,27,0,18,29
50,Fail,43,38,0,16,27
50,Fail,41,38,0,19,22
50,Fail,43,37,1,19,24
50,Fail,45,34,6,15,30
50,Fail,50,34,0,7,43
50,Fail,44,43,0,10,34
50,Fail,50,36,0,12,38
50,Fail,39,40,9,12,27
50,Fail,51,33,2,14,37
50,Fail,57,23,5,15,42
50,Fail,53,35,2,10,43
50,Fail,44,38,0,14,30
50,Fail,55,30,0,9,46
50,Fail,47,32,0,9,38
50,Fail,55,32,0,11,44
50,Fail,45,42,0,11,34
50,Fail,50,37,0,7,43
50,Fail,41,46,3,10,31
50,Fail,49,29,0,12,37
50,Fail,44,35,0,11,33
50,Fail,51,36,0,12,39
50,Fail,51,31,3,15,36
50,Fail,47,32,6,15,32
50,Fail,43,40,7,10,33
50,Fail,45,33,0,13,32
50,Fail,51,34,2,13,38
50,Fail,48,41,3,8,40
50,Success,58,32,2,8,50
50,Fail,46,43,3,8,38
50,Fail,47,31,7,15,32
50,Fail,43,34,0,20,23
50,Fail,41,48,0,10,31
50,Fail,43,33,10,14,29
50,Fail,51,30,0,11,40
50,Fail,43,41,3,13,30
50,Fail,52,32,0,15,37
50,Fail,51,34,0,15,36
50,Fail,51,31,1,17,34
50,Fail,40,38,0,13,27
50,Fail,50,33,0,12,38
50,Fail,47,42,4,7,40
50,Fail,41,45,0,11,30
50,Fail,46,37,2,15,31
50,Fail,49,34,0,13,36
50,Fail,45,40,3,12,33
50,Fail,49,36,2,13,36
50,Fail,50,39,0,9,41
50,Fail,51,34,2,13,38
50,Fail,43,38,0,17,26
50,Fail,38,44,0,15,23
50,Fail,51,34,0,12,39
50,Fail,50,34,8,8,42
50,Fail,49,32,0,18,31
50,Fail,46,34,0,16,30
50,Fail,55,38,1,6,49
50,Fail,53,35,0,12,41
50,Fail,46,35,0,18,28
50,Fail,50,38,3,9,41
50,Fail,49,40,1,10,39
50,Fail,56,28,0,16,40
50,Fail,44,36,0,16,28
50,Fail,52,41,1,6,46
50,Fail,55,31,0,12,43
50,Fail,42,47,0,11,31
50,Fail,48,36,0,12,36
50,Fail,53,31,2,14,39
50,Fail,47,31,0,15,32
50,Fail,50,36,0,14,36
50,Fail,45,35,8,12,33
50,Fail,51,37,0,10,41
50,Fail,46,43,0,10,36
50,Fail,49,35,0,13,36
50,Fail,55,37,2,6,49
50,Fail,50,41,1,8,42
50,Fail,41,33,9,17,24
50,Fail,53,31,0,16,37
50,Fail,47,32,8,13,34
50,Fail,51,33,2,14,37
50,Success,59,35,0,5,54
50,Fail,47,36,0,12,35
50,Fail,48,31,4,17,31
50,Fail,47,42,0,9,38
50,Fail,47,37,0,8,39
50,Fail,53,35,0,9,44
50,Fail,52,37,0,10,42
50,Fail,50,34,0,15,35
50,Fail,35,49,0,15,20
50,Fail,49,39,0,9,40
50,Fail,45,49,0,6,39
50,Fail,52,30,0,17,35
50,Fail,45,37,0,15,30
50,Fail,45,32,0,15,30
50,Fail,39,39,0,13,26
50,Fail,57,32,2,9,48
50,Fail,40,37,10,13,27
50,Fail,47,38,0,13,34
50,Fail,46,39,2,13,33
50,Fail,45,33,8,14,31
50,Fail,47,39,0,13,34
50,Fail,47,34,0,14,33
50,Fail,51,33,0,12,39
50,Fail,51,33,0,9,42
50,Fail,46,36,0,12,34
50,Fail,46,40,0,10,36
50,Fail,48,37,5,10,38
50,Fail,50,33,0,11,39
50,Fail,49,29,0,15,34
50,Fail,49,34,0,10,39
50,Fail,42,34,0,14,28
50,Fail,53,30,0,13,40
50,Fail,51,39,1,9,42
50,Fail,48,38,0,13,35
50,Fail,46,29,12,13,33
50,Fail,44,42,0,14,30
50,Fail,48,35,6,11,37
50,Fail,35,40,10,15,20
50,Fail,41,45,3,11,30
50,Fail,52,34,3,11,41
50,Fail,47,35,3,15,32
50,Fail,52,25,0,20,32
50,Fail,51,35,0,13,38
50,Fail,44,42,0,13,31
50,Fail,57,29,0,11,46
50,Fail,48,42,0,10,38
50,Fail,50,36,2,12,38
50,Fail,50,33,3,14,36
50,Fail,48,37,4,11,37
50,Fail,46,40,0,6,40
50,Fail,54,33,1,12,42
50,Fail,49,35,0,14,35
50,Success,55,35,0,4,51
50,Fail,47,35,5,13,34
50,Fail,39,49,0,10,29
50,Fail,49,36,2,13,36
50,Fail,47,39,4,10,37
50,Fail,41,44,1,14,27
50,Fail,41,40,2,17,24
50,Fail,43,33,0,15,28
50,Fail,47,42,0,11,36
50,Fail,48,30,0,14,34
50,Fail,51,34,0,13,38
50,Fail,47,35,3,15,32
50,Fail,42,39,6,13,29
50,Fail,47,38,1,14,33
50,Fail,54,32,5,9,45
50,Fail,47,40,0,11,36
50,Fail,39,36,0,16,23
50,Fail,45,36,0,16,29
50,Fail,48,35,0,14,34
50,Fail,52,32,0,16,36
50,Fail,42,38,4,16,26
50,Fail,54,26,13,7,47
50,Fail,42,33,0,14,28
50,Fail,51,33,2,14,37
50,Fail,48,37,2,13,35
50,Fail,40,41,6,13,27
50,Fail,52,35,0,9,43
50,Fail,51,36,0,11,40
50,Fail,52,36,1,11,41
50,Fail,41,40,6,13,28
50,Fail,51,36,3,10,41
50,Fail,46,43,0,11,35
50,Fail,51,33,0,12,39
50,Fail,46,44,0,9,37
50,Fail,43,35,1,21,22
50,Fail,37,36,0,16,21
50,Fail,52,36,3,9,43
50,Fail,51,29,0,14,37
50,Fail,48,33,0,7,41
50,Fail,49,36,2,13,36
50,Fail,41,39,0,15,26
50,Fail,54,33,3,10,44
50,Fail,44,40,0,14,30
50,Fail,48,31,0,18,30
50,Fail,48,36,1,15,33
50,Fail,44,37,13,6,38
50,Fail,50,38,1,11,39
50,Fail,49,35,2,14,35
50,Fail,46,37,0,14,32
50,Fail,48,33,0,14,34
50,Fail,47,37,5,11,36
50,Fail,50,31,0,13,37
50,Fail,47,39,6,8,39
50,Fail,40,42,6,12,28
50,Fail,45,36,0,12,33
50,Fail,49,40,0,10,39
50,Fail,39,37,9,15,24
50,Fail,53,34,1,12,41
50,Fail,47,37,0,16,31
50,Fail,55,29,1,15,40
50,Fail,50,30,0,10,40
50,Fail,57,33,0,8,49
50,Fail,48,34,0,16,32
50,Fail,50,36,3,11,39
50,Fail,42,36,0,17,25
50,Fail,49,37,1,13,36
50,Fail,52,31,0,9,43
50,Fail,44,37,7,12,32
50,Fail,44,36,6,14,30
50,Fail,57,28,3,12,45
50,Fail,53,39,0,6,47
50,Fail,43,36,0,12,31
50,Fail,43,35,9,13,30
50,Fail,47,32,0,21,26
50,Fail,47,34,5,14,33
50,Fail,48,36,0,10,38
50,Fail,46,37,3,14,32
50,Fail,49,36,0,14,35
50,Fail,46,33,7,14,32
50,Fail,50,35,0,13,37
50,Fail,50,43,1,6,44
50,Fail,46,39,0,13,33
50,Fail,46,44,6,4,42
50,Fail,43,30,0,19,24
50,Fail,49,26,3,22,27
50,Fail,50,36,1,13,37
50,Fail,52,31,4,13,39
50,Fail,47,37,4,12,35
50,Fail,44,45,1,10,34
50,Fail,56,31,0,13,43
50,Fail,50,30,0,13,37
50,Fail,45,37,3,15,30
50,Fail,47,40,5,8,39
50,Fail,46,41,1,12,34
50,Fail,46,31,0,18,28
50,Fail,51,31,3,15,36
50,Fail,49,35,1,15,34
50,Fail,49,33,0,11,38
50,Fail,42,37,0,20,22
50,Fail,46,43,1,10,36
50,Fail,50,29,1,20,30
50,Fail,47,36,4,13,34
50,Fail,52,37,0,10,42
50,Fail,47,29,5,19,28
50,Fail,44,40,0,13,31
50,Fail,46,34,0,16,30
50,Fail,50,31,0,13,37
50,Fail,47,40,0,13,34
50,Fail,37,38,4,21,16
50,Fail,56,27,1,16,40
50,Fail,51,32,0,13,38
50,Fail,48,37,5,10,38
50,Fail,56,33,2,9,47
50,Fail,50,35,1,14,36
50,Fail,44,41,0,12,32
50,Fail,52,38,0,9,43
50,Fail,48,36,0,13,35
50,Fail,49,42,1,8,41
50,Fail,48,31,0,17,31
50,Fail,54,30,0,10,44
50,Fail,41,34,0,20,21
50,Fail,50,38,1,11,39
50,Fail,48,38,0,13,35
50,Fail,51,36,0,13,38
50,Fail,46,38,4,12,34
50,Fail,42,36,4,18,24
50,Fail,51,34,0,12,39
50,Fail,48,41,0,11,37
50,Fail,53,36,1,10,43
50,Fail,49,32,0,16,33
50,Fail,48,33,3,16,32
50,Fail,52,36,0,10,42
50,Fail,45,31,1,23,22
50,Fail,50,37,2,11,39
50,Fail,45,38,2,15,30
50,Fail,49,36,3,12,37
50,Fail,47,36,0,14,33
50,Fail,53,41,2,4,49
50,Fail,44,31,0,21,23
50,Fail,55,30,6,9,46
50,Fail,42,40,0,11,31
50,Fail,45,29,0,22,23
50,Fail,49,38,2,11,38
50,Fail,28,43,0,18,10
50,Fail,44,43,0,10,34
50,Fail,49,31,0,12,37
50,Fail,47,35,4,14,33
50,Fail,44,38,0,13,31
50,Fail,53,35,0,10,43
50,Fail,52,27,7,14,38
50,Fail,45,31,0,21,24
50,Fail,45,30,0,21,24
50,Fail,48,38,1,13,35
50,Fail,42,32,0,23,19
50,Fail,49,31,6,14,35
50,Fail,41,37,3,19,22
50,Fail,54,34,7,5,49
50,Fail,47,38,0,10,37
50,Fail,50,38,0,12,38
50,Fail,54,25,5,16,38
50,Fail,41,37,6,16,25
50,Fail,50,38,1,11,39
50,Fail,46,42,0,12,34
50,Fail,50,33,3,14,36
50,Fail,52,26,0,13,39
50,Fail,45,29,7,19,26
50,Fail,56,30,0,14,42
50,Fail,43,29,0,20,23
50,Fail,48,32,5,15,33
50,Fail,55,33,0,8,47
50,Fail,52,31,9,8,44
50,Fail,51,38,0,8,43
50,Fail,40,37,5,18,22
50,Fail,37,45,0,15,22
50,Fail,53,34,0,8,45
50,Fail,49,34,0,13,36
50,Fail,54,39,0,6,48
50,Fail,52,37,2,9,43
50,Fail,47,39,0,10,37
50,Fail,53,30,4,13,40
50,Fail,56,30,3,11,45
50,Fail,42,39,4,15,27
50,Fail,52,32,7,9,43
50,Fail,49,43,0,8,41
50,Fail,42,47,2,9,33
50,Fail,45,37,0,15,30
50,Fail,40,43,0,16,24
50,Fail,51,35,0,10,41
50,Fail,52,33,0,7,45
50,Fail,46,37,0,10,36
50,Fail,50,34,0,15,35
50,Fail,40,36,0,18,22
50,Fail,38,41,9,12,26
50,Fail,51,34,7,8,43
50,Success,55,36,4,5,50
50,Fail,46,45,1,8,38
50,Fail,49,32,3,16,33
50,Fail,48,39,0,13,35
50,Fail,48,36,3,13,35
50,Fail,51,34,0,12,39
50,Fail,45,38,0,12,33
50,Success,56,39,0,5,51
50,Fail,43,39,4,14,29
50,Fail,47,40,0,12,35
50,Fail,50,39,0,7,43
50,Fail,42,38,0,19,23
50,Fail,45,38,0,15,30
50,Fail,48,34,0,15,33
50,Fail,49,35,0,13,36
50,Fail,44,40,0,14,30
50,Fail,54,37,0,7,47
50,Fail,55,29,0,13,42
50,Fail,43,32,0,19,24
50,Fail,45,41,1,13,32
50,Fail,56,30,1,13,43
50,Fail,41,41,6,12,29
50,Fail,51,34,2,13,38
50,Fail,50,34,1,15,35
50,Fail,40,33,0,16,24
50,Fail,49,37,1,13,36
50,Fail,47,38,6,9,38
50,Fail,51,36,0,13,38
50,Fail,43,37,0,12,31
50,Fail,50,34,0,13,37
50,Fail,55,23,5,17,38
50,Fail,48,29,5,18,30
50,Fail,53,30,0,9,44
50,Fail,50,37,5,8,42
50,Fail,44,44,1,11,33
50,Fail,52,32,3,13,39
50,Fail,43,42,0,8,35
50,Fail,45,45,0,10,35
50,Fail,49,33,0,18,31
50,Fail,52,31,0,14,38
50,Fail,47,38,1,14,33
50,Fail,50,35,0,14,36
50,Fail,48,32,2,18,30
50,Fail,44,41,2,13,31
50,Fail,49,37,1,13,36
50,Fail,49,33,0,13,36
50,Fail,50,40,0,7,43
50,Fail,54,32,3,11,43
50,Fail,53,38,0,6,47
50,Fail,59,27,0,10,49
50,Fail,45,41,5,9,36
50,Success,59,33,0,8,51
50,Fail,57,32,0,10,47
50,Fail,47,38,3,12,35
50,Fail,40,42,3,15,25
50,Fail,47,29,10,14,33
50,Fail,53,31,5,11,42
50,Fail,51,37,0,12,39
50,Fail,52,34,0,9,43
50,Fail,44,40,0,5,39
50,Fail,47,32,0,17,30
50,Fail,51,38,2,9,42
50,Fail,46,36,4,14,32
50,Fail,47,30,7,16,31
50,Fail,41,40,0,13,28
50,Fail,48,42,0,8,40
50,Fail,36,41,0,8,28
50,Fail,47,40,0,12,35
50,Fail,49,38,0,12,37
50,Fail,47,36,0,11,36
50,Fail,49,32,0,14,35
50,Fail,43,34,0,15,28
50,Fail,51,39,0,10,41
50,Fail,53,27,4,16,37
50,Fail,50,34,0,9,41
50,Fail,47,33,0,20,27
50,Fail,48,39,0,10,38
50,Fail,46,33,0,12,34
50,Fail,49,35,0,15,34
50,Fail,53,29,0,12,41
50,Fail,55,34,0,9,46
50,Fail,46,37,2,15,31
50,Fail,50,35,6,9,41
50,Fail,53,30,0,15,38
50,Fail,47,32,3,18,29
50,Fail,50,41,0,9,41
50,Fail,47,34,0,15,32
50,Fail,52,32,0,13,39
50,Fail,44,38,0,9,35
50,Fail,49,35,0,16,33
50,Fail,46,34,7,13,33
50,Fail,48,38,0,14,34
50,Fail,42,41,2,15,27
50,Fail,40,37,0,12,28
50,Fail,43,40,0,14,29
50,Fail,45,36,3,16,29
50,Fail,55,31,0,12,43
50,Fail,42,39,2,17,25
50,Fail,47,34,0,10,37
50,Fail,54,34,4,8,46
50,Fail,37,37,0,21,16
50,Fail,50,33,5,12,38
50,Fail,45,39,5,11,34
50,Fail,52,31,0,9,43
50,Fail,39,42,4,15,24
50,Fail,49,38,0,13,36
50,Fail,48,36,0,11,37
50,Fail,41,35,9,15,26
50,Fail,47,39,0,9,38
50,Fail,47,34,0,16,31
50,Fail,40,36,5,19,21
50,Fail,42,36,0,10,32
50,Fail,46,43,0,9,37
50,Fail,42,36,6,16,26
50,Fail,53,31,7,9,44
50,Fail,56,29,0,13,43
50,Fail,41,38,0,12,29
50,Fail,55,24,0,15,40
50,Fail,48,34,2,16,32
50,Fail,47,31,8,14,33
50,Fail,53,35,6,6,47
50,Fail,51,34,0,11,40
50,Fail,53,33,0,11,42
50,Fail,51,32,0,12,39
50,Fail,50,30,0,13,37
50,Fail,49,35,0,10,39
50,Fail,41,32,0,16,25
50,Fail,43,36,0,14,29
50,Fail,40,39,0,11,29
50,Fail,46,41,0,10,36
50,Fail,45,46,4,5,40
50,Fail,41,39,0,13,28
50,Fail,50,33,0,12,38
50,Fail,53,38,2,7,46
50,Fail,52,31,0,14,38
50,Fail,50,34,6,10,40
50,Fail,48,28,6,18,30
50,Fail,49,36,0,13,36
50,Fail,49,27,3,21,28
50,Fail,50,33,2,15,35
50,Fail,52,32,0,12,40
50,Fail,50,32,0,16,34
50,Fail,47,36,2,15,32
50,Fail,53,36,2,9,44
50,Fail,43,33,6,18,25
50,Fail,52,39,0,9,43
50,Fail,48,38,0,12,36
50,Fail,52,29,6,13,39
50,Fail,40,44,4,12,28
50,Fail,45,36,0,14,31
50,Fail,44,46,3,7,37
50,Fail,43,40,0,10,33
50,Fail,49,32,1,18,31
50,Fail,46,27,9,18,28
50,Fail,42,34,9,15,27
50,Fail,51,39,6,4,47
50,Fail,50,36,0,12,38
50,Fail,41,41,3,15,26
50,Fail,57,30,0,12,45
50,Fail,45,36,0,8,37
50,Fail,50,40,2,8,42
50,Success,61,28,3,8,53
50,Fail,48,27,16,9,39
50,Fail,47,37,5,11,36
50,Fail,52,40,1,7,45
50,Fail,53,25,0,14,39
50,Fail,45,42,1,12,33
50,Fail,50,38,0,10,40
50,Fail,50,39,2,9,41
50,Fail,43,41,0,16,27
50,Fail,56,28,4,12,44
50,Fail,52,32,3,13,39
50,Fail,45,33,2,20,25
50,Fail,47,34,0,11,36
50,Fail,47,34,0,18,29
50,Fail,50,30,4,16,34
50,Fail,44,41,0,11,33
50,Fail,43,33,5,19,24
50,Fail,48,40,0,8,40
50,Fail,46,32,0,16,30
50,Fail,48,36,0,13,35
50,Fail,43,39,10,8,35
50,Fail,47,26,10,17,30
50,Fail,52,38,1,9,43
50,Fail,55,31,5,9,46
50,Fail,47,41,2,10,37
50,Fail,45,39,6,10,35
50,Fail,54,36,0,8,46
50,Fail,46,34,1,19,27
50,Fail,46,37,8,9,37
50,Fail,43,35,9,13,30
50,Fail,40,37,6,17,23
50,Fail,54,32,1,13,41
50,Fail,48,36,0,15,33
50,Fail,51,35,0,10,41
50,Fail,50,38,5,7,43
50,Fail,51,33,0,16,35
50,Fail,47,38,5,10,37
50,Fail,44,34,6,16,28
50,Fail,50,34,2,14,36
50,Fail,45,27,15,13,32
50,Fail,54,27,0,16,38
50,Success,59,33,1,7,52
50,Fail,41,38,3,18,23
50,Fail,50,41,0,9,41
50,Fail,50,33,0,17,33
50,Fail,48,34,5,13,35
50,Fail,48,34,6,12,36
50,Fail,47,39,0,11,36
50,Fail,46,39,1,14,32
50,Fail,50,33,0,14,36
50,Fail,45,40,0,15,30
50,Fail,43,42,3,12,31
50,Fail,56,29,0,15,41
50,Fail,51,34,0,7,44
50,Fail,42,41,0,16,26
50,Fail,50,30,10,10,40
50,Fail,46,40,0,14,32
50,Fail,43,38,2,17,26
50,Fail,55,32,0,13,42
50,Fail,43,42,2,13,30
50,Fail,44,38,5,13,31
50,Fail,53,35,0,7,46
50,Fail,42,37,3,18,24
50,Fail,39,40,4,17,22
50,Fail,51,33,0,16,35
50,Fail,50,29,0,18,32
50,Fail,49,37,4,10,39
50,Fail,52,30,0,13,39
50,Fail,49,33,1,17,32
50,Fail,49,36,0,14,35
50,Fail,55,35,0,9,46
50,Fail,55,36,1,8,47
50,Fail,59,27,0,11,48
50,Fail,51,38,2,9,42
50,Fail,47,38,0,13,34
50,Fail,48,32,0,16,32
50,Fail,56,33,2,9,47
50,Fail,55,27,4,14,41
50,Fail,57,31,0,9,48
50,Fail,51,37,2,10,41
50,Fail,51,33,0,11,40
50,Fail,42,31,0,18,24
50,Fail,51,34,0,14,37
50,Fail,52,30,2,16,36
50,Fail,51,36,0,13,38
50,Fail,50,38,3,9,41
50,Fail,38,38,6,18,20
50,Fail,53,32,0,15,38
50,Fail,45,33,10,12,33
50,Fail,52,29,6,13,39
50,Fail,43,40,5,12,31
50,Fail,45,36,1,18,27
50,Fail,53,33,1,13,40
50,Success,59,31,1,9,50
50,Fail,42,43,5,10,32
50,Fail,55,30,0,14,41
50,Fail,51,35,0,12,39
50,Fail,47,36,4,13,34
50,Fail,49,34,0,12,37
50,Fail,49,39,0,8,41
50,Fail,43,36,0,13,30
50,Fail,44,39,0,10,34
50,Fail,47,30,0,11,36
50,Fail,48,36,4,12,36
50,Fail,51,34,5,10,41
50,Fail,45,37,0,9,36
50,Fail,44,42,1,13,31
50,Fail,46,32,0,17,29
50,Fail,53,39,0,8,45
50,Fail,40,35,0,18,22
50,Success,56,31,0,6,50
50,Fail,38,42,0,14,24
50,Fail,42,32,9,17,25
50,Fail,45,34,0,16,29
50,Fail,53,34,0,12,41
50,Fail,50,37,1,12,38
50,Fail,54,31,1,14,40
50,Fail,52,37,0,8,44
50,Fail,50,34,4,12,38
50,Fail,50,33,9,8,42
50,Fail,49,38,0,12,37
50,Fail,48,38,6,8,40
50,Fail,47,40,1,12,35
50,Fail,43,30,0,19,24
50,Fail,51,34,5,10,41
50,Fail,55,37,0,8,47
50,Fail,46,38,0,13,33
50,Fail,46,34,0,10,36
50,Fail,50,39,4,7,43
50,Fail,39,42,0,8,31
50,Fail,51,37,0,11,40
50,Fail,42,44,0,11,31
50,Fail,50,27,8,15,35
50,Fail,52,42,0,5,47
50,Fail,46,33,0,15,31
50,Fail,49,33,0,11,38
50,Fail,53,32,5,10,43
50,Fail,56,26,0,16,40
50,Fail,46,40,0,11,35
50,Fail,49,33,0,12,37
50,Fail,45,46,1,8,37
50,Fail,52,32,0,9,43
50,Fail,53,38,0,8,45
50,Fail,49,33,0,16,33
50,Fail,52,30,0,11,41
50,Fail,37,42,0,18,19
50,Fail,55,30,0,12,43
50,Fail,48,32,0,16,32
50,Fail,43,39,0,15,28
50,Fail,41,42,4,13,28
50,Fail,49,36,4,11,38
50,Fail,47,32,7,14,33
50,Fail,52,37,0,10,42
50,Fail,55,30,4,11,44
50,Fail,50,28,0,11,39
50,Fail,49,39,0,12,37
50,Fail,44,35,0,13,31
50,Fail,47,34,0,17,30
50,Fail,56,17,0,17,39
50,Fail,49,34,1,16,33
50,Fail,49,40,2,9,40
50,Fail,49,40,0,11,38
50,Fail,53,35,0,12,41
50,Fail,54,30,5,11,43
50,Fail,43,38,0,14,29
50,Fail,48,42,0,10,38
50,Fail,54,31,5,10,44
50,Fail,44,38,0,17,27
50,Fail,47,37,4,12,35
50,Fail,56,34,0,7,49
50,Fail,38,44,6,12,26
50,Fail,57,33,0,10,47
50,Fail,42,47,2,9,33
50,Fail,57,27,0,12,45
50,Fail,49,32,2,17,32
50,Fail,52,35,4,9,43
50,Fail,51,31,2,16,35
50,Fail,45,42,0,12,33
50,Fail,49,35,3,13,36
50,Fail,51,30,6,13,38
50,Fail,48,43,0,9,39
50,Fail,48,39,1,12,36
50,Fail,54,33,0,13,41
50,Fail,48,33,0,14,34
50,Fail,51,37,0,12,39
50,Fail,51,34,0,12,39
50,Fail,45,36,1,18,27
50,Fail,50,34,4,12,38
50,Fail,47,34,0,8,39
50,Fail,44,37,10,9,35
50,Fail,45,29,0,16,29
50,Fail,51,39,0,8,43
50,Fail,45,35,0,17,28
50,Fail,46,32,0,20,26
50,Fail,42,40,0,16,26
50,Fail,54,31,0,12,42
50,Fail,46,43,0,11,35
50,Fail,49,38,0,6,43
50,Fail,46,42,4,8,38
50,Fail,49,38,0,7,42
50,Fail,51,35,0,8,43
50,Fail,48,40,0,10,38
50,Fail,51,39,0,9,42
50,Fail,46,32,0,14,32
50,Fail,48,35,1,16,32
50,Fail,46,31,0,15,31
50,Fail,44,38,6,12,32
50,Fail,39,38,0,18,21
50,Fail,49,31,0,19,30
50,Fail,46,30,0,13,33
50,Fail,58,30,0,9,49
50,Fail,51,39,0,8,43
50,Fail,43,42,6,9,34
50,Fail,52,38,2,8,44
50,Fail,47,36,0,15,32
50,Fail,51,34,0,15,36
50,Fail,53,32,0,11,42
50,Fail,51,34,0,13,38
50,Fail,49,38,3,10,39
50,Fail,48,35,0,15,33
50,Fail,33,48,0,19,14
50,Fail,43,41,4,12,31
50,Fail,51,36,0,9,42
50,Fail,54,36,2,8,46
50,Fail,48,34,4,14,34
50,Fail,55,35,1,9,46
50,Fail,49,27,12,12,37
50,Fail,42,36,0,14,28
50,Fail,45,38,0,11,34
50,Success,62,24,3,11,51
50,Success,57,38,0,2,55
50,Fail,46,34,5,15,31
50,Fail,55,35,1,9,46
50,Fail,56,31,0,10,46
50,Fail,49,35,0,11,38
50,Fail,46,39,0,14,32
50,Fail,39,35,0,22,17
50,Fail,51,32,3,14,37
50,Fail,53,30,0,7,46
50,Fail,51,31,4,14,37
50,Fail,51,33,6,10,41
50,Fail,52,42,1,5,47
50,Fail,54,34,2,10,44
50,Fail,46,40,2,12,34
50,Fail,44,43,1,12,32
50,Fail,53,30,1,16,37
50,Fail,40,42,0,14,26
50,Fail,53,33,3,11,42
50,Fail,58,31,0,9,49
50,Fail,53,31,2,14,39
50,Fail,47,36,0,10,37
50,Fail,47,39,0,10,37
50,Fail,43,38,7,12,31
50,Fail,48,27,0,13,35
50,Fail,45,41,1,13,32
50,Fail,54,33,1,12,42
50,Success,62,26,0,8,54
50,Fail,50,36,0,11,39
50,Fail,54,34,0,10,44
50,Fail,40,39,0,18,22
50,Fail,43,42,0,8,35
50,Fail,48,42,0,9,39
50,Fail,43,42,0,13,30
50,Fail,49,33,0,12,37
50,Fail,45,30,0,16,29
50,Fail,51,34,0,13,38
50,Fail,45,36,0,15,30
50,Fail,49,40,0,11,38
50,Fail,49,36,0,11,38
50,Fail,42,36,12,10,32
50,Success,58,31,3,8,50
50,Fail,44,38,10,8,36
50,Fail,40,34,0,20,20
50,Fail,49,40,1,10,39
50,Fail,49,39,0,11,38
50,Fail,43,42,0,9,34
50,Fail,40,41,4,15,25
50,Fail,45,40,1,14,31
50,Fail,44,40,3,13,31
50,Fail,47,28,0,15,32
50,Fail,45,28,6,21,24
50,Fail,44,40,0,15,29
50,Fail,49,34,4,13,36
50,Fail,53,35,0,9,44
50,Fail,49,38,0,9,40
50,Fail,50,31,0,10,40
50,Fail,54,32,0,11,43
50,Fail,51,33,0,15,36
50,Fail,52,36,0,11,41
50,Fail,46,40,0,12,34
50,Fail,53,35,0,11,42
50,Fail,52,32,3,13,39
50,Fail,39,42,4,15,24
50,Fail,50,43,0,6,44
50,Fail,42,34,6,18,24
50,Fail,52,29,4,15,37
50,Fail,52,35,1,12,40
50,Fail,53,32,2,13,40
50,Fail,54,34,0,12,42
50,Fail,54,34,2,10,44
50,Fail,48,36,1,15,33
50,Fail,44,32,7,17,27
50,Fail,52,32,0,16,36
50,Fail,45,44,0,8,37
50,Fail,40,39,0,12,28
50,Fail,49,35,0,15,34
50,Fail,56,32,0,7,49
50,Fail,53,37,3,7,46
50,Fail,47,31,13,9,38
50,Success,57,33,3,7,50
50,Fail,41,37,3,19,22
50,Fail,44,43,2,11,33
50,Fail,48,37,3,12,36
50,Fail,48,38,0,11,37
50,Fail,44,43,0,11,33
50,Fail,49,37,0,14,35
50,Fail,46,36,0,14,32
50,Fail,52,34,1,13,39
50,Fail,42,37,9,12,30
50,Fail,54,32,0,9,45
50,Fail,45,41,0,11,34
50,Success,58,32,0,8,50
50,Fail,45,36,6,13,32
50,Fail,46,36,0,14,32
50,Fail,50,31,0,16,34
50,Fail,48,42,1,9,39
50,Fail,47,39,6,8,39
50,Fail,47,39,1,13,34
50,Fail,40,30,0,19,21
50,Fail,43,36,1,20,23
50,Fail,42,42,6,10,32
50,Fail,51,29,0,12,39
50,Fail,55,35,0,9,46
50,Fail,46,39,4,11,35
50,Fail,49,34,5,12,37
50,Fail,50,35,3,12,38
50,Fail,52,38,0,8,44
50,Fail,39,39,9,13,26
50,Fail,45,35,0,18,27
50,Fail,44,37,0,13,31
50,Fail,52,33,4,11,41
50,Fail,38,30,16,16,22
50,Fail,51,30,2,17,34
50,Fail,51,36,4,9,42
50,Fail,48,40,0,10,38
50,Fail,49,30,0,18,31
50,Fail,55,27,3,15,40
50,Fail,49,35,2,14,35
50,Fail,48,39,2,11,37
50,Fail,47,38,0,13,34
50,Fail,57,28,0,11,46
50,Fail,43,40,11,6,37
50,Fail,51,36,0,11,40
50,Fail,55,31,0,8,47
50,Fail,45,40,6,9,36
50,Fail,46,36,8,10,36
50,Fail,50,38,0,10,40
50,Fail,47,31,0,16,31
50,Fail,47,34,0,16,31
50,Fail,41,31,0,22,19
50,Fail,49,36,4,11,38
50,Fail,53,33,0,14,39
50,Fail,47,36,0,14,33
50,Fail,46,40,1,13,33
50,Fail,51,29,0,15,36
50,Fail,44,27,11,18,26
50,Fail,44,36,4,16,28
50,Fail,57,33,2,8,49
50,Fail,48,35,0,16,32
50,Fail,46,38,0,11,35
50,Fail,44,40,0,14,30
50,Fail,53,32,3,12,41
50,Fail,44,39,0,17,27
50,Fail,46,38,0,10,36
50,Fail,52,37,1,10,42
50,Fail,46,41,3,10,36
50,Fail,45,39,0,12,33
50,Fail,53,33,5,9,44
50,Fail,40,40,0,14,26
50,Fail,50,35,0,12,38
50,Fail,55,35,0,9,46
50,Fail,49,34,0,11,38
50,Fail,54,33,0,10,44
50,Fail,47,35,0,12,35
50,Fail,50,35,4,11,39
50,Success,59,33,0,8,51
50,Fail,50,37,1,12,38
50,Fail,38,37,9,16,22
50,Fail,51,36,0,10,41
50,Fail,51,36,0,12,39
50,Fail,48,38,1,13,35
50,Fail,49,34,8,9,40
50,Fail,48,36,0,7,41
50,Fail,43,46,0,8,35
50,Fail,47,40,1,12,35
50,Fail,45,41,0,14,31
50,Fail,46,37,0,11,35
50,Fail,48,41,0,11,37
50,Fail,43,43,2,12,31
50,Fail,50,37,1,12,38
50,Fail,44,47,1,8,36
50,Fail,47,35,0,17,30
50,Fail,47,37,5,11,36
50,Fail,47,31,4,18,29
50,Fail,49,30,7,14,35
50,Fail,43,46,1,10,33
50,Fail,48,37,0,15,33
50,Fail,41,30,16,13,28
50,Fail,55,36,1,8,47
50,Fail,54,33,3,10,44
50,Fail,41,48,0,11,30
50,Fail,56,31,0,12,44
50,Fail,57,30,0,13,44
50,Fail,42,43,0,11,31
50,Fail,43,36,4,17,26
50,Fail,48,33,1,18,30
50,Fail,45,35,7,13,32
50,Fail,39,40,7,14,25
50,Fail,47,36,4,13,34
50,Success,57,34,0,6,51
50,Fail,50,31,0,12,38
50,Fail,41,36,0,15,26
50,Fail,49,31,0,11,38
50,Fail,43,41,0,15,28
50,Fail,46,36,5,13,33
50,Fail,53,36,0,11,42
50,Fail,49,35,2,14,35
50,Success,58,30,4,8,50
50,Fail,44,44,0,12,32
50,Fail,50,36,5,9,41
50,Fail,52,40,3,5,47
50,Fail,45,37,4,14,31
50,Fail,39,45,0,13,26
50,Fail,45,40,2,13,32
50,Fail,53,27,5,15,38
50,Fail,45,33,0,15,30
50,Fail,45,37,0,14,31
50,Fail,45,41,2,12,33
50,Fail,46,39,0,7,39
50,Fail,35,30,0,22,13
50,Fail,55,32,0,12,43
50,Fail,50,41,0,8,42
50,Fail,47,39,2,12,35
50,Fail,51,31,0,14,37
50,Fail,42,41,2,15,27
50,Fail,40,46,0,14,26
50,Fail,41,40,6,13,28
50,Fail,57,31,0,11,46
50,Fail,56,29,0,15,41
50,Fail,48,34,7,11,37
50,Fail,43,41,6,10,33
50,Fail,48,31,4,17,31
50,Fail,41,35,8,16,25
50,Fail,51,35,0,13,38
50,Fail,53,41,0,6,47
50,Fail,45,38,0,16,29
50,Fail,47,29,0,14,33
50,Fail,42,38,7,13,29
50,Fail,46,34,1,19,27
50,Fail,51,26,9,14,37
50,Fail,43,39,0,14,29
50,Fail,45,35,3,17,28
50,Fail,55,34,0,7,48
50,Fail,42,46,1,11,31
50,Fail,50,41,0,6,44
50,Fail,45,39,0,11,34
50,Fail,51,28,3,18,33
50,Fail,47,38,6,9,38
50,Fail,43,35,4,18,25
50,Fail,45,32,0,15,30
50,Fail,55,35,1,9,46
50,Fail,39,40,0,21,18
50,Fail,42,36,3,19,23
50,Fail,46,35,7,12,34
50,Fail,49,38,0,12,37
50,Fail,43,40,0,13,30
50,Fail,49,39,2,10,39
50,Fail,46,41,4,9,37
50,Fail,40,46,0,9,31
50,Fail,53,37,0,10,43
50,Fail,46,34,5,15,31
50,Fail,46,36,0,13,33
50,Fail,48,35,0,14,34
50,Fail,41,38,7,14,27
50,Fail,50,30,0,19,31
50,Fail,46,33,5,16,30
50,Fail,51,36,2,11,40
50,Fail,55,33,2,10,45
50,Fail,54,35,0,7,47
50,Fail,54,27,8,11,43
50,Success,60,31,0,9,51
50,Fail,51,35,0,10,41
50,Fail,46,37,2,15,31
50,Fail,40,31,18,11,29
50,Fail,58,28,0,13,45
50,Fail,48,33,0,18,30
50,Fail,54,29,5,12,42
50,Fail,51,28,0,18,33
50,Fail,51,31,0,18,33
50,Fail,53,34,0,12,41
50,Fail,35,40,9,16,19
50,Fail,56,28,0,9,47
50,Fail,44,45,0,11,33
50,Fail,47,36,3,14,33
50,Fail,43,32,0,15,28
50,Fail,43,39,0,14,29
50,Fail,46,38,0,11,35
50,Fail,43,37,4,16,27
50,Fail,49,38,0,10,39
50,Fail,54,36,4,6,48
50,Fail,54,32,0,12,42
50,Fail,46,35,7,12,34
50,Fail,50,40,2,8,42
50,Fail,49,38,0,9,40
50,Fail,39,34,6,21,18
50,Fail,47,40,2,11,36
50,Fail,36,37,0,13,23
50,Fail,54,33,4,9,45
50,Fail,44,36,0,11,33
50,Fail,54,35,1,10,44
50,Fail,53,32,0,12,41
50,Fail,50,32,4,14,36
50,Fail,47,38,0,12,35
50,Fail,42,42,0,10,32
50,Fail,45,32,0,16,29
50,Fail,39,40,0,16,23
50,Fail,49,27,6,18,31
50,Fail,46,33,0,15,31
50,Fail,49,34,0,17,32
50,Fail,49,36,0,13,36
50,Fail,50,36,3,11,39
50,Fail,47,34,0,14,33
50,Fail,48,39,0,11,37
50,Fail,44,38,0,13,31
50,Fail,46,36,0,17,29
50,Fail,50,34,9,7,43
50,Fail,47,26,0,17,30
50,Fail,45,38,3,14,31
50,Fail,43,45,0,12,31
50,Fail,46,34,0,14,32
50,Fail,45,40,0,11,34
50,Fail,47,42,0,7,40
50,Fail,56,31,0,12,44
50,Fail,53,35,0,10,43
50,Fail,40,38,0,13,27
50,Success,57,31,0,6,51
50,Fail,50,27,0,14,36
50,Fail,48,33,6,13,35
50,Fail,55,35,2,8,47
50,Fail,50,38,0,10,40
50,Fail,41,36,0,23,18
50,Fail,50,33,0,17,33
50,Fail,39,31,0,21,18
50,Fail,42,43,0,9,33
50,Fail,47,38,3,12,35
50,Fail,47,39,0,12,35
50,Fail,43,43,1,13,30
50,Fail,55,35,0,9,46
50,Fail,49,41,0,10,39
50,Fail,52,38,0,10,42
50,Fail,54,36,2,8,46
50,Fail,51,34,2,13,38
50,Fail,43,46,2,9,34
50,Fail,52,35,0,12,40
50,Fail,47,36,3,14,33
50,Fail,46,38,7,9,37
50,Fail,47,32,9,12,35
50,Fail,47,39,0,12,35
50,Fail,54,39,0,7,47
50,Fail,43,41,2,14,29
50,Fail,46,36,0,16,30
50,Fail,53,38,0,6,47
50,Fail,54,30,7,9,45
50,Fail,43,47,0,7,36
50,Fail,46,41,0,10,36
50,Fail,52,32,5,11,41
50,Fail,40,44,0,15,25
50,Fail,48,39,0,13,35
50,Fail,43,45,0,9,34
50,Fail,41,45,0,14,27
50,Fail,38,42,1,19,19
50,Fail,52,29,6,13,39
50,Fail,49,37,0,11,38
50,Fail,52,36,0,5,47
50,Fail,60,28,0,12,48
50,Success,55,37,3,5,50
50,Fail,51,35,0,10,41
50,Fail,55,36,0,8,47
50,Fail,32,41,0,20,12
50,Fail,49,35,0,9,40
50,Fail,54,30,0,14,40
50,Fail,44,46,0,10,34
50,Fail,44,36,0,13,31
50,Fail,46,38,0,16,30
50,Fail,52,36,0,8,44
50,Fail,50,33,1,16,34
50,Fail,54,34,0,11,43
50,Fail,50,37,0,13,37
50,Fail,42,40,5,13,29
50,Fail,52,35,5,8,44
50,Fail,41,33,0,17,24
50,Fail,43,36,0,15,28
50,Fail,45,41,0,12,33
50,Fail,52,36,0,12,40
50,Fail,48,30,0,15,33
50,Fail,37,39,0,16,21
50,Fail,48,37,0,12,36
50,Fail,47,35,7,11,36
50,Fail,51,38,2,9,42
50,Fail,48,33,5,14,34
50,Fail,48,33,0,12,36
50,Fail,49,41,0,10,39
50,Fail,39,36,0,17,22
50,Fail,50,33,5,12,38
50,Fail,44,41,1,14,30
50,Fail,43,39,7,11,32
50,Fail,40,37,0,13,27
50,Fail,49,34,0,16,33
50,Fail,51,37,0,12,39
50,Fail,38,45,3,14,24
50,Fail,45,34,5,16,29
50,Fail,55,32,1,12,43
50,Fail,43,36,7,14,29
50,Fail,53,30,0,13,40
50,Fail,49,36,0,13,36
50,Fail,53,31,0,14,39
50,Fail,48,37,0,11,37
50,Fail,40,38,9,13,27
50,Fail,49,32,0,9,40
50,Fail,46,37,5,12,34
50,Fail,55,34,2,9,46
50,Fail,45,41,0,13,32
50,Fail,50,33,0,13,37
50,Fail,45,41,0,10,35
50,Fail,50,35,0,9,41
50,Fail,45,41,4,10,35
50,Fail,47,35,0,14,33
50,Fail,54,36,2,8,46
50,Success,57,31,0,6,51
50,Fail,55,34,0,11,44
50,Fail,45,32,0,19,26
50,Fail,42,25,8,25,17
50,Fail,49,31,3,17,32
50,Fail,46,38,0,10,36
50,Fail,51,32,0,15,36
50,Fail,45,33,7,15,30
50,Fail,44,42,2,12,32
50,Fail,51,26,0,16,35
50,Fail,39,32,5,24,15
50,Fail,48,33,10,9,39
50,Fail,50,35,5,10,40
50,Fail,44,37,6,13,31
50,Fail,50,31,1,18,32
50,Fail,46,33,0,19,27
50,Fail,49,31,8,12,37
50,Fail,42,41,0,14,28
50,Fail,45,37,0,10,35
50,Fail,39,35,0,22,17
50,Fail,43,38,0,12,31
50,Fail,49,40,3,8,41
50,Fail,57,31,1,11,46
50,Fail,49,42,3,6,43
50,Fail,45,37,0,16,29
50,Fail,50,36,0,14,36
50,Fail,45,38,2,15,30
50,Fail,51,27,8,14,37
50,Fail,45,39,11,5,40
50,Fail,54,32,0,11,43
50,Fail,47,36,0,14,33
50,Fail,49,38,0,11,38
50,Fail,46,42,0,9,37
50,Fail,50,38,0,9,41
50,Success,59,30,2,9,50
50,Fail,44,37,0,11,33
50,Fail,46,34,0,18,28
50,Fail,45,39,6,10,35
50,Fail,50,28,10,12,38
50,Fail,46,41,1,12,34
50,Fail,41,42,0,14,27
50,Fail,43,41,0,15,28
50,Fail,45,40,0,12,33
50,Fail,51,30,0,13,38
50,Fail,53,40,0,7,46
50,Fail,43,39,4,14,29
50,Fail,44,36,7,13,31
50,Fail,52,31,4,13,39
50,Fail,39,43,0,12,27
50,Fail,47,36,0,16,31
50,Fail,52,37,0,9,43
50,Fail,42,38,1,19,23
50,Fail,47,36,0,11,36
50,Fail,44,41,0,10,34
50,Fail,50,43,0,6,44
50,Fail,54,35,5,6,48
50,Fail,48,37,0,13,35
50,Fail,43,35,0,16,27
50,Fail,47,39,1,13,34
50,Fail,47,40,2,11,36
50,Fail,49,31,0,16,33
50,Fail,54,36,2,8,46
50,Fail,46,40,1,13,33
50,Fail,48,33,0,12,36
50,Success,58,33,1,8,50
50,Fail,47,39,0,9,38
50,Fail,57,34,0,9,48
50,Fail,51,28,0,9,42
50,Fail,49,29,4,18,31
50,Fail,50,34,0,12,38
50,Fail,47,45,0,8,39
50,Fail,52,26,0,14,38
50,Fail,47,42,0,10,37
50,Fail,39,43,0,17,22
50,Fail,51,36,4,9,42
50,Fail,46,42,1,11,35
50,Fail,36,40,0,13,23
50,Fail,49,33,0,16,33
50,Fail,46,30,13,11,35
50,Fail,47,38,0,9,38
50,Fail,49,35,6,10,39
50,Fail,44,34,7,15,29
50,Fail,48,39,0,10,38
50,Fail,54,33,0,12,42
50,Fail,50,39,0,7,43
50,Fail,42,35,0,18,24
50,Fail,57,28,2,13,44
50,Fail,50,37,2,11,39
50,Fail,40,36,7,17,23
50,Fail,46,36,6,12,34
50,Fail,48,40,1,11,37
50,Fail,43,42,0,11,32
50,Fail,45,28,14,13,32
50,Fail,52,38,0,7,45
50,Fail,52,33,0,13,39
50,Fail,54,37,0,9,45
50,Fail,47,38,5,10,37
50,Fail,45,40,0,14,31
50,Fail,47,39,0,14,33
50,Fail,50,30,6,14,36
50,Fail,45,37,7,11,34
50,Fail,47,40,0,8,39
50,Fail,45,36,0,12,33
50,Fail,55,31,0,12,43
50,Fail,55,27,9,9,46
50,Fail,53,31,0,16,37
50,Fail,47,29,0,6,41
50,Fail,43,37,4,16,27
50,Fail,44,42,1,13,31
50,Fail,49,36,0,12,37
50,Fail,46,32,0,14,32
50,Fail,46,39,1,14,32
50,Fail,50,29,8,13,37
50,Fail,49,31,1,19,30
50,Fail,45,30,0,18,27
50,Fail,52,34,0,11,41
50,Fail,49,31,8,12,37
50,Fail,40,43,4,13,27
50,Fail,46,33,0,15,31
50,Fail,51,32,5,12,39
50,Fail,55,38,0,7,48
50,Fail,56,32,1,11,45
50,Fail,51,34,4,11,40
50,Fail,49,33,0,15,34
50,Fail,47,29,10,14,33
50,Fail,45,31,5,19,26
50,Fail,47,35,0,15,32
50,Fail,50,35,0,12,38
50,Fail,42,38,0,12,30
50,Fail,46,34,0,17,29
50,Fail,50,33,4,13,37
50,Fail,51,37,2,10,41
50,Fail,46,40,1,13,33
50,Fail,51,29,0,10,41
50,Fail,40,43,5,12,28
50,Fail,48,37,5,10,38
50,Fail,49,28,0,23,26
50,Fail,48,29,0,19,29
50,Fail,54,32,0,13,41
50,Fail,46,37,0,10,36
50,Fail,44,42,0,12,32
50,Fail,51,35,2,12,39
50,Fail,50,35,0,12,38
50,Fail,46,37,0,15,31
50,Fail,46,38,8,8,38
50,Fail,41,38,0,14,27
50,Fail,42,35,3,20,22
50,Fail,49,42,2,7,42
50,Fail,43,34,12,11,32
50,Fail,45,36,3,16,29
50,Fail,41,31,11,17,24
50,Fail,44,34,0,6,38
50,Fail,54,32,0,13,41
50,Fail,41,42,5,12,29
50,Fail,53,35,2,10,43
50,Fail,56,30,0,13,43
50,Fail,52,28,0,13,39
50,Fail,49,33,0,13,36
50,Fail,36,43,12,9,27
50,Fail,50,36,0,13,37
50,Fail,45,37,0,17,28
50,Fail,46,46,2,6,40
50,Fail,46,39,0,11,35
50,Fail,43,36,0,21,22
50,Fail,39,40,0,10,29
50,Fail,38,42,3,17,21
50,Fail,49,35,1,15,34
50,Fail,56,32,0,12,44
50,Fail,50,33,0,13,37
50,Fail,58,30,1,11,47
50,Fail,38,34,0,11,27
50,Fail,47,37,0,14,33
50,Fail,48,35,5,12,36
50,Fail,40,42,1,17,23
50,Fail,46,31,6,17,29
50,Fail,48,31,0,9,39
50,Fail,51,34,0,6,45
50,Fail,48,35,0,13,35
50,Success,57,38,0,5,52
50,Fail,48,31,4,17,31
50,Fail,47,32,5,16,31
50,Fail,51,27,0,13,38
50,Fail,50,33,0,11,39
50,Fail,49,35,4,12,37
50,Fail,43,43,3,11,32
50,Fail,46,26,10,18,28
50,Fail,53,31,5,11,42
50,Fail,49,34,0,12,37
50,Fail,45,39,4,12,33
50,Fail,49,37,1,13,36
50,Fail,41,37,0,11,30
50,Fail,49,36,0,8,41
50,Fail,46,29,0,21,25
50,Fail,44,33,0,18,26
50,Fail,52,36,0,8,44
50,Fail,43,43,0,10,33
50,Success,62,28,0,10,52
50,Fail,45,37,0,14,31
50,Fail,56,31,0,12,44
50,Fail,53,31,0,15,38
50,Fail,49,35,0,15,34
50,Fail,45,31,0,18,27
50,Fail,47,40,3,10,37
50,Fail,56,28,0,12,44
50,Fail,41,29,10,20,21
50,Fail,46,37,0,13,33
50,Fail,47,43,0,8,39
50,Fail,46,35,0,10,36
50,Fail,47,36,0,11,36
50,Fail,46,41,0,13,33
50,Fail,51,33,0,15,36
50,Fail,47,34,0,18,29
50,Fail,43,44,0,9,34
50,Fail,49,34,2,15,34
50,Fail,44,38,0,15,29
50,Fail,54,29,8,9,45
50,Fail,48,38,0,13,35
50,Fail,52,25,12,11,41
50,Fail,48,40,0,12,36
50,Fail,44,39,4,13,31
50,Fail,46,33,5,16,30
50,Fail,54,34,0,12,42
50,Fail,51,32,2,15,36
50,Fail,48,34,5,13,35
50,Fail,48,37,0,9,39
50,Fail,46,35,0,14,32
50,Fail,48,37,9,6,42
50,Fail,49,34,1,16,33
50,Fail,42,39,0,12,30
50,Fail,51,32,0,10,41
50,Fail,49,31,7,13,36
50,Fail,50,29,3,18,32
50,Fail,44,39,7,10,34
50,Success,56,34,4,6,50
50,Fail,48,35,4,13,35
50,Fail,50,29,0,14,36
50,Fail,45,33,6,16,29
50,Fail,42,31,0,16,26
50,Fail,52,35,6,7,45
50,Fail,47,33,6,14,33
50,Fail,45,39,4,12,33
50,Fail,42,34,0,12,30
50,Fail,42,38,5,15,27
50,Fail,53,29,4,14,39
50,Fail,49,38,1,12,37
50,Fail,49,37,3,11,38
50,Fail,58,28,4,10,48
50,Fail,46,34,0,15,31
50,Fail,57,29,0,11,46
50,Fail,50,37,0,10,40
50,Fail,46,35,6,13,33
50,Fail,43,41,0,16,27
50,Fail,53,33,3,11,42
50,Fail,56,28,0,15,41
50,Fail,45,39,2,14,31
50,Fail,55,35,2,8,47
50,Fail,47,32,8,13,34
50,Fail,57,30,2,11,46
50,Fail,49,32,8,11,38
50,Fail,44,42,0,8,36
50,Fail,44,32,0,17,27
50,Fail,47,30,0,10,37
50,Fail,44,39,1,16,28
50,Fail,50,37,0,9,41
50,Fail,36,46,8,10,26
50,Success,59,34,2,5,54
50,Fail,42,38,8,12,30
50,Fail,43,35,0,19,24
50,Fail,46,38,2,14,32
50,Fail,49,29,0,18,31
50,Fail,50,36,6,8,42
50,Fail,46,39,5,10,36
50,Fail,42,34,0,20,22
50,Fail,49,34,0,13,36
50,Success,58,35,1,6,52
50,Fail,43,33,0,22,21
50,Fail,46,39,6,9,37
50,Fail,50,34,3,13,37
50,Fail,44,37,3,16,28
50,Fail,47,35,4,14,33
50,Fail,52,30,6,12,40
50,Fail,45,36,0,19,26
50,Fail,41,37,7,15,26
50,Fail,49,36,0,12,37
50,Fail,50,43,2,5,45
50,Fail,49,40,0,10,39
50,Fail,47,34,0,12,35
50,Fail,51,33,3,13,38
50,Fail,56,30,0,12,44
50,Fail,42,39,0,16,26
50,Fail,45,32,9,14,31
50,Fail,41,35,0,16,25
50,Fail,49,36,3,12,37
50,Fail,52,31,0,15,37
50,Fail,44,30,12,14,30
50,Fail,55,36,1,8,47
50,Fail,47,30,0,13,34
50,Fail,41,49,0,9,32
50,Fail,51,33,0,13,38
50,Fail,46,34,8,12,34
50,Fail,42,39,3,16,26
50,Fail,49,35,0,9,40
50,Fail,51,31,4,14,37
50,Fail,48,39,1,12,36
50,Fail,46,37,2,15,31
50,Fail,48,38,0,14,34
50,Fail,49,36,0,11,38
50,Fail,47,37,0,12,35
50,Fail,49,41,0,10,39
50,Fail,47,42,0,10,37
50,Fail,45,40,0,15,30
50,Fail,51,37,5,7,44
50,Fail,44,36,7,13,31
50,Fail,50,32,8,10,40
50,Fail,54,36,0,8,46
50,Fail,45,37,4,14,31
50,Fail,52,34,0,12,40
50,Fail,53,35,0,11,42
50,Fail,44,40,3,13,31
50,Fail,50,35,0,12,38
50,Fail,49,30,0,20,29
50,Fail,52,39,0,8,44
50,Fail,52,41,0,6,46
50,Fail,43,35,0,17,26
50,Fail,49,32,0,15,34
50,Fail,42,43,0,9,33
50,Fail,50,24,0,15,35
50,Fail,43,39,0,15,28
50,Fail,46,34,6,14,32
50,Fail,48,40,3,9,39
50,Fail,48,27,0,20,28
50,Fail,50,34,0,8,42
50,Fail,43,39,6,12,31
50,Fail,42,36,7,15,27
50,Fail,49,37,0,12,37
50,Fail,41,35,0,17,24
50,Fail,49,37,1,13,36
50,Fail,44,34,0,13,31
50,Fail,52,34,0,9,43
50,Fail,50,36,1,13,37
50,Fail,49,39,2,10,39
50,Fail,53,36,1,10,43
50,Fail,58,32,0,9,49
50,Fail,57,32,1,10,47
50,Fail,36,42,8,14,22
50,Fail,48,29,15,8,40
50,Fail,53,34,2,11,42
50,Fail,48,31,0,12,36
50,Fail,50,38,0,10,40
50,Fail,52,34,3,11,41
50,Fail,46,37,7,10,36
50,Fail,49,30,0,19,30
50,Fail,39,34,9,18,21
50,Fail,40,37,6,17,23
50,Fail,40,36,0,23,17
50,Fail,48,36,0,14,34
50,Success,59,33,1,7,52
50,Fail,52,41,0,6,46
50,Fail,56,28,0,10,46
50,Fail,43,37,4,16,27
50,Fail,49,38,2,11,38
50,Fail,48,44,0,8,40
50,Fail,49,38,2,11,38
50,Fail,49,39,0,11,38
50,Fail,50,36,0,13,37
50,Fail,49,33,0,14,35
50,Fail,46,33,0,15,31
50,Fail,50,36,0,13,37
50,Fail,44,36,0,18,26
50,Fail,53,34,0,10,43
50,Fail,41,31,9,19,22
50,Fail,55,26,0,15,40
50,Fail,45,33,6,16,29
50,Fail,43,36,3,18,25
50,Fail,46,39,0,13,33
50,Fail,45,39,0,16,29
50,Fail,50,32,0,13,37
50,Fail,46,37,2,15,31
50,Fail,46,30,7,17,29
50,Fail,52,35,0,11,41
50,Fail,51,35,0,12,39
50,Fail,46,37,2,15,31
50,Fail,43,38,0,18,25
50,Fail,51,36,4,9,42
50,Fail,51,40,0,6,45
50,Fail,48,39,0,10,38
50,Fail,49,26,0,12,37
50,Fail,47,39,6,8,39
50,Fail,40,39,0,11,29
50,Fail,44,32,0,17,27
50,Fail,49,29,0,15,34
50,Fail,51,33,0,12,39
50,Fail,49,39,0,10,39
50,Fail,49,37,0,10,39
50,Fail,42,33,7,18,24
50,Fail,49,34,0,11,38
50,Fail,57,34,0,8,49
50,Fail,52,35,2,11,41
50,Fail,50,36,3,11,39
50,Fail,48,36,0,9,39
50,Fail,48,37,0,12,36
50,Fail,51,33,5,11,40
50,Fail,44,37,0,17,27
50,Fail,49,36,0,12,37
50,Success,60,35,2,3,57
50,Fail,56,35,0,8,48
50,Fail,42,34,0,14,28
50,Fail,49,39,0,9,40
50,Fail,53,35,0,12,41
50,Fail,50,32,0,15,35
50,Fail,47,35,9,9,38
50,Fail,56,29,7,8,48
50,Fail,43,37,5,15,28
50,Fail,51,34,0,14,37
50,Fail,40,41,3,16,24
50,Fail,53,36,0,7,46
50,Fail,42,29,12,17,25
50,Fail,46,36,2,16,30
50,Fail,51,37,4,8,43
50,Fail,49,29,0,14,35
50,Fail,54,28,3,15,39
50,Fail,49,33,0,10,39
50,Fail,49,38,0,10,39
50,Fail,44,32,0,21,23
50,Fail,47,42,0,9,38
50,Fail,53,33,0,11,42
50,Fail,52,33,0,12,40
50,Fail,44,35,8,13,31
50,Fail,53,36,0,8,45
50,Fail,45,34,9,12,33
50,Fail,51,28,7,14,37
50,Fail,43,39,0,13,30
50,Fail,53,32,0,13,40
50,Fail,50,32,0,15,35
50,Fail,45,41,0,12,33
50,Fail,53,28,9,10,43
50,Success,57,30,6,7,50
50,Fail,51,33,4,12,39
50,Fail,53,36,0,8,45
50,Fail,47,37,0,15,32
50,Fail,48,40,0,12,36
50,Fail,54,26,7,13,41
50,Fail,53,34,0,9,44
50,Fail,49,35,0,13,36
50,Fail,41,44,3,12,29
50,Fail,37,44,2,17,20
50,Fail,52,31,0,12,40
50,Fail,53,33,0,11,42
50,Fail,46,39,4,11,35
50,Success,63,26,2,9,54
50,Fail,50,33,7,10,40
50,Fail,42,39,4,15,27
50,Fail,51,34,0,13,38
50,Fail,54,32,2,12,42
50,Success,61,27,5,7,54
50,Fail,55,30,5,10,45
50,Fail,50,28,1,21,29
50,Fail,40,44,7,9,31
50,Success,57,31,0,7,50
50,Fail,47,35,3,15,32
50,Fail,44,35,6,15,29
50,Fail,47,39,0,12,35
50,Fail,46,39,2,13,33
50,Fail,51,36,1,12,39
50,Fail,41,38,0,13,28
50,Fail,54,32,2,12,42
50,Fail,51,34,4,11,40
50,Fail,43,27,7,23,20
50,Fail,51,34,1,14,37
50,Fail,50,37,2,11,39
50,Fail,48,35,0,16,32
50,Fail,47,38,2,13,34
50,Fail,43,42,0,11,32
50,Fail,43,38,0,13,30
50,Fail,55,30,0,15,40
50,Fail,48,36,0,14,34
50,Fail,44,33,0,14,30
50,Fail,49,33,0,10,39
50,Fail,51,35,0,13,38
50,Fail,45,31,0,10,35
50,Fail,56,36,1,7,49
50,Fail,45,40,0,13,32
50,Fail,56,32,4,8,48
50,Fail,50,34,0,13,37
50,Fail,41,35,4,20,21
50,Fail,55,29,0,10,45
50,Fail,48,41,1,10,38
50,Fail,45,36,0,12,33
50,Fail,49,38,0,9,40
50,Fail,46,34,9,11,35
50,Fail,53,25,10,12,41
50,Fail,52,31,2,15,37
50,Fail,53,27,6,14,39
50,Fail,40,41,15,4,36
50,Fail,50,30,4,16,34
50,Fail,42,36,0,16,26
50,Fail,42,42,2,14,28
50,Fail,51,32,3,14,37
50,Fail,44,42,1,13,31
50,Fail,51,37,0,11,40
50,Fail,49,31,2,18,31
50,Fail,50,37,7,6,44
50,Fail,43,39,0,15,28
50,Fail,48,33,0,18,30
50,Fail,41,44,0,14,27
50,Fail,47,32,10,11,36
50,Fail,38,50,0,11,27
50,Fail,58,29,0,13,45
50,Fail,48,33,5,14,34
50,Fail,50,34,0,13,37
50,Fail,48,28,0,13,35
50,Fail,45,44,0,10,35
50,Fail,47,42,0,9,38
50,Fail,51,34,2,13,38
50,Fail,52,36,0,7,45
50,Fail,53,35,0,9,44
50,Fail,51,31,0,13,38
50,Fail,46,43,0,7,39
50,Fail,47,35,0,16,31
50,Fail,47,36,7,10,37
50,Fail,44,40,0,11,33
50,Fail,51,32,6,11,40
50,Fail,46,36,1,17,29
50,Fail,52,32,0,14,38
50,Fail,50,38,2,10,40
50,Fail,48,41,3,8,40
50,Fail,48,35,0,13,35
50,Fail,42,37,0,16,26
50,Fail,54,37,0,7,47
50,Fail,51,36,1,12,39
50,Fail,41,33,10,16,25
50,Fail,47,37,0,13,34
50,Fail,45,32,4,19,26
50,Fail,52,33,0,8,44
50,Fail,45,43,0,8,37
50,Fail,53,35,0,9,44
50,Fail,46,34,0,14,32
50,Fail,40,35,6,19,21
50,Fail,57,27,0,11,46
50,Fail,52,26,7,15,37
50,Fail,50,33,0,14,36
50,Fail,54,28,0,16,38
50,Fail,45,39,0,11,34
50,Fail,52,36,1,11,41
50,Fail,49,40,1,10,39
50,Fail,50,32,2,16,34
50,Fail,50,35,0,15,35
50,Fail,48,37,0,15,33
50,Fail,56,35,0,9,47
50,Fail,44,37,0,14,30
50,Fail,46,36,0,12,34
50,Fail,56,34,0,10,46
50,Fail,39,42,3,16,23
50,Fail,48,40,3,9,39
50,Success,58,34,2,6,52
50,Fail,48,39,0,10,38
50,Fail,52,33,3,12,40
50,Fail,50,32,3,15,35
50,Fail,57,33,1,9,48
50,Fail,55,33,0,10,45
50,Fail,42,38,0,14,28
50,Fail,50,32,0,16,34
50,Fail,45,30,9,16,29
50,Fail,47,36,0,15,32
50,Success,60,29,0,9,51
50,Fail,42,35,4,19,23
50,Fail,55,35,0,6,49
50,Fail,47,37,0,14,33
50,Fail,46,31,0,13,33
50,Fail,42,44,2,12,30
50,Fail,49,37,1,13,36
50,Fail,57,25,0,14,43
50,Fail,42,43,0,12,30
50,Fail,50,34,2,14,36
50,Fail,39,36,10,15,24
50,Fail,48,35,5,12,36
50,Fail,46,40,0,13,33
50,Fail,43,40,2,15,28
50,Fail,57,26,0,10,47
50,Fail,49,40,0,9,40
50,Fail,48,36,0,13,35
50,Fail,54,34,0,10,44
50,Fail,40,35,9,16,24
50,Fail,45,29,0,14,31
50,Fail,47,37,6,10,37
50,Fail,35,45,9,11,24
50,Fail,51,37,0,12,39
50,Fail,38,45,3,14,24
50,Fail,45,41,0,10,35
50,Fail,47,39,3,11,36
50,Fail,50,30,0,17,33
50,Fail,48,33,0,19,29
50,Fail,42,43,0,15,27
50,Fail,50,37,0,13,37
50,Fail,56,32,4,8,48
50,Fail,48,35,4,13,35
50,Fail,46,43,0,8,38
50,Fail,48,36,0,14,34
50,Fail,52,38,0,10,42
50,Fail,50,33,0,13,37
50,Fail,52,34,1,13,39
50,Fail,50,37,0,8,42
50,Fail,48,39,0,10,38
50,Fail,53,34,2,11,42
50,Fail,46,36,0,15,31
50,Fail,49,36,0,14,35
50,Fail,44,37,3,16,28
50,Fail,45,38,6,11,34
50,Fail,48,35,0,14,34
50,Fail,51,30,0,12,39
50,Fail,46,42,3,9,37
50,Fail,43,30,0,16,27
50,Fail,37,33,0,20,17
50,Fail,47,35,5,13,34
50,Fail,53,32,1,14,39
50,Fail,45,32,7,16,29
50,Fail,54,33,0,11,43
50,Fail,48,31,0,20,28
50,Fail,54,34,0,11,43
50,Fail,52,29,8,11,41
50,Fail,45,37,0,15,30
50,Fail,49,34,2,15,34
50,Fail,45,37,4,14,31
50,Fail,49,37,0,9,40
50,Fail,46,42,4,8,38
50,Fail,51,38,0,11,40
50,Fail,55,34,0,10,45
50,Fail,53,31,0,15,38
50,Fail,46,35,0,19,27
50,Fail,43,38,8,11,32
50,Fail,45,36,0,19,26
50,Fail,43,34,7,16,27
50,Fail,55,33,0,9,46
50,Fail,51,33,4,12,39
50,Fail,55,35,0,8,47
50,Fail,53,27,5,15,38
50,Fail,44,31,6,19,25
50,Fail,50,34,3,13,37
50,Fail,52,29,0,16,36
50,Fail,53,38,1,8,45
50,Fail,53,30,0,15,38
50,Fail,45,33,0,15,30
50,Fail,53,27,0,19,34
50,Fail,47,35,5,13,34
50,Fail,42,35,5,18,24
50,Fail,43,33,0,18,25
50,Fail,43,40,0,13,30
50,Fail,47,37,4,12,35
50,Fail,51,35,3,11,40
50,Fail,45,38,3,14,31
50,Fail,46,38,3,13,33
50,Fail,45,36,0,10,35
50,Fail,52,34,0,12,40
50,Fail,45,37,6,12,33
50,Fail,45,39,0,11,34
50,Fail,50,36,0,11,39
50,Fail,55,34,0,10,45
50,Fail,49,38,0,13,36
50,Fail,45,33,6,16,29
50,Fail,57,26,5,12,45
50,Fail,37,41,4,18,19
50,Fail,46,41,0,11,35
50,Fail,43,43,0,11,32
50,Fail,44,38,0,13,31
50,Fail,44,48,0,8,36
50,Fail,48,38,0,12,36
50,Fail,47,36,4,13,34
50,Fail,44,34,0,15,29
50,Fail,50,35,3,12,38
50,Fail,38,42,0,14,24
50,Fail,51,37,0,12,39
50,Fail,44,40,0,15,29
50,Fail,55,34,0,9,46
50,Fail,53,31,1,15,38
50,Fail,48,41,4,7,41
50,Fail,41,34,8,17,24
50,Fail,55,27,6,12,43
50,Fail,54,33,0,12,42
50,Fail,49,34,0,16,33
50,Fail,53,34,4,9,44
50,Fail,47,32,0,18,29
50,Fail,48,37,0,14,34
50,Fail,49,33,3,15,34
50,Fail,54,37,0,9,45
50,Fail,49,35,4,12,37
50,Fail,45,37,5,13,32
50,Fail,45,37,0,12,33
50,Fail,51,34,4,11,40
50,Fail,44,36,9,11,33
50,Fail,45,39,4,12,33
50,Fail,47,34,3,16,31
50,Fail,56,33,4,7,49
50,Fail,45,40,2,13,32
50,Fail,54,35,1,10,44
50,Fail,50,30,9,11,39
50,Fail,52,34,0,13,39
50,Fail,48,37,5,10,38
50,Fail,54,32,3,11,43
50,Fail,47,42,0,9,38
50,Fail,45,38,9,8,37
50,Fail,55,30,0,10,45
50,Fail,42,44,3,11,31
50,Fail,54,33,3,10,44
50,Fail,42,32,0,19,23
50,Fail,47,42,5,6,41
50,Fail,52,35,0,12,40
50,Fail,45,35,0,11,34
50,Fail,45,37,0,16,29
50,Fail,49,29,0,15,34
50,Fail,45,35,5,15,30
50,Fail,49,30,5,16,33
50,Fail,45,43,1,11,34
50,Fail,43,29,10,18,25
50,Fail,49,32,5,14,35
50,Fail,39,39,9,13,26
50,Fail,44,41,0,13,31
50,Fail,45,38,2,15,30
50,Fail,51,38,0,6,45
50,Fail,47,38,0,15,32
50,Fail,50,30,3,17,33
50,Fail,46,36,0,10,36
50,Success,58,33,0,7,51
50,Fail,49,33,7,11,38
50,Fail,50,35,0,10,40
50,Fail,49,28,0,20,29
50,Fail,48,38,0,9,39
50,Fail,54,32,0,11,43
50,Fail,55,35,0,7,48
50,Fail,49,34,0,15,34
50,Fail,39,44,0,12,27
50,Fail,48,41,0,11,37
50,Fail,49,32,5,14,35
50,Fail,45,41,0,14,31
50,Fail,51,32,9,8,43
50,Fail,38,42,0,13,25
50,Fail,38,44,0,13,25
50,Fail,43,35,0,21,22
50,Fail,50,33,3,14,36
50,Fail,56,36,0,8,48
50,Fail,54,34,3,9,45
50,Fail,42,29,0,16,26
50,Fail,51,39,0,10,41
50,Fail,50,33,5,12,38
50,Fail,53,31,0,15,38
50,Fail,42,41,1,16,26
50,Fail,54,34,0,12,42
50,Fail,52,36,0,10,42
50,Fail,48,34,0,15,33
50,Fail,57,25,0,15,42
50,Fail,59,27,2,12,47
50,Fail,41,44,0,12,29
50,Fail,49,33,0,10,39
50,Fail,57,32,0,8,49
50,Fail,46,41,0,10,36
50,Fail,49,35,0,16,33
50,Fail,50,33,0,14,36
50,Fail,45,41,0,14,31
50,Fail,48,40,0,10,38
50,Fail,42,35,6,17,25
50,Fail,47,35,0,15,32
50,Fail,55,34,0,10,45
50,Fail,45,38,7,10,35
50,Fail,49,32,0,16,33
50,Fail,45,28,0,12,33
50,Fail,48,37,0,14,34
50,Fail,51,33,0,9,42
50,Fail,49,29,9,13,36
50,Fail,46,39,6,9,37
50,Fail,47,37,0,9,38
50,Fail,46,39,1,14,32
50,Fail,46,41,1,12,34
50,Fail,57,29,0,10,47
50,Fail,48,36,7,9,39
50,Fail,39,40,0,19,20
50,Fail,48,38,5,9,39
50,Fail,42,34,0,15,27
50,Fail,50,32,2,16,34
50,Fail,45,34,5,16,29
50,Fail,59,28,1,12,47
50,Fail,46,36,7,11,35
50,Fail,51,36,0,7,44
50,Fail,53,33,2,12,41
50,Fail,47,31,1,21,26
50,Fail,42,34,11,13,29
50,Fail,54,38,0,8,46
50,Fail,53,33,0,14,39
50,Fail,53,35,5,7,46
50,Fail,48,29,9,14,34
50,Fail,54,30,1,15,39
50,Fail,49,34,6,11,38
50,Fail,45,36,0,13,32
50,Fail,51,30,8,11,40
50,Fail,51,39,0,10,41
50,Fail,52,31,3,14,38
50,Fail,48,39,0,10,38
50,Fail,38,37,0,16,22
50,Fail,50,37,0,10,40
50,Fail,49,27,4,20,29
50,Fail,52,37,0,11,41
50,Fail,52,29,4,15,37
50,Fail,49,36,0,13,36
50,Fail,48,40,3,9,39
50,Fail,43,43,0,12,31
50,Fail,51,29,0,12,39
50,Fail,40,44,6,10,30
50,Fail,55,34,3,8,47
50,Fail,55,31,0,12,43
50,Fail,56,32,0,11,45
50,Fail,48,36,2,14,34
50,Fail,46,39,0,14,32
50,Fail,44,38,0,11,33
50,Fail,50,28,0,18,32
50,Fail,55,30,0,12,43
50,Fail,52,36,0,12,40
50,Fail,42,35,7,16,26
50,Fail,43,37,6,14,29
50,Fail,50,38,0,12,38
50,Fail,45,37,0,12,33
50,Fail,47,32,1,20,27
50,Fail,48,28,11,13,35
50,Fail,46,37,2,15,31
50,Fail,40,34,0,18,22
50,Fail,51,28,0,19,32
50,Fail,53,39,0,8,45
50,Fail,50,36,0,9,41
50,Fail,46,38,0,13,33
50,Fail,46,39,0,15,31
50,Fail,47,41,0,10,37
50,Fail,48,32,0,17,31
50,Fail,51,40,3,6,45
50,Fail,48,34,3,15,33
50,Fail,47,34,3,16,31
50,Fail,53,34,0,13,40
50,Fail,43,40,0,16,27
50,Fail,48,29,0,14,34
50,Fail,57,27,0,14,43
50,Fail,49,30,6,15,34
50,Fail,51,31,0,14,37
50,Fail,46,41,0,11,35
50,Fail,46,40,0,8,38
50,Fail,37,44,3,16,21
50,Fail,45,40,0,15,30
50,Fail,46,39,0,12,34
50,Fail,50,35,0,14,36
50,Fail,39,42,6,13,26
50,Fail,50,26,9,15,35
50,Fail,48,33,10,9,39
50,Fail,46,38,5,11,35
50,Fail,41,37,0,17,24
50,Fail,41,38,0,14,27
50,Fail,52,32,5,11,41
50,Fail,50,43,0,5,45
50,Fail,45,40,0,11,34
50,Fail,56,35,0,8,48
50,Fail,47,31,0,18,29
50,Fail,46,35,8,11,35
50,Fail,52,28,0,16,36
50,Fail,46,33,0,16,30
50,Fail,57,25,6,12,45
50,Fail,42,39,5,14,28
50,Fail,53,33,3,11,42
50,Fail,48,41,1,10,38
50,Fail,50,34,5,11,39
50,Fail,49,45,0,6,43
50,Fail,48,36,3,13,35
50,Fail,44,38,0,15,29
50,Fail,51,35,0,12,39
50,Fail,54,34,0,10,44
50,Fail,54,34,0,12,42
50,Fail,53,27,5,15,38
50,Fail,39,35,0,18,21
50,Fail,50,39,0,10,40
50,Fail,48,36,0,9,39
50,Fail,45,37,5,13,32
50,Fail,53,28,0,18,35
50,Fail,48,36,1,15,33
50,Fail,52,35,4,9,43
50,Fail,50,39,1,10,40
50,Fail,43,44,0,9,34
50,Fail,51,28,5,16,35
50,Fail,46,42,0,11,35
50,Fail,56,33,0,11,45
50,Fail,51,34,0,14,37
50,Fail,42,28,18,12,30
50,Fail,48,30,2,20,28
50,Fail,38,39,3,20,18
50,Fail,48,26,11,15,33
50,Fail,41,30,0,14,27
50,Fail,50,32,0,17,33
50,Fail,54,32,1,13,41
50,Fail,48,32,11,9,39
50,Fail,52,30,0,17,35
50,Fail,53,26,9,12,41
50,Fail,42,46,0,9,33
50,Fail,45,40,0,11,34
50,Fail,53,36,6,5,48
50,Fail,46,36,0,18,28
50,Fail,48,41,0,10,38
50,Fail,50,34,3,13,37
50,Fail,57,23,3,17,40
50,Fail,48,34,3,15,33
50,Fail,55,30,3,12,43
50,Fail,56,27,2,15,41
50,Fail,48,28,0,12,36
50,Fail,44,39,6,11,33
50,Success,60,30,0,9,51
50,Fail,44,43,2,11,33
50,Fail,50,34,4,12,38
50,Fail,48,35,0,13,35
50,Fail,49,38,2,11,38
50,Fail,44,43,0,9,35
50,Fail,53,33,0,9,44
50,Fail,48,37,10,5,43
50,Fail,47,37,0,11,36
50,Fail,52,39,0,5,47
50,Fail,42,41,5,12,30
50,Fail,52,35,0,9,43
50,Fail,46,35,0,18,28
50,Fail,41,39,0,20,21
50,Fail,50,36,0,11,39
50,Fail,49,27,0,14,35
50,Fail,50,36,0,9,41
50,Fail,47,38,0,15,32
50,Fail,42,32,10,16,26
50,Fail,47,26,13,14,33
50,Fail,46,45,0,8,38
50,Success,56,36,3,5,51
50,Fail,46,43,3,8,38
50,Fail,49,31,2,18,31
50,Fail,53,38,1,8,45
50,Fail,50,30,7,13,37
50,Fail,39,39,3,19,20
50,Fail,47,33,0,16,31
50,Fail,44,31,0,19,25
50,Success,58,36,1,5,53
50,Fail,55,34,0,10,45
50,Fail,43,39,8,10,33
50,Fail,48,34,1,17,31
50,Fail,51,32,0,10,41
50,Fail,50,35,0,12,38
50,Fail,45,35,0,15,30
50,Fail,54,32,2,12,42
50,Fail,46,35,0,14,32
50,Fail,54,34,0,11,43
50,Fail,52,32,0,14,38
50,Fail,43,42,3,12,31
50,Fail,50,32,5,13,37
50,Fail,40,40,7,13,27
50,Fail,44,30,0,17,27
50,Fail,50,33,0,17,33
50,Fail,55,28,5,12,43
50,Fail,48,31,0,12,36
50,Fail,52,31,0,15,37
50,Fail,42,42,2,14,28
50,Fail,50,30,4,16,34
50,Fail,43,36,6,15,28
50,Fail,57,30,2,11,46
50,Fail,45,41,0,14,31
50,Fail,43,40,5,12,31
50,Fail,49,40,0,10,39
50,Fail,48,37,3,12,36
50,Fail,48,34,2,16,32
50,Fail,54,30,0,15,39
50,Fail,52,42,0,5,47
50,Fail,48,33,0,14,34
50,Fail,57,27,0,9,48
50,Fail,50,31,0,18,32
50,Fail,53,29,0,9,44
50,Fail,48,39,1,12,36
50,Fail,51,35,0,14,37
50,Fail,39,42,0,11,28
50,Fail,46,38,1,15,31
50,Fail,50,26,6,18,32
50,Fail,56,29,0,12,44
50,Fail,46,37,3,14,32
50,Fail,40,31,12,17,23
50,Success,56,37,0,6,50
50,Fail,51,38,3,8,43
50,Fail,55,31,1,13,42
50,Fail,52,36,1,11,41
50,Fail,46,38,1,15,31
50,Fail,54,34,3,9,45
50,Fail,48,39,0,6,42
50,Fail,51,27,0,13,38
50,Fail,49,30,6,15,34
50,Fail,55,31,5,9,46
50,Fail,44,32,9,15,29
50,Fail,56,34,0,7,49
50,Fail,52,37,0,11,41
50,Fail,53,35,3,9,44
50,Fail,53,31,6,10,43
50,Fail,45,34,0,17,28
50,Fail,49,35,0,9,40
50,Fail,52,37,3,8,44
50,Fail,45,43,2,10,35
50,Fail,41,33,0,17,24
50,Fail,44,40,4,12,32
50,Fail,51,36,2,11,40
50,Fail,44,36,0,19,25
50,Fail,49,38,3,10,39
50,Fail,51,30,0,11,40
50,Fail,47,37,3,13,34
50,Fail,52,31,4,13,39
50,Fail,56,33,1,10,46
50,Fail,41,41,0,14,27
50,Fail,49,33,7,11,38
50,Fail,55,27,0,8,47
50,Fail,50,33,4,13,37
50,Fail,45,34,2,19,26
50,Fail,45,33,7,15,30
50,Fail,40,39,8,13,27
50,Fail,52,34,0,9,43
50,Fail,47,42,2,9,38
50,Fail,48,36,0,13,35
50,Fail,48,35,1,16,32
50,Fail,49,41,0,8,41
50,Fail,41,41,10,8,33
50,Fail,57,32,0,11,46
50,Fail,43,36,9,12,31
50,Fail,46,35,8,11,35
50,Fail,43,39,0,16,27
50,Fail,57,32,0,10,47
50,Fail,52,34,5,9,43
50,Fail,50,33,0,10,40
50,Fail,49,40,2,9,40
50,Fail,49,34,0,15,34
50,Fail,37,41,0,21,16
50,Fail,46,36,3,15,31
50,Fail,47,34,0,12,35
50,Fail,48,34,4,14,34
50,Fail,43,37,6,14,29
50,Fail,48,36,2,14,34
50,Fail,52,37,0,11,41
50,Fail,49,31,0,19,30
50,Fail,54,35,0,8,46
50,Fail,43,31,0,19,24
50,Fail,48,32,0,15,33
50,Fail,52,32,0,13,39
50,Fail,46,36,1,17,29
50,Fail,53,31,6,10,43
50,Fail,45,37,5,13,32
50,Success,57,33,3,7,50
50,Fail,50,37,0,8,42
50,Fail,42,30,8,20,22
50,Fail,49,36,5,10,39
50,Fail,46,32,8,14,32
50,Fail,47,32,7,14,33
50,Fail,51,36,0,10,41
50,Fail,42,35,0,13,29
50,Fail,49,38,4,9,40
50,Fail,56,35,0,9,47
50,Fail,56,30,0,12,44
50,Fail,42,42,0,12,30
50,Fail,46,40,0,5,41
50,Fail,48,31,0,12,36
50,Fail,55,32,0,12,43
50,Fail,58,29,0,13,45
50,Fail,48,34,0,18,30
50,Fail,55,36,1,8,47
50,Fail,52,35,0,12,40
50,Fail,42,42,0,11,31
50,Fail,49,32,0,15,34
50,Fail,55,31,4,10,45
50,Fail,51,29,0,13,38
50,Fail,38,50,2,10,28
50,Fail,39,40,11,10,29
50,Fail,51,35,1,13,38
50,Fail,45,34,0,11,34
50,Fail,49,31,2,18,31
50,Fail,51,39,2,8,43
50,Fail,56,29,0,12,44
50,Fail,51,29,8,12,39
50,Fail,58,33,0,9,49
50,Fail,56,34,0,10,46
50,Fail,38,46,0,8,30
50,Fail,50,29,10,11,39
50,Fail,54,34,1,11,43
50,Success,59,35,1,5,54
50,Fail,50,35,0,8,42
50,Fail,50,37,4,9,41
50,Fail,46,39,0,14,32
50,Fail,46,44,0,7,39
50,Fail,56,31,4,9,47
50,Fail,45,40,0,15,30
50,Fail,52,39,1,8,44
50,Fail,49,39,5,7,42
50,Fail,51,29,0,17,34
50,Fail,45,38,0,16,29
50,Fail,36,40,9,15,21
50,Fail,48,40,0,12,36
50,Fail,53,34,2,11,42
50,Fail,45,36,0,15,30
50,Fail,45,40,0,11,34
50,Fail,48,33,0,13,35
50,Fail,52,36,0,12,40
50,Fail,42,33,0,14,28
50,Fail,42,41,0,14,28
50,Fail,49,31,0,17,32
50,Fail,41,40,2,17,24
50,Fail,49,38,0,13,36
50,Fail,42,39,0,12,30
50,Fail,45,32,4,19,26
50,Fail,50,31,0,16,34
50,Fail,45,42,1,12,33
50,Fail,52,40,1,7,45
50,Fail,53,35,1,11,42
50,Fail,51,36,0,13,38
50,Fail,49,31,3,17,32
50,Fail,49,32,6,13,36
50,Fail,39,47,2,12,27
50,Fail,46,40,0,13,33
50,Fail,45,38,2,15,30
50,Fail,50,33,2,15,35
50,Fail,45,42,0,8,37
50,Fail,46,34,8,12,34
50,Fail,49,36,7,8,41
50,Fail,51,31,6,12,39
50,Fail,53,36,0,9,44
50,Fail,40,42,1,17,23
50,Fail,47,37,0,12,35
50,Fail,47,36,0,14,33
50,Fail,46,35,6,13,33
50,Fail,46,42,0,8,38
50,Fail,50,39,0,11,39
50,Fail,47,30,0,16,31
50,Fail,49,34,7,10,39
50,Fail,48,31,0,14,34
50,Fail,48,36,0,15,33
50,Fail,47,38,0,11,36
50,Fail,57,31,0,10,47
50,Fail,42,39,0,19,23
50,Fail,49,42,1,8,41
50,Fail,45,36,5,14,31
50,Fail,51,29,6,14,37
50,Fail,49,32,0,18,31
50,Fail,54,33,0,11,43
50,Fail,51,31,3,15,36
50,Fail,55,34,4,7,48
50,Fail,50,34,0,9,41
50,Fail,56,31,2,11,45
50,Fail,52,39,1,8,44
50,Fail,48,36,0,13,35
50,Fail,51,34,0,11,40
50,Fail,51,39,0,8,43
50,Fail,47,40,0,13,34
50,Fail,46,38,4,12,34
50,Fail,50,33,0,13,37
50,Fail,51,28,0,11,40
50,Fail,47,42,2,9,38
50,Fail,49,37,3,11,38
50,Fail,48,40,0,9,39
50,Fail,42,41,5,12,30
50,Fail,51,35,7,7,44
50,Fail,47,44,0,6,41
50,Fail,51,29,0,14,37
50,Fail,48,38,5,9,39
50,Fail,56,34,0,10,46
50,Fail,47,38,0,11,36
50,Fail,37,38,0,8,29
50,Fail,47,36,0,16,31
50,Fail,48,37,3,12,36
50,Fail,47,34,0,14,33
50,Fail,52,36,2,10,42
50,Fail,56,21,4,19,37
50,Fail,41,39,4,16,25
50,Fail,50,40,0,9,41
50,Fail,54,32,2,12,42
50,Fail,52,40,0,5,47
50,Fail,47,38,0,15,32
50,Fail,48,35,3,14,34
50,Fail,51,30,0,14,37
50,Fail,53,32,0,15,38
50,Fail,53,36,0,8,45
50,Fail,48,42,2,8,40
50,Fail,54,32,0,9,45
50,Fail,52,28,4,16,36
50,Fail,51,26,0,11,40
50,Fail,46,39,4,11,35
50,Fail,53,32,0,15,38
50,Fail,40,39,7,14,26
50,Fail,47,42,0,9,38
50,Fail,50,41,3,6,44
50,Fail,48,38,4,10,38
50,Fail,50,38,0,11,39
50,Fail,42,41,1,16,26
50,Fail,48,39,0,10,38
50,Fail,48,40,0,10,38
50,Fail,43,35,9,13,30
50,Fail,49,44,0,5,44
50,Fail,51,31,6,12,39
50,Fail,50,38,0,12,38
50,Fail,46,35,8,11,35
50,Fail,55,32,3,10,45
50,Fail,40,27,19,14,26
50,Fail,41,38,5,16,25
50,Fail,49,36,0,11,38
50,Fail,53,32,9,6,47
50,Fail,49,39,1,11,38
50,Fail,51,34,0,14,37
50,Fail,48,42,2,8,40
50,Fail,46,36,0,15,31
50,Fail,41,38,0,17,24
50,Fail,46,36,3,15,31
50,Fail,41,37,0,16,25
50,Fail,54,31,0,12,42
50,Fail,39,42,9,10,29
50,Fail,43,38,11,8,35
50,Fail,48,38,0,12,36
50,Fail,45,40,2,13,32
50,Fail,53,40,2,5,48
50,Fail,51,32,0,16,35
50,Fail,52,39,2,7,45
50,Fail,46,34,0,13,33
50,Fail,51,35,1,13,38
50,Fail,54,32,0,13,41
50,Fail,49,41,0,9,40
50,Fail,49,31,0,10,39
50,Fail,48,35,0,15,33
50,Fail,45,40,1,14,31
50,Fail,45,33,0,8,37
50,Fail,57,28,3,12,45
50,Fail,52,34,0,7,45
50,Fail,46,38,0,15,31
50,Fail,49,34,0,9,40
50,Fail,36,40,0,19,17
50,Fail,50,35,0,11,39
50,Fail,49,40,1,10,39
50,Success,59,31,1,9,50
50,Fail,56,30,0,14,42
50,Fail,45,39,1,15,30
50,Fail,42,39,0,16,26
50,Fail,59,29,1,11,48
50,Fail,49,31,0,12,37
50,Fail,53,31,0,9,44
50,Fail,48,36,7,9,39
50,Fail,47,38,0,11,36
50,Fail,47,42,0,10,37
50,Fail,40,40,0,13,27
50,Fail,47,37,3,13,34
50,Fail,49,39,0,12,37
50,Fail,46,37,5,12,34
50,Fail,55,30,2,13,42
50,Fail,53,38,0,9,44
50,Fail,47,38,0,15,32
50,Fail,47,35,6,12,35
50,Fail,51,32,5,12,39
50,Fail,48,40,0,11,37
50,Fail,52,31,0,14,38
50,Fail,47,35,0,15,32
50,Fail,51,23,0,20,31
50,Fail,46,42,0,11,35
50,Fail,46,39,0,15,31
50,Fail,53,33,1,13,40
50,Fail,43,41,0,11,32
50,Fail,48,39,0,13,35
50,Fail,46,38,0,8,38
50,Fail,52,32,0,5,47
50,Fail,52,31,4,13,39
50,Fail,53,38,0,9,44
50,Fail,44,35,0,15,29
50,Fail,50,33,0,17,33
50,Fail,46,41,3,10,36
50,Fail,56,27,3,14,42
50,Fail,51,31,0,15,36
50,Fail,53,32,6,9,44
50,Fail,53,31,0,12,41
50,Fail,51,34,2,13,38
50,Fail,53,28,2,17,36
50,Fail,45,28,0,15,30
50,Fail,46,38,0,13,33
50,Fail,42,35,7,16,26
50,Fail,49,38,0,12,37
50,Fail,50,31,6,13,37
50,Fail,51,36,0,11,40
50,Fail,49,29,0,20,29
50,Fail,51,38,2,9,42
50,Fail,47,33,5,15,32
50,Fail,46,40,0,12,34
50,Fail,39,43,0,15,24
50,Fail,49,31,0,14,35
50,Fail,48,43,0,9,39
50,Fail,45,47,3,5,40
50,Fail,46,36,0,15,31
50,Fail,46,35,4,15,31
50,Fail,47,34,1,18,29
50,Fail,53,28,5,14,39
50,Fail,50,39,1,10,40
50,Fail,55,33,2,10,45
50,Fail,45,42,0,11,34
50,Success,58,34,0,7,51
50,Fail,53,37,0,7,46
50,Fail,51,37,0,10,41
50,Fail,46,37,0,14,32
50,Fail,49,42,2,7,42
50,Fail,49,32,0,18,31
50,Fail,45,40,1,14,31
50,Fail,46,36,0,14,32
50,Fail,54,28,4,14,40
50,Fail,44,45,0,9,35
50,Fail,56,34,1,9,47
50,Fail,46,38,0,10,36
50,Fail,57,32,1,10,47
50,Fail,51,34,1,14,37
50,Fail,48,35,7,10,38
50,Fail,47,43,0,9,38
50,Fail,45,33,3,19,26
50,Fail,44,38,0,17,27
50,Fail,51,34,0,14,37
50,Fail,49,33,3,15,34
50,Fail,45,33,11,11,34
50,Fail,50,30,0,18,32
50,Fail,53,36,0,10,43
50,Fail,44,42,0,13,31
50,Fail,46,27,10,17,29
50,Fail,51,38,0,8,43
50,Fail,46,39,2,13,33
50,Fail,43,41,0,12,31
50,Fail,45,38,0,13,32
50,Fail,48,37,4,11,37
50,Fail,44,41,2,13,31
50,Fail,54,37,0,6,48
50,Fail,48,33,0,12,36
50,Fail,37,37,0,16,21
50,Fail,50,36,1,13,37
50,Fail,44,44,0,10,34
50,Fail,50,36,1,13,37
50,Fail,50,40,1,9,41
50,Fail,47,38,2,13,34
50,Fail,53,25,0,14,39
50,Fail,50,35,0,9,41
50,Fail,39,34,10,17,22
50,Fail,47,36,0,12,35
50,Fail,53,30,0,12,41
50,Fail,42,40,0,9,33
50,Fail,48,40,0,11,37
50,Fail,49,37,0,14,35
50,Fail,47,33,0,12,35
50,Fail,47,35,1,17,30
50,Fail,43,41,0,8,35
50,Fail,48,35,4,13,35
50,Success,56,38,0,6,50
50,Fail,46,35,7,12,34
50,Fail,44,29,5,22,22
50,Fail,52,32,0,14,38
50,Fail,50,31,0,13,37
50,Fail,46,36,2,16,30
50,Fail,47,39,0,12,35
50,Fail,40,46,2,12,28
50,Fail,45,29,9,17,28
50,Fail,50,42,0,3,47
50,Fail,51,34,3,12,39
50,Fail,45,32,11,12,33
50,Fail,46,40,2,12,34
50,Fail,46,36,6,12,34
50,Fail,44,33,0,23,21
50,Fail,46,38,2,14,32
50,Fail,49,34,7,10,39
50,Fail,46,37,0,10,36
50,Fail,50,36,2,12,38
50,Fail,54,31,3,12,42
50,Fail,52,36,0,11,41
50,Fail,42,41,2,15,27
50,Fail,45,41,3,11,34
50,Fail,44,30,0,21,23
50,Fail,46,35,0,12,34
50,Fail,45,39,2,14,31
50,Fail,50,36,4,10,40
50,Fail,44,36,4,16,28
50,Fail,52,37,0,10,42
50,Fail,45,31,4,20,25
50,Fail,56,30,0,10,46
50,Fail,45,42,0,9,36
50,Fail,46,37,0,13,33
50,Fail,53,35,0,6,47
50,Fail,51,34,3,12,39
50,Fail,45,34,0,9,36
50,Fail,40,41,8,11,29
50,Fail,43,33,0,15,28
50,Fail,48,36,4,12,36
50,Fail,50,37,0,9,41
50,Fail,44,34,0,17,27
50,Fail,41,40,5,14,27
50,Fail,51,35,5,9,42
50,Fail,44,44,0,12,32
50,Fail,41,32,0,10,31
50,Fail,43,34,7,16,27
50,Fail,45,36,4,15,30
50,Fail,46,44,0,9,37
50,Fail,47,35,0,18,29
50,Fail,38,44,2,16,22
50,Fail,54,34,0,7,47
50,Fail,50,42,1,7,43
50,Fail,49,34,4,13,36
50,Fail,45,39,3,13,32
50,Fail,46,41,0,11,35
50,Fail,52,38,2,8,44
50,Fail,45,31,0,12,33
50,Fail,41,44,0,15,26
50,Fail,52,40,2,6,46
50,Fail,55,32,1,12,43
50,Fail,39,47,0,11,28
50,Fail,51,40,0,5,46
50,Fail,43,39,5,13,30
50,Fail,50,37,2,11,39
50,Fail,47,41,0,11,36
50,Fail,47,33,3,17,30
50,Fail,41,34,12,13,28
50,Fail,43,40,1,16,27
50,Fail,48,37,5,10,38
50,Fail,48,34,5,13,35
50,Fail,51,31,0,9,42
50,Fail,50,38,0,11,39
50,Fail,52,31,0,9,43
50,Fail,47,37,1,15,32
50,Fail,42,43,0,10,32
50,Fail,56,33,3,8,48
50,Fail,51,34,2,13,38
50,Fail,41,39,0,16,25
50,Fail,42,40,0,18,24
50,Fail,44,45,4,7,37
50,Fail,58,26,1,15,43
50,Fail,49,34,0,13,36
50,Fail,50,41,0,4,46
50,Fail,45,33,6,16,29
50,Fail,50,32,5,13,37
50,Fail,45,27,12,16,29
50,Fail,49,35,8,8,41
50,Fail,52,36,0,9,43
50,Fail,40,40,6,14,26
50,Fail,48,37,3,12,36
50,Fail,51,35,2,12,39
50,Fail,41,36,0,11,30
50,Fail,42,35,10,13,29
50,Fail,45,46,0,7,38
50,Fail,52,36,0,11,41
50,Fail,54,33,1,12,42
50,Fail,46,38,6,10,36
50,Fail,47,34,3,16,31
50,Fail,49,38,2,11,38
50,Fail,50,31,5,14,36
50,Fail,45,35,0,13,32
50,Fail,48,28,6,18,30
50,Fail,54,36,0,6,48
50,Fail,50,34,0,12,38
50,Fail,43,34,0,17,26
50,Fail,46,38,0,13,33
50,Fail,49,37,0,13,36
50,Fail,49,36,2,13,36
50,Fail,43,39,0,16,27
50,Fail,47,30,0,15,32
50,Fail,44,36,5,15,29
50,Fail,54,37,0,6,48
50,Fail,45,35,0,11,34
50,Fail,46,36,1,17,29
50,Fail,47,39,0,12,35
50,Fail,46,34,0,14,32
50,Fail,54,28,5,13,41
50,Fail,50,38,1,11,39
50,Fail,56,33,2,9,47
50,Fail,51,35,0,11,40
50,Fail,42,47,0,9,33
50,Fail,49,34,7,10,39
50,Fail,50,35,1,14,36
50,Fail,55,26,0,13,42
50,Fail,47,34,2,17,30
50,Fail,47,37,0,14,33
50,Fail,45,34,5,16,29
50,Fail,43,42,0,13,30
50,Fail,49,43,2,6,43
50,Fail,51,38,2,9,42
50,Fail,40,47,6,7,33
50,Fail,53,30,9,8,45
50,Fail,52,37,0,11,41
50,Fail,37,36,0,15,22
50,Fail,55,29,6,10,45
50,Fail,44,41,5,10,34
50,Fail,44,33,0,16,28
50,Fail,44,32,9,15,29
50,Fail,50,34,0,9,41
50,Fail,47,39,0,10,37
50,Fail,42,40,4,14,28
50,Fail,47,34,6,13,34
50,Fail,44,34,6,16,28
50,Fail,43,39,0,7,36
50,Fail,48,42,0,8,40
50,Fail,49,35,3,13,36
50,Fail,48,34,0,15,33
50,Fail,48,41,1,10,38
50,Fail,43,38,0,16,27
50,Fail,49,31,6,14,35
50,Fail,47,32,0,18,29
50,Fail,45,28,12,15,30
50,Fail,44,39,1,16,28
50,Fail,44,35,0,11,33
50,Fail,46,38,0,8,38
50,Fail,47,39,3,11,36
50,Fail,40,40,3,17,23
50,Fail,48,40,3,9,39
50,Fail,51,38,0,7,44
50,Fail,54,28,0,15,39
50,Fail,51,35,0,10,41
50,Fail,45,43,2,10,35
50,Fail,50,36,5,9,41
50,Fail,46,36,0,8,38
50,Fail,45,36,0,19,26
50,Fail,45,32,0,17,28
50,Fail,57,34,0,9,48
50,Fail,50,36,7,7,43
50,Fail,44,39,4,13,31
50,Fail,51,39,0,8,43
50,Fail,43,38,0,15,28
50,Fail,46,35,4,15,31
50,Fail,53,34,0,9,44
50,Fail,51,28,0,16,35
50,Fail,43,33,0,13,30
50,Fail,53,35,1,11,42
50,Fail,41,41,0,11,30
50,Fail,49,35,0,12,37
50,Fail,47,32,0,20,27
50,Fail,47,37,0,15,32
50,Fail,40,44,4,12,28
50,Fail,45,36,5,14,31
50,Fail,50,34,0,10,40
50,Fail,55,33,0,9,46
50,Fail,51,32,0,14,37
50,Fail,40,35,0,18,22
50,Fail,54,31,0,10,44
50,Fail,43,42,0,7,36
50,Fail,54,29,5,12,42
50,Fail,46,40,0,11,35
50,Fail,55,35,0,10,45
50,Fail,47,47,0,6,41
50,Fail,51,31,0,13,38
50,Fail,51,43,0,5,46
50,Fail,46,38,0,10,36
50,Fail,51,35,0,11,40
50,Fail,46,36,8,10,36
50,Fail,49,29,0,13,36
50,Fail,50,38,0,11,39
50,Fail,48,26,0,16,32
50,Fail,48,30,9,13,35
50,Fail,51,28,6,15,36
50,Fail,52,37,0,11,41
50,Fail,47,39,0,14,33
50,Fail,51,30,6,13,38
50,Fail,46,31,0,16,30
50,Fail,50,35,5,10,40
50,Fail,44,42,0,9,35
50,Fail,49,38,1,12,37
50,Fail,38,44,5,13,25
50,Fail,52,34,5,9,43
50,Fail,52,36,0,9,43
50,Fail,48,37,4,11,37
50,Fail,50,38,0,12,38
50,Fail,53,37,1,9,44
50,Fail,46,31,9,14,32
50,Fail,45,36,7,12,33
50,Fail,52,31,7,10,42
50,Fail,59,22,9,10,49
50,Fail,47,33,0,17,30
50,Fail,45,43,1,11,34
50,Fail,54,32,1,13,41
50,Fail,50,32,2,16,34
50,Fail,45,39,4,12,33
50,Fail,44,39,6,11,33
50,Fail,49,41,2,8,41
50,Fail,50,32,4,14,36
50,Fail,56,36,0,8,48
50,Fail,43,45,5,7,36
50,Fail,43,42,7,8,35
50,Fail,48,36,4,12,36
50,Fail,54,29,0,12,42
50,Fail,47,40,0,12,35
50,Success,63,24,0,11,52
50,Success,60,29,1,10,50
50,Fail,49,30,4,17,32
50,Fail,45,36,0,19,26
50,Fail,46,35,5,14,32
50,Fail,59,29,0,12,47
50,Fail,50,32,0,14,36
50,Fail,46,30,0,17,29
50,Fail,45,31,7,17,28
50,Fail,54,32,0,8,46
50,Fail,49,40,0,11,38
50,Fail,45,32,7,16,29
50,Fail,53,37,0,8,45
50,Fail,43,45,0,9,34
50,Fail,48,38,3,11,37
50,Fail,48,37,0,14,34
50,Fail,50,37,2,11,39
50,Fail,46,39,1,14,32
50,Fail,47,31,10,12,35
50,Fail,47,38,0,12,35
50,Fail,50,36,5,9,41
50,Fail,43,40,0,15,28
50,Fail,39,41,0,12,27
50,Fail,55,35,0,9,46
50,Fail,47,35,0,15,32
50,Fail,45,34,0,11,34
50,Fail,48,39,0,9,39
50,Fail,49,34,0,12,37
50,Fail,50,44,0,6,44
50,Fail,43,27,0,22,21
50,Fail,47,34,0,16,31
50,Fail,50,33,0,15,35
50,Fail,49,34,0,15,34
50,Fail,47,38,0,10,37
50,Fail,51,39,2,8,43
50,Fail,52,29,3,16,36
50,Fail,41,41,3,15,26
50,Fail,45,35,9,11,34
50,Fail,55,35,4,6,49
50,Fail,46,36,4,14,32
50,Fail,45,32,8,15,30
50,Fail,47,36,4,13,34
50,Fail,55,31,0,9,46
50,Fail,46,38,0,13,33
50,Fail,51,31,3,15,36
50,Fail,47,32,8,13,34
50,Fail,48,30,6,16,32
50,Fail,49,31,0,14,35
50,Fail,42,33,3,22,20
50,Fail,48,34,0,12,36
50,Fail,46,39,1,14,32
50,Fail,45,37,8,10,35
50,Fail,47,43,0,5,42
50,Fail,58,30,2,10,48
50,Fail,46,36,7,11,35
50,Fail,50,31,0,5,45
50,Fail,50,35,0,8,42
50,Fail,48,35,0,10,38
50,Fail,46,42,0,11,35
50,Fail,51,31,2,16,35
50,Fail,49,35,0,14,35
50,Fail,47,39,1,13,34
50,Fail,52,36,0,9,43
50,Fail,54,34,3,9,45
50,Fail,44,41,0,11,33
50,Fail,38,36,9,17,21
50,Fail,44,37,0,12,32
50,Fail,43,43,2,12,31
50,Fail,46,32,0,18,28
50,Fail,43,38,1,18,25
50,Fail,46,33,0,17,29
50,Fail,42,36,0,19,23
50,Fail,44,37,4,15,29
50,Fail,51,37,1,11,40
50,Fail,47,40,0,12,35
50,Fail,45,41,0,8,37
50,Fail,53,35,0,7,46
50,Fail,44,37,0,13,31
50,Fail,50,38,0,12,38
50,Fail,49,33,3,15,34
50,Fail,41,34,5,20,21
50,Fail,43,45,0,10,33
50,Fail,45,41,0,14,31
50,Fail,43,37,5,15,28
50,Fail,51,26,11,12,39
50,Fail,44,35,5,16,28
50,Fail,55,31,1,13,42
50,Fail,45,44,2,9,36
50,Fail,40,37,9,14,26
50,Fail,49,32,0,13,36
50,Fail,51,28,8,13,38
50,Fail,49,35,0,11,38
50,Fail,46,35,0,15,31
50,Fail,52,28,4,16,36
50,Success,60,26,0,10,50
50,Fail,43,36,10,11,32
50,Fail,46,37,0,10,36
50,Fail,40,31,10,19,21
50,Fail,44,35,0,15,29
50,Fail,44,33,0,15,29
50,Fail,51,33,0,12,39
50,Fail,53,30,2,15,38
50,Fail,55,31,6,8,47
50,Fail,47,41,1,11,36
50,Fail,50,36,2,12,38
50,Fail,52,32,4,12,40
50,Fail,53,28,0,16,37
50,Fail,54,31,5,10,44
50,Fail,48,37,0,15,33
50,Fail,57,30,2,11,46
50,Fail,43,37,0,19,24
50,Fail,49,32,2,17,32
50,Fail,50,33,9,8,42
50,Fail,52,39,2,7,45
50,Fail,51,31,3,15,36
50,Fail,50,36,4,10,40
50,Fail,42,42,3,13,29
50,Fail,41,29,10,20,21
50,Fail,42,32,0,17,25
50,Fail,40,45,3,12,28
50,Fail,47,40,0,10,37
50,Fail,50,37,1,12,38
50,Fail,47,33,0,13,34
50,Fail,52,37,1,10,42
50,Fail,42,41,1,16,26
50,Fail,49,34,0,12,37
50,Fail,58,30,0,12,46
50,Fail,42,36,8,14,28
50,Fail,57,25,2,16,41
50,Fail,43,37,8,12,31
50,Fail,46,37,1,16,30
50,Fail,50,38,1,11,39
50,Fail,45,39,0,12,33
50,Fail,46,33,0,15,31
50,Success,62,26,0,10,52
50,Fail,44,32,13,11,33
50,Fail,43,40,2,15,28
50,Fail,45,38,0,14,31
50,Fail,43,33,7,17,26
50,Fail,42,38,6,14,28
50,Fail,53,29,4,14,39
50,Fail,49,40,0,11,38
50,Fail,49,36,0,14,35
50,Fail,45,34,6,15,30
50,Fail,49,30,1,20,29
50,Success,59,31,1,9,50
50,Fail,45,40,4,11,34
50,Fail,43,42,1,14,29
50,Fail,48,35,0,12,36
50,Fail,44,37,3,16,28
50,Fail,50,34,0,14,36
50,Fail,43,36,0,16,27
50,Fail,48,33,0,15,33
50,Fail,41,39,4,16,25
50,Fail,53,32,4,11,42
50,Fail,55,33,0,11,44
50,Fail,54,34,2,10,44
50,Fail,54,35,4,7,47
50,Fail,54,33,0,12,42
50,Fail,38,39,0,12,26
50,Fail,50,27,0,21,29
50,Fail,54,23,0,13,41
50,Fail,53,34,0,10,43
50,Fail,46,37,1,16,30
50,Fail,53,37,2,8,45
50,Fail,48,36,2,14,34
50,Fail,55,32,0,9,46
50,Fail,54,25,5,16,38
50,Fail,53,33,4,10,43
50,Fail,44,39,5,12,32
50,Success,57,31,6,6,51
50,Fail,47,37,0,9,38
50,Fail,47,43,0,7,40
50,Fail,40,39,0,13,27
50,Fail,46,33,9,12,34
50,Fail,46,36,0,11,35
50,Fail,51,32,0,10,41
50,Fail,47,36,2,15,32
50,Fail,51,32,0,7,44
50,Fail,40,38,0,15,25
50,Fail,43,38,0,11,32
50,Fail,51,40,0,8,43
50,Fail,53,28,0,15,38
50,Fail,46,39,3,12,34
50,Fail,53,32,8,7,46
50,Fail,50,38,0,7,43
50,Fail,45,36,0,18,27
50,Fail,50,32,5,13,37
50,Fail,50,35,1,14,36
50,Fail,43,37,0,12,31
50,Fail,52,37,2,9,43
50,Fail,52,35,0,10,42
50,Fail,45,42,2,11,34
50,Fail,50,36,0,13,37
50,Fail,40,39,2,19,21
50,Fail,49,38,0,12,37
50,Fail,49,42,0,9,40
50,Fail,43,44,3,10,33
50,Fail,46,33,3,18,28
50,Fail,50,40,4,6,44
50,Fail,50,38,3,9,41
50,Fail,46,43,0,9,37
50,Fail,52,33,0,7,45
50,Fail,49,38,0,12,37
50,Fail,54,33,0,9,45
50,Fail,43,33,3,21,22
50,Fail,51,35,0,10,41
50,Fail,43,42,5,10,33
50,Fail,46,39,0,12,34
50,Fail,54,38,0,8,46
50,Fail,50,36,0,14,36
50,Fail,42,46,1,11,31
50,Fail,51,29,0,16,35
50,Fail,51,33,0,9,42
50,Fail,39,42,4,15,24
50,Fail,51,28,0,14,37
50,Fail,52,33,0,11,41
50,Fail,55,36,0,6,49
50,Fail,46,38,1,15,31
50,Fail,49,35,0,12,37
50,Fail,54,34,3,9,45
50,Fail,53,31,4,12,41
50,Fail,50,39,0,11,39
50,Fail,42,35,6,17,25
50,Fail,54,30,0,8,46
50,Success,60,27,3,10,50
50,Fail,47,39,0,11,36
50,Fail,42,42,4,12,30
50,Fail,46,37,0,17,29
50,Fail,45,33,4,18,27
50,Fail,44,37,0,12,32
50,Fail,40,35,7,18,22
50,Fail,51,25,0,17,34
50,Fail,47,39,1,13,34
50,Fail,54,36,1,9,45
50,Fail,46,35,0,14,32
50,Fail,48,35,0,14,34
50,Success,59,27,0,7,52
50,Fail,46,42,5,7,39
50,Fail,51,33,2,14,37
50,Fail,46,30,0,13,33
50,Fail,48,32,2,18,30
50,Fail,53,42,1,4,49
50,Fail,40,34,0,10,30
50,Fail,43,35,11,11,32
50,Fail,45,42,4,9,36
50,Fail,53,29,6,12,41
50,Fail,54,31,3,12,42
50,Fail,47,37,0,13,34
50,Fail,49,35,0,15,34
50,Fail,48,34,0,10,38
50,Fail,42,40,2,16,26
50,Fail,53,38,2,7,46
50,Fail,47,33,0,16,31
50,Fail,51,33,0,15,36
50,Fail,54,34,2,10,44
50,Fail,45,32,0,14,31
50,Fail,53,34,4,9,44
50,Fail,50,39,0,9,41
50,Fail,53,28,0,14,39
50,Fail,54,34,0,11,43
50,Fail,48,39,0,10,38
50,Fail,48,35,3,14,34
50,Fail,48,38,0,10,38
50,Fail,48,34,0,15,33
50,Fail,50,37,3,10,40
50,Fail,50,36,0,14,36
50,Fail,47,40,2,11,36
50,Success,59,33,1,7,52
50,Fail,53,36,3,8,45
50,Fail,50,31,0,12,38
50,Fail,48,39,2,11,37
50,Fail,53,37,0,6,47
50,Fail,47,37,1,15,32
50,Fail,42,39,0,18,24
50,Fail,52,32,1,15,37
50,Fail,53,33,0,14,39
50,Fail,46,29,0,18,28
50,Success,62,30,2,6,56
50,Fail,50,30,4,16,34
50,Fail,52,38,3,7,45
50,Fail,47,42,0,11,36
50,Fail,47,36,3,14,33
50,Fail,47,37,7,9,38
50,Fail,41,38,8,13,28
50,Fail,51,32,0,11,40
50,Fail,47,39,2,12,35
50,Fail,46,38,0,14,32
50,Fail,49,33,4,14,35
50,Fail,49,34,1,16,33
50,Fail,39,37,0,20,19
50,Fail,52,32,2,14,38
50,Fail,51,25,0,17,34
50,Fail,45,35,4,16,29
50,Fail,50,33,0,17,33
50,Fail,52,33,1,14,38
50,Fail,47,37,0,15,32
50,Fail,45,36,4,15,30
50,Fail,46,39,0,14,32
50,Fail,53,32,2,13,40
50,Fail,50,35,4,11,39
50,Fail,43,41,1,15,28
50,Fail,51,38,3,8,43
50,Fail,42,38,0,13,29
50,Fail,40,42,0,16,24
50,Fail,50,29,0,14,36
50,Fail,48,37,0,15,33
50,Fail,44,42,0,13,31
50,Fail,49,32,0,19,30
50,Fail,41,36,4,19,22
50,Fail,54,35,1,10,44
50,Fail,47,37,5,11,36
50,Fail,50,38,0,12,38
50,Fail,47,30,0,14,33
50,Fail,53,34,0,13,40
50,Fail,51,36,0,12,39
50,Fail,49,37,0,6,43
50,Fail,46,34,7,13,33
50,Fail,48,30,8,14,34
50,Fail,51,33,0,14,37
50,Fail,48,32,0,10,38
50,Fail,49,34,0,16,33
50,Fail,45,39,0,10,35
50,Fail,52,38,3,7,45
50,Fail,52,37,0,8,44
50,Fail,51,32,8,9,42
50,Fail,49,38,0,12,37
50,Fail,47,38,2,13,34
50,Fail,43,40,6,11,32
50,Fail,42,33,12,13,29
50,Fail,49,34,3,14,35
50,Fail,45,42,9,4,41
50,Fail,48,37,0,10,38
50,Fail,52,35,1,12,40
50,Fail,49,37,0,13,36
50,Fail,49,29,0,17,32
50,Fail,53,37,1,9,44
50,Fail,54,32,0,13,41
50,Fail,53,35,0,9,44
50,Fail,46,34,6,14,32
50,Fail,48,37,0,12,36
50,Fail,53,28,0,16,37
50,Fail,49,36,3,12,37
50,Fail,44,44,0,10,34
50,Fail,44,35,0,12,32
50,Fail,43,36,3,18,25
50,Fail,44,37,5,14,30
50,Fail,45,40,0,14,31
50,Fail,49,31,0,16,33
50,Success,57,35,1,7,50
50,Fail,57,30,2,11,46
50,Fail,53,34,0,11,42
50,Fail,49,36,3,12,37
50,Fail,44,36,7,13,31
50,Fail,53,36,0,10,43
50,Fail,52,33,3,12,40
50,Fail,51,38,4,7,44
50,Fail,51,38,2,9,42
50,Fail,45,40,3,12,33
50,Success,58,30,4,8,50
50,Fail,48,32,0,17,31
50,Fail,44,40,0,11,33
50,Fail,45,30,0,12,33
50,Fail,50,31,0,12,38
50,Fail,52,33,0,13,39
50,Fail,54,35,0,9,45
50,Fail,44,40,0,13,31
50,Fail,50,38,3,9,41
50,Fail,51,30,6,13,38
50,Fail,39,38,0,13,26
50,Fail,50,31,0,11,39
50,Fail,44,33,0,15,29
50,Fail,50,33,5,12,38
50,Fail,48,37,2,13,35
50,Fail,47,34,5,14,33
50,Fail,48,38,0,12,36
50,Fail,32,36,0,13,19
50,Fail,41,37,0,17,24
50,Fail,37,45,0,18,19
50,Fail,44,40,0,11,33
50,Fail,55,33,4,8,47
50,Fail,54,35,0,9,45
50,Fail,53,32,3,12,41
50,Fail,49,33,5,13,36
50,Fail,54,32,0,9,45
50,Fail,54,33,1,12,42
50,Fail,51,32,1,16,35
50,Fail,46,44,0,9,37
50,Fail,57,28,2,13,44
50,Fail,41,42,5,12,29
50,Fail,53,36,0,11,42
50,Fail,49,36,4,11,38
50,Fail,37,45,2,16,21
50,Fail,53,31,5,11,42
50,Fail,49,33,7,11,38
50,Fail,45,34,0,16,29
50,Fail,46,41,0,13,33
50,Fail,50,32,5,13,37
50,Fail,52,38,2,8,44
50,Success,60,28,0,9,51
50,Fail,46,32,5,17,29
50,Fail,43,43,0,14,29
50,Fail,50,40,1,9,41
50,Fail,51,37,0,8,43
50,Fail,52,32,0,9,43
50,Fail,49,32,0,10,39
50,Fail,53,36,0,8,45
50,Fail,53,31,0,8,45
50,Fail,47,38,1,14,33
50,Fail,50,37,0,13,37
50,Fail,46,40,0,11,35
50,Fail,56,33,0,7,49
50,Fail,51,37,0,8,43
50,Fail,46,34,5,15,31
50,Fail,52,37,0,10,42
50,Fail,40,38,0,19,21
50,Fail,55,29,0,14,41
50,Fail,52,31,5,12,40
50,Fail,46,28,0,19,27
50,Fail,42,39,7,12,30
50,Fail,52,36,1,11,41
50,Fail,48,33,0,12,36
50,Fail,46,34,0,15,31
50,Fail,50,35,0,9,41
50,Fail,44,41,0,11,33
50,Fail,45,32,0,17,28
50,Fail,56,31,0,13,43
50,Fail,49,30,5,16,33
50,Fail,49,33,0,13,36
50,Fail,52,32,0,14,38
50,Fail,51,31,7,11,40
50,Fail,48,34,4,14,34
50,Fail,42,45,2,11,31
50,Fail,43,35,0,19,24
50,Fail,48,36,2,14,34
50,Fail,48,36,3,13,35
50,Fail,39,39,0,20,19
50,Fail,47,33,0,11,36
50,Fail,45,33,0,12,33
50,Fail,48,37,5,10,38
50,Fail,44,42,0,13,31
50,Fail,43,40,4,13,30
50,Fail,49,36,5,10,39
50,Fail,47,41,0,8,39
50,Fail,44,41,0,12,32
50,Fail,43,40,10,7,36
50,Fail,49,39,7,5,44
50,Fail,45,32,5,18,27
50,Fail,53,39,0,6,47
50,Fail,54,36,0,9,45
50,Fail,42,42,7,9,33
50,Fail,51,33,6,10,41
50,Fail,53,31,2,14,39
50,Fail,51,35,5,9,42
50,Fail,46,33,2,19,27
50,Fail,42,45,4,9,33
50,Fail,50,28,0,13,37
50,Fail,54,36,0,6,48
50,Fail,40,44,2,14,26
50,Fail,41,42,5,12,29
50,Fail,49,33,0,11,38
50,Fail,45,32,0,20,25
50,Fail,51,29,5,15,36
50,Fail,57,28,2,13,44
50,Fail,48,40,0,8,40
50,Fail,50,32,0,18,32
50,Fail,52,36,2,10,42
50,Fail,46,35,0,17,29
50,Fail,52,34,5,9,43
50,Fail,50,31,0,18,32
50,Fail,45,42,0,13,32
50,Fail,47,36,4,13,34
50,Fail,51,38,0,9,42
50,Fail,48,27,0,17,31
50,Success,59,32,0,8,51
50,Fail,53,35,0,12,41
50,Fail,46,37,0,14,32
50,Fail,51,34,0,15,36
50,Fail,42,36,4,18,24
50,Fail,48,36,0,13,35
50,Fail,54,28,6,12,42
50,Success,57,34,4,5,52
50,Fail,40,49,1,10,30
50,Fail,46,40,2,12,34
50,Fail,51,38,0,7,44
50,Fail,47,38,0,12,35
50,Fail,44,35,0,18,26
50,Fail,48,37,0,14,34
50,Fail,51,41,0,6,45
50,Fail,51,38,0,8,43
50,Fail,53,35,0,12,41
50,Fail,48,37,0,11,37
50,Fail,43,33,0,16,27
50,Fail,55,34,0,11,44
50,Fail,42,38,5,15,27
50,Fail,56,31,0,10,46
50,Fail,51,32,0,8,43
50,Fail,39,44,2,15,24
50,Fail,48,38,2,12,36
50,Fail,48,32,0,14,34
50,Fail,48,43,0,8,40
50,Fail,51,38,6,5,46
50,Fail,42,35,9,14,28
50,Fail,47,40,0,11,36
50,Fail,46,36,0,18,28
50,Fail,41,40,0,15,26
50,Fail,52,31,0,12,40
50,Fail,52,36,0,10,42
50,Fail,48,33,0,14,34
50,Fail,51,38,0,7,44
50,Fail,38,39,3,20,18
50,Fail,46,39,0,13,33
50,Fail,48,36,1,15,33
50,Fail,50,31,0,18,32
50,Fail,45,41,0,14,31
50,Fail,53,36,1,10,43
50,Fail,44,41,0,10,34
50,Fail,54,35,0,9,45
50,Fail,52,40,0,6,46
50,Fail,50,33,3,14,36
50,Fail,44,44,0,12,32
50,Fail,52,31,0,11,41
50,Fail,49,40,0,11,38
50,Fail,48,37,0,9,39
50,Fail,41,41,10,8,33
50,Fail,49,37,0,12,37
50,Fail,50,39,0,10,40
50,Fail,51,36,0,12,39
50,Fail,48,36,0,11,37
50,Fail,54,31,0,11,43
50,Fail,47,35,0,15,32
50,Fail,53,38,4,5,48
50,Fail,47,36,1,16,31
50,Fail,52,27,0,12,40
50,Fail,46,34,5,15,31
50,Fail,54,32,0,11,43
50,Fail,50,37,0,13,37
50,Fail,43,38,0,17,26
50,Fail,50,34,0,14,36
50,Fail,52,25,0,18,34
50,Fail,52,37,1,10,42
50,Fail,47,35,4,14,33
50,Fail,49,36,3,12,37
50,Fail,52,36,2,10,42
50,Fail,51,36,2,11,40
50,Fail,51,38,2,9,42
50,Fail,54,30,0,15,39
50,Fail,55,31,4,10,45
50,Fail,47,38,0,14,33
50,Fail,52,35,1,12,40
50,Fail,52,32,7,9,43
50,Fail,47,39,0,11,36
50,Fail,36,43,0,13,23
50,Fail,52,32,2,14,38
50,Fail,48,34,3,15,33
50,Fail,54,29,1,16,38
50,Fail,46,37,2,15,31
50,Fail,50,40,0,7,43
50,Fail,44,36,4,16,28
50,Fail,52,32,7,9,43
50,Fail,54,26,2,18,36
50,Fail,50,42,1,7,43
50,Fail,48,36,0,14,34
50,Fail,52,35,1,12,40
50,Fail,54,35,0,7,47
50,Fail,51,41,2,6,45
50,Fail,48,41,0,11,37
50,Fail,52,28,6,14,38
50,Fail,56,28,0,12,44
50,Fail,48,35,0,13,35
50,Fail,42,37,0,18,24
50,Fail,58,32,0,10,48
50,Fail,54,37,1,8,46
50,Fail,46,38,0,11,35
50,Fail,47,33,0,9,38
50,Fail,48,40,0,8,40
50,Fail,43,32,0,21,22
50,Fail,49,32,0,13,36
50,Fail,47,38,0,11,36
50,Fail,47,32,2,19,28
50,Fail,42,40,0,17,25
50,Fail,44,41,0,12,32
50,Fail,54,34,1,11,43
50,Fail,47,32,0,11,36
50,Fail,47,37,2,14,33
50,Fail,49,40,0,9,40
50,Fail,49,37,0,12,37
50,Fail,52,37,3,8,44
50,Fail,42,39,0,13,29
50,Fail,58,31,0,9,49
50,Fail,47,36,2,15,32
50,Fail,47,39,6,8,39
50,Fail,52,33,0,8,44
50,Fail,38,46,0,14,24
50,Fail,42,37,0,15,27
50,Fail,50,27,0,16,34
50,Fail,42,41,0,14,28
50,Fail,53,33,2,12,41
50,Fail,51,33,1,15,36
50,Fail,48,34,5,13,35
50,Fail,53,34,8,5,48
50,Fail,43,34,13,10,33
50,Fail,49,33,0,8,41
50,Fail,44,40,1,15,29
50,Fail,43,38,0,14,29
50,Fail,53,31,2,14,39
50,Fail,51,36,0,8,43
50,Fail,53,29,4,14,39
50,Fail,49,36,2,13,36
50,Fail,44,39,0,10,34
50,Fail,51,37,1,11,40
50,Fail,58,27,0,12,46
50,Fail,52,33,5,10,42
50,Fail,53,41,0,5,48
50,Fail,45,35,1,19,26
50,Fail,48,42,0,5,43
50,Fail,52,29,0,15,37
50,Fail,45,37,5,13,32
50,Fail,49,40,4,7,42
50,Fail,53,32,0,12,41
50,Fail,47,27,0,21,26
50,Fail,52,35,0,11,41
50,Fail,40,40,0,16,24
50,Fail,44,37,6,13,31
50,Fail,45,41,0,14,31
50,Fail,41,35,11,13,28
50,Fail,47,36,2,15,32
50,Fail,48,38,0,11,37
50,Fail,48,36,5,11,37
50,Fail,56,30,0,12,44
50,Fail,49,36,0,13,36
50,Fail,54,33,0,12,42
50,Fail,46,31,0,13,33
50,Fail,53,30,3,14,39
50,Fail,49,37,0,14,35
50,Fail,53,28,6,13,40
50,Fail,49,35,1,15,34
50,Fail,49,30,0,15,34
50,Fail,51,37,0,12,39
50,Fail,41,46,0,12,29
50,Fail,51,30,0,12,39
50,Fail,40,38,9,13,27
50,Fail,46,37,5,12,34
50,Fail,50,33,2,15,35
50,Fail,46,38,5,11,35
50,Fail,48,34,2,16,32
50,Fail,51,32,3,14,37
50,Fail,46,34,0,14,32
50,Fail,50,34,3,13,37
50,Fail,52,34,6,8,44
50,Fail,48,27,9,16,32
50,Fail,44,28,0,19,25
50,Fail,44,37,1,18,26
50,Fail,41,40,0,16,25
50,Fail,53,38,1,8,45
50,Fail,45,34,4,17,28
50,Success,60,31,0,9,51
50,Fail,38,43,0,16,22
50,Fail,49,39,0,12,37
50,Fail,45,36,9,10,35
50,Fail,50,33,0,14,36
50,Fail,50,33,6,11,39
50,Fail,46,31,7,16,30
50,Fail,44,37,7,12,32
50,Fail,52,29,6,13,39
50,Fail,45,39,5,11,34
50,Fail,45,32,2,21,24
50,Fail,35,43,0,17,18
50,Fail,59,29,1,11,48
50,Fail,52,38,2,8,44
50,Fail,51,33,4,12,39
50,Fail,43,41,0,15,28
50,Fail,51,36,3,10,41
50,Fail,38,39,0,10,28
50,Fail,51,37,3,9,42
50,Fail,39,46,0,15,24
50,Fail,42,37,0,21,21
50,Fail,46,34,8,12,34
50,Fail,47,31,0,12,35
50,Fail,50,36,2,12,38
50,Fail,50,29,0,14,36
50,Fail,44,38,5,13,31
50,Fail,50,35,0,11,39
50,Fail,51,31,3,15,36
50,Fail,48,32,0,10,38
50,Fail,54,33,2,11,43
50,Fail,43,41,2,14,29
50,Fail,48,37,1,14,34
50,Fail,46,39,1,14,32
50,Fail,48,40,1,11,37
50,Fail,54,34,0,10,44
50,Fail,45,40,5,10,35
50,Fail,38,37,0,19,19
50,Fail,50,34,6,10,40
50,Fail,54,33,4,9,45
50,Fail,50,42,3,5,45
50,Fail,45,35,0,11,34
50,Fail,51,32,1,16,35
50,Fail,51,36,1,12,39
50,Fail,53,31,3,13,40
50,Fail,40,41,7,12,28
50,Fail,52,41,1,6,46
50,Fail,50,35,0,15,35
50,Fail,44,40,0,8,36
50,Fail,44,47,1,8,36
50,Fail,45,31,0,14,31
50,Fail,47,45,2,6,41
50,Fail,47,39,1,13,34
50,Fail,50,36,1,13,37
50,Fail,51,33,4,12,39
50,Success,60,28,3,9,51
50,Fail,51,36,0,11,40
50,Fail,52,37,0,10,42
50,Fail,50,40,0,8,42
50,Fail,48,36,1,15,33
50,Fail,53,28,4,15,38
50,Fail,50,34,2,14,36
50,Fail,43,37,3,17,26
50,Fail,48,36,0,13,35
50,Fail,40,36,0,14,26
50,Fail,51,31,3,15,36
50,Fail,49,33,4,14,35
50,Fail,49,43,0,7,42
50,Fail,50,33,0,10,40
50,Fail,42,40,1,17,25
50,Fail,49,40,0,11,38
50,Fail,44,39,0,13,31
50,Fail,48,38,0,13,35
50,Fail,39,30,0,17,22
50,Fail,48,41,2,9,39
50,Fail,47,26,12,15,32
50,Fail,41,35,0,18,23
50,Fail,46,37,0,13,33
50,Fail,55,31,2,12,43
50,Fail,52,36,2,10,42
50,Fail,49,35,0,14,35
50,Fail,49,39,0,10,39
50,Fail,40,38,8,14,26
50,Fail,50,27,0,16,34
50,Fail,52,33,0,13,39
50,Fail,51,31,1,17,34
50,Fail,49,33,4,14,35
50,Fail,46,38,4,12,34
50,Fail,45,44,0,11,34
50,Fail,45,43,3,9,36
50,Fail,47,40,0,8,39
50,Fail,44,40,0,14,30
50,Fail,40,37,0,13,27
50,Fail,45,43,1,11,34
50,Fail,45,32,12,11,34
50,Fail,44,27,0,18,26
50,Fail,40,36,4,20,20
50,Fail,52,37,5,6,46
50,Fail,45,37,9,9,36
50,Fail,51,33,1,15,36
50,Fail,48,39,0,13,35
50,Fail,41,43,0,11,30
50,Fail,50,36,0,9,41
50,Fail,52,42,0,6,46
50,Fail,54,32,0,12,42
50,Fail,53,35,1,11,42
50,Fail,46,34,5,15,31
50,Fail,49,35,0,12,37
50,Fail,56,27,0,10,46
50,Fail,43,36,0,16,27
50,Fail,49,38,2,11,38
50,Fail,53,33,2,12,41
50,Fail,48,29,0,19,29
50,Fail,52,36,2,10,42
50,Fail,54,33,5,8,46
50,Fail,50,35,0,10,40
50,Fail,48,32,4,16,32
50,Fail,48,28,9,15,33
50,Fail,51,31,0,11,40
50,Fail,45,40,0,10,35
50,Fail,45,37,0,18,27
50,Fail,44,43,0,9,35
50,Fail,49,33,0,14,35
50,Fail,47,32,0,11,36
50,Fail,46,39,0,14,32
50,Fail,42,33,6,19,23
50,Fail,48,41,0,9,39
50,Fail,50,29,0,13,37
50,Fail,54,35,0,8,46
50,Fail,51,36,0,12,39
50,Fail,46,38,0,11,35
50,Fail,49,36,1,14,35
50,Fail,50,32,0,14,36
50,Fail,52,39,1,8,44
50,Fail,50,38,0,10,40
50,Fail,46,39,4,11,35
50,Fail,52,29,0,14,38
50,Fail,48,30,0,20,28
50,Fail,49,31,5,15,34
50,Fail,39,38,4,19,20
50,Fail,38,32,0,15,23
50,Fail,52,32,3,13,39
50,Fail,47,34,0,13,34
50,Fail,47,36,0,16,31
50,Fail,51,37,3,9,42
50,Fail,47,33,6,14,33
50,Fail,53,34,0,10,43
50,Fail,44,45,0,8,36
50,Fail,52,30,5,13,39
50,Fail,47,36,8,9,38
50,Fail,52,29,7,12,40
50,Fail,46,34,4,16,30
50,Fail,41,45,4,10,31
50,Success,58,33,2,7,51
50,Fail,44,37,0,14,30
50,Fail,46,34,6,14,32
50,Fail,53,35,2,10,43
50,Fail,41,42,6,11,30
50,Fail,51,34,0,13,38
50,Fail,42,34,0,19,23
50,Fail,53,26,7,14,39
50,Fail,47,37,9,7,40
50,Fail,54,29,4,13,41
50,Fail,49,33,4,14,35
50,Fail,43,44,4,9,34
50,Fail,53,34,0,10,43
50,Fail,42,37,8,13,29
50,Fail,51,33,0,14,37
50,Fail,51,29,0,15,36
50,Fail,56,36,0,8,48
50,Fail,45,39,0,12,33
50,Fail,50,30,0,10,40
50,Fail,43,39,6,12,31
50,Fail,51,37,0,9,42
50,Fail,49,39,0,6,43
50,Fail,51,36,4,9,42
50,Success,58,33,4,5,53
50,Fail,56,20,0,19,37
50,Fail,45,33,5,17,28
50,Fail,54,32,2,12,42
50,Fail,61,23,0,16,45
50,Fail,51,33,0,9,42
50,Fail,41,44,0,12,29
50,Fail,51,33,8,8,43
50,Fail,47,34,8,11,36
50,Fail,46,37,4,13,33
50,Fail,46,37,1,16,30
50,Fail,52,36,4,8,44
50,Fail,43,43,0,13,30
50,Fail,48,33,0,14,34
50,Fail,56,28,5,11,45
50,Fail,49,33,10,8,41
50,Fail,44,36,0,13,31
50,Fail,48,32,5,15,33
50,Fail,51,32,5,12,39
50,Fail,44,35,0,16,28
50,Fail,48,28,4,20,28
50,Fail,54,34,0,11,43
50,Fail,50,30,0,9,41
50,Fail,42,45,3,10,32
50,Fail,44,35,0,10,34
50,Fail,41,36,13,10,31
50,Fail,44,42,0,13,31
50,Fail,48,37,5,10,38
50,Fail,44,33,0,16,28
50,Fail,54,29,0,15,39
50,Fail,50,33,0,14,36
50,Fail,52,37,0,8,44
50,Fail,53,28,0,12,41
50,Fail,50,32,0,9,41
50,Success,59,30,0,7,52
50,Fail,45,36,0,15,30
50,Fail,49,41,0,10,39
50,Fail,49,32,1,18,31
50,Fail,46,33,7,14,32
50,Fail,50,37,0,13,37
50,Fail,46,36,6,12,34
50,Fail,50,32,6,12,38
50,Fail,40,40,0,17,23
50,Fail,51,38,1,10,41
50,Fail,42,38,0,16,26
50,Fail,49,41,2,8,41
50,Fail,46,35,6,13,33
50,Fail,49,34,0,16,33
50,Fail,40,43,0,10,30
50,Fail,48,34,6,12,36
50,Fail,46,45,0,9,37
50,Fail,52,29,0,11,41
50,Fail,49,36,2,13,36
50,Fail,40,43,4,13,27
50,Fail,53,35,2,10,43
50,Fail,49,34,3,14,35
50,Fail,49,31,7,13,36
50,Fail,50,35,0,11,39
50,Fail,47,39,5,9,38
50,Fail,48,35,7,10,38
50,Fail,45,42,0,12,33
50,Fail,49,32,1,18,31
50,Fail,55,35,1,9,46
50,Fail,39,40,11,10,29
50,Fail,54,29,4,13,41
50,Fail,43,42,0,14,29
50,Fail,42,42,0,12,30
50,Fail,54,34,3,9,45
50,Fail,44,39,1,16,28
50,Fail,44,44,0,8,36
50,Fail,49,23,0,23,26
50,Fail,52,32,6,10,42
50,Fail,42,38,5,15,27
50,Fail,49,33,6,12,37
50,Fail,53,31,3,13,40
50,Fail,44,37,7,12,32
50,Fail,46,36,3,15,31
50,Fail,53,37,0,10,43
50,Success,57,34,3,6,51
50,Fail,47,42,3,8,39
50,Fail,52,35,0,12,40
50,Fail,47,39,4,10,37
50,Fail,51,26,9,14,37
50,Fail,54,26,4,16,38
50,Fail,44,30,0,14,30
50,Fail,52,39,0,8,44
50,Success,58,35,0,7,51
50,Fail,53,34,5,8,45
50,Fail,54,34,1,11,43
50,Fail,58,24,5,13,45
50,Fail,45,32,9,14,31
50,Fail,48,36,2,14,34
50,Fail,46,35,7,12,34
50,Fail,48,27,0,16,32
50,Fail,56,30,1,13,43
50,Fail,48,38,0,14,34
50,Fail,47,34,0,11,36
50,Fail,55,32,0,8,47
50,Fail,52,33,4,11,41
50,Fail,48,37,4,11,37
50,Fail,44,33,3,20,24
50,Fail,48,31,0,20,28
50,Fail,51,28,3,18,33
50,Fail,50,32,0,12,38
50,Fail,49,32,0,15,34
50,Fail,44,39,4,13,31
50,Fail,50,36,1,13,37
50,Fail,46,42,1,11,35
50,Fail,48,26,0,17,31
50,Fail,46,37,0,8,38
50,Fail,44,34,0,9,35
50,Fail,51,31,0,14,37
50,Fail,48,36,0,12,36
50,Fail,56,27,0,11,45
50,Fail,58,31,1,10,48
50,Fail,52,29,0,16,36
50,Fail,45,37,0,9,36
50,Fail,54,32,0,12,42
50,Fail,50,31,3,16,34
50,Fail,41,47,0,8,33
50,Fail,49,37,0,8,41
50,Fail,49,34,1,16,33
50,Fail,45,30,5,20,25
50,Fail,49,35,0,9,40
50,Fail,43,42,0,14,29
50,Fail,43,36,7,14,29
50,Fail,48,36,2,14,34
50,Fail,59,28,3,10,49
50,Fail,44,35,0,16,28
50,Fail,46,42,2,10,36
50,Fail,48,36,0,11,37
50,Fail,45,26,0,17,28
50,Fail,44,37,0,15,29
50,Fail,40,40,0,16,24
50,Fail,49,38,2,11,38
50,Fail,41,33,15,11,30
50,Fail,54,37,1,8,46
50,Fail,50,28,2,20,30
50,Fail,41,42,7,10,31
50,Fail,53,38,0,9,44
50,Fail,43,36,0,15,28
50,Fail,42,44,2,12,30
50,Fail,54,31,4,11,43
50,Fail,43,30,0,12,31
50,Fail,47,33,0,13,34
50,Fail,50,34,7,9,41
50,Success,60,28,4,8,52
50,Fail,45,29,5,21,24
50,Fail,50,35,4,11,39
50,Fail,49,34,0,9,40
50,Fail,51,34,2,13,38
50,Fail,52,36,1,11,41
50,Fail,45,38,0,12,33
50,Fail,58,22,0,14,44
50,Fail,53,34,1,12,41
50,Fail,45,36,0,13,32
50,Fail,46,37,4,13,33
50,Fail,41,39,0,17,24
50,Fail,47,32,0,16,31
50,Fail,46,38,3,13,33
50,Fail,44,46,1,9,35
50,Fail,51,44,0,5,46
50,Fail,45,39,0,13,32
50,Fail,56,31,2,11,45
50,Fail,53,30,7,10,43
50,Fail,45,34,7,14,31
50,Fail,53,32,2,13,40
50,Fail,42,42,3,13,29
50,Fail,38,40,7,15,23
50,Fail,43,38,0,12,31
50,Fail,48,41,0,8,40
50,Fail,50,37,6,7,43
50,Fail,37,32,18,13,24
50,Fail,45,36,0,14,31
50,Fail,48,35,6,11,37
50,Fail,45,39,0,12,33
50,Fail,41,33,8,18,23
50,Fail,43,31,0,22,21
50,Fail,48,34,5,13,35
50,Fail,50,29,8,13,37
50,Fail,47,41,0,12,35
50,Fail,47,33,0,15,32
50,Fail,47,37,3,13,34
50,Fail,52,38,0,8,44
50,Fail,45,40,0,11,34
50,Fail,46,40,0,14,32
50,Fail,39,38,6,17,22
50,Fail,50,35,6,9,41
50,Fail,47,39,0,12,35
50,Fail,57,33,1,9,48
50,Fail,49,33,0,12,37
50,Fail,46,30,6,18,28
50,Fail,51,33,0,12,39
50,Fail,54,29,0,16,38
50,Fail,42,37,0,18,24
50,Fail,46,39,1,14,32
50,Fail,45,33,7,15,30
50,Fail,41,38,6,15,26
50,Fail,52,31,0,13,39
50,Fail,49,32,0,16,33
50,Fail,45,37,0,13,32
50,Fail,48,33,0,12,36
50,Fail,50,37,2,11,39
50,Fail,50,36,0,12,38
50,Fail,52,36,4,8,44
50,Fail,45,37,6,12,33
50,Fail,49,38,0,13,36
50,Fail,43,42,0,13,30
50,Fail,47,37,0,12,35
50,Fail,42,47,2,9,33
50,Fail,50,36,2,12,38
50,Fail,47,42,3,8,39
50,Fail,51,30,3,16,35
50,Fail,51,36,0,9,42
50,Fail,52,33,3,12,40
50,Fail,56,35,0,7,49
50,Fail,47,33,6,14,33
50,Success,56,34,4,6,50
50,Fail,44,43,3,10,34
50,Fail,52,39,1,8,44
50,Fail,39,50,0,11,28
50,Fail,46,38,2,14,32
50,Fail,55,31,0,12,43
50,Fail,42,39,0,18,24
50,Fail,46,32,1,21,25
50,Fail,49,38,0,8,41
50,Fail,52,32,0,15,37
50,Fail,48,39,0,10,38
50,Fail,44,44,4,8,36
50,Fail,47,36,0,13,34
50,Fail,46,37,0,13,33
50,Fail,49,34,2,15,34
50,Fail,48,39,0,10,38
50,Fail,51,36,1,12,39
50,Fail,45,43,6,6,39
50,Fail,51,29,7,13,38
50,Fail,45,39,9,7,38
50,Fail,49,33,7,11,38
50,Fail,45,40,1,14,31
50,Fail,52,30,0,15,37
50,Fail,46,42,1,11,35
50,Fail,54,33,1,12,42
50,Fail,43,43,1,13,30
50,Fail,53,30,5,12,41
50,Fail,38,42,0,17,21
50,Fail,44,34,8,14,30
50,Fail,45,36,2,17,28
50,Fail,60,23,0,14,46
50,Fail,39,31,0,17,22
50,Fail,45,30,0,15,30
50,Fail,47,42,0,11,36
50,Fail,54,35,2,9,45
50,Fail,37,48,1,14,23
50,Fail,53,32,0,12,41
50,Fail,47,34,4,15,32
50,Fail,46,34,3,17,29
50,Fail,43,38,3,16,27
50,Fail,41,35,7,17,24
50,Fail,49,36,0,13,36
50,Fail,48,24,0,10,38
50,Fail,51,39,0,10,41
50,Fail,48,35,3,14,34
50,Fail,48,31,0,15,33
50,Fail,47,34,0,14,33
50,Fail,49,36,0,9,40
50,Fail,47,35,0,12,35
50,Fail,43,41,8,8,35
50,Fail,39,42,0,17,22
50,Fail,54,33,4,9,45
50,Success,59,34,0,7,52
50,Fail,49,35,0,13,36
50,Fail,44,34,0,15,29
50,Fail,48,30,0,18,30
50,Fail,48,39,0,10,38
50,Fail,48,33,0,10,38
50,Fail,48,35,0,10,38
50,Fail,48,33,0,13,35
50,Fail,49,34,0,12,37
50,Fail,39,40,0,20,19
50,Fail,53,31,0,11,42
50,Fail,44,41,0,13,31
50,Fail,42,44,6,8,34
50,Fail,49,36,5,10,39
50,Fail,46,34,7,13,33
50,Fail,45,44,0,10,35
50,Fail,54,37,0,9,45
50,Fail,50,32,0,12,38
50,Fail,51,38,0,11,40
50,Fail,37,44,0,8,29
50,Fail,51,36,2,11,40
50,Fail,42,38,3,17,25
50,Fail,49,38,0,10,39
50,Fail,50,31,0,18,32
50,Fail,40,45,0,11,29
50,Fail,46,33,0,14,32
50,Fail,46,30,9,15,31
50,Fail,44,39,0,11,33
50,Fail,40,40,9,11,29
50,Fail,49,27,0,16,33
50,Fail,52,36,0,9,43
50,Fail,49,41,0,8,41
50,Fail,43,37,0,16,27
50,Fail,52,22,9,17,35
50,Fail,51,35,0,14,37
50,Fail,50,36,0,10,40
50,Fail,51,34,0,13,38
50,Fail,42,44,5,9,33
50,Fail,52,35,1,12,40
50,Fail,50,34,0,14,36
50,Fail,49,40,0,11,38
50,Fail,41,39,0,14,27
50,Fail,48,28,0,20,28
50,Fail,52,33,2,13,39
50,Fail,49,34,1,16,33
50,Fail,51,30,0,19,32
50,Fail,39,42,3,16,23
50,Fail,49,39,0,10,39
50,Fail,48,27,0,13,35
50,Fail,54,39,0,6,48
50,Fail,46,33,6,15,31
50,Fail,56,29,0,12,44
50,Fail,41,37,0,14,27
50,Fail,50,32,0,12,38
50,Fail,53,35,2,10,43
50,Fail,46,37,4,13,33
50,Fail,45,29,5,21,24
50,Fail,50,32,0,13,37
50,Fail,49,31,6,14,35
50,Fail,48,33,0,13,35
50,Fail,43,37,8,12,31
50,Fail,45,41,0,14,31
50,Fail,51,38,3,8,43
50,Fail,53,33,3,11,42
50,Fail,50,34,4,12,38
50,Fail,56,34,0,8,48
50,Fail,42,43,0,13,29
50,Fail,47,32,10,11,36
50,Fail,45,41,3,11,34
50,Fail,49,34,5,12,37
50,Fail,44,39,5,12,32
50,Fail,51,36,1,12,39
50,Fail,47,34,1,18,29
50,Fail,49,29,0,14,35
50,Fail,40,35,7,18,22
50,Fail,47,37,6,10,37
50,Fail,40,44,3,13,27
50,Fail,51,32,5,12,39
50,Fail,48,36,0,15,33
50,Fail,49,36,0,14,35
50,Fail,43,37,9,11,32
50,Fail,44,33,8,15,29
50,Fail,48,37,4,11,37
50,Fail,51,35,0,14,37
50,Fail,43,43,0,13,30
50,Fail,49,40,0,9,40
50,Fail,55,38,0,6,49
50,Fail,48,33,3,16,32
50,Fail,43,29,0,24,19
50,Fail,49,40,0,11,38
50,Fail,42,38,0,17,25
50,Success,56,35,3,6,50
50,Fail,40,42,0,17,23
50,Fail,41,40,0,11,30
50,Fail,57,33,0,10,47
50,Fail,53,33,4,10,43
50,Fail,52,35,0,9,43
50,Fail,47,40,0,7,40
50,Fail,56,31,0,11,45
50,Fail,46,37,0,12,34
50,Fail,41,30,0,17,24
50,Fail,50,33,0,15,35
50,Fail,45,36,0,12,33
50,Fail,42,43,2,13,29
50,Fail,47,35,0,13,34
50,Fail,48,34,3,15,33
50,Fail,50,38,0,11,39
50,Fail,53,35,0,11,42
50,Fail,44,31,7,18,26
50,Fail,54,28,0,11,43
50,Fail,51,31,0,14,37
50,Fail,45,34,0,18,27
50,Fail,55,32,0,11,44
50,Fail,47,34,9,10,37
50,Fail,45,39,2,14,31
50,Fail,59,30,0,10,49
50,Fail,51,37,6,6,45
50,Fail,55,31,2,12,43
50,Fail,39,36,11,14,25
50,Fail,42,35,0,15,27
50,Fail,54,29,3,14,40
50,Fail,56,30,0,13,43
50,Fail,50,36,3,11,39
50,Fail,47,33,6,14,33
50,Success,59,32,0,8,51
50,Fail,44,41,0,13,31
50,Fail,43,41,0,13,30
50,Fail,49,38,0,11,38
50,Fail,42,40,0,16,26
50,Fail,55,32,1,12,43
50,Fail,50,35,0,15,35
50,Fail,46,43,1,10,36
50,Fail,51,32,2,15,36
50,Fail,40,40,3,17,23
50,Fail,51,23,0,19,32
50,Success,53,42,0,3,50
50,Fail,49,38,0,11,38
50,Fail,42,42,0,16,26
50,Fail,52,34,0,12,40
50,Fail,51,35,0,8,43
50,Fail,46,31,0,20,26
50,Fail,48,36,2,14,34
50,Fail,51,41,0,8,43
50,Fail,50,34,0,16,34
50,Fail,52,34,0,10,42
50,Fail,51,40,1,8,43
50,Fail,48,36,0,15,33
50,Fail,48,37,0,14,34
50,Fail,51,28,0,17,34
50,Fail,47,44,3,6,41
50,Fail,48,23,9,20,28
50,Fail,53,31,3,13,40
50,Fail,48,34,0,11,37
50,Fail,43,38,0,17,26
50,Fail,52,33,4,11,41
50,Success,59,29,0,8,51
50,Fail,42,38,7,13,29
50,Fail,43,31,0,18,25
50,Fail,46,35,4,15,31
50,Fail,44,37,1,18,26
50,Fail,47,39,0,14,33
50,Fail,49,39,0,11,38
50,Fail,47,37,7,9,38
50,Fail,47,42,1,10,37
50,Fail,47,36,0,14,33
50,Success,59,31,0,8,51
50,Fail,50,38,0,12,38
50,Success,57,32,4,7,50
50,Fail,46,33,7,14,32
50,Fail,48,33,4,15,33
50,Fail,42,33,0,14,28
50,Fail,46,39,0,10,36
50,Fail,50,36,0,10,40
50,Fail,56,28,3,13,43
50,Fail,46,27,2,25,21
50,Fail,56,35,2,7,49
50,Fail,51,28,1,20,31
50,Fail,43,42,3,12,31
50,Fail,49,29,7,15,34
50,Success,59,30,3,8,51
50,Fail,48,43,0,7,41
50,Fail,52,38,2,8,44
50,Fail,44,38,0,15,29
50,Fail,44,34,0,13,31
50,Fail,45,35,0,19,26
50,Fail,46,35,5,14,32
50,Fail,45,41,2,12,33
50,Fail,48,35,0,13,35
50,Fail,50,34,0,9,41
50,Fail,51,39,2,8,43
50,Fail,54,33,0,10,44
50,Fail,51,33,4,12,39
50,Fail,51,38,0,11,40
50,Fail,59,28,2,11,48
50,Fail,46,32,7,15,31
50,Fail,44,36,8,12,32
50,Fail,50,31,0,8,42
50,Fail,40,40,2,18,22
50,Fail,51,28,9,12,39
50,Fail,48,36,9,7,41
50,Fail,49,35,0,13,36
50,Fail,54,35,4,7,47
50,Fail,49,34,7,10,39
50,Fail,46,38,4,12,34
50,Fail,54,38,0,8,46
50,Fail,45,33,1,21,24
50,Fail,50,37,1,12,38
50,Fail,43,40,0,14,29
50,Fail,50,30,4,16,34
50,Fail,52,34,0,14,38
50,Fail,48,39,1,12,36
50,Fail,48,35,0,14,34
50,Fail,52,36,3,9,43
50,Fail,50,39,0,7,43
50,Fail,49,35,3,13,36
50,Fail,50,33,0,10,40
50,Fail,44,39,2,15,29
50,Fail,47,40,0,12,35
50,Fail,47,34,0,16,31
50,Fail,58,26,5,11,47
50,Fail,45,33,0,18,27
50,Fail,53,34,2,11,42
50,Fail,45,35,9,11,34
50,Fail,45,36,0,13,32
50,Fail,49,40,3,8,41
50,Fail,47,41,0,10,37
50,Fail,48,36,0,13,35
50,Fail,50,39,0,11,39
50,Fail,47,37,0,15,32
50,Fail,48,37,0,10,38
50,Fail,48,37,2,13,35
50,Fail,49,32,3,16,33
50,Fail,48,34,0,17,31
50,Fail,48,39,0,8,40
50,Fail,51,32,0,10,41
50,Fail,43,36,0,15,28
50,Fail,43,36,10,11,32
50,Fail,49,35,0,15,34
50,Fail,49,37,0,10,39
50,Fail,52,38,0,10,42
50,Fail,48,34,0,14,34
50,Fail,51,36,2,11,40
50,Fail,49,37,0,14,35
50,Fail,44,35,10,11,33
50,Fail,51,32,8,9,42
50,Fail,45,38,0,16,29
50,Fail,50,34,1,15,35
50,Fail,42,41,0,12,30
50,Fail,48,34,4,14,34
50,Fail,43,46,3,8,35
50,Fail,45,37,8,10,35
50,Fail,53,34,5,8,45
50,Fail,44,35,0,15,29
50,Fail,49,36,0,12,37
50,Fail,50,39,2,9,41
50,Fail,52,30,0,10,42
50,Fail,40,39,0,17,23
50,Fail,47,37,2,14,33
50,Fail,50,36,0,9,41
50,Fail,40,37,8,15,25
50,Fail,45,36,0,14,31
50,Fail,44,30,9,17,27
50,Fail,55,29,3,13,42
50,Fail,50,36,0,14,36
50,Fail,49,37,0,13,36
50,Fail,52,34,4,10,42
50,Fail,42,38,0,15,27
50,Fail,39,43,0,14,25
50,Fail,39,36,0,16,23
50,Fail,42,42,0,13,29
50,Fail,48,41,0,11,37
50,Fail,53,31,5,11,42
50,Fail,50,30,9,11,39
50,Fail,49,34,2,15,34
50,Fail,46,37,3,14,32
50,Fail,53,39,0,8,45
50,Fail,39,33,4,24,15
50,Fail,44,37,0,11,33
50,Fail,48,33,4,15,33
50,Fail,44,34,0,20,24
50,Fail,49,33,4,14,35
50,Fail,55,27,2,16,39
50,Fail,47,43,2,8,39
50,Fail,49,28,5,18,31
50,Fail,55,35,0,10,45
50,Fail,47,32,6,15,32
50,Fail,40,40,1,19,21
50,Fail,47,35,0,15,32
50,Fail,52,37,1,10,42
50,Fail,48,37,1,14,34
50,Fail,46,38,3,13,33
50,Fail,51,22,0,17,34
50,Fail,49,37,5,9,40
50,Fail,51,33,0,10,41
50,Fail,48,39,1,12,36
50,Fail,54,33,6,7,47
50,Fail,46,37,0,16,30
50,Fail,55,33,0,12,43
50,Fail,42,43,1,14,28
50,Fail,44,41,4,11,33
50,Fail,47,38,0,14,33
50,Fail,54,25,0,16,38
50,Fail,47,34,2,17,30
50,Fail,44,40,0,11,33
50,Fail,53,31,0,16,37
50,Fail,48,33,0,12,36
50,Fail,40,41,4,15,25
50,Fail,48,37,0,12,36
50,Fail,52,33,4,11,41
50,Fail,49,39,0,8,41
50,Fail,48,40,3,9,39
50,Fail,55,36,1,8,47
50,Fail,49,35,6,10,39
50,Success,60,29,0,10,50
50,Fail,54,30,0,12,42
50,Fail,48,38,0,12,36
50,Fail,46,36,0,11,35
50,Fail,53,27,0,11,42
50,Fail,48,41,0,10,38
50,Fail,52,29,0,12,40
50,Fail,50,41,0,5,45
50,Fail,52,33,0,14,38
50,Fail,50,38,0,7,43
50,Fail,54,30,0,12,42
50,Fail,47,38,0,13,34
50,Fail,50,36,1,13,37
50,Fail,42,42,0,15,27
50,Fail,40,45,2,13,27
50,Fail,47,31,8,14,33
50,Fail,54,32,0,12,42
50,Fail,50,42,0,7,43
50,Fail,41,42,0,11,30
50,Fail,52,35,0,9,43
50,Fail,43,44,0,12,31
50,Fail,43,35,8,14,29
50,Fail,46,36,0,18,28
50,Fail,39,30,11,20,19
50,Fail,50,36,0,14,36
50,Fail,42,36,0,14,28
50,Fail,55,29,0,12,43
50,Fail,51,37,0,10,41
50,Fail,38,48,0,11,27
50,Fail,41,43,5,11,30
50,Fail,50,32,0,17,33
50,Fail,44,37,0,12,32
50,Fail,46,33,0,14,32
50,Fail,45,40,2,13,32
50,Fail,43,44,6,7,36
50,Fail,46,33,5,16,30
50,Fail,49,42,0,7,42
50,Fail,53,31,0,14,39
50,Fail,49,35,0,11,38
50,Fail,50,36,3,11,39
50,Fail,46,37,0,7,39
50,Fail,39,36,6,19,20
50,Fail,53,31,0,12,41
50,Fail,52,35,4,9,43
50,Fail,51,36,5,8,43
50,Fail,43,35,0,16,27
50,Fail,49,28,7,16,33
50,Fail,48,30,5,17,31
50,Fail,49,37,0,13,36
50,Fail,48,40,0,12,36
50,Fail,48,32,0,17,31
50,Fail,45,31,12,12,33
50,Fail,51,36,0,12,39
50,Fail,46,37,1,16,30
50,Fail,53,30,7,10,43
50,Fail,44,43,1,12,32
50,Fail,55,30,6,9,46
50,Fail,46,30,0,18,28
50,Fail,44,34,0,14,30
50,Fail,52,30,0,17,35
50,Fail,55,35,2,8,47
50,Fail,43,30,6,21,22
50,Fail,54,28,3,15,39
50,Fail,53,31,6,10,43
50,Fail,45,42,2,11,34
50,Fail,44,41,0,14,30
50,Fail,46,38,0,15,31
50,Fail,41,36,6,17,24
50,Fail,50,37,3,10,40
50,Fail,52,30,0,13,39
50,Fail,47,36,0,12,35
50,Fail,34,37,12,17,17
50,Fail,48,32,0,13,35
50,Fail,51,27,0,16,35
50,Success,62,27,0,7,55
50,Fail,42,35,5,18,24
50,Fail,53,41,1,5,48
50,Fail,49,38,5,8,41
50,Fail,44,38,0,12,32
50,Fail,44,36,4,16,28
50,Fail,52,31,4,13,39
50,Fail,49,33,0,15,34
50,Fail,49,35,0,14,35
50,Fail,50,29,6,15,35
50,Fail,55,27,0,14,41
50,Fail,38,41,0,16,22
50,Fail,55,35,0,10,45
50,Fail,57,30,2,11,46
50,Fail,50,37,4,9,41
50,Fail,52,35,0,13,39
50,Fail,49,35,0,10,39
50,Fail,55,37,2,6,49
50,Fail,57,25,0,14,43
50,Fail,47,39,0,14,33
50,Fail,47,43,0,10,37
50,Fail,43,32,0,9,34
50,Fail,39,48,4,9,30
50,Fail,46,36,0,16,30
50,Fail,50,39,2,9,41
50,Fail,48,36,4,12,36
50,Fail,49,35,0,15,34
50,Fail,49,32,6,13,36
50,Fail,47,39,0,11,36
50,Fail,44,41,0,14,30
50,Fail,46,36,0,17,29
50,Fail,55,34,0,6,49
50,Fail,55,32,0,12,43
50,Fail,49,33,3,15,34
50,Fail,45,40,0,15,30
50,Fail,48,30,0,15,33
50,Fail,53,24,10,13,40
50,Fail,53,33,0,12,41
50,Fail,41,41,0,17,24
50,Fail,48,34,1,17,31
50,Fail,53,36,1,10,43
50,Fail,48,31,3,18,30
50,Fail,54,32,0,13,41
50,Success,59,33,0,8,51
50,Fail,52,35,0,11,41
50,Fail,54,30,0,10,44
50,Fail,47,35,0,13,34
50,Fail,43,35,0,18,25
50,Fail,45,34,0,17,28
50,Fail,49,35,0,14,35
50,Fail,50,33,0,16,34
50,Fail,50,34,4,12,38
50,Fail,46,35,0,18,28
50,Fail,50,33,0,11,39
50,Fail,45,44,0,10,35
50,Fail,39,42,0,13,26
50,Fail,45,44,1,10,35
50,Fail,43,38,3,16,27
50,Fail,52,33,5,10,42
50,Fail,51,37,0,8,43
50,Fail,53,31,4,12,41
50,Fail,44,40,3,13,31
50,Fail,50,36,1,13,37
50,Fail,42,47,3,8,34
50,Fail,42,41,0,14,28
50,Fail,42,34,0,22,20
50,Fail,50,35,1,14,36
50,Fail,51,38,2,9,42
50,Fail,50,35,0,14,36
50,Fail,46,33,4,17,29
50,Fail,52,34,0,11,41
50,Fail,48,37,0,9,39
50,Fail,40,37,2,21,19
50,Fail,51,32,6,11,40
50,Fail,44,38,4,14,30
50,Fail,50,37,1,12,38
50,Fail,45,33,10,12,33
50,Fail,53,31,0,15,38
50,Fail,50,35,5,10,40
50,Fail,45,38,0,17,28
50,Fail,36,37,4,23,13
50,Fail,44,34,0,13,31
50,Fail,53,28,0,12,41
50,Fail,43,41,0,14,29
50,Fail,50,32,0,12,38
50,Fail,45,29,0,18,27
50,Fail,53,40,2,5,48
50,Fail,49,30,0,14,35
50,Fail,46,34,8,12,34
50,Fail,44,43,5,8,36
50,Fail,54,34,0,9,45
50,Fail,43,43,1,13,30
50,Fail,50,29,0,14,36
50,Fail,45,34,0,9,36
50,Fail,49,40,1,10,39
50,Fail,51,31,0,16,35
50,Fail,46,42,0,6,40
50,Fail,43,34,6,17,26
50,Fail,42,40,2,16,26
50,Fail,42,46,0,12,30
50,Fail,53,30,0,11,42
50,Fail,46,36,0,11,35
50,Fail,43,45,4,8,35
50,Fail,47,33,0,17,30
50,Fail,49,33,4,14,35
50,Fail,51,33,0,11,40
50,Fail,50,35,0,13,37
50,Fail,48,40,7,5,43
50,Fail,44,38,7,11,33
50,Fail,46,29,12,13,33
50,Fail,49,35,5,11,38
50,Fail,51,32,1,16,35
50,Fail,46,38,0,13,33
50,Fail,51,39,0,8,43
50,Fail,45,40,5,10,35
50,Fail,52,36,0,10,42
50,Fail,43,40,0,13,30
50,Fail,50,28,0,17,33
50,Fail,43,37,4,16,27
50,Fail,47,38,1,14,33
50,Fail,53,33,2,12,41
50,Fail,47,33,0,18,29
50,Fail,46,35,7,12,34
50,Fail,39,36,0,15,24
50,Fail,45,33,0,13,32
50,Fail,50,38,1,11,39
50,Fail,50,26,0,15,35
50,Fail,55,35,1,9,46
50,Fail,38,42,8,12,26
50,Success,61,27,3,9,52
50,Fail,49,35,4,12,37
50,Fail,45,38,0,14,31
50,Fail,56,35,0,9,47
50,Fail,50,30,7,13,37
50,Fail,48,35,7,10,38
50,Fail,49,37,0,13,36
50,Fail,45,38,5,12,33
50,Fail,48,42,0,9,39
50,Fail,43,39,6,12,31
50,Fail,43,34,9,14,29
50,Fail,48,31,0,12,36
50,Fail,48,33,8,11,37
50,Fail,46,34,0,11,35
50,Fail,48,40,2,10,38
50,Fail,45,37,0,13,32
50,Fail,53,30,7,10,43
50,Fail,43,46,1,10,33
50,Fail,40,41,4,15,25
50,Fail,48,33,2,17,31
50,Fail,41,37,0,22,19
50,Fail,52,36,0,10,42
50,Fail,46,37,3,14,32
50,Fail,50,31,3,16,34
50,Fail,40,32,11,17,23
50,Fail,48,37,0,13,35
50,Fail,50,37,4,9,41
50,Fail,49,37,1,13,36
50,Fail,49,35,2,14,35
50,Fail,50,30,0,17,33
50,Fail,49,34,7,10,39
50,Fail,43,38,7,12,31
50,Fail,55,36,0,9,46
50,Fail,57,31,1,11,46
50,Fail,56,32,0,8,48
50,Fail,44,41,0,14,30
50,Fail,57,32,3,8,49
50,Fail,52,32,4,12,40
50,Fail,43,42,0,13,30
50,Fail,58,31,0,10,48
50,Fail,50,34,4,12,38
50,Fail,49,33,5,13,36
50,Fail,41,36,4,19,22
50,Fail,50,30,0,18,32
50,Fail,53,35,0,8,45
50,Fail,50,31,8,11,39
50,Fail,53,39,0,7,46
50,Fail,51,33,0,13,38
50,Fail,45,39,4,12,33
50,Fail,47,32,0,17,30
50,Fail,48,38,1,13,35
50,Fail,41,40,0,11,30
50,Fail,51,33,0,8,43
50,Fail,49,40,1,10,39
50,Fail,46,33,3,18,28
50,Fail,45,40,2,13,32
50,Fail,48,37,1,14,34
50,Fail,50,33,0,14,36
50,Fail,52,35,0,10,42
50,Fail,43,33,6,18,25
50,Fail,55,35,0,8,47
50,Fail,47,35,0,12,35
50,Fail,49,30,5,16,33
50,Fail,60,25,0,15,45
50,Fail,51,34,0,14,37
50,Fail,52,36,1,11,41
50,Fail,51,33,3,13,38
50,Fail,44,44,0,10,34
50,Fail,44,39,3,14,30
50,Fail,40,44,5,11,29
50,Fail,49,38,0,10,39
50,Fail,43,35,0,15,28
50,Fail,47,32,0,12,35
50,Fail,49,42,1,8,41
50,Fail,52,28,9,11,41
50,Fail,44,37,5,14,30
50,Fail,41,36,0,14,27
50,Fail,51,31,0,13,38
50,Fail,44,37,0,13,31
50,Fail,48,31,4,17,31
50,Fail,42,43,0,12,30
50,Fail,57,28,0,10,47
50,Fail,43,49,1,7,36
50,Fail,50,32,5,13,37
50,Fail,42,41,0,17,25
50,Fail,53,29,3,15,38
50,Fail,54,31,0,13,41
50,Fail,44,41,0,14,30
50,Fail,46,40,0,13,33
50,Fail,42,44,7,7,35
50,Fail,51,38,0,5,46
50,Fail,48,37,0,11,37
50,Fail,46,32,0,19,27
50,Fail,48,35,0,14,34
50,Fail,49,29,0,15,34
50,Fail,42,34,0,20,22
50,Fail,50,40,0,10,40
50,Fail,44,35,7,14,30
50,Fail,44,34,0,15,29
50,Fail,45,27,0,19,26
50,Fail,48,39,5,8,40
50,Fail,40,31,16,13,27
50,Fail,50,39,0,10,40
50,Fail,50,33,5,12,38
50,Fail,50,32,0,10,40
50,Fail,40,39,7,14,26
50,Fail,55,29,0,10,45
50,Fail,51,33,0,10,41
50,Fail,48,39,0,11,37
50,Fail,46,28,6,20,26
50,Fail,48,37,0,11,37
50,Fail,51,34,0,10,41
50,Fail,42,36,0,15,27
50,Fail,49,41,0,8,41
50,Fail,44,42,3,11,33
50,Fail,52,30,7,11,41
50,Fail,52,37,0,10,42
50,Fail,45,30,6,19,26
50,Fail,53,34,0,11,42
50,Fail,51,38,2,9,42
50,Fail,49,33,0,13,36
50,Fail,47,34,0,15,32
50,Fail,54,36,0,10,44
50,Fail,45,38,1,16,29
50,Fail,45,41,2,12,33
50,Fail,47,33,0,13,34
50,Fail,54,33,0,10,44
50,Fail,48,36,0,15,33
50,Fail,52,32,2,14,38
50,Fail,52,35,1,12,40
50,Fail,49,35,2,14,35
50,Fail,49,38,3,10,39
50,Fail,57,29,0,12,45
50,Fail,54,27,5,14,40
50,Fail,46,29,13,12,34
50,Fail,60,24,3,13,47
50,Fail,56,30,2,12,44
50,Fail,42,43,3,12,30
50,Fail,56,31,0,13,43
50,Fail,55,33,4,8,47
50,Fail,45,40,2,13,32
50,Fail,50,36,0,12,38
50,Fail,54,34,2,10,44
50,Fail,50,38,0,10,40
50,Fail,45,38,0,14,31
50,Fail,39,43,0,15,24
50,Fail,50,33,0,14,36
50,Fail,57,28,0,15,42
50,Fail,41,32,8,19,22
50,Fail,48,33,9,10,38
50,Fail,49,36,0,11,38
50,Fail,52,32,3,13,39
50,Fail,52,38,2,8,44
50,Fail,49,36,5,10,39
50,Fail,52,32,1,15,37
50,Fail,52,35,0,13,39
50,Fail,38,48,0,8,30
50,Fail,46,36,8,10,36
50,Fail,51,32,0,8,43
50,Fail,38,35,9,18,20
50,Fail,45,44,0,11,34
50,Fail,49,42,0,9,40
50,Fail,48,33,5,14,34
50,Fail,47,34,5,14,33
50,Fail,43,38,9,10,33
50,Fail,53,30,2,15,38
50,Fail,45,41,1,13,32
50,Fail,49,37,1,13,36
50,Fail,45,40,0,11,34
50,Fail,43,40,3,14,29
50,Fail,52,31,1,16,36
50,Fail,52,30,0,16,36
50,Fail,46,39,0,10,36
50,Fail,48,26,0,15,33
50,Fail,41,40,0,17,24
50,Fail,53,36,2,9,44
50,Fail,43,41,0,9,34
50,Fail,47,41,0,10,37
50,Fail,48,31,0,9,39
50,Fail,56,30,0,12,44
50,Fail,55,35,0,8,47
50,Fail,50,40,0,10,40
50,Fail,42,38,0,14,28
50,Fail,47,44,0,9,38
50,Fail,41,42,3,14,27
50,Fail,47,34,4,15,32
50,Fail,40,33,11,16,24
50,Fail,45,37,0,16,29
50,Fail,51,33,1,15,36
50,Fail,54,37,0,9,45
50,Fail,49,38,4,9,40
50,Fail,41,45,0,11,30
50,Fail,54,31,4,11,43
50,Fail,55,26,0,13,42
50,Fail,48,35,0,11,37
50,Fail,53,34,0,11,42
50,Fail,46,32,8,14,32
50,Fail,47,32,0,18,29
50,Fail,45,38,2,15,30
50,Fail,47,34,0,13,34
50,Fail,50,31,0,12,38
50,Fail,48,31,0,14,34
50,Fail,43,36,11,10,33
50,Fail,49,36,0,8,41
50,Fail,50,32,8,10,40
50,Fail,46,35,0,11,35
50,Fail,48,29,10,13,35
50,Fail,45,42,0,13,32
50,Fail,42,39,0,17,25
50,Fail,49,34,3,14,35
50,Fail,52,36,0,9,43
50,Fail,40,39,0,14,26
50,Fail,48,38,3,11,37
50,Fail,40,39,5,16,24
50,Fail,44,39,1,16,28
50,Fail,50,27,0,13,37
50,Fail,45,35,4,16,29
50,Fail,49,33,6,12,37
50,Fail,44,36,5,15,29
50,Fail,42,37,6,15,27
50,Fail,53,31,0,9,44
50,Fail,47,28,0,11,36
50,Fail,38,41,3,18,20
50,Fail,45,35,0,18,27
50,Fail,55,31,0,10,45
50,Fail,56,29,0,15,41
50,Fail,42,39,0,13,29
50,Fail,45,41,2,12,33
50,Fail,47,40,0,10,37
50,Fail,54,29,0,14,40
50,Fail,50,38,0,5,45
50,Fail,40,41,3,16,24
50,Fail,49,32,5,14,35
50,Fail,51,34,4,11,40
50,Fail,51,35,0,14,37
50,Fail,45,39,0,15,30
50,Fail,48,36,1,15,33
50,Fail,47,40,0,13,34
50,Fail,44,34,0,16,28
50,Fail,57,31,0,8,49
50,Fail,52,36,1,11,41
50,Fail,52,33,0,11,41
50,Fail,53,35,4,8,45
50,Fail,55,34,2,9,46
50,Fail,46,27,0,16,30
50,Fail,46,31,0,21,25
50,Fail,48,41,0,10,38
50,Fail,39,43,2,16,23
50,Fail,50,39,3,8,42
50,Fail,51,31,7,11,40
50,Fail,47,37,4,12,35
50,Fail,41,35,0,20,21
50,Fail,50,32,7,11,39
50,Fail,44,34,0,14,30
50,Fail,54,31,2,13,41
50,Fail,45,35,8,12,33
50,Fail,57,30,2,11,46
50,Fail,51,33,0,11,40
50,Fail,47,36,1,16,31
50,Fail,51,34,0,10,41
50,Fail,47,39,0,11,36
50,Fail,49,25,10,16,33
50,Fail,57,28,0,13,44
50,Fail,51,34,2,13,38
50,Fail,44,38,0,9,35
50,Fail,32,42,0,19,13
50,Fail,49,33,2,16,33
50,Fail,49,39,0,6,43
50,Fail,50,35,1,14,36
50,Fail,51,35,0,13,38
50,Fail,52,36,0,8,44
50,Fail,53,29,2,16,37
50,Fail,50,33,0,11,39
50,Fail,50,33,8,9,41
50,Fail,46,38,2,14,32
50,Fail,48,39,0,8,40
50,Fail,50,36,5,9,41
50,Fail,53,25,5,17,36
50,Fail,50,37,1,12,38
50,Fail,50,33,2,15,35
50,Fail,52,38,0,10,42
50,Fail,50,33,2,15,35
50,Fail,53,38,1,8,45
50,Fail,45,39,0,13,32
50,Fail,41,45,2,12,29
50,Fail,54,33,2,11,43
50,Fail,47,37,0,10,37
50,Fail,48,34,0,14,34
50,Fail,50,35,0,9,41
50,Fail,53,31,0,13,40
50,Fail,43,35,0,16,27
50,Fail,48,38,1,13,35
50,Fail,45,39,1,15,30
50,Fail,46,32,7,15,31
50,Fail,46,39,2,13,33
50,Fail,45,41,2,12,33
50,Fail,45,40,5,10,35
50,Fail,39,48,1,12,27
50,Fail,53,32,0,8,45
50,Fail,48,37,7,8,40
50,Fail,43,43,2,12,31
50,Success,58,33,3,6,52
50,Fail,51,28,7,14,37
50,Fail,40,36,8,16,24
50,Fail,43,41,0,13,30
50,Fail,48,34,0,14,34
50,Fail,52,32,2,14,38
50,Fail,44,37,0,18,26
50,Success,64,24,0,6,58
50,Fail,48,32,6,14,34
50,Fail,50,29,0,19,31
50,Fail,53,35,0,11,42
50,Fail,49,38,1,12,37
50,Fail,53,29,0,13,40
50,Fail,51,36,5,8,43
50,Fail,52,35,2,11,41
50,Fail,41,38,3,18,23
50,Fail,49,40,0,10,39
50,Fail,51,28,0,18,33
50,Fail,38,42,0,16,22
50,Fail,53,33,0,12,41
50,Fail,44,29,0,20,24
50,Fail,58,30,0,10,48
50,Fail,43,24,13,20,23
50,Fail,46,29,0,21,25
50,Fail,49,36,0,14,35
50,Fail,46,33,1,20,26
50,Fail,50,38,0,10,40
50,Fail,56,31,0,12,44
50,Fail,47,30,6,17,30
50,Fail,42,42,3,13,29
50,Fail,42,40,0,13,29
50,Fail,42,37,3,18,24
50,Fail,47,45,1,7,40
50,Fail,49,34,0,12,37
50,Fail,48,32,0,15,33
50,Fail,45,32,0,14,31
50,Fail,43,38,3,16,27
50,Fail,51,37,2,10,41
50,Fail,53,31,1,15,38
50,Fail,47,34,5,14,33
50,Fail,43,37,6,14,29
50,Fail,47,34,4,15,32
50,Fail,58,30,0,10,48
50,Fail,50,37,1,12,38
50,Fail,53,39,0,7,46
50,Fail,41,40,0,18,23
50,Fail,52,26,8,14,38
50,Fail,42,31,0,17,25
50,Fail,44,40,0,10,34
50,Fail,47,32,0,11,36
50,Fail,48,41,0,10,38
50,Fail,47,34,0,14,33
50,Fail,49,40,0,9,40
50,Fail,53,39,2,6,47
50,Fail,48,32,0,10,38
50,Fail,52,26,9,13,39
50,Fail,50,33,6,11,39
50,Fail,56,31,2,11,45
50,Fail,53,39,1,7,46
50,Fail,51,29,2,18,33
50,Fail,43,38,2,17,26
50,Fail,45,35,5,15,30
50,Fail,46,36,1,17,29
50,Fail,43,44,0,12,31
50,Fail,47,35,0,16,31
50,Fail,49,34,8,9,40
50,Fail,47,41,1,11,36
50,Fail,48,39,0,13,35
50,Fail,46,34,4,16,30
50,Fail,49,29,8,14,35
50,Fail,46,33,0,21,25
50,Fail,48,32,0,13,35
50,Fail,44,41,5,10,34
50,Fail,58,30,1,11,47
50,Fail,38,35,0,15,23
50,Fail,54,26,0,8,46
50,Fail,58,30,1,11,47
50,Fail,45,42,0,11,34
50,Fail,44,46,2,8,36
50,Fail,41,39,0,16,25
50,Fail,43,37,2,18,25
50,Fail,40,36,14,10,30
50,Fail,36,37,6,21,15
50,Fail,56,27,3,14,42
50,Fail,47,37,5,11,36
50,Fail,44,38,1,17,27
50,Fail,48,36,5,11,37
50,Fail,44,40,0,13,31
50,Fail,45,40,0,13,32
50,Fail,50,33,0,15,35
50,Fail,50,35,0,7,43
50,Fail,45,38,0,14,31
50,Success,61,30,1,8,53
50,Fail,48,35,6,11,37
50,Fail,50,35,0,14,36
50,Fail,49,34,0,12,37
50,Fail,48,40,0,10,38
50,Fail,52,28,0,17,35
50,Fail,45,33,0,15,30
50,Success,60,27,0,9,51
50,Fail,47,37,0,16,31
50,Fail,53,35,0,11,42
50,Fail,49,42,1,8,41
50,Fail,49,37,0,12,37
50,Fail,46,33,5,16,30
50,Fail,53,33,0,14,39
50,Fail,45,35,0,18,27
50,Fail,54,34,0,12,42
50,Fail,41,39,3,17,24
50,Fail,44,42,0,14,30
50,Fail,52,31,1,16,36
50,Fail,53,36,0,9,44
50,Fail,52,35,0,12,40
50,Fail,55,33,0,8,47
50,Fail,48,31,7,14,34
50,Fail,48,35,8,9,39
50,Fail,49,32,8,11,38
50,Fail,52,31,0,9,43
50,Fail,51,33,0,11,40
50,Fail,45,34,0,14,31
50,Fail,48,30,4,18,30
50,Fail,51,37,4,8,43
50,Success,58,29,0,6,52
50,Fail,52,28,0,11,41
50,Fail,47,34,0,11,36
50,Fail,57,33,0,9,48
50,Fail,39,46,6,9,30
50,Fail,43,38,3,16,27
50,Fail,45,33,8,14,31
50,Fail,48,35,3,14,34
50,Fail,48,31,8,13,35
50,Fail,45,32,0,16,29
50,Fail,46,40,0,7,39
50,Fail,52,35,3,10,42
50,Fail,49,39,0,11,38
50,Fail,41,37,8,14,27
50,Fail,44,41,0,14,30
50,Fail,46,34,5,15,31
50,Fail,51,40,0,5,46
50,Fail,47,39,4,10,37
50,Fail,48,29,0,16,32
50,Fail,46,38,0,15,31
50,Fail,45,34,0,17,28
50,Fail,53,33,3,11,42
50,Fail,58,30,0,11,47
50,Fail,45,32,0,15,30
50,Fail,47,35,6,12,35
50,Fail,49,36,6,9,40
50,Success,57,35,1,7,50
50,Fail,39,44,3,14,25
50,Fail,46,34,0,14,32
50,Fail,45,39,0,16,29
50,Fail,51,34,2,13,38
50,Fail,49,26,14,11,38
50,Fail,51,38,2,9,42
50,Fail,45,41,0,14,31
50,Fail,47,37,0,10,37
50,Fail,54,31,0,14,40
50,Fail,47,38,0,14,33
50,Fail,49,34,1,16,33
50,Fail,51,32,0,15,36
50,Fail,47,36,7,10,37
50,Fail,50,36,0,13,37
50,Fail,48,27,0,15,33
50,Fail,42,40,5,13,29
50,Fail,54,33,0,9,45
50,Fail,54,27,3,16,38
50,Fail,56,30,0,12,44
50,Fail,52,31,0,10,42
50,Fail,49,31,0,8,41
50,Fail,51,34,0,8,43
50,Fail,43,39,10,8,35
50,Fail,50,34,0,11,39
50,Fail,50,34,0,11,39
50,Fail,49,32,7,12,37
50,Fail,43,36,6,15,28
50,Fail,51,32,0,17,34
50,Fail,54,32,0,13,41
50,Fail,45,40,0,14,31
50,Fail,48,43,0,7,41
50,Fail,43,40,0,14,29
50,Fail,48,30,7,15,33
50,Fail,42,43,3,12,30
50,Fail,51,39,3,7,44
50,Fail,44,39,1,16,28
50,Fail,52,35,0,8,44
50,Fail,48,33,0,15,33
50,Fail,42,40,0,8,34
50,Fail,52,35,0,11,41
50,Fail,55,32,2,11,44
50,Fail,54,36,2,8,46
50,Fail,51,34,0,15,36
50,Fail,48,33,0,14,34
50,Fail,47,38,2,13,34
50,Fail,42,35,4,19,23
50,Fail,48,35,6,11,37
50,Fail,43,39,6,12,31
50,Fail,40,41,0,15,25
50,Fail,49,35,1,15,34
50,Fail,56,32,3,9,47
50,Fail,47,40,0,11,36
50,Fail,48,37,3,12,36
50,Fail,54,31,0,13,41
50,Fail,52,30,0,11,41
50,Fail,51,28,0,19,32
50,Fail,45,42,0,13,32
50,Fail,47,40,0,12,35
50,Fail,49,39,0,11,38
50,Fail,42,38,0,20,22
50,Fail,52,30,4,14,38
50,Fail,42,39,6,13,29
50,Fail,44,34,11,11,33
50,Fail,47,38,3,12,35
50,Fail,45,36,6,13,32
50,Fail,38,39,0,15,23
50,Fail,49,37,5,9,40
50,Fail,52,32,3,13,39
50,Fail,46,32,0,16,30
50,Fail,45,38,6,11,34
50,Fail,50,36,1,13,37
50,Fail,50,31,0,14,36
50,Fail,46,36,0,13,33
50,Fail,53,34,4,9,44
50,Fail,51,24,0,16,35
50,Fail,50,35,0,14,36
50,Fail,41,45,6,8,33
50,Fail,43,40,4,13,30
50,Fail,52,30,0,15,37
50,Fail,56,26,1,17,39
50,Fail,38,38,11,13,25
50,Fail,52,39,1,8,44
50,Fail,48,39,1,12,36
50,Fail,53,38,0,9,44
50,Fail,43,44,0,12,31
50,Fail,45,36,0,18,27
50,Fail,47,36,5,12,35
50,Fail,48,29,0,16,32
50,Fail,47,25,8,20,27
50,Fail,52,35,0,12,40
50,Fail,43,40,0,13,30
50,Fail,52,31,0,12,40
50,Fail,39,41,9,11,28
50,Fail,54,30,0,13,41
50,Fail,51,37,0,10,41
50,Fail,50,33,0,16,34
50,Fail,42,39,0,16,26
50,Fail,51,30,0,13,38
50,Fail,41,31,6,22,19
50,Fail,48,43,0,9,39
50,Fail,55,28,0,8,47
50,Fail,44,35,7,14,30
50,Fail,46,36,0,17,29
50,Fail,53,38,0,8,45
50,Fail,44,45,2,9,35
50,Fail,46,39,3,12,34
50,Fail,38,39,8,15,23
50,Fail,42,36,4,18,24
50,Fail,49,34,0,10,39
50,Fail,45,33,0,17,28
50,Fail,56,31,1,12,44
50,Fail,47,40,0,9,38
50,Fail,51,31,6,12,39
50,Fail,54,26,0,19,35
50,Fail,49,28,7,16,33
50,Success,59,22,0,9,50
50,Fail,45,30,0,21,24
50,Fail,51,38,0,9,42
50,Fail,52,30,1,17,35
50,Fail,38,42,7,13,25
50,Fail,50,30,0,14,36
50,Fail,48,39,1,12,36
50,Fail,37,44,11,8,29
50,Fail,35,45,0,18,17
50,Fail,43,38,0,13,30
50,Fail,47,33,0,17,30
50,Fail,42,39,0,18,24
50,Fail,52,31,0,16,36
50,Fail,53,34,3,10,43
50,Fail,48,30,0,15,33
50,Fail,53,30,1,16,37
50,Fail,49,33,3,15,34
50,Fail,49,35,0,9,40
50,Fail,48,31,3,18,30
50,Fail,51,41,0,7,44
50,Fail,50,31,0,15,35
50,Fail,49,29,11,11,38
50,Fail,53,37,2,8,45
50,Fail,59,28,0,12,47
50,Fail,43,43,6,8,35
50,Fail,44,43,0,11,33
50,Fail,42,38,8,12,30
50,Fail,52,36,1,11,41
50,Fail,48,33,0,19,29
50,Fail,47,38,0,11,36
50,Fail,50,37,0,11,39
50,Fail,45,41,0,13,32
50,Fail,40,46,0,13,27
50,Fail,44,38,0,12,32
50,Fail,52,44,0,4,48
50,Fail,45,35,4,16,29
50,Fail,42,35,0,13,29
50,Fail,52,35,0,9,43
50,Fail,53,32,3,12,41
50,Fail,54,34,2,10,44
50,Fail,46,40,0,10,36
50,Fail,53,32,0,9,44
50,Fail,46,39,6,9,37
50,Fail,42,44,0,11,31
50,Fail,47,38,1,14,33
50,Fail,50,36,0,11,39
50,Fail,48,36,8,8,40
50,Fail,53,33,0,14,39
50,Fail,46,31,0,18,28
50,Fail,35,39,0,17,18
50,Fail,51,34,1,14,37
50,Fail,51,35,2,12,39
50,Fail,45,31,5,19,26
50,Fail,48,36,0,15,33
50,Fail,47,38,0,13,34
50,Fail,52,37,2,9,43
50,Fail,52,35,0,9,43
50,Fail,53,31,6,10,43
50,Fail,40,44,6,10,30
50,Fail,48,41,0,9,39
50,Fail,44,34,0,13,31
50,Fail,40,48,2,10,30
50,Fail,52,32,0,13,39
50,Fail,46,38,5,11,35
50,Fail,47,39,5,9,38
50,Fail,49,38,1,12,37
50,Fail,48,35,5,12,36
50,Fail,47,37,0,16,31
50,Fail,43,38,0,17,26
50,Fail,49,38,0,12,37
50,Fail,47,36,0,10,37
50,Fail,51,35,1,13,38
50,Fail,51,36,0,9,42
50,Fail,53,31,5,11,42
50,Fail,50,31,5,14,36
50,Fail,50,33,0,15,35
50,Fail,53,41,1,5,48
50,Fail,45,46,2,7,38
50,Fail,56,32,2,10,46
50,Fail,49,41,2,8,41
50,Fail,44,40,0,11,33
50,Fail,42,37,0,14,28
50,Fail,50,37,1,12,38
50,Fail,44,38,0,15,29
50,Fail,45,34,9,12,33
50,Fail,47,29,0,15,32
50,Fail,51,31,5,13,38
50,Fail,38,29,12,21,17
50,Fail,46,36,0,17,29
50,Fail,47,33,0,12,35
50,Fail,46,36,0,14,32
50,Fail,40,39,0,15,25
50,Fail,50,40,4,6,44
50,Fail,47,39,0,11,36
50,Fail,40,39,0,17,23
50,Fail,50,32,0,11,39
50,Fail,45,36,10,9,36
50,Fail,48,33,6,13,35
50,Fail,48,40,0,9,39
50,Fail,46,38,9,7,39
50,Fail,46,37,0,16,30
50,Fail,47,31,0,15,32
50,Fail,53,29,4,14,39
50,Fail,52,34,0,9,43
50,Fail,48,30,5,17,31
50,Fail,51,35,5,9,42
50,Fail,42,39,0,15,27
50,Fail,46,31,0,14,32
50,Fail,48,36,8,8,40
50,Fail,57,32,2,9,48
50,Fail,54,33,0,12,42
50,Fail,54,30,2,14,40
50,Fail,52,35,0,12,40
50,Fail,40,43,6,11,29
50,Fail,47,36,0,13,34
50,Fail,51,36,5,8,43
50,Fail,47,37,4,12,35
50,Fail,49,37,0,9,40
50,Fail,47,39,0,14,33
50,Fail,47,40,0,10,37
50,Fail,49,41,0,7,42
50,Fail,42,42,4,12,30
50,Fail,47,33,4,16,31
50,Fail,44,36,0,15,29
50,Fail,55,32,0,13,42
50,Fail,46,34,0,12,34
50,Fail,42,31,0,19,23
50,Fail,43,39,0,12,31
50,Fail,54,36,0,9,45
50,Fail,42,44,6,8,34
50,Fail,50,40,0,7,43
50,Fail,46,40,0,7,39
50,Fail,36,42,0,17,19
50,Fail,42,34,0,18,24
50,Fail,46,37,0,14,32
50,Fail,47,41,1,11,36
50,Fail,43,40,0,13,30
50,Fail,39,43,0,16,23
50,Fail,51,37,6,6,45
50,Fail,49,37,2,12,37
50,Fail,46,38,0,16,30
50,Fail,47,40,5,8,39
50,Fail,55,34,1,10,45
50,Fail,54,31,0,11,43
50,Fail,48,34,7,11,37
50,Fail,42,39,4,15,27
50,Fail,42,38,0,11,31
50,Fail,49,34,10,7,42
50,Fail,53,36,2,9,44
50,Fail,43,43,0,12,31
50,Fail,42,39,0,16,26
50,Fail,55,30,2,13,42
50,Fail,50,37,1,12,38
50,Fail,49,31,4,16,33
50,Fail,45,40,0,13,32
50,Fail,55,32,0,9,46
50,Fail,47,36,0,10,37
50,Fail,43,37,0,12,31
50,Fail,49,33,0,16,33
50,Fail,51,33,1,15,36
50,Fail,47,31,9,13,34
50,Fail,56,32,3,9,47
50,Fail,54,36,0,10,44
50,Fail,44,46,0,8,36
50,Fail,54,34,0,11,43
50,Fail,49,33,0,18,31
50,Fail,48,32,8,12,36
50,Fail,53,35,2,10,43
50,Fail,56,28,6,10,46
50,Fail,47,28,3,22,25
50,Fail,45,38,0,13,32
50,Fail,51,34,1,14,37
50,Fail,39,41,8,12,27
50,Fail,40,34,0,17,23
50,Fail,45,37,0,15,30
50,Fail,57,32,0,8,49
50,Fail,56,33,0,10,46
50,Fail,50,38,0,10,40
50,Fail,46,41,0,12,34
50,Fail,46,32,5,17,29
50,Fail,45,34,0,14,31
50,Fail,40,41,3,16,24
50,Fail,46,40,0,10,36
50,Fail,49,33,0,14,35
50,Fail,54,29,0,8,46
50,Fail,46,32,0,12,34
50,Fail,54,32,1,13,41
50,Fail,52,30,0,15,37
50,Fail,42,45,0,13,29
50,Fail,43,32,0,16,27
50,Fail,50,37,1,12,38
50,Fail,51,30,0,15,36
50,Success,57,32,0,7,50
50,Fail,43,33,7,17,26
50,Fail,38,34,11,17,21
50,Fail,56,33,0,7,49
50,Fail,44,42,0,11,33
50,Fail,49,34,0,14,35
50,Fail,50,38,0,9,41
50,Fail,42,39,0,13,29
50,Fail,48,35,0,15,33
50,Fail,51,38,3,8,43
50,Fail,51,44,0,5,46
50,Fail,42,33,0,16,26
50,Fail,43,34,11,12,31
50,Fail,50,30,4,16,34
50,Fail,52,37,0,9,43
50,Fail,49,40,0,11,38
50,Fail,56,30,0,10,46
50,Fail,50,38,0,10,40
50,Fail,41,44,5,10,31
50,Fail,54,32,0,8,46
50,Fail,44,27,9,20,24
50,Fail,56,32,2,10,46
50,Fail,52,38,1,9,43
50,Fail,45,37,3,15,30
50,Fail,42,38,0,17,25
50,Fail,50,33,3,14,36
50,Fail,46,39,0,11,35
50,Fail,51,29,7,13,38
50,Fail,53,31,2,14,39
50,Fail,52,36,1,11,41
50,Fail,52,35,0,10,42
50,Fail,50,31,0,13,37
50,Fail,52,29,0,19,33
50,Fail,40,46,0,12,28
50,Fail,53,36,2,9,44
50,Fail,56,34,0,9,47
50,Fail,47,34,1,18,29
50,Fail,43,29,6,22,21
50,Fail,49,38,7,6,43
50,Fail,47,35,6,12,35
50,Fail,46,38,0,15,31
50,Success,59,31,0,7,52
50,Fail,50,37,0,9,41
50,Fail,50,28,0,16,34
50,Fail,48,35,3,14,34
50,Fail,43,32,0,12,31
50,Fail,52,34,1,13,39
50,Fail,39,39,6,16,23
50,Fail,44,36,3,17,27
50,Fail,47,38,6,9,38
50,Fail,50,37,1,12,38
50,Fail,45,31,5,19,26
50,Fail,47,40,2,11,36
50,Fail,47,39,8,6,41
50,Fail,47,32,2,19,28
50,Fail,50,33,1,16,34
50,Fail,52,32,3,13,39
50,Fail,52,26,0,13,39
50,Fail,37,45,7,11,26
50,Fail,45,33,0,16,29
50,Fail,46,37,0,10,36
50,Fail,46,41,0,12,34
50,Fail,41,40,0,15,26
50,Fail,46,30,5,19,27
50,Fail,49,43,1,7,42
50,Fail,54,28,6,12,42
50,Fail,50,30,7,13,37
50,Fail,44,42,0,14,30
50,Fail,52,34,5,9,43
50,Fail,52,31,0,16,36
50,Fail,50,33,0,12,38
50,Fail,44,40,2,14,30
50,Fail,56,26,0,13,43
50,Fail,43,41,0,13,30
50,Fail,48,37,0,12,36
50,Fail,45,39,0,13,32
50,Fail,48,35,3,14,34
50,Fail,45,42,0,10,35
50,Fail,45,34,0,12,33
50,Fail,42,40,5,13,29
50,Fail,39,43,0,15,24
50,Fail,45,36,0,18,27
50,Success,62,26,0,11,51
50,Fail,55,31,2,12,43
50,Fail,48,35,0,16,32
50,Fail,42,47,1,10,32
50,Fail,45,42,2,11,34
50,Fail,52,32,2,14,38
50,Fail,45,30,0,19,26
50,Fail,48,36,0,15,33
50,Fail,54,33,0,13,41
50,Fail,44,42,0,12,32
50,Fail,45,34,0,17,28
50,Fail,45,38,1,16,29
50,Success,57,34,2,7,50
50,Fail,48,36,4,12,36
50,Fail,47,33,7,13,34
50,Fail,43,42,0,12,31
50,Fail,45,25,0,18,27
50,Fail,51,36,4,9,42
50,Fail,48,37,3,12,36
50,Fail,56,30,0,13,43
50,Fail,46,39,0,15,31
50,Fail,51,35,5,9,42
50,Fail,55,28,6,11,44
50,Fail,42,39,0,16,26
50,Fail,47,32,0,11,36
50,Fail,48,32,4,16,32
50,Fail,44,35,5,16,28
50,Success,62,26,0,9,53
50,Fail,48,29,0,12,36
50,Fail,49,29,4,18,31
50,Fail,43,38,5,14,29
50,Fail,47,41,2,10,37
50,Fail,41,38,0,12,29
50,Fail,36,31,0,21,15
50,Fail,54,31,6,9,45
50,Fail,50,34,0,13,37
50,Fail,46,41,2,11,35
50,Fail,51,31,8,10,41
50,Fail,56,32,0,10,46
50,Fail,45,44,1,10,35
50,Fail,48,29,0,15,33
50,Fail,53,34,3,10,43
50,Fail,47,36,0,11,36
50,Fail,48,34,0,14,34
50,Fail,48,35,0,13,35
50,Fail,44,38,6,12,32
50,Fail,42,35,0,13,29
50,Fail,50,32,7,11,39
50,Fail,43,39,1,17,26
50,Success,55,31,0,5,50
50,Fail,47,36,1,16,31
50,Fail,53,26,0,14,39
50,Fail,40,42,0,12,28
50,Fail,48,35,6,11,37
50,Fail,45,38,6,11,34
50,Fail,41,42,1,16,25
50,Fail,48,34,0,13,35
50,Fail,41,51,0,8,33
50,Fail,55,34,0,9,46
50,Fail,43,37,2,18,25
50,Fail,41,31,12,16,25
50,Fail,48,32,1,19,29
50,Fail,41,39,0,16,25
50,Fail,53,30,0,17,36
50,Fail,45,42,2,11,34
50,Fail,47,40,3,10,37
50,Fail,60,24,0,11,49
50,Fail,45,36,0,16,29
50,Fail,42,39,0,16,26
50,Fail,42,41,0,15,27
50,Fail,45,32,0,17,28
50,Fail,42,40,2,16,26
50,Fail,47,36,0,14,33
50,Fail,44,38,2,16,28
50,Fail,44,39,0,9,35
50,Fail,46,35,0,15,31
50,Fail,45,40,0,15,30
50,Fail,45,44,0,10,35
50,Fail,37,50,2,11,26
50,Fail,48,39,0,13,35
50,Fail,50,30,0,10,40
50,Fail,43,39,0,15,28
50,Fail,45,35,0,11,34
50,Fail,54,31,0,15,39
50,Fail,49,38,3,10,39
50,Fail,51,35,0,13,38
50,Fail,42,40,3,15,27
50,Fail,53,29,6,12,41
50,Fail,47,36,0,10,37
50,Fail,49,38,0,7,42
50,Fail,49,41,6,4,45
50,Fail,50,28,7,15,35
50,Fail,52,35,3,10,42
50,Fail,50,35,6,9,41
50,Fail,53,36,1,10,43
50,Fail,47,39,0,13,34
50,Fail,41,39,0,12,29
50,Fail,45,34,1,20,25
50,Fail,44,39,5,12,32
50,Fail,53,30,3,14,39
50,Fail,54,32,2,12,42
50,Fail,44,34,9,13,31
50,Fail,49,35,4,12,37
50,Fail,45,38,0,15,30
50,Fail,40,35,8,17,23
50,Fail,50,36,0,5,45
50,Fail,42,34,7,17,25
50,Fail,38,42,0,15,23
50,Fail,53,37,0,9,44
50,Fail,53,35,2,10,43
50,Fail,50,34,3,13,37
50,Fail,54,34,0,12,42
50,Fail,54,33,1,12,42
50,Fail,47,32,8,13,34
50,Fail,53,36,2,9,44
50,Fail,49,37,0,10,39
50,Fail,49,38,0,8,41
50,Fail,46,40,0,7,39
50,Fail,45,46,1,8,37
50,Fail,49,27,9,15,34
50,Fail,46,31,0,11,35
50,Fail,55,28,2,15,40
50,Fail,47,42,0,11,36
50,Fail,44,38,0,10,34
50,Fail,40,36,0,17,23
50,Success,57,34,0,7,50
50,Fail,50,31,4,15,35
50,Fail,54,29,9,8,46
50,Fail,55,31,1,13,42
50,Fail,47,39,1,13,34
50,Fail,45,32,0,16,29
50,Fail,45,39,3,13,32
50,Fail,53,31,1,15,38
50,Fail,46,39,3,12,34
50,Fail,53,34,4,9,44
50,Fail,45,38,0,9,36
50,Fail,52,38,2,8,44
50,Fail,54,36,0,9,45
50,Fail,46,38,5,11,35
50,Fail,49,36,0,13,36
50,Fail,53,35,0,9,44
50,Fail,49,33,9,9,40
50,Fail,50,36,0,13,37
50,Fail,46,29,0,15,31
50,Fail,45,33,0,10,35
50,Fail,46,41,1,12,34
50,Fail,49,38,0,13,36
50,Fail,46,36,2,16,30
50,Fail,43,35,0,12,31
50,Fail,47,32,0,15,32
50,Fail,43,37,0,9,34
50,Fail,53,33,0,12,41
50,Fail,38,37,8,17,21
50,Fail,44,45,0,11,33
50,Fail,49,37,4,10,39
50,Fail,47,41,0,11,36
50,Fail,50,38,2,10,40
50,Fail,48,32,6,14,34
50,Fail,50,32,0,15,35
50,Fail,44,35,3,18,26
50,Fail,47,28,0,21,26
50,Fail,46,32,0,17,29
50,Fail,40,31,7,22,18
50,Fail,53,39,2,6,47
50,Fail,51,40,1,8,43
50,Fail,46,41,0,10,36
50,Fail,45,38,2,15,30
50,Fail,42,40,6,12,30
50,Fail,51,40,2,7,44
50,Fail,44,40,2,14,30
50,Fail,51,26,12,11,40
50,Fail,47,34,8,11,36
50,Fail,44,34,0,14,30
50,Fail,46,37,0,10,36
50,Fail,50,33,0,12,38
50,Fail,54,30,7,9,45
50,Fail,53,40,0,6,47
50,Fail,52,33,0,10,42
50,Fail,50,33,3,14,36
50,Fail,46,35,1,18,28
50,Fail,56,26,0,12,44
50,Fail,53,27,5,15,38
50,Fail,44,37,0,13,31
50,Fail,42,46,2,10,32
50,Fail,47,31,0,18,29
50,Fail,47,38,0,12,35
50,Fail,45,34,0,13,32
50,Fail,49,32,0,13,36
50,Fail,42,39,0,17,25
50,Success,59,32,1,8,51
50,Fail,43,39,0,14,29
50,Fail,50,32,7,11,39
50,Fail,47,36,1,16,31
50,Fail,48,38,0,14,34
50,Fail,43,34,4,19,24
50,Fail,43,37,0,13,30
50,Fail,49,34,0,13,36
50,Fail,49,36,0,9,40
50,Fail,54,34,0,9,45
50,Fail,39,36,0,20,19
50,Fail,55,34,0,8,47
50,Fail,52,39,1,8,44
50,Fail,50,40,0,8,42
50,Fail,42,36,0,19,23
50,Fail,49,41,2,8,41
50,Fail,51,31,0,13,38
50,Fail,42,33,7,18,24
50,Fail,44,35,6,15,29
50,Fail,41,37,5,17,24
50,Fail,46,39,0,15,31
50,Fail,44,38,0,14,30
50,Fail,47,36,7,10,37
50,Fail,51,35,0,14,37
50,Fail,40,37,0,14,26
50,Fail,57,32,3,8,49
50,Fail,52,33,5,10,42
50,Fail,46,35,2,17,29
50,Fail,52,32,0,10,42
50,Fail,52,34,0,12,40
50,Fail,56,34,0,10,46
50,Fail,44,39,0,16,28
50,Fail,47,39,2,12,35
50,Fail,38,32,11,19,19
50,Fail,45,36,0,10,35
50,Fail,48,33,0,19,29
50,Fail,46,27,11,16,30
50,Fail,53,37,2,8,45
50,Fail,45,44,0,11,34
50,Fail,49,38,0,9,40
50,Fail,53,37,0,7,46
50,Fail,45,36,6,13,32
50,Fail,54,35,2,9,45
50,Fail,51,29,6,14,37
50,Fail,46,30,5,19,27
50,Fail,47,39,1,13,34
50,Fail,47,36,0,13,34
50,Fail,39,42,5,14,25
50,Fail,45,40,1,14,31
50,Fail,53,27,3,17,36
50,Fail,46,35,8,11,35
50,Fail,54,29,0,17,37
50,Fail,52,33,3,12,40
50,Fail,45,29,0,14,31
50,Fail,52,35,0,9,43
50,Fail,43,35,0,10,33
50,Fail,40,32,11,17,23
50,Fail,51,30,0,10,41
50,Fail,53,35,2,10,43
50,Fail,39,42,1,18,21
50,Fail,50,38,3,9,41
50,Fail,51,35,0,12,39
50,Fail,47,43,1,9,38
50,Fail,54,26,0,16,38
50,Fail,50,36,0,12,38
50,Fail,44,37,0,14,30
50,Fail,46,36,0,14,32
50,Fail,46,42,4,8,38
50,Fail,52,35,0,13,39
50,Fail,57,30,0,9,48
50,Fail,41,34,0,13,28
50,Fail,45,42,0,10,35
50,Fail,45,37,0,15,30
50,Fail,57,32,3,8,49
50,Fail,44,41,1,14,30
50,Fail,44,42,0,13,31
50,Fail,48,36,0,7,41
50,Fail,47,34,8,11,36
50,Fail,56,34,1,9,47
50,Fail,53,28,0,13,40
50,Fail,46,33,8,13,33
50,Fail,46,34,3,17,29
50,Fail,51,33,0,12,39
50,Fail,46,44,0,6,40
50,Fail,49,36,4,11,38
50,Fail,52,34,0,11,41
50,Fail,50,37,0,12,38
50,Fail,47,32,2,19,28
50,Fail,48,38,0,13,35
50,Fail,49,37,2,12,37
50,Fail,40,36,0,16,24
50,Fail,46,33,3,18,28
50,Fail,52,31,2,15,37
50,Fail,47,36,4,13,34
50,Fail,42,43,6,9,33
50,Fail,42,30,0,19,23
50,Fail,56,28,0,16,40
50,Fail,45,39,3,13,32
50,Fail,43,39,0,17,26
50,Fail,48,38,6,8,40
50,Fail,49,33,0,13,36
50,Fail,50,30,0,13,37
50,Fail,44,42,3,11,33
50,Fail,47,42,2,9,38
50,Fail,51,36,0,13,38
50,Fail,39,39,0,16,23
50,Fail,50,38,0,7,43
50,Fail,51,29,0,17,34
50,Fail,42,36,0,13,29
50,Fail,47,38,0,13,34
50,Fail,43,43,3,11,32
50,Fail,51,32,0,13,38
50,Fail,42,44,0,14,28
50,Fail,43,36,0,15,28
50,Fail,51,36,1,12,39
50,Fail,48,41,0,11,37
50,Fail,48,31,0,21,27
50,Fail,48,35,3,14,34
50,Fail,52,34,0,11,41
50,Fail,48,34,11,7,41
50,Fail,50,34,0,12,38
50,Fail,44,33,0,17,27
50,Fail,50,31,0,10,40
50,Fail,42,43,0,15,27
50,Fail,54,37,0,8,46
50,Fail,45,35,0,16,29
50,Fail,46,41,3,10,36
50,Fail,50,36,0,11,39
50,Fail,45,29,9,17,28
50,Fail,43,44,0,10,33
50,Fail,55,31,0,9,46
50,Fail,53,30,0,14,39
50,Fail,54,32,2,12,42
50,Fail,53,34,2,11,42
50,Fail,44,33,0,13,31
50,Fail,47,35,4,14,33
50,Fail,56,31,0,11,45
50,Fail,42,36,0,20,22
50,Fail,51,39,0,10,41
50,Fail,54,37,0,9,45
50,Fail,47,39,0,14,33
50,Fail,47,40,1,12,35
50,Fail,43,40,0,17,26
50,Fail,47,34,0,11,36
50,Fail,52,33,2,13,39
50,Fail,50,38,5,7,43
50,Fail,50,31,0,16,34
50,Fail,41,39,0,11,30
50,Fail,48,40,0,7,41
50,Fail,45,35,0,13,32
50,Fail,44,39,0,9,35
50,Fail,48,41,3,8,40
50,Fail,56,30,0,9,47
50,Fail,43,39,0,13,30
50,Fail,52,35,0,9,43
50,Fail,48,28,0,17,31
50,Fail,48,35,1,16,32
50,Fail,50,32,4,14,36
50,Fail,48,34,3,15,33
50,Fail,46,35,0,14,32
50,Fail,46,41,2,11,35
50,Fail,48,31,0,18,30
50,Fail,55,30,2,13,42
50,Fail,51,38,0,11,40
50,Fail,44,41,3,12,32
50,Fail,60,27,0,12,48
50,Fail,44,30,0,19,25
50,Fail,45,32,12,11,34
50,Fail,50,33,6,11,39
50,Fail,46,36,0,13,33
50,Fail,41,41,8,10,31
50,Fail,50,38,2,10,40
50,Fail,42,37,0,16,26
50,Fail,45,35,8,12,33
50,Fail,44,42,0,14,30
50,Fail,44,41,2,13,31
50,Fail,49,32,5,14,35
50,Fail,47,42,0,9,38
50,Fail,50,38,1,11,39
50,Fail,55,31,3,11,44
50,Fail,44,39,0,11,33
50,Fail,47,39,4,10,37
50,Fail,47,36,0,14,33
50,Fail,59,26,0,11,48
50,Fail,48,36,1,15,33
50,Fail,51,33,1,15,36
50,Fail,46,44,0,10,36
50,Fail,53,29,10,8,45
50,Fail,51,34,0,13,38
50,Fail,38,32,14,16,22
50,Fail,49,42,0,9,40
50,Fail,47,32,0,12,35
50,Fail,40,44,2,14,26
50,Fail,44,33,0,10,34
50,Fail,48,36,5,11,37
50,Fail,50,39,3,8,42
50,Fail,45,36,0,17,28
50,Fail,53,27,0,13,40
50,Fail,47,39,2,12,35
50,Fail,49,38,0,12,37
50,Fail,53,33,0,11,42
50,Fail,47,38,0,14,33
50,Fail,46,34,7,13,33
50,Fail,46,35,7,12,34
50,Fail,43,41,7,9,34
50,Fail,43,35,6,16,27
50,Fail,47,34,3,16,31
50,Fail,48,38,7,7,41
50,Fail,51,34,1,14,37
50,Fail,53,31,0,14,39
50,Fail,53,33,3,11,42
50,Fail,54,32,0,13,41
50,Fail,47,37,0,16,31
50,Fail,49,35,7,9,40
50,Fail,49,36,0,11,38
50,Fail,46,26,15,13,33
50,Fail,49,36,2,13,36
50,Fail,49,37,0,10,39
50,Fail,46,38,0,16,30
50,Fail,49,32,6,13,36
50,Fail,47,41,2,10,37
50,Fail,45,40,0,15,30
50,Fail,46,39,8,7,39
50,Fail,50,32,2,16,34
50,Fail,52,36,0,10,42
50,Fail,45,37,6,12,33
50,Fail,52,38,2,8,44
50,Fail,50,32,2,16,34
50,Fail,55,26,0,11,44
50,Fail,49,40,0,10,39
50,Fail,50,35,2,13,37
50,Fail,48,29,6,17,31
50,Fail,52,35,0,10,42
50,Fail,53,30,1,16,37
50,Fail,52,25,0,13,39
50,Fail,44,38,4,14,30
50,Fail,47,29,1,23,24
50,Fail,48,38,0,14,34
50,Fail,43,36,0,17,26
50,Fail,51,35,0,12,39
50,Fail,53,35,1,11,42
50,Fail,49,32,7,12,37
50,Fail,42,38,0,14,28
50,Fail,42,44,0,12,30
50,Fail,48,37,0,11,37
50,Fail,44,29,0,12,32
50,Fail,54,35,0,11,43
50,Fail,48,30,8,14,34
50,Fail,46,35,7,12,34
50,Fail,50,36,0,12,38
50,Fail,45,39,0,15,30
50,Fail,47,29,4,20,27
50,Fail,41,38,0,13,28
50,Fail,38,39,0,14,24
50,Fail,52,23,0,13,39
50,Fail,42,45,0,11,31
50,Fail,50,33,4,13,37
50,Fail,54,32,1,13,41
50,Fail,51,33,0,13,38
50,Fail,52,41,1,6,46
50,Fail,37,43,3,17,20
50,Fail,58,30,0,12,46
50,Fail,53,33,1,13,40
50,Fail,46,33,0,15,31
50,Fail,53,36,0,8,45
50,Fail,50,35,0,12,38
50,Fail,46,38,0,12,34
50,Fail,48,33,0,14,34
50,Fail,40,43,4,13,27
50,Fail,45,35,4,16,29
50,Fail,46,39,0,12,34
50,Fail,45,27,10,18,27
50,Fail,57,33,0,9,48
50,Fail,42,39,9,10,32
50,Fail,47,36,0,14,33
50,Fail,46,39,1,14,32
50,Fail,44,37,4,15,29
50,Fail,47,34,0,15,32
50,Fail,41,32,0,21,20
50,Fail,43,38,6,13,30
50,Fail,47,38,2,13,34
50,Fail,47,35,2,16,31
50,Fail,47,31,0,20,27
50,Fail,42,38,3,17,25
50,Fail,50,35,0,13,37
50,Fail,42,30,9,19,23
50,Fail,46,46,2,6,40
50,Fail,51,34,0,11,40
50,Fail,42,30,0,19,23
50,Fail,43,29,13,15,28
50,Fail,44,40,0,13,31
50,Fail,44,36,3,17,27
50,Fail,49,33,5,13,36
50,Fail,48,37,1,14,34
50,Fail,45,38,3,14,31
50,Fail,44,35,5,16,28
50,Fail,45,41,2,12,33
50,Fail,49,34,0,9,40
50,Fail,54,41,0,5,49
50,Fail,50,35,4,11,39
50,Fail,53,29,2,16,37
50,Fail,45,35,0,15,30
50,Fail,55,30,0,12,43
50,Fail,45,31,0,20,25
50,Fail,50,34,0,12,38
50,Fail,41,39,0,15,26
50,Fail,54,33,1,12,42
50,Fail,50,33,0,16,34
50,Fail,45,37,0,10,35
50,Fail,51,33,0,8,43
50,Fail,49,34,6,11,38
50,Fail,55,38,1,6,49
50,Fail,47,40,1,12,35
50,Fail,48,43,0,9,39
50,Fail,51,32,0,13,38
50,Fail,48,31,0,16,32
50,Fail,52,33,3,12,40
50,Fail,52,36,2,10,42
50,Fail,51,39,1,9,42
50,Fail,40,36,7,17,23
50,Fail,51,34,0,15,36
50,Fail,50,34,0,12,38
50,Fail,48,32,0,13,35
50,Fail,54,31,0,12,42
50,Fail,46,41,0,13,33
50,Fail,54,34,0,11,43
50,Fail,46,44,0,10,36
50,Fail,46,32,10,12,34
50,Fail,49,34,0,9,40
50,Fail,47,36,0,13,34
50,Fail,45,35,6,14,31
50,Fail,49,36,0,10,39
50,Fail,43,42,4,11,32
50,Fail,48,42,1,9,39
50,Fail,45,43,2,10,35
50,Fail,44,37,4,15,29
50,Fail,50,38,3,9,41
50,Fail,50,39,0,11,39
50,Fail,52,34,1,13,39
50,Fail,48,40,3,9,39
50,Fail,40,43,0,13,27
50,Fail,43,38,0,15,28
50,Fail,55,31,2,12,43
50,Fail,53,34,3,10,43
50,Fail,46,39,4,11,35
50,Fail,49,31,7,13,36
50,Fail,48,32,0,17,31
50,Fail,45,42,2,11,34
50,Fail,41,45,0,11,30
50,Fail,49,31,7,13,36
50,Fail,52,31,2,15,37
50,Fail,47,33,9,11,36
50,Fail,44,43,0,12,32
50,Fail,43,40,1,16,27
50,Fail,54,28,6,12,42
50,Fail,47,35,1,17,30
50,Fail,43,39,4,14,29
50,Fail,54,35,0,10,44
50,Fail,45,40,0,11,34
50,Fail,48,42,3,7,41
50,Fail,51,39,1,9,42
50,Fail,53,30,4,13,40
50,Fail,53,35,0,10,43
50,Fail,49,36,3,12,37
50,Fail,51,39,2,8,43
50,Fail,47,36,0,8,39
50,Fail,45,42,0,10,35
50,Fail,41,40,0,11,30
50,Fail,41,42,2,15,26
50,Fail,41,39,3,17,24
50,Fail,46,37,0,12,34
50,Fail,41,38,3,18,23
50,Fail,44,43,0,12,32
50,Fail,52,23,8,17,35
50,Fail,47,38,5,10,37
50,Fail,48,34,0,14,34
50,Fail,52,38,0,10,42
50,Fail,46,33,0,17,29
50,Fail,48,38,4,10,38
50,Fail,42,36,5,17,25
50,Success,57,38,1,4,53
50,Fail,49,33,8,10,39
50,Fail,42,44,0,12,30
50,Fail,44,37,0,18,26
50,Fail,42,42,4,12,30
50,Fail,50,39,0,6,44
50,Fail,39,38,0,10,29
50,Fail,49,35,0,9,40
50,Fail,51,31,0,17,34
50,Fail,48,37,0,12,36
50,Fail,51,31,0,11,40
50,Fail,49,40,0,10,39
50,Fail,43,33,0,17,26
50,Fail,46,36,0,10,36
50,Fail,46,36,7,11,35
50,Fail,46,37,5,12,34
50,Fail,44,34,7,15,29
50,Success,58,31,4,7,51
50,Fail,48,38,0,12,36
50,Fail,46,41,0,12,34
50,Fail,46,43,1,10,36
50,Fail,50,33,2,15,35
50,Fail,47,36,0,16,31
50,Fail,42,37,0,21,21
50,Fail,43,40,2,15,28
50,Fail,45,33,6,16,29
50,Fail,52,37,0,7,45
50,Fail,45,38,0,13,32
50,Fail,52,41,0,4,48
50,Fail,49,34,0,14,35
50,Fail,50,25,0,17,33
50,Fail,57,28,0,14,43
50,Fail,45,38,0,12,33
50,Fail,49,35,4,12,37
50,Fail,46,34,8,12,34
50,Fail,38,37,0,17,21
50,Fail,40,38,8,14,26
50,Fail,45,34,7,14,31
50,Fail,47,35,6,12,35
50,Fail,52,36,1,11,41
50,Fail,49,36,6,9,40
50,Fail,49,37,0,10,39
50,Fail,45,41,0,12,33
50,Fail,49,37,5,9,40
50,Fail,45,32,10,13,32
50,Fail,51,28,7,14,37
50,Fail,47,31,0,13,34
50,Fail,52,36,0,9,43
50,Fail,48,38,3,11,37
50,Fail,47,35,0,16,31
50,Fail,53,34,4,9,44
50,Fail,45,38,0,13,32
50,Fail,45,43,0,8,37
50,Fail,43,45,0,12,31
50,Fail,40,37,4,19,21
50,Fail,51,38,0,10,41
50,Fail,50,35,5,10,40
50,Fail,40,43,5,12,28
50,Fail,50,41,1,8,42
50,Fail,48,39,0,11,37
50,Fail,45,42,1,12,33
50,Fail,40,42,2,16,24
50,Fail,49,34,3,14,35
50,Fail,42,42,0,14,28
50,Fail,47,32,6,15,32
50,Fail,45,34,0,14,31
50,Fail,50,39,4,7,43
50,Fail,43,40,7,10,33
50,Fail,38,36,0,23,15
50,Fail,46,31,0,17,29
50,Fail,52,36,0,7,45
50,Fail,56,34,3,7,49
50,Fail,50,35,2,13,37
50,Fail,53,35,3,9,44
50,Fail,47,43,0,9,38
50,Fail,43,39,7,11,32
50,Success,55,29,12,4,51
50,Fail,49,40,0,9,40
50,Fail,41,38,0,15,26
50,Fail,44,33,7,16,28
50,Fail,44,42,1,13,31
50,Fail,37,40,0,16,21
50,Fail,46,39,0,14,32
50,Fail,42,35,11,12,30
50,Fail,43,38,5,14,29
50,Fail,48,42,0,8,40
50,Fail,50,37,0,9,41
50,Fail,50,23,7,20,30
50,Fail,43,40,1,16,27
50,Fail,46,38,2,14,32
50,Fail,53,29,3,15,38
50,Fail,47,38,0,13,34
50,Fail,45,34,9,12,33
50,Fail,50,36,0,10,40
50,Fail,53,33,3,11,42
50,Fail,51,35,0,12,39
50,Fail,48,37,0,10,38
50,Fail,41,38,0,13,28
50,Fail,47,37,0,11,36
50,Success,58,36,0,6,52
50,Fail,46,30,3,21,25
50,Success,58,32,0,7,51
50,Fail,50,34,6,10,40
50,Fail,52,31,0,16,36
50,Fail,55,31,0,12,43
50,Fail,44,43,0,8,36
50,Fail,43,32,7,18,25
50,Fail,47,37,3,13,34
50,Fail,51,40,0,8,43
50,Fail,51,39,0,8,43
50,Fail,51,40,0,8,43
50,Fail,44,41,3,12,32
50,Fail,45,37,9,9,36
50,Fail,49,34,2,15,34
50,Fail,52,36,2,10,42
50,Fail,50,42,0,6,44
50,Fail,45,38,5,12,33
50,Fail,40,41,8,11,29
50,Fail,56,32,0,9,47
50,Fail,51,36,0,8,43
50,Fail,49,32,1,18,31
50,Fail,45,37,7,11,34
50,Fail,44,35,0,13,31
50,Fail,50,37,0,12,38
50,Fail,46,32,0,16,30
50,Fail,50,33,3,14,36
50,Fail,47,38,1,14,33
50,Fail,52,37,2,9,43
50,Fail,44,36,0,12,32
50,Fail,46,35,0,16,30
50,Fail,49,34,0,9,40
50,Fail,49,36,0,12,37
50,Fail,44,43,1,12,32
50,Fail,52,39,0,8,44
50,Fail,44,45,0,11,33
50,Fail,42,39,0,12,30
50,Fail,44,30,9,17,27
50,Fail,50,29,4,17,33
50,Fail,41,34,0,14,27
50,Fail,49,34,3,14,35
50,Fail,42,40,4,14,28
50,Fail,48,33,0,14,34
50,Fail,53,34,0,12,41
50,Fail,49,34,0,15,34
50,Fail,43,39,0,12,31
50,Fail,45,35,0,17,28
50,Fail,50,35,0,14,36
50,Fail,40,40,1,19,21
50,Fail,50,37,0,8,42
50,Fail,48,38,0,12,36
50,Fail,48,32,0,20,28
50,Fail,43,38,1,18,25
50,Fail,43,33,0,17,26
50,Fail,51,39,2,8,43
50,Fail,49,39,0,10,39
50,Fail,48,35,3,14,34
50,Fail,39,37,0,15,24
50,Fail,50,34,7,9,41
50,Fail,48,32,0,15,33
50,Fail,51,37,0,7,44
50,Fail,52,34,1,13,39
50,Fail,47,36,0,17,30
50,Fail,49,33,3,15,34
50,Fail,46,31,0,16,30
50,Fail,47,36,2,15,32
50,Fail,50,38,0,9,41
50,Fail,55,31,2,12,43
50,Fail,48,39,0,8,40
50,Fail,49,35,0,12,37
50,Fail,43,37,6,14,29
50,Fail,52,40,0,7,45
50,Fail,54,30,0,10,44
50,Fail,51,35,0,11,40
50,Fail,48,39,5,8,40
50,Fail,49,38,0,10,39
50,Fail,53,37,1,9,44
50,Fail,48,37,3,12,36
50,Fail,49,36,6,9,40
50,Fail,55,33,0,11,44
50,Fail,51,38,1,10,41
50,Fail,44,32,0,13,31
50,Fail,52,33,1,14,38
50,Fail,40,33,0,12,28
50,Fail,45,32,0,17,28
50,Fail,47,34,0,12,35
50,Fail,47,36,0,12,35
50,Fail,50,34,0,13,37
50,Fail,49,35,6,10,39
50,Fail,43,40,0,13,30
50,Fail,44,47,0,8,36
50,Fail,46,38,2,14,32
50,Fail,49,27,14,10,39
50,Fail,50,33,2,15,35
50,Fail,45,36,6,13,32
50,Fail,50,33,8,9,41
50,Fail,44,35,0,13,31
50,Fail,39,43,6,12,27
50,Fail,51,35,2,12,39
50,Fail,55,26,0,14,41
50,Fail,54,33,0,12,42
50,Fail,57,35,0,8,49
50,Fail,38,45,0,16,22
50,Fail,55,29,0,12,43
50,Fail,53,29,9,9,44
50,Fail,46,42,0,12,34
50,Fail,55,25,5,15,40
50,Success,61,27,2,10,51
50,Fail,48,32,0,14,34
50,Fail,45,34,8,13,32
50,Fail,39,40,0,15,24
50,Fail,50,32,6,12,38
50,Fail,48,42,0,9,39
50,Fail,50,31,12,7,43
50,Fail,47,39,3,11,36
50,Fail,56,32,0,8,48
50,Fail,48,32,0,16,32
50,Fail,47,41,2,10,37
50,Fail,50,39,0,8,42
50,Fail,40,49,0,8,32
50,Fail,56,33,0,11,45
50,Fail,51,34,0,11,40
50,Fail,57,27,4,12,45
50,Fail,47,27,7,19,28
50,Fail,57,28,1,14,43
50,Fail,49,37,0,10,39
50,Fail,49,30,0,18,31
50,Fail,48,34,5,13,35
50,Fail,52,31,0,10,42
50,Fail,48,39,2,11,37
50,Fail,51,34,3,12,39
50,Fail,46,36,3,15,31
50,Fail,43,31,7,19,24
50,Fail,50,32,2,16,34
50,Fail,50,33,0,13,37
50,Fail,53,29,0,16,37
50,Fail,40,36,0,16,24
50,Fail,52,33,3,12,40
50,Fail,44,38,0,15,29
50,Fail,43,33,0,17,26
50,Fail,41,39,0,16,25
50,Fail,39,37,6,18,21
50,Fail,50,35,4,11,39
50,Fail,48,35,2,15,33
50,Fail,54,33,0,12,42
50,Fail,43,35,0,18,25
50,Fail,46,29,0,16,30
50,Fail,53,32,2,13,40
50,Fail,47,40,3,10,37
50,Fail,43,36,0,17,26
50,Fail,47,27,0,16,31
50,Fail,49,39,0,12,37
50,Fail,52,32,3,13,39
50,Fail,45,38,2,15,30
50,Fail,38,35,0,16,22
50,Fail,51,32,0,12,39
50,Fail,43,36,2,19,24
50,Fail,48,36,0,12,36
50,Fail,51,32,0,16,35
50,Fail,38,39,0,18,20
50,Fail,52,37,0,11,41
50,Fail,55,29,0,13,42
50,Fail,54,33,0,12,42
50,Fail,50,39,0,9,41
50,Fail,48,33,1,18,30
50,Fail,46,24,0,25,21
50,Fail,53,32,0,13,40
50,Fail,58,33,0,9,49
50,Fail,49,34,0,16,33
50,Fail,47,39,3,11,36
50,Fail,54,32,5,9,45
50,Fail,50,36,5,9,41
50,Fail,52,35,3,10,42
50,Fail,48,35,8,9,39
50,Fail,47,28,7,18,29
50,Fail,51,29,7,13,38
50,Fail,46,38,6,10,36
50,Fail,45,36,8,11,34
50,Fail,48,34,0,13,35
50,Fail,50,40,0,9,41
50,Fail,38,37,4,21,17
50,Fail,40,39,4,17,23
50,Fail,40,38,12,10,30
50,Fail,43,38,2,17,26
50,Fail,43,35,8,14,29
50,Fail,41,34,11,14,27
50,Fail,52,31,5,12,40
50,Fail,45,45,2,8,37
50,Fail,46,30,0,13,33
50,Fail,39,37,0,13,26
50,Fail,38,40,0,14,24
50,Fail,51,36,1,12,39
50,Fail,49,34,0,17,32
50,Fail,44,40,5,11,33
50,Fail,43,35,0,15,28
50,Fail,47,37,3,13,34
50,Fail,56,28,0,14,42
50,Fail,54,34,0,12,42
50,Fail,51,30,0,16,35
50,Fail,50,38,2,10,40
50,Fail,43,26,0,22,21
50,Fail,48,33,0,14,34
50,Fail,47,32,0,19,28
50,Fail,52,37,1,10,42
50,Fail,51,35,1,13,38
50,Success,58,33,2,7,51
50,Fail,40,40,11,9,31
50,Fail,43,41,0,12,31
50,Fail,47,38,0,12,35
50,Fail,56,35,0,8,48
50,Fail,49,38,0,12,37
50,Fail,50,36,0,9,41
50,Fail,50,35,0,11,39
50,Fail,57,31,0,10,47
50,Fail,45,40,6,9,36
50,Fail,55,28,0,13,42
50,Fail,46,33,10,11,35
50,Fail,47,38,0,13,34
50,Fail,47,34,0,16,31
50,Fail,50,29,5,16,34
50,Fail,47,43,1,9,38
50,Fail,52,35,1,12,40
50,Fail,52,34,4,10,42
50,Fail,43,34,5,18,25
50,Fail,51,40,2,7,44
50,Fail,49,34,0,16,33
50,Fail,44,41,3,12,32
50,Fail,38,44,1,17,21
50,Fail,52,35,0,12,40
50,Fail,46,37,0,12,34
50,Fail,44,36,9,11,33
50,Fail,44,32,9,15,29
50,Fail,51,39,0,9,42
50,Fail,51,35,1,13,38
50,Fail,48,38,0,14,34
50,Fail,47,33,3,17,30
50,Fail,44,38,0,16,28
50,Fail,46,34,2,18,28
50,Fail,52,37,0,11,41
50,Fail,45,38,4,13,32
50,Fail,47,34,0,15,32
50,Success,58,32,2,8,50
50,Fail,47,41,4,8,39
50,Fail,50,36,3,11,39
50,Fail,44,37,3,16,28
50,Success,57,30,6,7,50
50,Fail,51,32,0,12,39
50,Fail,48,33,4,15,33
50,Fail,51,41,3,5,46
50,Fail,43,35,0,12,31
50,Fail,46,34,0,11,35
50,Fail,49,30,0,11,38
50,Fail,40,39,6,15,25
50,Fail,49,43,0,8,41
50,Fail,54,29,0,16,38
50,Success,60,30,0,7,53
50,Fail,43,41,0,12,31
50,Fail,48,30,2,20,28
50,Success,54,41,2,3,51
50,Fail,55,35,0,10,45
50,Fail,42,39,0,18,24
60,Fail,52,34,6,8,44
60,Fail,46,36,0,11,35
60,Fail,50,33,7,10,40
60,Fail,39,43,2,16,23
60,Fail,58,27,6,9,49
60,Fail,56,30,0,10,46
60,Fail,54,27,0,10,44
60,Fail,44,39,7,10,34
60,Fail,43,29,10,18,25
60,Fail,49,32,3,16,33
60,Fail,51,41,2,6,45
60,Fail,45,34,3,18,27
60,Fail,52,36,0,11,41
60,Fail,50,28,1,21,29
60,Fail,48,28,1,23,25
60,Fail,45,29,0,18,27
60,Fail,44,41,0,10,34
60,Fail,54,28,6,12,42
60,Fail,47,36,0,14,33
60,Fail,49,28,0,14,35
60,Fail,56,26,5,13,43
60,Fail,44,39,0,10,34
60,Fail,55,30,3,12,43
60,Fail,40,36,0,14,26
60,Fail,37,45,9,9,28
60,Fail,45,39,0,15,30
60,Fail,55,34,2,9,46
60,Fail,49,40,0,7,42
60,Fail,45,39,1,15,30
60,Fail,47,42,0,8,39
60,Fail,43,33,0,16,27
60,Fail,47,33,0,14,33
60,Fail,38,40,0,19,19
60,Fail,48,43,2,7,41
60,Fail,46,36,0,14,32
60,Fail,44,41,2,13,31
60,Fail,49,31,3,17,32
60,Fail,49,40,0,10,39
60,Fail,51,31,0,14,37
60,Fail,40,37,0,19,21
60,Fail,44,41,0,11,33
60,Fail,38,37,0,25,13
60,Fail,48,36,0,14,34
60,Fail,53,33,0,10,43
60,Fail,43,41,7,9,34
60,Fail,50,35,7,8,42
60,Fail,49,43,3,5,44
60,Fail,47,39,0,14,33
60,Fail,50,35,2,13,37
60,Fail,47,39,1,13,34
60,Fail,40,38,3,19,21
60,Fail,50,30,4,16,34
60,Fail,52,36,3,9,43
60,Fail,49,37,0,11,38
60,Fail,54,31,5,10,44
60,Fail,47,36,0,12,35
60,Fail,47,37,0,10,37
60,Fail,52,27,9,12,40
60,Fail,46,36,0,14,32
60,Fail,46,31,9,14,32
60,Fail,47,34,7,12,35
60,Fail,38,40,0,18,20
60,Fail,52,37,0,9,43
60,Fail,53,33,0,10,43
60,Fail,56,34,2,8,48
60,Fail,55,32,0,8,47
60,Fail,57,26,5,12,45
60,Fail,44,36,4,16,28
60,Fail,46,40,1,13,33
60,Fail,55,33,3,9,46
60,Fail,53,31,1,15,38
60,Fail,55,37,0,5,50
60,Fail,47,40,0,8,39
60,Fail,49,38,1,12,37
60,Fail,49,30,6,15,34
60,Fail,52,32,0,13,39
60,Fail,52,34,0,10,42
60,Fail,46,39,3,12,34
60,Fail,42,37,4,17,25
60,Fail,49,29,11,11,38
60,Fail,47,33,4,16,31
60,Fail,55,34,0,8,47
60,Fail,43,36,10,11,32
60,Fail,58,30,5,7,51
60,Fail,48,36,0,13,35
60,Fail,46,39,0,12,34
60,Fail,49,37,0,11,38
60,Fail,40,33,11,16,24
60,Fail,49,36,2,13,36
60,Fail,44,39,1,16,28
60,Fail,45,36,4,15,30
60,Fail,49,34,0,14,35
60,Fail,46,41,0,11,35
60,Fail,49,32,3,16,33
60,Fail,49,37,0,11,38
60,Fail,46,26,19,9,37
60,Fail,51,34,0,12,39
60,Fail,49,37,3,11,38
60,Fail,44,30,7,19,25
60,Fail,56,31,0,11,45
60,Fail,24,51,10,15,9
60,Fail,48,32,4,16,32
60,Fail,46,42,0,10,36
60,Fail,48,32,0,11,37
60,Fail,53,33,3,11,42
60,Fail,44,37,0,18,26
60,Fail,46,33,0,14,32
60,Fail,49,37,0,12,37
60,Fail,53,32,0,15,38
60,Fail,48,36,5,11,37
60,Fail,55,40,0,5,50
60,Fail,51,34,0,14,37
60,Fail,45,31,0,14,31
60,Fail,48,39,9,4,44
60,Fail,46,37,1,16,30
60,Fail,52,35,3,10,42
60,Fail,52,37,2,9,43
60,Fail,46,40,1,13,33
60,Fail,49,27,13,11,38
60,Fail,49,31,0,14,35
60,Fail,54,29,0,11,43
60,Fail,49,30,8,13,36
60,Fail,49,38,0,10,39
60,Fail,51,37,5,7,44
60,Fail,57,32,0,6,51
60,Fail,44,46,3,7,37
60,Fail,46,33,0,13,33
60,Fail,56,28,1,15,41
60,Fail,47,33,0,16,31
60,Fail,53,24,0,17,36
60,Fail,54,34,2,10,44
60,Fail,46,35,6,13,33
60,Fail,42,37,0,8,34
60,Fail,49,33,0,14,35
60,Fail,47,40,1,12,35
60,Fail,42,37,0,12,30
60,Fail,43,38,2,17,26
60,Fail,55,30,2,13,42
60,Fail,50,34,1,15,35
60,Fail,48,33,6,13,35
60,Fail,51,34,5,10,41
60,Fail,45,38,7,10,35
60,Fail,51,33,3,13,38
60,Fail,36,33,0,22,14
60,Fail,53,37,0,7,46
60,Fail,50,32,0,17,33
60,Fail,48,40,0,11,37
60,Fail,44,34,10,12,32
60,Fail,48,32,3,17,31
60,Fail,55,28,1,16,39
60,Fail,49,29,5,17,32
60,Fail,49,34,0,12,37
60,Fail,48,39,0,10,38
60,Fail,44,38,9,9,35
60,Fail,43,36,11,10,33
60,Fail,41,40,0,16,25
60,Fail,41,39,0,16,25
60,Fail,59,32,0,7,52
60,Fail,37,43,0,7,30
60,Fail,53,33,0,14,39
60,Fail,48,35,0,11,37
60,Fail,58,29,5,8,50
60,Fail,51,40,1,8,43
60,Fail,41,38,0,13,28
60,Fail,49,40,0,9,40
60,Fail,44,33,9,14,30
60,Fail,50,36,3,11,39
60,Fail,45,40,0,7,38
60,Fail,45,33,8,14,31
60,Fail,41,40,6,13,28
60,Fail,55,30,3,12,43
60,Fail,50,30,0,14,36
60,Fail,50,37,0,10,40
60,Fail,46,39,5,10,36
60,Fail,51,30,0,11,40
60,Fail,45,37,4,14,31
60,Fail,58,33,1,8,50
60,Fail,52,28,0,14,38
60,Fail,55,31,1,13,42
60,Fail,48,34,0,15,33
60,Fail,49,37,3,11,38
60,Fail,46,32,0,16,30
60,Fail,44,39,0,14,30
60,Fail,53,32,0,11,42
60,Fail,53,22,9,16,37
60,Fail,50,38,0,10,40
60,Fail,47,43,1,9,38
60,Fail,50,31,0,13,37
60,Fail,54,40,1,5,49
60,Fail,51,28,4,17,34
60,Fail,46,33,0,15,31
60,Fail,42,41,0,13,29
60,Fail,49,38,4,9,40
60,Fail,46,36,0,14,32
60,Fail,45,30,6,19,26
60,Fail,42,37,0,19,23
60,Fail,43,37,0,20,23
60,Fail,58,29,0,12,46
60,Fail,52,31,0,12,40
60,Fail,47,38,0,15,32
60,Fail,52,38,2,8,44
60,Fail,48,35,0,16,32
60,Fail,53,30,6,11,42
60,Fail,49,32,5,14,35
60,Fail,44,37,0,19,25
60,Fail,42,44,0,12,30
60,Fail,49,33,0,13,36
60,Fail,50,35,0,12,38
60,Fail,54,34,3,9,45
60,Fail,53,34,0,10,43
60,Fail,54,30,0,10,44
60,Fail,50,36,0,13,37
60,Fail,48,35,2,15,33
60,Fail,51,34,1,14,37
60,Fail,43,39,0,14,29
60,Fail,53,37,2,8,45
60,Fail,54,31,5,10,44
60,Fail,53,30,2,15,38
60,Fail,42,38,2,18,24
60,Fail,49,36,2,13,36
60,Fail,38,44,0,18,20
60,Fail,51,37,0,12,39
60,Fail,54,29,10,7,47
60,Fail,47,38,3,12,35
60,Fail,50,38,0,11,39
60,Fail,49,31,6,14,35
60,Fail,48,29,5,18,30
60,Fail,57,33,0,7,50
60,Fail,54,37,0,6,48
60,Fail,49,34,0,9,40
60,Fail,57,28,3,12,45
60,Fail,50,35,0,15,35
60,Fail,39,30,0,17,22
60,Fail,52,32,0,12,40
60,Fail,44,38,3,15,29
60,Fail,51,37,2,10,41
60,Fail,51,28,0,11,40
60,Fail,45,44,3,8,37
60,Fail,49,36,0,13,36
60,Fail,47,34,1,18,29
60,Fail,50,40,0,10,40
60,Fail,44,36,0,15,29
60,Fail,50,39,0,8,42
60,Fail,49,36,0,12,37
60,Fail,50,29,2,19,31
60,Fail,53,30,0,11,42
60,Fail,41,42,0,15,26
60,Fail,49,34,3,14,35
60,Fail,41,29,0,18,23
60,Fail,49,29,11,11,38
60,Fail,49,35,0,12,37
60,Fail,46,36,3,15,31
60,Fail,55,32,0,13,42
60,Fail,51,40,0,9,42
60,Fail,49,33,1,17,32
60,Fail,51,39,0,9,42
60,Fail,47,37,3,13,34
60,Fail,43,42,5,10,33
60,Fail,52,31,0,17,35
60,Fail,48,38,2,12,36
60,Fail,50,27,0,17,33
60,Fail,49,25,0,20,29
60,Fail,41,38,0,10,31
60,Fail,49,37,0,13,36
60,Fail,49,37,1,13,36
60,Fail,52,38,0,9,43
60,Fail,50,33,0,11,39
60,Fail,42,34,0,17,25
60,Fail,45,41,0,12,33
60,Fail,54,32,5,9,45
60,Fail,48,37,0,14,34
60,Fail,44,41,0,15,29
60,Fail,58,30,1,11,47
60,Fail,54,31,0,10,44
60,Fail,53,32,1,14,39
60,Fail,49,34,0,6,43
60,Fail,50,43,0,7,43
60,Fail,39,45,2,14,25
60,Fail,44,35,6,15,29
60,Fail,47,36,0,13,34
60,Fail,47,38,0,14,33
60,Fail,45,40,0,13,32
60,Fail,43,38,0,13,30
60,Fail,48,33,0,16,32
60,Fail,53,29,0,13,40
60,Fail,52,30,0,15,37
60,Fail,42,38,0,11,31
60,Fail,52,35,2,11,41
60,Fail,48,39,3,10,38
60,Fail,41,41,0,15,26
60,Fail,48,37,1,14,34
60,Fail,55,36,0,8,47
60,Fail,45,35,8,12,33
60,Fail,42,40,3,15,27
60,Fail,40,37,0,18,22
60,Fail,52,32,4,12,40
60,Fail,41,40,2,17,24
60,Fail,50,36,0,12,38
60,Fail,51,34,2,13,38
60,Fail,49,31,0,14,35
60,Fail,47,34,4,15,32
60,Fail,50,40,0,8,42
60,Fail,50,40,0,9,41
60,Fail,48,36,0,12,36
60,Fail,45,39,0,13,32
60,Fail,49,34,0,12,37
60,Fail,47,34,0,15,32
60,Fail,43,40,0,17,26
60,Fail,46,41,0,12,34
60,Fail,51,39,0,7,44
60,Fail,39,32,8,21,18
60,Fail,45,32,11,12,33
60,Fail,49,36,0,15,34
60,Fail,52,32,0,10,42
60,Fail,47,36,1,16,31
60,Fail,47,32,0,17,30
60,Fail,51,37,0,11,40
60,Fail,45,39,2,14,31
60,Fail,46,41,1,12,34
60,Fail,49,43,0,8,41
60,Fail,56,30,6,8,48
60,Fail,52,38,0,7,45
60,Fail,47,35,0,12,35
60,Fail,55,37,2,6,49
60,Fail,51,29,4,16,35
60,Fail,47,34,0,13,34
60,Fail,53,31,0,12,41
60,Fail,47,36,0,12,35
60,Fail,51,32,0,12,39
60,Fail,52,35,0,12,40
60,Fail,45,35,2,18,27
60,Fail,54,36,1,9,45
60,Fail,48,41,0,10,38
60,Fail,53,35,0,11,42
60,Fail,42,39,0,17,25
60,Fail,48,43,1,8,40
60,Fail,51,31,0,14,37
60,Fail,43,34,7,16,27
60,Fail,63,31,0,5,58
60,Fail,54,32,4,10,44
60,Fail,46,29,0,10,36
60,Fail,46,41,0,12,34
60,Fail,42,38,7,13,29
60,Fail,53,34,0,9,44
60,Fail,53,37,0,10,43
60,Fail,51,37,0,12,39
60,Fail,51,32,0,16,35
60,Fail,50,34,6,10,40
60,Fail,50,41,0,8,42
60,Fail,53,32,0,11,42
60,Fail,49,32,0,10,39
60,Fail,49,43,0,8,41
60,Fail,48,34,0,14,34
60,Fail,46,42,3,9,37
60,Fail,53,35,0,12,41
60,Fail,52,30,0,12,40
60,Fail,52,36,4,8,44
60,Fail,46,35,4,15,31
60,Fail,44,38,7,11,33
60,Fail,46,43,1,10,36
60,Fail,46,35,0,15,31
60,Fail,36,37,10,17,19
60,Fail,45,36,3,16,29
60,Fail,48,32,0,14,34
60,Fail,45,42,0,13,32
60,Fail,51,33,1,15,36
60,Fail,52,31,0,17,35
60,Fail,48,39,0,13,35
60,Fail,50,38,1,11,39
60,Fail,47,39,4,10,37
60,Fail,49,34,0,12,37
60,Fail,49,42,0,8,41
60,Fail,52,37,4,7,45
60,Fail,47,38,1,14,33
60,Fail,44,41,1,14,30
60,Fail,46,37,1,16,30
60,Fail,55,30,2,13,42
60,Fail,51,33,0,13,38
60,Fail,53,28,4,15,38
60,Fail,41,28,14,17,24
60,Fail,52,30,0,15,37
60,Fail,47,35,5,13,34
60,Fail,41,36,12,11,30
60,Fail,45,38,2,15,30
60,Fail,43,37,9,11,32
60,Fail,41,35,0,17,24
60,Fail,48,37,0,15,33
60,Fail,51,34,6,9,42
60,Fail,50,38,0,12,38
60,Fail,46,41,1,12,34
60,Fail,50,32,6,12,38
60,Fail,45,38,0,12,33
60,Fail,59,31,2,8,51
60,Fail,49,28,0,22,27
60,Fail,51,32,4,13,38
60,Fail,48,35,2,15,33
60,Fail,47,35,0,11,36
60,Fail,51,27,0,12,39
60,Fail,48,39,1,12,36
60,Fail,53,37,1,9,44
60,Fail,48,39,3,10,38
60,Fail,40,41,6,13,27
60,Fail,46,33,0,17,29
60,Fail,55,28,0,15,40
60,Fail,46,31,11,12,34
60,Fail,53,35,0,11,42
60,Fail,56,28,6,10,46
60,Fail,46,36,0,14,32
60,Fail,42,38,0,15,27
60,Fail,45,33,11,11,34
60,Fail,41,44,1,14,27
60,Fail,46,38,3,13,33
60,Fail,45,41,0,12,33
60,Fail,42,36,9,13,29
60,Fail,45,38,0,13,32
60,Fail,44,33,10,13,31
60,Fail,44,47,0,6,38
60,Fail,35,35,0,18,17
60,Fail,51,36,3,10,41
60,Fail,49,36,0,13,36
60,Fail,52,31,0,13,39
60,Fail,48,41,2,9,39
60,Fail,50,40,2,8,42
60,Fail,54,32,3,11,43
60,Fail,46,33,0,16,30
60,Fail,45,40,2,13,32
60,Fail,50,34,0,14,36
60,Fail,41,40,0,18,23
60,Fail,41,30,10,19,22
60,Fail,44,43,2,11,33
60,Fail,55,32,0,12,43
60,Fail,51,31,3,15,36
60,Fail,44,41,0,14,30
60,Fail,47,42,1,10,37
60,Fail,47,37,0,15,32
60,Fail,46,38,0,12,34
60,Fail,54,30,0,16,38
60,Fail,46,34,5,15,31
60,Fail,48,31,0,16,32
60,Fail,46,34,7,13,33
60,Fail,42,31,0,19,23
60,Fail,54,32,3,11,43
60,Fail,43,37,0,16,27
60,Fail,39,39,0,11,28
60,Fail,51,34,2,13,38
60,Fail,48,37,0,14,34
60,Fail,49,31,6,14,35
60,Fail,46,41,0,10,36
60,Fail,47,38,0,14,33
60,Fail,47,38,3,12,35
60,Fail,48,38,0,10,38
60,Fail,45,38,0,11,34
60,Fail,50,33,2,15,35
60,Fail,48,35,0,15,33
60,Fail,47,33,7,13,34
60,Fail,50,36,2,12,38
60,Fail,59,32,1,8,51
60,Fail,48,47,0,5,43
60,Fail,48,37,0,12,36
60,Fail,39,42,0,10,29
60,Fail,47,33,0,13,34
60,Fail,53,36,6,5,48
60,Fail,44,38,4,14,30
60,Fail,57,29,3,11,46
60,Fail,55,31,2,12,43
60,Fail,52,32,3,13,39
60,Fail,52,32,0,16,36
60,Fail,46,38,1,15,31
60,Fail,45,39,6,10,35
60,Fail,51,35,5,9,42
60,Fail,52,32,2,14,38
60,Fail,49,35,0,9,40
60,Fail,48,35,0,10,38
60,Fail,48,37,0,11,37
60,Fail,48,36,2,14,34
60,Fail,49,38,2,11,38
60,Fail,44,36,7,13,31
60,Fail,53,32,0,11,42
60,Fail,52,33,5,10,42
60,Fail,44,39,0,15,29
60,Fail,53,30,3,14,39
60,Fail,49,30,0,11,38
60,Fail,53,33,0,13,40
60,Fail,51,38,0,9,42
60,Fail,40,39,9,12,28
60,Fail,51,35,0,6,45
60,Fail,54,38,1,7,47
60,Fail,45,30,8,17,28
60,Fail,54,32,3,11,43
60,Fail,47,42,0,9,38
60,Fail,53,31,1,15,38
60,Fail,47,35,5,13,34
60,Fail,52,39,2,7,45
60,Fail,53,37,2,8,45
60,Fail,49,44,0,7,42
60,Fail,49,33,0,16,33
60,Fail,45,43,1,11,34
60,Fail,42,35,0,14,28
60,Fail,46,39,7,8,38
60,Fail,47,38,0,11,36
60,Fail,41,45,2,12,29
60,Fail,48,32,0,17,31
60,Fail,49,34,0,11,38
60,Fail,49,35,6,10,39
60,Fail,49,36,2,13,36
60,Fail,45,33,0,20,25
60,Fail,46,33,0,15,31
60,Fail,50,34,0,15,35
60,Fail,52,36,2,10,42
60,Fail,49,38,4,9,40
60,Fail,47,35,0,13,34
60,Fail,49,39,0,12,37
60,Fail,49,33,5,13,36
60,Fail,48,33,3,16,32
60,Fail,44,37,3,16,28
60,Fail,40,43,6,11,29
60,Fail,46,42,0,11,35
60,Fail,52,31,6,11,41
60,Fail,49,35,0,16,33
60,Fail,42,35,7,16,26
60,Fail,55,34,2,9,46
60,Fail,53,36,1,10,43
60,Fail,54,37,1,8,46
60,Fail,49,39,0,10,39
60,Fail,50,32,0,17,33
60,Fail,49,32,6,13,36
60,Fail,43,43,4,10,33
60,Fail,48,41,0,9,39
60,Fail,51,36,1,12,39
60,Fail,47,39,0,9,38
60,Fail,50,30,6,14,36
60,Fail,48,31,3,18,30
60,Fail,39,30,0,21,18
60,Fail,48,36,1,15,33
60,Fail,53,34,0,8,45
60,Fail,40,33,0,16,24
60,Fail,49,38,0,10,39
60,Fail,53,34,0,11,42
60,Fail,44,37,9,10,34
60,Fail,50,30,0,11,39
60,Fail,49,34,0,17,32
60,Fail,48,29,0,15,33
60,Fail,53,33,0,10,43
60,Fail,45,36,4,15,30
60,Fail,52,31,0,16,36
60,Fail,49,34,0,13,36
60,Fail,50,38,4,8,42
60,Fail,55,30,1,14,41
60,Fail,44,42,0,13,31
60,Fail,47,36,6,11,36
60,Fail,51,35,2,12,39
60,Fail,50,35,5,10,40
60,Fail,42,42,3,13,29
60,Fail,51,31,0,16,35
60,Fail,50,31,5,14,36
60,Fail,49,29,0,16,33
60,Fail,47,41,3,9,38
60,Fail,56,33,0,11,45
60,Fail,51,35,0,9,42
60,Fail,51,35,0,11,40
60,Fail,57,32,2,9,48
60,Fail,42,41,2,15,27
60,Fail,44,39,0,8,36
60,Fail,53,31,2,14,39
60,Fail,60,26,2,12,48
60,Fail,48,39,3,10,38
60,Fail,45,34,9,12,33
60,Fail,47,38,0,12,35
60,Fail,49,32,0,12,37
60,Fail,51,29,0,19,32
60,Fail,49,35,0,15,34
60,Fail,48,36,3,13,35
60,Fail,46,38,4,12,34
60,Fail,45,39,4,12,33
60,Fail,47,32,10,11,36
60,Fail,54,37,0,8,46
60,Fail,49,30,9,12,37
60,Fail,43,39,0,17,26
60,Fail,49,39,0,6,43
60,Fail,49,34,0,15,34
60,Fail,47,39,0,10,37
60,Fail,45,34,0,12,33
60,Fail,43,33,0,15,28
60,Fail,38,37,0,17,21
60,Fail,53,35,0,8,45
60,Fail,52,41,3,4,48
60,Fail,46,38,0,14,32
60,Fail,51,32,3,14,37
60,Fail,50,35,3,12,38
60,Fail,48,33,0,15,33
60,Fail,46,43,0,10,36
60,Fail,47,30,0,21,26
60,Fail,54,31,3,12,42
60,Fail,51,34,6,9,42
60,Fail,41,33,0,20,21
60,Fail,45,32,8,15,30
60,Fail,54,35,1,10,44
60,Fail,47,38,2,13,34
60,Fail,47,31,0,16,31
60,Fail,45,33,8,14,31
60,Fail,47,41,1,11,36
60,Fail,46,31,6,17,29
60,Fail,43,38,0,16,27
60,Fail,54,33,0,13,41
60,Fail,46,35,1,18,28
60,Fail,50,35,2,13,37
60,Fail,48,28,0,16,32
60,Fail,51,32,0,12,39
60,Fail,49,29,6,16,33
60,Fail,47,41,3,9,38
60,Fail,49,37,0,12,37
60,Fail,47,33,0,19,28
60,Fail,54,33,0,12,42
60,Fail,49,34,0,13,36
60,Fail,47,33,4,16,31
60,Fail,47,35,0,13,34
60,Fail,50,34,0,13,37
60,Fail,48,34,0,13,35
60,Fail,42,45,0,12,30
60,Fail,49,38,0,8,41
60,Fail,47,36,3,14,33
60,Fail,39,36,0,14,25
60,Fail,43,43,0,13,30
60,Fail,47,36,0,11,36
60,Fail,48,27,0,18,30
60,Fail,36,43,0,10,26
60,Fail,40,43,3,14,26
60,Fail,43,37,0,18,25
60,Fail,41,36,11,12,29
60,Fail,41,36,7,16,25
60,Fail,47,35,0,14,33
60,Fail,54,29,5,12,42
60,Fail,49,41,1,9,40
60,Fail,40,50,0,9,31
60,Fail,50,35,0,12,38
60,Fail,42,39,0,14,28
60,Fail,53,39,1,7,46
60,Fail,57,25,0,12,45
60,Fail,50,34,3,13,37
60,Fail,46,36,0,10,36
60,Fail,49,34,3,14,35
60,Fail,44,27,14,15,29
60,Fail,49,35,2,14,35
60,Fail,41,32,9,18,23
60,Fail,57,27,0,12,45
60,Fail,46,39,2,13,33
60,Fail,50,36,0,11,39
60,Fail,47,25,9,19,28
60,Fail,49,31,0,18,31
60,Fail,54,38,0,7,47
60,Fail,43,43,0,12,31
60,Fail,48,28,0,19,29
60,Fail,47,39,0,14,33
60,Fail,50,41,0,8,42
60,Fail,55,27,3,15,40
60,Fail,41,38,0,14,27
60,Fail,53,41,0,6,47
60,Fail,39,38,0,16,23
60,Fail,50,38,1,11,39
60,Fail,51,29,3,17,34
60,Fail,52,32,5,11,41
60,Fail,53,36,1,10,43
60,Fail,50,40,0,9,41
60,Fail,53,38,0,8,45
60,Fail,50,34,0,14,36
60,Fail,51,33,1,15,36
60,Fail,48,34,7,11,37
60,Fail,43,35,3,19,24
60,Fail,51,33,1,15,36
60,Fail,45,41,0,11,34
60,Fail,55,36,0,7,48
60,Fail,54,34,0,10,44
60,Fail,51,37,0,12,39
60,Fail,40,42,2,16,24
60,Fail,40,39,5,16,24
60,Fail,42,42,0,16,26
60,Fail,54,33,0,13,41
60,Fail,43,44,0,11,32
60,Fail,47,30,4,19,28
60,Fail,39,37,0,19,20
60,Fail,40,37,0,17,23
60,Fail,48,32,2,18,30
60,Fail,47,34,6,13,34
60,Fail,50,33,1,16,34
60,Fail,40,35,0,18,22
60,Fail,54,29,0,10,44
60,Fail,51,28,0,14,37
60,Fail,42,29,11,18,24
60,Fail,58,33,0,8,50
60,Fail,48,38,0,13,35
60,Fail,48,38,0,10,38
60,Fail,41,45,2,12,29
60,Fail,46,42,6,6,40
60,Fail,52,32,0,14,38
60,Fail,54,32,1,13,41
60,Fail,53,30,6,11,42
60,Fail,55,38,0,6,49
60,Fail,39,44,0,14,25
60,Fail,48,35,0,16,32
60,Fail,51,36,0,9,42
60,Fail,55,29,0,12,43
60,Fail,43,42,4,11,32
60,Fail,46,36,0,12,34
60,Fail,49,32,5,14,35
60,Fail,50,41,0,9,41
60,Fail,45,39,4,12,33
60,Fail,50,28,7,15,35
60,Fail,50,35,2,13,37
60,Fail,44,34,0,12,32
60,Fail,53,40,0,7,46
60,Fail,44,43,2,11,33
60,Fail,45,35,5,15,30
60,Fail,52,27,0,16,36
60,Fail,47,34,0,19,28
60,Fail,52,29,6,13,39
60,Fail,46,37,0,8,38
60,Fail,50,36,0,14,36
60,Fail,48,39,0,12,36
60,Fail,44,35,9,12,32
60,Fail,37,48,0,14,23
60,Fail,49,32,0,13,36
60,Fail,47,34,0,17,30
60,Fail,54,28,0,15,39
60,Fail,50,35,0,12,38
60,Fail,52,30,9,9,43
60,Fail,50,36,0,12,38
60,Fail,47,34,3,16,31
60,Fail,51,26,6,17,34
60,Fail,46,37,0,13,33
60,Fail,49,32,11,8,41
60,Fail,37,39,8,16,21
60,Fail,48,43,0,8,40
60,Fail,49,43,1,7,42
60,Fail,44,29,14,13,31
60,Fail,42,38,0,9,33
60,Fail,52,32,5,11,41
60,Fail,44,34,9,13,31
60,Fail,48,30,0,21,27
60,Fail,51,32,0,9,42
60,Fail,47,32,0,17,30
60,Fail,44,42,2,12,32
60,Fail,52,33,0,13,39
60,Fail,39,45,0,9,30
60,Fail,48,41,0,10,38
60,Fail,46,31,1,22,24
60,Fail,38,34,12,16,22
60,Fail,47,36,8,9,38
60,Fail,45,39,0,13,32
60,Fail,49,36,1,14,35
60,Fail,46,35,0,14,32
60,Fail,45,35,6,14,31
60,Fail,50,38,0,12,38
60,Fail,48,27,0,17,31
60,Fail,44,37,6,13,31
60,Fail,47,39,2,12,35
60,Fail,49,37,1,13,36
60,Fail,50,36,4,10,40
60,Fail,41,44,0,13,28
60,Fail,47,33,0,10,37
60,Fail,48,31,9,12,36
60,Fail,36,45,5,14,22
60,Fail,42,31,0,17,25
60,Fail,38,34,0,23,15
60,Fail,50,35,0,9,41
60,Fail,48,31,0,18,30
60,Fail,42,40,4,14,28
60,Fail,42,32,13,13,29
60,Fail,47,31,0,17,30
60,Fail,50,31,2,17,33
60,Fail,48,39,0,13,35
60,Fail,51,35,0,12,39
60,Fail,49,27,0,18,31
60,Fail,49,33,7,11,38
60,Fail,47,40,4,9,38
60,Fail,45,37,3,15,30
60,Fail,45,32,8,15,30
60,Fail,48,37,0,11,37
60,Fail,54,29,5,12,42
60,Fail,42,42,2,14,28
60,Fail,41,41,4,14,27
60,Fail,43,38,0,11,32
60,Fail,45,37,6,12,33
60,Fail,52,37,0,9,43
60,Fail,51,31,0,12,39
60,Fail,42,39,0,17,25
60,Fail,51,33,0,12,39
60,Fail,50,30,5,15,35
60,Fail,53,35,1,11,42
60,Fail,50,34,4,12,38
60,Fail,49,35,6,10,39
60,Fail,52,36,0,12,40
60,Fail,49,39,0,9,40
60,Fail,55,29,0,14,41
60,Fail,48,36,0,10,38
60,Fail,47,31,6,16,31
60,Fail,47,38,1,14,33
60,Fail,45,36,0,17,28
60,Fail,43,44,0,9,34
60,Fail,48,33,0,16,32
60,Fail,50,39,2,9,41
60,Fail,48,29,0,15,33
60,Fail,51,37,0,8,43
60,Fail,51,31,4,14,37
60,Fail,46,32,0,17,29
60,Fail,46,34,0,17,29
60,Fail,47,34,0,14,33
60,Fail,47,33,8,12,35
60,Fail,49,33,0,18,31
60,Fail,48,40,2,10,38
60,Fail,42,44,0,12,30
60,Fail,51,30,5,14,37
60,Fail,38,51,0,9,29
60,Fail,57,27,3,13,44
60,Fail,50,35,3,12,38
60,Fail,53,34,1,12,41
60,Fail,47,35,0,10,37
60,Fail,44,31,10,15,29
60,Fail,43,38,9,10,33
60,Fail,46,34,0,10,36
60,Fail,43,38,0,16,27
60,Fail,43,33,7,17,26
60,Fail,49,34,0,15,34
60,Fail,53,28,0,16,37
60,Fail,50,35,0,14,36
60,Fail,49,35,0,12,37
60,Fail,47,37,0,13,34
60,Fail,47,36,0,16,31
60,Fail,52,35,0,12,40
60,Fail,43,33,9,15,28
60,Fail,49,40,1,10,39
60,Fail,51,34,0,14,37
60,Fail,52,42,0,6,46
60,Fail,45,44,0,11,34
60,Fail,50,31,0,9,41
60,Fail,44,33,14,9,35
60,Fail,53,38,0,6,47
60,Fail,44,37,4,15,29
60,Fail,50,36,0,13,37
60,Fail,51,31,0,7,44
60,Fail,43,42,0,13,30
60,Fail,43,26,0,23,20
60,Fail,39,41,6,14,25
60,Fail,49,31,0,13,36
60,Fail,41,41,4,14,27
60,Fail,52,32,2,14,38
60,Fail,48,35,6,11,37
60,Fail,41,44,1,14,27
60,Fail,52,35,2,11,41
60,Fail,60,27,0,12,48
60,Fail,42,38,8,12,30
60,Fail,50,38,0,12,38
60,Fail,41,45,6,8,33
60,Fail,52,28,4,16,36
60,Fail,46,39,2,13,33
60,Fail,48,36,5,11,37
60,Fail,60,27,3,10,50
60,Fail,51,40,0,9,42
60,Fail,55,29,6,10,45
60,Fail,46,40,0,14,32
60,Fail,48,31,2,19,29
60,Fail,46,37,4,13,33
60,Fail,44,32,0,12,32
60,Fail,51,35,0,10,41
60,Fail,47,34,5,14,33
60,Fail,48,36,0,11,37
60,Fail,48,37,5,10,38
60,Fail,51,36,1,12,39
60,Fail,45,40,2,13,32
60,Fail,55,32,0,10,45
60,Fail,43,43,3,11,32
60,Fail,57,32,4,7,50
60,Fail,43,38,3,16,27
60,Fail,44,30,13,13,31
60,Fail,46,41,0,12,34
60,Fail,46,34,0,13,33
60,Fail,44,36,4,16,28
60,Fail,43,39,3,15,28
60,Fail,50,31,8,11,39
60,Fail,44,32,0,17,27
60,Fail,47,39,0,14,33
60,Fail,51,32,0,17,34
60,Fail,54,33,0,12,42
60,Fail,50,38,0,11,39
60,Fail,40,32,8,20,20
60,Fail,53,25,6,16,37
60,Fail,52,34,0,13,39
60,Fail,47,38,5,10,37
60,Fail,51,41,0,5,46
60,Fail,43,38,10,9,34
60,Fail,48,32,13,7,41
60,Fail,42,36,6,16,26
60,Fail,55,34,5,6,49
60,Fail,52,34,0,12,40
60,Fail,47,35,4,14,33
60,Fail,49,33,0,18,31
60,Fail,50,33,5,12,38
60,Fail,53,25,3,19,34
60,Fail,45,39,0,14,31
60,Fail,50,35,1,14,36
60,Fail,48,39,0,10,38
60,Fail,51,37,0,12,39
60,Fail,46,40,0,12,34
60,Fail,45,40,0,12,33
60,Fail,47,41,0,8,39
60,Fail,48,35,0,15,33
60,Fail,45,38,4,13,32
60,Fail,48,44,1,7,41
60,Fail,49,31,7,13,36
60,Fail,53,33,2,12,41
60,Fail,42,41,0,15,27
60,Fail,43,38,0,12,31
60,Fail,49,32,6,13,36
60,Fail,51,34,1,14,37
60,Fail,47,38,0,9,38
60,Fail,43,42,0,9,34
60,Fail,49,37,2,12,37
60,Fail,47,36,0,13,34
60,Fail,47,38,0,10,37
60,Fail,43,38,0,17,26
60,Fail,39,34,0,19,20
60,Fail,49,30,0,18,31
60,Fail,49,33,5,13,36
60,Fail,50,31,5,14,36
60,Fail,45,42,3,10,35
60,Fail,39,34,13,14,25
60,Fail,42,36,4,18,24
60,Fail,35,50,6,9,26
60,Fail,40,44,2,14,26
60,Fail,54,28,1,17,37
60,Fail,50,32,0,10,40
60,Fail,56,29,0,11,45
60,Fail,51,32,5,12,39
60,Fail,42,41,0,16,26
60,Fail,49,31,0,15,34
60,Fail,50,30,0,12,38
60,Fail,45,31,9,15,30
60,Fail,47,39,4,10,37
60,Fail,53,27,0,9,44
60,Fail,42,34,4,20,22
60,Fail,39,40,0,15,24
60,Fail,41,37,0,13,28
60,Fail,49,32,0,15,34
60,Fail,58,36,0,6,52
60,Fail,42,34,0,19,23
60,Fail,50,38,3,9,41
60,Fail,47,40,0,13,34
60,Fail,44,38,6,12,32
60,Fail,50,33,0,16,34
60,Fail,50,37,0,11,39
60,Fail,51,39,0,9,42
60,Fail,46,31,0,15,31
60,Fail,43,39,0,18,25
60,Fail,45,38,0,12,33
60,Fail,41,40,0,12,29
60,Fail,51,35,4,10,41
60,Fail,47,29,9,15,32
60,Fail,48,36,3,13,35
60,Fail,49,34,0,9,40
60,Fail,45,32,7,16,29
60,Fail,55,28,3,14,41
60,Fail,51,34,0,11,40
60,Fail,47,32,5,16,31
60,Fail,53,33,4,10,43
60,Fail,51,35,0,12,39
60,Fail,45,33,0,15,30
60,Fail,58,35,0,7,51
60,Fail,44,39,9,8,36
60,Fail,43,40,0,13,30
60,Fail,43,38,0,15,28
60,Fail,45,33,0,15,30
60,Fail,38,39,0,15,23
60,Fail,49,38,3,10,39
60,Fail,56,35,0,8,48
60,Fail,54,34,3,9,45
60,Fail,38,40,0,20,18
60,Fail,46,38,0,11,35
60,Fail,50,31,3,16,34
60,Fail,51,34,1,14,37
60,Fail,45,43,2,10,35
60,Fail,50,35,7,8,42
60,Fail,54,30,3,13,41
60,Fail,43,36,0,14,29
60,Fail,49,30,0,13,36
60,Fail,42,31,8,19,23
60,Fail,45,39,1,15,30
60,Fail,51,34,0,12,39
60,Fail,54,30,0,12,42
60,Fail,48,37,0,14,34
60,Fail,50,31,0,17,33
60,Fail,48,35,0,16,32
60,Fail,56,35,2,7,49
60,Fail,52,31,2,15,37
60,Fail,50,35,1,14,36
60,Fail,46,37,1,16,30
60,Fail,56,34,0,10,46
60,Fail,50,42,1,7,43
60,Fail,45,34,3,18,27
60,Fail,50,33,4,13,37
60,Fail,54,34,0,11,43
60,Fail,42,37,0,13,29
60,Fail,50,39,1,10,40
60,Fail,48,37,0,8,40
60,Fail,55,35,0,10,45
60,Fail,49,38,0,9,40
60,Fail,42,41,3,14,28
60,Fail,62,24,0,9,53
60,Fail,51,33,8,8,43
60,Fail,59,21,0,15,44
60,Fail,38,40,0,13,25
60,Fail,48,40,0,8,40
60,Fail,62,25,0,7,55
60,Fail,52,34,1,13,39
60,Fail,40,35,7,18,22
60,Fail,51,36,0,7,44
60,Fail,48,31,5,16,32
60,Fail,43,37,5,15,28
60,Fail,44,41,0,15,29
60,Fail,48,41,0,10,38
60,Fail,49,32,2,17,32
60,Fail,48,34,0,16,32
60,Fail,54,31,6,9,45
60,Fail,50,30,3,17,33
60,Fail,45,34,5,16,29
60,Fail,41,45,4,10,31
60,Fail,50,34,0,13,37
60,Fail,49,27,9,15,34
60,Fail,47,30,0,16,31
60,Fail,44,30,6,20,24
60,Fail,54,36,0,10,44
60,Fail,50,37,4,9,41
60,Fail,46,37,5,12,34
60,Fail,42,43,0,13,29
60,Fail,54,29,3,14,40
60,Fail,47,42,0,7,40
60,Fail,44,40,3,13,31
60,Fail,53,36,0,10,43
60,Fail,43,36,0,14,29
60,Fail,51,33,2,14,37
60,Fail,51,35,0,11,40
60,Fail,46,41,0,13,33
60,Fail,48,40,0,12,36
60,Fail,44,32,0,14,30
60,Fail,57,29,0,9,48
60,Fail,55,37,2,6,49
60,Fail,45,40,1,14,31
60,Fail,48,20,18,14,34
60,Fail,45,33,7,15,30
60,Fail,43,45,0,12,31
60,Fail,43,42,5,10,33
60,Fail,46,31,11,12,34
60,Fail,50,33,0,14,36
60,Fail,47,43,0,10,37
60,Fail,46,35,0,17,29
60,Fail,47,41,0,10,37
60,Fail,44,34,0,16,28
60,Fail,51,33,7,9,42
60,Fail,53,40,2,5,48
60,Fail,47,36,0,12,35
60,Fail,47,35,4,14,33
60,Fail,44,38,0,17,27
60,Fail,41,46,6,7,34
60,Fail,41,42,0,15,26
60,Fail,44,36,0,17,27
60,Fail,60,31,0,9,51
60,Fail,47,38,0,15,32
60,Fail,46,37,0,14,32
60,Fail,38,44,7,11,27
60,Fail,48,31,8,13,35
60,Fail,47,32,9,12,35
60,Fail,48,37,0,11,37
60,Fail,51,30,0,17,34
60,Fail,53,31,4,12,41
60,Fail,50,34,2,14,36
60,Fail,59,32,0,9,50
60,Fail,39,36,0,14,25
60,Fail,46,38,3,13,33
60,Fail,44,41,0,14,30
60,Fail,53,31,0,12,41
60,Fail,48,37,3,12,36
60,Fail,40,38,0,17,23
60,Fail,45,38,7,10,35
60,Fail,44,41,3,12,32
60,Fail,42,41,4,13,29
60,Fail,42,39,8,11,31
60,Fail,57,23,6,14,43
60,Fail,55,27,8,10,45
60,Fail,45,41,0,13,32
60,Fail,36,38,0,15,21
60,Fail,47,40,0,8,39
60,Fail,36,38,0,22,14
60,Fail,45,35,0,15,30
60,Fail,44,23,18,15,29
60,Fail,52,35,0,13,39
60,Fail,56,31,2,11,45
60,Fail,47,36,1,16,31
60,Fail,49,39,0,10,39
60,Fail,42,33,0,19,23
60,Fail,47,32,0,13,34
60,Fail,56,32,0,9,47
60,Fail,59,17,0,11,48
60,Fail,51,36,0,11,40
60,Fail,48,32,7,13,35
60,Fail,40,38,0,13,27
60,Fail,37,43,0,16,21
60,Fail,48,37,2,13,35
60,Fail,48,36,1,15,33
60,Fail,50,36,1,13,37
60,Fail,44,38,5,13,31
60,Fail,44,34,0,17,27
60,Fail,55,31,7,7,48
60,Fail,50,39,0,11,39
60,Fail,45,29,13,13,32
60,Fail,51,35,6,8,43
60,Fail,46,32,11,11,35
60,Fail,50,32,0,13,37
60,Fail,49,35,4,12,37
60,Fail,46,39,0,15,31
60,Fail,46,36,1,17,29
60,Fail,50,35,5,10,40
60,Fail,53,37,3,7,46
60,Fail,47,40,2,11,36
60,Fail,49,35,5,11,38
60,Fail,42,38,0,14,28
60,Fail,52,28,2,18,34
60,Fail,40,40,7,13,27
60,Fail,52,34,0,9,43
60,Fail,50,30,5,15,35
60,Fail,45,32,6,17,28
60,Fail,40,40,0,14,26
60,Fail,51,32,3,14,37
60,Fail,46,40,0,14,32
60,Fail,45,32,0,21,24
60,Fail,57,31,3,9,48
60,Fail,51,32,7,10,41
60,Fail,52,34,0,14,38
60,Fail,50,34,6,10,40
60,Fail,47,42,0,11,36
60,Fail,45,43,0,12,33
60,Fail,48,38,0,12,36
60,Fail,49,30,9,12,37
60,Fail,46,39,0,6,40
60,Fail,48,30,4,18,30
60,Fail,50,40,2,8,42
60,Fail,52,34,5,9,43
60,Fail,52,35,0,10,42
60,Fail,51,30,8,11,40
60,Fail,44,32,0,20,24
60,Fail,41,35,3,21,20
60,Fail,42,48,0,10,32
60,Fail,43,35,10,12,31
60,Fail,49,36,4,11,38
60,Fail,48,36,0,14,34
60,Fail,49,33,0,15,34
60,Fail,44,34,9,13,31
60,Fail,43,40,0,16,27
60,Fail,51,37,0,9,42
60,Fail,41,38,11,10,31
60,Fail,46,39,4,11,35
60,Fail,46,39,7,8,38
60,Fail,53,29,0,13,40
60,Fail,44,40,4,12,32
60,Fail,50,43,1,6,44
60,Fail,51,32,0,17,34
60,Fail,44,34,2,20,24
60,Fail,50,43,0,7,43
60,Fail,50,36,3,11,39
60,Fail,55,33,2,10,45
60,Fail,57,34,0,8,49
60,Fail,47,32,0,19,28
60,Fail,50,38,2,10,40
60,Fail,54,31,2,13,41
60,Fail,49,40,1,10,39
60,Fail,47,40,0,11,36
60,Fail,56,35,0,9,47
60,Fail,41,41,4,14,27
60,Fail,43,36,0,16,27
60,Fail,51,28,0,14,37
60,Fail,44,37,5,14,30
60,Fail,49,38,0,9,40
60,Fail,55,36,0,8,47
60,Fail,43,41,0,14,29
60,Fail,54,27,0,15,39
60,Fail,44,45,1,10,34
60,Fail,51,34,0,14,37
60,Fail,43,36,0,20,23
60,Fail,49,37,4,10,39
60,Fail,46,35,0,14,32
60,Fail,54,35,0,8,46
60,Fail,48,31,0,12,36
60,Fail,50,31,0,15,35
60,Fail,46,37,0,13,33
60,Fail,51,37,4,8,43
60,Fail,49,35,0,12,37
60,Fail,39,34,5,22,17
60,Fail,42,41,0,12,30
60,Fail,51,33,0,12,39
60,Fail,45,40,0,6,39
60,Fail,49,33,0,11,38
60,Fail,45,36,4,15,30
60,Fail,47,34,0,14,33
60,Fail,50,37,0,13,37
60,Fail,51,37,1,11,40
60,Fail,63,28,0,8,55
60,Fail,52,32,1,15,37
60,Fail,52,32,0,13,39
60,Fail,52,37,0,10,42
60,Fail,49,28,0,10,39
60,Fail,55,36,0,4,51
60,Fail,46,41,0,9,37
60,Fail,46,41,1,12,34
60,Fail,52,34,7,7,45
60,Fail,43,44,3,10,33
60,Fail,48,40,1,11,37
60,Fail,52,40,0,8,44
60,Fail,39,37,0,18,21
60,Fail,47,36,2,15,32
60,Fail,54,35,0,11,43
60,Fail,43,36,0,15,28
60,Fail,53,34,0,11,42
60,Fail,38,39,0,16,22
60,Fail,46,37,0,12,34
60,Fail,44,36,4,16,28
60,Fail,44,41,0,11,33
60,Fail,44,40,1,15,29
60,Fail,45,37,0,14,31
60,Fail,47,35,0,13,34
60,Fail,36,44,0,15,21
60,Fail,45,38,0,8,37
60,Fail,56,33,0,11,45
60,Fail,42,39,9,10,32
60,Fail,50,35,4,11,39
60,Fail,45,41,0,10,35
60,Fail,45,36,5,14,31
60,Fail,47,33,0,15,32
60,Fail,49,36,6,9,40
60,Fail,48,33,4,15,33
60,Fail,50,33,0,12,38
60,Fail,54,35,0,9,45
60,Fail,48,40,0,11,37
60,Fail,47,37,1,15,32
60,Fail,47,33,0,15,32
60,Fail,42,32,8,18,24
60,Fail,47,37,0,10,37
60,Fail,50,36,0,11,39
60,Fail,47,32,0,14,33
60,Fail,46,33,0,19,27
60,Fail,49,34,0,9,40
60,Fail,57,30,0,12,45
60,Fail,44,41,0,12,32
60,Fail,46,40,3,11,35
60,Fail,44,34,0,17,27
60,Fail,55,32,3,10,45
60,Fail,38,37,7,18,20
60,Fail,52,29,6,13,39
60,Fail,58,29,2,11,47
60,Fail,56,30,0,11,45
60,Fail,48,30,10,12,36
60,Fail,41,37,0,20,21
60,Fail,50,37,0,8,42
60,Fail,54,37,0,7,47
60,Fail,48,40,1,11,37
60,Fail,46,41,2,11,35
60,Fail,46,38,0,12,34
60,Fail,50,35,5,10,40
60,Fail,52,34,4,10,42
60,Fail,46,41,0,12,34
60,Fail,49,39,0,10,39
60,Fail,57,36,0,6,51
60,Fail,46,36,3,15,31
60,Fail,44,42,8,6,38
60,Fail,48,38,0,12,36
60,Fail,50,40,2,8,42
60,Fail,50,34,0,13,37
60,Fail,50,31,0,16,34
60,Fail,46,33,0,18,28
60,Fail,45,33,11,11,34
60,Fail,52,32,1,15,37
60,Fail,52,32,1,15,37
60,Fail,43,42,5,10,33
60,Fail,51,36,4,9,42
60,Fail,53,35,0,9,44
60,Fail,48,41,1,10,38
60,Fail,50,33,2,15,35
60,Fail,46,36,8,10,36
60,Fail,48,37,0,14,34
60,Fail,47,39,5,9,38
60,Fail,52,28,4,16,36
60,Fail,48,38,0,12,36
60,Fail,46,35,0,15,31
60,Fail,47,38,2,13,34
60,Fail,46,37,0,14,32
60,Fail,52,36,2,10,42
60,Fail,47,40,0,12,35
60,Fail,52,34,0,12,40
60,Fail,53,29,0,11,42
60,Fail,48,40,3,9,39
60,Fail,53,35,0,12,41
60,Fail,47,37,6,10,37
60,Fail,46,36,7,11,35
60,Fail,50,32,0,11,39
60,Fail,44,35,6,15,29
60,Fail,52,34,0,14,38
60,Fail,39,42,4,15,24
60,Fail,52,32,0,12,40
60,Fail,43,34,0,15,28
60,Fail,49,32,9,10,39
60,Fail,48,44,0,8,40
60,Fail,45,34,0,18,27
60,Fail,49,40,0,10,39
60,Fail,47,38,3,12,35
60,Fail,48,40,0,12,36
60,Fail,52,31,2,15,37
60,Fail,47,37,4,12,35
60,Fail,54,29,0,14,40
60,Fail,50,39,1,10,40
60,Fail,51,33,0,12,39
60,Fail,49,39,0,11,38
60,Fail,52,38,3,7,45
60,Fail,44,38,1,17,27
60,Fail,42,38,6,14,28
60,Fail,47,38,5,10,37
60,Fail,57,35,1,7,50
60,Fail,57,31,0,11,46
60,Fail,47,28,0,14,33
60,Fail,43,40,7,10,33
60,Fail,45,36,7,12,33
60,Fail,45,34,11,10,35
60,Fail,47,40,0,9,38
60,Fail,51,36,3,10,41
60,Fail,51,38,0,11,40
60,Fail,43,39,5,13,30
60,Fail,47,34,0,18,29
60,Fail,51,39,1,9,42
60,Fail,49,35,3,13,36
60,Fail,46,37,0,17,29
60,Fail,53,30,3,14,39
60,Fail,50,38,0,9,41
60,Fail,54,35,5,6,48
60,Fail,52,30,0,13,39
60,Fail,45,39,0,15,30
60,Fail,42,38,0,14,28
60,Fail,52,33,0,14,38
60,Fail,48,30,0,17,31
60,Fail,41,38,0,16,25
60,Fail,42,42,0,13,29
60,Fail,53,39,0,7,46
60,Fail,51,34,2,13,38
60,Fail,48,38,0,10,38
60,Fail,45,37,2,16,29
60,Fail,47,39,0,8,39
60,Fail,47,37,0,13,34
60,Fail,51,34,0,14,37
60,Fail,52,36,0,12,40
60,Fail,42,44,2,12,30
60,Fail,50,34,6,10,40
60,Fail,41,36,0,17,24
60,Fail,43,41,0,14,29
60,Fail,40,24,0,24,16
60,Fail,46,37,0,14,32
60,Fail,42,36,9,13,29
60,Fail,54,36,1,9,45
60,Fail,52,25,9,14,38
60,Fail,53,32,2,13,40
60,Fail,49,36,6,9,40
60,Fail,39,40,5,16,23
60,Fail,55,25,3,17,38
60,Fail,43,41,3,13,30
60,Fail,44,41,0,12,32
60,Fail,45,41,2,12,33
60,Fail,46,34,7,13,33
60,Fail,53,30,4,13,40
60,Fail,42,45,0,12,30
60,Fail,40,32,11,17,23
60,Fail,47,31,0,17,30
60,Fail,48,37,5,10,38
60,Fail,58,32,0,10,48
60,Fail,49,34,2,15,34
60,Fail,54,32,3,11,43
60,Fail,46,40,2,12,34
60,Fail,50,35,5,10,40
60,Fail,43,36,6,15,28
60,Fail,51,34,0,12,39
60,Fail,50,35,0,10,40
60,Fail,50,38,2,10,40
60,Fail,48,37,0,12,36
60,Fail,41,37,6,16,25
60,Fail,48,32,0,17,31
60,Fail,51,30,8,11,40
60,Fail,45,41,0,10,35
60,Fail,50,33,0,11,39
60,Fail,49,32,0,12,37
60,Fail,47,43,0,10,37
60,Fail,49,38,2,11,38
60,Fail,49,34,7,10,39
60,Fail,53,32,0,11,42
60,Fail,47,35,4,14,33
60,Fail,45,39,0,12,33
60,Fail,48,39,1,12,36
60,Fail,59,29,0,10,49
60,Fail,48,42,0,9,39
60,Fail,44,41,4,11,33
60,Fail,44,28,7,21,23
60,Fail,52,29,5,14,38
60,Fail,50,29,12,9,41
60,Fail,52,32,2,14,38
60,Fail,44,42,0,11,33
60,Fail,53,37,1,9,44
60,Fail,50,36,3,11,39
60,Fail,50,35,0,14,36
60,Fail,41,37,0,20,21
60,Fail,47,36,2,15,32
60,Fail,46,37,0,14,32
60,Fail,56,28,0,12,44
60,Fail,50,38,0,10,40
60,Fail,48,46,0,6,42
60,Fail,48,32,11,9,39
60,Fail,48,34,0,13,35
60,Fail,49,29,0,16,33
60,Fail,53,38,0,9,44
60,Fail,43,34,0,13,30
60,Fail,46,39,0,15,31
60,Fail,58,30,0,12,46
60,Fail,48,35,0,13,35
60,Fail,42,39,0,10,32
60,Fail,50,39,0,8,42
60,Fail,49,40,0,9,40
60,Fail,51,33,0,11,40
60,Fail,48,35,7,10,38
60,Fail,49,38,4,9,40
60,Fail,42,39,0,9,33
60,Fail,44,38,9,9,35
60,Fail,50,28,0,12,38
60,Fail,50,31,0,18,32
60,Fail,55,29,4,12,43
60,Fail,57,31,2,10,47
60,Fail,41,41,0,14,27
60,Fail,49,40,0,8,41
60,Fail,47,34,7,12,35
60,Fail,49,38,0,12,37
60,Fail,51,35,0,10,41
60,Fail,55,35,1,9,46
60,Fail,55,38,0,7,48
60,Fail,46,34,5,15,31
60,Fail,53,39,0,8,45
60,Fail,48,40,1,11,37
60,Fail,46,37,0,10,36
60,Fail,42,39,6,13,29
60,Fail,42,31,0,20,22
60,Fail,42,42,4,12,30
60,Fail,48,35,5,12,36
60,Fail,58,31,3,8,50
60,Fail,51,34,4,11,40
60,Fail,45,33,0,16,29
60,Fail,48,35,3,14,34
60,Fail,46,39,0,15,31
60,Fail,50,30,0,18,32
60,Fail,51,32,0,12,39
60,Fail,58,27,0,14,44
60,Fail,54,30,4,12,42
60,Fail,53,34,0,9,44
60,Fail,53,30,5,12,41
60,Fail,49,38,0,12,37
60,Fail,47,35,0,18,29
60,Fail,51,27,5,17,34
60,Fail,47,39,3,11,36
60,Fail,48,35,0,12,36
60,Fail,52,29,5,14,38
60,Fail,57,29,5,9,48
60,Fail,39,41,8,12,27
60,Fail,43,38,0,14,29
60,Fail,40,33,9,18,22
60,Fail,54,37,1,8,46
60,Fail,52,35,2,11,41
60,Fail,54,28,7,11,43
60,Fail,49,41,0,10,39
60,Fail,52,29,0,10,42
60,Fail,49,34,0,13,36
60,Fail,54,29,7,10,44
60,Fail,41,38,5,16,25
60,Fail,39,44,2,15,24
60,Fail,43,37,5,15,28
60,Fail,49,34,2,15,34
60,Fail,52,33,0,11,41
60,Fail,46,40,4,10,36
60,Fail,45,37,7,11,34
60,Fail,53,37,0,7,46
60,Fail,54,37,0,9,45
60,Fail,49,21,8,22,27
60,Fail,51,37,0,6,45
60,Fail,50,38,3,9,41
60,Fail,45,35,6,14,31
60,Fail,55,32,0,12,43
60,Fail,39,41,7,13,26
60,Fail,48,32,7,13,35
60,Fail,46,35,2,17,29
60,Fail,45,30,8,17,28
60,Fail,45,44,2,9,36
60,Fail,41,45,1,13,28
60,Fail,55,34,3,8,47
60,Fail,54,32,0,13,41
60,Fail,52,34,0,12,40
60,Fail,50,32,6,12,38
60,Fail,46,33,8,13,33
60,Fail,53,32,1,14,39
60,Fail,45,39,0,10,35
60,Fail,46,39,0,12,34
60,Fail,47,36,0,13,34
60,Fail,46,36,0,15,31
60,Fail,38,43,5,14,24
60,Fail,48,36,0,13,35
60,Fail,50,37,0,13,37
60,Fail,47,40,0,11,36
60,Fail,49,32,2,17,32
60,Fail,48,34,3,15,33
60,Fail,51,31,0,11,40
60,Fail,49,36,3,12,37
60,Fail,59,30,0,11,48
60,Fail,46,29,0,18,28
60,Fail,44,33,4,19,25
60,Fail,51,39,0,3,48
60,Fail,45,36,0,11,34
60,Fail,52,39,0,7,45
60,Fail,58,29,0,12,46
60,Fail,45,42,0,9,36
60,Fail,54,35,0,9,45
60,Fail,57,39,1,3,54
60,Fail,43,32,0,18,25
60,Fail,43,37,4,16,27
60,Fail,50,36,0,12,38
60,Fail,45,38,0,13,32
60,Fail,47,35,0,13,34
60,Fail,55,32,0,8,47
60,Fail,52,34,7,7,45
60,Fail,39,45,7,9,30
60,Fail,45,46,0,8,37
60,Fail,43,37,0,13,30
60,Fail,41,38,0,10,31
60,Fail,45,33,12,10,35
60,Fail,47,33,9,11,36
60,Fail,46,33,9,12,34
60,Fail,55,28,6,11,44
60,Fail,49,39,0,12,37
60,Fail,49,33,0,16,33
60,Fail,55,33,0,9,46
60,Fail,50,34,0,15,35
60,Fail,52,36,1,11,41
60,Fail,51,38,2,9,42
60,Fail,45,35,8,12,33
60,Fail,58,30,3,9,49
60,Fail,38,41,0,14,24
60,Fail,52,28,7,13,39
60,Fail,50,35,2,13,37
60,Fail,53,37,1,9,44
60,Fail,41,44,6,9,32
60,Fail,54,28,3,15,39
60,Fail,36,45,0,14,22
60,Fail,49,37,0,12,37
60,Fail,49,41,1,9,40
60,Fail,45,40,2,13,32
60,Fail,47,37,0,12,35
60,Fail,50,30,3,17,33
60,Fail,54,30,0,13,41
60,Fail,46,39,0,15,31
60,Fail,46,35,1,18,28
60,Fail,47,34,7,12,35
60,Fail,47,38,6,9,38
60,Fail,48,29,0,14,34
60,Fail,53,34,0,10,43
60,Fail,56,33,0,9,47
60,Fail,42,39,2,17,25
60,Fail,43,34,6,17,26
60,Fail,49,40,0,10,39
60,Fail,39,40,0,15,24
60,Fail,45,34,0,13,32
60,Fail,50,33,1,16,34
60,Fail,52,34,0,13,39
60,Fail,52,38,1,9,43
60,Fail,48,32,11,9,39
60,Fail,52,30,0,17,35
60,Fail,51,31,0,11,40
60,Fail,56,34,4,6,50
60,Fail,43,36,10,11,32
60,Fail,48,35,5,12,36
60,Fail,44,32,8,16,28
60,Fail,35,46,0,16,19
60,Fail,54,29,0,7,47
60,Fail,50,36,0,13,37
60,Fail,48,40,0,8,40
60,Fail,52,34,0,13,39
60,Fail,44,41,0,14,30
60,Fail,48,40,0,11,37
60,Fail,55,35,2,8,47
60,Fail,48,37,0,9,39
60,Fail,40,34,0,21,19
60,Fail,47,35,0,16,31
60,Fail,50,37,1,12,38
60,Fail,49,33,6,12,37
60,Fail,51,27,10,12,39
60,Fail,44,36,2,18,26
60,Fail,47,31,6,16,31
60,Fail,47,31,10,12,35
60,Fail,51,34,3,12,39
60,Fail,46,38,0,9,37
60,Fail,56,35,0,9,47
60,Fail,45,39,1,15,30
60,Fail,49,35,0,9,40
60,Fail,47,39,7,7,40
60,Fail,52,35,0,13,39
60,Fail,50,35,6,9,41
60,Fail,42,36,8,14,28
60,Fail,48,38,0,14,34
60,Fail,43,43,3,11,32
60,Fail,45,37,9,9,36
60,Fail,38,44,0,14,24
60,Fail,48,38,5,9,39
60,Fail,41,35,0,16,25
60,Fail,45,41,0,12,33
60,Fail,47,34,4,15,32
60,Fail,54,32,1,13,41
60,Fail,44,32,6,18,26
60,Fail,45,36,0,15,30
60,Fail,52,40,0,8,44
60,Fail,53,34,1,12,41
60,Fail,52,34,1,13,39
60,Fail,53,33,4,10,43
60,Fail,46,37,2,15,31
60,Fail,47,33,0,20,27
60,Fail,48,43,0,8,40
60,Fail,41,45,2,12,29
60,Fail,42,33,8,17,25
60,Fail,52,36,0,12,40
60,Fail,53,33,0,10,43
60,Fail,45,33,2,20,25
60,Fail,39,40,0,16,23
60,Fail,49,36,0,12,37
60,Fail,52,31,0,10,42
60,Fail,46,38,4,12,34
60,Fail,51,34,0,13,38
60,Fail,52,32,0,12,40
60,Fail,49,34,0,17,32
60,Fail,47,39,0,11,36
60,Fail,47,38,0,13,34
60,Fail,45,41,3,11,34
60,Fail,47,36,6,11,36
60,Fail,47,41,4,8,39
60,Fail,53,34,3,10,43
60,Fail,43,40,2,15,28
60,Fail,46,37,0,13,33
60,Fail,55,31,2,12,43
60,Fail,50,32,0,11,39
60,Fail,49,33,3,15,34
60,Fail,44,41,0,10,34
60,Fail,38,36,0,18,20
60,Fail,60,23,0,14,46
60,Fail,46,39,5,10,36
60,Fail,51,40,0,9,42
60,Fail,47,36,0,12,35
60,Fail,53,41,0,6,47
60,Fail,56,30,2,12,44
60,Fail,46,31,0,15,31
60,Fail,44,42,0,13,31
60,Fail,49,37,3,11,38
60,Fail,47,36,2,15,32
60,Fail,35,45,0,19,16
60,Fail,49,30,1,20,29
60,Fail,50,33,0,13,37
60,Fail,48,43,0,8,40
60,Fail,49,37,0,12,37
60,Fail,47,35,0,15,32
60,Fail,47,43,0,8,39
60,Fail,51,31,0,14,37
60,Fail,53,32,8,7,46
60,Fail,51,35,4,10,41
60,Fail,49,36,0,14,35
60,Fail,50,37,2,11,39
60,Fail,48,35,4,13,35
60,Fail,49,34,1,16,33
60,Fail,52,31,0,17,35
60,Fail,45,43,0,9,36
60,Fail,47,32,1,20,27
60,Fail,48,35,0,11,37
60,Fail,45,38,0,12,33
60,Fail,51,31,0,14,37
60,Fail,48,42,1,9,39
60,Fail,44,45,3,8,36
60,Fail,44,30,14,12,32
60,Fail,47,37,4,12,35
60,Fail,49,34,4,13,36
60,Fail,40,38,1,21,19
60,Fail,56,31,0,11,45
60,Fail,56,27,0,16,40
60,Fail,51,34,4,11,40
60,Fail,50,29,5,16,34
60,Fail,44,39,2,15,29
60,Fail,53,27,0,16,37
60,Fail,44,35,5,16,28
60,Fail,50,39,2,9,41
60,Fail,52,31,5,12,40
60,Fail,38,38,10,14,24
60,Fail,53,32,3,12,41
60,Fail,37,43,0,12,25
60,Fail,47,32,7,14,33
60,Fail,42,40,0,13,29
60,Fail,49,35,2,14,35
60,Fail,53,37,1,9,44
60,Fail,45,30,0,17,28
60,Fail,47,36,6,11,36
60,Fail,44,34,0,11,33
60,Fail,50,30,6,14,36
60,Fail,49,34,0,15,34
60,Fail,41,44,0,12,29
60,Fail,57,29,0,11,46
60,Fail,54,34,0,9,45
60,Fail,55,30,0,12,43
60,Fail,45,35,1,19,26
60,Fail,41,40,0,12,29
60,Fail,43,37,6,14,29
60,Fail,45,40,0,15,30
60,Fail,45,31,10,14,31
60,Fail,49,38,2,11,38
60,Fail,37,33,14,16,21
60,Fail,49,38,0,13,36
60,Fail,45,41,0,14,31
60,Fail,42,39,8,11,31
60,Fail,50,36,0,14,36
60,Fail,47,33,5,15,32
60,Fail,42,31,0,15,27
60,Fail,50,38,0,11,39
60,Fail,53,36,3,8,45
60,Fail,47,34,5,14,33
60,Fail,43,34,7,16,27
60,Fail,37,37,0,16,21
60,Fail,43,44,0,13,30
60,Fail,48,43,0,8,40
60,Fail,54,35,0,8,46
60,Fail,49,39,0,12,37
60,Fail,52,39,0,9,43
60,Fail,49,35,6,10,39
60,Fail,42,40,2,16,26
60,Fail,41,39,8,12,29
60,Fail,54,37,0,7,47
60,Fail,49,36,4,11,38
60,Fail,41,36,9,14,27
60,Fail,48,40,2,10,38
60,Fail,46,31,9,14,32
60,Fail,53,27,0,13,40
60,Fail,47,35,0,10,37
60,Fail,54,33,0,10,44
60,Fail,49,34,6,11,38
60,Fail,48,37,5,10,38
60,Fail,54,30,0,13,41
60,Fail,44,37,4,15,29
60,Fail,53,35,3,9,44
60,Fail,50,36,3,11,39
60,Fail,47,31,0,11,36
60,Fail,54,32,2,12,42
60,Fail,44,37,3,16,28
60,Fail,49,40,0,8,41
60,Fail,53,36,0,8,45
60,Fail,49,32,7,12,37
60,Fail,52,35,1,12,40
60,Fail,55,27,6,12,43
60,Fail,56,28,4,12,44
60,Fail,56,30,0,13,43
60,Fail,53,38,1,8,45
60,Fail,48,35,5,12,36
60,Fail,40,36,0,14,26
60,Fail,43,39,0,10,33
60,Fail,50,30,0,17,33
60,Fail,50,38,0,10,40
60,Fail,50,34,6,10,40
60,Fail,50,34,3,13,37
60,Fail,46,32,0,13,33
60,Fail,54,31,0,15,39
60,Fail,52,31,4,13,39
60,Fail,45,43,0,12,33
60,Fail,43,31,0,12,31
60,Fail,45,35,7,13,32
60,Fail,47,39,1,13,34
60,Fail,56,22,0,17,39
60,Fail,49,35,5,11,38
60,Fail,46,44,0,10,36
60,Fail,45,41,0,12,33
60,Fail,51,35,0,10,41
60,Fail,45,31,0,17,28
60,Fail,53,33,2,12,41
60,Fail,53,35,1,11,42
60,Fail,48,37,0,11,37
60,Fail,44,42,0,12,32
60,Fail,53,32,0,11,42
60,Fail,52,28,2,18,34
60,Fail,48,37,0,15,33
60,Fail,37,37,11,15,22
60,Fail,48,37,7,8,40
60,Fail,61,26,4,9,52
60,Fail,58,33,0,6,52
60,Fail,50,38,0,11,39
60,Fail,48,33,0,15,33
60,Fail,37,35,0,20,17
60,Fail,46,33,0,13,33
60,Fail,47,40,1,12,35
60,Fail,46,40,0,13,33
60,Fail,47,33,8,12,35
60,Fail,47,33,0,13,34
60,Fail,45,34,0,15,30
60,Fail,62,27,1,10,52
60,Fail,50,36,0,12,38
60,Fail,54,29,0,10,44
60,Fail,52,35,6,7,45
60,Fail,46,38,2,14,32
60,Fail,43,45,0,11,32
60,Fail,51,35,2,12,39
60,Fail,45,43,4,8,37
60,Fail,56,33,0,9,47
60,Fail,44,39,2,15,29
60,Fail,46,39,2,13,33
60,Fail,46,38,0,12,34
60,Fail,45,38,2,15,30
60,Fail,50,28,10,12,38
60,Fail,46,34,10,10,36
60,Fail,47,36,4,13,34
60,Fail,52,35,0,12,40
60,Fail,45,44,0,10,35
60,Fail,46,38,9,7,39
60,Fail,47,41,4,8,39
60,Fail,48,34,0,17,31
60,Fail,47,28,6,19,28
60,Fail,49,34,0,16,33
60,Fail,49,31,0,16,33
60,Fail,46,40,0,7,39
60,Fail,48,36,0,13,35
60,Fail,46,38,0,14,32
60,Fail,50,37,1,12,38
60,Fail,47,41,0,11,36
60,Fail,45,42,0,12,33
60,Fail,49,33,4,14,35
60,Fail,44,47,0,9,35
60,Fail,58,29,5,8,50
60,Fail,45,36,0,17,28
60,Fail,53,32,1,14,39
60,Fail,51,34,8,7,44
60,Fail,43,38,0,15,28
60,Fail,47,39,0,11,36
60,Fail,46,36,3,15,31
60,Fail,47,40,0,11,36
60,Fail,48,42,0,9,39
60,Fail,54,36,0,9,45
60,Fail,43,41,2,14,29
60,Fail,48,40,4,8,40
60,Fail,48,31,10,11,37
60,Fail,52,34,0,11,41
60,Fail,50,35,0,10,40
60,Fail,46,39,0,12,34
60,Fail,45,38,0,17,28
60,Fail,47,38,3,12,35
60,Fail,45,35,0,17,28
60,Fail,42,39,0,15,27
60,Fail,47,32,11,10,37
60,Fail,50,30,0,16,34
60,Fail,52,38,0,9,43
60,Fail,49,36,3,12,37
60,Fail,40,32,12,16,24
60,Fail,46,39,1,14,32
60,Fail,52,30,3,15,37
60,Fail,45,37,0,18,27
60,Fail,43,39,0,17,26
60,Fail,46,30,0,16,30
60,Fail,54,38,0,7,47
60,Fail,55,33,1,11,44
60,Fail,51,31,4,14,37
60,Fail,40,38,0,16,24
60,Fail,45,30,0,14,31
60,Fail,49,35,4,12,37
60,Fail,42,38,0,13,29
60,Fail,44,36,0,16,28
60,Fail,47,27,0,17,30
60,Fail,47,39,0,10,37
60,Fail,53,32,2,13,40
60,Fail,49,31,5,15,34
60,Fail,51,37,0,12,39
60,Fail,45,36,0,16,29
60,Fail,45,43,0,11,34
60,Fail,45,36,0,13,32
60,Fail,45,40,0,10,35
60,Fail,52,35,0,11,41
60,Fail,47,41,0,10,37
60,Fail,46,42,2,10,36
60,Fail,40,34,0,20,20
60,Fail,53,31,0,12,41
60,Fail,46,35,0,16,30
60,Fail,53,30,4,13,40
60,Fail,50,32,7,11,39
60,Fail,51,39,0,8,43
60,Fail,45,37,0,13,32
60,Fail,52,35,0,12,40
60,Fail,55,35,0,10,45
60,Fail,54,37,0,9,45
60,Fail,51,30,2,17,34
60,Fail,50,38,0,12,38
60,Fail,56,24,0,9,47
60,Fail,51,33,10,6,45
60,Fail,50,40,2,8,42
60,Fail,51,34,0,14,37
60,Fail,43,40,0,14,29
60,Fail,49,36,0,11,38
60,Fail,47,40,0,12,35
60,Fail,44,35,0,14,30
60,Fail,51,37,1,11,40
60,Fail,43,41,0,13,30
60,Fail,53,30,3,14,39
60,Fail,51,31,0,14,37
60,Fail,42,45,0,10,32
60,Fail,51,43,3,3,48
60,Fail,51,31,0,13,38
60,Fail,53,35,0,9,44
60,Fail,53,32,0,14,39
60,Fail,48,37,0,9,39
60,Fail,45,28,8,19,26
60,Fail,52,37,0,11,41
60,Fail,48,33,4,15,33
60,Fail,49,34,1,16,33
60,Fail,39,47,0,14,25
60,Fail,45,41,0,10,35
60,Fail,42,36,7,15,27
60,Fail,45,40,5,10,35
60,Fail,52,29,5,14,38
60,Fail,42,35,0,12,30
60,Fail,43,42,0,14,29
60,Fail,47,39,0,9,38
60,Fail,46,37,6,11,35
60,Fail,50,39,4,7,43
60,Fail,48,35,8,9,39
60,Fail,50,42,0,8,42
60,Fail,47,33,0,13,34
60,Fail,46,37,0,14,32
60,Fail,53,34,0,11,42
60,Fail,49,33,0,16,33
60,Fail,45,41,7,7,38
60,Fail,37,41,0,15,22
60,Fail,53,34,4,9,44
60,Fail,45,37,3,15,30
60,Fail,47,37,0,12,35
60,Fail,47,29,7,17,30
60,Fail,47,43,0,7,40
60,Fail,51,29,0,11,40
60,Fail,51,32,1,16,35
60,Fail,50,38,0,12,38
60,Fail,51,36,0,11,40
60,Fail,52,32,0,15,37
60,Fail,52,31,2,15,37
60,Fail,48,40,0,11,37
60,Fail,48,32,0,16,32
60,Fail,45,37,3,15,30
60,Fail,49,30,0,8,41
60,Fail,57,28,0,13,44
60,Fail,48,38,1,13,35
60,Fail,42,45,1,12,30
60,Fail,45,33,0,13,32
60,Fail,46,34,5,15,31
60,Fail,52,36,0,8,44
60,Fail,52,31,2,15,37
60,Fail,59,26,4,11,48
60,Fail,47,39,2,12,35
60,Fail,44,40,0,12,32
60,Fail,46,34,1,19,27
60,Fail,55,37,0,8,47
60,Fail,39,35,15,11,28
60,Fail,39,42,3,16,23
60,Fail,43,40,1,16,27
60,Fail,44,33,10,13,31
60,Fail,41,46,1,12,29
60,Fail,49,32,5,14,35
60,Fail,43,43,0,11,32
60,Fail,54,29,3,14,40
60,Fail,51,34,1,14,37
60,Fail,55,28,0,11,44
60,Fail,41,40,6,13,28
60,Fail,46,32,7,15,31
60,Fail,43,38,0,9,34
60,Fail,49,32,2,17,32
60,Fail,52,40,2,6,46
60,Fail,40,43,6,11,29
60,Fail,41,39,7,13,28
60,Fail,44,43,1,12,32
60,Fail,53,32,0,13,40
60,Fail,49,33,0,17,32
60,Fail,48,32,5,15,33
60,Fail,56,33,0,8,48
60,Fail,50,31,0,13,37
60,Fail,52,38,2,8,44
60,Fail,46,42,3,9,37
60,Fail,49,34,2,15,34
60,Fail,51,33,0,15,36
60,Fail,50,30,7,13,37
60,Fail,50,29,0,10,40
60,Fail,53,36,0,11,42
60,Fail,48,34,8,10,38
60,Fail,51,32,0,12,39
60,Fail,47,33,0,12,35
60,Fail,49,35,0,13,36
60,Fail,52,41,0,6,46
60,Fail,50,32,9,9,41
60,Fail,56,26,3,15,41
60,Fail,37,37,6,20,17
60,Fail,46,35,0,14,32
60,Fail,46,36,2,16,30
60,Fail,41,40,0,17,24
60,Fail,49,32,4,15,34
60,Fail,53,38,0,9,44
60,Fail,58,29,1,12,46
60,Fail,48,36,0,12,36
60,Fail,44,35,2,19,25
60,Fail,43,37,0,19,24
60,Fail,45,34,0,14,31
60,Fail,51,36,0,11,40
60,Fail,50,36,0,12,38
60,Fail,56,31,3,10,46
60,Fail,50,35,0,15,35
60,Fail,51,30,0,13,38
60,Fail,57,30,2,11,46
60,Fail,50,36,0,8,42
60,Fail,50,37,2,11,39
60,Fail,45,36,8,11,34
60,Fail,45,36,0,13,32
60,Fail,49,38,0,13,36
60,Fail,55,31,0,14,41
60,Fail,47,29,14,10,37
60,Fail,45,40,2,13,32
60,Fail,47,41,0,9,38
60,Fail,53,32,0,14,39
60,Fail,43,37,6,14,29
60,Fail,41,32,0,15,26
60,Fail,45,37,4,14,31
60,Fail,48,32,0,16,32
60,Fail,43,36,0,17,26
60,Fail,44,42,5,9,35
60,Fail,36,43,0,18,18
60,Fail,49,38,0,8,41
60,Fail,49,32,0,14,35
60,Fail,53,34,0,12,41
60,Fail,58,33,0,9,49
60,Fail,59,34,1,6,53
60,Fail,55,30,0,14,41
60,Fail,47,35,0,13,34
60,Fail,47,35,0,11,36
60,Fail,47,39,2,12,35
60,Fail,55,32,2,11,44
60,Fail,53,38,3,6,47
60,Fail,45,45,0,9,36
60,Fail,55,34,0,11,44
60,Fail,47,32,0,17,30
60,Fail,42,41,6,11,31
60,Fail,54,29,0,10,44
60,Fail,38,42,4,16,22
60,Fail,44,34,8,14,30
60,Fail,55,26,0,10,45
60,Fail,44,44,1,11,33
60,Fail,44,40,0,12,32
60,Fail,48,37,0,15,33
60,Fail,48,41,0,7,41
60,Fail,50,33,2,15,35
60,Fail,52,34,0,13,39
60,Fail,48,38,0,11,37
60,Fail,45,39,1,15,30
60,Fail,37,45,0,18,19
60,Fail,55,32,0,8,47
60,Fail,44,38,5,13,31
60,Fail,48,41,0,9,39
60,Fail,50,32,0,16,34
60,Fail,41,35,11,13,28
60,Fail,36,40,0,16,20
60,Fail,48,35,0,11,37
60,Fail,43,38,4,15,28
60,Fail,47,37,0,15,32
60,Fail,47,38,0,9,38
60,Fail,47,37,0,12,35
60,Fail,54,31,0,10,44
60,Fail,55,27,10,8,47
60,Fail,53,33,0,13,40
60,Fail,44,29,9,18,26
60,Fail,51,37,0,11,40
60,Fail,44,41,8,7,37
60,Fail,44,38,0,13,31
60,Fail,50,37,5,8,42
60,Fail,49,39,0,11,38
60,Fail,56,33,1,10,46
60,Fail,46,35,0,15,31
60,Fail,49,35,0,12,37
60,Fail,59,31,0,8,51
60,Fail,50,31,6,13,37
60,Fail,56,33,0,11,45
60,Fail,45,40,0,15,30
60,Fail,46,33,4,17,29
60,Fail,51,35,3,11,40
60,Fail,44,37,0,16,28
60,Fail,49,36,0,15,34
60,Fail,51,34,0,12,39
60,Fail,53,30,0,17,36
60,Fail,51,37,0,10,41
60,Fail,42,37,0,13,29
60,Fail,47,43,3,7,40
60,Fail,45,36,3,16,29
60,Fail,49,27,15,9,40
60,Fail,46,37,11,6,40
60,Fail,57,34,2,7,50
60,Fail,43,40,2,15,28
60,Fail,47,38,0,12,35
60,Fail,46,43,2,9,37
60,Fail,42,35,6,17,25
60,Fail,50,30,6,14,36
60,Fail,45,35,0,11,34
60,Fail,48,34,0,15,33
60,Fail,43,36,6,15,28
60,Fail,43,33,10,14,29
60,Fail,42,42,5,11,31
60,Fail,53,30,4,13,40
60,Fail,47,40,0,12,35
60,Fail,55,29,0,11,44
60,Fail,40,40,0,14,26
60,Fail,47,34,0,14,33
60,Fail,50,35,0,9,41
60,Fail,53,29,5,13,40
60,Fail,54,27,7,12,42
60,Fail,48,33,7,12,36
60,Fail,40,37,0,19,21
60,Fail,50,29,9,12,38
60,Fail,47,33,0,19,28
60,Fail,46,39,0,15,31
60,Fail,53,32,0,15,38
60,Fail,46,38,2,14,32
60,Fail,46,39,0,14,32
60,Fail,51,33,0,9,42
60,Fail,55,31,0,13,42
60,Fail,47,35,0,15,32
60,Fail,53,35,2,10,43
60,Fail,47,32,0,16,31
60,Fail,53,31,0,9,44
60,Fail,46,34,5,15,31
60,Fail,55,31,0,13,42
60,Fail,50,29,8,13,37
60,Fail,54,36,0,10,44
60,Fail,55,36,0,9,46
60,Fail,53,35,3,9,44
60,Fail,50,31,4,15,35
60,Fail,54,35,2,9,45
60,Fail,42,41,0,15,27
60,Fail,46,34,0,13,33
60,Fail,56,38,0,6,50
60,Fail,48,33,5,14,34
60,Fail,48,34,0,14,34
60,Fail,49,37,4,10,39
60,Fail,47,39,0,14,33
60,Fail,51,32,2,15,36
60,Fail,48,36,0,14,34
60,Fail,48,32,8,12,36
60,Fail,47,38,0,14,33
60,Fail,53,35,1,11,42
60,Fail,50,40,0,10,40
60,Fail,52,35,1,12,40
60,Fail,50,31,0,14,36
60,Fail,51,32,0,7,44
60,Fail,48,37,0,12,36
60,Fail,44,34,7,15,29
60,Fail,53,33,1,13,40
60,Fail,49,37,0,13,36
60,Fail,47,36,0,14,33
60,Fail,50,33,0,17,33
60,Fail,46,39,0,14,32
60,Fail,50,39,0,8,42
60,Fail,45,36,0,17,28
60,Fail,47,40,3,10,37
60,Fail,49,38,3,10,39
60,Fail,58,29,0,6,52
60,Fail,49,39,0,9,40
60,Fail,47,27,6,20,27
60,Fail,43,46,0,10,33
60,Fail,53,28,0,11,42
60,Fail,45,37,0,14,31
60,Fail,51,36,3,10,41
60,Fail,45,36,0,14,31
60,Fail,52,35,0,13,39
60,Fail,52,30,0,12,40
60,Fail,46,34,0,15,31
60,Fail,50,33,3,14,36
60,Fail,51,31,8,10,41
60,Fail,53,37,0,10,43
60,Fail,41,44,0,11,30
60,Fail,49,33,9,9,40
60,Fail,52,27,7,14,38
60,Fail,51,34,0,11,40
60,Fail,55,33,0,11,44
60,Fail,45,33,6,16,29
60,Fail,42,40,3,15,27
60,Fail,48,39,3,10,38
60,Fail,48,42,1,9,39
60,Fail,46,37,0,17,29
60,Fail,49,33,0,11,38
60,Fail,46,37,0,16,30
60,Fail,44,32,0,13,31
60,Fail,57,31,0,7,50
60,Fail,52,31,0,11,41
60,Fail,52,28,0,10,42
60,Fail,43,36,0,17,26
60,Fail,49,34,2,15,34
60,Fail,48,37,5,10,38
60,Fail,44,36,5,15,29
60,Fail,51,36,0,10,41
60,Fail,49,31,3,17,32
60,Fail,48,32,0,19,29
60,Fail,49,35,2,14,35
60,Fail,54,25,6,15,39
60,Fail,46,36,4,14,32
60,Fail,47,37,5,11,36
60,Fail,42,37,7,14,28
60,Fail,54,28,0,16,38
60,Fail,44,36,6,14,30
60,Fail,45,44,0,11,34
60,Fail,45,37,0,11,34
60,Fail,46,29,0,16,30
60,Fail,42,37,9,12,30
60,Fail,61,31,0,8,53
60,Fail,51,36,1,12,39
60,Fail,57,25,7,11,46
60,Fail,48,40,0,9,39
60,Fail,55,31,2,12,43
60,Fail,46,33,0,13,33
60,Fail,52,37,0,9,43
60,Fail,50,36,0,14,36
60,Fail,53,33,2,12,41
60,Fail,49,33,0,15,34
60,Fail,49,36,0,12,37
60,Fail,49,35,4,12,37
60,Fail,53,36,0,8,45
60,Fail,41,39,10,10,31
60,Fail,44,36,2,18,26
60,Fail,49,37,0,9,40
60,Fail,56,30,1,13,43
60,Fail,44,41,4,11,33
60,Fail,53,34,3,10,43
60,Fail,57,32,0,9,48
60,Fail,56,34,4,6,50
60,Fail,49,33,4,14,35
60,Fail,52,32,5,11,41
60,Fail,53,34,0,11,42
60,Fail,47,39,1,13,34
60,Fail,33,40,0,21,12
60,Fail,48,34,6,12,36
60,Fail,46,37,0,14,32
60,Fail,50,30,6,14,36
60,Fail,45,34,7,14,31
60,Fail,44,39,5,12,32
60,Fail,35,39,0,17,18
60,Fail,49,31,6,14,35
60,Fail,39,38,1,22,17
60,Fail,46,35,4,15,31
60,Fail,49,39,0,12,37
60,Fail,45,30,8,17,28
60,Fail,48,37,0,14,34
60,Fail,53,28,0,8,45
60,Fail,52,31,8,9,43
60,Fail,46,34,12,8,38
60,Fail,56,32,0,4,52
60,Fail,48,36,3,13,35
60,Fail,41,44,0,8,33
60,Fail,50,28,0,21,29
60,Fail,46,31,7,16,30
60,Fail,51,38,4,7,44
60,Fail,51,29,0,13,38
60,Fail,51,36,1,12,39
60,Fail,44,37,0,13,31
60,Fail,36,44,0,17,19
60,Fail,47,40,2,11,36
60,Fail,47,38,3,12,35
60,Fail,41,36,0,12,29
60,Fail,47,42,0,11,36
60,Fail,49,36,4,11,38
60,Fail,48,36,0,11,37
60,Fail,54,31,1,14,40
60,Fail,49,34,1,16,33
60,Fail,49,37,0,9,40
60,Fail,45,33,3,19,26
60,Fail,45,34,0,16,29
60,Fail,44,31,11,14,30
60,Fail,48,38,3,11,37
60,Fail,50,36,0,10,40
60,Fail,45,22,0,21,24
60,Fail,57,32,1,10,47
60,Fail,46,39,4,11,35
60,Fail,56,33,0,9,47
60,Fail,50,34,0,15,35
60,Fail,46,37,0,12,34
60,Fail,47,35,1,17,30
60,Fail,50,34,0,12,38
60,Fail,42,42,1,15,27
60,Fail,46,35,4,15,31
60,Fail,44,45,0,10,34
60,Fail,50,37,0,11,39
60,Fail,49,41,2,8,41
60,Fail,50,36,3,11,39
60,Fail,48,32,0,17,31
60,Fail,47,41,0,11,36
60,Fail,49,39,0,11,38
60,Fail,46,31,8,15,31
60,Fail,48,33,3,16,32
60,Fail,46,37,0,17,29
60,Fail,49,38,0,12,37
60,Fail,38,43,0,16,22
60,Fail,45,36,0,12,33
60,Fail,46,38,4,12,34
60,Fail,50,37,0,11,39
60,Fail,50,27,9,14,36
60,Fail,52,31,2,15,37
60,Fail,50,33,0,10,40
60,Fail,58,31,2,9,49
60,Fail,44,39,0,10,34
60,Fail,58,31,0,11,47
60,Fail,48,38,0,13,35
60,Fail,46,33,6,15,31
60,Fail,51,36,1,12,39
60,Fail,46,37,5,12,34
60,Fail,44,37,0,14,30
60,Fail,47,39,4,10,37
60,Fail,45,32,7,16,29
60,Fail,50,39,4,7,43
60,Fail,47,40,2,11,36
60,Fail,46,41,3,10,36
60,Fail,44,42,0,12,32
60,Fail,48,42,4,6,42
60,Fail,39,32,18,11,28
60,Fail,51,34,2,13,38
60,Fail,47,37,0,12,35
60,Fail,45,37,0,18,27
60,Fail,58,24,6,12,46
60,Fail,41,41,3,15,26
60,Fail,51,35,0,13,38
60,Fail,48,35,3,14,34
60,Fail,45,32,0,14,31
60,Fail,52,37,3,8,44
60,Fail,49,34,0,15,34
60,Fail,53,34,0,6,47
60,Fail,40,35,0,18,22
60,Fail,56,35,0,8,48
60,Fail,45,35,8,12,33
60,Fail,42,40,4,14,28
60,Fail,44,35,14,7,37
60,Fail,47,36,7,10,37
60,Fail,41,36,8,15,26
60,Fail,54,30,2,14,40
60,Fail,50,31,0,15,35
60,Fail,50,36,6,8,42
60,Fail,53,30,6,11,42
60,Fail,47,36,0,17,30
60,Fail,47,36,7,10,37
60,Fail,58,35,0,6,52
60,Fail,53,36,1,10,43
60,Fail,49,32,3,16,33
60,Fail,46,39,4,11,35
60,Fail,42,38,7,13,29
60,Fail,57,33,1,9,48
60,Fail,48,30,0,11,37
60,Fail,55,31,6,8,47
60,Fail,49,31,0,17,32
60,Fail,40,35,2,23,17
60,Fail,55,31,0,12,43
60,Fail,56,27,0,12,44
60,Fail,49,35,9,7,42
60,Fail,52,36,4,8,44
60,Fail,52,35,0,13,39
60,Fail,55,29,8,8,47
60,Fail,51,35,1,13,38
60,Fail,49,37,2,12,37
60,Fail,54,30,0,13,41
60,Fail,49,40,1,10,39
60,Fail,45,36,0,13,32
60,Fail,51,37,0,11,40
60,Fail,55,25,0,15,40
60,Fail,58,29,0,13,45
60,Fail,42,42,0,15,27
60,Fail,43,40,0,10,33
60,Fail,47,36,0,11,36
60,Fail,42,41,0,12,30
60,Fail,44,33,10,13,31
60,Fail,47,33,5,15,32
60,Fail,48,36,2,14,34
60,Fail,47,36,0,12,35
60,Fail,40,44,7,9,31
60,Fail,40,38,4,18,22
60,Fail,54,34,0,9,45
60,Fail,38,41,6,15,23
60,Fail,45,43,0,9,36
60,Fail,44,39,3,14,30
60,Fail,51,35,0,13,38
60,Fail,40,34,4,22,18
60,Fail,41,42,0,12,29
60,Fail,49,35,0,11,38
60,Fail,49,36,3,12,37
60,Fail,50,35,2,13,37
60,Fail,48,34,4,14,34
60,Fail,53,39,4,4,49
60,Fail,47,32,0,20,27
60,Fail,53,29,0,13,40
60,Fail,49,31,0,13,36
60,Fail,54,35,0,9,45
60,Fail,53,31,3,13,40
60,Fail,40,37,0,12,28
60,Fail,47,40,0,10,37
60,Fail,52,31,0,16,36
60,Fail,50,39,2,9,41
60,Fail,49,31,0,14,35
60,Fail,45,39,2,14,31
60,Fail,49,32,0,18,31
60,Fail,46,34,9,11,35
60,Fail,42,44,0,13,29
60,Fail,51,32,0,14,37
60,Fail,46,34,0,17,29
60,Fail,40,46,4,10,30
60,Fail,46,29,13,12,34
60,Fail,51,39,0,9,42
60,Fail,46,37,1,16,30
60,Fail,49,38,0,12,37
60,Fail,51,31,0,14,37
60,Fail,44,36,0,19,25
60,Fail,45,42,0,9,36
60,Fail,48,31,0,20,28
60,Fail,44,38,2,16,28
60,Fail,47,34,9,10,37
60,Fail,40,42,6,12,28
60,Fail,48,31,0,16,32
60,Fail,47,42,3,8,39
60,Fail,56,28,5,11,45
60,Fail,44,38,0,14,30
60,Fail,51,41,0,7,44
60,Fail,42,34,9,15,27
60,Fail,44,41,0,11,33
60,Fail,47,34,0,12,35
60,Fail,54,32,0,9,45
60,Fail,49,33,0,14,35
60,Fail,46,36,7,11,35
60,Fail,47,38,0,13,34
60,Fail,42,38,0,12,30
60,Fail,49,39,2,10,39
60,Fail,46,43,3,8,38
60,Fail,48,38,0,8,40
60,Fail,51,29,5,15,36
60,Fail,42,43,0,9,33
60,Fail,43,41,4,12,31
60,Fail,51,32,0,15,36
60,Fail,45,35,6,14,31
60,Fail,50,35,0,14,36
60,Fail,43,34,0,10,33
60,Fail,52,30,2,16,36
60,Fail,50,30,0,13,37
60,Fail,56,33,0,8,48
60,Fail,56,29,3,12,44
60,Fail,47,37,0,13,34
60,Fail,33,36,10,21,12
60,Fail,49,33,5,13,36
60,Fail,51,36,0,5,46
60,Fail,51,34,1,14,37
60,Fail,52,26,0,11,41
60,Fail,49,37,2,12,37
60,Fail,46,36,0,18,28
60,Fail,35,36,9,20,15
60,Fail,49,35,4,12,37
60,Fail,49,27,2,22,27
60,Fail,49,40,5,6,43
60,Fail,45,40,1,14,31
60,Fail,52,30,0,13,39
60,Fail,52,33,2,13,39
60,Fail,51,37,0,10,41
60,Fail,47,34,10,9,38
60,Fail,45,35,3,17,28
60,Fail,38,36,6,20,18
60,Fail,47,36,0,15,32
60,Fail,48,35,1,16,32
60,Fail,46,37,6,11,35
60,Fail,58,31,0,10,48
60,Fail,50,36,0,14,36
60,Fail,59,28,2,11,48
60,Fail,53,34,0,13,40
60,Fail,45,44,0,9,36
60,Fail,48,36,3,13,35
60,Fail,51,38,0,7,44
60,Fail,44,38,0,16,28
60,Fail,49,36,3,12,37
60,Fail,42,40,5,13,29
60,Fail,53,35,0,5,48
60,Fail,59,34,1,6,53
60,Fail,51,35,6,8,43
60,Fail,51,35,1,13,38
60,Fail,48,39,0,13,35
60,Fail,45,34,0,17,28
60,Fail,45,35,4,16,29
60,Fail,47,33,4,16,31
60,Fail,54,33,0,13,41
60,Fail,50,34,2,14,36
60,Fail,46,43,6,5,41
60,Fail,53,32,0,13,40
60,Fail,38,47,0,11,27
60,Fail,53,35,0,10,43
60,Fail,53,36,0,10,43
60,Fail,46,42,0,12,34
60,Fail,49,31,0,14,35
60,Fail,51,39,0,5,46
60,Fail,49,33,0,16,33
60,Fail,50,35,3,12,38
60,Fail,58,32,0,10,48
60,Fail,52,34,3,11,41
60,Fail,46,34,0,11,35
60,Fail,47,35,5,13,34
60,Fail,49,32,0,11,38
60,Fail,42,45,0,12,30
60,Fail,45,37,0,17,28
60,Fail,51,36,3,10,41
60,Fail,52,30,1,17,35
60,Fail,44,28,12,16,28
60,Fail,50,32,1,17,33
60,Fail,48,34,5,13,35
60,Fail,57,30,0,13,44
60,Fail,53,33,0,12,41
60,Fail,51,32,0,11,40
60,Fail,39,29,0,20,19
60,Fail,58,28,0,11,47
60,Fail,41,42,4,13,28
60,Fail,41,43,0,14,27
60,Fail,45,38,2,15,30
60,Fail,51,28,7,14,37
60,Fail,43,38,5,14,29
60,Fail,48,35,1,16,32
60,Fail,54,32,3,11,43
60,Fail,44,36,0,16,28
60,Fail,54,35,0,11,43
60,Fail,50,37,0,9,41
60,Fail,49,30,3,18,31
60,Fail,51,36,2,11,40
60,Fail,48,38,0,11,37
60,Fail,50,38,0,10,40
60,Fail,49,27,0,13,36
60,Fail,46,36,3,15,31
60,Fail,53,39,0,6,47
60,Fail,54,35,3,8,46
60,Fail,50,37,0,11,39
60,Fail,56,35,1,8,48
60,Fail,53,29,12,6,47
60,Fail,50,34,0,11,39
60,Fail,46,36,5,13,33
60,Fail,51,42,0,6,45
60,Fail,44,39,0,14,30
60,Fail,46,41,3,10,36
60,Fail,44,38,0,12,32
60,Fail,48,31,0,11,37
60,Fail,44,44,1,11,33
60,Fail,40,29,13,18,22
60,Fail,53,33,2,12,41
60,Fail,39,34,13,14,25
60,Fail,48,32,7,13,35
60,Fail,36,29,15,20,16
60,Fail,50,36,0,13,37
60,Fail,48,41,0,11,37
60,Fail,43,30,11,16,27
60,Fail,49,32,7,12,37
60,Fail,48,25,0,15,33
60,Fail,55,37,0,5,50
60,Fail,51,30,0,12,39
60,Fail,57,31,1,11,46
60,Fail,41,37,0,14,27
60,Fail,54,33,0,11,43
60,Fail,54,36,0,9,45
60,Fail,52,28,6,14,38
60,Fail,47,40,5,8,39
60,Fail,51,31,3,15,36
60,Fail,44,37,0,13,31
60,Fail,53,33,4,10,43
60,Fail,45,42,0,12,33
60,Fail,44,38,0,13,31
60,Fail,50,37,0,13,37
60,Fail,42,40,0,15,27
60,Fail,48,36,0,11,37
60,Fail,44,39,0,15,29
60,Fail,49,35,4,12,37
60,Fail,52,35,0,8,44
60,Fail,38,41,0,13,25
60,Fail,41,34,13,12,29
60,Fail,51,34,2,13,38
60,Fail,50,35,0,10,40
60,Fail,48,39,2,11,37
60,Fail,43,39,0,10,33
60,Fail,46,40,3,11,35
60,Fail,47,43,1,9,38
60,Fail,38,48,0,10,28
60,Fail,47,35,10,8,39
60,Fail,51,30,2,17,34
60,Fail,55,33,0,9,46
60,Fail,41,41,3,15,26
60,Fail,45,39,5,11,34
60,Fail,41,39,4,16,25
60,Fail,51,31,0,13,38
60,Fail,46,31,0,13,33
60,Fail,48,32,0,14,34
60,Fail,50,38,0,10,40
60,Fail,55,29,7,9,46
60,Fail,47,38,0,9,38
60,Fail,47,38,0,10,37
60,Fail,52,31,0,16,36
60,Fail,49,35,2,14,35
60,Fail,47,35,7,11,36
60,Fail,50,34,0,12,38
60,Fail,51,36,1,12,39
60,Fail,56,34,0,10,46
60,Fail,44,42,0,13,31
60,Fail,48,40,1,11,37
60,Fail,53,33,0,13,40
60,Fail,40,36,13,11,29
60,Fail,45,41,0,12,33
60,Fail,44,38,0,13,31
60,Fail,42,38,0,18,24
60,Fail,53,31,2,14,39
60,Fail,52,32,0,15,37
60,Fail,42,33,11,14,28
60,Fail,54,31,2,13,41
60,Fail,49,29,10,12,37
60,Fail,42,42,4,12,30
60,Fail,43,40,0,13,30
60,Fail,44,39,8,9,35
60,Fail,56,34,0,8,48
60,Fail,49,35,0,14,35
60,Fail,42,37,0,17,25
60,Fail,45,40,0,14,31
60,Fail,51,34,3,12,39
60,Fail,47,33,8,12,35
60,Fail,43,40,5,12,31
60,Fail,44,34,11,11,33
60,Fail,50,42,2,6,44
60,Fail,48,32,6,14,34
60,Fail,45,36,0,16,29
60,Fail,41,38,0,10,31
60,Fail,45,40,4,11,34
60,Fail,45,41,3,11,34
60,Fail,46,39,0,15,31
60,Fail,49,32,0,15,34
60,Fail,45,37,0,14,31
60,Fail,50,33,0,16,34
60,Fail,48,36,0,14,34
60,Fail,54,28,1,17,37
60,Fail,50,31,4,15,35
60,Fail,55,29,5,11,44
60,Fail,47,39,0,8,39
60,Fail,52,31,0,16,36
60,Fail,44,39,0,13,31
60,Fail,58,28,5,9,49
60,Fail,41,41,0,18,23
60,Fail,51,37,0,12,39
60,Fail,40,41,0,16,24
60,Fail,53,32,0,8,45
60,Fail,48,37,2,13,35
60,Fail,44,39,0,12,32
60,Fail,48,29,0,14,34
60,Fail,42,42,1,15,27
60,Fail,48,34,9,9,39
60,Fail,49,31,8,12,37
60,Fail,40,38,0,13,27
60,Fail,54,33,0,9,45
60,Fail,49,38,0,7,42
60,Fail,52,32,1,15,37
60,Fail,50,37,3,10,40
60,Fail,43,38,2,17,26
60,Fail,49,34,0,14,35
60,Fail,44,43,0,12,32
60,Fail,51,34,0,11,40
60,Fail,51,36,5,8,43
60,Fail,50,47,0,3,47
60,Fail,51,39,0,7,44
60,Fail,41,39,0,16,25
60,Fail,41,40,0,15,26
60,Fail,49,28,0,18,31
60,Fail,51,34,2,13,38
60,Fail,43,33,0,20,23
60,Fail,46,41,0,10,36
60,Fail,46,41,2,11,35
60,Fail,47,33,0,10,37
60,Fail,44,37,2,17,27
60,Fail,46,37,0,10,36
60,Fail,46,30,0,18,28
60,Fail,45,40,0,15,30
60,Fail,45,42,3,10,35
60,Fail,54,37,0,8,46
60,Fail,47,34,0,16,31
60,Fail,52,37,0,7,45
60,Fail,45,39,0,15,30
60,Fail,53,39,0,7,46
60,Fail,45,39,2,14,31
60,Fail,50,34,6,10,40
60,Fail,55,35,0,7,48
60,Fail,42,47,1,10,32
60,Fail,48,32,0,16,32
60,Fail,50,37,0,12,38
60,Fail,44,35,9,12,32
60,Fail,52,33,6,9,43
60,Fail,43,38,4,15,28
60,Fail,44,35,0,13,31
60,Fail,55,34,1,10,45
60,Fail,51,26,5,18,33
60,Fail,52,36,0,11,41
60,Fail,46,37,6,11,35
60,Fail,54,31,1,14,40
60,Fail,43,32,0,22,21
60,Fail,46,36,0,17,29
60,Fail,52,34,0,10,42
60,Fail,46,35,0,15,31
60,Fail,45,35,0,11,34
60,Fail,44,42,1,13,31
60,Fail,47,29,0,19,28
60,Fail,44,39,0,11,33
60,Fail,41,36,0,14,27
60,Fail,44,39,0,14,30
60,Fail,49,34,0,13,36
60,Fail,44,34,6,16,28
60,Fail,51,37,0,11,40
60,Fail,44,40,0,13,31
60,Fail,45,41,0,14,31
60,Fail,49,36,0,14,35
60,Fail,49,42,0,9,40
60,Fail,47,33,0,16,31
60,Fail,47,34,0,16,31
60,Fail,41,40,0,13,28
60,Fail,40,41,0,14,26
60,Fail,51,34,0,13,38
60,Fail,49,27,0,17,32
60,Fail,45,32,1,22,23
60,Fail,49,34,2,15,34
60,Fail,46,36,0,14,32
60,Fail,50,41,0,8,42
60,Fail,45,40,0,13,32
60,Fail,49,38,0,8,41
60,Fail,47,35,7,11,36
60,Fail,53,33,0,7,46
60,Fail,47,37,0,11,36
60,Fail,47,43,1,9,38
60,Fail,45,26,0,8,37
60,Fail,44,33,0,17,27
60,Fail,46,40,0,11,35
60,Fail,49,35,2,14,35
60,Fail,47,37,2,14,33
60,Fail,45,36,8,11,34
60,Fail,54,25,6,15,39
60,Fail,47,36,0,7,40
60,Fail,47,40,0,13,34
60,Fail,41,28,0,19,22
60,Fail,48,33,0,16,32
60,Fail,51,34,0,14,37
60,Fail,54,37,1,8,46
60,Fail,52,36,0,8,44
60,Fail,42,40,3,15,27
60,Fail,48,38,0,12,36
60,Fail,44,38,0,17,27
60,Fail,50,32,8,10,40
60,Fail,50,31,2,17,33
60,Fail,40,45,3,12,28
60,Fail,49,34,9,8,41
60,Fail,48,35,0,9,39
60,Fail,51,33,3,13,38
60,Fail,52,32,7,9,43
60,Fail,56,35,2,7,49
60,Fail,50,36,6,8,42
60,Fail,50,42,1,7,43
60,Fail,45,34,7,14,31
60,Fail,41,40,4,15,26
60,Fail,42,38,9,11,31
60,Fail,44,39,0,15,29
60,Fail,46,31,0,19,27
60,Fail,46,33,0,15,31
60,Fail,51,29,3,17,34
60,Fail,40,38,5,17,23
60,Fail,46,38,5,11,35
60,Fail,44,40,3,13,31
60,Fail,51,24,0,18,33
60,Fail,54,34,0,10,44
60,Fail,55,32,3,10,45
60,Fail,48,41,1,10,38
60,Fail,50,38,0,8,42
60,Fail,45,42,1,12,33
60,Fail,48,30,0,12,36
60,Fail,45,40,4,11,34
60,Fail,47,33,0,12,35
60,Fail,47,36,4,13,34
60,Fail,48,39,0,11,37
60,Fail,49,24,4,23,26
60,Fail,44,36,0,12,32
60,Fail,55,27,0,11,44
60,Fail,53,34,0,10,43
60,Fail,46,41,0,11,35
60,Fail,50,43,0,5,45
60,Fail,43,37,4,16,27
60,Fail,48,32,3,17,31
60,Fail,53,33,0,13,40
60,Fail,47,36,0,14,33
60,Fail,46,38,0,14,32
60,Fail,43,43,0,12,31
60,Fail,42,38,0,16,26
60,Fail,46,40,6,8,38
60,Fail,39,35,0,15,24
60,Fail,45,38,3,14,31
60,Fail,44,39,1,16,28
60,Fail,46,38,2,14,32
60,Fail,42,36,0,19,23
60,Fail,41,46,0,13,28
60,Fail,46,36,3,15,31
60,Fail,45,38,0,14,31
60,Fail,37,40,0,14,23
60,Fail,53,35,0,12,41
60,Fail,45,40,0,14,31
60,Fail,57,33,0,5,52
60,Fail,47,40,1,12,35
60,Fail,50,36,0,14,36
60,Fail,45,37,6,12,33
60,Fail,37,47,0,12,25
60,Fail,48,37,4,11,37
60,Fail,51,30,0,14,37
60,Fail,49,38,0,13,36
60,Fail,39,42,0,13,26
60,Fail,53,38,0,7,46
60,Fail,54,31,3,12,42
60,Fail,44,39,0,16,28
60,Fail,43,34,0,17,26
60,Fail,48,38,4,10,38
60,Fail,41,44,1,14,27
60,Fail,47,39,0,9,38
60,Fail,53,28,9,10,43
60,Fail,43,35,0,15,28
60,Fail,51,33,7,9,42
60,Fail,52,32,1,15,37
60,Fail,48,34,0,18,30
60,Fail,51,34,4,11,40
60,Fail,33,41,10,16,17
60,Fail,53,33,0,11,42
60,Fail,51,26,0,19,32
60,Fail,50,33,0,15,35
60,Fail,43,39,0,11,32
60,Fail,48,39,1,12,36
60,Fail,48,35,3,14,34
60,Fail,55,26,0,12,43
60,Fail,45,36,2,17,28
60,Fail,48,36,0,13,35
60,Fail,52,30,5,13,39
60,Fail,40,40,0,16,24
60,Fail,51,33,7,9,42
60,Fail,47,30,9,14,33
60,Fail,53,33,0,13,40
60,Fail,54,34,0,12,42
60,Fail,44,39,2,15,29
60,Fail,51,34,2,13,38
60,Fail,43,33,0,19,24
60,Fail,58,30,0,12,46
60,Fail,44,42,2,12,32
60,Fail,52,33,0,10,42
60,Fail,60,31,0,9,51
60,Fail,58,29,0,13,45
60,Fail,45,41,0,12,33
60,Fail,41,43,5,11,30
60,Fail,49,40,1,10,39
60,Fail,42,37,4,17,25
60,Fail,45,32,0,22,23
60,Fail,46,37,0,16,30
60,Fail,49,39,0,10,39
60,Fail,54,35,0,11,43
60,Fail,53,35,2,10,43
60,Fail,50,30,0,14,36
60,Fail,44,36,0,16,28
60,Fail,53,32,0,13,40
60,Fail,54,35,3,8,46
60,Fail,47,39,0,12,35
60,Fail,48,37,0,15,33
60,Fail,44,38,0,16,28
60,Fail,44,37,8,11,33
60,Fail,39,43,6,12,27
60,Fail,53,30,0,14,39
60,Fail,44,37,0,18,26
60,Fail,43,39,0,16,27
60,Fail,46,40,0,13,33
60,Fail,48,36,1,15,33
60,Fail,47,32,0,15,32
60,Fail,49,38,0,13,36
60,Fail,57,35,2,6,51
60,Fail,52,33,3,12,40
60,Fail,54,37,2,7,47
60,Fail,42,42,3,13,29
60,Fail,40,36,11,13,27
60,Fail,48,32,3,17,31
60,Fail,54,33,2,11,43
60,Fail,50,37,1,12,38
60,Fail,50,35,0,13,37
60,Fail,47,29,1,23,24
60,Fail,54,38,0,8,46
60,Fail,51,36,0,10,41
60,Fail,48,34,7,11,37
60,Fail,42,46,5,7,35
60,Fail,43,44,3,10,33
60,Fail,47,33,0,15,32
60,Fail,49,37,0,12,37
60,Fail,46,40,4,10,36
60,Fail,50,32,0,15,35
60,Fail,52,29,0,15,37
60,Fail,41,37,0,15,26
60,Fail,47,36,1,16,31
60,Fail,47,36,0,12,35
60,Fail,55,32,0,11,44
60,Fail,52,40,0,6,46
60,Fail,47,38,0,10,37
60,Fail,49,35,0,16,33
60,Fail,42,38,6,14,28
60,Fail,45,33,3,19,26
60,Fail,50,36,0,14,36
60,Fail,49,39,1,11,38
60,Fail,48,34,6,12,36
60,Fail,44,36,2,18,26
60,Fail,51,35,3,11,40
60,Fail,44,46,0,8,36
60,Fail,45,34,0,16,29
60,Fail,47,43,0,8,39
60,Fail,45,33,0,18,27
60,Fail,48,35,0,17,31
60,Fail,40,45,0,15,25
60,Fail,44,40,1,15,29
60,Fail,49,38,0,12,37
60,Fail,47,43,0,7,40
60,Fail,43,35,0,18,25
60,Fail,44,37,9,10,34
60,Fail,44,28,7,21,23
60,Fail,49,32,0,15,34
60,Fail,52,36,0,11,41
60,Fail,42,39,6,13,29
60,Fail,55,35,0,6,49
60,Fail,46,39,0,12,34
60,Fail,53,41,0,6,47
60,Fail,48,43,2,7,41
60,Fail,50,35,0,10,40
60,Fail,47,33,9,11,36
60,Fail,49,41,0,10,39
60,Fail,50,43,0,5,45
60,Fail,41,40,4,15,26
60,Fail,56,24,5,15,41
60,Fail,40,42,3,15,25
60,Fail,37,38,0,16,21
60,Fail,50,32,0,17,33
60,Fail,48,36,0,13,35
60,Fail,46,42,1,11,35
60,Fail,47,37,1,15,32
60,Fail,45,38,0,16,29
60,Fail,46,35,0,11,35
60,Fail,56,28,0,11,45
60,Fail,45,40,1,14,31
60,Fail,51,31,4,14,37
60,Fail,54,37,6,3,51
60,Fail,44,39,0,14,30
60,Fail,53,37,2,8,45
60,Fail,49,36,3,12,37
60,Fail,51,37,3,9,42
60,Fail,53,29,0,14,39
60,Fail,39,45,3,13,26
60,Fail,43,39,0,16,27
60,Fail,43,41,0,12,31
60,Fail,44,33,0,15,29
60,Fail,44,36,7,13,31
60,Fail,45,34,4,17,28
60,Fail,47,38,4,11,36
60,Fail,39,40,4,17,22
60,Fail,48,37,8,7,41
60,Fail,46,40,4,10,36
60,Fail,55,32,2,11,44
60,Fail,50,28,8,14,36
60,Fail,49,38,0,12,37
60,Fail,42,40,2,16,26
60,Fail,47,34,5,14,33
60,Fail,53,37,0,7,46
60,Fail,48,32,8,12,36
60,Fail,46,30,9,15,31
60,Fail,54,30,4,12,42
60,Fail,50,39,0,10,40
60,Fail,47,35,0,13,34
60,Fail,46,38,0,13,33
60,Fail,39,42,0,14,25
60,Fail,55,35,0,10,45
60,Fail,53,37,0,7,46
60,Fail,49,34,0,12,37
60,Fail,48,36,2,14,34
60,Fail,53,31,5,11,42
60,Fail,50,33,3,14,36
60,Fail,51,30,0,16,35
60,Fail,53,34,0,11,42
60,Fail,47,33,4,16,31
60,Fail,56,29,1,14,42
60,Fail,50,30,10,10,40
60,Fail,52,33,2,13,39
60,Fail,45,36,6,13,32
60,Fail,54,30,3,13,41
60,Fail,44,40,0,15,29
60,Fail,42,35,8,15,27
60,Fail,48,36,0,10,38
60,Fail,57,32,0,11,46
60,Fail,43,39,1,17,26
60,Fail,47,32,10,11,36
60,Fail,49,41,2,8,41
60,Fail,50,35,0,15,35
60,Fail,47,36,3,14,33
60,Fail,48,34,0,12,36
60,Fail,45,41,0,14,31
60,Fail,49,42,0,8,41
60,Fail,47,36,5,12,35
60,Fail,46,40,0,7,39
60,Fail,54,30,0,15,39
60,Fail,41,42,0,15,26
60,Fail,54,27,0,19,35
60,Fail,49,35,1,15,34
60,Fail,51,31,6,12,39
60,Fail,43,36,2,19,24
60,Fail,48,35,6,11,37
60,Fail,47,37,0,11,36
60,Fail,47,36,0,12,35
60,Fail,51,34,0,9,42
60,Fail,44,40,2,14,30
60,Fail,40,39,0,13,27
60,Fail,44,38,4,14,30
60,Fail,46,35,0,12,34
60,Fail,47,43,1,9,38
60,Fail,55,29,0,11,44
60,Fail,51,36,0,9,42
60,Fail,49,43,0,6,43
60,Fail,46,32,6,16,30
60,Fail,47,36,2,15,32
60,Fail,48,39,2,11,37
60,Fail,48,40,2,10,38
60,Fail,47,35,4,14,33
60,Fail,53,32,0,13,40
60,Fail,45,37,5,13,32
60,Fail,49,41,0,7,42
60,Fail,50,33,9,8,42
60,Fail,42,39,4,15,27
60,Fail,51,32,0,16,35
60,Fail,47,39,0,14,33
60,Fail,50,34,2,14,36
60,Fail,52,32,0,11,41
60,Fail,51,33,0,13,38
60,Fail,46,37,8,9,37
60,Fail,56,33,0,10,46
60,Fail,49,32,0,14,35
60,Fail,41,38,10,11,30
60,Fail,52,31,2,15,37
60,Fail,41,37,0,15,26
60,Fail,45,37,4,14,31
60,Fail,46,39,0,11,35
60,Fail,46,43,0,11,35
60,Fail,44,44,0,9,35
60,Fail,53,27,9,11,42
60,Fail,52,32,5,11,41
60,Fail,51,36,0,11,40
60,Fail,51,34,2,13,38
60,Fail,47,40,0,5,42
60,Fail,44,40,7,9,35
60,Fail,54,32,0,12,42
60,Fail,44,30,9,17,27
60,Fail,49,41,0,9,40
60,Fail,49,36,0,11,38
60,Fail,39,45,0,12,27
60,Fail,49,31,1,19,30
60,Fail,41,38,6,15,26
60,Fail,51,32,0,16,35
60,Fail,58,35,1,6,52
60,Fail,54,29,3,14,40
60,Fail,47,40,2,11,36
60,Fail,56,32,0,11,45
60,Fail,56,33,0,8,48
60,Fail,43,37,0,11,32
60,Fail,42,41,0,12,30
60,Fail,51,34,6,9,42
60,Fail,52,31,0,14,38
60,Fail,48,37,0,14,34
60,Fail,53,40,0,7,46
60,Fail,47,35,6,12,35
60,Fail,54,34,1,11,43
60,Fail,54,39,0,6,48
60,Fail,51,33,0,13,38
60,Fail,44,33,7,16,28
60,Fail,45,41,0,14,31
60,Fail,53,33,0,13,40
60,Fail,54,30,0,14,40
60,Fail,50,30,0,13,37
60,Fail,48,42,0,10,38
60,Fail,56,27,4,13,43
60,Fail,44,41,1,14,30
60,Fail,50,27,13,10,40
60,Fail,39,34,0,20,19
60,Fail,44,28,0,17,27
60,Fail,49,39,0,10,39
60,Fail,41,43,0,15,26
60,Fail,50,32,0,16,34
60,Fail,44,32,10,14,30
60,Fail,48,37,5,10,38
60,Fail,48,34,7,11,37
60,Fail,47,31,0,20,27
60,Fail,47,39,5,9,38
60,Fail,44,35,3,18,26
60,Fail,52,37,1,10,42
60,Fail,46,33,6,15,31
60,Fail,47,32,0,17,30
60,Fail,48,38,4,10,38
60,Fail,51,34,2,13,38
60,Fail,52,38,0,8,44
60,Fail,42,41,0,15,27
60,Fail,44,43,2,11,33
60,Fail,54,30,0,11,43
60,Fail,47,35,0,13,34
60,Fail,43,37,6,14,29
60,Fail,50,26,6,18,32
60,Fail,39,44,0,17,22
60,Fail,51,39,0,10,41
60,Fail,39,40,3,18,21
60,Fail,42,36,0,13,29
60,Fail,52,36,4,8,44
60,Fail,55,30,0,15,40
60,Fail,49,43,0,7,42
60,Fail,40,46,1,13,27
60,Fail,51,38,0,11,40
60,Fail,45,42,1,12,33
60,Fail,47,29,2,22,25
60,Fail,53,37,2,8,45
60,Fail,45,40,4,11,34
60,Fail,53,36,0,9,44
60,Fail,50,33,0,14,36
60,Fail,54,33,0,11,43
60,Fail,47,31,0,14,33
60,Fail,44,39,0,11,33
60,Fail,47,28,12,13,34
60,Fail,50,34,0,16,34
60,Fail,46,37,3,14,32
60,Fail,49,32,6,13,36
60,Fail,49,32,0,15,34
60,Fail,35,33,11,21,14
60,Fail,39,42,5,14,25
60,Fail,51,29,0,11,40
60,Fail,47,37,0,10,37
60,Fail,47,37,3,13,34
60,Fail,48,25,0,17,31
60,Fail,43,39,3,15,28
60,Fail,40,33,0,17,23
60,Fail,50,37,0,10,40
60,Fail,50,35,0,15,35
60,Fail,60,27,0,10,50
60,Fail,48,40,1,11,37
60,Fail,39,39,0,18,21
60,Fail,43,41,0,11,32
60,Fail,43,34,8,15,28
60,Fail,47,37,0,16,31
60,Fail,54,32,9,5,49
60,Fail,39,44,6,11,28
60,Fail,52,39,0,9,43
60,Fail,53,30,5,12,41
60,Fail,57,38,0,5,52
60,Fail,47,44,0,6,41
60,Fail,57,34,1,8,49
60,Fail,43,41,2,14,29
60,Fail,43,36,0,13,30
60,Fail,45,39,0,15,30
60,Fail,48,40,2,10,38
60,Fail,46,37,0,13,33
60,Fail,37,44,5,14,23
60,Fail,48,31,0,15,33
60,Fail,45,32,0,11,34
60,Fail,48,34,0,15,33
60,Fail,49,30,0,20,29
60,Fail,45,40,0,13,32
60,Fail,41,44,5,10,31
60,Fail,47,38,0,15,32
60,Fail,47,39,0,12,35
60,Fail,37,48,0,13,24
60,Fail,52,36,2,10,42
60,Fail,52,35,0,7,45
60,Fail,41,33,16,10,31
60,Fail,46,43,1,10,36
60,Fail,47,37,0,16,31
60,Fail,44,32,9,15,29
60,Fail,53,34,0,11,42
60,Fail,49,34,0,17,32
60,Fail,55,36,1,8,47
60,Fail,43,37,5,15,28
60,Fail,43,38,0,14,29
60,Fail,43,36,0,14,29
60,Fail,41,52,0,5,36
60,Fail,47,34,0,13,34
60,Fail,42,32,12,14,28
60,Fail,49,35,0,14,35
60,Fail,49,30,11,10,39
60,Fail,46,42,2,10,36
60,Fail,38,38,9,15,23
60,Fail,47,34,3,16,31
60,Fail,42,42,0,9,33
60,Fail,44,34,10,12,32
60,Fail,42,31,8,19,23
60,Fail,49,40,1,10,39
60,Fail,49,34,6,11,38
60,Fail,57,24,13,6,51
60,Fail,51,34,3,12,39
60,Fail,52,32,0,12,40
60,Fail,47,36,0,14,33
60,Fail,53,35,1,11,42
60,Fail,50,34,0,13,37
60,Fail,45,43,0,11,34
60,Fail,46,36,0,16,30
60,Fail,44,35,0,15,29
60,Fail,48,34,4,14,34
60,Fail,45,37,0,8,37
60,Fail,45,33,0,11,34
60,Fail,48,33,0,14,34
60,Fail,46,39,0,12,34
60,Fail,55,29,0,9,46
60,Fail,52,37,0,11,41
60,Fail,53,32,4,11,42
60,Fail,40,31,0,18,22
60,Fail,46,40,5,9,37
60,Fail,47,38,2,13,34
60,Fail,53,35,1,11,42
60,Fail,64,22,1,13,51
60,Fail,53,33,0,13,40
60,Fail,46,35,7,12,34
60,Fail,48,33,8,11,37
60,Fail,46,34,0,17,29
60,Fail,48,38,3,11,37
60,Fail,49,39,1,11,38
60,Fail,52,34,3,11,41
60,Fail,45,34,0,15,30
60,Fail,43,38,0,17,26
60,Fail,45,36,2,17,28
60,Fail,45,41,0,12,33
60,Fail,41,45,0,12,29
60,Fail,41,30,0,23,18
60,Fail,54,38,0,8,46
60,Fail,47,32,0,18,29
60,Fail,51,31,0,14,37
60,Fail,60,29,1,10,50
60,Fail,47,32,4,17,30
60,Fail,46,40,0,13,33
60,Fail,48,39,1,12,36
60,Fail,45,34,11,10,35
60,Fail,53,33,0,10,43
60,Fail,52,34,0,14,38
60,Fail,53,34,2,11,42
60,Fail,47,38,2,13,34
60,Fail,53,30,0,16,37
60,Fail,48,41,1,10,38
60,Fail,46,37,0,14,32
60,Fail,46,40,0,11,35
60,Fail,51,33,0,12,39
60,Fail,54,36,1,9,45
60,Fail,42,36,4,18,24
60,Fail,47,41,0,12,35
60,Fail,49,35,0,15,34
60,Fail,51,31,8,10,41
60,Fail,58,28,8,6,52
60,Fail,48,35,0,9,39
60,Fail,61,30,0,9,52
60,Fail,46,33,0,13,33
60,Fail,49,39,0,8,41
60,Fail,55,30,2,13,42
60,Fail,44,39,0,10,34
60,Fail,50,37,0,8,42
60,Fail,47,31,0,11,36
60,Fail,47,36,3,14,33
60,Fail,42,41,5,12,30
60,Fail,46,34,8,12,34
60,Fail,53,35,0,10,43
60,Fail,44,38,5,13,31
60,Fail,47,33,11,9,38
60,Fail,53,38,0,8,45
60,Fail,48,38,0,12,36
60,Fail,45,40,1,14,31
60,Fail,58,28,4,10,48
60,Fail,41,43,0,12,29
60,Fail,38,46,0,11,27
60,Fail,47,40,0,13,34
60,Fail,56,30,0,10,46
60,Fail,53,33,0,12,41
60,Fail,49,36,1,14,35
60,Fail,42,44,0,13,29
60,Fail,52,32,5,11,41
60,Fail,42,34,6,18,24
60,Fail,53,33,3,11,42
60,Fail,39,37,0,13,26
60,Fail,39,39,0,22,17
60,Fail,53,33,3,11,42
60,Fail,46,45,0,9,37
60,Fail,46,34,0,11,35
60,Fail,53,30,0,15,38
60,Fail,46,34,0,17,29
60,Fail,52,34,3,11,41
60,Fail,50,39,0,10,40
60,Fail,49,42,1,8,41
60,Fail,51,30,0,14,37
60,Fail,45,35,0,14,31
60,Fail,45,35,0,15,30
60,Fail,50,36,0,14,36
60,Fail,45,38,6,11,34
60,Fail,52,34,1,13,39
60,Fail,46,42,0,12,34
60,Fail,43,37,4,16,27
60,Fail,41,34,10,15,26
60,Fail,42,35,9,14,28
60,Fail,38,37,1,24,14
60,Fail,58,29,0,13,45
60,Fail,58,31,1,10,48
60,Fail,51,36,4,9,42
60,Fail,47,35,4,14,33
60,Fail,42,43,0,11,31
60,Fail,48,34,0,15,33
60,Fail,49,30,7,14,35
60,Fail,50,35,0,12,38
60,Fail,50,33,0,11,39
60,Fail,47,35,0,15,32
60,Fail,50,37,0,13,37
60,Fail,59,28,0,12,47
60,Fail,49,29,7,15,34
60,Fail,49,37,0,11,38
60,Fail,48,36,5,11,37
60,Fail,46,45,0,9,37
60,Fail,48,31,5,16,32
60,Fail,49,34,4,13,36
60,Fail,50,33,0,12,38
60,Fail,47,37,3,13,34
60,Fail,51,30,0,12,39
60,Fail,46,34,0,15,31
60,Fail,53,32,2,13,40
60,Fail,44,30,12,14,30
60,Fail,43,41,0,16,27
60,Fail,50,36,0,10,40
60,Fail,48,36,2,14,34
60,Fail,52,35,1,12,40
60,Fail,41,37,0,15,26
60,Fail,53,33,1,13,40
60,Fail,48,30,0,11,37
60,Fail,48,31,5,16,32
60,Fail,54,29,2,15,39
60,Fail,50,36,1,13,37
60,Fail,53,39,0,8,45
60,Fail,53,32,0,14,39
60,Fail,46,36,0,13,33
60,Fail,45,41,1,13,32
60,Fail,46,40,0,8,38
60,Fail,49,29,4,18,31
60,Fail,50,33,12,5,45
60,Fail,46,46,1,7,39
60,Fail,51,30,2,17,34
60,Fail,51,35,0,13,38
60,Fail,49,35,0,10,39
60,Fail,46,40,0,11,35
60,Fail,41,36,13,10,31
60,Fail,53,34,0,13,40
60,Fail,46,38,0,14,32
60,Fail,47,38,0,14,33
60,Fail,53,34,1,12,41
60,Fail,46,40,3,11,35
60,Fail,45,37,0,10,35
60,Fail,48,39,2,11,37
60,Fail,37,35,16,12,25
60,Fail,52,33,0,9,43
60,Fail,41,48,2,9,32
60,Fail,49,31,4,16,33
60,Fail,51,37,1,11,40
60,Fail,50,36,2,12,38
60,Fail,53,33,3,11,42
60,Fail,37,41,4,18,19
60,Fail,51,34,2,13,38
60,Fail,44,34,13,9,35
60,Fail,47,29,12,12,35
60,Fail,46,41,0,12,34
60,Fail,49,32,0,17,32
60,Fail,52,29,1,18,34
60,Fail,46,35,9,10,36
60,Fail,44,37,5,14,30
60,Fail,39,39,11,11,28
60,Fail,47,39,0,12,35
60,Fail,51,36,0,13,38
60,Fail,42,39,0,18,24
60,Fail,46,31,0,16,30
60,Fail,50,31,4,15,35
60,Fail,40,39,6,15,25
60,Fail,47,41,2,10,37
60,Fail,44,38,0,11,33
60,Fail,57,32,3,8,49
60,Fail,47,30,5,18,29
60,Fail,53,34,4,9,44
60,Fail,49,33,0,8,41
60,Fail,50,35,6,9,41
60,Fail,52,33,0,11,41
60,Fail,55,31,0,10,45
60,Fail,54,34,0,12,42
60,Fail,50,29,0,16,34
60,Fail,48,31,2,19,29
60,Fail,39,49,4,8,31
60,Fail,37,34,10,19,18
60,Fail,48,35,1,16,32
60,Fail,44,29,7,20,24
60,Fail,46,39,1,14,32
60,Fail,45,35,0,15,30
60,Fail,47,35,1,17,30
60,Fail,46,41,0,13,33
60,Fail,47,39,0,14,33
60,Fail,45,42,3,10,35
60,Fail,51,37,0,12,39
60,Fail,49,34,0,14,35
60,Fail,51,33,0,15,36
60,Fail,49,37,4,10,39
60,Fail,43,42,0,10,33
60,Fail,48,35,3,14,34
60,Fail,39,38,0,16,23
60,Fail,57,29,7,7,50
60,Fail,50,41,1,8,42
60,Fail,53,30,0,16,37
60,Fail,52,37,1,10,42
60,Fail,52,29,1,18,34
60,Fail,51,34,0,12,39
60,Fail,56,26,0,9,47
60,Fail,49,35,0,14,35
60,Fail,57,30,1,12,45
60,Fail,47,30,5,18,29
60,Fail,52,36,1,11,41
60,Fail,48,35,1,16,32
60,Fail,45,35,0,14,31
60,Fail,50,34,3,13,37
60,Fail,49,39,1,11,38
60,Fail,43,37,10,10,33
60,Fail,53,33,0,11,42
60,Fail,55,36,0,9,46
60,Fail,53,33,2,12,41
60,Fail,55,36,0,6,49
60,Fail,36,38,0,16,20
60,Fail,44,35,0,13,31
60,Fail,48,34,0,18,30
60,Fail,44,38,3,15,29
60,Fail,51,36,2,11,40
60,Fail,45,45,1,9,36
60,Fail,57,21,0,11,46
60,Fail,44,36,9,11,33
60,Fail,46,30,10,14,32
60,Fail,51,38,2,9,42
60,Fail,48,31,9,12,36
60,Fail,57,33,0,9,48
60,Fail,48,39,0,13,35
60,Fail,46,35,0,11,35
60,Fail,43,39,0,16,27
60,Fail,52,32,8,8,44
60,Fail,46,38,0,14,32
60,Fail,47,41,0,11,36
60,Fail,49,33,7,11,38
60,Fail,50,37,2,11,39
60,Fail,44,42,1,13,31
60,Fail,44,34,0,15,29
60,Fail,43,33,0,17,26
60,Fail,48,41,1,10,38
60,Fail,45,36,6,13,32
60,Fail,47,46,1,6,41
60,Fail,47,48,0,5,42
60,Fail,58,30,0,12,46
60,Fail,53,37,0,8,45
60,Fail,43,39,0,14,29
60,Fail,46,32,0,14,32
60,Fail,47,33,10,10,37
60,Fail,50,34,0,13,37
60,Fail,46,33,0,14,32
60,Fail,46,40,0,12,34
60,Fail,42,38,0,12,30
60,Fail,47,38,4,11,36
60,Fail,49,31,2,18,31
60,Fail,52,21,4,23,29
60,Fail,53,29,4,14,39
60,Fail,50,32,1,17,33
60,Fail,34,36,13,17,17
60,Fail,49,38,2,11,38
60,Fail,47,35,0,13,34
60,Fail,48,43,0,9,39
60,Fail,52,35,0,10,42
60,Fail,52,33,0,15,37
60,Fail,46,35,0,16,30
60,Fail,39,38,0,17,22
60,Fail,44,33,5,18,26
60,Fail,50,30,0,14,36
60,Fail,47,40,0,13,34
60,Fail,50,38,0,11,39
60,Fail,48,38,4,10,38
60,Fail,51,40,2,7,44
60,Fail,50,32,1,17,33
60,Fail,49,39,0,11,38
60,Fail,50,37,0,10,40
60,Fail,51,40,0,7,44
60,Fail,51,37,5,7,44
60,Fail,58,32,0,9,49
60,Fail,54,31,0,9,45
60,Fail,48,37,0,14,34
60,Fail,51,38,0,9,42
60,Fail,49,36,4,11,38
60,Fail,43,36,5,16,27
60,Fail,45,42,2,11,34
60,Fail,50,40,0,8,42
60,Fail,50,40,0,8,42
60,Fail,50,35,3,12,38
60,Fail,45,33,0,22,23
60,Fail,46,40,3,11,35
60,Fail,46,34,0,10,36
60,Fail,53,36,0,11,42
60,Fail,52,37,0,11,41
60,Fail,56,36,0,5,51
60,Fail,45,37,0,16,29
60,Fail,47,38,0,14,33
60,Fail,48,32,0,18,30
60,Fail,48,43,1,8,40
60,Fail,48,37,4,11,37
60,Fail,53,32,2,13,40
60,Fail,47,39,0,12,35
60,Fail,44,33,0,23,21
60,Fail,43,41,0,15,28
60,Fail,54,31,6,9,45
60,Fail,45,39,6,10,35
60,Fail,46,36,3,15,31
60,Fail,49,39,2,10,39
60,Fail,45,36,0,17,28
60,Fail,37,36,10,17,20
60,Fail,55,34,0,10,45
60,Fail,39,36,0,19,20
60,Fail,38,36,8,18,20
60,Fail,55,35,1,9,46
60,Fail,48,29,4,19,29
60,Fail,52,37,0,11,41
60,Fail,53,37,5,5,48
60,Fail,41,39,0,15,26
60,Fail,50,41,1,8,42
60,Fail,42,38,0,16,26
60,Fail,48,29,0,17,31
60,Fail,45,39,0,8,37
60,Fail,49,33,4,14,35
60,Fail,50,33,9,8,42
60,Fail,45,41,0,11,34
60,Fail,46,40,2,12,34
60,Fail,37,35,0,20,17
60,Fail,46,35,8,11,35
60,Fail,44,42,2,12,32
60,Fail,46,33,4,17,29
60,Fail,57,30,0,13,44
60,Fail,43,40,0,12,31
60,Fail,56,28,4,12,44
60,Fail,41,38,10,11,30
60,Fail,46,35,1,18,28
60,Fail,48,35,0,14,34
60,Fail,49,39,1,11,38
60,Fail,54,38,0,5,49
60,Fail,46,39,0,15,31
60,Fail,49,33,0,16,33
60,Fail,52,33,4,11,41
60,Fail,52,34,0,9,43
60,Fail,51,38,0,11,40
60,Fail,47,39,4,10,37
60,Fail,46,42,1,11,35
60,Fail,48,40,1,11,37
60,Fail,47,37,4,12,35
60,Fail,49,33,0,13,36
60,Fail,49,36,4,11,38
60,Fail,49,33,0,18,31
60,Fail,55,27,0,15,40
60,Fail,49,36,0,11,38
60,Fail,43,43,0,9,34
60,Fail,57,27,0,9,48
60,Fail,48,39,0,13,35
60,Fail,50,34,2,14,36
60,Fail,52,35,0,13,39
60,Fail,50,34,3,13,37
60,Fail,50,35,1,14,36
60,Fail,43,33,8,16,27
60,Fail,43,31,0,18,25
60,Fail,46,44,0,10,36
60,Fail,50,35,0,9,41
60,Fail,52,39,0,9,43
60,Fail,47,28,5,20,27
60,Fail,46,39,0,12,34
60,Fail,42,35,14,9,33
60,Fail,41,32,0,16,25
60,Fail,46,36,3,15,31
60,Fail,45,39,0,9,36
60,Fail,56,37,1,6,50
60,Fail,49,30,9,12,37
60,Fail,44,42,1,13,31
60,Fail,40,36,0,17,23
60,Fail,45,35,0,14,31
60,Fail,46,34,8,12,34
60,Fail,47,37,0,15,32
60,Fail,46,38,2,14,32
60,Fail,53,35,0,10,43
60,Fail,47,37,1,15,32
60,Fail,42,41,6,11,31
60,Fail,54,32,0,11,43
60,Fail,38,39,0,20,18
60,Fail,58,33,0,7,51
60,Fail,52,35,0,7,45
60,Fail,41,26,13,20,21
60,Fail,51,30,1,18,33
60,Fail,46,35,5,14,32
60,Fail,57,32,3,8,49
60,Fail,51,42,0,5,46
60,Fail,52,34,0,10,42
60,Fail,42,40,3,15,27
60,Fail,51,31,0,8,43
60,Fail,45,42,0,9,36
60,Fail,49,32,0,14,35
60,Fail,43,36,3,18,25
60,Fail,47,38,3,12,35
60,Fail,48,31,0,16,32
60,Fail,45,38,4,13,32
60,Fail,44,34,9,13,31
60,Fail,44,30,0,14,30
60,Fail,45,39,1,15,30
60,Fail,50,36,1,13,37
60,Fail,45,37,0,13,32
60,Fail,47,39,0,12,35
60,Fail,48,38,6,8,40
60,Fail,49,38,0,13,36
60,Fail,47,37,0,13,34
60,Fail,44,37,0,12,32
60,Fail,52,36,1,11,41
60,Fail,42,39,0,16,26
60,Fail,54,28,1,17,37
60,Fail,47,38,2,13,34
60,Fail,46,35,0,15,31
60,Fail,47,37,0,6,41
60,Fail,44,34,14,8,36
60,Fail,57,28,0,11,46
60,Fail,50,37,6,7,43
60,Fail,35,37,0,16,19
60,Fail,51,35,0,11,40
60,Fail,42,42,1,15,27
60,Fail,55,34,2,9,46
60,Fail,43,33,0,11,32
60,Fail,49,38,1,12,37
60,Fail,55,33,0,10,45
60,Fail,48,39,0,9,39
60,Fail,51,35,0,11,40
60,Fail,54,30,2,14,40
60,Fail,52,35,0,12,40
60,Fail,46,38,4,12,34
60,Fail,54,34,0,11,43
60,Fail,46,37,0,17,29
60,Fail,48,39,1,12,36
60,Fail,39,39,9,13,26
60,Fail,54,32,2,12,42
60,Fail,45,33,11,11,34
60,Fail,54,40,0,6,48
60,Fail,46,36,0,17,29
60,Fail,45,35,5,15,30
60,Fail,51,33,6,10,41
60,Fail,38,40,6,16,22
60,Fail,40,33,14,13,27
60,Fail,59,30,3,8,51
60,Fail,51,39,0,10,41
60,Fail,48,36,7,9,39
60,Fail,42,42,6,10,32
60,Fail,50,35,0,15,35
60,Fail,52,34,0,8,44
60,Fail,53,32,0,12,41
60,Fail,44,30,0,17,27
60,Fail,55,32,0,11,44
60,Fail,48,37,0,13,35
60,Fail,44,41,3,12,32
60,Fail,48,34,0,15,33
60,Fail,48,33,6,13,35
60,Fail,50,34,4,12,38
60,Fail,47,29,0,18,29
60,Fail,63,30,0,7,56
60,Fail,46,34,0,17,29
60,Fail,45,43,0,8,37
60,Fail,55,34,2,9,46
60,Fail,47,29,0,19,28
60,Fail,51,36,2,11,40
60,Fail,53,30,0,11,42
60,Fail,49,39,0,9,40
60,Fail,48,31,0,17,31
60,Fail,46,36,0,15,31
60,Fail,50,38,0,9,41
60,Fail,47,35,0,12,35
60,Fail,51,35,3,11,40
60,Fail,49,31,1,19,30
60,Fail,50,31,0,15,35
60,Fail,53,35,0,8,45
60,Fail,45,35,0,15,30
60,Fail,44,40,2,14,30
60,Fail,48,34,4,14,34
60,Fail,47,41,5,7,40
60,Fail,36,42,0,16,20
60,Fail,48,38,5,9,39
60,Fail,43,44,1,12,31
60,Fail,49,34,0,12,37
60,Fail,49,37,3,11,38
60,Fail,47,38,3,12,35
60,Fail,45,38,0,12,33
60,Fail,50,40,0,6,44
60,Fail,51,31,2,16,35
60,Fail,46,34,9,11,35
60,Fail,44,37,4,15,29
60,Fail,41,41,6,12,29
60,Fail,43,43,4,10,33
60,Fail,50,29,6,15,35
60,Fail,44,38,1,17,27
60,Fail,43,40,0,14,29
60,Fail,45,40,0,11,34
60,Fail,50,35,1,14,36
60,Fail,48,34,2,16,32
60,Fail,45,39,0,11,34
60,Fail,54,28,0,12,42
60,Fail,47,37,0,14,33
60,Fail,49,38,3,10,39
60,Fail,49,35,3,13,36
60,Fail,53,35,2,10,43
60,Fail,51,31,0,14,37
60,Fail,49,37,2,12,37
60,Fail,51,29,7,13,38
60,Fail,55,31,0,9,46
60,Fail,46,35,0,10,36
60,Fail,42,38,2,18,24
60,Fail,45,38,2,15,30
60,Fail,45,37,2,16,29
60,Fail,46,36,5,13,33
60,Fail,46,41,1,12,34
60,Fail,47,37,0,12,35
60,Fail,54,31,0,9,45
60,Fail,48,40,5,7,41
60,Fail,35,31,9,25,10
60,Fail,51,32,0,12,39
60,Fail,54,34,1,11,43
60,Fail,47,31,5,17,30
60,Fail,57,31,0,12,45
60,Fail,51,36,2,11,40
60,Fail,44,34,0,15,29
60,Fail,40,40,0,14,26
60,Fail,49,36,0,12,37
60,Fail,46,30,0,14,32
60,Fail,46,37,0,15,31
60,Fail,49,40,1,10,39
60,Fail,48,37,0,13,35
60,Fail,50,30,4,16,34
60,Fail,51,32,4,13,38
60,Fail,45,39,4,12,33
60,Fail,50,31,0,17,33
60,Fail,50,32,0,11,39
60,Fail,52,32,8,8,44
60,Fail,42,45,0,10,32
60,Fail,44,44,2,10,34
60,Fail,46,37,0,10,36
60,Fail,50,37,4,9,41
60,Fail,42,35,8,15,27
60,Fail,43,36,0,15,28
60,Fail,42,41,4,13,29
60,Fail,49,32,0,13,36
60,Fail,49,37,0,8,41
60,Fail,49,36,1,14,35
60,Fail,50,35,0,13,37
60,Fail,46,34,6,14,32
60,Fail,47,29,4,20,27
60,Fail,49,34,0,12,37
60,Fail,51,27,0,16,35
60,Fail,51,34,3,12,39
60,Fail,41,40,5,14,27
60,Fail,45,39,0,16,29
60,Fail,52,31,3,14,38
60,Fail,47,36,2,15,32
60,Fail,54,35,4,7,47
60,Fail,62,29,0,9,53
60,Fail,44,32,3,21,23
60,Fail,53,35,0,9,44
60,Fail,48,36,0,12,36
60,Fail,45,40,2,13,32
60,Fail,45,37,2,16,29
60,Fail,46,37,0,14,32
60,Fail,40,46,0,12,28
60,Fail,47,34,0,11,36
60,Fail,55,34,0,7,48
60,Fail,50,30,0,13,37
60,Fail,52,35,1,12,40
60,Fail,45,47,2,6,39
60,Fail,53,38,0,7,46
60,Fail,45,38,0,13,32
60,Fail,55,32,3,10,45
60,Fail,43,46,0,9,34
60,Fail,42,37,4,17,25
60,Fail,53,35,0,11,42
60,Fail,48,39,0,13,35
60,Fail,50,37,0,10,40
60,Fail,47,37,5,11,36
60,Fail,56,30,1,13,43
60,Fail,53,27,5,15,38
60,Fail,54,33,0,12,42
60,Fail,51,34,6,9,42
60,Fail,41,36,6,17,24
60,Fail,43,41,5,11,32
60,Fail,53,40,1,6,47
60,Fail,50,31,6,13,37
60,Fail,47,41,0,12,35
60,Fail,47,32,5,16,31
60,Fail,42,32,0,14,28
60,Fail,52,31,3,14,38
60,Fail,51,37,0,10,41
60,Fail,42,31,0,20,22
60,Fail,52,40,0,8,44
60,Fail,51,33,4,12,39
60,Fail,46,34,0,16,30
60,Fail,55,34,2,9,46
60,Fail,49,34,0,13,36
60,Fail,51,37,2,10,41
60,Fail,46,30,0,15,31
60,Fail,52,33,0,10,42
60,Fail,50,37,2,11,39
60,Fail,49,38,0,11,38
60,Fail,51,35,0,12,39
60,Fail,48,36,3,13,35
60,Fail,49,37,6,8,41
60,Fail,45,38,0,17,28
60,Fail,56,30,0,13,43
60,Fail,54,29,1,16,38
60,Fail,51,32,0,15,36
60,Fail,43,49,0,8,35
60,Fail,51,39,0,6,45
60,Fail,48,39,0,11,37
60,Fail,46,41,0,11,35
60,Fail,48,37,0,12,36
60,Fail,46,36,0,10,36
60,Fail,53,32,5,10,43
60,Fail,48,38,3,11,37
60,Fail,50,38,0,6,44
60,Fail,49,33,5,13,36
60,Fail,53,31,4,12,41
60,Fail,48,42,0,10,38
60,Fail,46,32,0,14,32
60,Fail,47,36,0,16,31
60,Fail,50,38,0,11,39
60,Fail,50,36,3,11,39
60,Fail,41,36,5,18,23
60,Fail,49,35,4,12,37
60,Fail,58,29,0,9,49
60,Fail,46,40,0,11,35
60,Fail,43,40,4,13,30
60,Fail,52,35,1,12,40
60,Fail,48,31,7,14,34
60,Fail,52,39,4,5,47
60,Fail,49,31,0,8,41
60,Fail,40,40,6,14,26
60,Fail,46,37,6,11,35
60,Fail,42,32,0,16,26
60,Fail,47,39,0,14,33
60,Fail,49,40,0,11,38
60,Fail,47,36,0,16,31
60,Fail,49,29,0,15,34
60,Fail,51,24,0,15,36
60,Fail,43,47,2,8,35
60,Fail,44,36,0,16,28
60,Fail,46,32,9,13,33
60,Fail,48,35,2,15,33
60,Fail,45,31,5,19,26
60,Fail,50,35,0,13,37
60,Fail,41,39,0,18,23
60,Fail,52,36,6,6,46
60,Fail,51,29,6,14,37
60,Fail,52,38,3,7,45
60,Fail,46,37,0,10,36
60,Fail,45,31,4,20,25
60,Fail,42,24,0,18,24
60,Fail,48,36,4,12,36
60,Fail,52,35,0,8,44
60,Fail,49,39,0,9,40
60,Fail,49,36,1,14,35
60,Fail,50,31,0,15,35
60,Fail,53,30,7,10,43
60,Fail,50,40,0,10,40
60,Fail,46,34,11,9,37
60,Fail,38,40,5,17,21
60,Fail,50,40,0,8,42
60,Fail,38,50,0,12,26
60,Fail,44,35,4,17,27
60,Fail,45,36,0,9,36
60,Fail,47,38,4,11,36
60,Fail,50,35,4,11,39
60,Fail,46,42,7,5,41
60,Fail,51,35,3,11,40
60,Fail,43,46,0,11,32
60,Fail,48,33,5,14,34
60,Fail,47,42,1,10,37
60,Fail,45,38,0,17,28
60,Fail,45,38,3,14,31
60,Fail,48,32,0,17,31
60,Fail,47,39,2,12,35
60,Fail,52,32,3,13,39
60,Fail,55,38,0,6,49
60,Fail,52,34,3,11,41
60,Fail,47,39,4,10,37
60,Fail,43,42,1,14,29
60,Fail,52,37,0,11,41
60,Fail,47,39,0,11,36
60,Fail,54,30,2,14,40
60,Fail,42,36,8,14,28
60,Fail,48,38,0,10,38
60,Fail,43,34,11,12,31
60,Fail,49,30,0,13,36
60,Fail,50,38,0,10,40
60,Fail,53,37,0,8,45
60,Fail,58,25,8,9,49
60,Fail,48,36,1,15,33
60,Fail,43,39,4,14,29
60,Fail,54,31,0,14,40
60,Fail,48,32,1,19,29
60,Fail,49,38,3,10,39
60,Fail,45,43,0,12,33
60,Fail,40,38,5,17,23
60,Fail,48,28,8,16,32
60,Fail,58,23,0,17,41
60,Fail,52,32,0,12,40
60,Fail,50,32,3,15,35
60,Fail,50,40,0,10,40
60,Fail,49,35,7,9,40
60,Fail,46,41,0,8,38
60,Fail,51,36,0,11,40
60,Fail,45,32,0,16,29
60,Fail,42,41,0,11,31
60,Fail,50,40,1,9,41
60,Fail,49,22,0,21,28
60,Fail,51,35,2,12,39
60,Fail,53,33,0,11,42
60,Fail,46,30,8,16,30
60,Fail,49,34,4,13,36
60,Fail,42,40,5,13,29
60,Fail,45,37,9,9,36
60,Fail,42,38,0,15,27
60,Fail,48,33,0,10,38
60,Fail,53,33,0,12,41
60,Fail,46,38,0,14,32
60,Fail,48,29,0,19,29
60,Fail,42,43,0,13,29
60,Fail,49,34,5,12,37
60,Fail,44,39,4,13,31
60,Fail,42,39,0,18,24
60,Fail,49,40,0,11,38
60,Fail,47,36,4,13,34
60,Fail,51,37,0,12,39
60,Fail,42,42,2,14,28
60,Fail,42,42,4,12,30
60,Fail,50,33,0,15,35
60,Fail,43,37,7,13,30
60,Fail,42,29,9,20,22
60,Fail,43,38,4,15,28
60,Fail,49,33,0,15,34
60,Fail,48,36,0,10,38
60,Fail,57,32,1,10,47
60,Fail,61,25,0,11,50
60,Fail,46,35,4,15,31
60,Fail,54,37,0,9,45
60,Fail,49,35,8,8,41
60,Fail,55,37,0,8,47
60,Fail,47,35,0,17,30
60,Fail,50,33,6,11,39
60,Fail,49,42,0,9,40
60,Fail,40,42,0,17,23
60,Fail,45,40,4,11,34
60,Fail,50,40,3,7,43
60,Fail,48,33,3,16,32
60,Fail,53,33,0,13,40
60,Fail,46,38,0,12,34
60,Fail,47,33,2,18,29
60,Fail,53,33,2,12,41
60,Fail,47,35,1,17,30
60,Fail,40,43,0,14,26
60,Fail,56,36,1,7,49
60,Fail,51,30,0,13,38
60,Fail,43,38,6,13,30
60,Fail,42,43,0,11,31
60,Fail,52,35,0,12,40
60,Fail,52,38,0,9,43
60,Fail,48,31,1,20,28
60,Fail,48,35,0,16,32
60,Fail,47,40,0,11,36
60,Fail,44,39,0,10,34
60,Fail,53,36,3,8,45
60,Fail,46,37,0,13,33
60,Fail,49,33,0,15,34
60,Fail,50,32,0,13,37
60,Fail,47,37,0,12,35
60,Fail,44,40,0,15,29
60,Fail,47,34,3,16,31
60,Fail,45,35,4,16,29
60,Fail,48,40,0,11,37
60,Fail,51,32,6,11,40
60,Fail,49,35,5,11,38
60,Fail,46,28,7,19,27
60,Fail,46,40,5,9,37
60,Fail,49,38,0,9,40
60,Fail,55,34,1,10,45
60,Fail,45,41,0,10,35
60,Fail,41,39,8,12,29
60,Fail,39,46,4,11,28
60,Fail,51,34,0,13,38
60,Fail,51,38,6,5,46
60,Fail,51,35,0,9,42
60,Fail,47,36,6,11,36
60,Fail,48,34,0,17,31
60,Fail,39,49,0,12,27
60,Fail,54,33,0,10,44
60,Fail,42,40,5,13,29
60,Fail,42,43,2,13,29
60,Fail,49,36,0,14,35
60,Fail,56,30,2,12,44
60,Fail,48,30,2,20,28
60,Fail,47,39,0,10,37
60,Fail,55,36,0,8,47
60,Fail,49,35,1,15,34
60,Fail,42,31,10,17,25
60,Fail,51,30,0,14,37
60,Fail,40,34,14,12,28
60,Fail,48,32,7,13,35
60,Fail,50,37,1,12,38
60,Fail,47,30,0,16,31
60,Fail,52,32,0,12,40
60,Fail,36,42,0,15,21
60,Fail,48,39,0,12,36
60,Fail,46,38,0,13,33
60,Fail,46,35,3,16,30
60,Fail,40,39,8,13,27
60,Fail,41,38,0,13,28
60,Fail,49,34,0,16,33
60,Fail,53,35,0,9,44
60,Fail,57,30,3,10,47
60,Fail,47,33,2,18,29
60,Fail,44,39,0,13,31
60,Fail,50,40,0,9,41
60,Fail,46,30,6,18,28
60,Fail,46,39,2,13,33
60,Fail,49,28,5,18,31
60,Fail,46,33,0,13,33
60,Fail,56,30,0,12,44
60,Fail,49,32,3,16,33
60,Fail,50,34,2,14,36
60,Fail,39,36,12,13,26
60,Fail,51,36,0,8,43
60,Fail,55,37,0,8,47
60,Fail,43,34,0,10,33
60,Fail,48,38,0,14,34
60,Fail,51,36,0,12,39
60,Fail,51,35,3,11,40
60,Fail,40,39,0,14,26
60,Fail,49,34,0,12,37
60,Fail,50,31,8,11,39
60,Fail,47,27,11,15,32
60,Fail,36,40,0,11,25
60,Fail,52,35,0,8,44
60,Fail,44,29,0,15,29
60,Fail,49,32,2,17,32
60,Fail,58,30,0,10,48
60,Fail,49,42,0,9,40
60,Fail,39,42,0,16,23
60,Fail,48,42,0,9,39
60,Fail,52,34,5,9,43
60,Fail,52,28,0,16,36
60,Fail,46,43,2,9,37
60,Fail,53,34,2,11,42
60,Fail,51,32,0,8,43
60,Fail,55,33,1,11,44
60,Fail,46,32,9,13,33
60,Fail,52,35,4,9,43
60,Fail,42,40,0,10,32
60,Fail,43,39,0,15,28
60,Fail,50,37,0,13,37
60,Fail,45,35,0,13,32
60,Fail,41,44,0,12,29
60,Fail,53,42,0,5,48
60,Fail,47,31,7,15,32
60,Fail,53,29,5,13,40
60,Fail,39,38,0,21,18
60,Fail,49,32,3,16,33
60,Fail,56,32,0,12,44
60,Fail,57,29,0,13,44
60,Fail,47,38,6,9,38
60,Fail,48,28,0,17,31
60,Fail,40,38,6,16,24
60,Fail,54,35,2,9,45
60,Fail,44,33,0,11,33
60,Fail,59,32,0,7,52
60,Fail,53,32,4,11,42
60,Fail,56,33,0,9,47
60,Fail,51,37,3,9,42
60,Fail,44,39,0,14,30
60,Fail,47,41,2,10,37
60,Fail,50,35,1,14,36
60,Fail,46,35,0,13,33
60,Fail,46,28,10,16,30
60,Fail,44,37,3,16,28
60,Fail,40,38,0,15,25
60,Fail,45,30,3,22,23
60,Fail,47,37,0,13,34
60,Fail,49,42,0,7,42
60,Fail,52,33,0,12,40
60,Fail,41,45,4,10,31
60,Fail,52,36,0,11,41
60,Fail,41,38,8,13,28
60,Fail,49,35,2,14,35
60,Fail,45,42,0,11,34
60,Fail,50,39,0,10,40
60,Fail,48,33,0,16,32
60,Fail,44,46,0,10,34
60,Fail,54,34,6,6,48
60,Fail,48,33,4,15,33
60,Fail,49,35,0,9,40
60,Fail,53,31,2,14,39
60,Fail,50,36,0,12,38
60,Fail,58,27,3,12,46
60,Fail,44,40,0,15,29
60,Fail,47,35,1,17,30
60,Fail,46,41,4,9,37
60,Fail,46,35,4,15,31
60,Fail,42,39,0,16,26
60,Fail,50,28,4,18,32
60,Fail,57,29,0,14,43
60,Fail,55,29,0,13,42
60,Fail,49,40,3,8,41
60,Fail,55,26,0,17,38
60,Fail,39,45,0,11,28
60,Fail,46,42,0,12,34
60,Fail,45,42,0,11,34
60,Fail,48,31,10,11,37
60,Fail,45,39,3,13,32
60,Fail,46,44,0,9,37
60,Fail,51,39,1,9,42
60,Fail,48,31,0,13,35
60,Fail,43,44,0,11,32
60,Fail,47,36,4,13,34
60,Fail,49,38,0,11,38
60,Fail,50,39,0,7,43
60,Fail,44,42,0,12,32
60,Fail,51,32,0,17,34
60,Fail,46,39,0,15,31
60,Fail,51,35,2,12,39
60,Fail,52,38,0,8,44
60,Fail,44,37,0,18,26
60,Fail,47,34,2,17,30
60,Fail,46,38,0,15,31
60,Fail,55,33,0,11,44
60,Fail,52,38,1,9,43
60,Fail,47,40,1,12,35
60,Fail,47,34,0,9,38
60,Fail,53,33,1,13,40
60,Fail,50,35,0,11,39
60,Fail,54,35,2,9,45
60,Fail,47,33,0,15,32
60,Fail,52,38,2,8,44
60,Fail,45,34,8,13,32
60,Fail,53,30,4,13,40
60,Fail,50,36,5,9,41
60,Fail,62,29,0,8,54
60,Fail,49,34,0,10,39
60,Fail,45,33,0,19,26
60,Fail,63,28,0,9,54
60,Fail,42,34,3,21,21
60,Fail,45,32,2,21,24
60,Fail,40,34,11,15,25
60,Fail,51,37,0,10,41
60,Fail,49,32,0,12,37
60,Fail,57,32,0,8,49
60,Fail,52,27,0,15,37
60,Fail,54,34,0,11,43
60,Fail,52,35,0,13,39
60,Fail,48,38,7,7,41
60,Fail,45,38,0,13,32
60,Fail,49,36,4,11,38
60,Fail,45,40,0,11,34
60,Fail,49,41,1,9,40
60,Fail,49,32,4,15,34
60,Fail,48,34,0,16,32
60,Fail,45,34,3,18,27
60,Fail,53,34,3,10,43
60,Fail,46,38,0,11,35
60,Fail,45,35,0,14,31
60,Fail,50,33,4,13,37
60,Fail,46,32,0,13,33
60,Fail,38,40,0,18,20
60,Fail,48,43,0,7,41
60,Fail,57,28,0,13,44
60,Fail,42,35,0,12,30
60,Fail,46,38,0,12,34
60,Fail,47,37,0,14,33
60,Fail,47,38,3,12,35
60,Fail,47,37,6,10,37
60,Fail,49,34,4,13,36
60,Fail,56,36,0,8,48
60,Fail,45,40,0,10,35
60,Fail,46,36,6,12,34
60,Fail,40,47,4,9,31
60,Fail,41,33,16,10,31
60,Fail,54,30,1,15,39
60,Fail,53,34,0,12,41
60,Fail,50,34,6,10,40
60,Fail,50,27,6,17,33
60,Fail,44,40,0,9,35
60,Fail,48,36,0,11,37
60,Fail,46,37,0,14,32
60,Fail,46,36,8,10,36
60,Fail,53,27,5,15,38
60,Fail,49,30,0,15,34
60,Fail,48,37,2,13,35
60,Fail,49,41,0,9,40
60,Fail,53,34,0,9,44
60,Fail,47,43,0,8,39
60,Fail,46,44,0,10,36
60,Fail,47,36,0,15,32
60,Fail,46,35,5,14,32
60,Fail,51,37,1,11,40
60,Fail,53,36,0,11,42
60,Fail,47,42,5,6,41
60,Fail,52,33,2,13,39
60,Fail,39,43,0,16,23
60,Fail,46,36,9,9,37
60,Fail,48,35,0,16,32
60,Fail,38,36,0,16,22
60,Fail,47,36,0,12,35
60,Fail,54,35,0,11,43
60,Fail,49,37,0,13,36
60,Fail,50,40,1,9,41
60,Fail,42,45,3,10,32
60,Fail,46,46,0,8,38
60,Fail,48,38,2,12,36
60,Fail,50,37,0,12,38
60,Fail,58,23,6,13,45
60,Fail,47,39,0,13,34
60,Fail,46,40,1,13,33
60,Fail,43,37,6,14,29
60,Fail,50,31,0,15,35
60,Fail,49,33,0,18,31
60,Fail,56,33,0,10,46
60,Fail,45,35,0,14,31
60,Fail,53,31,6,10,43
60,Fail,49,37,0,11,38
60,Fail,62,28,0,6,56
60,Fail,56,31,0,8,48
60,Fail,45,32,7,16,29
60,Fail,52,34,3,11,41
60,Fail,43,37,7,13,30
60,Fail,51,38,0,10,41
60,Fail,49,41,0,9,40
60,Fail,57,21,0,17,40
60,Fail,44,36,9,11,33
60,Fail,53,25,2,20,33
60,Fail,53,34,0,10,43
60,Fail,49,33,0,17,32
60,Fail,50,37,3,10,40
60,Fail,48,40,0,10,38
60,Fail,47,39,3,11,36
60,Fail,40,41,4,15,25
60,Fail,48,43,0,9,39
60,Success,66,28,1,5,61
60,Fail,46,35,0,14,32
60,Fail,43,40,2,15,28
60,Fail,50,39,3,8,42
60,Fail,40,40,7,13,27
60,Fail,52,31,0,16,36
60,Fail,45,40,0,8,37
60,Fail,53,30,1,16,37
60,Fail,50,35,0,12,38
60,Fail,45,36,10,9,36
60,Fail,55,28,0,14,41
60,Fail,52,29,0,16,36
60,Fail,53,35,2,10,43
60,Fail,48,35,0,15,33
60,Fail,49,35,3,13,36
60,Fail,47,36,0,14,33
60,Fail,47,34,0,14,33
60,Fail,52,32,0,11,41
60,Fail,54,36,1,9,45
60,Fail,42,35,10,13,29
60,Fail,46,38,0,10,36
60,Fail,47,36,8,9,38
60,Fail,47,34,8,11,36
60,Fail,50,30,6,14,36
60,Fail,47,37,5,11,36
60,Fail,40,38,7,15,25
60,Fail,44,37,8,11,33
60,Fail,49,37,0,14,35
60,Fail,47,38,0,8,39
60,Fail,52,35,1,12,40
60,Fail,54,33,3,10,44
60,Fail,48,39,5,8,40
60,Fail,50,36,0,13,37
60,Fail,44,36,0,14,30
60,Fail,49,32,0,14,35
60,Fail,40,35,10,15,25
60,Fail,50,32,1,17,33
60,Fail,48,35,0,14,34
60,Fail,50,35,0,15,35
60,Fail,45,40,0,13,32
60,Fail,51,33,4,12,39
60,Fail,45,33,5,17,28
60,Fail,43,36,9,12,31
60,Fail,44,40,1,15,29
60,Fail,45,36,0,17,28
60,Fail,52,30,0,13,39
60,Fail,48,37,4,11,37
60,Fail,55,30,5,10,45
60,Fail,48,36,2,14,34
60,Fail,52,35,0,11,41
60,Fail,46,40,2,12,34
60,Fail,46,38,3,13,33
60,Fail,50,34,0,13,37
60,Fail,56,34,0,10,46
60,Fail,44,40,0,11,33
60,Fail,46,36,0,16,30
60,Fail,52,30,0,17,35
60,Fail,48,45,0,7,41
60,Fail,45,35,0,11,34
60,Fail,51,31,4,14,37
60,Fail,49,34,0,14,35
60,Fail,55,27,8,10,45
60,Fail,54,25,0,19,35
60,Fail,49,34,0,15,34
60,Fail,44,33,11,12,32
60,Fail,52,39,1,8,44
60,Fail,48,34,6,12,36
60,Fail,51,36,0,11,40
60,Fail,55,32,0,12,43
60,Fail,51,33,0,13,38
60,Fail,50,29,7,14,36
60,Fail,46,38,0,16,30
60,Fail,42,39,9,10,32
60,Fail,46,36,7,11,35
60,Fail,54,34,1,11,43
60,Fail,50,35,0,15,35
60,Fail,42,42,0,15,27
60,Fail,44,30,9,17,27
60,Fail,48,35,0,13,35
60,Fail,43,42,4,11,32
60,Fail,53,31,8,8,45
60,Fail,57,33,3,7,50
60,Fail,49,31,9,11,38
60,Fail,43,44,0,9,34
60,Fail,45,41,2,12,33
60,Fail,58,31,3,8,50
60,Fail,44,28,8,20,24
60,Fail,53,32,0,10,43
60,Fail,42,35,9,14,28
60,Fail,57,33,1,9,48
60,Fail,52,29,7,12,40
60,Fail,39,34,9,18,21
60,Fail,51,33,0,16,35
60,Fail,53,35,0,8,45
60,Fail,50,37,0,13,37
60,Fail,46,37,0,17,29
60,Fail,53,32,3,12,41
60,Fail,39,40,0,16,23
60,Fail,53,31,4,12,41
60,Fail,55,31,0,9,46
60,Fail,50,36,3,11,39
60,Fail,40,39,4,17,23
60,Fail,44,40,0,9,35
60,Fail,50,39,1,10,40
60,Fail,50,34,3,13,37
60,Fail,48,35,2,15,33
60,Fail,51,32,0,16,35
60,Fail,44,42,1,13,31
60,Fail,48,39,0,13,35
60,Fail,49,31,6,14,35
60,Fail,51,35,0,14,37
60,Fail,34,37,12,17,17
60,Fail,54,32,0,12,42
60,Fail,44,41,0,12,32
60,Fail,52,34,3,11,41
60,Fail,50,35,0,13,37
60,Fail,47,42,0,10,37
60,Fail,39,34,8,19,20
60,Fail,43,40,3,14,29
60,Fail,56,36,0,8,48
60,Fail,50,37,2,11,39
60,Fail,52,31,0,17,35
60,Fail,47,38,2,13,34
60,Fail,49,28,0,18,31
60,Fail,41,42,2,15,26
60,Fail,43,42,0,13,30
60,Fail,52,34,1,13,39
60,Fail,45,44,2,9,36
60,Fail,49,34,0,15,34
60,Fail,49,35,0,14,35
60,Fail,49,32,1,18,31
60,Fail,44,43,0,13,31
60,Fail,38,47,0,14,24
60,Fail,51,38,0,10,41
60,Fail,56,29,3,12,44
60,Fail,49,40,0,10,39
60,Fail,51,36,3,10,41
60,Fail,42,37,0,12,30
60,Fail,48,36,0,13,35
60,Fail,47,29,0,16,31
60,Fail,50,31,5,14,36
60,Fail,48,33,0,13,35
60,Fail,59,28,0,9,50
60,Fail,48,33,0,18,30
60,Fail,41,44,4,11,30
60,Fail,46,36,0,17,29
60,Fail,47,35,0,18,29
60,Fail,47,37,4,12,35
60,Fail,46,40,4,10,36
60,Fail,41,45,1,13,28
60,Fail,54,32,0,10,44
60,Fail,49,42,1,8,41
60,Fail,52,38,3,7,45
60,Fail,57,34,1,8,49
60,Fail,49,34,7,10,39
60,Fail,53,30,0,13,40
60,Fail,48,34,9,9,39
60,Fail,47,39,0,9,38
60,Fail,45,33,11,11,34
60,Fail,44,29,0,22,22
60,Fail,49,38,0,13,36
60,Fail,52,34,0,13,39
60,Fail,51,35,0,14,37
60,Fail,48,30,0,18,30
60,Fail,39,43,5,13,26
60,Fail,43,35,0,9,34
60,Fail,49,36,2,13,36
60,Fail,46,40,3,11,35
60,Fail,49,41,0,7,42
60,Fail,44,36,8,12,32
60,Fail,42,37,1,20,22
60,Fail,50,32,3,15,35
60,Fail,36,38,7,19,17
60,Fail,58,31,0,8,50
60,Fail,51,37,3,9,42
60,Fail,50,36,0,11,39
60,Fail,51,36,0,13,38
60,Fail,55,34,2,9,46
60,Fail,39,37,0,16,23
60,Fail,39,45,1,15,24
60,Fail,51,38,0,8,43
60,Fail,48,30,0,20,28
60,Fail,56,26,7,11,45
60,Fail,48,38,4,10,38
60,Fail,52,37,0,9,43
60,Fail,46,35,6,13,33
60,Fail,46,34,4,16,30
60,Fail,47,32,9,12,35
60,Fail,51,36,3,10,41
60,Fail,59,33,0,6,53
60,Fail,49,37,0,11,38
60,Fail,44,35,6,15,29
60,Fail,41,45,0,10,31
60,Fail,48,32,8,12,36
60,Fail,46,35,4,15,31
60,Fail,48,32,0,16,32
60,Fail,48,26,6,20,28
60,Fail,44,39,8,9,35
60,Fail,52,36,0,11,41
60,Fail,50,30,0,11,39
60,Fail,50,39,1,10,40
60,Fail,46,30,0,17,29
60,Fail,49,37,1,13,36
60,Fail,45,42,1,12,33
60,Fail,57,39,0,4,53
60,Fail,51,36,1,12,39
60,Fail,43,39,2,16,27
60,Fail,46,34,5,15,31
60,Fail,47,36,0,13,34
60,Fail,49,34,0,11,38
60,Fail,54,34,1,11,43
60,Fail,49,31,7,13,36
60,Fail,52,33,0,8,44
60,Fail,53,30,0,11,42
60,Fail,54,29,6,11,43
60,Fail,50,35,5,10,40
60,Fail,48,31,3,18,30
60,Fail,47,44,0,5,42
60,Fail,45,38,0,14,31
60,Fail,52,36,0,10,42
60,Fail,43,42,0,10,33
60,Fail,49,37,2,12,37
60,Fail,48,39,2,11,37
60,Fail,46,30,10,14,32
60,Fail,52,34,0,13,39
60,Fail,48,41,0,11,37
60,Fail,47,31,11,11,36
60,Fail,49,28,7,16,33
60,Fail,52,21,16,11,41
60,Fail,46,28,2,24,22
60,Fail,47,37,6,10,37
60,Fail,44,34,10,12,32
60,Fail,50,35,4,11,39
60,Fail,37,42,6,15,22
60,Fail,57,26,0,14,43
60,Fail,53,36,0,10,43
60,Fail,52,41,2,5,47
60,Fail,54,31,0,15,39
60,Fail,44,37,0,14,30
60,Fail,48,32,7,13,35
60,Fail,49,30,7,14,35
60,Fail,51,29,0,17,34
60,Fail,49,42,1,8,41
60,Fail,58,28,0,12,46
60,Fail,51,40,0,9,42
60,Fail,48,36,0,15,33
60,Fail,46,31,8,15,31
60,Fail,47,29,13,11,36
60,Fail,50,37,0,12,38
60,Fail,48,32,0,14,34
60,Fail,49,39,0,9,40
60,Fail,47,41,0,7,40
60,Fail,40,44,1,15,25
60,Fail,51,35,0,10,41
60,Fail,41,37,4,18,23
60,Fail,55,33,0,12,43
60,Fail,49,36,0,11,38
60,Fail,51,32,1,16,35
60,Fail,41,33,0,17,24
60,Fail,50,40,0,9,41
60,Fail,48,39,2,11,37
60,Fail,59,29,0,9,50
60,Fail,44,33,2,21,23
60,Fail,58,35,0,7,51
60,Fail,49,40,3,8,41
60,Fail,48,37,2,13,35
60,Fail,49,39,1,11,38
60,Fail,43,31,0,15,28
60,Fail,50,36,0,14,36
60,Fail,44,41,6,9,35
60,Fail,55,31,1,13,42
60,Fail,51,31,7,11,40
60,Fail,48,38,0,14,34
60,Fail,54,31,0,14,40
60,Fail,47,35,0,17,30
60,Fail,44,36,1,19,25
60,Fail,43,41,4,12,31
60,Fail,47,38,0,12,35
60,Fail,47,32,7,14,33
60,Fail,40,38,0,16,24
60,Fail,53,36,4,7,46
60,Fail,45,33,4,18,27
60,Fail,47,35,0,18,29
60,Fail,41,42,0,13,28
60,Fail,49,43,0,8,41
60,Fail,42,39,2,17,25
60,Fail,52,32,4,12,40
60,Fail,49,25,13,13,36
60,Fail,45,43,0,8,37
60,Fail,39,44,0,12,27
60,Fail,45,35,0,13,32
60,Fail,47,37,2,14,33
60,Fail,47,40,3,10,37
60,Fail,49,39,0,12,37
60,Fail,49,32,0,13,36
60,Fail,44,33,7,16,28
60,Fail,45,34,0,10,35
60,Fail,50,39,0,8,42
60,Fail,48,40,3,9,39
60,Fail,57,31,0,12,45
60,Fail,53,35,1,11,42
60,Fail,51,32,3,14,37
60,Fail,53,32,5,10,43
60,Fail,45,36,0,14,31
60,Fail,52,35,0,12,40
60,Fail,53,36,2,9,44
60,Fail,45,42,4,9,36
60,Fail,46,34,0,13,33
60,Fail,40,38,0,14,26
60,Fail,43,44,0,11,32
60,Fail,39,43,0,10,29
60,Fail,51,36,3,10,41
60,Fail,42,43,0,10,32
60,Fail,41,45,0,8,33
60,Fail,44,40,0,12,32
60,Fail,51,37,0,12,39
60,Fail,40,40,8,12,28
60,Fail,49,41,0,10,39
60,Fail,50,29,0,18,32
60,Fail,50,39,0,11,39
60,Fail,42,36,0,15,27
60,Fail,47,37,3,13,34
60,Fail,44,38,0,17,27
60,Fail,41,33,0,17,24
60,Fail,46,36,7,11,35
60,Fail,51,32,0,13,38
60,Fail,45,40,0,13,32
60,Fail,49,34,0,12,37
60,Fail,43,38,3,16,27
60,Fail,41,34,2,23,18
60,Fail,49,30,4,17,32
60,Fail,53,35,5,7,46
60,Fail,49,42,0,8,41
60,Fail,44,45,0,7,37
60,Fail,47,37,3,13,34
60,Fail,57,29,4,10,47
60,Fail,42,35,3,20,22
60,Fail,52,31,0,11,41
60,Fail,48,40,0,11,37
60,Fail,44,40,0,14,30
60,Fail,42,37,5,16,26
60,Fail,44,33,0,17,27
60,Fail,49,33,3,15,34
60,Fail,43,38,2,17,26
60,Fail,52,34,5,9,43
60,Fail,48,36,4,12,36
60,Fail,42,43,1,14,28
60,Fail,47,40,5,8,39
60,Fail,46,28,5,21,25
60,Fail,42,32,0,17,25
60,Fail,61,29,0,9,52
60,Fail,48,28,0,20,28
60,Fail,50,35,3,12,38
60,Fail,47,42,0,11,36
60,Fail,51,29,0,14,37
60,Fail,37,44,3,16,21
60,Fail,44,40,6,10,34
60,Fail,49,32,0,15,34
60,Fail,55,36,1,8,47
60,Fail,42,42,4,12,30
60,Fail,44,35,0,19,25
60,Fail,55,33,0,9,46
60,Fail,46,38,0,11,35
60,Fail,53,28,0,12,41
60,Fail,49,34,2,15,34
60,Fail,46,41,6,7,39
60,Fail,57,32,0,9,48
60,Fail,58,30,1,11,47
60,Fail,42,31,10,17,25
60,Fail,51,39,0,9,42
60,Fail,53,30,2,15,38
60,Fail,46,27,0,19,27
60,Fail,47,33,0,10,37
60,Fail,44,34,9,13,31
60,Fail,42,35,0,14,28
60,Fail,52,37,0,10,42
60,Fail,49,36,0,12,37
60,Fail,44,41,1,14,30
60,Fail,49,34,0,9,40
60,Fail,46,39,0,11,35
60,Fail,47,35,0,12,35
60,Fail,50,35,0,13,37
60,Fail,49,37,5,9,40
60,Fail,45,38,0,14,31
60,Fail,44,36,0,20,24
60,Fail,54,40,1,5,49
60,Fail,49,43,0,8,41
60,Fail,40,42,0,13,27
60,Fail,56,32,0,12,44
60,Fail,44,42,3,11,33
60,Fail,51,32,4,13,38
60,Fail,46,33,0,19,27
60,Fail,50,32,5,13,37
60,Fail,45,36,0,16,29
60,Fail,56,26,0,13,43
60,Fail,43,35,5,17,26
60,Fail,42,39,0,17,25
60,Fail,52,29,2,17,35
60,Fail,37,49,3,11,26
60,Fail,39,39,3,19,20
60,Fail,48,44,0,7,41
60,Fail,54,35,1,10,44
60,Fail,51,37,0,11,40
60,Fail,49,32,0,16,33
60,Fail,54,31,1,14,40
60,Fail,49,42,0,9,40
60,Fail,44,40,7,9,35
60,Fail,51,34,0,14,37
60,Fail,40,40,1,19,21
60,Fail,53,33,0,11,42
60,Fail,53,37,1,9,44
60,Fail,52,35,0,5,47
60,Fail,54,35,0,10,44
60,Fail,46,41,2,11,35
60,Fail,49,33,0,16,33
60,Fail,49,34,5,12,37
60,Fail,45,40,1,14,31
60,Fail,53,35,1,11,42
60,Fail,51,37,2,10,41
60,Fail,45,37,3,15,30
60,Fail,45,29,10,16,29
60,Fail,53,37,0,10,43
60,Fail,56,27,0,15,41
60,Fail,45,34,7,14,31
60,Fail,44,44,0,12,32
60,Fail,46,35,4,15,31
60,Fail,50,35,0,11,39
60,Fail,49,36,3,12,37
60,Fail,46,33,3,18,28
60,Fail,47,37,0,9,38
60,Fail,56,28,0,13,43
60,Fail,39,44,0,12,27
60,Fail,53,35,3,9,44
60,Fail,53,35,0,7,46
60,Fail,50,28,4,18,32
60,Fail,50,32,0,13,37
60,Fail,41,37,0,16,25
60,Fail,51,37,3,9,42
60,Fail,48,36,0,9,39
60,Fail,52,32,3,13,39
60,Fail,50,33,0,15,35
60,Fail,51,38,0,11,40
60,Fail,46,42,1,11,35
60,Fail,45,34,0,16,29
60,Fail,51,27,0,20,31
60,Fail,45,44,1,10,35
60,Fail,41,42,0,13,28
60,Fail,43,43,0,10,33
60,Fail,42,41,2,15,27
60,Fail,49,33,0,15,34
60,Fail,51,33,0,10,41
60,Fail,48,35,0,14,34
60,Fail,54,36,0,9,45
60,Fail,50,33,0,14,36
60,Fail,47,44,0,7,40
60,Fail,49,39,2,10,39
60,Fail,44,37,0,14,30
60,Fail,48,39,0,12,36
60,Fail,55,33,0,10,45
60,Fail,52,35,0,11,41
60,Fail,52,29,4,15,37
60,Fail,42,35,5,18,24
60,Fail,48,34,6,12,36
60,Fail,52,32,3,13,39
60,Fail,50,32,0,13,37
60,Fail,46,41,3,10,36
60,Fail,47,30,0,19,28
60,Fail,48,35,9,8,40
60,Fail,47,36,5,12,35
60,Fail,42,36,0,14,28
60,Fail,46,34,0,11,35
60,Fail,46,40,0,8,38
60,Fail,49,31,0,15,34
60,Fail,44,34,5,17,27
60,Fail,44,43,1,12,32
60,Fail,38,45,0,17,21
60,Fail,52,31,3,14,38
60,Fail,50,42,3,5,45
60,Fail,52,30,5,13,39
60,Fail,49,37,2,12,37
60,Fail,47,38,0,9,38
60,Fail,54,34,0,12,42
60,Fail,43,42,2,13,30
60,Fail,48,31,8,13,35
60,Fail,58,36,0,6,52
60,Fail,44,42,0,8,36
60,Fail,49,32,8,11,38
60,Fail,39,41,5,15,24
60,Fail,43,42,0,14,29
60,Fail,57,31,0,12,45
60,Fail,46,37,0,10,36
60,Fail,49,28,0,13,36
60,Fail,49,31,5,15,34
60,Fail,50,33,6,11,39
60,Fail,47,40,0,13,34
60,Fail,44,37,7,12,32
60,Fail,46,34,7,13,33
60,Fail,44,33,0,13,31
60,Fail,40,40,7,13,27
60,Fail,49,32,11,8,41
60,Fail,55,33,5,7,48
60,Fail,49,35,0,13,36
60,Fail,47,39,4,10,37
60,Fail,59,31,0,6,53
60,Fail,50,32,0,13,37
60,Fail,52,33,6,9,43
60,Fail,48,31,0,13,35
60,Fail,46,35,9,10,36
60,Fail,43,41,6,10,33
60,Fail,51,38,3,8,43
60,Fail,44,39,3,14,30
60,Fail,45,37,0,8,37
60,Fail,50,32,5,13,37
60,Fail,46,40,0,11,35
60,Fail,44,40,0,11,33
60,Fail,47,35,0,13,34
60,Fail,56,24,3,17,39
60,Fail,37,33,0,21,16
60,Fail,46,30,8,16,30
60,Fail,41,37,0,16,25
60,Fail,50,42,0,7,43
60,Fail,45,38,0,12,33
60,Fail,54,32,6,8,46
60,Fail,49,34,1,16,33
60,Fail,49,32,8,11,38
60,Fail,49,26,9,16,33
60,Fail,49,31,0,14,35
60,Fail,54,32,3,11,43
60,Fail,50,39,0,10,40
60,Fail,47,27,0,17,30
60,Fail,43,40,3,14,29
60,Fail,49,38,3,10,39
60,Fail,51,36,0,12,39
60,Fail,47,40,4,9,38
60,Fail,55,32,1,12,43
60,Fail,41,39,0,16,25
60,Fail,50,34,0,14,36
60,Fail,42,35,0,18,24
60,Fail,49,36,0,10,39
60,Fail,49,37,0,13,36
60,Fail,53,31,0,15,38
60,Fail,52,31,5,12,40
60,Fail,48,41,3,8,40
60,Fail,51,30,4,15,36
60,Fail,52,35,0,10,42
60,Fail,41,39,0,13,28
60,Fail,44,36,0,15,29
60,Fail,55,32,6,7,48
60,Fail,56,33,2,9,47
60,Fail,46,35,3,16,30
60,Fail,49,33,3,15,34
60,Fail,55,34,0,9,46
60,Fail,51,39,0,7,44
60,Fail,59,30,0,9,50
60,Fail,45,36,10,9,36
60,Fail,52,34,0,11,41
60,Fail,57,34,0,5,52
60,Fail,44,31,0,13,31
60,Fail,41,46,0,12,29
60,Fail,47,35,0,11,36
60,Fail,56,34,0,10,46
60,Fail,38,36,0,21,17
60,Fail,45,39,2,14,31
60,Fail,54,28,6,12,42
60,Fail,41,37,0,18,23
60,Fail,53,36,0,10,43
60,Fail,46,38,5,11,35
60,Fail,42,36,0,16,26
60,Fail,47,35,3,15,32
60,Fail,55,32,0,13,42
60,Fail,50,37,1,12,38
60,Fail,44,34,6,16,28
60,Fail,53,33,0,11,42
60,Fail,45,38,0,16,29
60,Fail,46,38,1,15,31
60,Fail,44,32,0,19,25
60,Fail,48,33,2,17,31
60,Fail,45,37,0,11,34
60,Fail,45,30,11,14,31
60,Fail,45,34,0,14,31
60,Fail,47,33,0,14,33
60,Fail,48,30,5,17,31
60,Fail,49,36,0,13,36
60,Fail,46,32,0,16,30
60,Fail,50,37,2,11,39
60,Fail,52,33,0,11,41
60,Fail,44,32,0,14,30
60,Fail,52,29,0,18,34
60,Fail,46,35,5,14,32
60,Fail,46,36,2,16,30
60,Fail,47,38,0,12,35
60,Fail,47,38,0,12,35
60,Fail,55,33,0,9,46
60,Fail,47,33,6,14,33
60,Fail,42,36,7,15,27
60,Fail,51,34,0,15,36
60,Fail,51,32,0,10,41
60,Fail,52,38,0,9,43
60,Fail,51,31,5,13,38
60,Fail,46,35,0,12,34
60,Fail,51,40,0,7,44
60,Fail,57,29,0,10,47
60,Fail,48,36,0,12,36
60,Fail,57,24,6,13,44
60,Fail,52,32,0,14,38
60,Fail,42,37,0,14,28
60,Fail,46,39,1,14,32
60,Fail,47,32,0,15,32
60,Fail,46,41,7,6,40
60,Fail,47,35,0,15,32
60,Fail,49,37,4,10,39
60,Fail,50,36,1,13,37
60,Fail,53,36,0,9,44
60,Fail,52,35,0,13,39
60,Fail,47,36,1,16,31
60,Fail,53,32,1,14,39
60,Fail,50,41,0,8,42
60,Fail,49,32,0,17,32
60,Fail,42,36,0,11,31
60,Fail,47,44,2,7,40
60,Fail,47,35,0,17,30
60,Fail,42,37,11,10,32
60,Fail,41,47,1,11,30
60,Fail,48,34,8,10,38
60,Fail,52,33,6,9,43
60,Fail,42,32,8,18,24
60,Fail,44,44,0,10,34
60,Fail,47,30,0,16,31
60,Fail,43,44,1,12,31
60,Fail,51,33,2,14,37
60,Fail,42,37,7,14,28
60,Fail,47,27,11,15,32
60,Fail,55,33,0,12,43
60,Fail,46,34,0,20,26
60,Fail,42,37,0,13,29
60,Fail,50,34,0,9,41
60,Fail,47,37,4,12,35
60,Fail,47,36,0,12,35
60,Fail,53,35,0,12,41
60,Fail,56,24,2,18,38
60,Fail,43,36,9,12,31
60,Fail,46,45,0,8,38
60,Fail,51,33,0,14,37
60,Fail,43,46,1,10,33
60,Fail,50,35,2,13,37
60,Fail,33,45,10,12,21
60,Fail,42,41,0,16,26
60,Fail,53,33,2,12,41
60,Fail,48,36,3,13,35
60,Fail,56,32,2,10,46
60,Fail,46,29,6,19,27
60,Fail,50,40,0,8,42
60,Fail,44,41,2,13,31
60,Fail,43,35,10,12,31
60,Fail,53,32,0,12,41
60,Fail,54,34,0,9,45
60,Fail,42,38,0,20,22
60,Fail,49,35,0,8,41
60,Fail,42,38,4,16,26
60,Fail,55,30,7,8,47
60,Fail,51,32,3,14,37
60,Fail,56,33,0,11,45
60,Fail,51,32,0,13,38
60,Fail,40,47,0,11,29
60,Fail,47,34,0,9,38
60,Fail,55,31,0,14,41
60,Fail,49,31,0,15,34
60,Fail,46,39,1,14,32
60,Fail,47,35,1,17,30
60,Fail,46,41,2,11,35
60,Fail,47,40,0,9,38
60,Fail,50,27,6,17,33
60,Fail,47,34,0,14,33
60,Fail,47,35,5,13,34
60,Fail,40,40,9,11,29
60,Fail,45,35,0,13,32
60,Fail,39,39,0,16,23
60,Fail,55,33,1,11,44
60,Fail,45,35,0,18,27
60,Fail,45,39,3,13,32
60,Fail,46,40,1,13,33
60,Fail,49,35,0,16,33
60,Fail,53,32,0,13,40
60,Fail,49,38,0,13,36
60,Fail,45,40,8,7,38
60,Fail,55,31,1,13,42
60,Fail,54,35,0,11,43
60,Fail,41,31,0,20,21
60,Fail,54,33,0,12,42
60,Fail,47,33,0,16,31
60,Fail,49,36,0,13,36
60,Fail,44,43,1,12,32
60,Fail,40,37,0,13,27
60,Fail,38,46,2,14,24
60,Fail,51,34,1,14,37
60,Fail,51,36,0,9,42
60,Fail,51,32,0,11,40
60,Fail,46,35,7,12,34
60,Fail,54,36,1,9,45
60,Fail,41,36,0,15,26
60,Fail,49,30,0,17,32
60,Fail,48,38,0,8,40
60,Fail,50,40,3,7,43
60,Fail,52,30,3,15,37
60,Fail,45,37,0,17,28
60,Fail,53,35,1,11,42
60,Fail,48,37,5,10,38
60,Fail,59,29,0,10,49
60,Fail,47,39,0,11,36
60,Fail,46,43,0,11,35
60,Fail,42,40,5,13,29
60,Fail,46,33,0,13,33
60,Fail,46,31,0,17,29
60,Fail,53,38,0,6,47
60,Fail,47,38,0,13,34
60,Fail,54,31,0,8,46
60,Fail,50,35,0,13,37
60,Fail,55,34,1,10,45
60,Fail,41,36,6,17,24
60,Fail,45,39,0,14,31
60,Fail,45,45,1,9,36
60,Fail,46,32,0,15,31
60,Fail,51,39,2,8,43
60,Fail,46,39,3,12,34
60,Fail,47,32,0,16,31
60,Fail,50,40,0,10,40
60,Fail,51,32,4,13,38
60,Fail,54,27,0,13,41
60,Fail,42,36,0,16,26
60,Fail,54,31,2,13,41
60,Fail,46,35,0,8,38
60,Fail,51,37,0,11,40
60,Fail,49,41,1,9,40
60,Fail,45,36,0,14,31
60,Fail,51,29,0,17,34
60,Fail,46,35,0,9,37
60,Fail,46,36,7,11,35
60,Fail,53,35,3,9,44
60,Fail,50,33,1,16,34
60,Fail,48,34,7,11,37
60,Fail,43,38,5,14,29
60,Fail,49,31,5,15,34
60,Fail,55,28,1,16,39
60,Fail,45,26,7,22,23
60,Fail,49,35,0,15,34
60,Fail,48,30,0,15,33
60,Fail,46,35,5,14,32
60,Fail,52,36,0,10,42
60,Fail,53,37,4,6,47
60,Fail,53,32,0,13,40
60,Fail,47,36,0,12,35
60,Fail,52,27,0,15,37
60,Fail,49,39,0,11,38
60,Fail,50,38,2,10,40
60,Fail,48,35,0,12,36
60,Fail,56,30,1,13,43
60,Fail,45,35,5,15,30
60,Fail,52,28,0,15,37
60,Fail,49,38,0,12,37
60,Fail,44,27,11,18,26
60,Fail,43,33,7,17,26
60,Fail,43,43,0,11,32
60,Fail,50,38,0,10,40
60,Fail,40,39,10,11,29
60,Fail,46,31,7,16,30
60,Fail,44,30,10,16,28
60,Fail,53,33,5,9,44
60,Fail,51,30,0,14,37
60,Fail,45,32,9,14,31
60,Fail,54,31,0,10,44
60,Fail,53,38,2,7,46
60,Fail,43,33,0,9,34
60,Fail,50,28,5,17,33
60,Fail,42,38,0,14,28
60,Fail,49,31,0,9,40
60,Fail,47,36,0,8,39
60,Fail,46,39,0,15,31
60,Fail,42,33,7,18,24
60,Fail,49,36,4,11,38
60,Fail,49,36,0,13,36
60,Fail,52,32,0,11,41
60,Fail,49,30,4,17,32
60,Fail,45,31,2,22,23
60,Fail,49,31,3,17,32
60,Fail,49,39,2,10,39
60,Fail,39,37,5,19,20
60,Fail,51,33,0,13,38
60,Fail,51,36,5,8,43
60,Fail,48,41,0,9,39
60,Fail,38,42,0,11,27
60,Fail,49,29,0,11,38
60,Fail,42,36,0,18,24
60,Fail,45,35,11,9,36
60,Fail,54,34,1,11,43
60,Fail,43,42,0,13,30
60,Fail,41,34,0,17,24
60,Fail,45,35,1,19,26
60,Fail,49,40,2,9,40
60,Fail,42,42,5,11,31
60,Fail,52,36,3,9,43
60,Fail,44,31,0,18,26
60,Fail,53,32,0,13,40
60,Fail,46,39,0,12,34
60,Fail,49,37,0,11,38
60,Fail,55,31,0,12,43
60,Fail,56,34,0,7,49
60,Fail,49,33,0,13,36
60,Fail,45,37,9,9,36
60,Fail,47,35,0,16,31
60,Fail,49,35,0,11,38
60,Fail,51,35,0,14,37
60,Fail,51,34,0,15,36
60,Fail,46,36,2,16,30
60,Fail,51,32,0,15,36
60,Fail,47,37,0,14,33
60,Fail,55,31,3,11,44
60,Fail,45,36,9,10,35
60,Fail,51,32,7,10,41
60,Fail,45,31,0,19,26
60,Fail,51,32,1,16,35
60,Fail,48,35,0,8,40
60,Fail,48,36,2,14,34
60,Fail,43,36,0,13,30
60,Fail,42,36,4,18,24
60,Fail,39,38,0,17,22
60,Fail,46,33,5,16,30
60,Fail,56,27,3,14,42
60,Fail,44,32,7,17,27
60,Fail,45,32,0,16,29
60,Fail,44,30,10,16,28
60,Fail,52,35,0,12,40
60,Fail,47,45,0,8,39
60,Fail,50,35,0,13,37
60,Fail,46,34,4,16,30
60,Fail,48,34,4,14,34
60,Fail,48,35,3,14,34
60,Fail,46,34,0,14,32
60,Fail,52,27,0,21,31
60,Fail,43,36,3,18,25
60,Fail,46,36,0,14,32
60,Fail,48,35,5,12,36
60,Fail,50,37,0,12,38
60,Fail,45,40,0,9,36
60,Fail,48,31,0,13,35
60,Fail,42,33,0,18,24
60,Fail,45,39,0,11,34
60,Fail,48,38,4,10,38
60,Fail,41,39,2,18,23
60,Fail,49,38,0,10,39
60,Fail,49,29,8,14,35
60,Fail,49,33,0,12,37
60,Fail,49,38,1,12,37
60,Fail,42,40,8,10,32
60,Fail,48,41,0,8,40
60,Fail,48,36,0,15,33
60,Fail,46,36,0,13,33
60,Fail,41,39,7,13,28
60,Fail,46,38,3,13,33
60,Fail,48,35,4,13,35
60,Fail,52,34,0,14,38
60,Fail,51,34,2,13,38
60,Fail,58,32,0,9,49
60,Fail,56,34,0,9,47
60,Fail,53,32,1,14,39
60,Fail,51,36,3,10,41
60,Fail,48,42,0,8,40
60,Fail,43,41,1,15,28
60,Fail,40,32,14,14,26
60,Fail,52,27,0,15,37
60,Fail,43,40,7,10,33
60,Fail,46,40,4,10,36
60,Fail,44,41,0,12,32
60,Fail,49,34,2,15,34
60,Fail,51,30,3,16,35
60,Fail,47,34,3,16,31
60,Fail,41,41,10,8,33
60,Fail,53,34,0,12,41
60,Fail,48,31,0,16,32
60,Fail,47,43,0,9,38
60,Fail,43,37,0,14,29
60,Fail,48,29,9,14,34
60,Fail,47,31,0,19,28
60,Fail,49,36,0,15,34
60,Fail,50,36,2,12,38
60,Fail,51,31,3,15,36
60,Fail,45,33,0,16,29
60,Fail,51,33,4,12,39
60,Fail,56,32,0,12,44
60,Fail,52,31,0,16,36
60,Fail,53,35,2,10,43
60,Fail,47,32,0,17,30
60,Fail,48,36,0,15,33
60,Fail,51,32,5,12,39
60,Fail,45,31,4,20,25
60,Fail,50,36,0,14,36
60,Fail,47,40,0,11,36
60,Fail,46,30,10,14,32
60,Fail,46,35,4,15,31
60,Fail,45,32,0,10,35
60,Fail,41,35,0,15,26
60,Fail,49,31,0,17,32
60,Fail,42,43,0,13,29
60,Fail,48,33,0,17,31
60,Fail,45,34,0,11,34
60,Fail,52,31,0,12,40
60,Fail,43,38,0,14,29
60,Fail,44,36,4,16,28
60,Fail,52,30,0,15,37
60,Fail,55,27,0,16,39
60,Fail,49,34,5,12,37
60,Fail,57,32,0,10,47
60,Fail,52,29,0,18,34
60,Fail,48,35,0,16,32
60,Fail,53,31,1,15,38
60,Fail,47,35,0,11,36
60,Fail,50,33,6,11,39
60,Fail,54,29,0,12,42
60,Fail,57,30,0,7,50
60,Fail,47,36,0,11,36
60,Fail,47,33,0,15,32
60,Fail,56,26,0,11,45
60,Fail,47,33,0,12,35
60,Fail,49,42,0,8,41
60,Fail,39,39,0,17,22
60,Fail,45,35,3,17,28
60,Fail,46,38,0,14,32
60,Fail,48,38,2,12,36
60,Fail,41,32,11,16,25
60,Fail,53,35,0,12,41
60,Fail,47,41,6,6,41
60,Fail,52,34,0,10,42
60,Fail,48,36,8,8,40
60,Fail,50,34,0,10,40
60,Fail,53,31,0,11,42
60,Fail,51,35,2,12,39
60,Fail,50,30,0,14,36
60,Fail,49,33,1,17,32
60,Fail,41,43,0,14,27
60,Fail,44,38,0,17,27
60,Fail,55,36,0,9,46
60,Fail,51,35,0,6,45
60,Fail,49,36,0,13,36
60,Fail,50,35,0,15,35
60,Fail,51,37,1,11,40
60,Fail,51,33,6,10,41
60,Fail,46,45,0,8,38
60,Fail,42,39,0,18,24
60,Fail,51,36,4,9,42
60,Fail,48,39,2,11,37
60,Fail,47,37,2,14,33
60,Fail,46,36,0,11,35
60,Fail,41,35,0,12,29
60,Fail,43,42,0,8,35
60,Fail,50,32,6,12,38
60,Fail,49,38,0,9,40
60,Fail,48,40,0,12,36
60,Fail,49,36,4,11,38
60,Fail,50,34,2,14,36
60,Fail,46,36,10,8,38
60,Fail,53,34,0,11,42
60,Fail,56,32,0,11,45
60,Fail,50,30,0,14,36
60,Fail,55,25,0,14,41
60,Fail,41,40,0,16,25
60,Fail,45,41,2,12,33
60,Fail,49,35,4,12,37
60,Fail,50,35,0,13,37
60,Fail,54,22,13,11,43
60,Fail,55,31,0,8,47
60,Fail,44,37,4,15,29
60,Fail,48,35,2,15,33
60,Fail,50,34,0,15,35
60,Fail,51,35,4,10,41
60,Fail,50,31,0,15,35
60,Fail,54,33,6,7,47
60,Fail,50,33,5,12,38
60,Fail,47,36,0,13,34
60,Fail,51,32,0,16,35
60,Fail,45,35,0,19,26
60,Fail,47,37,3,13,34
60,Fail,54,36,0,7,47
60,Fail,47,39,0,10,37
60,Fail,48,38,0,14,34
60,Fail,44,42,0,10,34
60,Fail,37,43,8,12,25
60,Fail,51,33,0,13,38
60,Fail,45,39,0,15,30
60,Fail,51,38,0,11,40
60,Fail,44,31,4,21,23
60,Fail,46,33,0,15,31
60,Fail,41,41,0,18,23
60,Fail,42,39,0,11,31
60,Fail,41,40,0,16,25
60,Fail,46,39,5,10,36
60,Fail,51,31,0,15,36
60,Fail,44,37,8,11,33
60,Fail,57,31,0,11,46
60,Fail,56,32,1,11,45
60,Fail,48,37,8,7,41
60,Fail,50,33,3,14,36
60,Fail,42,36,0,19,23
60,Fail,44,32,0,15,29
60,Fail,49,36,2,13,36
60,Fail,42,42,0,9,33
60,Fail,47,29,0,16,31
60,Fail,41,28,10,21,20
60,Fail,40,39,0,14,26
60,Fail,40,37,7,16,24
60,Fail,47,44,0,9,38
60,Fail,43,34,10,13,30
60,Fail,51,39,3,7,44
60,Fail,46,35,3,16,30
60,Fail,48,33,6,13,35
60,Fail,46,36,5,13,33
60,Fail,48,33,0,19,29
60,Fail,53,32,0,12,41
60,Fail,44,39,1,16,28
60,Fail,52,32,0,16,36
60,Fail,49,38,0,13,36
60,Fail,49,33,0,13,36
60,Fail,47,37,0,12,35
60,Fail,47,40,0,13,34
60,Fail,52,35,0,10,42
60,Fail,56,28,0,12,44
60,Fail,46,36,0,16,30
60,Fail,45,37,8,10,35
60,Fail,42,42,6,10,32
60,Fail,50,36,3,11,39
60,Fail,51,34,0,13,38
60,Fail,44,37,0,11,33
60,Fail,60,31,2,7,53
60,Fail,44,38,2,16,28
60,Fail,51,36,3,10,41
60,Fail,53,34,0,10,43
60,Fail,45,37,0,16,29
60,Fail,49,35,3,13,36
60,Fail,55,34,0,8,47
60,Fail,53,30,4,13,40
60,Fail,55,31,2,12,43
60,Fail,44,35,10,11,33
60,Fail,53,34,0,12,41
60,Fail,39,32,0,22,17
60,Fail,47,41,0,11,36
60,Fail,32,43,5,20,12
60,Fail,47,35,3,15,32
60,Fail,52,34,1,13,39
60,Fail,43,37,2,18,25
60,Fail,43,44,0,12,31
60,Fail,49,41,0,8,41
60,Fail,52,37,0,11,41
60,Fail,46,34,0,17,29
60,Fail,44,40,0,13,31
60,Fail,50,43,1,6,44
60,Fail,55,34,0,11,44
60,Fail,52,35,0,9,43
60,Fail,50,37,6,7,43
60,Fail,49,34,6,11,38
60,Fail,48,38,0,10,38
60,Fail,47,37,1,15,32
60,Fail,38,36,16,10,28
60,Fail,54,34,0,11,43
60,Fail,49,28,5,18,31
60,Fail,49,32,0,19,30
60,Fail,53,32,0,9,44
60,Fail,57,30,0,11,46
60,Fail,49,28,12,11,38
60,Fail,46,34,5,15,31
60,Fail,47,28,0,15,32
60,Fail,53,34,4,9,44
60,Fail,46,38,0,10,36
60,Fail,58,30,2,10,48
60,Fail,44,37,0,17,27
60,Fail,43,43,0,13,30
60,Fail,50,37,0,13,37
60,Fail,49,30,0,14,35
60,Fail,41,30,10,19,22
60,Fail,49,31,5,15,34
60,Fail,58,32,2,8,50
60,Fail,43,42,0,12,31
60,Fail,54,39,0,4,50
60,Fail,41,47,0,6,35
60,Fail,51,38,0,8,43
60,Fail,53,30,3,14,39
60,Fail,45,37,1,17,28
60,Fail,40,39,7,14,26
60,Fail,49,35,0,16,33
60,Fail,44,30,0,11,33
60,Fail,47,32,0,16,31
60,Fail,46,32,6,16,30
60,Fail,54,30,4,12,42
60,Fail,47,31,0,19,28
60,Fail,50,38,2,10,40
60,Fail,45,42,0,12,33
60,Fail,53,33,0,8,45
60,Fail,44,34,0,15,29
60,Fail,44,42,1,13,31
60,Fail,47,35,9,9,38
60,Fail,47,33,0,19,28
60,Fail,45,39,0,14,31
60,Fail,47,36,5,12,35
60,Fail,51,35,6,8,43
60,Fail,53,34,5,8,45
60,Fail,44,37,0,18,26
60,Fail,42,41,0,14,28
60,Fail,49,34,2,15,34
60,Fail,46,35,4,15,31
60,Fail,48,30,6,16,32
60,Fail,47,33,0,17,30
60,Fail,48,41,1,10,38
60,Fail,45,42,1,12,33
60,Fail,47,42,1,10,37
60,Fail,46,41,1,12,34
60,Fail,41,40,0,14,27
60,Fail,47,38,0,11,36
60,Fail,51,38,0,11,40
60,Fail,40,28,0,17,23
60,Fail,49,34,0,8,41
60,Fail,52,31,0,16,36
60,Fail,50,39,0,10,40
60,Fail,48,34,0,16,32
60,Fail,51,29,6,14,37
60,Fail,48,34,4,14,34
60,Fail,48,42,0,7,41
60,Fail,41,37,2,20,21
60,Fail,50,36,0,14,36
60,Fail,46,35,0,12,34
60,Fail,55,33,0,12,43
60,Fail,47,42,0,11,36
60,Fail,48,32,0,17,31
60,Fail,49,35,3,13,36
60,Fail,47,32,0,12,35
60,Fail,43,33,4,20,23
60,Fail,43,39,8,10,33
60,Fail,49,34,0,17,32
60,Fail,48,38,5,9,39
60,Fail,46,42,3,9,37
60,Fail,47,30,10,13,34
60,Fail,44,40,0,11,33
60,Fail,44,37,3,16,28
60,Fail,50,36,0,14,36
60,Fail,49,33,5,13,36
60,Fail,49,26,7,18,31
60,Fail,50,36,6,8,42
60,Fail,56,37,1,6,50
60,Fail,45,35,0,8,37
60,Fail,51,40,0,9,42
60,Fail,49,37,0,12,37
60,Fail,51,39,0,10,41
60,Fail,48,38,3,11,37
60,Fail,47,41,0,10,37
60,Fail,45,41,1,13,32
60,Fail,46,38,0,13,33
60,Fail,43,34,7,16,27
60,Fail,49,34,0,14,35
60,Fail,45,41,2,12,33
60,Fail,47,37,0,16,31
60,Fail,44,43,0,12,32
60,Fail,46,37,0,14,32
60,Fail,45,36,8,11,34
60,Fail,47,35,0,15,32
60,Fail,40,34,10,16,24
60,Fail,50,41,0,8,42
60,Fail,47,28,4,21,26
60,Fail,48,34,0,15,33
60,Fail,48,38,0,14,34
60,Fail,52,32,4,12,40
60,Fail,48,39,1,12,36
60,Fail,44,39,0,13,31
60,Fail,50,33,12,5,45
60,Fail,49,35,0,12,37
60,Fail,47,38,1,14,33
60,Fail,51,34,6,9,42
60,Fail,45,33,14,8,37
60,Fail,45,42,2,11,34
60,Fail,45,38,0,16,29
60,Fail,49,34,4,13,36
60,Fail,45,36,6,13,32
60,Fail,46,42,1,11,35
60,Fail,44,36,0,17,27
60,Fail,41,33,0,19,22
60,Fail,53,37,1,9,44
60,Fail,46,29,0,13,33
60,Fail,51,35,3,11,40
60,Fail,38,40,5,17,21
60,Fail,47,36,5,12,35
60,Fail,46,39,0,9,37
60,Fail,37,35,8,20,17
60,Fail,38,40,6,16,22
60,Fail,50,33,0,13,37
60,Fail,54,30,0,14,40
60,Fail,46,38,10,6,40
60,Fail,54,30,0,14,40
60,Fail,44,34,0,9,35
60,Fail,44,36,6,14,30
60,Fail,47,37,0,16,31
60,Fail,46,33,0,19,27
60,Fail,45,38,2,15,30
60,Fail,46,42,3,9,37
60,Fail,47,33,0,16,31
60,Fail,43,35,0,13,30
60,Fail,47,37,2,14,33
60,Fail,53,33,7,7,46
60,Fail,40,47,0,12,28
60,Fail,48,43,0,7,41
60,Fail,45,35,0,15,30
60,Fail,48,30,8,14,34
60,Fail,46,44,0,10,36
60,Fail,51,31,1,17,34
60,Fail,43,38,0,16,27
60,Fail,49,35,7,9,40
60,Fail,48,37,0,12,36
60,Fail,42,36,0,13,29
60,Fail,50,31,0,12,38
60,Fail,48,36,0,15,33
60,Fail,49,44,0,7,42
60,Fail,55,29,7,9,46
60,Fail,61,21,0,10,51
60,Fail,42,43,3,12,30
60,Fail,46,36,3,15,31
60,Fail,49,33,1,17,32
60,Fail,54,31,2,13,41
60,Fail,46,39,6,9,37
60,Fail,40,41,0,19,21
60,Fail,49,34,9,8,41
60,Fail,52,32,0,10,42
60,Fail,44,39,5,12,32
60,Fail,58,25,0,13,45
60,Fail,50,34,4,12,38
60,Fail,52,36,1,11,41
60,Fail,42,34,0,12,30
60,Fail,54,35,0,7,47
60,Fail,52,34,0,10,42
60,Fail,42,43,0,12,30
60,Fail,47,30,0,16,31
60,Fail,56,36,1,7,49
60,Fail,42,40,0,9,33
60,Fail,47,34,9,10,37
60,Fail,52,32,5,11,41
60,Fail,46,32,9,13,33
60,Fail,47,41,0,11,36
60,Fail,45,34,7,14,31
60,Fail,43,36,9,12,31
60,Fail,44,37,5,14,30
60,Fail,52,30,3,15,37
60,Fail,51,32,0,15,36
60,Fail,52,40,0,7,45
60,Fail,49,39,2,10,39
60,Fail,47,33,0,13,34
60,Fail,50,29,0,16,34
60,Fail,40,43,0,17,23
60,Fail,42,42,7,9,33
60,Fail,40,34,0,20,20
60,Fail,46,36,0,17,29
60,Fail,45,40,1,14,31
60,Fail,49,33,0,11,38
60,Fail,51,44,0,5,46
60,Fail,53,30,6,11,42
60,Fail,50,35,0,11,39
60,Fail,49,33,0,13,36
60,Fail,52,38,0,8,44
60,Fail,50,35,2,13,37
60,Fail,54,34,5,7,47
60,Fail,43,37,0,18,25
60,Fail,46,36,0,17,29
60,Fail,48,32,0,13,35
60,Fail,45,42,4,9,36
60,Fail,47,32,2,19,28
60,Fail,46,33,7,14,32
60,Fail,50,28,7,15,35
60,Fail,45,34,1,20,25
60,Fail,55,32,0,10,45
60,Fail,44,34,6,16,28
60,Fail,58,35,0,7,51
60,Fail,48,37,0,11,37
60,Fail,48,35,0,7,41
60,Fail,40,37,0,19,21
60,Fail,56,33,1,10,46
60,Fail,46,37,4,13,33
60,Fail,42,40,4,14,28
60,Fail,44,40,0,11,33
60,Fail,49,43,1,7,42
60,Fail,48,40,4,8,40
60,Fail,45,41,0,12,33
60,Fail,40,39,0,15,25
60,Fail,41,41,5,13,28
60,Fail,49,35,5,11,38
60,Fail,49,42,1,8,41
60,Fail,58,28,3,11,47
60,Fail,52,34,3,11,41
60,Fail,50,36,0,13,37
60,Fail,46,35,0,14,32
60,Fail,45,38,0,12,33
60,Fail,47,42,1,10,37
60,Fail,51,41,0,8,43
60,Fail,41,35,7,17,24
60,Fail,48,36,0,8,40
60,Fail,47,35,0,15,32
60,Fail,41,43,0,16,25
60,Fail,50,37,1,12,38
60,Fail,42,31,5,22,20
60,Fail,48,39,0,11,37
60,Fail,57,30,0,12,45
60,Fail,53,30,6,11,42
60,Fail,47,33,10,10,37
60,Fail,41,41,0,15,26
60,Fail,52,37,0,6,46
60,Fail,51,34,0,13,38
60,Fail,43,36,0,15,28
60,Fail,43,44,4,9,34
60,Fail,52,32,4,12,40
60,Fail,47,31,5,17,30
60,Fail,46,38,0,15,31
60,Fail,47,36,5,12,35
60,Fail,43,42,7,8,35
60,Fail,43,33,0,22,21
60,Fail,52,32,2,14,38
60,Fail,52,36,0,11,41
60,Fail,56,27,7,10,46
60,Fail,43,39,0,13,30
60,Fail,47,32,0,13,34
60,Fail,49,30,6,15,34
60,Fail,45,37,2,16,29
60,Fail,45,34,2,19,26
60,Fail,50,36,3,11,39
60,Fail,57,32,0,11,46
60,Fail,48,42,1,9,39
60,Fail,53,32,0,11,42
60,Fail,45,36,0,18,27
60,Fail,50,36,2,12,38
60,Fail,46,31,0,13,33
60,Fail,44,44,0,10,34
60,Fail,48,39,0,9,39
60,Fail,45,36,0,12,33
60,Fail,47,39,0,12,35
60,Fail,45,38,0,14,31
60,Fail,51,29,3,17,34
60,Fail,40,37,12,11,29
60,Fail,44,38,1,17,27
60,Fail,53,27,0,16,37
60,Fail,43,37,7,13,30
60,Fail,37,45,0,17,20
60,Fail,46,40,1,13,33
60,Fail,55,36,1,8,47
60,Fail,45,37,0,12,33
60,Fail,44,35,12,9,35
60,Fail,44,44,0,9,35
60,Fail,48,39,4,9,39
60,Fail,42,35,0,16,26
60,Fail,51,26,0,15,36
60,Fail,52,35,0,12,40
60,Fail,46,38,4,12,34
60,Fail,48,32,0,12,36
60,Fail,54,32,0,7,47
60,Fail,44,37,10,9,35
60,Fail,43,43,2,12,31
60,Fail,57,27,2,14,43
60,Fail,45,38,0,17,28
60,Fail,46,41,0,10,36
60,Fail,44,42,5,9,35
60,Fail,49,40,0,11,38
60,Fail,55,32,5,8,47
60,Fail,53,36,0,10,43
60,Fail,51,39,1,9,42
60,Fail,40,41,3,16,24
60,Fail,46,37,0,13,33
60,Fail,42,37,9,12,30
60,Fail,45,42,1,12,33
60,Fail,48,35,0,10,38
60,Fail,46,36,0,14,32
60,Fail,36,42,0,17,19
60,Fail,43,41,0,12,31
60,Fail,45,36,3,16,29
60,Fail,47,36,0,13,34
60,Fail,42,42,0,13,29
60,Fail,48,41,0,8,40
60,Fail,43,33,0,19,24
60,Fail,45,37,0,16,29
60,Fail,52,37,0,10,42
60,Fail,44,41,0,13,31
60,Fail,43,37,1,19,24
60,Fail,40,40,0,12,28
60,Fail,44,38,2,16,28
60,Fail,48,36,3,13,35
60,Fail,49,28,9,14,35
60,Fail,43,36,0,14,29
60,Fail,46,38,0,15,31
60,Fail,47,37,0,10,37
60,Fail,48,39,2,11,37
60,Fail,59,29,0,9,50
60,Fail,46,31,0,14,32
60,Fail,44,39,0,8,36
60,Fail,52,34,0,11,41
60,Fail,39,47,0,12,27
60,Fail,47,32,9,12,35
60,Fail,35,48,2,15,20
60,Fail,45,36,0,17,28
60,Fail,43,32,0,19,24
60,Fail,43,41,0,13,30
60,Fail,50,30,0,14,36
60,Fail,40,37,6,17,23
60,Fail,47,36,1,16,31
60,Fail,45,33,0,16,29
60,Fail,48,39,0,10,38
60,Fail,53,31,0,15,38
60,Fail,48,38,1,13,35
60,Fail,48,37,5,10,38
60,Fail,47,39,3,11,36
60,Fail,48,36,0,13,35
60,Fail,59,27,1,13,46
60,Fail,44,31,12,13,31
60,Fail,50,34,0,11,39
60,Fail,45,44,1,10,35
60,Fail,51,33,3,13,38
60,Fail,46,38,0,12,34
60,Fail,50,32,2,16,34
60,Fail,50,36,2,12,38
60,Fail,50,37,1,12,38
60,Fail,44,39,7,10,34
60,Fail,49,33,6,12,37
60,Fail,50,35,0,12,38
60,Fail,50,35,0,11,39
60,Fail,53,39,0,6,47
60,Fail,45,32,9,14,31
60,Fail,49,37,1,13,36
60,Fail,47,38,0,10,37
60,Fail,52,36,0,10,42
60,Fail,45,36,0,18,27
60,Fail,48,39,1,12,36
60,Fail,63,26,0,9,54
60,Fail,51,30,10,9,42
60,Fail,47,35,4,14,33
60,Fail,44,30,0,19,25
60,Fail,47,36,0,9,38
60,Fail,50,39,0,8,42
60,Fail,50,37,2,11,39
60,Fail,49,35,5,11,38
60,Fail,49,30,5,16,33
60,Fail,47,32,0,15,32
60,Fail,47,40,0,13,34
60,Fail,44,36,6,14,30
60,Fail,41,35,10,14,27
60,Fail,43,35,0,18,25
60,Fail,45,28,13,14,31
60,Fail,47,38,1,14,33
60,Fail,44,43,2,11,33
60,Fail,52,36,0,9,43
60,Fail,44,42,0,13,31
60,Fail,49,35,0,10,39
60,Fail,52,37,0,11,41
60,Fail,46,39,0,9,37
60,Fail,48,32,2,18,30
60,Fail,47,40,0,11,36
60,Fail,52,26,0,14,38
60,Fail,46,33,3,18,28
60,Fail,49,37,0,11,38
60,Fail,51,37,0,12,39
60,Fail,47,34,0,7,40
60,Fail,42,39,0,10,32
60,Fail,48,40,3,9,39
60,Fail,47,37,0,10,37
60,Fail,42,44,4,10,32
60,Fail,48,43,1,8,40
60,Fail,45,38,0,9,36
60,Fail,40,35,6,19,21
60,Fail,55,31,0,10,45
60,Fail,50,34,1,15,35
60,Fail,49,35,4,12,37
60,Fail,45,35,7,13,32
60,Fail,44,35,10,11,33
60,Fail,48,34,0,17,31
60,Fail,57,33,0,8,49
60,Fail,55,32,0,13,42
60,Fail,45,41,0,14,31
60,Fail,54,30,0,15,39
60,Fail,47,40,0,11,36
60,Fail,51,32,5,12,39
60,Fail,54,33,0,13,41
60,Fail,44,42,0,10,34
60,Fail,57,34,3,6,51
60,Fail,48,38,0,12,36
60,Fail,54,30,0,14,40
60,Fail,50,33,0,13,37
60,Fail,48,39,3,10,38
60,Fail,43,37,0,13,30
60,Fail,45,38,1,16,29
60,Fail,51,37,0,7,44
60,Fail,42,40,3,15,27
60,Fail,50,38,0,11,39
60,Fail,46,36,6,12,34
60,Fail,50,33,5,12,38
60,Fail,55,35,1,9,46
60,Fail,41,36,6,17,24
60,Fail,40,34,8,18,22
60,Fail,57,33,0,10,47
60,Fail,48,33,3,16,32
60,Fail,41,45,0,7,34
60,Fail,47,32,5,16,31
60,Fail,41,43,2,14,27
60,Fail,51,38,2,9,42
60,Fail,42,39,9,10,32
60,Fail,48,36,1,15,33
60,Fail,48,39,0,12,36
60,Fail,47,40,3,10,37
60,Fail,44,31,6,19,25
60,Fail,52,35,0,12,40
60,Fail,58,29,3,10,48
60,Fail,53,33,0,14,39
60,Fail,51,32,5,12,39
60,Fail,48,30,0,17,31
60,Fail,48,35,6,11,37
60,Fail,44,41,0,14,30
60,Fail,55,29,6,10,45
60,Fail,46,38,0,14,32
60,Fail,50,34,1,15,35
60,Fail,43,36,6,15,28
60,Fail,48,35,0,14,34
60,Fail,55,33,3,9,46
60,Fail,42,39,2,17,25
60,Fail,46,42,0,11,35
60,Fail,51,32,0,10,41
60,Fail,46,40,0,14,32
60,Fail,54,36,0,8,46
60,Fail,43,41,0,16,27
60,Fail,49,33,2,16,33
60,Fail,52,36,3,9,43
60,Fail,40,50,0,10,30
60,Fail,54,32,0,13,41
60,Fail,48,36,3,13,35
60,Fail,42,47,0,6,36
60,Fail,51,39,1,9,42
60,Fail,52,33,0,9,43
60,Fail,46,41,1,12,34
60,Fail,46,34,0,17,29
60,Fail,49,38,0,13,36
60,Fail,43,39,0,18,25
60,Fail,46,35,0,14,32
60,Fail,53,31,2,14,39
60,Fail,41,39,0,13,28
60,Fail,56,35,1,8,48
60,Fail,57,33,1,9,48
60,Fail,41,43,7,9,32
60,Fail,38,40,3,19,19
60,Fail,59,30,0,5,54
60,Fail,52,33,0,15,37
60,Fail,54,31,6,9,45
60,Fail,55,36,1,8,47
60,Fail,51,36,0,12,39
60,Fail,50,39,1,10,40
60,Fail,50,35,3,12,38
60,Fail,46,36,6,12,34
60,Fail,53,38,0,9,44
60,Fail,50,44,0,6,44
60,Fail,48,37,3,12,36
60,Fail,46,37,0,11,35
60,Fail,50,34,3,13,37
60,Fail,47,37,0,9,38
60,Fail,45,43,1,11,34
60,Fail,51,40,0,6,45
60,Fail,54,23,3,20,34
60,Fail,49,31,8,12,37
60,Fail,50,39,5,6,44
60,Fail,47,34,0,10,37
60,Fail,47,37,0,16,31
60,Fail,43,36,0,19,24
60,Fail,42,44,0,11,31
60,Fail,45,38,0,15,30
60,Fail,45,36,0,13,32
60,Fail,57,32,1,10,47
60,Fail,45,32,0,15,30
60,Fail,48,34,0,18,30
60,Fail,49,36,4,11,38
60,Fail,43,36,0,14,29
60,Fail,47,30,7,16,31
60,Fail,51,35,4,10,41
60,Fail,39,35,13,13,26
60,Fail,43,36,0,13,30
60,Fail,50,35,3,12,38
60,Fail,52,33,0,14,38
60,Fail,45,38,0,14,31
60,Fail,42,34,0,16,26
60,Fail,52,35,0,10,42
60,Fail,46,26,0,14,32
60,Fail,42,41,0,14,28
60,Fail,46,36,0,13,33
60,Fail,44,35,4,17,27
60,Fail,39,44,7,10,29
60,Fail,53,34,0,12,41
60,Fail,57,38,1,4,53
60,Fail,41,44,2,13,28
60,Fail,46,42,0,11,35
60,Fail,50,29,5,16,34
60,Fail,55,35,0,10,45
60,Fail,57,28,1,14,43
60,Fail,50,28,6,16,34
60,Fail,46,37,6,11,35
60,Fail,49,30,0,16,33
60,Fail,51,34,3,12,39
60,Fail,49,35,0,15,34
60,Fail,47,30,12,11,36
60,Fail,51,31,4,14,37
60,Fail,51,37,0,11,40
60,Fail,53,27,2,18,35
60,Fail,51,38,0,9,42
60,Fail,42,30,10,18,24
60,Fail,48,36,0,16,32
60,Fail,44,38,0,14,30
60,Fail,44,35,0,17,27
60,Fail,47,43,0,10,37
60,Fail,45,39,6,10,35
60,Fail,47,35,0,15,32
60,Fail,45,38,6,11,34
60,Fail,49,39,0,11,38
60,Fail,41,42,0,10,31
60,Fail,52,28,7,13,39
60,Fail,46,38,7,9,37
60,Fail,46,34,0,19,27
60,Fail,44,36,0,13,31
60,Fail,48,39,2,11,37
60,Fail,46,37,8,9,37
60,Fail,46,34,0,17,29
60,Fail,45,29,16,10,35
60,Fail,55,29,0,12,43
60,Fail,45,33,3,19,26
60,Fail,45,36,0,14,31
60,Fail,46,32,11,11,35
60,Fail,49,34,4,13,36
60,Fail,55,28,4,13,42
60,Fail,51,32,0,14,37
60,Fail,51,38,2,9,42
60,Fail,55,28,0,12,43
60,Fail,55,35,3,7,48
60,Fail,52,30,0,13,39
60,Fail,56,35,0,9,47
60,Fail,52,28,8,12,40
60,Fail,50,34,5,11,39
60,Fail,46,30,12,12,34
60,Fail,50,32,10,8,42
60,Fail,59,31,0,9,50
60,Fail,45,36,6,13,32
60,Fail,51,35,2,12,39
60,Fail,55,32,2,11,44
60,Fail,49,32,7,12,37
60,Fail,47,41,0,12,35
60,Fail,58,30,0,12,46
60,Fail,47,34,2,17,30
60,Fail,51,36,1,12,39
60,Fail,50,35,0,13,37
60,Fail,44,34,0,17,27
60,Fail,46,33,0,8,38
60,Fail,51,33,2,14,37
60,Fail,48,36,0,13,35
60,Fail,39,41,10,10,29
60,Fail,52,39,1,8,44
60,Fail,47,38,3,12,35
60,Fail,45,37,0,11,34
60,Fail,50,34,1,15,35
60,Fail,50,35,0,12,38
60,Fail,50,33,5,12,38
60,Fail,48,35,0,17,31
60,Fail,54,28,0,12,42
60,Fail,45,33,5,17,28
60,Fail,46,42,0,12,34
60,Fail,47,40,0,12,35
60,Fail,46,39,0,9,37
60,Fail,52,35,2,11,41
60,Fail,50,34,6,10,40
60,Fail,46,42,0,11,35
60,Fail,50,35,0,13,37
60,Fail,43,44,4,9,34
60,Fail,51,30,6,13,38
60,Fail,55,31,0,12,43
60,Fail,54,32,0,7,47
60,Fail,53,29,0,15,38
60,Fail,46,35,0,18,28
60,Fail,49,33,7,11,38
60,Fail,49,32,6,13,36
60,Fail,48,35,0,17,31
60,Fail,39,42,0,14,25
60,Fail,40,39,5,16,24
60,Fail,51,35,0,13,38
60,Fail,49,36,0,8,41
60,Fail,48,40,2,10,38
60,Fail,50,38,3,9,41
60,Fail,50,34,0,10,40
60,Fail,43,42,4,11,32
60,Fail,45,40,0,12,33
60,Fail,45,44,0,10,35
60,Fail,42,34,8,16,26
60,Fail,53,39,0,7,46
60,Fail,56,24,4,16,40
60,Fail,48,34,2,16,32
60,Fail,45,45,0,10,35
60,Fail,45,38,3,14,31
60,Fail,49,36,0,12,37
60,Fail,43,41,0,11,32
60,Fail,52,36,1,11,41
60,Fail,51,37,2,10,41
60,Fail,54,30,4,12,42
60,Fail,52,35,0,11,41
60,Fail,55,32,4,9,46
60,Fail,48,35,6,11,37
60,Fail,52,33,1,14,38
60,Fail,56,30,0,7,49
60,Fail,51,36,5,8,43
60,Fail,47,32,5,16,31
60,Fail,49,34,0,10,39
60,Fail,48,40,2,10,38
60,Fail,55,34,3,8,47
60,Fail,45,34,0,17,28
60,Fail,39,41,0,18,21
60,Fail,55,28,2,15,40
60,Fail,48,29,7,16,32
60,Fail,43,37,0,13,30
60,Fail,51,36,0,7,44
60,Fail,49,32,3,16,33
60,Fail,50,29,0,13,37
60,Fail,50,40,0,10,40
60,Fail,43,32,0,15,28
60,Fail,56,34,0,10,46
60,Fail,46,38,0,13,33
60,Fail,56,28,0,13,43
60,Fail,55,36,0,9,46
60,Fail,62,26,0,11,51
60,Fail,50,31,0,14,36
60,Fail,47,37,9,7,40
60,Fail,48,27,13,12,36
60,Fail,43,37,0,17,26
60,Fail,49,32,0,16,33
60,Fail,51,33,6,10,41
60,Fail,52,39,0,9,43
60,Fail,48,42,0,9,39
60,Fail,51,39,0,7,44
60,Fail,53,38,4,5,48
60,Fail,48,38,1,13,35
60,Fail,55,28,6,11,44
60,Fail,49,36,1,14,35
60,Fail,55,33,2,10,45
60,Fail,50,29,6,15,35
60,Fail,43,34,12,11,32
60,Fail,43,36,3,18,25
60,Fail,47,35,3,15,32
60,Fail,46,36,6,12,34
60,Fail,56,35,0,6,50
60,Fail,47,33,1,19,28
60,Fail,44,40,0,11,33
60,Fail,61,28,0,9,52
60,Fail,48,33,4,15,33
60,Fail,54,32,2,12,42
60,Fail,59,27,0,13,46
60,Fail,43,42,0,13,30
60,Fail,48,34,2,16,32
60,Fail,36,37,4,23,13
60,Fail,44,36,3,17,27
60,Fail,52,38,0,6,46
60,Fail,46,40,3,11,35
60,Fail,53,34,0,13,40
60,Fail,40,39,2,19,21
60,Fail,47,33,6,14,33
60,Fail,48,35,1,16,32
60,Fail,42,40,0,12,30
60,Fail,53,36,4,7,46
60,Fail,55,32,3,10,45
60,Fail,53,28,5,14,39
60,Fail,48,39,0,12,36
60,Fail,44,38,0,16,28
60,Fail,48,41,0,11,37
60,Fail,46,43,1,10,36
60,Fail,50,34,4,12,38
60,Fail,52,39,3,6,46
60,Fail,43,40,0,14,29
60,Fail,44,34,4,18,26
60,Fail,53,35,3,9,44
60,Fail,49,38,0,13,36
60,Fail,46,39,0,12,34
60,Fail,55,28,0,13,42
60,Fail,54,34,0,12,42
60,Fail,39,43,0,9,30
60,Fail,53,35,4,8,45
60,Fail,34,33,22,11,23
60,Fail,46,37,0,6,40
60,Fail,44,41,0,15,29
60,Fail,46,39,0,13,33
60,Fail,47,40,1,12,35
60,Fail,40,37,0,16,24
60,Fail,48,33,0,14,34
60,Fail,47,31,0,18,29
60,Fail,49,36,0,12,37
60,Fail,37,39,0,18,19
60,Fail,45,37,0,15,30
60,Fail,46,42,0,12,34
60,Fail,51,34,0,11,40
60,Fail,50,32,0,11,39
60,Fail,44,39,0,16,28
60,Fail,52,31,0,17,35
60,Fail,38,42,7,13,25
60,Fail,42,46,0,10,32
60,Fail,47,41,0,9,38
60,Fail,50,37,0,13,37
60,Fail,45,41,3,11,34
60,Fail,49,34,4,13,36
60,Fail,42,37,0,19,23
60,Fail,52,30,0,15,37
60,Fail,45,39,0,10,35
60,Fail,47,32,2,19,28
60,Fail,46,39,0,14,32
60,Fail,43,40,0,15,28
60,Fail,50,35,0,15,35
60,Fail,52,31,0,15,37
60,Fail,54,35,0,11,43
60,Fail,49,43,0,8,41
60,Fail,40,42,8,10,30
60,Fail,49,36,5,10,39
60,Fail,50,36,0,11,39
60,Fail,49,31,8,12,37
60,Fail,55,38,0,5,50
60,Fail,45,42,1,12,33
60,Fail,49,38,2,11,38
60,Fail,49,41,0,9,40
60,Fail,42,40,0,13,29
60,Fail,53,32,0,8,45
60,Fail,56,31,3,10,46
60,Fail,46,41,0,13,33
60,Fail,44,39,0,16,28
60,Fail,51,36,0,10,41
60,Fail,57,27,0,13,44
60,Fail,41,34,0,15,26
60,Fail,50,37,0,10,40
60,Fail,49,43,0,7,42
60,Fail,48,33,0,11,37
60,Fail,50,37,0,9,41
60,Fail,46,29,0,16,30
60,Fail,47,35,0,10,37
60,Fail,39,42,4,15,24
60,Fail,48,32,2,18,30
60,Fail,40,44,0,9,31
60,Fail,45,40,0,11,34
60,Fail,43,42,0,13,30
60,Fail,40,38,0,18,22
60,Fail,53,36,0,11,42
60,Fail,50,40,0,8,42
60,Fail,50,39,4,7,43
60,Fail,41,44,1,14,27
60,Fail,53,33,0,12,41
60,Fail,55,29,0,13,42
60,Fail,49,39,0,12,37
60,Fail,56,35,0,9,47
60,Fail,47,34,0,18,29
60,Fail,39,36,0,22,17
60,Fail,49,29,0,14,35
60,Fail,43,27,10,20,23
60,Fail,48,29,9,14,34
60,Fail,50,33,0,11,39
60,Fail,57,32,0,10,47
60,Fail,54,34,0,9,45
60,Fail,42,39,0,19,23
60,Fail,48,36,1,15,33
60,Fail,48,38,3,11,37
60,Fail,45,35,0,17,28
60,Fail,56,34,0,9,47
60,Fail,50,29,0,15,35
60,Fail,38,42,6,14,24
60,Fail,48,38,0,14,34
60,Fail,48,39,0,13,35
60,Fail,55,33,0,12,43
60,Fail,41,41,5,13,28
60,Fail,51,33,3,13,38
60,Fail,45,33,0,17,28
60,Fail,47,41,0,8,39
60,Fail,48,40,0,9,39
60,Fail,44,36,6,14,30
60,Fail,48,34,0,16,32
60,Fail,51,35,1,13,38
60,Fail,46,29,0,15,31
60,Fail,48,39,1,12,36
60,Fail,48,40,0,10,38
60,Fail,49,35,0,12,37
60,Fail,47,35,5,13,34
60,Fail,46,34,0,16,30
60,Fail,47,37,3,13,34
60,Fail,47,42,6,5,42
60,Fail,49,36,0,10,39
60,Fail,54,36,0,9,45
60,Fail,45,38,0,13,32
60,Fail,52,32,3,13,39
60,Fail,41,36,6,17,24
60,Fail,45,36,0,18,27
60,Fail,48,34,2,16,32
60,Fail,45,37,6,12,33
60,Fail,53,32,0,14,39
60,Fail,40,40,0,14,26
60,Fail,49,37,2,12,37
60,Fail,46,40,6,8,38
60,Fail,46,43,3,8,38
60,Fail,45,36,6,13,32
60,Fail,49,32,4,15,34
60,Fail,55,29,0,12,43
60,Fail,43,39,0,12,31
60,Fail,48,40,1,11,37
60,Fail,44,42,0,8,36
60,Fail,47,39,0,9,38
60,Fail,44,35,0,16,28
60,Fail,48,31,0,19,29
60,Fail,48,27,14,11,37
60,Fail,46,27,0,18,28
60,Fail,51,34,0,12,39
60,Fail,48,36,0,14,34
60,Fail,45,34,0,13,32
60,Fail,50,38,0,12,38
60,Fail,46,39,0,10,36
60,Fail,52,30,0,9,43
60,Fail,49,31,0,17,32
60,Fail,55,33,0,12,43
60,Fail,43,36,0,12,31
60,Fail,48,37,0,12,36
60,Fail,49,41,0,7,42
60,Fail,42,37,0,15,27
60,Fail,56,31,0,11,45
60,Fail,40,37,0,9,31
60,Fail,48,34,7,11,37
60,Fail,45,35,0,20,25
60,Fail,45,39,0,9,36
60,Fail,50,34,0,13,37
60,Fail,44,39,6,11,33
60,Fail,56,28,0,13,43
60,Fail,46,40,1,13,33
60,Fail,51,32,0,15,36
60,Fail,44,43,3,10,34
60,Fail,48,39,0,10,38
60,Fail,45,38,0,16,29
60,Fail,39,40,0,15,24
60,Fail,44,35,3,18,26
60,Fail,48,38,0,14,34
60,Fail,44,36,0,19,25
60,Fail,41,42,0,12,29
60,Fail,50,35,0,8,42
60,Fail,49,35,0,14,35
60,Fail,44,35,0,9,35
60,Fail,47,43,0,7,40
60,Fail,40,48,2,10,30
60,Fail,42,44,0,13,29
60,Fail,57,27,4,12,45
60,Fail,45,35,0,13,32
60,Fail,46,36,0,9,37
60,Fail,54,27,5,14,40
60,Fail,60,25,0,12,48
60,Fail,49,34,6,11,38
60,Fail,44,36,0,20,24
60,Fail,55,33,0,12,43
60,Fail,46,34,0,14,32
60,Fail,49,37,0,9,40
60,Fail,46,36,4,14,32
60,Fail,52,30,3,15,37
60,Fail,48,34,2,16,32
60,Fail,50,34,7,9,41
60,Fail,52,29,0,14,38
60,Fail,51,27,0,16,35
60,Fail,44,42,0,10,34
60,Fail,44,42,0,14,30
60,Fail,54,35,1,10,44
60,Fail,47,42,0,11,36
60,Fail,52,35,0,8,44
60,Fail,46,29,3,22,24
60,Fail,46,37,3,14,32
60,Fail,46,26,8,20,26
60,Fail,44,40,0,13,31
60,Fail,48,24,12,16,32
60,Fail,50,27,5,18,32
60,Fail,51,30,5,14,37
60,Fail,49,34,9,8,41
60,Fail,52,37,1,10,42
60,Fail,48,32,5,15,33
60,Fail,46,33,0,16,30
60,Fail,45,36,4,15,30
60,Fail,52,34,2,12,40
60,Fail,44,31,0,17,27
60,Fail,52,32,3,13,39
60,Fail,43,38,0,12,31
60,Fail,52,38,1,9,43
60,Fail,52,34,0,12,40
60,Fail,54,37,0,8,46
60,Fail,47,33,0,16,31
60,Fail,55,30,0,12,43
60,Fail,52,32,4,12,40
60,Fail,51,31,0,13,38
60,Fail,51,40,0,8,43
60,Fail,50,38,1,11,39
60,Fail,44,35,5,16,28
60,Fail,51,36,0,11,40
60,Fail,54,30,0,16,38
60,Fail,50,35,0,15,35
60,Fail,48,34,9,9,39
60,Fail,47,39,0,11,36
60,Fail,45,35,8,12,33
60,Fail,52,33,0,15,37
60,Fail,53,31,1,15,38
60,Fail,54,33,1,12,42
60,Fail,47,39,2,12,35
60,Fail,54,30,0,13,41
60,Fail,52,31,0,16,36
60,Fail,52,39,0,6,46
60,Fail,46,40,2,12,34
60,Fail,43,37,7,13,30
60,Fail,46,34,0,17,29
60,Fail,49,36,0,13,36
60,Fail,44,39,3,14,30
60,Fail,49,39,1,11,38
60,Fail,44,35,0,13,31
60,Fail,51,28,6,15,36
60,Fail,39,44,4,13,26
60,Fail,50,39,5,6,44
60,Fail,50,40,0,8,42
60,Fail,47,37,2,14,33
60,Fail,46,36,1,17,29
60,Fail,50,38,1,11,39
60,Fail,50,34,0,16,34
60,Fail,46,37,0,12,34
60,Fail,53,28,5,14,39
60,Fail,43,43,8,6,37
60,Fail,55,27,1,17,38
60,Fail,50,39,0,11,39
60,Fail,40,40,0,18,22
60,Fail,50,38,2,10,40
60,Fail,55,36,3,6,49
60,Fail,56,26,4,14,42
60,Fail,51,30,3,16,35
60,Fail,48,35,7,10,38
60,Fail,56,32,0,8,48
60,Fail,38,35,6,21,17
60,Fail,48,37,7,8,40
60,Fail,47,37,0,12,35
60,Fail,45,30,0,13,32
60,Fail,52,35,0,11,41
60,Fail,43,39,0,17,26
60,Fail,42,45,0,13,29
60,Fail,50,38,2,10,40
60,Fail,42,37,0,16,26
60,Fail,50,37,2,11,39
60,Fail,54,39,1,6,48
60,Fail,42,42,0,11,31
60,Fail,48,42,1,9,39
60,Fail,47,33,0,12,35
60,Fail,49,30,0,16,33
60,Fail,52,33,0,11,41
60,Fail,47,36,0,12,35
60,Fail,54,34,0,11,43
60,Fail,47,30,0,18,29
60,Fail,53,35,4,8,45
60,Fail,49,32,10,9,40
60,Fail,44,36,0,20,24
60,Fail,50,28,4,18,32
60,Fail,44,39,4,13,31
60,Fail,47,37,3,13,34
60,Fail,43,39,0,18,25
60,Fail,46,32,9,13,33
60,Fail,46,35,4,15,31
60,Fail,48,40,0,9,39
60,Fail,54,38,0,8,46
60,Fail,48,40,0,11,37
60,Fail,48,37,0,11,37
60,Fail,51,29,0,16,35
60,Fail,51,32,5,12,39
60,Fail,43,43,0,14,29
60,Fail,55,33,0,6,49
60,Fail,46,41,2,11,35
60,Fail,49,33,6,12,37
60,Fail,48,32,8,12,36
60,Fail,49,35,4,12,37
60,Fail,49,27,6,18,31
60,Fail,43,42,3,12,31
60,Fail,42,37,8,13,29
60,Fail,50,29,3,18,32
60,Fail,52,31,6,11,41
60,Fail,50,36,0,10,40
60,Fail,46,33,0,20,26
60,Fail,46,34,5,15,31
60,Fail,37,45,0,17,20
60,Fail,46,36,0,17,29
60,Fail,47,39,0,13,34
60,Fail,51,32,7,10,41
60,Fail,47,35,6,12,35
60,Fail,53,34,0,11,42
60,Fail,48,30,0,14,34
60,Fail,43,36,8,13,30
60,Fail,49,38,0,13,36
60,Fail,48,33,4,15,33
60,Fail,50,32,7,11,39
60,Fail,53,35,1,11,42
60,Fail,46,31,4,19,27
60,Fail,41,29,0,20,21
60,Fail,52,32,0,14,38
60,Fail,49,34,0,13,36
60,Fail,32,36,10,22,10
60,Fail,43,39,2,16,27
60,Fail,47,39,0,13,34
60,Fail,43,35,0,16,27
60,Fail,41,33,10,16,25
60,Fail,54,37,0,5,49
60,Fail,53,35,2,10,43
60,Fail,45,41,0,12,33
60,Fail,49,29,9,13,36
60,Fail,41,39,0,12,29
60,Fail,38,36,9,17,21
60,Fail,49,30,0,16,33
60,Fail,54,35,0,10,44
60,Fail,47,37,9,7,40
60,Fail,55,27,0,17,38
60,Fail,47,33,0,16,31
60,Fail,44,37,6,13,31
60,Fail,51,40,0,8,43
60,Fail,40,42,0,12,28
60,Fail,47,37,0,15,32
60,Fail,44,33,0,10,34
60,Fail,52,30,0,14,38
60,Fail,46,36,2,16,30
60,Fail,54,40,0,4,50
60,Fail,47,37,6,10,37
60,Fail,48,35,0,15,33
60,Fail,37,41,0,15,22
60,Fail,44,35,8,13,31
60,Fail,40,34,8,18,22
60,Fail,48,35,7,10,38
60,Fail,53,27,0,17,36
60,Fail,45,38,0,10,35
60,Fail,53,34,0,13,40
60,Fail,49,36,0,12,37
60,Fail,42,34,0,13,29
60,Fail,52,32,0,11,41
60,Fail,54,35,1,10,44
60,Fail,45,34,9,12,33
60,Fail,57,30,2,11,46
60,Fail,38,42,0,17,21
60,Fail,48,35,3,14,34
60,Fail,44,37,0,15,29
60,Fail,51,28,9,12,39
60,Fail,56,32,6,6,50
60,Fail,40,38,8,14,26
60,Fail,50,36,0,13,37
60,Fail,42,32,0,19,23
60,Fail,52,36,0,10,42
60,Fail,45,35,4,16,29
60,Fail,49,31,0,13,36
60,Fail,57,37,0,5,52
60,Fail,50,32,4,14,36
60,Fail,52,28,5,15,37
60,Fail,49,31,0,20,29
60,Fail,50,36,0,11,39
60,Fail,48,30,7,15,33
60,Fail,41,33,10,16,25
60,Fail,48,30,7,15,33
60,Fail,48,39,2,11,37
60,Fail,49,39,0,11,38
60,Fail,47,40,0,13,34
60,Fail,48,36,0,16,32
60,Fail,39,38,0,14,25
60,Fail,51,28,0,12,39
60,Fail,42,42,4,12,30
60,Fail,46,40,3,11,35
60,Fail,48,31,8,13,35
60,Fail,52,27,0,12,40
60,Fail,36,37,0,16,20
60,Fail,46,35,0,19,27
60,Fail,51,35,0,7,44
60,Fail,50,30,4,16,34
60,Fail,49,40,0,8,41
60,Fail,44,33,4,19,25
60,Fail,55,30,0,12,43
60,Fail,44,38,7,11,33
60,Fail,51,36,4,9,42
60,Fail,48,38,0,7,41
60,Fail,41,30,7,22,19
60,Fail,51,32,0,14,37
60,Fail,47,36,0,14,33
60,Fail,47,38,0,11,36
60,Fail,48,34,6,12,36
60,Fail,46,33,0,16,30
60,Fail,44,36,6,14,30
60,Fail,47,38,0,9,38
60,Fail,51,35,0,10,41
60,Fail,43,30,4,23,20
60,Fail,43,37,0,15,28
60,Fail,56,31,0,10,46
60,Fail,43,40,0,9,34
60,Fail,50,32,2,16,34
60,Fail,41,37,0,19,22
60,Fail,41,43,0,12,29
60,Fail,62,24,3,11,51
60,Fail,48,40,0,11,37
60,Fail,42,34,0,18,24
60,Fail,48,36,5,11,37
60,Fail,53,34,0,13,40
60,Fail,50,32,4,14,36
60,Fail,45,37,0,11,34
60,Fail,47,36,5,12,35
60,Fail,49,38,1,12,37
60,Fail,48,35,0,17,31
60,Fail,45,40,0,8,37
60,Fail,53,27,0,15,38
60,Fail,53,37,0,10,43
60,Fail,50,35,3,12,38
60,Fail,44,43,2,11,33
60,Fail,54,32,1,13,41
60,Fail,58,34,0,4,54
60,Fail,49,34,0,13,36
60,Fail,53,30,5,12,41
60,Fail,45,36,0,16,29
60,Fail,47,37,3,13,34
60,Fail,44,38,0,16,28
60,Fail,46,39,0,12,34
60,Fail,52,32,0,16,36
60,Fail,43,44,0,10,33
60,Fail,58,33,0,7,51
60,Fail,41,36,8,15,26
60,Fail,42,30,6,22,20
60,Fail,47,41,0,12,35
60,Fail,33,45,0,13,20
60,Fail,56,33,0,9,47
60,Fail,40,41,1,18,22
60,Fail,43,40,0,11,32
60,Fail,51,37,1,11,40
60,Fail,44,35,5,16,28
60,Fail,48,27,0,19,29
60,Fail,41,34,11,14,27
60,Fail,50,34,0,14,36
60,Fail,43,40,3,14,29
60,Fail,43,31,7,19,24
60,Fail,52,28,9,11,41
60,Fail,45,30,11,14,31
60,Fail,41,41,0,18,23
60,Fail,44,49,0,7,37
60,Fail,46,37,1,16,30
60,Fail,52,40,1,7,45
60,Fail,43,36,5,16,27
60,Fail,50,34,2,14,36
60,Fail,50,27,0,17,33
60,Fail,48,39,2,11,37
60,Fail,45,36,5,14,31
60,Fail,45,33,9,13,32
60,Fail,37,41,0,18,19
60,Fail,50,31,0,13,37
60,Fail,53,38,0,8,45
60,Fail,52,35,5,8,44
60,Fail,49,26,11,14,35
60,Fail,50,34,0,13,37
60,Fail,54,32,0,10,44
60,Fail,49,20,0,15,34
60,Fail,47,34,5,14,33
60,Fail,46,31,14,9,37
60,Fail,44,32,0,9,35
60,Fail,46,42,0,11,35
60,Fail,46,35,0,17,29
60,Fail,51,43,1,5,46
60,Fail,50,37,0,11,39
60,Fail,49,30,0,17,32
60,Fail,42,39,0,13,29
60,Fail,47,40,0,9,38
60,Fail,53,39,0,8,45
60,Fail,48,40,6,6,42
60,Fail,54,34,3,9,45
60,Fail,45,34,3,18,27
60,Fail,45,38,0,10,35
60,Fail,44,33,9,14,30
60,Fail,52,30,0,16,36
60,Fail,47,40,0,11,36
60,Fail,38,44,0,14,24
60,Fail,57,30,3,10,47
60,Fail,36,48,1,15,21
60,Fail,48,42,4,6,42
60,Fail,49,30,9,12,37
60,Fail,41,35,0,18,23
60,Fail,51,30,0,18,33
60,Fail,51,36,0,12,39
60,Fail,51,34,4,11,40
60,Fail,55,32,2,11,44
60,Fail,47,39,2,12,35
60,Fail,41,45,0,13,28
60,Fail,44,41,0,15,29
60,Fail,56,27,0,13,43
60,Fail,51,35,2,12,39
60,Fail,49,37,3,11,38
60,Fail,43,38,0,14,29
60,Fail,53,33,0,13,40
60,Fail,39,35,0,11,28
60,Fail,47,30,0,12,35
60,Fail,53,34,0,9,44
60,Fail,53,33,3,11,42
60,Fail,51,32,4,13,38
60,Fail,51,32,0,10,41
60,Fail,46,44,0,9,37
60,Fail,44,34,0,17,27
60,Fail,45,42,1,12,33
60,Fail,43,40,2,15,28
60,Fail,46,43,1,10,36
60,Fail,46,38,6,10,36
60,Fail,40,40,10,10,30
60,Fail,45,39,0,16,29
60,Fail,39,41,5,15,24
60,Fail,47,39,0,11,36
60,Fail,51,37,0,12,39
60,Fail,48,34,4,14,34
60,Fail,51,32,0,15,36
60,Fail,46,38,2,14,32
60,Fail,52,29,7,12,40
60,Fail,60,32,0,6,54
60,Fail,46,37,5,12,34
60,Fail,51,30,2,17,34
60,Fail,40,31,0,16,24
60,Fail,50,45,0,5,45
60,Fail,46,32,5,17,29
60,Fail,48,37,0,14,34
60,Fail,45,42,2,11,34
60,Fail,40,30,3,27,13
60,Fail,36,34,7,23,13
60,Fail,50,34,0,12,38
60,Fail,39,34,0,27,12
60,Fail,52,39,1,8,44
60,Fail,48,34,0,17,31
60,Fail,44,41,0,12,32
60,Fail,47,42,0,11,36
60,Fail,45,35,0,12,33
60,Fail,46,37,0,16,30
60,Fail,49,41,0,9,40
60,Fail,50,28,0,15,35
60,Fail,47,42,0,11,36
60,Fail,42,41,4,13,29
60,Fail,44,37,0,14,30
60,Fail,46,38,6,10,36
60,Fail,46,41,0,12,34
60,Fail,50,36,0,10,40
60,Fail,49,35,0,16,33
60,Fail,47,36,6,11,36
60,Fail,52,32,0,15,37
60,Fail,52,30,12,6,46
60,Fail,50,37,0,12,38
60,Fail,49,28,0,17,32
60,Fail,51,28,4,17,34
60,Fail,54,33,0,11,43
60,Fail,38,38,14,10,28
60,Fail,50,35,3,12,38
60,Fail,50,33,2,15,35
60,Fail,55,30,2,13,42
60,Fail,50,38,0,10,40
60,Fail,44,41,2,13,31
60,Fail,59,30,0,8,51
60,Fail,50,34,6,10,40
60,Fail,48,35,5,12,36
60,Fail,44,31,0,17,27
60,Fail,44,33,0,19,25
60,Fail,55,35,3,7,48
60,Fail,54,33,0,9,45
60,Fail,55,27,0,13,42
60,Fail,47,41,1,11,36
60,Fail,47,37,0,11,36
60,Fail,39,45,0,12,27
60,Fail,55,33,0,12,43
60,Fail,50,40,1,9,41
60,Fail,54,36,1,9,45
60,Fail,54,26,0,12,42
60,Fail,43,40,0,12,31
60,Fail,51,43,0,6,45
60,Fail,50,31,4,15,35
60,Fail,47,35,6,12,35
60,Fail,48,33,4,15,33
60,Fail,45,29,0,20,25
60,Fail,47,35,5,13,34
60,Fail,55,33,0,11,44
60,Fail,55,34,2,9,46
60,Fail,38,35,0,15,23
60,Fail,47,35,0,17,30
60,Fail,46,42,2,10,36
60,Fail,46,41,0,9,37
60,Fail,46,34,0,17,29
60,Fail,51,38,1,10,41
60,Fail,58,27,0,8,50
60,Fail,46,34,8,12,34
60,Fail,55,33,0,12,43
60,Fail,45,41,2,12,33
60,Fail,44,34,6,16,28
60,Fail,53,35,1,11,42
60,Fail,51,34,0,12,39
60,Fail,49,43,0,7,42
60,Fail,48,36,6,10,38
60,Fail,49,30,0,20,29
60,Fail,56,29,0,12,44
60,Fail,41,35,7,17,24
60,Fail,43,42,0,14,29
60,Fail,51,31,8,10,41
60,Fail,47,35,0,18,29
60,Fail,50,35,0,15,35
60,Fail,47,40,0,9,38
60,Fail,44,42,7,7,37
60,Fail,46,37,0,15,31
60,Fail,46,37,2,15,31
60,Fail,45,36,3,16,29
60,Fail,53,36,0,10,43
60,Fail,55,34,1,10,45
60,Fail,48,34,6,12,36
60,Fail,48,39,0,11,37
60,Fail,45,44,0,10,35
60,Fail,54,34,1,11,43
60,Fail,47,39,0,12,35
60,Fail,51,32,2,15,36
60,Fail,46,29,8,17,29
60,Fail,50,32,2,16,34
60,Fail,54,29,0,11,43
60,Fail,52,31,0,11,41
60,Fail,50,31,0,14,36
60,Fail,45,42,0,13,32
60,Fail,61,26,0,8,53
60,Fail,49,32,8,11,38
60,Fail,41,40,0,15,26
60,Fail,45,32,12,11,34
60,Fail,55,27,7,11,44
60,Fail,42,38,10,10,32
60,Fail,53,31,5,11,42
60,Fail,52,31,0,11,41
60,Fail,39,39,0,15,24
60,Fail,47,30,0,12,35
60,Fail,45,41,0,12,33
60,Fail,49,36,6,9,40
60,Fail,48,28,0,21,27
60,Fail,48,38,0,11,37
60,Fail,49,33,0,16,33
60,Fail,53,33,5,9,44
60,Fail,49,36,1,14,35
60,Fail,47,36,6,11,36
60,Fail,54,33,2,11,43
60,Fail,51,29,0,16,35
60,Fail,39,49,0,10,29
60,Fail,50,36,0,11,39
60,Fail,50,39,2,9,41
60,Fail,54,31,0,14,40
60,Fail,50,35,0,10,40
60,Fail,45,37,0,17,28
60,Fail,47,36,0,17,30
60,Fail,50,32,3,15,35
60,Fail,52,35,0,12,40
60,Fail,50,31,0,11,39
60,Fail,39,41,0,15,24
60,Fail,49,25,0,19,30
60,Fail,46,36,1,17,29
60,Fail,44,34,11,11,33
60,Fail,45,32,7,16,29
60,Fail,46,40,1,13,33
60,Fail,47,35,5,13,34
60,Fail,46,39,0,6,40
60,Fail,50,40,0,9,41
60,Fail,50,41,0,9,41
60,Fail,44,41,0,9,35
60,Fail,52,29,6,13,39
60,Fail,46,38,0,16,30
60,Fail,52,31,5,12,40
60,Fail,50,41,1,8,42
60,Fail,46,31,0,13,33
60,Fail,56,33,1,10,46
60,Fail,47,39,0,7,40
60,Fail,48,38,0,10,38
60,Fail,50,38,0,11,39
60,Fail,47,35,0,10,37
60,Fail,48,38,7,7,41
60,Fail,51,28,9,12,39
60,Fail,51,32,3,14,37
60,Fail,54,30,5,11,43
60,Fail,50,33,0,15,35
60,Fail,53,33,1,13,40
60,Fail,46,31,7,16,30
60,Fail,55,31,0,13,42
60,Fail,48,36,0,15,33
60,Fail,48,37,0,10,38
60,Fail,43,36,5,16,27
60,Fail,44,41,3,12,32
60,Fail,45,36,2,17,28
60,Fail,44,47,0,8,36
60,Fail,45,37,0,16,29
60,Fail,48,30,13,9,39
60,Fail,50,39,0,8,42
60,Fail,41,33,0,11,30
60,Fail,49,38,2,11,38
60,Fail,52,28,9,11,41
60,Fail,51,33,0,13,38
60,Fail,48,33,0,11,37
60,Fail,47,40,0,12,35
60,Fail,52,36,0,9,43
60,Fail,52,27,0,14,38
60,Fail,43,32,13,12,31
60,Fail,43,41,0,12,31
60,Fail,41,35,8,16,25
60,Fail,53,31,3,13,40
60,Fail,46,41,3,10,36
60,Fail,44,30,4,22,22
60,Fail,44,41,3,12,32
60,Fail,44,36,8,12,32
60,Fail,44,39,0,11,33
60,Fail,47,37,0,11,36
60,Fail,57,32,1,10,47
60,Fail,50,32,0,13,37
60,Fail,57,31,0,8,49
60,Fail,49,36,6,9,40
60,Fail,41,42,5,12,29
60,Fail,44,44,0,11,33
60,Fail,49,24,6,21,28
60,Fail,46,33,0,11,35
60,Fail,51,41,0,6,45
60,Fail,50,31,0,16,34
60,Fail,51,36,0,12,39
60,Fail,44,33,0,16,28
60,Fail,51,36,1,12,39
60,Fail,45,37,1,17,28
60,Fail,46,37,10,7,39
60,Fail,45,40,2,13,32
60,Fail,51,36,1,12,39
60,Fail,42,35,0,17,25
60,Fail,55,36,3,6,49
60,Fail,51,31,3,15,36
60,Fail,51,27,0,13,38
60,Fail,41,39,0,19,22
60,Fail,52,40,0,5,47
60,Fail,47,37,1,15,32
60,Fail,41,39,5,15,26
60,Fail,48,35,2,15,33
60,Fail,54,35,2,9,45
60,Fail,36,38,0,18,18
60,Fail,39,37,9,15,24
60,Fail,45,32,8,15,30
60,Fail,49,37,0,10,39
60,Fail,53,32,4,11,42
60,Fail,49,35,6,10,39
60,Fail,45,47,0,8,37
60,Fail,55,31,6,8,47
60,Fail,49,31,0,14,35
60,Fail,46,39,3,12,34
60,Fail,45,38,2,15,30
60,Fail,55,37,0,6,49
60,Fail,50,40,0,10,40
60,Fail,54,31,0,10,44
60,Fail,45,43,0,8,37
60,Fail,55,30,3,12,43
60,Fail,53,33,4,10,43
60,Fail,42,34,8,16,26
60,Fail,49,33,6,12,37
60,Fail,48,32,0,10,38
60,Fail,49,39,0,10,39
60,Fail,48,34,5,13,35
60,Fail,45,32,0,18,27
60,Fail,55,36,2,7,48
60,Fail,54,27,5,14,40
60,Fail,49,26,7,18,31
60,Fail,49,35,0,16,33
60,Fail,49,28,6,17,32
60,Fail,55,29,0,15,40
60,Fail,55,34,1,10,45
60,Fail,46,43,2,9,37
60,Fail,54,32,1,13,41
60,Fail,45,42,6,7,38
60,Fail,42,40,8,10,32
60,Fail,52,37,2,9,43
60,Fail,39,45,0,14,25
60,Fail,53,34,0,11,42
60,Fail,44,33,7,16,28
60,Fail,53,35,0,10,43
60,Fail,44,36,0,17,27
60,Fail,46,35,8,11,35
60,Fail,50,37,1,12,38
60,Fail,46,40,0,12,34
60,Fail,52,35,0,8,44
60,Fail,50,39,2,9,41
60,Fail,49,35,0,11,38
60,Fail,52,36,0,12,40
60,Fail,54,30,4,12,42
60,Fail,42,33,7,18,24
60,Fail,39,47,3,11,28
60,Fail,47,25,10,18,29
60,Fail,45,31,0,13,32
60,Fail,53,33,3,11,42
60,Fail,43,32,11,14,29
60,Fail,45,36,2,17,28
60,Fail,47,35,3,15,32
60,Fail,44,43,0,11,33
60,Fail,57,27,0,10,47
60,Fail,39,46,5,10,29
60,Fail,50,38,4,8,42
60,Fail,50,40,0,8,42
60,Fail,52,34,0,8,44
60,Fail,48,35,0,16,32
60,Fail,51,35,0,11,40
60,Fail,51,33,1,15,36
60,Fail,49,35,0,13,36
60,Fail,52,33,0,7,45
60,Fail,53,33,1,13,40
60,Fail,50,30,0,16,34
60,Fail,49,32,7,12,37
60,Fail,52,38,1,9,43
60,Fail,50,34,0,16,34
60,Fail,46,39,3,12,34
60,Fail,50,36,0,12,38
60,Fail,48,36,0,16,32
60,Fail,43,39,5,13,30
60,Fail,43,35,5,17,26
60,Fail,44,39,0,12,32
60,Fail,41,39,5,15,26
60,Fail,46,39,0,13,33
60,Fail,51,33,0,13,38
60,Fail,53,35,3,9,44
60,Fail,45,34,6,15,30
60,Fail,45,33,0,19,26
60,Fail,49,28,0,20,29
60,Fail,38,40,15,7,31
60,Fail,52,41,0,7,45
60,Fail,44,42,0,11,33
60,Fail,44,43,3,10,34
60,Fail,47,34,0,16,31
60,Fail,40,30,12,18,22
60,Fail,45,39,2,14,31
60,Fail,41,41,0,15,26
60,Fail,44,32,0,16,28
60,Fail,53,28,0,16,37
60,Fail,37,43,5,15,22
60,Fail,53,37,0,9,44
60,Fail,47,39,0,13,34
60,Fail,43,37,0,14,29
60,Fail,38,37,0,12,26
60,Fail,42,39,3,16,26
60,Fail,40,38,9,13,27
60,Fail,42,42,1,15,27
60,Fail,47,36,0,17,30
60,Fail,46,33,0,13,33
60,Fail,53,29,0,14,39
60,Fail,44,36,7,13,31
60,Fail,44,37,0,12,32
60,Fail,45,33,8,14,31
60,Fail,48,28,8,16,32
60,Fail,46,38,0,12,34
60,Fail,54,32,0,9,45
60,Fail,45,41,0,11,34
60,Fail,42,39,3,16,26
60,Fail,40,40,0,12,28
60,Fail,43,39,2,16,27
60,Fail,53,33,1,13,40
60,Fail,50,35,0,13,37
60,Fail,42,42,0,13,29
60,Fail,52,34,0,6,46
60,Fail,42,36,0,15,27
60,Fail,51,36,0,12,39
60,Fail,41,37,0,14,27
60,Fail,42,31,13,14,28
60,Fail,48,35,3,14,34
60,Fail,52,34,0,11,41
60,Fail,46,29,11,14,32
60,Fail,50,31,0,13,37
60,Fail,46,33,0,17,29
60,Fail,46,38,0,13,33
60,Fail,45,41,3,11,34
60,Fail,46,36,0,16,30
60,Fail,51,38,1,10,41
60,Fail,50,29,0,18,32
60,Fail,50,32,0,14,36
60,Fail,41,34,9,16,25
60,Fail,49,35,0,12,37
60,Fail,45,24,12,19,26
60,Fail,50,38,0,9,41
60,Fail,48,33,9,10,38
60,Fail,51,36,3,10,41
60,Fail,50,36,0,8,42
60,Fail,43,34,0,16,27
60,Fail,40,50,1,9,31
60,Fail,48,32,0,18,30
60,Fail,51,35,3,11,40
60,Fail,41,38,7,14,27
60,Fail,51,38,0,9,42
60,Fail,53,32,0,13,40
60,Fail,40,34,0,15,25
60,Fail,46,35,0,19,27
60,Fail,44,35,0,20,24
60,Fail,43,39,0,18,25
60,Fail,47,35,0,15,32
60,Fail,52,37,0,10,42
60,Fail,49,33,1,17,32
60,Fail,42,42,2,14,28
60,Fail,45,35,6,14,31
60,Fail,36,41,0,16,20
60,Fail,47,38,5,10,37
60,Fail,42,43,0,15,27
60,Fail,49,38,0,10,39
60,Fail,49,37,1,13,36
60,Fail,41,35,0,15,26
60,Fail,51,34,0,9,42
60,Fail,46,39,0,15,31
60,Fail,51,31,0,13,38
60,Fail,46,40,0,10,36
60,Fail,52,41,0,6,46
60,Fail,52,42,1,5,47
60,Fail,50,35,7,8,42
60,Fail,49,36,2,13,36
60,Fail,55,28,0,12,43
60,Fail,42,31,13,14,28
60,Fail,52,38,0,7,45
60,Fail,56,29,0,13,43
60,Fail,47,28,3,22,25
60,Fail,54,27,5,14,40
60,Fail,45,42,3,10,35
60,Fail,56,26,5,13,43
60,Fail,47,44,0,9,38
60,Fail,45,31,0,19,26
60,Fail,55,30,3,12,43
60,Fail,51,34,4,11,40
60,Fail,47,30,7,16,31
60,Fail,39,37,0,13,26
60,Fail,53,35,0,12,41
60,Fail,55,33,0,10,45
60,Fail,50,40,1,9,41
60,Fail,52,31,0,13,39
60,Fail,53,28,2,17,36
60,Fail,51,33,0,11,40
60,Fail,50,39,0,9,41
60,Fail,63,29,0,6,57
60,Fail,48,41,1,10,38
60,Fail,47,37,4,12,35
60,Fail,46,30,0,21,25
60,Fail,47,33,6,14,33
60,Fail,43,37,0,16,27
60,Fail,42,32,0,14,28
60,Fail,42,38,9,11,31
60,Fail,54,26,6,14,40
60,Fail,54,27,0,18,36
60,Fail,43,39,1,17,26
60,Fail,49,33,0,9,40
60,Fail,52,33,5,10,42
60,Fail,45,33,5,17,28
60,Fail,45,34,0,13,32
60,Fail,43,44,0,11,32
60,Fail,50,31,0,16,34
60,Fail,50,34,0,13,37
60,Fail,50,31,0,14,36
60,Fail,47,31,4,18,29
60,Fail,43,40,4,13,30
60,Fail,48,35,0,15,33
60,Fail,52,37,0,11,41
60,Fail,47,41,6,6,41
60,Fail,53,33,0,9,44
60,Fail,51,36,0,9,42
60,Fail,44,34,4,18,26
60,Fail,51,31,0,17,34
60,Fail,53,35,1,11,42
60,Fail,47,42,4,7,40
60,Fail,50,30,8,12,38
60,Fail,45,33,0,18,27
60,Fail,50,32,0,16,34
60,Fail,45,37,0,15,30
60,Fail,57,34,0,8,49
60,Fail,38,40,0,17,21
60,Fail,49,37,1,13,36
60,Fail,51,35,0,14,37
60,Fail,58,28,0,13,45
60,Fail,46,37,0,11,35
60,Fail,47,39,1,13,34
60,Fail,50,34,0,16,34
60,Fail,53,36,0,9,44
60,Fail,45,31,0,15,30
60,Fail,55,34,0,9,46
60,Fail,41,33,4,22,19
60,Fail,48,35,0,15,33
60,Fail,51,35,1,13,38
60,Fail,51,38,1,10,41
60,Fail,44,40,3,13,31
60,Fail,41,34,0,18,23
60,Fail,45,33,0,18,27
60,Fail,51,35,0,14,37
60,Fail,49,36,3,12,37
60,Fail,45,40,0,13,32
60,Fail,45,41,2,12,33
60,Fail,48,31,14,7,41
60,Fail,47,39,0,12,35
60,Fail,49,34,2,15,34
60,Fail,46,41,0,12,34
60,Fail,55,28,9,8,47
60,Fail,43,35,0,18,25
60,Fail,37,43,7,13,24
60,Fail,51,34,0,15,36
60,Fail,53,35,3,9,44
60,Fail,51,37,0,12,39
60,Fail,48,33,0,13,35
60,Fail,48,31,6,15,33
60,Fail,46,35,0,18,28
60,Fail,56,29,0,13,43
60,Fail,51,33,1,15,36
60,Fail,45,44,1,10,35
60,Fail,46,36,7,11,35
60,Fail,50,31,0,11,39
60,Fail,42,46,2,10,32
60,Fail,45,38,0,12,33
60,Fail,36,38,3,23,13
60,Fail,49,33,0,10,39
60,Fail,49,42,1,8,41
60,Fail,51,35,4,10,41
60,Fail,40,42,0,12,28
60,Fail,48,33,5,14,34
60,Fail,50,32,0,16,34
60,Fail,48,35,0,15,33
60,Fail,46,37,2,15,31
60,Fail,37,44,7,12,25
60,Fail,53,23,0,17,36
60,Fail,52,29,7,12,40
60,Fail,46,39,0,10,36
60,Fail,46,31,6,17,29
60,Fail,50,34,3,13,37
60,Fail,37,38,0,15,22
60,Fail,46,38,1,15,31
60,Fail,59,35,1,5,54
60,Fail,45,38,0,14,31
60,Fail,49,37,0,13,36
60,Fail,41,36,9,14,27
60,Fail,39,34,0,20,19
60,Fail,52,28,8,12,40
60,Fail,49,37,0,13,36
60,Fail,49,32,6,13,36
60,Fail,50,36,0,14,36
60,Fail,50,36,5,9,41
60,Fail,56,30,6,8,48
60,Fail,49,38,0,10,39
60,Fail,46,32,0,17,29
60,Fail,49,34,0,15,34
60,Fail,51,39,0,7,44
60,Fail,43,40,4,13,30
60,Fail,42,42,2,14,28
60,Fail,51,35,4,10,41
60,Fail,45,39,0,9,36
60,Fail,45,42,0,10,35
60,Fail,48,35,0,13,35
60,Fail,49,33,9,9,40
60,Fail,48,39,1,12,36
60,Fail,48,41,0,11,37
60,Fail,48,41,0,8,40
60,Fail,50,41,0,8,42
60,Fail,39,38,12,11,28
60,Fail,53,31,0,13,40
60,Fail,45,40,6,9,36
60,Fail,54,35,0,10,44
60,Fail,48,32,0,17,31
60,Fail,38,46,0,14,24
60,Fail,40,33,8,19,21
60,Fail,50,37,3,10,40
60,Fail,47,43,0,8,39
60,Fail,46,36,0,17,29
60,Fail,46,35,0,13,33
60,Fail,46,37,0,16,30
60,Fail,49,36,0,10,39
60,Fail,46,31,7,16,30
60,Fail,41,42,1,16,25
60,Fail,45,36,0,19,26
60,Fail,44,34,0,15,29
60,Fail,48,39,2,11,37
60,Fail,42,30,12,16,26
60,Fail,46,42,3,9,37
60,Fail,52,30,0,9,43
60,Fail,48,38,2,12,36
60,Fail,48,38,5,9,39
60,Fail,49,35,0,10,39
60,Fail,53,29,0,14,39
60,Fail,53,32,2,13,40
60,Fail,50,35,0,9,41
60,Fail,44,36,0,11,33
60,Fail,46,38,3,13,33
60,Fail,49,39,0,11,38
60,Fail,42,44,0,10,32
60,Fail,53,30,0,17,36
60,Fail,45,44,0,7,38
60,Fail,53,28,4,15,38
60,Fail,50,35,0,14,36
60,Fail,46,36,11,7,39
60,Fail,47,30,0,14,33
60,Fail,40,32,0,16,24
60,Fail,43,38,2,17,26
60,Fail,48,29,4,19,29
60,Fail,47,36,6,11,36
60,Fail,48,37,0,11,37
60,Fail,53,33,0,13,40
60,Fail,49,29,14,8,41
60,Fail,50,33,3,14,36
60,Fail,48,38,0,10,38
60,Fail,47,41,2,10,37
60,Fail,45,39,0,10,35
60,Fail,49,43,0,6,43
60,Fail,54,39,0,6,48
60,Fail,59,28,0,13,46
60,Fail,45,34,6,15,30
60,Fail,50,33,0,16,34
60,Fail,47,34,0,15,32
60,Fail,51,32,0,11,40
60,Fail,52,31,2,15,37
60,Fail,50,35,1,14,36
60,Fail,51,39,0,9,42
60,Fail,48,37,3,12,36
60,Fail,48,38,1,13,35
60,Fail,46,32,0,17,29
60,Fail,45,35,7,13,32
60,Fail,45,38,0,14,31
60,Fail,48,33,4,15,33
60,Fail,52,37,0,9,43
60,Fail,49,37,0,13,36
60,Fail,50,38,2,10,40
60,Fail,46,31,0,9,37
60,Fail,49,36,0,10,39
60,Fail,49,40,0,11,38
60,Fail,47,40,2,11,36
60,Fail,45,34,6,15,30
60,Fail,41,42,0,16,25
60,Fail,40,34,0,13,27
60,Fail,42,31,14,13,29
60,Fail,45,33,0,12,33
60,Fail,53,36,0,6,47
60,Fail,48,29,0,14,34
60,Fail,47,38,1,14,33
60,Fail,44,33,0,14,30
60,Fail,49,27,0,20,29
60,Fail,37,44,0,14,23
60,Fail,47,32,0,13,34
60,Fail,50,26,0,12,38
60,Fail,52,37,1,10,42
60,Fail,49,34,3,14,35
60,Fail,43,34,9,14,29
60,Fail,53,33,0,14,39
60,Fail,56,27,3,14,42
60,Fail,50,38,3,9,41
60,Fail,47,40,2,11,36
60,Fail,50,39,0,10,40
60,Fail,47,40,2,11,36
60,Fail,54,30,0,14,40
60,Fail,46,25,12,17,29
60,Fail,49,32,2,17,32
60,Fail,51,34,4,11,40
60,Fail,51,36,2,11,40
60,Fail,38,40,0,15,23
60,Fail,47,29,4,20,27
60,Fail,53,31,0,15,38
60,Fail,48,41,0,11,37
60,Fail,42,24,15,19,23
60,Fail,45,43,0,11,34
60,Fail,44,38,5,13,31
60,Fail,48,38,0,13,35
60,Fail,49,41,1,9,40
60,Fail,42,41,3,14,28
60,Fail,45,38,3,14,31
60,Fail,47,34,0,14,33
60,Fail,47,43,0,8,39
60,Fail,47,34,6,13,34
60,Fail,53,32,0,12,41
60,Fail,45,36,1,18,27
60,Fail,40,45,0,14,26
60,Fail,42,35,0,16,26
60,Fail,49,38,1,12,37
60,Fail,52,29,0,11,41
60,Fail,50,40,1,9,41
60,Fail,40,36,12,12,28
60,Fail,46,33,0,16,30
60,Fail,44,34,0,16,28
60,Fail,54,33,0,10,44
60,Fail,48,34,0,14,34
60,Fail,42,44,0,13,29
60,Fail,56,35,0,7,49
60,Fail,46,34,0,15,31
60,Fail,51,34,0,11,40
60,Fail,44,35,1,20,24
60,Fail,46,33,9,12,34
60,Fail,49,38,0,12,37
60,Fail,45,34,3,18,27
60,Fail,44,38,0,12,32
60,Fail,46,36,0,18,28
60,Fail,49,32,0,16,33
60,Fail,44,36,7,13,31
60,Fail,49,41,0,10,39
60,Fail,51,34,0,11,40
60,Fail,49,34,0,13,36
60,Fail,44,43,0,12,32
60,Fail,53,34,0,10,43
60,Fail,47,35,0,14,33
60,Fail,46,37,0,14,32
60,Fail,42,34,0,16,26
60,Fail,52,31,0,13,39
60,Fail,47,41,0,9,38
60,Fail,47,45,0,8,39
60,Fail,45,34,0,13,32
60,Fail,34,42,2,22,12
60,Fail,47,29,8,16,31
60,Fail,41,38,6,15,26
60,Fail,46,32,0,6,40
60,Fail,40,38,0,19,21
60,Fail,40,41,0,9,31
60,Fail,49,35,1,15,34
60,Fail,47,35,0,12,35
60,Fail,44,37,0,11,33
60,Fail,47,41,0,11,36
60,Fail,40,36,4,20,20
60,Fail,46,30,7,17,29
60,Fail,51,37,0,11,40
60,Fail,46,41,5,8,38
60,Fail,50,33,3,14,36
60,Fail,53,33,0,13,40
60,Fail,44,34,7,15,29
60,Fail,45,35,0,16,29
60,Fail,52,37,0,10,42
60,Fail,47,34,0,16,31
60,Fail,47,31,8,14,33
60,Fail,49,41,2,8,41
60,Fail,50,36,0,11,39
60,Fail,51,28,12,9,42
60,Fail,52,38,2,8,44
60,Fail,44,37,9,10,34
60,Fail,56,37,0,6,50
60,Fail,45,34,0,11,34
60,Fail,55,34,0,8,47
60,Fail,48,38,0,9,39
60,Fail,48,35,10,7,41
60,Fail,44,35,0,14,30
60,Fail,49,28,0,17,32
60,Fail,53,31,0,15,38
60,Fail,42,33,6,19,23
60,Fail,54,38,0,5,49
60,Fail,42,41,5,12,30
60,Fail,50,34,0,16,34
60,Fail,41,45,0,13,28
60,Fail,54,34,0,12,42
60,Fail,55,32,0,13,42
60,Fail,50,27,0,14,36
60,Fail,41,40,0,19,22
60,Fail,46,32,6,16,30
60,Fail,35,42,8,15,20
60,Fail,41,39,4,16,25
60,Fail,41,41,0,12,29
60,Fail,50,31,0,10,40
60,Fail,42,32,16,10,32
60,Fail,55,37,0,4,51
60,Fail,52,37,1,10,42
60,Fail,45,36,0,16,29
60,Fail,49,33,2,16,33
60,Fail,45,43,0,10,35
60,Fail,53,34,2,11,42
60,Fail,52,30,0,13,39
60,Fail,44,34,9,13,31
60,Fail,56,33,0,10,46
60,Fail,47,43,1,9,38
60,Fail,40,44,0,13,27
60,Fail,46,35,3,16,30
60,Fail,53,38,0,7,46
60,Fail,52,34,4,10,42
60,Fail,41,32,0,20,21
60,Fail,50,40,1,9,41
60,Fail,56,35,0,9,47
60,Fail,39,46,1,14,25
60,Fail,42,38,0,14,28
60,Fail,47,33,0,14,33
60,Fail,52,31,7,10,42
60,Fail,49,34,4,13,36
60,Fail,50,36,5,9,41
60,Fail,51,32,0,17,34
60,Fail,48,37,0,14,34
60,Fail,49,35,3,13,36
60,Fail,48,35,0,13,35
60,Fail,46,41,0,8,38
60,Fail,52,32,0,11,41
60,Fail,51,27,12,10,41
60,Fail,49,31,0,13,36
60,Fail,52,33,0,9,43
60,Fail,47,37,1,15,32
60,Fail,53,33,4,10,43
60,Fail,42,44,2,12,30
60,Fail,46,38,0,14,32
60,Fail,47,38,0,11,36
60,Fail,42,36,10,12,30
60,Fail,49,32,0,14,35
60,Fail,51,33,6,10,41
60,Fail,58,32,1,9,49
60,Fail,47,36,3,14,33
60,Fail,47,38,4,11,36
60,Fail,51,36,0,13,38
60,Fail,48,36,8,8,40
60,Fail,48,37,2,13,35
60,Fail,47,34,9,10,37
60,Fail,45,39,4,12,33
60,Fail,44,32,4,20,24
60,Fail,43,33,3,21,22
60,Fail,53,29,0,10,43
60,Fail,41,38,0,15,26
60,Fail,46,42,0,10,36
60,Fail,47,37,8,8,39
60,Fail,51,40,0,9,42
60,Fail,40,37,0,20,20
60,Fail,48,38,0,13,35
60,Fail,51,36,0,12,39
60,Fail,52,30,5,13,39
60,Fail,46,33,5,16,30
60,Fail,47,37,0,13,34
60,Fail,51,38,0,6,45
60,Fail,44,41,0,14,30
60,Fail,54,28,0,13,41
60,Fail,45,41,0,13,32
60,Fail,47,29,0,21,26
60,Fail,46,38,1,15,31
60,Fail,37,43,8,12,25
60,Fail,43,33,0,15,28
60,Fail,47,41,4,8,39
60,Fail,46,41,0,10,36
60,Fail,47,41,0,11,36
60,Fail,53,30,4,13,40
60,Fail,51,32,0,14,37
60,Fail,46,36,6,12,34
60,Fail,47,38,3,12,35
60,Fail,43,33,8,16,27
60,Fail,49,37,0,8,41
60,Fail,43,34,0,19,24
60,Fail,48,39,3,10,38
60,Fail,54,33,0,9,45
60,Fail,50,31,0,14,36
60,Fail,53,33,0,14,39
60,Fail,48,33,6,13,35
60,Fail,46,36,8,10,36
60,Fail,51,30,4,15,36
60,Fail,42,33,8,17,25
60,Fail,54,37,0,9,45
60,Fail,44,28,12,16,28
60,Fail,56,30,0,12,44
60,Fail,48,37,0,15,33
60,Fail,51,34,0,15,36
60,Fail,50,29,13,8,42
60,Fail,53,34,4,9,44
60,Fail,38,29,0,20,18
60,Fail,48,35,1,16,32
60,Fail,42,37,5,16,26
60,Fail,44,35,0,18,26
60,Fail,44,37,1,18,26
60,Fail,48,39,4,9,39
60,Fail,38,35,0,22,16
60,Fail,51,33,0,10,41
60,Fail,57,32,0,11,46
60,Fail,49,38,0,12,37
60,Fail,43,37,0,13,30
60,Fail,48,35,4,13,35
60,Fail,53,34,0,12,41
60,Fail,44,41,1,14,30
60,Fail,42,39,11,8,34
60,Fail,51,33,0,14,37
60,Fail,44,37,0,17,27
60,Fail,43,45,4,8,35
60,Fail,50,32,0,11,39
60,Fail,44,40,0,9,35
60,Fail,37,47,5,11,26
60,Fail,46,31,0,10,36
60,Fail,47,34,4,15,32
60,Fail,43,38,0,14,29
60,Fail,43,36,0,14,29
60,Fail,47,35,0,13,34
60,Fail,43,37,8,12,31
60,Fail,51,35,3,11,40
60,Fail,48,32,0,15,33
60,Fail,48,36,3,13,35
60,Fail,50,34,7,9,41
60,Fail,56,30,0,11,45
60,Fail,47,28,10,15,32
60,Fail,41,47,0,12,29
60,Fail,57,33,2,8,49
60,Fail,46,36,3,15,31
60,Fail,52,34,7,7,45
60,Fail,50,31,3,16,34
60,Fail,48,39,0,13,35
60,Fail,47,36,7,10,37
60,Fail,45,38,0,16,29
60,Fail,46,34,8,12,34
60,Fail,51,34,0,10,41
60,Fail,49,30,7,14,35
60,Fail,53,28,0,17,36
60,Fail,51,36,1,12,39
60,Fail,39,37,0,17,22
60,Fail,46,37,0,16,30
60,Fail,48,42,0,10,38
60,Fail,47,33,0,14,33
60,Fail,50,32,3,15,35
60,Fail,44,43,1,12,32
60,Fail,45,40,4,11,34
60,Fail,50,27,5,18,32
60,Fail,44,37,0,18,26
60,Fail,51,34,2,13,38
60,Fail,47,35,6,12,35
60,Fail,48,29,7,16,32
60,Fail,47,36,4,13,34
60,Fail,46,41,2,11,35
60,Fail,51,35,0,8,43
60,Fail,45,38,0,11,34
60,Fail,46,34,8,12,34
60,Fail,47,42,0,10,37
60,Fail,46,40,2,12,34
60,Fail,44,37,0,15,29
60,Fail,45,41,0,9,36
60,Fail,47,37,1,15,32
60,Fail,53,26,0,13,40
60,Fail,41,35,0,16,25
60,Fail,48,36,1,15,33
60,Fail,49,38,0,12,37
60,Fail,47,39,3,11,36
60,Fail,46,42,3,9,37
60,Fail,40,35,9,16,24
60,Fail,50,34,1,15,35
60,Fail,47,40,2,11,36
60,Fail,53,31,6,10,43
60,Fail,48,31,0,15,33
60,Fail,50,38,4,8,42
60,Fail,55,27,0,17,38
60,Fail,41,41,0,11,30
60,Fail,44,42,1,13,31
60,Fail,54,31,3,12,42
60,Fail,53,28,0,15,38
60,Fail,54,33,4,9,45
60,Fail,51,35,0,10,41
60,Fail,48,38,5,9,39
60,Fail,49,37,0,10,39
60,Fail,48,40,0,12,36
60,Fail,47,37,0,9,38
60,Fail,45,38,0,14,31
60,Fail,39,38,0,15,24
60,Fail,41,40,0,14,27
60,Fail,49,33,4,14,35
60,Fail,50,38,0,10,40
60,Fail,50,33,0,8,42
60,Fail,49,35,0,16,33
60,Fail,44,39,0,15,29
60,Fail,49,39,0,9,40
60,Fail,57,28,0,15,42
60,Fail,48,38,0,9,39
60,Fail,46,41,0,11,35
60,Fail,44,35,4,17,27
60,Fail,43,41,0,14,29
60,Fail,48,26,0,17,31
60,Fail,50,41,0,8,42
60,Fail,44,34,0,14,30
60,Fail,47,30,7,16,31
60,Fail,48,34,0,13,35
60,Fail,46,38,1,15,31
60,Fail,53,36,0,8,45
60,Fail,44,36,5,15,29
60,Fail,43,36,4,17,26
60,Fail,45,34,0,11,34
60,Fail,45,39,0,11,34
60,Fail,48,34,6,12,36
60,Fail,49,34,0,14,35
60,Fail,55,28,5,12,43
60,Fail,41,41,7,11,30
60,Fail,48,41,1,10,38
60,Fail,49,41,0,8,41
60,Fail,48,36,0,7,41
60,Fail,54,36,0,8,46
60,Fail,45,39,0,13,32
60,Fail,50,35,0,11,39
60,Fail,54,35,0,8,46
60,Fail,43,40,0,13,30
60,Fail,51,31,0,17,34
60,Fail,49,36,1,14,35
60,Fail,48,35,4,13,35
60,Fail,50,39,2,9,41
60,Fail,46,40,0,12,34
60,Fail,45,36,0,19,26
60,Fail,48,37,0,15,33
60,Fail,58,32,5,5,53
60,Fail,47,30,0,20,27
60,Fail,43,40,1,16,27
60,Fail,39,40,0,16,23
60,Fail,50,37,0,13,37
60,Fail,51,38,0,10,41
60,Fail,47,36,0,10,37
60,Fail,47,36,4,13,34
60,Fail,44,40,4,12,32
60,Fail,44,46,2,8,36
60,Fail,44,40,2,14,30
60,Fail,55,34,0,8,47
60,Fail,59,30,0,7,52
60,Fail,50,40,0,8,42
60,Fail,51,36,0,13,38
60,Fail,53,37,0,9,44
60,Fail,44,37,0,13,31
60,Fail,54,37,0,7,47
60,Fail,45,40,1,14,31
60,Fail,47,31,0,12,35
60,Fail,46,35,0,6,40
60,Fail,44,40,6,10,34
60,Fail,48,28,0,21,27
60,Fail,41,35,10,14,27
60,Fail,46,44,3,7,39
60,Fail,46,33,0,11,35
60,Fail,42,39,0,15,27
60,Fail,50,32,4,14,36
60,Fail,53,37,1,9,44
60,Fail,46,39,1,14,32
60,Fail,58,30,0,10,48
60,Fail,51,30,7,12,39
60,Fail,46,43,3,8,38
60,Fail,41,39,0,12,29
60,Fail,49,39,3,9,40
60,Fail,52,38,0,9,43
60,Fail,51,37,4,8,43
60,Fail,50,31,8,11,39
60,Fail,49,31,10,10,39
60,Fail,48,41,3,8,40
60,Fail,53,31,1,15,38
60,Fail,46,30,9,15,31
60,Fail,45,38,0,15,30
60,Fail,39,44,1,16,23
60,Fail,51,33,0,15,36
60,Fail,49,33,0,10,39
60,Fail,49,40,0,10,39
60,Fail,43,37,7,13,30
60,Fail,50,28,7,15,35
60,Fail,50,35,0,14,36
60,Fail,52,38,0,10,42
60,Fail,45,32,8,15,30
60,Fail,62,26,0,12,50
60,Fail,45,40,0,7,38
60,Fail,49,34,0,13,36
60,Fail,46,39,0,14,32
60,Fail,50,34,0,12,38
60,Fail,51,32,4,13,38
60,Fail,47,34,0,8,39
60,Fail,48,39,0,13,35
60,Fail,43,29,8,20,23
60,Fail,46,37,0,16,30
60,Fail,45,41,1,13,32
60,Fail,41,42,1,16,25
60,Fail,39,41,0,18,21
60,Fail,47,39,9,5,42
60,Fail,47,43,0,9,38
60,Fail,38,41,8,13,25
60,Fail,41,35,10,14,27
60,Fail,45,44,0,9,36
60,Fail,49,35,1,15,34
60,Fail,51,32,0,12,39
60,Fail,47,34,3,16,31
60,Fail,49,31,0,18,31
60,Fail,46,30,0,20,26
60,Fail,47,36,4,13,34
60,Fail,48,30,0,14,34
60,Fail,53,35,0,10,43
60,Fail,43,41,6,10,33
60,Fail,50,30,6,14,36
60,Fail,50,36,5,9,41
60,Fail,43,40,2,15,28
60,Fail,52,30,0,14,38
60,Fail,51,44,0,3,48
60,Fail,47,38,0,7,40
60,Fail,51,30,0,13,38
60,Fail,46,43,0,11,35
60,Fail,46,37,0,17,29
60,Fail,47,40,0,9,38
60,Fail,52,38,0,5,47
60,Fail,38,46,5,11,27
60,Fail,48,45,2,5,43
60,Fail,50,33,0,16,34
60,Fail,56,34,0,7,49
60,Fail,49,32,0,19,30
60,Fail,49,33,2,16,33
60,Fail,46,42,0,11,35
60,Fail,56,28,0,10,46
60,Fail,50,32,7,11,39
60,Fail,51,35,4,10,41
60,Fail,45,37,3,15,30
60,Fail,56,24,6,14,42
60,Fail,40,30,15,15,25
60,Fail,52,32,0,11,41
60,Fail,47,38,3,12,35
60,Fail,48,39,0,9,39
60,Fail,44,46,0,8,36
60,Fail,48,35,0,13,35
60,Fail,56,29,0,11,45
60,Fail,49,34,3,14,35
60,Fail,52,31,0,15,37
60,Fail,35,29,0,18,17
60,Fail,44,38,0,14,30
60,Fail,43,44,0,11,32
60,Fail,40,39,0,12,28
60,Fail,44,37,10,9,35
60,Fail,53,32,4,11,42
60,Fail,52,35,0,10,42
60,Fail,52,32,5,11,41
60,Fail,43,39,0,14,29
60,Fail,48,41,2,9,39
60,Fail,49,35,1,15,34
60,Fail,45,38,0,17,28
60,Fail,54,31,7,8,46
60,Fail,44,39,0,12,32
60,Fail,40,34,0,17,23
60,Fail,48,34,0,12,36
60,Fail,48,44,0,7,41
60,Fail,52,31,5,12,40
60,Fail,46,42,2,10,36
60,Fail,52,33,4,11,41
60,Fail,55,34,1,10,45
60,Fail,45,36,0,17,28
60,Fail,39,45,6,10,29
60,Fail,50,36,1,13,37
60,Fail,45,40,0,13,32
60,Fail,52,30,4,14,38
60,Fail,37,33,0,25,12
60,Fail,55,33,0,12,43
60,Fail,46,35,0,15,31
60,Fail,49,32,0,17,32
60,Fail,44,33,0,19,25
60,Fail,48,37,2,13,35
60,Fail,51,38,0,11,40
60,Fail,52,33,1,14,38
60,Fail,49,41,0,10,39
60,Fail,45,38,0,15,30
60,Fail,52,32,6,10,42
60,Fail,52,40,2,6,46
60,Fail,42,34,0,15,27
60,Fail,51,29,0,12,39
60,Fail,46,39,6,9,37
60,Fail,46,38,6,10,36
60,Fail,49,39,4,8,41
60,Fail,48,33,0,12,36
60,Fail,46,39,4,11,35
60,Fail,51,32,4,13,38
60,Fail,46,34,1,19,27
60,Fail,43,40,0,16,27
60,Fail,54,31,0,15,39
60,Fail,34,39,0,16,18
60,Fail,49,34,0,16,33
60,Fail,53,32,0,14,39
60,Fail,53,34,6,7,46
60,Fail,45,35,0,13,32
60,Fail,45,29,0,17,28
60,Fail,60,27,1,12,48
60,Fail,44,37,4,15,29
60,Fail,46,37,5,12,34
60,Fail,44,43,0,13,31
60,Fail,49,32,3,16,33
60,Fail,42,42,0,14,28
60,Fail,50,34,1,15,35
60,Fail,56,33,0,11,45
60,Fail,53,30,6,11,42
60,Fail,44,42,0,10,34
60,Fail,49,41,0,8,41
60,Fail,43,30,0,16,27
60,Fail,50,42,0,8,42
60,Fail,52,30,0,17,35
60,Fail,50,29,8,13,37
60,Fail,52,35,5,8,44
60,Fail,43,41,0,13,30
60,Fail,52,37,2,9,43
60,Fail,54,34,3,9,45
60,Fail,56,24,0,14,42
60,Fail,47,41,0,12,35
60,Fail,50,39,0,11,39
60,Fail,52,30,0,13,39
60,Fail,45,38,5,12,33
60,Fail,48,34,5,13,35
60,Fail,54,35,0,10,44
60,Fail,47,30,7,16,31
60,Fail,52,27,10,11,41
60,Fail,36,46,7,11,25
60,Fail,47,39,0,12,35
60,Fail,38,44,0,14,24
60,Fail,46,40,0,13,33
60,Fail,48,33,0,12,36
60,Fail,40,33,9,18,22
60,Fail,46,30,10,14,32
60,Fail,47,35,3,15,32
60,Fail,46,35,4,15,31
60,Fail,51,37,0,10,41
60,Fail,51,35,2,12,39
60,Fail,55,31,0,13,42
60,Fail,51,35,0,8,43
60,Fail,55,36,1,8,47
60,Fail,46,29,0,15,31
60,Fail,49,34,0,10,39
60,Fail,46,34,4,16,30
60,Fail,55,32,0,10,45
60,Fail,48,38,0,11,37
60,Fail,52,33,2,13,39
60,Fail,38,41,0,19,19
60,Fail,45,39,4,12,33
60,Fail,41,41,0,13,28
60,Fail,46,36,2,16,30
60,Fail,43,36,8,13,30
60,Fail,41,41,0,16,25
60,Fail,55,30,0,12,43
60,Fail,48,39,0,13,35
60,Fail,46,32,0,14,32
60,Fail,52,35,0,13,39
60,Fail,46,42,1,11,35
60,Fail,54,31,6,9,45
60,Fail,54,31,0,10,44
60,Fail,46,41,0,11,35
60,Fail,48,37,2,13,35
60,Fail,44,38,0,15,29
60,Fail,49,33,0,15,34
60,Fail,42,31,0,16,26
60,Fail,44,36,0,17,27
60,Fail,50,34,4,12,38
60,Fail,48,33,4,15,33
60,Fail,48,39,0,10,38
60,Fail,52,34,6,8,44
60,Fail,45,39,0,15,30
60,Fail,54,35,1,10,44
60,Fail,45,32,0,17,28
60,Fail,46,38,0,12,34
60,Fail,42,43,0,13,29
60,Fail,54,24,6,16,38
60,Fail,45,34,0,17,28
60,Fail,46,35,4,15,31
60,Fail,43,42,0,12,31
60,Fail,46,32,6,16,30
60,Fail,48,39,0,7,41
60,Fail,59,28,1,12,47
60,Fail,52,35,0,13,39
60,Fail,54,24,6,16,38
60,Fail,53,32,0,12,41
60,Fail,51,35,3,11,40
60,Fail,51,35,5,9,42
60,Fail,43,43,1,13,30
60,Fail,50,39,2,9,41
60,Fail,48,35,0,15,33
60,Fail,44,44,0,8,36
60,Fail,55,34,0,7,48
60,Fail,51,31,9,9,42
60,Fail,45,37,7,11,34
60,Fail,46,36,3,15,31
60,Fail,50,37,0,11,39
60,Fail,47,34,0,16,31
60,Fail,53,36,1,10,43
60,Fail,44,42,0,13,31
60,Fail,58,30,5,7,51
60,Fail,41,41,0,18,23
60,Fail,50,28,0,18,32
60,Fail,52,31,0,13,39
60,Fail,45,38,10,7,38
60,Fail,49,36,0,14,35
60,Fail,53,36,0,10,43
60,Fail,46,41,0,13,33
60,Fail,49,32,0,17,32
60,Fail,55,32,0,9,46
60,Fail,40,41,0,16,24
60,Fail,46,36,2,16,30
60,Fail,46,36,4,14,32
60,Fail,51,35,0,12,39
60,Fail,58,28,0,11,47
60,Fail,46,35,0,10,36
60,Fail,51,38,0,10,41
60,Fail,44,41,0,12,32
60,Fail,47,34,4,15,32
60,Fail,55,27,2,16,39
60,Fail,51,33,0,14,37
60,Fail,42,43,6,9,33
60,Fail,47,29,7,17,30
60,Fail,50,37,2,11,39
60,Fail,54,31,0,13,41
60,Fail,50,35,0,14,36
60,Fail,45,34,0,12,33
60,Fail,56,35,3,6,50
60,Fail,40,34,0,15,25
60,Fail,49,34,1,16,33
60,Fail,46,34,0,15,31
60,Fail,44,28,0,18,26
60,Fail,55,31,0,14,41
60,Fail,49,31,0,9,40
60,Fail,52,30,3,15,37
60,Fail,47,36,0,17,30
60,Fail,49,29,0,12,37
60,Fail,49,30,0,21,28
60,Fail,46,38,0,14,32
60,Fail,52,34,0,8,44
60,Fail,50,38,3,9,41
60,Fail,46,38,0,10,36
60,Fail,49,34,0,16,33
60,Fail,44,44,0,6,38
60,Fail,40,32,7,21,19
60,Fail,45,34,0,15,30
60,Fail,53,27,2,18,35
60,Fail,51,31,8,10,41
60,Fail,53,39,0,6,47
60,Fail,52,33,0,9,43
60,Fail,47,38,0,13,34
60,Fail,51,35,0,14,37
60,Fail,61,29,1,9,52
60,Fail,47,35,0,12,35
60,Fail,52,39,1,8,44
60,Fail,51,29,0,14,37
60,Fail,47,37,5,11,36
60,Fail,52,30,7,11,41
60,Fail,51,37,0,8,43
60,Fail,54,32,0,9,45
60,Fail,48,33,7,12,36
60,Fail,48,26,12,14,34
60,Fail,43,40,0,13,30
60,Fail,54,29,4,13,41
60,Fail,53,24,11,12,41
60,Fail,47,28,0,7,40
60,Fail,47,29,11,13,34
60,Fail,50,39,0,11,39
60,Fail,57,31,0,9,48
60,Fail,41,43,0,13,28
60,Fail,46,38,3,13,33
60,Fail,52,31,4,13,39
60,Fail,43,37,5,15,28
60,Fail,53,36,0,10,43
60,Fail,53,35,5,7,46
60,Fail,56,34,0,10,46
60,Fail,48,38,3,11,37
60,Fail,43,37,3,17,26
60,Fail,45,47,2,6,39
60,Fail,51,34,0,8,43
60,Fail,48,36,4,12,36
60,Fail,47,39,0,14,33
60,Fail,49,38,3,10,39
60,Fail,51,33,6,10,41
60,Fail,40,33,0,15,25
60,Fail,50,31,4,15,35
60,Fail,49,36,3,12,37
60,Fail,44,37,0,15,29
60,Fail,44,48,2,6,38
60,Fail,56,34,0,9,47
60,Fail,45,35,7,13,32
60,Fail,51,34,2,13,38
60,Fail,45,34,3,18,27
60,Fail,49,35,4,12,37
60,Fail,47,40,0,13,34
60,Fail,44,38,3,15,29
60,Fail,52,39,3,6,46
60,Fail,51,33,0,16,35
60,Fail,53,37,0,10,43
60,Fail,44,43,0,12,32
60,Fail,53,34,0,11,42
60,Fail,58,27,0,12,46
60,Fail,49,31,8,12,37
60,Fail,49,31,0,16,33
60,Fail,60,32,0,8,52
60,Fail,44,37,12,7,37
60,Fail,54,39,0,7,47
60,Fail,47,41,0,11,36
60,Fail,46,33,9,12,34
60,Fail,47,40,1,12,35
60,Fail,49,37,0,14,35
60,Fail,44,39,6,11,33
60,Fail,49,41,0,9,40
60,Fail,50,37,1,12,38
60,Fail,53,27,5,15,38
60,Fail,46,42,0,9,37
60,Fail,47,36,0,13,34
60,Fail,52,37,0,9,43
60,Fail,46,36,6,12,34
60,Fail,40,45,4,11,29
60,Fail,50,33,0,15,35
60,Fail,50,38,2,10,40
60,Fail,53,34,0,7,46
60,Fail,36,38,0,18,18
60,Fail,48,33,0,14,34
60,Success,68,25,0,6,62
60,Fail,42,32,13,13,29
60,Fail,53,36,0,9,44
60,Fail,53,34,3,10,43
60,Fail,43,38,0,16,27
60,Fail,44,37,0,14,30
60,Fail,48,36,0,15,33
60,Fail,43,39,0,6,37
60,Fail,50,37,4,9,41
60,Fail,51,34,1,14,37
60,Fail,53,36,0,10,43
60,Fail,44,33,0,16,28
60,Fail,52,31,3,14,38
60,Fail,45,40,6,9,36
60,Fail,39,41,0,14,25
60,Fail,45,32,0,19,26
60,Fail,53,35,0,12,41
60,Fail,51,28,7,14,37
60,Fail,47,39,0,13,34
60,Fail,54,34,5,7,47
60,Fail,44,44,1,11,33
60,Fail,40,36,0,14,26
60,Fail,47,38,0,9,38
60,Fail,47,39,0,11,36
60,Fail,50,32,0,16,34
60,Fail,50,34,4,12,38
60,Fail,40,37,0,15,25
60,Fail,47,31,7,15,32
60,Fail,44,34,6,16,28
60,Fail,46,39,2,13,33
60,Fail,49,34,0,16,33
60,Fail,45,42,0,12,33
60,Fail,53,34,1,12,41
60,Fail,52,38,1,9,43
60,Fail,55,23,7,15,40
60,Fail,52,37,1,10,42
60,Fail,47,38,6,9,38
60,Fail,52,34,0,10,42
60,Fail,55,34,1,10,45
60,Fail,48,41,1,10,38
60,Fail,42,41,0,14,28
60,Fail,42,33,0,15,27
60,Fail,47,38,0,11,36
60,Fail,48,41,0,9,39
60,Fail,51,28,8,13,38
60,Fail,42,31,0,19,23
60,Fail,51,31,1,17,34
60,Fail,46,31,0,16,30
60,Fail,49,35,0,14,35
60,Fail,48,36,0,12,36
60,Fail,48,32,0,15,33
60,Fail,49,38,0,13,36
60,Fail,46,38,0,14,32
60,Fail,51,35,2,12,39
60,Fail,52,31,0,17,35
60,Fail,39,40,3,18,21
60,Fail,40,40,0,13,27
60,Fail,54,29,7,10,44
60,Fail,52,39,0,9,43
60,Fail,51,36,0,11,40
60,Fail,53,37,0,8,45
60,Fail,57,32,0,9,48
60,Fail,50,31,0,16,34
60,Fail,46,32,0,16,30
60,Fail,54,32,4,10,44
60,Fail,52,38,0,10,42
60,Fail,48,34,0,13,35
60,Fail,43,35,0,14,29
60,Fail,47,37,0,13,34
60,Fail,45,35,3,17,28
60,Fail,43,46,0,11,32
60,Fail,41,35,0,18,23
60,Fail,42,32,0,20,22
60,Fail,49,29,0,16,33
60,Fail,43,31,14,12,31
60,Fail,45,39,0,14,31
60,Fail,47,36,0,16,31
60,Fail,44,37,7,12,32
60,Fail,51,35,0,14,37
60,Fail,52,36,1,11,41
60,Fail,46,35,5,14,32
60,Fail,52,33,0,14,38
60,Fail,55,30,0,9,46
60,Fail,39,45,4,12,27
60,Fail,48,34,5,13,35
60,Fail,45,37,0,15,30
60,Fail,53,33,4,10,43
60,Fail,40,36,9,15,25
60,Fail,50,33,0,14,36
60,Fail,51,28,6,15,36
60,Fail,52,37,0,9,43
60,Fail,49,33,8,10,39
60,Fail,47,37,0,16,31
60,Fail,51,30,0,16,35
60,Fail,46,34,0,12,34
60,Fail,46,34,2,18,28
60,Fail,46,37,1,16,30
60,Fail,44,38,8,10,34
60,Fail,49,34,0,11,38
60,Fail,41,39,2,18,23
60,Fail,54,29,1,16,38
60,Fail,49,25,0,19,30
60,Fail,50,33,9,8,42
60,Fail,43,39,6,12,31
60,Fail,46,40,6,8,38
60,Fail,51,33,6,10,41
60,Fail,43,38,0,12,31
60,Fail,51,31,0,12,39
60,Fail,50,36,0,9,41
60,Fail,48,35,5,12,36
60,Fail,48,34,10,8,40
60,Fail,46,34,3,17,29
60,Fail,49,38,2,11,38
60,Fail,53,30,6,11,42
60,Fail,44,38,4,14,30
60,Fail,46,39,0,12,34
60,Fail,53,35,2,10,43
60,Fail,45,41,2,12,33
60,Fail,52,32,4,12,40
60,Fail,57,34,0,9,48
60,Fail,41,36,6,17,24
60,Fail,48,27,0,13,35
60,Fail,52,36,3,9,43
60,Fail,53,30,2,15,38
60,Fail,45,40,0,15,30
60,Fail,47,37,0,15,32
60,Fail,54,30,0,11,43
60,Fail,41,35,6,18,23
60,Fail,58,31,0,8,50
60,Fail,46,31,0,17,29
60,Fail,50,28,0,11,39
60,Fail,47,34,0,15,32
60,Fail,54,33,1,12,42
60,Fail,41,33,0,18,23
60,Fail,45,36,3,16,29
60,Fail,43,42,1,14,29
60,Fail,48,32,2,18,30
60,Fail,46,42,3,9,37
60,Fail,48,38,0,13,35
60,Fail,44,36,5,15,29
60,Fail,36,42,8,14,22
60,Fail,43,34,0,16,27
60,Fail,49,36,0,11,38
60,Fail,46,43,4,7,39
60,Fail,48,38,0,9,39
60,Fail,43,40,5,12,31
60,Fail,44,30,0,22,22
60,Fail,50,37,1,12,38
60,Fail,53,37,0,5,48
60,Fail,46,38,3,13,33
60,Fail,40,39,1,20,20
60,Fail,52,34,0,11,41
60,Fail,48,40,1,11,37
60,Fail,52,34,0,14,38
60,Fail,49,36,0,15,34
60,Fail,49,32,0,12,37
60,Fail,45,36,0,17,28
60,Fail,60,30,3,7,53
60,Fail,52,28,0,14,38
60,Fail,42,38,0,18,24
60,Fail,44,36,0,9,35
60,Fail,44,35,0,18,26
60,Fail,53,33,1,13,40
60,Fail,48,41,0,10,38
60,Fail,46,30,0,24,22
60,Fail,43,37,3,17,26
60,Fail,45,33,8,14,31
60,Fail,43,32,16,9,34
60,Fail,48,30,6,16,32
60,Fail,46,37,0,9,37
60,Fail,50,36,1,13,37
60,Fail,37,40,0,18,19
60,Fail,31,54,4,11,20
60,Fail,53,35,2,10,43
60,Fail,48,31,4,17,31
60,Fail,46,38,6,10,36
60,Fail,44,31,9,16,28
60,Fail,49,36,0,10,39
60,Fail,45,32,0,17,28
60,Fail,53,33,4,10,43
60,Fail,52,27,0,17,35
60,Fail,49,28,7,16,33
60,Fail,41,27,10,22,19
60,Fail,48,36,8,8,40
60,Fail,49,40,0,8,41
60,Fail,49,37,0,14,35
60,Fail,46,35,9,10,36
60,Fail,52,35,3,10,42
60,Fail,54,26,6,14,40
60,Fail,49,38,5,8,41
60,Fail,50,37,2,11,39
60,Fail,46,42,0,9,37
60,Fail,54,33,0,12,42
60,Fail,43,34,0,17,26
60,Fail,45,39,5,11,34
60,Fail,42,31,0,18,24
60,Fail,46,36,7,11,35
60,Fail,55,27,6,12,43
60,Fail,53,33,0,8,45
60,Fail,48,39,0,10,38
60,Fail,45,38,0,13,32
60,Fail,47,39,1,13,34
60,Fail,46,34,8,12,34
60,Fail,48,36,0,9,39
60,Fail,48,30,2,20,28
60,Fail,48,37,4,11,37
60,Fail,50,32,0,13,37
60,Fail,51,39,1,9,42
60,Fail,53,36,0,10,43
60,Fail,47,38,0,9,38
60,Fail,52,27,8,13,39
60,Fail,57,28,4,11,46
60,Fail,48,38,0,14,34
60,Fail,48,32,6,14,34
60,Fail,51,40,0,7,44
60,Fail,53,33,0,10,43
60,Fail,44,37,0,16,28
60,Fail,52,35,3,10,42
60,Fail,50,36,5,9,41
60,Fail,50,36,1,13,37
60,Fail,51,36,0,13,38
60,Fail,49,32,9,10,39
60,Fail,44,25,0,14,30
60,Fail,46,33,6,15,31
60,Fail,59,31,3,7,52
60,Fail,44,39,0,9,35
60,Fail,51,26,0,9,42
60,Fail,45,37,0,15,30
60,Fail,45,37,0,14,31
60,Fail,47,38,0,8,39
60,Fail,51,35,0,13,38
60,Fail,54,35,2,9,45
60,Fail,45,30,0,15,30
60,Fail,52,34,2,12,40
60,Fail,43,38,7,12,31
60,Fail,52,34,0,12,40
60,Fail,46,36,4,14,32
60,Fail,42,39,6,13,29
60,Fail,52,33,8,7,45
60,Fail,47,43,0,6,41
60,Fail,54,29,0,14,40
60,Fail,50,37,2,11,39
60,Fail,48,36,5,11,37
60,Fail,37,39,7,17,20
60,Fail,56,32,1,11,45
60,Fail,45,37,4,14,31
60,Fail,51,36,0,10,41
60,Fail,50,31,3,16,34
60,Fail,55,33,0,9,46
60,Fail,48,40,0,12,36
60,Fail,54,36,0,10,44
60,Fail,48,31,0,15,33
60,Fail,47,37,0,11,36
60,Fail,56,31,0,12,44
60,Fail,49,33,0,11,38
60,Fail,47,37,1,15,32
60,Fail,56,28,0,10,46
60,Fail,45,41,1,13,32
60,Fail,47,33,0,8,39
60,Fail,50,38,0,7,43
60,Fail,52,35,2,11,41
60,Fail,48,37,0,9,39
60,Fail,50,28,8,14,36
60,Fail,44,37,1,18,26
60,Fail,52,38,1,9,43
60,Fail,50,37,3,10,40
60,Fail,48,39,0,13,35
60,Fail,45,40,0,15,30
60,Fail,46,39,5,10,36
60,Fail,51,26,5,18,33
60,Fail,48,37,0,12,36
60,Fail,48,39,0,9,39
60,Fail,38,36,7,19,19
60,Fail,52,34,0,14,38
60,Fail,42,41,0,13,29
60,Fail,45,42,2,11,34
60,Fail,50,32,0,13,37
60,Fail,48,33,7,12,36
60,Fail,46,40,4,10,36
60,Fail,44,38,0,16,28
60,Fail,47,35,7,11,36
60,Fail,46,39,4,11,35
60,Fail,44,40,0,13,31
60,Fail,52,36,6,6,46
60,Fail,49,40,4,7,42
60,Fail,45,30,4,21,24
60,Fail,57,28,5,10,47
60,Fail,45,32,0,16,29
60,Fail,55,33,0,12,43
60,Fail,39,33,8,20,19
60,Fail,49,40,1,10,39
60,Fail,43,38,6,13,30
60,Fail,55,32,3,10,45
60,Fail,44,40,1,15,29
60,Fail,49,39,0,12,37
60,Fail,53,31,0,14,39
60,Fail,52,34,1,13,39
60,Fail,61,32,3,4,57
60,Fail,45,42,0,13,32
60,Fail,52,37,0,11,41
60,Fail,45,36,0,12,33
60,Fail,46,42,2,10,36
60,Fail,50,34,0,13,37
60,Fail,41,36,6,17,24
60,Fail,54,33,7,6,48
60,Fail,48,36,0,14,34
60,Fail,58,33,0,8,50
60,Fail,54,35,5,6,48
60,Fail,54,36,2,8,46
60,Fail,41,38,7,14,27
60,Fail,56,39,0,5,51
60,Fail,50,34,0,15,35
60,Fail,40,44,1,15,25
60,Fail,46,30,6,18,28
60,Fail,40,39,0,14,26
60,Fail,46,42,1,11,35
60,Fail,43,34,0,17,26
60,Fail,47,39,0,11,36
60,Fail,49,35,0,16,33
60,Fail,51,34,0,10,41
60,Fail,48,30,0,12,36
60,Fail,53,34,0,12,41
60,Fail,49,31,4,16,33
60,Fail,51,36,4,9,42
60,Fail,48,34,2,16,32
60,Fail,40,44,0,12,28
60,Fail,51,30,7,12,39
60,Fail,50,27,0,18,32
60,Fail,52,29,6,13,39
60,Fail,47,37,0,15,32
60,Fail,37,40,7,16,21
60,Fail,47,39,0,11,36
60,Fail,53,28,9,10,43
60,Fail,44,39,4,13,31
60,Fail,54,34,0,11,43
60,Fail,55,27,0,18,37
60,Fail,58,32,0,6,52
60,Fail,54,36,0,9,45
60,Fail,52,36,0,12,40
60,Fail,54,34,0,7,47
60,Fail,50,30,0,17,33
60,Fail,45,38,3,14,31
60,Fail,43,40,0,17,26
60,Fail,51,30,7,12,39
60,Fail,41,29,0,22,19
60,Fail,45,37,0,14,31
60,Fail,59,33,2,6,53
60,Fail,54,36,0,8,46
60,Fail,56,29,8,7,49
60,Fail,55,36,1,8,47
60,Fail,44,43,0,9,35
60,Fail,47,33,3,17,30
60,Fail,53,36,1,10,43
60,Fail,41,39,0,12,29
60,Fail,52,36,0,12,40
60,Fail,51,34,0,13,38
60,Fail,49,38,8,5,44
60,Fail,43,39,10,8,35
60,Fail,51,31,0,13,38
60,Fail,43,39,2,16,27
60,Fail,59,30,0,11,48
60,Fail,47,33,3,17,30
60,Fail,50,33,4,13,37
60,Fail,38,39,10,13,25
60,Fail,47,36,0,17,30
60,Fail,43,41,3,13,30
60,Fail,44,38,9,9,35
60,Fail,53,33,3,11,42
60,Fail,55,32,0,6,49
60,Fail,50,39,0,10,40
60,Fail,55,32,0,13,42
60,Fail,48,33,4,15,33
60,Fail,50,38,0,12,38
60,Fail,46,39,0,8,38
60,Fail,50,37,2,11,39
60,Fail,50,32,5,13,37
60,Fail,55,35,0,10,45
60,Fail,51,31,3,15,36
60,Fail,44,33,0,17,27
60,Fail,53,20,11,16,37
60,Fail,43,38,0,12,31
60,Fail,44,34,10,12,32
60,Fail,52,34,0,7,45
60,Fail,49,36,0,7,42
60,Fail,53,36,0,10,43
60,Fail,47,41,2,10,37
60,Fail,48,42,0,6,42
60,Fail,47,38,0,12,35
60,Fail,45,38,0,17,28
60,Fail,49,36,2,13,36
60,Fail,48,37,0,14,34
60,Fail,47,40,5,8,39
60,Fail,60,25,0,12,48
60,Fail,40,44,3,13,27
60,Fail,40,40,0,15,25
60,Fail,46,35,4,15,31
60,Fail,52,30,0,14,38
60,Fail,51,35,1,13,38
60,Fail,54,36,2,8,46
60,Fail,45,34,0,16,29
60,Fail,47,33,5,15,32
60,Fail,51,30,6,13,38
60,Fail,54,29,0,14,40
60,Fail,53,37,0,10,43
60,Fail,53,34,4,9,44
60,Fail,45,40,2,13,32
60,Fail,49,39,0,10,39
60,Fail,47,42,0,4,43
60,Fail,43,41,0,16,27
60,Fail,49,32,2,17,32
60,Fail,42,41,0,11,31
60,Fail,49,36,1,14,35
60,Fail,54,30,0,15,39
60,Fail,44,40,4,12,32
60,Fail,52,28,0,16,36
60,Fail,46,40,0,13,33
60,Fail,46,41,0,10,36
60,Fail,53,30,4,13,40
60,Fail,48,35,5,12,36
60,Fail,43,44,1,12,31
60,Fail,49,40,0,11,38
60,Fail,49,40,0,10,39
60,Fail,47,36,1,16,31
60,Fail,52,36,2,10,42
60,Fail,49,36,3,12,37
60,Fail,49,36,4,11,38
60,Fail,47,36,0,12,35
60,Fail,46,38,3,13,33
60,Fail,52,39,1,8,44
60,Fail,37,51,1,11,26
60,Fail,52,32,8,8,44
60,Fail,51,35,0,9,42
60,Fail,44,31,0,19,25
60,Fail,37,45,3,15,22
60,Fail,44,35,1,20,24
60,Fail,52,32,5,11,41
60,Fail,53,32,0,13,40
60,Fail,45,37,5,13,32
60,Fail,46,34,0,17,29
60,Fail,50,34,4,12,38
60,Fail,58,27,0,12,46
60,Fail,45,40,0,14,31
60,Fail,50,38,0,8,42
60,Fail,42,41,0,13,29
60,Fail,44,38,5,13,31
60,Fail,49,31,0,13,36
60,Fail,48,37,0,11,37
60,Fail,56,29,7,8,48
60,Fail,42,34,0,17,25
60,Fail,46,40,0,10,36
60,Fail,45,41,0,9,36
60,Fail,48,30,0,12,36
60,Fail,48,31,0,15,33
60,Fail,46,37,6,11,35
60,Fail,49,38,0,12,37
60,Fail,52,30,0,14,38
60,Fail,55,36,0,8,47
60,Fail,44,40,0,15,29
60,Fail,48,35,0,10,38
60,Fail,48,37,2,13,35
60,Fail,57,32,0,9,48
60,Fail,49,31,0,16,33
60,Fail,60,30,2,8,52
60,Fail,50,38,0,9,41
60,Fail,49,30,9,12,37
60,Fail,44,33,0,15,29
60,Fail,48,37,0,11,37
60,Fail,45,42,3,10,35
60,Fail,41,41,0,13,28
60,Fail,46,40,2,12,34
60,Fail,52,34,3,11,41
60,Fail,52,31,0,13,39
60,Fail,49,34,0,15,34
60,Fail,42,32,7,19,23
60,Fail,42,38,4,16,26
60,Fail,51,30,0,11,40
60,Fail,41,41,0,14,27
60,Fail,44,34,8,14,30
60,Fail,48,44,0,8,40
60,Fail,49,29,4,18,31
60,Fail,43,26,7,24,19
60,Fail,46,41,6,7,39
60,Fail,51,27,0,12,39
60,Fail,49,37,5,9,40
60,Fail,45,37,0,15,30
60,Fail,46,38,0,10,36
60,Fail,44,38,0,15,29
60,Fail,51,38,0,10,41
60,Fail,50,35,0,14,36
60,Fail,52,33,0,9,43
60,Fail,48,39,2,11,37
60,Fail,40,38,0,18,22
60,Fail,53,31,3,13,40
60,Fail,47,40,4,9,38
60,Fail,46,40,0,12,34
60,Fail,51,33,1,15,36
60,Fail,40,38,4,18,22
60,Fail,55,34,0,8,47
60,Fail,47,45,0,8,39
60,Fail,53,37,0,10,43
60,Fail,53,36,0,11,42
60,Fail,51,26,0,13,38
60,Fail,50,30,0,15,35
60,Fail,47,34,0,13,34
60,Fail,44,41,1,14,30
60,Fail,41,41,0,13,28
60,Fail,52,32,4,12,40
60,Fail,46,38,0,11,35
60,Fail,43,38,3,16,27
60,Fail,53,30,7,10,43
60,Fail,51,31,0,16,35
60,Fail,51,23,8,18,33
60,Fail,44,36,2,18,26
60,Fail,48,39,0,12,36
60,Fail,48,29,0,16,32
60,Fail,57,31,0,8,49
60,Fail,49,37,4,10,39
60,Fail,40,34,11,15,25
60,Fail,52,42,0,4,48
60,Fail,48,40,0,12,36
60,Fail,44,36,9,11,33
60,Fail,53,33,0,11,42
60,Fail,49,31,7,13,36
60,Fail,44,37,0,9,35
60,Fail,50,29,8,13,37
60,Fail,46,41,0,8,38
60,Fail,54,38,0,8,46
60,Fail,42,34,5,19,23
60,Fail,50,34,0,10,40
60,Fail,42,38,0,12,30
60,Fail,38,36,5,21,17
60,Fail,45,41,0,9,36
60,Fail,51,34,0,9,42
60,Fail,49,31,0,18,31
60,Fail,48,33,0,15,33
60,Fail,48,31,8,13,35
60,Fail,52,32,4,12,40
60,Fail,43,40,7,10,33
60,Fail,47,34,1,18,29
60,Fail,44,39,2,15,29
60,Fail,50,42,0,7,43
60,Fail,49,35,4,12,37
60,Fail,58,31,4,7,51
60,Fail,51,29,3,17,34
60,Fail,56,35,0,4,52
60,Fail,45,42,0,10,35
60,Fail,48,39,0,12,36
60,Fail,55,36,0,5,50
60,Fail,45,34,7,14,31
60,Fail,47,41,0,12,35
60,Fail,47,30,0,18,29
60,Fail,49,39,0,9,40
60,Fail,45,34,2,19,26
60,Fail,50,39,1,10,40
60,Fail,48,26,0,25,23
60,Fail,50,35,0,13,37
60,Fail,51,38,3,8,43
60,Fail,47,41,0,11,36
60,Fail,43,40,6,11,32
60,Fail,56,29,0,15,41
60,Fail,54,33,5,8,46
60,Fail,42,43,0,11,31
60,Fail,49,35,0,10,39
60,Fail,46,29,14,11,35
60,Fail,52,32,0,11,41
60,Fail,48,26,0,11,37
60,Fail,54,38,0,8,46
60,Fail,46,31,0,14,32
60,Fail,55,31,0,14,41
60,Fail,47,33,0,18,29
60,Fail,43,47,1,9,34
60,Fail,47,39,5,9,38
60,Fail,48,31,7,14,34
60,Fail,49,35,0,13,36
60,Fail,46,35,0,11,35
60,Fail,42,33,0,17,25
60,Fail,50,35,0,12,38
60,Fail,55,37,0,8,47
60,Fail,38,38,13,11,27
60,Fail,57,29,0,10,47
60,Fail,47,37,0,16,31
60,Fail,47,35,0,18,29
60,Fail,46,38,0,16,30
60,Fail,50,34,4,12,38
60,Fail,55,29,7,9,46
60,Fail,52,32,0,10,42
60,Fail,44,37,2,17,27
60,Fail,51,37,0,11,40
60,Fail,54,25,13,8,46
60,Fail,41,38,0,19,22
60,Fail,51,37,1,11,40
60,Fail,53,36,0,7,46
60,Fail,44,39,4,13,31
60,Fail,53,36,1,10,43
60,Fail,50,35,6,9,41
60,Fail,49,38,4,9,40
60,Fail,49,36,0,14,35
60,Fail,49,34,1,16,33
60,Fail,45,37,5,13,32
60,Fail,56,36,0,8,48
60,Fail,58,28,0,13,45
60,Fail,48,32,0,16,32
60,Fail,46,39,0,10,36
60,Fail,44,38,0,16,28
60,Fail,46,41,3,10,36
60,Fail,49,40,0,9,40
60,Fail,50,33,4,13,37
60,Fail,43,40,0,14,29
60,Fail,45,37,0,17,28
60,Fail,49,38,1,12,37
60,Fail,49,31,0,19,30
60,Fail,43,41,0,10,33
60,Fail,56,29,4,11,45
60,Fail,60,34,2,4,56
60,Fail,52,40,0,5,47
60,Fail,54,33,0,6,48
60,Fail,48,36,7,9,39
60,Fail,57,29,0,13,44
60,Fail,47,35,1,17,30
60,Fail,53,30,0,10,43
60,Fail,53,33,1,13,40
60,Fail,44,42,0,14,30
60,Fail,47,39,0,12,35
60,Fail,44,44,0,10,34
60,Fail,43,36,0,12,31
60,Fail,42,42,0,16,26
60,Fail,48,34,7,11,37
60,Fail,43,36,6,15,28
60,Fail,45,38,0,15,30
60,Fail,45,36,0,12,33
60,Fail,54,31,0,9,45
60,Fail,50,31,0,12,38
60,Fail,50,36,2,12,38
60,Fail,44,41,4,11,33
60,Fail,49,36,2,13,36
60,Fail,56,30,2,12,44
60,Fail,50,32,0,17,33
60,Fail,47,38,0,15,32
60,Fail,44,47,0,9,35
60,Fail,42,38,0,18,24
60,Fail,50,41,0,4,46
60,Fail,51,31,0,11,40
60,Fail,53,34,0,12,41
60,Fail,48,33,0,9,39
60,Fail,45,40,0,13,32
60,Fail,45,35,0,20,25
60,Fail,45,38,0,17,28
60,Fail,55,33,0,10,45
60,Fail,48,31,11,10,38
60,Fail,42,41,0,11,31
60,Fail,47,34,8,11,36
60,Fail,48,35,0,12,36
60,Fail,50,37,1,12,38
60,Fail,43,37,0,17,26
60,Fail,50,31,1,18,32
60,Fail,52,29,5,14,38
60,Fail,48,38,1,13,35
60,Fail,52,34,0,5,47
60,Fail,56,34,0,10,46
60,Fail,43,37,0,15,28
60,Fail,38,40,2,20,18
60,Fail,49,37,0,10,39
60,Fail,42,46,4,8,34
60,Fail,49,36,0,14,35
60,Fail,52,34,0,11,41
60,Fail,45,34,0,18,27
60,Fail,49,34,3,14,35
60,Fail,42,39,5,14,28
60,Fail,51,33,0,11,40
60,Fail,47,37,2,14,33
60,Fail,45,41,2,12,33
60,Fail,50,26,8,16,34
60,Fail,42,41,3,14,28
60,Fail,51,37,0,10,41
60,Fail,56,31,7,6,50
60,Fail,48,34,0,16,32
60,Fail,45,33,8,14,31
60,Fail,42,41,1,16,26
60,Fail,53,38,0,7,46
60,Fail,45,33,0,16,29
60,Fail,41,38,1,20,21
60,Fail,45,43,0,12,33
60,Fail,53,29,0,14,39
60,Fail,44,40,0,14,30
60,Fail,57,29,0,14,43
60,Fail,56,30,0,8,48
60,Fail,47,41,1,11,36
60,Fail,48,35,0,13,35
60,Fail,49,29,4,18,31
60,Fail,47,38,0,14,33
60,Fail,46,36,8,10,36
60,Fail,46,40,0,8,38
60,Fail,56,30,1,13,43
60,Fail,50,35,0,13,37
60,Fail,39,38,7,16,23
60,Fail,52,32,0,16,36
60,Fail,54,39,0,5,49
60,Fail,49,29,0,19,30
60,Fail,45,37,0,11,34
60,Fail,51,30,1,18,33
60,Fail,44,35,6,15,29
60,Fail,42,35,7,16,26
60,Fail,45,32,0,17,28
60,Fail,48,37,1,14,34
60,Fail,45,42,0,11,34
60,Fail,49,38,1,12,37
60,Fail,44,37,0,9,35
60,Fail,43,36,8,13,30
60,Fail,46,38,0,14,32
60,Fail,48,41,1,10,38
60,Fail,43,37,1,19,24
60,Fail,40,41,1,18,22
60,Fail,53,37,2,8,45
60,Fail,45,34,0,15,30
60,Fail,48,32,0,12,36
60,Fail,49,36,1,14,35
60,Fail,45,42,4,9,36
60,Fail,54,31,0,13,41
60,Fail,54,34,0,7,47
60,Fail,52,34,1,13,39
60,Fail,51,36,0,9,42
60,Fail,54,33,0,11,43
60,Fail,52,36,0,12,40
60,Fail,40,36,9,15,25
60,Fail,48,39,0,9,39
60,Fail,54,38,0,8,46
60,Fail,53,29,2,16,37
60,Fail,49,41,0,10,39
60,Fail,46,38,0,13,33
60,Fail,45,28,7,20,25
60,Fail,42,39,0,16,26
60,Fail,52,32,1,15,37
60,Fail,41,39,0,14,27
60,Fail,44,36,10,10,34
60,Fail,59,23,0,15,44
60,Fail,49,29,0,17,32
60,Fail,55,34,2,9,46
60,Fail,52,32,0,12,40
60,Fail,48,35,2,15,33
60,Fail,52,31,0,10,42
60,Fail,47,31,0,17,30
60,Fail,49,31,0,17,32
60,Fail,49,38,0,12,37
60,Fail,49,38,0,11,38
60,Fail,49,34,0,15,34
60,Fail,48,39,1,12,36
60,Fail,47,36,0,15,32
60,Fail,43,34,7,16,27
60,Fail,42,33,0,19,23
60,Fail,50,32,0,15,35
60,Fail,51,37,0,12,39
60,Fail,52,29,3,16,36
60,Fail,47,29,0,15,32
60,Fail,44,42,0,12,32
60,Fail,41,45,0,12,29
60,Fail,50,36,0,10,40
60,Fail,47,40,0,12,35
60,Fail,40,39,0,13,27
60,Fail,57,29,2,12,45
60,Fail,45,34,10,11,34
60,Fail,53,36,2,9,44
60,Fail,53,32,0,13,40
60,Fail,50,37,1,12,38
60,Fail,50,29,10,11,39
60,Fail,42,40,0,14,28
60,Fail,53,36,0,7,46
60,Fail,45,37,0,12,33
60,Fail,44,35,0,18,26
60,Fail,54,33,1,12,42
60,Fail,47,37,0,10,37
60,Fail,50,38,1,11,39
60,Fail,48,30,0,16,32
60,Fail,59,28,0,12,47
60,Fail,49,34,6,11,38
60,Fail,41,37,4,18,23
60,Fail,53,31,0,15,38
60,Fail,49,36,4,11,38
60,Fail,43,33,9,15,28
60,Fail,49,30,8,13,36
60,Fail,50,36,0,12,38
60,Fail,59,28,0,10,49
60,Fail,45,40,0,13,32
60,Fail,48,36,0,11,37
60,Fail,53,29,0,15,38
60,Fail,44,38,0,12,32
60,Fail,49,35,0,14,35
60,Fail,52,35,3,10,42
60,Fail,46,30,0,22,24
60,Fail,45,36,5,14,31
60,Fail,53,36,0,9,44
60,Fail,49,38,1,12,37
60,Fail,46,36,0,15,31
60,Fail,45,37,0,11,34
60,Fail,50,36,1,13,37
60,Fail,47,35,5,13,34
60,Fail,43,36,0,15,28
60,Fail,45,37,3,15,30
60,Fail,39,41,6,14,25
60,Fail,48,33,3,16,32
60,Fail,46,37,4,13,33
60,Fail,46,42,4,8,38
60,Fail,51,36,2,11,40
60,Fail,45,41,2,12,33
60,Fail,48,40,0,11,37
60,Fail,44,36,0,16,28
60,Fail,47,33,0,12,35
60,Fail,48,37,0,12,36
60,Fail,40,32,0,15,25
60,Fail,54,35,0,11,43
60,Fail,46,34,7,13,33
60,Fail,50,35,0,9,41
60,Fail,55,33,0,12,43
60,Fail,50,38,0,12,38
60,Fail,44,33,7,16,28
60,Fail,45,39,0,13,32
60,Fail,52,36,0,6,46
60,Fail,51,36,3,10,41
60,Fail,46,35,0,13,33
60,Fail,49,41,0,10,39
60,Fail,43,33,0,15,28
60,Fail,49,41,0,10,39
60,Fail,47,30,0,16,31
60,Fail,45,38,2,15,30
60,Fail,47,34,0,15,32
60,Fail,47,40,2,11,36
60,Fail,50,34,4,12,38
60,Fail,46,36,0,15,31
60,Fail,44,41,0,12,32
60,Fail,53,32,0,10,43
60,Fail,45,32,8,15,30
60,Fail,60,32,2,6,54
60,Fail,42,34,8,16,26
60,Fail,64,26,1,9,55
60,Fail,52,38,0,9,43
60,Fail,51,38,3,8,43
60,Fail,41,45,0,11,30
60,Fail,50,30,0,15,35
60,Fail,48,33,5,14,34
60,Fail,45,41,1,13,32
60,Fail,36,37,4,23,13
60,Fail,49,32,0,16,33
60,Fail,48,38,1,13,35
60,Fail,45,32,5,18,27
60,Fail,38,36,12,14,24
60,Fail,48,38,0,12,36
60,Fail,50,38,2,10,40
60,Fail,47,34,0,15,32
60,Fail,51,37,6,6,45
60,Fail,47,36,6,11,36
60,Fail,59,28,5,8,51
60,Fail,44,41,0,13,31
60,Fail,49,32,0,11,38
60,Fail,50,36,0,11,39
60,Fail,56,32,0,10,46
60,Fail,45,41,1,13,32
60,Fail,53,35,3,9,44
60,Fail,46,35,0,14,32
60,Fail,54,31,1,14,40
60,Fail,38,39,0,15,23
60,Fail,54,31,0,11,43
60,Fail,55,29,8,8,47
60,Fail,54,30,5,11,43
60,Fail,49,36,0,12,37
60,Fail,45,36,0,12,33
60,Fail,48,26,0,15,33
60,Fail,44,38,6,12,32
60,Fail,46,37,0,14,32
60,Fail,38,45,1,16,22
60,Fail,48,37,0,13,35
60,Fail,49,40,0,8,41
60,Fail,50,36,0,12,38
60,Fail,43,32,0,16,27
60,Fail,39,49,2,10,29
60,Fail,54,33,0,11,43
60,Fail,60,29,0,9,51
60,Fail,49,34,7,10,39
60,Fail,48,39,2,11,37
60,Fail,56,30,5,9,47
60,Fail,51,34,0,13,38
60,Fail,44,37,11,8,36
60,Fail,46,40,2,12,34
60,Fail,46,42,3,9,37
60,Fail,57,29,0,9,48
60,Fail,46,34,10,10,36
60,Fail,46,33,0,21,25
60,Fail,43,39,0,14,29
60,Fail,53,39,0,6,47
60,Fail,56,33,2,9,47
60,Fail,54,37,0,7,47
60,Fail,50,30,0,12,38
60,Fail,43,35,0,12,31
60,Fail,46,41,1,12,34
60,Fail,44,44,7,5,39
60,Fail,56,33,0,11,45
60,Fail,47,34,0,18,29
60,Fail,41,41,6,12,29
60,Fail,54,29,2,15,39
60,Fail,54,40,1,5,49
60,Fail,47,39,5,9,38
60,Fail,44,30,8,18,26
60,Fail,49,37,1,13,36
60,Fail,44,39,3,14,30
60,Fail,52,36,0,11,41
60,Fail,52,32,1,15,37
60,Fail,33,44,0,16,17
60,Fail,53,36,2,9,44
60,Fail,47,35,0,11,36
60,Fail,52,36,0,12,40
60,Fail,51,37,0,10,41
60,Fail,40,34,0,18,22
60,Fail,40,48,0,8,32
60,Fail,45,48,0,6,39
60,Fail,44,37,0,14,30
60,Fail,50,33,6,11,39
60,Fail,48,37,0,14,34
60,Fail,51,35,0,11,40
60,Fail,49,32,5,14,35
60,Fail,52,34,0,14,38
60,Fail,46,30,0,17,29
60,Fail,37,50,1,12,25
60,Fail,46,34,3,17,29
60,Fail,53,35,3,9,44
60,Fail,42,37,2,19,23
60,Fail,46,34,0,15,31
60,Fail,51,33,0,9,42
60,Fail,43,34,0,14,29
60,Fail,45,32,10,13,32
60,Fail,52,32,2,14,38
60,Fail,50,35,1,14,36
60,Fail,48,32,8,12,36
60,Fail,43,34,0,21,22
60,Fail,44,41,0,13,31
60,Fail,49,36,0,11,38
60,Fail,56,32,0,12,44
60,Fail,41,32,0,15,26
60,Fail,43,38,0,13,30
60,Fail,51,35,0,12,39
60,Fail,52,37,0,10,42
60,Fail,40,36,10,14,26
60,Fail,46,35,0,17,29
60,Fail,47,33,4,16,31
60,Fail,51,29,8,12,39
60,Fail,49,41,1,9,40
60,Fail,53,34,0,12,41
60,Fail,44,36,7,13,31
60,Fail,51,29,5,15,36
60,Fail,48,40,3,9,39
60,Fail,42,40,4,14,28
60,Fail,47,35,5,13,34
60,Fail,53,30,4,13,40
60,Fail,48,39,4,9,39
60,Fail,38,42,4,16,22
60,Fail,48,42,3,7,41
60,Fail,53,29,6,12,41
60,Fail,48,34,0,15,33
60,Fail,49,33,0,10,39
60,Fail,41,39,6,14,27
60,Fail,48,37,0,12,36
60,Fail,53,30,0,17,36
60,Fail,41,44,0,12,29
60,Fail,52,39,0,3,49
60,Fail,42,39,0,17,25
60,Fail,43,41,0,9,34
60,Fail,48,44,1,7,41
60,Fail,49,42,1,8,41
60,Fail,49,39,0,11,38
60,Fail,49,31,7,13,36
60,Fail,48,34,5,13,35
60,Fail,50,34,5,11,39
60,Fail,37,45,0,13,24
60,Fail,50,38,0,11,39
60,Fail,49,34,1,16,33
60,Fail,55,35,3,7,48
60,Fail,53,27,10,10,43
60,Fail,57,30,1,12,45
60,Fail,53,26,10,11,42
60,Fail,47,33,0,13,34
60,Fail,43,38,0,13,30
60,Fail,48,35,0,13,35
60,Fail,48,39,0,12,36
60,Fail,48,33,4,15,33
60,Fail,40,40,0,16,24
60,Fail,47,34,2,17,30
60,Fail,47,38,0,10,37
60,Fail,54,31,0,9,45
60,Fail,50,38,0,8,42
60,Fail,50,25,0,16,34
60,Fail,46,36,4,14,32
60,Fail,51,29,0,12,39
60,Fail,51,30,0,13,38
60,Fail,54,37,0,8,46
60,Fail,54,30,9,7,47
60,Fail,50,38,0,12,38
60,Fail,50,28,8,14,36
60,Fail,49,35,0,13,36
60,Fail,43,39,0,17,26
60,Fail,45,34,2,19,26
60,Fail,42,38,0,16,26
60,Fail,45,43,0,11,34
60,Fail,49,41,0,10,39
60,Fail,48,38,2,12,36
60,Fail,47,38,3,12,35
60,Fail,43,36,0,15,28
60,Fail,52,34,0,12,40
60,Fail,46,40,0,13,33
60,Fail,49,32,0,12,37
60,Fail,53,35,0,11,42
60,Fail,54,29,7,10,44
60,Fail,50,32,8,10,40
60,Fail,51,31,0,14,37
60,Fail,45,33,0,16,29
60,Fail,44,44,0,12,32
60,Fail,53,34,0,10,43
60,Fail,46,38,2,14,32
60,Fail,50,37,2,11,39
60,Fail,47,39,5,9,38
60,Fail,50,36,0,9,41
60,Fail,41,44,0,11,30
60,Fail,53,28,0,18,35
60,Fail,44,39,0,13,31
60,Fail,45,39,1,15,30
60,Fail,50,30,6,14,36
60,Fail,44,37,0,16,28
60,Fail,54,32,2,12,42
60,Fail,43,42,5,10,33
60,Fail,42,38,0,14,28
60,Fail,52,33,0,8,44
60,Fail,47,31,0,18,29
60,Fail,47,37,7,9,38
60,Fail,45,41,1,13,32
60,Fail,48,39,1,12,36
60,Fail,55,30,0,14,41
60,Fail,43,32,11,14,29
60,Fail,39,34,10,17,22
60,Fail,50,26,0,13,37
60,Fail,48,38,0,13,35
60,Fail,42,31,0,17,25
60,Fail,46,41,0,12,34
60,Fail,52,31,5,12,40
60,Fail,50,40,2,8,42
60,Fail,46,33,0,18,28
60,Fail,57,32,0,11,46
60,Fail,52,36,0,11,41
60,Fail,45,36,5,14,31
60,Fail,46,34,11,9,37
60,Fail,48,38,0,13,35
60,Fail,51,32,1,16,35
60,Fail,40,42,4,14,26
60,Fail,51,33,0,14,37
60,Fail,53,33,0,9,44
60,Fail,57,29,1,13,44
60,Fail,50,34,2,14,36
60,Fail,41,34,0,16,25
60,Fail,53,36,0,10,43
60,Fail,52,37,7,4,48
60,Fail,53,32,0,12,41
60,Fail,53,32,0,12,41
60,Fail,46,43,1,10,36
60,Fail,50,39,0,11,39
60,Fail,50,27,0,18,32
60,Fail,44,35,3,18,26
60,Fail,51,35,0,12,39
60,Fail,47,39,0,12,35
60,Fail,52,36,4,8,44
60,Fail,47,35,0,14,33
60,Fail,50,32,3,15,35
60,Fail,47,35,9,9,38
60,Fail,48,41,0,9,39
60,Fail,52,33,0,11,41
60,Fail,48,35,3,14,34
60,Fail,46,41,2,11,35
60,Fail,47,34,0,19,28
60,Fail,54,27,3,16,38
60,Fail,55,32,1,12,43
60,Fail,48,38,2,12,36
60,Fail,46,42,1,11,35
60,Fail,50,38,2,10,40
60,Fail,48,36,6,10,38
60,Fail,47,37,0,12,35
60,Fail,57,34,0,9,48
60,Fail,47,41,0,12,35
60,Fail,51,39,0,8,43
60,Fail,53,35,0,11,42
60,Fail,48,38,0,12,36
60,Fail,44,36,4,16,28
60,Fail,45,36,2,17,28
60,Fail,45,38,7,10,35
60,Fail,42,40,0,11,31
60,Fail,54,27,3,16,38
60,Fail,48,34,4,14,34
60,Fail,46,40,0,8,38
60,Fail,43,36,0,20,23
60,Fail,53,36,0,11,42
60,Fail,56,33,0,9,47
60,Fail,46,37,0,13,33
60,Fail,54,38,1,7,47
60,Fail,53,31,2,14,39
60,Fail,54,32,0,7,47
60,Fail,53,35,3,9,44
60,Fail,56,32,0,11,45
60,Fail,49,36,0,13,36
60,Fail,38,49,0,11,27
60,Fail,47,35,0,15,32
60,Fail,45,37,0,12,33
60,Fail,46,38,3,13,33
60,Fail,44,39,3,14,30
60,Fail,45,38,7,10,35
60,Fail,43,41,6,10,33
60,Fail,47,39,1,13,34
60,Fail,48,34,1,17,31
60,Fail,50,32,1,17,33
60,Fail,56,31,0,13,43
60,Fail,47,42,1,10,37
60,Fail,44,33,7,16,28
60,Fail,51,39,0,8,43
60,Fail,39,33,20,8,31
60,Fail,52,31,0,15,37
60,Fail,51,35,0,12,39
60,Fail,43,40,7,10,33
60,Fail,55,33,2,10,45
60,Fail,45,33,5,17,28
60,Fail,50,38,2,10,40
60,Fail,52,32,4,12,40
60,Fail,50,32,1,17,33
60,Fail,47,39,0,13,34
60,Fail,46,39,0,13,33
60,Fail,48,37,0,13,35
60,Fail,49,32,1,18,31
60,Fail,55,35,1,9,46
60,Fail,55,33,0,12,43
60,Fail,48,37,4,11,37
60,Fail,48,40,4,8,40
60,Fail,49,34,0,10,39
60,Fail,51,31,0,18,33
60,Fail,53,29,0,13,40
60,Fail,53,39,0,6,47
60,Fail,55,33,5,7,48
60,Fail,58,32,1,9,49
60,Fail,41,37,13,9,32
60,Fail,50,38,0,9,41
60,Fail,39,42,10,9,30
60,Fail,53,34,0,13,40
60,Fail,47,36,5,12,35
60,Fail,54,30,0,8,46
60,Fail,50,39,3,8,42
60,Fail,41,31,0,13,28
60,Fail,48,32,4,16,32
60,Fail,52,32,4,12,40
60,Fail,47,41,0,12,35
60,Fail,54,34,0,6,48
60,Fail,48,29,0,15,33
60,Fail,52,28,0,15,37
60,Fail,54,34,6,6,48
60,Fail,48,34,0,16,32
60,Fail,44,37,0,19,25
60,Fail,45,35,4,16,29
60,Fail,50,35,3,12,38
60,Fail,45,39,0,12,33
60,Fail,47,33,0,15,32
60,Fail,48,41,0,8,40
60,Fail,51,31,7,11,40
60,Fail,47,42,0,11,36
60,Fail,44,31,0,13,31
60,Fail,39,42,0,14,25
60,Fail,44,29,13,14,30
60,Fail,56,37,0,5,51
60,Fail,42,38,0,13,29
60,Fail,46,41,1,12,34
60,Fail,45,36,0,15,30
60,Fail,47,33,0,17,30
60,Fail,45,36,7,12,33
60,Fail,50,34,0,13,37
60,Fail,41,42,2,15,26
60,Fail,53,27,0,13,40
60,Fail,32,41,0,18,14
60,Fail,51,33,0,16,35
60,Fail,49,36,0,13,36
60,Fail,49,37,3,11,38
60,Fail,45,30,4,21,24
60,Fail,47,39,5,9,38
60,Fail,54,35,0,9,45
60,Fail,49,40,6,5,44
60,Fail,51,32,0,14,37
60,Fail,49,38,0,7,42
60,Fail,42,39,8,11,31
60,Fail,54,27,4,15,39
60,Fail,43,26,10,21,22
60,Fail,52,34,0,13,39
60,Fail,51,32,8,9,42
60,Fail,54,31,0,10,44
60,Fail,44,35,10,11,33
60,Fail,48,36,0,10,38
60,Fail,46,40,2,12,34
60,Fail,55,31,3,11,44
60,Fail,51,28,0,15,36
60,Fail,59,35,0,6,53
60,Fail,57,29,5,9,48
60,Fail,45,35,0,19,26
60,Fail,56,29,5,10,46
60,Fail,48,34,1,17,31
60,Fail,54,35,0,10,44
60,Fail,44,29,11,16,28
60,Fail,57,27,0,16,41
60,Fail,51,35,1,13,38
60,Fail,49,41,4,6,43
60,Fail,46,36,6,12,34
60,Fail,45,35,0,20,25
60,Fail,50,34,0,11,39
60,Fail,40,37,0,19,21
60,Fail,48,38,0,14,34
60,Fail,45,41,3,11,34
60,Fail,52,34,0,11,41
60,Fail,38,37,8,17,21
60,Fail,43,30,9,18,25
60,Fail,47,33,0,18,29
60,Fail,47,36,2,15,32
60,Fail,41,42,0,12,29
60,Fail,44,37,0,17,27
60,Fail,45,44,0,10,35
60,Fail,53,34,2,11,42
60,Fail,45,36,1,18,27
60,Fail,45,32,0,13,32
60,Fail,48,43,0,9,39
60,Fail,47,35,2,16,31
60,Fail,40,46,3,11,29
60,Fail,41,37,0,19,22
60,Fail,48,34,0,12,36
60,Fail,57,30,0,11,46
60,Fail,44,29,0,15,29
60,Fail,49,30,0,18,31
60,Fail,45,35,5,15,30
60,Fail,47,37,0,16,31
60,Fail,49,37,0,13,36
60,Fail,45,43,0,12,33
60,Fail,50,34,1,15,35
60,Fail,50,35,6,9,41
60,Fail,48,38,0,7,41
60,Fail,45,41,3,11,34
60,Fail,46,38,4,12,34
60,Fail,46,30,12,12,34
60,Fail,48,33,2,17,31
60,Fail,59,27,0,11,48
60,Fail,47,34,0,19,28
60,Fail,48,38,0,12,36
60,Fail,51,35,0,13,38
60,Fail,50,37,1,12,38
60,Fail,41,36,0,18,23
60,Fail,49,36,5,10,39
60,Fail,50,34,0,14,36
60,Fail,42,37,0,17,25
60,Fail,46,34,5,15,31
60,Fail,49,34,2,15,34
60,Fail,46,35,0,16,30
60,Fail,49,40,0,9,40
60,Fail,51,32,5,12,39
60,Fail,45,33,0,19,26
60,Fail,47,43,0,9,38
60,Fail,55,31,2,12,43
60,Fail,47,40,4,9,38
60,Fail,59,30,1,10,49
60,Fail,49,42,0,7,42
60,Fail,47,37,5,11,36
60,Fail,50,27,0,15,35
60,Fail,53,34,0,7,46
60,Fail,48,39,0,10,38
60,Fail,54,34,0,8,46
60,Fail,52,35,0,12,40
60,Fail,40,41,4,15,25
60,Fail,49,39,3,9,40
60,Fail,53,36,0,10,43
60,Fail,49,40,0,11,38
60,Fail,42,37,5,16,26
60,Fail,44,39,1,16,28
60,Fail,50,37,1,12,38
60,Fail,45,40,0,14,31
60,Fail,44,36,0,18,26
60,Fail,47,33,10,10,37
60,Fail,57,27,0,12,45
60,Fail,47,39,1,13,34
60,Fail,44,42,3,11,33
60,Fail,49,35,0,12,37
60,Fail,47,39,3,11,36
60,Fail,40,40,2,18,22
60,Fail,51,33,8,8,43
60,Fail,43,33,14,10,33
60,Fail,43,40,3,14,29
60,Fail,57,30,0,9,48
60,Fail,47,37,0,13,34
60,Fail,46,27,4,23,23
60,Fail,43,39,6,12,31
60,Fail,51,32,1,16,35
60,Fail,49,38,0,11,38
60,Fail,47,37,0,11,36
60,Fail,45,26,0,20,25
60,Fail,41,37,0,14,27
60,Fail,49,40,2,9,40
60,Fail,55,40,1,4,51
60,Fail,52,35,0,11,41
60,Fail,59,33,2,6,53
60,Fail,44,39,0,16,28
60,Fail,46,38,0,16,30
60,Fail,46,39,2,13,33
60,Fail,48,38,0,11,37
60,Fail,41,40,0,13,28
60,Fail,48,36,0,9,39
60,Fail,42,38,0,15,27
60,Fail,45,33,8,14,31
60,Fail,50,37,0,12,38
60,Fail,50,30,0,16,34
60,Fail,39,41,0,13,26
60,Fail,48,41,0,11,37
60,Fail,47,36,5,12,35
60,Fail,56,31,8,5,51
60,Fail,46,33,0,15,31
60,Fail,51,30,0,12,39
60,Fail,41,35,0,15,26
60,Fail,51,33,0,12,39
60,Fail,43,37,2,18,25
60,Fail,40,37,0,14,26
60,Fail,45,40,4,11,34
60,Fail,51,39,0,8,43
60,Fail,52,38,2,8,44
60,Fail,47,34,0,16,31
60,Fail,45,36,0,18,27
60,Fail,50,36,0,13,37
60,Fail,48,37,0,14,34
60,Fail,45,35,8,12,33
60,Fail,51,32,0,12,39
60,Fail,51,33,0,12,39
60,Fail,48,44,0,7,41
60,Fail,43,35,0,14,29
60,Fail,45,37,0,13,32
60,Fail,49,30,0,16,33
60,Fail,55,29,1,15,40
60,Fail,46,38,5,11,35
60,Fail,44,39,0,6,38
60,Fail,48,29,0,12,36
60,Fail,45,37,0,16,29
60,Fail,45,30,0,12,33
60,Fail,57,30,0,11,46
60,Fail,55,31,2,12,43
60,Fail,47,38,2,13,34
60,Fail,47,35,2,16,31
60,Fail,54,31,7,8,46
60,Fail,47,39,0,13,34
60,Fail,52,30,5,13,39
60,Fail,42,31,0,18,24
60,Fail,59,24,4,13,46
60,Fail,38,46,6,10,28
60,Fail,49,33,1,17,32
60,Fail,54,30,0,8,46
60,Fail,47,30,7,16,31
60,Fail,50,36,0,12,38
60,Fail,50,35,0,15,35
60,Fail,39,39,8,14,25
60,Fail,52,32,3,13,39
60,Fail,43,41,0,15,28
60,Fail,49,38,2,11,38
60,Fail,47,29,8,16,31
60,Fail,48,35,5,12,36
60,Fail,51,34,3,12,39
60,Fail,53,41,0,5,48
60,Fail,44,41,0,12,32
60,Fail,44,34,2,20,24
60,Fail,44,40,2,14,30
60,Fail,40,30,0,17,23
60,Fail,47,35,0,13,34
60,Fail,45,36,0,12,33
60,Fail,47,31,4,18,29
60,Fail,47,30,0,16,31
60,Fail,45,28,0,19,26
60,Fail,52,32,6,10,42
60,Fail,48,34,0,16,32
60,Fail,50,39,2,9,41
60,Fail,55,28,3,14,41
60,Fail,55,34,4,7,48
60,Fail,49,35,0,13,36
60,Fail,44,24,0,22,22
60,Fail,43,41,1,15,28
60,Fail,52,31,0,13,39
60,Fail,50,29,0,16,34
60,Fail,43,43,2,12,31
60,Fail,48,32,4,16,32
60,Fail,45,36,0,18,27
60,Fail,56,37,1,6,50
60,Fail,38,41,9,12,26
60,Fail,45,36,2,17,28
60,Fail,51,35,0,13,38
60,Fail,44,39,0,14,30
60,Fail,44,40,5,11,33
60,Fail,52,36,0,9,43
60,Fail,44,38,0,13,31
60,Fail,51,33,0,10,41
60,Fail,49,38,0,11,38
60,Fail,45,33,5,17,28
60,Fail,53,34,0,11,42
60,Fail,55,32,2,11,44
60,Fail,46,40,0,13,33
60,Fail,45,43,0,8,37
60,Fail,42,43,0,10,32
60,Fail,47,39,0,14,33
60,Fail,53,32,0,15,38
60,Fail,46,35,6,13,33
60,Fail,55,35,1,9,46
60,Fail,48,36,0,6,42
60,Fail,51,34,0,12,39
60,Fail,51,32,0,11,40
60,Fail,40,41,2,17,23
60,Fail,46,43,0,11,35
60,Fail,37,40,4,19,18
60,Fail,55,29,3,13,42
60,Fail,46,35,0,11,35
60,Fail,51,39,0,10,41
60,Fail,42,43,0,13,29
60,Fail,49,31,0,17,32
60,Fail,49,40,2,9,40
60,Fail,46,36,1,17,29
60,Fail,44,35,3,18,26
60,Fail,50,37,4,9,41
60,Fail,47,37,0,13,34
60,Fail,45,36,4,15,30
60,Fail,50,30,7,13,37
60,Fail,55,29,0,15,40
60,Fail,54,32,0,12,42
60,Fail,45,43,0,11,34
60,Fail,50,27,0,15,35
60,Fail,57,27,0,12,45
60,Fail,50,34,0,15,35
60,Fail,36,47,1,16,20
60,Fail,48,38,0,13,35
60,Fail,42,37,2,19,23
60,Fail,47,35,8,10,37
60,Fail,50,33,0,17,33
60,Fail,51,34,0,15,36
60,Fail,50,37,1,12,38
60,Fail,49,40,2,9,40
60,Fail,53,32,0,13,40
60,Fail,55,27,6,12,43
60,Fail,50,40,1,9,41
60,Fail,45,26,0,20,25
60,Fail,51,36,0,9,42
60,Fail,48,27,9,16,32
60,Fail,47,46,0,5,42
60,Fail,56,35,0,6,50
60,Fail,50,33,0,11,39
60,Fail,50,35,0,10,40
60,Fail,50,35,0,13,37
60,Fail,53,38,0,9,44
60,Fail,50,34,0,12,38
60,Fail,52,34,0,12,40
60,Fail,45,28,8,19,26
60,Fail,55,37,0,8,47
60,Fail,44,41,4,11,33
60,Fail,47,38,0,12,35
60,Fail,46,37,1,16,30
60,Fail,47,39,0,11,36
60,Fail,45,41,1,13,32
60,Fail,45,40,0,8,37
60,Fail,47,30,0,18,29
60,Fail,49,34,4,13,36
60,Fail,54,31,0,9,45
60,Fail,47,36,0,14,33
60,Fail,50,34,4,12,38
60,Fail,42,32,8,18,24
60,Fail,41,33,6,20,21
60,Fail,54,29,0,15,39
60,Fail,48,31,0,18,30
60,Fail,41,45,3,11,30
60,Fail,48,35,4,13,35
60,Fail,42,40,0,11,31
60,Fail,49,40,0,7,42
60,Fail,56,34,0,5,51
60,Fail,54,38,0,8,46
60,Fail,46,43,0,10,36
60,Fail,39,40,9,12,27
60,Fail,47,33,0,14,33
60,Fail,50,36,2,12,38
60,Fail,50,33,0,11,39
60,Fail,43,41,0,11,32
60,Fail,47,36,0,14,33
60,Fail,49,40,0,11,38
60,Fail,37,36,6,21,16
60,Fail,40,36,0,20,20
60,Fail,54,25,0,15,39
60,Fail,51,32,2,15,36
60,Fail,42,42,0,11,31
60,Fail,49,38,4,9,40
60,Fail,50,37,2,11,39
60,Fail,37,39,8,16,21
60,Fail,53,30,0,17,36
60,Fail,49,35,0,8,41
60,Fail,48,39,0,12,36
60,Fail,42,42,0,16,26
60,Fail,50,32,0,11,39
60,Fail,56,30,2,12,44
60,Fail,52,35,0,11,41
60,Fail,42,37,10,11,31
60,Fail,50,28,3,19,31
60,Fail,42,38,0,15,27
60,Fail,52,35,5,8,44
60,Fail,49,41,0,10,39
60,Fail,47,39,2,12,35
60,Fail,53,42,0,5,48
60,Fail,45,34,0,15,30
60,Fail,49,35,3,13,36
60,Fail,50,35,0,7,43
60,Fail,42,36,9,13,29
60,Fail,39,36,7,18,21
60,Fail,47,30,0,15,32
60,Fail,51,33,0,12,39
60,Fail,45,31,3,21,24
60,Fail,53,31,0,12,41
60,Fail,53,30,0,12,41
60,Fail,46,38,3,13,33
60,Fail,51,39,0,6,45
60,Fail,55,30,0,12,43
60,Fail,52,40,0,5,47
60,Fail,46,44,0,10,36
60,Fail,50,33,6,11,39
60,Fail,46,39,0,13,33
60,Fail,56,38,0,6,50
60,Fail,42,38,7,13,29
60,Fail,48,39,3,10,38
60,Fail,40,33,3,24,16
60,Fail,50,38,0,10,40
60,Fail,51,37,0,10,41
60,Fail,43,39,0,13,30
60,Fail,53,34,0,12,41
60,Fail,42,38,0,16,26
60,Fail,45,37,8,10,35
60,Fail,51,37,0,11,40
60,Fail,46,35,9,10,36
60,Fail,56,30,1,13,43
60,Fail,52,30,0,12,40
60,Fail,41,40,0,14,27
60,Fail,46,40,4,10,36
60,Fail,47,33,4,16,31
60,Fail,48,39,0,10,38
60,Fail,50,34,1,15,35
60,Fail,41,36,0,16,25
60,Fail,44,35,7,14,30
60,Fail,48,33,0,12,36
60,Fail,48,31,0,18,30
60,Fail,44,37,0,16,28
60,Fail,44,22,12,22,22
60,Fail,47,32,10,11,36
60,Fail,43,35,0,12,31
60,Fail,44,43,0,12,32
60,Fail,46,34,0,17,29
60,Fail,45,33,0,18,27
60,Fail,46,33,5,16,30
60,Fail,52,36,3,9,43
60,Fail,47,34,5,14,33
60,Fail,44,39,5,12,32
60,Fail,43,41,0,11,32
60,Fail,48,34,1,17,31
60,Fail,44,38,0,11,33
60,Fail,42,36,7,15,27
60,Fail,46,33,0,14,32
60,Fail,55,30,0,15,40
60,Fail,37,42,7,14,23
60,Fail,49,35,0,10,39
60,Fail,50,32,0,11,39
60,Fail,37,40,10,13,24
60,Fail,45,35,0,15,30
60,Fail,43,32,12,13,30
60,Fail,48,32,8,12,36
60,Fail,51,36,0,9,42
60,Fail,55,34,0,10,45
60,Fail,48,36,0,14,34
60,Fail,44,27,8,21,23
60,Fail,50,33,0,12,38
60,Fail,44,42,0,8,36
60,Fail,40,36,6,18,22
60,Fail,51,34,0,14,37
60,Fail,50,34,0,12,38
60,Fail,51,37,3,9,42
60,Fail,45,38,0,15,30
60,Fail,40,39,6,15,25
60,Fail,59,29,0,10,49
60,Fail,48,37,0,11,37
60,Fail,52,37,0,9,43
60,Fail,56,32,2,10,46
60,Fail,59,30,0,8,51
60,Fail,50,36,0,11,39
60,Fail,48,36,0,16,32
60,Fail,39,44,0,13,26
60,Fail,46,34,0,12,34
60,Fail,50,35,0,13,37
60,Fail,46,39,5,10,36
60,Fail,48,37,0,12,36
60,Fail,49,37,2,12,37
60,Fail,42,41,0,15,27
60,Fail,51,41,0,8,43
60,Fail,50,32,8,10,40
60,Fail,36,33,9,22,14
60,Fail,56,26,0,16,40
60,Fail,47,34,0,13,34
60,Fail,46,31,0,16,30
60,Fail,51,38,6,5,46
60,Fail,51,31,0,8,43
60,Fail,50,32,2,16,34
60,Fail,48,44,0,8,40
60,Fail,47,27,0,12,35
60,Fail,50,42,1,7,43
60,Fail,52,32,0,15,37
60,Fail,60,34,0,6,54
60,Fail,57,24,0,18,39
60,Fail,49,33,7,11,38
60,Fail,51,36,8,5,46
60,Fail,49,34,5,12,37
60,Fail,46,39,0,13,33
60,Fail,50,34,2,14,36
60,Fail,53,26,0,15,38
60,Fail,44,40,0,16,28
60,Fail,52,30,0,14,38
60,Fail,51,31,2,16,35
60,Fail,47,37,0,14,33
60,Fail,47,31,0,15,32
60,Fail,47,40,0,12,35
60,Fail,51,29,5,15,36
60,Fail,48,33,7,12,36
60,Fail,51,29,0,17,34
60,Fail,45,38,0,15,30
60,Fail,49,41,0,10,39
60,Fail,52,35,0,11,41
60,Fail,55,37,0,8,47
60,Fail,44,36,0,13,31
60,Fail,44,40,6,10,34
60,Fail,56,29,6,9,47
60,Fail,43,42,0,11,32
60,Fail,40,43,3,14,26
60,Fail,52,33,0,9,43
60,Fail,49,30,0,15,34
60,Fail,50,37,0,10,40
60,Fail,53,36,1,10,43
60,Fail,54,32,3,11,43
60,Fail,45,36,0,16,29
60,Fail,44,38,4,14,30
60,Fail,50,32,1,17,33
60,Fail,43,38,3,16,27
60,Fail,45,39,2,14,31
60,Fail,46,37,0,16,30
60,Fail,53,31,6,10,43
60,Fail,50,36,2,12,38
60,Fail,52,31,3,14,38
60,Fail,48,36,2,14,34
60,Fail,44,33,12,11,33
60,Fail,50,37,0,13,37
60,Fail,46,42,2,10,36
60,Fail,54,28,8,10,44
60,Fail,44,40,0,16,28
60,Fail,40,44,0,13,27
60,Fail,45,45,3,7,38
60,Fail,44,42,0,12,32
60,Fail,51,34,2,13,38
60,Fail,53,34,0,11,42
60,Fail,48,42,0,9,39
60,Fail,39,38,0,16,23
60,Fail,53,29,0,11,42
60,Fail,52,25,0,16,36
60,Fail,52,34,0,13,39
60,Fail,50,34,0,14,36
60,Fail,38,40,10,12,26
60,Fail,49,35,0,16,33
60,Fail,58,32,0,7,51
60,Fail,50,33,0,12,38
60,Fail,46,36,0,12,34
60,Fail,42,33,0,18,24
60,Fail,60,28,0,12,48
60,Fail,48,27,14,11,37
60,Fail,51,30,7,12,39
60,Fail,46,43,0,9,37
60,Fail,44,35,0,16,28
60,Fail,51,33,1,15,36
60,Fail,42,41,0,13,29
60,Fail,48,30,7,15,33
60,Fail,48,45,1,6,42
60,Fail,53,32,5,10,43
60,Fail,40,37,0,17,23
60,Fail,46,32,0,20,26
60,Fail,53,35,0,10,43
60,Fail,50,24,0,15,35
60,Fail,44,34,0,16,28
60,Fail,52,42,0,6,46
60,Fail,42,37,0,12,30
60,Fail,40,39,0,18,22
60,Fail,51,30,8,11,40
60,Fail,54,37,0,8,46
60,Fail,46,33,1,20,26
60,Fail,54,34,0,9,45
60,Fail,44,39,4,13,31
60,Fail,47,38,3,12,35
60,Fail,51,32,3,14,37
60,Fail,58,30,0,12,46
60,Fail,47,38,0,14,33
60,Fail,47,32,0,18,29
60,Fail,40,41,1,18,22
60,Fail,41,35,0,14,27
60,Fail,57,27,0,12,45
60,Fail,51,31,0,12,39
60,Fail,45,32,0,18,27
60,Fail,43,36,0,12,31
60,Fail,42,33,10,15,27
60,Fail,51,35,0,12,39
60,Fail,49,36,0,12,37
60,Fail,46,42,0,12,34
60,Fail,54,36,0,9,45
60,Fail,50,31,5,14,36
60,Fail,43,32,15,10,33
60,Fail,52,36,1,11,41
60,Fail,47,37,0,13,34
60,Fail,52,30,8,10,42
60,Fail,46,40,0,13,33
60,Fail,46,37,0,10,36
60,Fail,51,35,1,13,38
60,Fail,49,40,3,8,41
60,Fail,51,36,0,8,43
60,Fail,45,39,6,10,35
60,Fail,43,41,0,16,27
60,Fail,44,43,0,11,33
60,Fail,47,32,9,12,35
60,Fail,48,34,4,14,34
60,Fail,50,40,0,9,41
60,Fail,41,39,3,17,24
60,Fail,46,39,1,14,32
60,Fail,53,27,0,17,36
60,Fail,50,30,4,16,34
60,Fail,44,34,8,14,30
60,Fail,52,29,7,12,40
60,Fail,46,35,5,14,32
60,Fail,54,36,0,8,46
60,Fail,45,41,0,10,35
60,Fail,44,31,0,18,26
60,Fail,43,41,2,14,29
60,Fail,47,32,0,14,33
60,Fail,46,39,3,12,34
60,Fail,44,32,6,18,26
60,Fail,44,43,2,11,33
60,Fail,46,43,0,11,35
60,Fail,52,30,8,10,42
60,Fail,51,41,0,5,46
60,Fail,48,35,0,14,34
60,Fail,57,29,0,10,47
60,Fail,44,38,0,11,33
60,Fail,47,39,0,12,35
60,Fail,52,34,0,11,41
60,Fail,47,42,0,10,37
60,Fail,46,40,4,10,36
60,Fail,42,37,10,11,31
60,Fail,51,30,1,18,33
60,Fail,54,34,0,11,43
60,Fail,49,33,0,11,38
60,Fail,48,42,0,10,38
60,Fail,57,22,6,15,42
60,Fail,48,42,0,8,40
60,Fail,49,38,0,8,41
60,Fail,48,35,2,15,33
60,Fail,44,34,0,17,27
60,Fail,53,35,0,7,46
60,Fail,56,28,0,8,48
60,Fail,47,31,3,19,28
60,Fail,52,28,0,13,39
60,Fail,45,39,0,13,32
60,Fail,48,32,0,12,36
60,Fail,48,36,4,12,36
60,Fail,48,38,5,9,39
60,Fail,47,42,0,11,36
60,Fail,54,31,0,11,43
60,Fail,47,38,0,12,35
60,Fail,53,34,0,12,41
60,Fail,54,30,3,13,41
60,Fail,56,34,0,8,48
60,Fail,46,34,0,10,36
60,Fail,51,35,1,13,38
60,Fail,46,42,0,8,38
60,Fail,51,29,0,17,34
60,Fail,41,46,0,9,32
60,Fail,56,37,1,6,50
60,Fail,43,44,0,11,32
60,Fail,44,41,2,13,31
60,Fail,54,29,0,12,42
60,Fail,45,30,0,16,29
60,Fail,54,30,0,16,38
60,Fail,50,39,0,11,39
60,Fail,44,38,0,13,31
60,Fail,44,40,1,15,29
60,Fail,47,38,0,15,32
60,Fail,46,43,4,7,39
60,Fail,40,36,0,14,26
60,Fail,45,32,0,15,30
60,Fail,45,39,0,14,31
60,Fail,51,31,3,15,36
60,Fail,50,36,0,14,36
60,Fail,47,42,0,11,36
60,Fail,53,32,5,10,43
60,Fail,56,30,3,11,45
60,Fail,50,30,2,18,32
60,Fail,56,32,2,10,46
60,Fail,54,34,0,12,42
60,Fail,55,36,0,9,46
60,Fail,49,36,0,15,34
60,Fail,38,36,4,22,16
60,Fail,47,37,0,16,31
60,Fail,50,36,5,9,41
60,Fail,33,42,12,13,20
60,Fail,53,33,0,9,44
60,Fail,42,32,0,18,24
60,Fail,44,42,0,14,30
60,Fail,51,36,0,13,38
60,Fail,43,32,10,15,28
60,Fail,49,40,0,10,39
60,Fail,49,40,0,9,40
60,Fail,37,35,7,21,16
60,Fail,54,29,1,16,38
60,Fail,43,40,0,11,32
60,Fail,44,33,6,17,27
60,Fail,47,30,0,10,37
60,Fail,41,40,5,14,27
60,Fail,46,34,6,14,32
60,Fail,52,34,4,10,42
60,Fail,47,40,0,12,35
60,Fail,48,34,0,18,30
60,Fail,44,39,0,13,31
60,Fail,56,35,0,7,49
60,Fail,51,43,1,5,46
60,Fail,50,35,3,12,38
60,Fail,50,46,0,4,46
60,Fail,57,36,1,6,51
60,Fail,49,39,1,11,38
60,Fail,39,37,0,19,20
60,Fail,53,34,0,13,40
60,Fail,46,36,0,12,34
60,Fail,46,38,5,11,35
60,Fail,48,35,0,12,36
60,Fail,43,44,0,11,32
60,Fail,47,35,0,14,33
60,Fail,52,37,3,8,44
60,Fail,53,23,9,15,38
60,Fail,53,32,7,8,45
60,Fail,50,41,0,8,42
60,Fail,42,32,0,14,28
60,Fail,53,35,1,11,42
60,Fail,50,31,0,12,38
60,Fail,57,31,0,5,52
60,Fail,54,32,2,12,42
60,Fail,45,33,10,12,33
60,Fail,47,40,1,12,35
60,Fail,51,35,0,11,40
60,Fail,50,31,1,18,32
60,Fail,44,36,0,20,24
60,Fail,45,37,0,11,34
60,Fail,43,41,0,16,27
60,Fail,52,25,9,14,38
60,Fail,52,32,0,11,41
60,Fail,55,33,1,11,44
60,Fail,45,39,1,15,30
60,Fail,47,40,0,10,37
60,Fail,44,39,0,12,32
60,Fail,41,46,0,11,30
60,Fail,41,39,3,17,24
60,Fail,48,32,6,14,34
60,Fail,55,29,0,16,39
60,Fail,43,40,1,16,27
60,Fail,45,38,4,13,32
60,Fail,50,35,0,11,39
60,Fail,48,37,3,12,36
60,Fail,43,39,0,10,33
60,Fail,47,35,4,14,33
60,Fail,41,43,0,14,27
60,Fail,46,35,5,14,32
60,Fail,46,35,1,18,28
60,Fail,48,38,1,13,35
60,Fail,51,42,1,6,45
60,Fail,45,34,10,11,34
60,Fail,56,35,0,9,47
60,Fail,46,34,0,16,30
60,Fail,52,33,0,14,38
60,Fail,39,37,4,20,19
60,Fail,55,37,0,6,49
60,Fail,52,31,0,10,42
60,Fail,49,35,0,14,35
60,Fail,42,42,0,12,30
60,Fail,44,39,0,9,35
60,Fail,42,42,4,12,30
60,Fail,55,29,0,11,44
60,Fail,43,32,8,17,26
60,Fail,43,38,8,11,32
60,Fail,51,32,0,14,37
60,Fail,54,23,0,16,38
60,Fail,46,38,1,15,31
60,Fail,41,39,0,16,25
60,Fail,55,32,0,11,44
60,Fail,44,39,0,16,28
60,Fail,49,35,5,11,38
60,Fail,46,32,0,17,29
60,Fail,48,41,0,11,37
60,Fail,48,39,1,12,36
60,Fail,43,32,0,13,30
60,Fail,53,39,1,7,46
60,Fail,49,37,2,12,37
60,Fail,38,32,10,20,18
60,Fail,46,34,0,9,37
60,Fail,49,28,0,17,32
60,Fail,48,37,1,14,34
60,Fail,49,33,0,15,34
60,Fail,42,32,6,20,22
60,Fail,42,41,0,12,30
60,Fail,47,42,0,11,36
60,Fail,50,34,0,9,41
60,Fail,45,38,0,14,31
60,Fail,52,38,2,8,44
60,Fail,47,40,0,11,36
60,Fail,46,38,0,14,32
60,Fail,54,35,1,10,44
60,Fail,49,32,7,12,37
60,Fail,45,39,7,9,36
60,Fail,45,39,7,9,36
60,Fail,44,40,0,12,32
60,Fail,43,42,0,10,33
60,Fail,42,36,9,13,29
60,Fail,50,37,2,11,39
60,Fail,43,39,0,12,31
60,Fail,49,37,0,14,35
60,Fail,53,26,0,7,46
60,Fail,48,39,2,11,37
60,Fail,46,33,14,7,39
60,Fail,44,39,8,9,35
60,Fail,51,37,0,11,40
60,Fail,56,29,0,15,41
60,Fail,42,41,0,14,28
60,Fail,49,36,0,15,34
60,Fail,48,34,2,16,32
60,Fail,45,34,0,10,35
60,Fail,45,43,0,11,34
60,Fail,57,29,0,13,44
60,Fail,49,38,0,11,38
60,Fail,45,38,1,16,29
60,Fail,47,38,0,13,34
60,Fail,52,26,0,16,36
60,Fail,51,36,0,11,40
60,Fail,43,34,8,15,28
60,Fail,55,38,1,6,49
60,Fail,51,36,0,13,38
60,Fail,48,41,0,10,38
60,Fail,53,36,0,10,43
60,Fail,46,35,0,12,34
60,Fail,54,34,0,12,42
60,Fail,44,35,8,13,31
60,Fail,45,35,0,16,29
60,Fail,54,33,2,11,43
60,Fail,50,31,0,17,33
60,Fail,50,30,10,10,40
60,Fail,46,41,0,12,34
60,Fail,48,33,1,18,30
60,Fail,49,40,1,10,39
60,Fail,51,34,3,12,39
60,Fail,46,40,4,10,36
60,Fail,49,30,0,13,36
60,Fail,43,38,0,15,28
60,Fail,55,34,0,8,47
60,Fail,57,29,0,11,46
60,Fail,42,37,0,15,27
60,Fail,49,38,0,11,38
60,Fail,52,37,3,8,44
60,Fail,47,41,0,10,37
60,Fail,50,38,1,11,39
60,Fail,48,33,0,15,33
60,Fail,51,35,0,12,39
60,Fail,57,29,0,10,47
60,Fail,49,41,1,9,40
60,Fail,49,33,3,15,34
60,Fail,48,42,0,10,38
60,Fail,47,33,3,17,30
60,Fail,50,35,0,11,39
60,Fail,44,39,0,14,30
60,Fail,60,30,0,10,50
60,Fail,55,38,1,6,49
60,Fail,46,48,1,5,41
60,Fail,39,32,0,23,16
60,Fail,52,34,5,9,43
60,Fail,43,36,8,13,30
60,Fail,44,31,0,18,26
60,Fail,44,42,0,7,37
60,Fail,45,36,3,16,29
60,Fail,50,37,0,12,38
60,Fail,52,33,0,13,39
60,Fail,53,36,5,6,47
60,Fail,46,42,1,11,35
60,Fail,48,39,1,12,36
60,Fail,49,32,0,15,34
60,Fail,42,36,0,15,27
60,Fail,51,35,0,11,40
60,Fail,44,38,0,10,34
60,Fail,51,35,0,12,39
60,Fail,54,37,0,8,46
60,Fail,51,33,0,10,41
60,Fail,55,28,0,17,38
60,Fail,58,25,0,11,47
60,Fail,45,41,0,9,36
60,Fail,50,39,0,9,41
60,Fail,51,35,0,14,37
60,Fail,51,36,2,11,40
60,Fail,51,34,0,7,44
60,Fail,53,34,0,10,43
60,Fail,50,32,0,15,35
60,Fail,51,35,0,8,43
60,Fail,52,31,2,15,37
60,Fail,49,32,0,12,37
60,Fail,46,38,6,10,36
60,Fail,40,36,0,19,21
60,Fail,49,29,12,10,39
60,Fail,39,35,0,13,26
60,Fail,50,34,4,12,38
60,Fail,49,38,0,13,36
60,Fail,42,40,0,10,32
60,Fail,50,34,0,12,38
60,Fail,47,36,2,15,32
60,Fail,50,37,0,13,37
60,Fail,47,41,0,7,40
60,Fail,45,38,0,11,34
60,Fail,53,35,2,10,43
60,Fail,58,34,1,7,51
60,Fail,50,30,7,13,37
60,Fail,46,35,0,14,32
60,Fail,46,40,0,10,36
60,Fail,48,38,0,13,35
60,Fail,49,38,0,10,39
60,Fail,50,33,0,16,34
60,Fail,46,39,9,6,40
60,Fail,44,42,0,12,32
60,Fail,45,34,8,13,32
60,Fail,49,35,2,14,35
60,Fail,43,36,0,18,25
60,Fail,46,34,0,20,26
60,Fail,47,33,6,14,33
60,Fail,52,35,0,10,42
60,Fail,49,38,0,13,36
60,Fail,48,30,8,14,34
60,Fail,44,33,6,17,27
60,Fail,53,33,0,11,42
60,Fail,50,34,0,14,36
60,Fail,44,32,8,16,28
60,Fail,52,38,0,10,42
60,Fail,51,34,0,14,37
60,Fail,44,33,4,19,25
60,Fail,40,48,0,9,31
60,Fail,42,37,4,17,25
60,Fail,56,36,0,8,48
60,Fail,49,38,0,8,41
60,Fail,53,31,0,11,42
60,Fail,49,39,3,9,40
60,Fail,44,34,0,17,27
60,Fail,45,42,0,12,33
60,Fail,48,38,0,7,41
60,Fail,43,33,0,18,25
60,Fail,55,35,1,9,46
60,Fail,41,39,5,15,26
60,Fail,45,40,3,12,33
60,Fail,46,37,1,16,30
60,Fail,43,36,4,17,26
60,Fail,42,39,4,15,27
60,Fail,49,31,0,11,38
60,Fail,43,45,0,11,32
60,Fail,51,29,7,13,38
60,Fail,49,37,0,11,38
60,Fail,53,37,2,8,45
60,Fail,45,42,0,13,32
60,Fail,51,34,4,11,40
60,Fail,46,39,3,12,34
60,Fail,46,37,0,16,30
60,Fail,53,28,8,11,42
60,Fail,44,38,6,12,32
60,Fail,44,37,0,16,28
60,Fail,45,37,4,14,31
60,Fail,48,34,3,15,33
60,Fail,50,36,2,12,38
60,Fail,49,35,0,13,36
60,Fail,49,28,9,14,35
60,Fail,44,37,8,11,33
60,Fail,48,30,8,14,34
60,Fail,55,31,0,9,46
60,Fail,52,35,0,10,42
60,Fail,51,37,1,11,40
60,Fail,54,33,0,9,45
60,Fail,54,31,0,9,45
60,Fail,45,38,4,13,32
60,Fail,46,40,0,9,37
60,Fail,50,40,0,8,42
60,Fail,53,31,0,15,38
60,Fail,40,39,0,14,26
60,Fail,47,34,0,10,37
60,Fail,46,30,6,18,28
60,Fail,47,37,0,11,36
60,Fail,39,31,0,19,20
60,Fail,55,39,2,4,51
60,Fail,51,35,1,13,38
70,Fail,53,36,0,11,42
70,Fail,51,30,9,10,41
70,Fail,55,31,0,11,44
70,Fail,49,39,0,12,37
70,Fail,48,34,6,12,36
70,Fail,47,38,2,13,34
70,Fail,46,31,0,8,38
70,Fail,48,42,3,7,41
70,Fail,43,36,4,17,26
70,Fail,46,37,0,12,34
70,Fail,53,29,0,16,37
70,Fail,45,41,0,12,33
70,Fail,45,30,10,15,30
70,Fail,55,27,11,7,48
70,Fail,50,33,3,14,36
70,Fail,48,38,1,13,35
70,Fail,50,40,0,9,41
70,Fail,56,33,0,10,46
70,Fail,42,42,8,8,34
70,Fail,44,41,4,11,33
70,Fail,50,29,0,18,32
70,Fail,41,38,0,13,28
70,Fail,39,35,3,23,16
70,Fail,46,37,0,16,30
70,Fail,60,23,0,14,46
70,Fail,44,42,4,10,34
70,Fail,60,30,0,9,51
70,Fail,49,33,0,12,37
70,Fail,46,40,0,11,35
70,Fail,51,37,2,10,41
70,Fail,43,46,0,9,34
70,Fail,52,29,0,13,39
70,Fail,48,40,1,11,37
70,Fail,51,38,0,9,42
70,Fail,47,37,6,10,37
70,Fail,46,40,4,10,36
70,Fail,61,26,0,10,51
70,Fail,49,35,0,11,38
70,Fail,41,36,0,14,27
70,Fail,50,30,7,13,37
70,Fail,48,37,5,10,38
70,Fail,40,39,6,15,25
70,Fail,49,40,2,9,40
70,Fail,43,48,0,9,34
70,Fail,44,30,13,13,31
70,Fail,54,28,6,12,42
70,Fail,43,35,5,17,26
70,Fail,51,36,7,6,45
70,Fail,52,35,0,13,39
70,Fail,55,28,4,13,42
70,Fail,51,34,0,9,42
70,Fail,49,30,6,15,34
70,Fail,49,28,8,15,34
70,Fail,37,40,6,17,20
70,Fail,50,33,5,12,38
70,Fail,48,40,4,8,40
70,Fail,49,35,8,8,41
70,Fail,47,30,0,17,30
70,Fail,53,28,8,11,42
70,Fail,55,28,0,11,44
70,Fail,51,31,0,16,35
70,Fail,46,35,5,14,32
70,Fail,54,28,6,12,42
70,Fail,45,39,4,12,33
70,Fail,51,31,0,14,37
70,Fail,48,32,10,10,38
70,Fail,40,36,5,19,21
70,Fail,38,42,3,17,21
70,Fail,52,36,2,10,42
70,Fail,43,31,0,17,26
70,Fail,55,33,1,11,44
70,Fail,45,38,0,14,31
70,Fail,55,32,0,6,49
70,Fail,47,36,0,15,32
70,Fail,44,41,0,15,29
70,Fail,42,40,0,17,25
70,Fail,46,37,0,12,34
70,Fail,44,39,0,13,31
70,Fail,43,44,6,7,36
70,Fail,46,36,4,14,32
70,Fail,50,35,0,11,39
70,Fail,49,35,4,12,37
70,Fail,43,40,0,14,29
70,Fail,43,40,0,15,28
70,Fail,42,41,1,16,26
70,Fail,53,29,3,15,38
70,Fail,43,30,8,19,24
70,Fail,49,38,0,10,39
70,Fail,54,30,5,11,43
70,Fail,45,34,2,19,26
70,Fail,48,33,5,14,34
70,Fail,49,32,0,13,36
70,Fail,46,28,11,15,31
70,Fail,51,33,5,11,40
70,Fail,47,43,0,9,38
70,Fail,51,32,0,16,35
70,Fail,44,39,0,9,35
70,Fail,47,33,0,12,35
70,Fail,42,32,0,17,25
70,Fail,40,39,5,16,24
70,Fail,43,43,1,13,30
70,Fail,43,36,4,17,26
70,Fail,41,34,9,16,25
70,Fail,48,37,7,8,40
70,Fail,45,40,0,13,32
70,Fail,48,38,0,12,36
70,Fail,48,32,6,14,34
70,Fail,51,37,0,12,39
70,Fail,46,34,5,15,31
70,Fail,51,33,8,8,43
70,Fail,50,34,0,11,39
70,Fail,43,43,0,13,30
70,Fail,48,36,3,13,35
70,Fail,42,39,0,17,25
70,Fail,48,42,1,9,39
70,Fail,43,36,8,13,30
70,Fail,45,40,0,8,37
70,Fail,57,32,1,10,47
70,Fail,47,41,0,7,40
70,Fail,50,39,3,8,42
70,Fail,59,27,3,11,48
70,Fail,51,33,5,11,40
70,Fail,44,37,8,11,33
70,Fail,54,37,0,7,47
70,Fail,49,34,4,13,36
70,Fail,48,32,0,17,31
70,Fail,55,30,5,10,45
70,Fail,42,37,8,13,29
70,Fail,46,38,0,11,35
70,Fail,37,43,0,17,20
70,Fail,43,38,0,13,30
70,Fail,42,41,7,10,32
70,Fail,45,37,0,9,36
70,Fail,47,27,7,19,28
70,Fail,39,43,1,17,22
70,Fail,41,41,6,12,29
70,Fail,46,35,0,15,31
70,Fail,52,29,5,14,38
70,Fail,46,30,4,20,26
70,Fail,46,35,0,13,33
70,Fail,43,33,5,19,24
70,Fail,59,26,8,7,52
70,Fail,50,35,0,12,38
70,Fail,61,24,1,14,47
70,Fail,50,34,1,15,35
70,Fail,51,32,0,9,42
70,Fail,42,33,11,14,28
70,Fail,52,32,3,13,39
70,Fail,38,47,3,12,26
70,Fail,52,33,5,10,42
70,Fail,52,36,0,11,41
70,Fail,41,33,10,16,25
70,Fail,48,43,0,8,40
70,Fail,53,30,0,17,36
70,Fail,43,37,7,13,30
70,Fail,54,27,4,15,39
70,Fail,53,25,0,14,39
70,Fail,41,32,10,17,24
70,Fail,46,36,0,14,32
70,Fail,47,37,0,16,31
70,Fail,46,37,2,15,31
70,Fail,47,42,0,11,36
70,Fail,51,35,0,14,37
70,Fail,48,33,0,15,33
70,Fail,45,39,0,13,32
70,Fail,47,41,0,11,36
70,Fail,51,31,0,16,35
70,Fail,42,31,0,15,27
70,Fail,41,38,0,17,24
70,Fail,48,43,4,5,43
70,Fail,48,40,0,10,38
70,Fail,47,37,0,13,34
70,Fail,54,39,0,7,47
70,Fail,43,35,9,13,30
70,Fail,41,42,0,11,30
70,Fail,49,35,1,15,34
70,Fail,51,35,0,11,40
70,Fail,52,35,1,12,40
70,Fail,49,34,2,15,34
70,Fail,37,40,0,16,21
70,Fail,50,28,0,15,35
70,Fail,53,26,11,10,43
70,Fail,52,39,0,8,44
70,Fail,49,38,2,11,38
70,Fail,44,35,6,15,29
70,Fail,56,36,1,7,49
70,Fail,44,32,9,15,29
70,Fail,54,31,7,8,46
70,Fail,55,36,0,9,46
70,Fail,47,32,0,10,37
70,Fail,44,28,13,15,29
70,Fail,46,40,0,6,40
70,Fail,49,31,0,20,29
70,Fail,53,32,0,12,41
70,Fail,41,35,0,12,29
70,Fail,38,41,0,15,23
70,Fail,57,34,0,9,48
70,Fail,52,35,1,12,40
70,Fail,40,42,0,18,22
70,Fail,51,33,0,10,41
70,Fail,43,47,1,9,34
70,Fail,49,32,4,15,34
70,Fail,48,35,3,14,34
70,Fail,44,35,9,12,32
70,Fail,54,32,4,10,44
70,Fail,42,42,2,14,28
70,Fail,43,37,0,18,25
70,Fail,50,34,0,14,36
70,Fail,41,39,0,6,35
70,Fail,51,32,0,11,40
70,Fail,45,36,6,13,32
70,Fail,41,36,6,17,24
70,Fail,43,40,0,15,28
70,Fail,50,29,0,21,29
70,Fail,54,30,0,11,43
70,Fail,50,30,0,16,34
70,Fail,48,30,4,18,30
70,Fail,47,39,0,12,35
70,Fail,45,41,0,14,31
70,Fail,46,36,0,12,34
70,Fail,50,37,3,10,40
70,Fail,53,32,0,13,40
70,Fail,44,38,0,12,32
70,Fail,52,31,4,13,39
70,Fail,53,31,6,10,43
70,Fail,50,35,4,11,39
70,Fail,51,31,4,14,37
70,Fail,37,37,0,18,19
70,Fail,42,33,5,20,22
70,Fail,52,34,0,10,42
70,Fail,50,35,2,13,37
70,Fail,51,40,0,8,43
70,Fail,48,37,0,9,39
70,Fail,42,38,3,17,25
70,Fail,50,31,6,13,37
70,Fail,49,29,9,13,36
70,Fail,48,34,0,17,31
70,Fail,42,39,2,17,25
70,Fail,52,33,0,14,38
70,Fail,49,35,0,12,37
70,Fail,45,40,5,10,35
70,Fail,46,38,5,11,35
70,Fail,56,28,4,12,44
70,Fail,43,38,4,15,28
70,Fail,47,35,9,9,38
70,Fail,43,37,11,9,34
70,Fail,48,26,10,16,32
70,Fail,47,35,0,9,38
70,Fail,46,39,0,14,32
70,Fail,42,41,0,13,29
70,Fail,51,35,2,12,39
70,Fail,51,29,2,18,33
70,Fail,50,38,0,12,38
70,Fail,53,37,0,10,43
70,Fail,47,44,2,7,40
70,Fail,54,27,2,17,37
70,Fail,48,33,7,12,36
70,Fail,49,38,0,12,37
70,Fail,49,41,1,9,40
70,Fail,45,32,0,18,27
70,Fail,50,37,0,13,37
70,Fail,47,35,0,14,33
70,Fail,52,40,0,6,46
70,Fail,50,32,0,11,39
70,Fail,47,39,0,14,33
70,Fail,50,33,0,13,37
70,Fail,49,33,0,18,31
70,Fail,54,34,1,11,43
70,Fail,47,39,0,12,35
70,Fail,53,36,0,7,46
70,Fail,45,41,2,12,33
70,Fail,53,33,3,11,42
70,Fail,46,41,0,11,35
70,Fail,54,35,0,9,45
70,Fail,47,33,4,16,31
70,Fail,42,35,7,16,26
70,Fail,49,41,0,10,39
70,Fail,46,38,1,15,31
70,Fail,49,39,0,12,37
70,Fail,46,37,2,15,31
70,Fail,45,40,2,13,32
70,Fail,54,29,6,11,43
70,Fail,46,31,0,12,34
70,Fail,44,35,0,16,28
70,Fail,51,34,0,12,39
70,Fail,47,35,0,17,30
70,Fail,50,36,2,12,38
70,Fail,56,35,1,8,48
70,Fail,57,39,0,4,53
70,Fail,45,41,0,13,32
70,Fail,50,32,0,12,38
70,Fail,53,31,0,8,45
70,Fail,43,44,0,13,30
70,Fail,57,33,3,7,50
70,Fail,53,30,0,12,41
70,Fail,52,33,0,15,37
70,Fail,43,38,1,18,25
70,Fail,53,34,0,9,44
70,Fail,46,40,1,13,33
70,Fail,44,40,3,13,31
70,Fail,53,30,0,11,42
70,Fail,45,40,2,13,32
70,Fail,46,37,0,13,33
70,Fail,42,41,0,17,25
70,Fail,53,28,0,15,38
70,Fail,50,35,3,12,38
70,Fail,46,38,2,14,32
70,Fail,47,39,1,13,34
70,Fail,48,32,8,12,36
70,Fail,45,41,0,9,36
70,Fail,54,32,5,9,45
70,Fail,49,32,0,12,37
70,Fail,53,39,0,7,46
70,Fail,51,25,0,18,33
70,Fail,57,32,0,9,48
70,Fail,56,29,0,14,42
70,Fail,56,32,4,8,48
70,Fail,46,38,0,11,35
70,Fail,47,37,3,13,34
70,Fail,33,47,0,18,15
70,Fail,48,31,0,13,35
70,Fail,45,33,0,17,28
70,Fail,43,43,1,13,30
70,Fail,37,40,0,18,19
70,Fail,43,44,3,10,33
70,Fail,50,34,0,11,39
70,Fail,48,37,0,12,36
70,Fail,40,39,0,15,25
70,Fail,49,38,0,11,38
70,Fail,48,37,2,13,35
70,Fail,53,33,1,13,40
70,Fail,47,38,1,14,33
70,Fail,51,32,5,12,39
70,Fail,39,37,0,15,24
70,Fail,46,35,0,17,29
70,Fail,46,35,7,12,34
70,Fail,42,31,0,17,25
70,Fail,41,43,2,14,27
70,Fail,44,38,1,17,27
70,Fail,49,34,4,13,36
70,Fail,55,33,0,12,43
70,Fail,37,37,0,18,19
70,Fail,53,34,0,13,40
70,Fail,53,38,0,6,47
70,Fail,47,39,0,11,36
70,Fail,49,34,4,13,36
70,Fail,53,41,2,4,49
70,Fail,50,35,7,8,42
70,Fail,39,37,9,15,24
70,Fail,56,29,0,10,46
70,Fail,50,36,0,10,40
70,Fail,51,32,0,15,36
70,Fail,53,34,3,10,43
70,Fail,48,38,0,14,34
70,Fail,49,37,0,14,35
70,Fail,53,30,3,14,39
70,Fail,44,39,0,16,28
70,Fail,50,29,0,14,36
70,Fail,45,39,0,12,33
70,Fail,53,35,3,9,44
70,Fail,64,27,0,7,57
70,Fail,43,35,0,21,22
70,Fail,49,33,3,15,34
70,Fail,48,28,15,9,39
70,Fail,46,31,0,17,29
70,Fail,43,40,0,15,28
70,Fail,49,38,0,13,36
70,Fail,42,36,9,13,29
70,Fail,49,42,0,9,40
70,Fail,50,31,0,12,38
70,Fail,41,44,1,14,27
70,Fail,52,39,0,8,44
70,Fail,44,40,6,10,34
70,Fail,50,35,3,12,38
70,Fail,42,41,0,14,28
70,Fail,51,38,0,9,42
70,Fail,45,34,1,20,25
70,Fail,50,27,11,12,38
70,Fail,53,33,2,12,41
70,Fail,56,29,5,10,46
70,Fail,46,42,0,10,36
70,Fail,51,38,0,10,41
70,Fail,47,36,3,14,33
70,Fail,53,33,2,12,41
70,Fail,47,38,3,12,35
70,Fail,41,39,0,14,27
70,Fail,53,29,0,16,37
70,Fail,48,32,0,15,33
70,Fail,55,32,4,9,46
70,Fail,46,31,7,16,30
70,Fail,45,43,1,11,34
70,Fail,57,34,0,6,51
70,Fail,54,32,3,11,43
70,Fail,47,41,0,12,35
70,Fail,48,40,4,8,40
70,Fail,52,36,0,10,42
70,Fail,53,33,4,10,43
70,Fail,50,31,4,15,35
70,Fail,42,31,3,24,18
70,Fail,49,33,0,16,33
70,Fail,59,29,0,11,48
70,Fail,48,32,4,16,32
70,Fail,44,36,0,15,29
70,Fail,48,37,0,9,39
70,Fail,43,40,0,16,27
70,Fail,44,36,10,10,34
70,Fail,41,34,12,13,28
70,Fail,45,40,0,13,32
70,Fail,52,38,0,10,42
70,Fail,51,28,0,14,37
70,Fail,46,40,6,8,38
70,Fail,50,38,0,10,40
70,Fail,45,38,0,12,33
70,Fail,52,34,2,12,40
70,Fail,58,29,0,12,46
70,Fail,51,32,3,14,37
70,Fail,48,33,0,16,32
70,Fail,46,36,1,17,29
70,Fail,49,35,1,15,34
70,Fail,39,39,4,18,21
70,Fail,46,36,6,12,34
70,Fail,47,39,0,10,37
70,Fail,53,33,0,9,44
70,Fail,48,37,6,9,39
70,Fail,46,39,4,11,35
70,Fail,46,42,3,9,37
70,Fail,47,40,0,13,34
70,Fail,45,35,3,17,28
70,Fail,54,29,5,12,42
70,Fail,44,39,9,8,36
70,Fail,41,27,0,21,20
70,Fail,51,33,0,15,36
70,Fail,51,34,0,12,39
70,Fail,49,36,1,14,35
70,Fail,45,41,1,13,32
70,Fail,45,32,0,13,32
70,Fail,46,38,0,12,34
70,Fail,54,37,0,8,46
70,Fail,56,28,0,12,44
70,Fail,45,31,9,15,30
70,Fail,50,38,1,11,39
70,Fail,48,41,0,10,38
70,Fail,51,31,0,18,33
70,Fail,51,41,0,8,43
70,Fail,49,34,4,13,36
70,Fail,50,38,4,8,42
70,Fail,48,34,11,7,41
70,Fail,55,27,3,15,40
70,Fail,44,43,3,10,34
70,Fail,42,39,4,15,27
70,Fail,48,40,4,8,40
70,Fail,51,32,0,15,36
70,Fail,52,38,1,9,43
70,Fail,52,37,0,10,42
70,Fail,50,34,0,10,40
70,Fail,41,42,0,14,27
70,Fail,52,31,5,12,40
70,Fail,49,34,8,9,40
70,Fail,51,34,0,10,41
70,Fail,47,41,0,12,35
70,Fail,50,35,3,12,38
70,Fail,43,38,0,19,24
70,Fail,47,37,0,11,36
70,Fail,46,39,0,15,31
70,Fail,50,35,5,10,40
70,Fail,51,35,0,12,39
70,Fail,45,41,0,12,33
70,Fail,46,40,0,7,39
70,Fail,46,42,2,10,36
70,Fail,53,28,8,11,42
70,Fail,50,40,0,7,43
70,Fail,47,32,0,20,27
70,Fail,46,32,0,11,35
70,Fail,55,28,0,14,41
70,Fail,54,29,0,15,39
70,Fail,47,33,0,15,32
70,Fail,55,31,0,9,46
70,Fail,53,27,0,17,36
70,Fail,38,48,2,12,26
70,Fail,45,40,3,12,33
70,Fail,51,35,0,13,38
70,Fail,48,33,9,10,38
70,Fail,49,41,0,10,39
70,Fail,52,30,6,12,40
70,Fail,55,35,0,8,47
70,Fail,47,29,15,9,38
70,Fail,46,35,3,16,30
70,Fail,45,36,0,15,30
70,Fail,52,36,2,10,42
70,Fail,56,31,0,10,46
70,Fail,47,38,0,11,36
70,Fail,45,31,11,13,32
70,Fail,37,40,8,15,22
70,Fail,36,47,1,16,20
70,Fail,49,35,3,13,36
70,Fail,49,33,3,15,34
70,Fail,44,33,4,19,25
70,Fail,48,36,4,12,36
70,Fail,55,29,4,12,43
70,Fail,48,39,0,10,38
70,Fail,55,32,0,12,43
70,Fail,52,36,3,9,43
70,Fail,45,27,14,14,31
70,Fail,44,42,0,11,33
70,Fail,51,36,0,6,45
70,Fail,45,34,3,18,27
70,Fail,50,43,0,6,44
70,Fail,58,26,1,15,43
70,Fail,47,41,0,8,39
70,Fail,48,28,10,14,34
70,Fail,51,32,6,11,40
70,Fail,49,39,0,12,37
70,Fail,53,32,0,13,40
70,Fail,51,39,0,10,41
70,Fail,48,35,0,9,39
70,Fail,47,30,8,15,32
70,Fail,46,43,0,11,35
70,Fail,44,41,3,12,32
70,Fail,49,29,0,18,31
70,Fail,51,37,1,11,40
70,Fail,51,39,0,8,43
70,Fail,52,37,1,10,42
70,Fail,42,36,0,16,26
70,Fail,54,34,1,11,43
70,Fail,46,32,7,15,31
70,Fail,54,28,0,16,38
70,Fail,49,30,0,16,33
70,Fail,53,31,8,8,45
70,Fail,54,32,1,13,41
70,Fail,48,37,0,13,35
70,Fail,46,33,10,11,35
70,Fail,49,32,0,13,36
70,Fail,48,36,0,9,39
70,Fail,42,33,0,13,29
70,Fail,53,32,0,11,42
70,Fail,50,39,4,7,43
70,Fail,41,42,2,15,26
70,Fail,48,25,5,22,26
70,Fail,51,31,0,17,34
70,Fail,48,39,2,11,37
70,Fail,46,41,4,9,37
70,Fail,45,36,0,18,27
70,Fail,54,35,0,8,46
70,Fail,40,36,7,17,23
70,Fail,53,32,0,13,40
70,Fail,53,29,7,11,42
70,Fail,53,38,0,6,47
70,Fail,41,38,8,13,28
70,Fail,47,39,0,13,34
70,Fail,49,31,0,17,32
70,Fail,49,42,1,8,41
70,Fail,53,31,3,13,40
70,Fail,39,34,0,25,14
70,Fail,51,26,12,11,40
70,Fail,45,40,3,12,33
70,Fail,52,28,0,18,34
70,Fail,47,35,0,12,35
70,Fail,53,40,0,6,47
70,Fail,48,35,2,15,33
70,Fail,54,35,0,10,44
70,Fail,49,38,0,9,40
70,Fail,49,31,6,14,35
70,Fail,45,40,0,10,35
70,Fail,57,35,1,7,50
70,Fail,50,35,6,9,41
70,Fail,49,39,2,10,39
70,Fail,49,32,0,7,42
70,Fail,45,29,14,12,33
70,Fail,44,39,0,17,27
70,Fail,47,35,1,17,30
70,Fail,46,36,7,11,35
70,Fail,51,36,1,12,39
70,Fail,48,33,1,18,30
70,Fail,51,41,0,8,43
70,Fail,41,41,4,14,27
70,Fail,49,35,0,9,40
70,Fail,48,34,4,14,34
70,Fail,49,39,0,11,38
70,Fail,37,38,5,20,17
70,Fail,43,37,0,12,31
70,Fail,48,36,0,13,35
70,Fail,46,34,0,16,30
70,Fail,51,35,6,8,43
70,Fail,53,31,0,11,42
70,Fail,50,36,0,12,38
70,Fail,48,30,7,15,33
70,Fail,43,33,6,18,25
70,Fail,38,49,0,13,25
70,Fail,47,39,0,13,34
70,Fail,43,34,5,18,25
70,Fail,49,29,11,11,38
70,Fail,58,30,1,11,47
70,Fail,47,38,0,12,35
70,Fail,50,35,2,13,37
70,Fail,41,39,6,14,27
70,Fail,42,39,8,11,31
70,Fail,44,40,0,8,36
70,Fail,50,33,4,13,37
70,Fail,41,45,0,11,30
70,Fail,47,29,9,15,32
70,Fail,44,39,4,13,31
70,Fail,53,34,0,11,42
70,Fail,49,35,0,13,36
70,Fail,43,43,0,10,33
70,Fail,53,28,3,16,37
70,Fail,46,31,9,14,32
70,Fail,44,36,0,14,30
70,Fail,49,41,0,9,40
70,Fail,55,36,2,7,48
70,Fail,46,36,0,10,36
70,Fail,51,28,9,12,39
70,Fail,62,24,0,12,50
70,Fail,46,39,6,9,37
70,Fail,48,37,3,12,36
70,Fail,51,29,5,15,36
70,Fail,43,36,0,21,22
70,Fail,45,41,0,8,37
70,Fail,47,37,6,10,37
70,Fail,48,31,5,16,32
70,Fail,45,28,0,16,29
70,Fail,52,34,3,11,41
70,Fail,45,37,0,15,30
70,Fail,50,40,0,10,40
70,Fail,47,38,1,14,33
70,Fail,48,34,0,12,36
70,Fail,45,34,7,14,31
70,Fail,45,29,0,14,31
70,Fail,56,29,0,13,43
70,Fail,51,31,5,13,38
70,Fail,48,38,1,13,35
70,Fail,46,33,4,17,29
70,Fail,45,41,0,12,33
70,Fail,55,22,10,13,42
70,Fail,50,29,0,14,36
70,Fail,49,35,0,8,41
70,Fail,45,29,0,19,26
70,Fail,47,39,0,10,37
70,Fail,39,36,8,17,22
70,Fail,45,36,0,13,32
70,Fail,55,35,0,10,45
70,Fail,48,32,2,18,30
70,Fail,44,35,0,15,29
70,Fail,43,36,3,18,25
70,Fail,49,35,0,14,35
70,Fail,48,38,0,11,37
70,Fail,50,36,6,8,42
70,Fail,46,36,6,12,34
70,Fail,38,40,6,16,22
70,Fail,45,41,0,11,34
70,Fail,52,36,1,11,41
70,Fail,49,31,2,18,31
70,Fail,47,42,0,9,38
70,Fail,40,38,0,17,23
70,Fail,46,36,4,14,32
70,Fail,49,35,0,16,33
70,Fail,52,37,2,9,43
70,Fail,48,38,3,11,37
70,Fail,46,40,0,10,36
70,Fail,34,41,0,16,18
70,Fail,53,30,1,16,37
70,Fail,44,41,1,14,30
70,Fail,46,34,6,14,32
70,Fail,43,36,9,12,31
70,Fail,48,27,6,19,29
70,Fail,47,36,0,14,33
70,Fail,46,43,0,8,38
70,Fail,46,41,4,9,37
70,Fail,49,36,4,11,38
70,Fail,42,44,0,9,33
70,Fail,43,34,0,13,30
70,Fail,56,33,0,11,45
70,Fail,48,38,0,8,40
70,Fail,48,34,0,14,34
70,Fail,51,36,0,10,41
70,Fail,43,39,0,13,30
70,Fail,48,30,3,19,29
70,Fail,51,29,0,16,35
70,Fail,54,31,0,12,42
70,Fail,51,30,3,16,35
70,Fail,46,35,0,13,33
70,Fail,45,39,2,14,31
70,Fail,46,38,3,13,33
70,Fail,48,41,0,10,38
70,Fail,41,38,2,19,22
70,Fail,42,36,0,14,28
70,Fail,51,34,0,9,42
70,Fail,56,25,7,12,44
70,Fail,42,38,3,17,25
70,Fail,52,37,2,9,43
70,Fail,54,34,8,4,50
70,Fail,51,34,0,9,42
70,Fail,44,28,0,17,27
70,Fail,42,35,9,14,28
70,Fail,50,36,0,12,38
70,Fail,50,31,0,13,37
70,Fail,42,44,0,10,32
70,Fail,42,35,6,17,25
70,Fail,47,36,5,12,35
70,Fail,45,43,5,7,38
70,Fail,49,39,0,10,39
70,Fail,55,32,0,9,46
70,Fail,48,36,0,7,41
70,Fail,50,34,5,11,39
70,Fail,46,37,3,14,32
70,Fail,49,33,0,15,34
70,Fail,45,32,0,9,36
70,Fail,60,33,0,7,53
70,Fail,50,34,0,13,37
70,Fail,37,39,0,18,19
70,Fail,45,33,0,12,33
70,Fail,50,38,0,7,43
70,Fail,47,37,2,14,33
70,Fail,43,35,5,17,26
70,Fail,55,31,2,12,43
70,Fail,44,47,1,8,36
70,Fail,46,39,4,11,35
70,Fail,49,27,0,19,30
70,Fail,44,37,5,14,30
70,Fail,44,38,0,15,29
70,Fail,52,32,5,11,41
70,Fail,49,25,0,20,29
70,Fail,45,35,0,13,32
70,Fail,52,34,0,14,38
70,Fail,50,37,2,11,39
70,Fail,45,46,2,7,38
70,Fail,48,36,0,10,38
70,Fail,47,31,0,15,32
70,Fail,56,33,4,7,49
70,Fail,55,21,0,14,41
70,Fail,60,28,1,11,49
70,Fail,43,34,0,18,25
70,Fail,47,37,0,9,38
70,Fail,54,32,6,8,46
70,Fail,46,41,0,7,39
70,Fail,37,44,9,10,27
70,Fail,50,26,7,17,33
70,Fail,39,31,10,20,19
70,Fail,42,41,11,6,36
70,Fail,47,36,8,9,38
70,Fail,47,30,0,15,32
70,Fail,53,32,0,14,39
70,Fail,48,29,0,16,32
70,Fail,47,41,6,6,41
70,Fail,55,28,0,9,46
70,Fail,47,35,3,15,32
70,Fail,51,29,0,15,36
70,Fail,50,33,10,7,43
70,Fail,51,34,4,11,40
70,Fail,49,36,0,13,36
70,Fail,47,39,0,14,33
70,Fail,45,34,0,17,28
70,Fail,49,39,1,11,38
70,Fail,49,33,2,16,33
70,Fail,49,35,6,10,39
70,Fail,46,33,0,16,30
70,Fail,51,31,0,13,38
70,Fail,49,34,0,12,37
70,Fail,45,43,0,11,34
70,Fail,49,41,2,8,41
70,Fail,42,37,6,15,27
70,Fail,54,34,0,12,42
70,Fail,43,34,6,17,26
70,Fail,51,34,5,10,41
70,Fail,48,35,0,13,35
70,Fail,47,37,2,14,33
70,Fail,50,35,0,14,36
70,Fail,42,34,7,17,25
70,Fail,57,29,0,14,43
70,Fail,42,44,0,8,34
70,Fail,43,41,0,13,30
70,Fail,42,31,9,18,24
70,Fail,56,29,7,8,48
70,Fail,48,27,11,14,34
70,Fail,42,38,7,13,29
70,Fail,53,28,8,11,42
70,Fail,52,34,0,11,41
70,Fail,43,41,1,15,28
70,Fail,52,39,0,8,44
70,Fail,48,33,3,16,32
70,Fail,47,37,0,15,32
70,Fail,46,39,1,14,32
70,Fail,51,32,0,11,40
70,Fail,46,40,0,14,32
70,Fail,55,31,0,10,45
70,Fail,39,42,0,19,20
70,Fail,46,39,3,12,34
70,Fail,51,30,0,15,36
70,Fail,48,38,3,11,37
70,Fail,51,36,2,11,40
70,Fail,48,36,2,14,34
70,Fail,47,41,4,8,39
70,Fail,53,32,0,15,38
70,Fail,55,29,0,11,44
70,Fail,40,40,1,19,21
70,Fail,47,30,4,19,28
70,Fail,58,31,0,11,47
70,Fail,45,37,0,12,33
70,Fail,54,32,6,8,46
70,Fail,54,36,5,5,49
70,Fail,45,40,4,11,34
70,Fail,52,37,1,10,42
70,Fail,47,40,0,11,36
70,Fail,48,34,3,15,33
70,Fail,54,38,0,8,46
70,Fail,47,38,0,11,36
70,Fail,53,34,0,9,44
70,Fail,46,35,6,13,33
70,Fail,56,31,0,13,43
70,Fail,52,38,0,8,44
70,Fail,45,36,3,16,29
70,Fail,50,37,0,10,40
70,Fail,47,39,3,11,36
70,Fail,46,33,7,14,32
70,Fail,54,30,0,13,41
70,Fail,41,38,0,16,25
70,Fail,45,43,0,12,33
70,Fail,52,32,5,11,41
70,Fail,48,30,9,13,35
70,Fail,52,34,2,12,40
70,Fail,50,33,0,15,35
70,Fail,39,40,5,16,23
70,Fail,45,32,8,15,30
70,Fail,51,37,0,10,41
70,Fail,43,38,5,14,29
70,Fail,55,29,4,12,43
70,Fail,52,39,0,8,44
70,Fail,47,39,0,14,33
70,Fail,39,34,2,25,14
70,Fail,48,38,0,10,38
70,Fail,47,35,0,15,32
70,Fail,55,29,0,16,39
70,Fail,52,33,0,12,40
70,Fail,43,42,3,12,31
70,Fail,44,38,3,15,29
70,Fail,53,31,0,13,40
70,Fail,43,34,0,14,29
70,Fail,45,39,0,11,34
70,Fail,51,32,0,14,37
70,Fail,46,40,0,14,32
70,Fail,46,37,0,14,32
70,Fail,50,34,0,14,36
70,Fail,44,34,0,15,29
70,Fail,50,37,1,12,38
70,Fail,47,37,1,15,32
70,Fail,51,36,0,13,38
70,Fail,49,35,2,14,35
70,Fail,53,37,4,6,47
70,Fail,59,28,0,7,52
70,Fail,42,39,0,14,28
70,Fail,52,34,5,9,43
70,Fail,51,28,0,13,38
70,Fail,46,36,5,13,33
70,Fail,47,42,0,11,36
70,Fail,45,43,5,7,38
70,Fail,46,33,7,14,32
70,Fail,51,35,4,10,41
70,Fail,56,30,5,9,47
70,Fail,53,32,0,10,43
70,Fail,52,29,5,14,38
70,Fail,47,36,0,7,40
70,Fail,48,37,0,9,39
70,Fail,53,29,6,12,41
70,Fail,58,37,0,4,54
70,Fail,47,38,1,14,33
70,Fail,55,33,0,8,47
70,Fail,54,36,5,5,49
70,Fail,48,34,0,17,31
70,Fail,48,36,0,12,36
70,Fail,49,30,0,12,37
70,Fail,45,34,6,15,30
70,Fail,53,28,4,15,38
70,Fail,53,37,1,9,44
70,Fail,57,30,1,12,45
70,Fail,51,37,0,11,40
70,Fail,50,31,4,15,35
70,Fail,59,32,0,8,51
70,Fail,43,36,0,15,28
70,Fail,40,37,0,18,22
70,Fail,51,31,0,11,40
70,Fail,46,37,0,12,34
70,Fail,46,40,0,13,33
70,Fail,45,33,0,20,25
70,Fail,48,42,0,7,41
70,Fail,49,35,0,9,40
70,Fail,43,32,12,13,30
70,Fail,47,37,0,14,33
70,Fail,46,33,0,14,32
70,Fail,43,41,0,13,30
70,Fail,48,32,0,12,36
70,Fail,41,39,10,10,31
70,Fail,46,34,0,16,30
70,Fail,45,36,4,15,30
70,Fail,49,43,0,7,42
70,Fail,48,34,0,14,34
70,Fail,44,43,0,12,32
70,Fail,57,23,10,10,47
70,Fail,47,35,4,14,33
70,Fail,50,37,0,7,43
70,Fail,47,32,8,13,34
70,Fail,45,41,0,7,38
70,Fail,47,40,2,11,36
70,Fail,47,29,0,16,31
70,Fail,50,34,0,15,35
70,Fail,45,39,0,14,31
70,Fail,46,42,4,8,38
70,Fail,48,38,7,7,41
70,Fail,44,45,1,10,34
70,Fail,44,37,0,11,33
70,Fail,53,31,0,9,44
70,Fail,44,35,8,13,31
70,Fail,47,43,0,10,37
70,Fail,46,35,0,13,33
70,Fail,48,32,7,13,35
70,Fail,45,35,0,14,31
70,Fail,47,33,0,15,32
70,Fail,38,43,0,16,22
70,Fail,40,43,0,13,27
70,Fail,51,40,0,8,43
70,Fail,56,32,0,12,44
70,Fail,50,39,0,9,41
70,Fail,57,31,0,12,45
70,Fail,48,30,9,13,35
70,Fail,49,36,3,12,37
70,Fail,50,32,0,17,33
70,Fail,46,43,2,9,37
70,Fail,43,35,3,19,24
70,Fail,50,32,4,14,36
70,Fail,53,33,0,14,39
70,Fail,45,36,4,15,30
70,Fail,41,41,0,12,29
70,Fail,45,37,0,11,34
70,Fail,54,30,0,11,43
70,Fail,49,39,4,8,41
70,Fail,49,32,4,15,34
70,Fail,54,33,1,12,42
70,Fail,49,37,1,13,36
70,Fail,53,25,0,16,37
70,Fail,46,31,0,14,32
70,Fail,43,37,4,16,27
70,Fail,53,30,0,9,44
70,Fail,46,36,6,12,34
70,Fail,45,33,0,12,33
70,Fail,46,35,5,14,32
70,Fail,48,34,0,14,34
70,Fail,48,34,0,16,32
70,Fail,47,32,6,15,32
70,Fail,41,46,0,8,33
70,Fail,46,42,1,11,35
70,Fail,47,37,4,12,35
70,Fail,52,37,0,10,42
70,Fail,41,45,0,11,30
70,Fail,50,33,7,10,40
70,Fail,49,31,0,17,32
70,Fail,53,33,9,5,48
70,Fail,40,34,9,17,23
70,Fail,50,36,0,7,43
70,Fail,43,35,0,18,25
70,Fail,45,27,5,23,22
70,Fail,40,40,0,15,25
70,Fail,58,24,2,16,42
70,Fail,47,36,0,9,38
70,Fail,48,39,1,12,36
70,Fail,48,36,0,9,39
70,Fail,52,35,0,12,40
70,Fail,49,35,1,15,34
70,Fail,57,29,1,13,44
70,Fail,47,30,0,19,28
70,Fail,47,40,0,12,35
70,Fail,50,36,3,11,39
70,Fail,49,32,3,16,33
70,Fail,47,38,0,10,37
70,Fail,43,42,0,10,33
70,Fail,52,34,0,14,38
70,Fail,48,36,1,15,33
70,Fail,45,38,6,11,34
70,Fail,43,40,6,11,32
70,Fail,49,39,0,11,38
70,Fail,48,42,0,7,41
70,Fail,52,30,2,16,36
70,Fail,45,33,0,16,29
70,Fail,50,32,4,14,36
70,Fail,50,32,0,17,33
70,Fail,47,43,1,9,38
70,Fail,46,41,2,11,35
70,Fail,44,43,1,12,32
70,Fail,45,39,1,15,30
70,Fail,46,45,0,8,38
70,Fail,50,33,0,17,33
70,Fail,41,32,0,17,24
70,Fail,46,33,0,14,32
70,Fail,46,36,3,15,31
70,Fail,44,39,0,11,33
70,Fail,51,35,0,9,42
70,Fail,44,34,0,14,30
70,Fail,44,38,4,14,30
70,Fail,50,29,3,18,32
70,Fail,46,41,5,8,38
70,Fail,55,37,0,8,47
70,Fail,40,48,0,10,30
70,Fail,45,39,0,12,33
70,Fail,40,37,8,15,25
70,Fail,48,34,2,16,32
70,Fail,48,39,1,12,36
70,Fail,45,33,0,15,30
70,Fail,49,37,2,12,37
70,Fail,43,42,3,12,31
70,Fail,51,30,1,18,33
70,Fail,46,41,3,10,36
70,Fail,41,44,0,11,30
70,Fail,47,37,6,10,37
70,Fail,53,30,0,12,41
70,Fail,47,33,7,13,34
70,Fail,45,42,0,12,33
70,Fail,46,31,6,17,29
70,Fail,49,36,0,15,34
70,Fail,52,39,0,5,47
70,Fail,48,33,9,10,38
70,Fail,55,37,0,7,48
70,Fail,42,37,0,12,30
70,Fail,47,32,7,14,33
70,Fail,45,38,0,15,30
70,Fail,49,36,0,9,40
70,Fail,44,39,6,11,33
70,Fail,43,36,6,15,28
70,Fail,44,40,0,12,32
70,Fail,48,33,0,19,29
70,Fail,43,40,0,10,33
70,Fail,51,35,0,12,39
70,Fail,51,39,0,10,41
70,Fail,45,33,0,13,32
70,Fail,47,37,0,13,34
70,Fail,47,32,1,20,27
70,Fail,48,34,0,12,36
70,Fail,54,37,0,8,46
70,Fail,51,36,0,11,40
70,Fail,49,39,3,9,40
70,Fail,40,38,0,15,25
70,Fail,37,41,0,12,25
70,Fail,46,39,3,12,34
70,Fail,49,36,2,13,36
70,Fail,50,34,2,14,36
70,Fail,48,32,0,17,31
70,Fail,53,33,3,11,42
70,Fail,49,31,8,12,37
70,Fail,55,35,2,8,47
70,Fail,51,41,0,7,44
70,Fail,49,32,3,16,33
70,Fail,51,39,0,7,44
70,Fail,42,36,0,11,31
70,Fail,51,38,2,9,42
70,Fail,50,38,2,10,40
70,Fail,52,34,5,9,43
70,Fail,47,26,0,17,30
70,Fail,47,33,1,19,28
70,Fail,48,38,2,12,36
70,Fail,46,38,3,13,33
70,Fail,51,33,0,10,41
70,Fail,41,39,0,18,23
70,Fail,55,30,1,14,41
70,Fail,51,38,2,9,42
70,Fail,42,45,3,10,32
70,Fail,51,37,0,11,40
70,Fail,49,35,0,13,36
70,Fail,49,39,0,10,39
70,Fail,46,36,0,11,35
70,Fail,50,32,0,16,34
70,Fail,41,45,1,13,28
70,Fail,49,39,0,9,40
70,Fail,45,44,0,6,39
70,Fail,37,41,5,17,20
70,Fail,52,33,0,14,38
70,Fail,52,27,9,12,40
70,Fail,48,40,0,9,39
70,Fail,44,33,7,16,28
70,Fail,53,29,0,13,40
70,Fail,51,32,0,15,36
70,Fail,45,38,0,11,34
70,Fail,48,36,0,13,35
70,Fail,45,37,4,14,31
70,Fail,51,27,6,16,35
70,Fail,50,37,0,11,39
70,Fail,48,38,5,9,39
70,Fail,36,42,0,19,17
70,Fail,42,40,4,14,28
70,Fail,51,26,0,21,30
70,Fail,49,31,4,16,33
70,Fail,40,41,0,12,28
70,Fail,51,33,2,14,37
70,Fail,46,45,0,9,37
70,Fail,48,30,0,18,30
70,Fail,55,27,0,16,39
70,Fail,50,40,0,10,40
70,Fail,52,38,2,8,44
70,Fail,43,39,0,16,27
70,Fail,46,39,0,11,35
70,Fail,52,37,4,7,45
70,Fail,42,40,5,13,29
70,Fail,49,34,7,10,39
70,Fail,53,32,0,12,41
70,Fail,56,23,8,13,43
70,Fail,49,35,1,15,34
70,Fail,52,36,2,10,42
70,Fail,42,44,0,14,28
70,Fail,53,35,0,8,45
70,Fail,41,41,2,16,25
70,Fail,54,34,3,9,45
70,Fail,48,35,1,16,32
70,Fail,40,38,9,13,27
70,Fail,47,39,0,11,36
70,Fail,51,33,0,15,36
70,Fail,49,30,0,21,28
70,Fail,58,34,1,7,51
70,Fail,46,33,0,16,30
70,Fail,48,38,2,12,36
70,Fail,44,39,0,17,27
70,Fail,43,35,0,14,29
70,Fail,39,42,11,8,31
70,Fail,48,34,2,16,32
70,Fail,51,35,0,13,38
70,Fail,47,34,9,10,37
70,Fail,55,34,0,10,45
70,Fail,41,34,0,18,23
70,Fail,51,33,0,10,41
70,Fail,46,37,6,11,35
70,Fail,55,34,0,8,47
70,Fail,47,31,4,18,29
70,Fail,48,32,0,15,33
70,Fail,50,36,6,8,42
70,Fail,44,33,10,13,31
70,Fail,43,37,6,14,29
70,Fail,47,38,4,11,36
70,Fail,50,33,0,17,33
70,Fail,45,40,1,14,31
70,Fail,49,34,0,15,34
70,Fail,46,31,0,13,33
70,Fail,41,36,0,17,24
70,Fail,52,27,7,14,38
70,Fail,51,33,0,16,35
70,Fail,44,38,3,15,29
70,Fail,41,45,5,9,32
70,Fail,43,35,0,16,27
70,Fail,51,34,0,8,43
70,Fail,44,39,0,14,30
70,Fail,50,38,0,8,42
70,Fail,48,28,8,16,32
70,Fail,47,37,0,14,33
70,Fail,49,39,0,12,37
70,Fail,43,33,0,18,25
70,Fail,50,32,4,14,36
70,Fail,41,45,3,11,30
70,Fail,53,33,2,12,41
70,Fail,43,39,0,14,29
70,Fail,52,36,0,12,40
70,Fail,52,32,6,10,42
70,Fail,37,36,0,19,18
70,Fail,48,35,2,15,33
70,Fail,52,29,0,17,35
70,Fail,56,32,0,10,46
70,Fail,51,39,0,10,41
70,Fail,52,31,2,15,37
70,Fail,51,34,0,12,39
70,Fail,46,34,8,12,34
70,Fail,39,35,0,20,19
70,Fail,53,34,1,12,41
70,Fail,49,30,0,18,31
70,Fail,45,36,4,15,30
70,Fail,40,33,9,18,22
70,Fail,45,31,5,19,26
70,Fail,45,40,0,12,33
70,Fail,54,34,1,11,43
70,Fail,54,35,0,10,44
70,Fail,49,28,0,16,33
70,Fail,47,42,5,6,41
70,Fail,56,36,0,8,48
70,Fail,56,28,2,14,42
70,Fail,48,35,7,10,38
70,Fail,52,37,0,9,43
70,Fail,47,34,5,14,33
70,Fail,43,39,0,13,30
70,Fail,43,32,0,13,30
70,Fail,49,37,0,14,35
70,Fail,50,36,2,12,38
70,Fail,53,36,0,10,43
70,Fail,52,34,5,9,43
70,Fail,46,32,8,14,32
70,Fail,49,37,3,11,38
70,Fail,47,41,1,11,36
70,Fail,46,41,5,8,38
70,Fail,49,33,0,9,40
70,Fail,56,30,2,12,44
70,Fail,49,39,1,11,38
70,Fail,48,35,3,14,34
70,Fail,53,31,3,13,40
70,Fail,48,34,5,13,35
70,Fail,56,32,1,11,45
70,Fail,49,42,0,8,41
70,Fail,43,42,5,10,33
70,Fail,42,38,0,16,26
70,Fail,45,35,0,15,30
70,Fail,48,31,6,15,33
70,Fail,53,36,0,6,47
70,Fail,35,41,0,21,14
70,Fail,44,39,0,17,27
70,Fail,48,39,2,11,37
70,Fail,49,39,0,10,39
70,Fail,49,36,3,12,37
70,Fail,45,31,10,14,31
70,Fail,52,38,1,9,43
70,Fail,48,34,0,14,34
70,Fail,53,39,2,6,47
70,Fail,53,34,0,7,46
70,Fail,52,39,0,8,44
70,Fail,43,34,0,16,27
70,Fail,51,38,0,11,40
70,Fail,48,40,2,10,38
70,Fail,55,29,0,16,39
70,Fail,43,34,0,20,23
70,Fail,44,34,0,17,27
70,Fail,41,48,0,10,31
70,Fail,45,32,0,21,24
70,Fail,49,31,0,14,35
70,Fail,46,39,0,11,35
70,Fail,45,39,3,13,32
70,Fail,52,34,1,13,39
70,Fail,49,35,0,7,42
70,Fail,51,34,1,14,37
70,Fail,48,31,8,13,35
70,Fail,48,32,0,15,33
70,Fail,48,37,0,13,35
70,Fail,45,33,0,11,34
70,Fail,48,34,0,12,36
70,Fail,59,28,0,9,50
70,Fail,49,29,0,11,38
70,Fail,53,34,7,6,47
70,Fail,38,37,0,10,28
70,Fail,40,30,0,17,23
70,Fail,53,34,0,11,42
70,Fail,47,36,0,12,35
70,Fail,52,29,0,14,38
70,Fail,48,34,7,11,37
70,Fail,49,38,0,13,36
70,Fail,50,38,0,10,40
70,Fail,44,41,0,10,34
70,Fail,48,33,7,12,36
70,Fail,52,34,0,12,40
70,Fail,44,38,1,17,27
70,Fail,44,36,0,17,27
70,Fail,42,38,0,17,25
70,Fail,48,31,0,11,37
70,Fail,56,30,3,11,45
70,Fail,47,26,0,9,38
70,Fail,45,41,1,13,32
70,Fail,56,30,0,13,43
70,Fail,48,42,2,8,40
70,Fail,50,34,0,10,40
70,Fail,56,27,0,12,44
70,Fail,46,38,8,8,38
70,Fail,39,44,2,15,24
70,Fail,54,32,0,9,45
70,Fail,47,35,0,13,34
70,Fail,48,36,0,14,34
70,Fail,47,44,3,6,41
70,Fail,48,34,0,15,33
70,Fail,40,40,0,15,25
70,Fail,47,38,1,14,33
70,Fail,51,38,0,10,41
70,Fail,53,30,0,15,38
70,Fail,44,40,5,11,33
70,Fail,42,39,0,18,24
70,Fail,44,38,0,17,27
70,Fail,43,35,9,13,30
70,Fail,44,38,0,9,35
70,Fail,53,30,0,15,38
70,Fail,54,32,0,12,42
70,Fail,59,31,4,6,53
70,Fail,53,33,0,10,43
70,Fail,56,30,4,10,46
70,Fail,47,33,0,14,33
70,Fail,52,37,1,10,42
70,Fail,44,30,8,18,26
70,Fail,50,36,5,9,41
70,Fail,53,28,0,14,39
70,Fail,53,29,5,13,40
70,Fail,44,35,0,11,33
70,Fail,54,38,0,8,46
70,Fail,45,36,0,13,32
70,Fail,51,29,11,9,42
70,Fail,49,35,0,11,38
70,Fail,54,30,0,12,42
70,Fail,51,38,1,10,41
70,Fail,56,35,0,9,47
70,Fail,49,32,0,10,39
70,Fail,54,38,1,7,47
70,Fail,52,39,0,2,50
70,Fail,48,41,0,10,38
70,Fail,46,40,2,12,34
70,Fail,45,32,0,12,33
70,Fail,46,34,0,18,28
70,Fail,48,44,1,7,41
70,Fail,51,35,0,10,41
70,Fail,51,32,0,13,38
70,Fail,43,35,0,10,33
70,Fail,45,33,0,11,34
70,Fail,49,43,0,7,42
70,Fail,54,32,0,14,40
70,Fail,42,38,9,11,31
70,Fail,44,35,0,14,30
70,Fail,51,30,0,12,39
70,Fail,52,33,7,8,44
70,Fail,50,30,0,17,33
70,Fail,45,39,0,11,34
70,Fail,50,28,8,14,36
70,Fail,56,32,3,9,47
70,Fail,51,31,4,14,37
70,Fail,38,45,0,14,24
70,Fail,49,25,0,16,33
70,Fail,49,42,0,9,40
70,Fail,43,46,0,9,34
70,Fail,48,31,13,8,40
70,Fail,43,36,7,14,29
70,Fail,53,34,0,9,44
70,Fail,57,29,0,11,46
70,Fail,52,36,0,11,41
70,Fail,41,41,0,12,29
70,Fail,53,38,0,8,45
70,Fail,45,43,1,11,34
70,Fail,48,42,0,10,38
70,Fail,42,35,4,19,23
70,Fail,47,38,2,13,34
70,Fail,42,38,0,17,25
70,Fail,40,43,0,15,25
70,Fail,46,34,0,18,28
70,Fail,48,29,11,12,36
70,Fail,48,37,1,14,34
70,Fail,35,40,10,15,20
70,Fail,50,34,0,11,39
70,Fail,52,33,6,9,43
70,Fail,40,48,1,11,29
70,Fail,49,40,1,10,39
70,Fail,51,30,5,14,37
70,Fail,54,34,0,8,46
70,Fail,52,35,5,8,44
70,Fail,44,41,5,10,34
70,Fail,41,41,0,13,28
70,Fail,42,40,4,14,28
70,Fail,51,34,6,9,42
70,Fail,57,36,1,6,51
70,Fail,41,39,0,18,23
70,Fail,42,41,0,14,28
70,Fail,56,28,2,14,42
70,Fail,50,36,0,11,39
70,Fail,49,36,0,10,39
70,Fail,46,44,1,9,37
70,Fail,45,40,0,14,31
70,Fail,53,32,3,12,41
70,Fail,51,37,6,6,45
70,Fail,46,42,4,8,38
70,Fail,48,38,1,13,35
70,Fail,50,35,3,12,38
70,Fail,48,41,0,7,41
70,Fail,52,37,0,11,41
70,Fail,43,38,0,14,29
70,Fail,44,33,0,19,25
70,Fail,45,36,8,11,34
70,Fail,52,33,5,10,42
70,Fail,43,47,1,9,34
70,Fail,44,42,3,11,33
70,Fail,54,34,0,12,42
70,Fail,46,37,2,15,31
70,Fail,39,40,8,13,26
70,Fail,44,36,0,16,28
70,Fail,43,42,3,12,31
70,Fail,43,34,6,17,26
70,Fail,50,29,5,16,34
70,Fail,52,31,0,15,37
70,Fail,46,34,0,13,33
70,Fail,42,49,0,8,34
70,Fail,47,39,0,13,34
70,Fail,47,40,1,12,35
70,Fail,43,37,0,16,27
70,Fail,49,35,0,13,36
70,Fail,47,29,3,21,26
70,Fail,50,35,0,15,35
70,Fail,47,35,0,14,33
70,Fail,54,30,0,13,41
70,Fail,51,32,0,13,38
70,Fail,45,34,10,11,34
70,Fail,39,38,7,16,23
70,Fail,50,33,0,14,36
70,Fail,35,41,5,19,16
70,Fail,48,35,6,11,37
70,Fail,48,33,2,17,31
70,Fail,38,45,0,17,21
70,Fail,44,37,6,13,31
70,Fail,46,32,0,17,29
70,Fail,51,32,0,13,38
70,Fail,46,42,0,10,36
70,Fail,53,36,0,10,43
70,Fail,48,31,0,12,36
70,Fail,58,32,1,9,49
70,Fail,49,28,0,17,32
70,Fail,45,40,3,12,33
70,Fail,57,29,2,12,45
70,Fail,44,35,6,15,29
70,Fail,48,37,1,14,34
70,Fail,45,38,5,12,33
70,Fail,48,40,3,9,39
70,Fail,55,32,1,12,43
70,Fail,47,44,4,5,42
70,Fail,54,34,0,11,43
70,Fail,43,40,1,16,27
70,Fail,57,30,0,8,49
70,Fail,47,31,0,20,27
70,Fail,46,46,0,7,39
70,Fail,47,29,9,15,32
70,Fail,47,39,2,12,35
70,Fail,51,32,0,11,40
70,Fail,46,36,0,11,35
70,Fail,43,43,3,11,32
70,Fail,44,33,0,17,27
70,Fail,45,37,0,13,32
70,Fail,46,36,0,16,30
70,Fail,53,37,0,10,43
70,Fail,54,34,3,9,45
70,Fail,41,44,2,13,28
70,Fail,50,33,0,12,38
70,Fail,40,33,12,15,25
70,Fail,51,39,5,5,46
70,Fail,54,33,4,9,45
70,Fail,50,37,0,13,37
70,Fail,40,37,12,11,29
70,Fail,44,42,0,14,30
70,Fail,49,37,7,7,42
70,Fail,47,34,0,14,33
70,Fail,49,39,0,12,37
70,Fail,49,34,7,10,39
70,Fail,49,32,4,15,34
70,Fail,49,33,3,15,34
70,Fail,42,40,4,14,28
70,Fail,47,36,6,11,36
70,Fail,51,38,0,11,40
70,Fail,55,23,0,16,39
70,Fail,39,39,0,15,24
70,Fail,46,30,0,13,33
70,Fail,58,27,0,11,47
70,Fail,43,38,0,12,31
70,Fail,52,32,0,10,42
70,Fail,51,32,5,12,39
70,Fail,49,37,1,13,36
70,Fail,54,35,0,11,43
70,Fail,54,27,0,12,42
70,Fail,46,39,2,13,33
70,Fail,45,42,1,12,33
70,Fail,43,46,0,10,33
70,Fail,45,43,0,9,36
70,Fail,54,29,3,14,40
70,Fail,55,28,0,11,44
70,Fail,50,33,0,13,37
70,Fail,38,40,0,12,26
70,Fail,48,40,0,12,36
70,Fail,51,36,0,11,40
70,Fail,56,33,4,7,49
70,Fail,57,34,2,7,50
70,Fail,47,42,0,10,37
70,Fail,52,41,0,7,45
70,Fail,43,40,2,15,28
70,Fail,49,37,0,10,39
70,Fail,53,33,0,12,41
70,Fail,51,33,0,15,36
70,Fail,45,35,0,15,30
70,Fail,50,34,0,9,41
70,Fail,46,38,3,13,33
70,Fail,39,41,0,17,22
70,Fail,45,37,0,12,33
70,Fail,45,29,8,18,27
70,Fail,49,36,4,11,38
70,Fail,53,33,2,12,41
70,Fail,46,46,2,6,40
70,Fail,48,32,0,11,37
70,Fail,49,38,0,12,37
70,Fail,59,25,6,10,49
70,Fail,55,36,2,7,48
70,Fail,50,37,0,9,41
70,Fail,48,36,12,4,44
70,Fail,51,28,0,17,34
70,Fail,55,34,0,8,47
70,Fail,49,30,0,12,37
70,Fail,51,38,1,10,41
70,Fail,38,36,6,20,18
70,Fail,53,28,0,18,35
70,Fail,47,38,4,11,36
70,Fail,49,39,0,11,38
70,Fail,49,38,5,8,41
70,Fail,50,40,0,9,41
70,Fail,46,35,5,14,32
70,Fail,48,36,1,15,33
70,Fail,40,43,7,10,30
70,Fail,50,36,0,13,37
70,Fail,42,34,0,15,27
70,Fail,61,29,0,8,53
70,Fail,51,28,0,14,37
70,Fail,45,35,4,16,29
70,Fail,52,34,4,10,42
70,Fail,56,27,0,15,41
70,Fail,46,34,5,15,31
70,Fail,44,44,2,10,34
70,Fail,42,37,0,15,27
70,Fail,45,40,5,10,35
70,Fail,53,27,0,18,35
70,Fail,42,44,0,14,28
70,Fail,51,31,5,13,38
70,Fail,45,38,0,9,36
70,Fail,55,32,3,10,45
70,Fail,45,40,0,13,32
70,Fail,55,26,0,15,40
70,Fail,57,31,3,9,48
70,Fail,45,43,0,12,33
70,Fail,53,39,0,7,46
70,Fail,42,33,0,12,30
70,Fail,52,34,0,12,40
70,Fail,55,30,0,13,42
70,Fail,46,29,9,16,30
70,Fail,46,41,1,12,34
70,Fail,46,36,0,17,29
70,Fail,47,33,0,10,37
70,Fail,48,26,9,17,31
70,Fail,49,33,0,14,35
70,Fail,52,36,0,11,41
70,Fail,53,37,0,10,43
70,Fail,46,36,0,15,31
70,Fail,40,39,0,19,21
70,Fail,51,37,0,11,40
70,Fail,48,32,0,20,28
70,Fail,58,27,0,15,43
70,Fail,46,34,0,19,27
70,Fail,54,35,0,9,45
70,Fail,44,39,5,12,32
70,Fail,57,29,4,10,47
70,Fail,46,34,0,10,36
70,Fail,49,35,2,14,35
70,Fail,47,39,1,13,34
70,Fail,55,40,0,5,50
70,Fail,47,38,6,9,38
70,Fail,43,38,0,16,27
70,Fail,48,35,0,12,36
70,Fail,49,35,4,12,37
70,Fail,50,35,3,12,38
70,Fail,49,33,5,13,36
70,Fail,57,26,0,14,43
70,Fail,54,34,0,10,44
70,Fail,41,29,15,15,26
70,Fail,45,37,1,17,28
70,Fail,48,38,2,12,36
70,Fail,41,39,6,14,27
70,Fail,47,33,4,16,31
70,Fail,50,34,0,7,43
70,Fail,55,31,0,13,42
70,Fail,47,36,0,14,33
70,Fail,54,27,0,12,42
70,Fail,42,38,0,8,34
70,Fail,50,35,0,14,36
70,Fail,39,39,7,15,24
70,Fail,43,39,0,18,25
70,Fail,49,38,0,10,39
70,Fail,48,36,3,13,35
70,Fail,45,31,8,16,29
70,Fail,44,29,0,19,25
70,Fail,52,36,0,9,43
70,Fail,48,39,0,9,39
70,Fail,50,35,0,10,40
70,Fail,50,36,5,9,41
70,Fail,37,38,0,14,23
70,Fail,35,43,0,15,20
70,Fail,44,31,0,18,26
70,Fail,41,37,0,14,27
70,Fail,56,35,0,7,49
70,Fail,54,34,1,11,43
70,Fail,50,37,2,11,39
70,Fail,48,28,8,16,32
70,Fail,50,28,6,16,34
70,Fail,44,39,0,16,28
70,Fail,43,38,0,13,30
70,Fail,37,36,8,19,18
70,Fail,48,37,0,14,34
70,Fail,46,38,0,11,35
70,Fail,56,34,1,9,47
70,Fail,52,37,0,11,41
70,Fail,39,39,11,11,28
70,Fail,47,38,1,14,33
70,Fail,46,42,0,12,34
70,Fail,50,34,6,10,40
70,Fail,52,25,9,14,38
70,Fail,41,42,0,14,27
70,Fail,51,37,5,7,44
70,Fail,44,38,6,12,32
70,Fail,55,31,1,13,42
70,Fail,49,33,0,12,37
70,Fail,53,31,2,14,39
70,Fail,47,33,4,16,31
70,Fail,35,39,0,20,15
70,Fail,52,38,2,8,44
70,Fail,50,31,0,13,37
70,Fail,45,32,7,16,29
70,Fail,52,33,5,10,42
70,Fail,50,31,0,15,35
70,Fail,53,32,0,8,45
70,Fail,45,35,8,12,33
70,Fail,42,38,3,17,25
70,Fail,49,31,8,12,37
70,Fail,52,31,3,14,38
70,Fail,51,38,0,9,42
70,Fail,61,32,0,7,54
70,Fail,45,41,0,12,33
70,Fail,43,32,0,20,23
70,Fail,46,38,0,10,36
70,Fail,52,37,3,8,44
70,Fail,48,31,10,11,37
70,Fail,47,39,0,9,38
70,Fail,47,32,7,14,33
70,Fail,49,41,2,8,41
70,Fail,53,34,0,13,40
70,Fail,57,37,0,6,51
70,Fail,36,41,10,13,23
70,Fail,52,28,12,8,44
70,Fail,45,32,9,14,31
70,Fail,49,35,6,10,39
70,Fail,50,34,0,15,35
70,Fail,54,32,3,11,43
70,Fail,49,35,0,12,37
70,Fail,52,28,0,20,32
70,Fail,55,33,0,11,44
70,Fail,43,33,0,16,27
70,Fail,44,37,3,16,28
70,Fail,60,25,0,11,49
70,Fail,47,39,0,12,35
70,Fail,50,38,2,10,40
70,Fail,50,36,1,13,37
70,Fail,42,44,0,9,33
70,Fail,52,30,0,17,35
70,Fail,44,32,0,16,28
70,Fail,43,34,4,19,24
70,Fail,43,37,0,17,26
70,Fail,45,40,0,14,31
70,Fail,46,38,4,12,34
70,Fail,42,34,6,18,24
70,Fail,59,34,2,5,54
70,Fail,49,37,1,13,36
70,Fail,39,38,15,8,31
70,Fail,50,32,0,17,33
70,Fail,42,37,6,15,27
70,Fail,42,35,7,16,26
70,Fail,45,43,5,7,38
70,Fail,47,38,0,13,34
70,Fail,41,37,1,21,20
70,Fail,51,37,0,9,42
70,Fail,38,44,0,18,20
70,Fail,48,33,4,15,33
70,Fail,56,35,0,5,51
70,Fail,39,47,1,13,26
70,Fail,57,29,0,11,46
70,Fail,46,36,0,17,29
70,Fail,49,37,1,13,36
70,Fail,49,32,0,16,33
70,Fail,56,31,1,12,44
70,Fail,46,39,0,7,39
70,Fail,45,41,0,13,32
70,Fail,33,47,0,14,19
70,Fail,55,34,2,9,46
70,Fail,55,34,1,10,45
70,Fail,43,30,7,20,23
70,Fail,46,32,0,17,29
70,Fail,43,43,0,10,33
70,Fail,45,37,3,15,30
70,Fail,42,38,2,18,24
70,Fail,53,33,0,10,43
70,Fail,42,33,5,20,22
70,Fail,52,35,5,8,44
70,Fail,52,37,0,11,41
70,Fail,45,40,3,12,33
70,Fail,43,38,0,12,31
70,Fail,43,35,0,19,24
70,Fail,51,37,0,11,40
70,Fail,57,28,0,13,44
70,Fail,50,37,0,12,38
70,Fail,47,36,0,15,32
70,Fail,52,33,4,11,41
70,Fail,52,35,0,13,39
70,Fail,52,33,6,9,43
70,Fail,43,39,0,14,29
70,Fail,54,34,0,9,45
70,Fail,41,44,6,9,32
70,Fail,43,39,9,9,34
70,Fail,41,41,7,11,30
70,Fail,51,33,0,10,41
70,Fail,43,40,2,15,28
70,Fail,43,34,6,17,26
70,Fail,50,40,0,10,40
70,Fail,46,36,0,11,35
70,Fail,37,36,9,18,19
70,Fail,41,33,14,12,29
70,Fail,57,30,0,12,45
70,Fail,44,42,0,13,31
70,Fail,54,30,7,9,45
70,Fail,49,31,0,11,38
70,Fail,40,45,5,10,30
70,Fail,42,36,11,11,31
70,Fail,40,37,5,18,22
70,Fail,46,38,0,11,35
70,Fail,42,35,7,16,26
70,Fail,45,38,0,16,29
70,Fail,49,37,3,11,38
70,Fail,52,29,0,16,36
70,Fail,48,39,0,13,35
70,Fail,55,37,0,7,48
70,Fail,50,29,0,19,31
70,Fail,54,32,4,10,44
70,Fail,50,42,0,6,44
70,Fail,53,34,2,11,42
70,Fail,48,34,0,16,32
70,Fail,52,35,1,12,40
70,Fail,43,43,0,10,33
70,Fail,59,29,5,7,52
70,Fail,48,35,4,13,35
70,Fail,49,29,4,18,31
70,Fail,42,43,0,12,30
70,Fail,49,32,9,10,39
70,Fail,49,32,0,15,34
70,Fail,39,34,5,22,17
70,Fail,46,38,0,14,32
70,Fail,43,41,0,11,32
70,Fail,43,36,0,16,27
70,Fail,54,30,0,16,38
70,Fail,46,41,0,8,38
70,Fail,50,35,4,11,39
70,Fail,43,39,7,11,32
70,Fail,46,38,0,12,34
70,Fail,45,42,0,9,36
70,Fail,46,33,9,12,34
70,Fail,54,36,4,6,48
70,Fail,45,36,0,19,26
70,Fail,49,34,3,14,35
70,Fail,60,25,0,12,48
70,Fail,52,40,0,8,44
70,Fail,57,29,0,12,45
70,Fail,39,47,4,10,29
70,Fail,49,37,0,11,38
70,Fail,49,35,1,15,34
70,Fail,43,47,0,9,34
70,Fail,39,36,8,17,22
70,Fail,48,35,0,10,38
70,Fail,48,25,7,20,28
70,Fail,44,36,0,12,32
70,Fail,49,36,3,12,37
70,Fail,44,42,1,13,31
70,Fail,41,37,0,14,27
70,Fail,47,41,0,10,37
70,Fail,41,45,1,13,28
70,Fail,50,33,0,12,38
70,Fail,46,33,9,12,34
70,Fail,47,38,5,10,37
70,Fail,56,32,0,12,44
70,Fail,47,43,0,9,38
70,Fail,53,33,0,13,40
70,Fail,48,33,0,15,33
70,Fail,48,40,0,8,40
70,Fail,55,29,1,15,40
70,Fail,44,44,0,10,34
70,Fail,46,32,0,18,28
70,Fail,49,39,0,12,37
70,Fail,44,35,0,12,32
70,Fail,56,22,10,12,44
70,Fail,52,33,1,14,38
70,Fail,47,38,0,15,32
70,Fail,51,32,0,11,40
70,Fail,49,34,3,14,35
70,Fail,44,41,0,13,31
70,Fail,48,36,0,15,33
70,Fail,44,32,0,18,26
70,Fail,43,46,1,10,33
70,Fail,54,26,7,13,41
70,Fail,48,39,6,7,41
70,Fail,45,34,13,8,37
70,Fail,48,41,0,10,38
70,Fail,50,36,0,12,38
70,Fail,54,26,0,11,43
70,Fail,48,38,2,12,36
70,Fail,49,36,2,13,36
70,Fail,52,31,3,14,38
70,Fail,50,39,0,11,39
70,Fail,57,29,0,11,46
70,Fail,49,38,3,10,39
70,Fail,46,39,2,13,33
70,Fail,55,27,0,14,41
70,Fail,45,42,0,9,36
70,Fail,56,36,0,8,48
70,Fail,56,35,4,5,51
70,Fail,44,40,4,12,32
70,Fail,47,34,7,12,35
70,Fail,53,31,7,9,44
70,Fail,53,24,0,18,35
70,Fail,45,41,0,13,32
70,Fail,52,37,0,8,44
70,Fail,50,33,7,10,40
70,Fail,54,35,1,10,44
70,Fail,53,32,4,11,42
70,Fail,50,34,0,14,36
70,Fail,46,40,0,13,33
70,Fail,45,34,0,19,26
70,Fail,43,36,0,9,34
70,Fail,45,38,0,14,31
70,Fail,49,36,0,12,37
70,Fail,55,27,6,12,43
70,Fail,49,33,0,16,33
70,Fail,48,34,0,11,37
70,Fail,53,32,0,15,38
70,Fail,49,37,0,12,37
70,Fail,59,30,1,10,49
70,Fail,45,36,0,18,27
70,Fail,47,37,0,13,34
70,Fail,49,35,1,15,34
70,Fail,43,36,0,18,25
70,Fail,46,38,7,9,37
70,Fail,47,38,6,9,38
70,Fail,46,33,2,19,27
70,Fail,49,36,0,10,39
70,Fail,48,35,0,12,36
70,Fail,43,36,9,12,31
70,Fail,55,32,4,9,46
70,Fail,47,39,0,12,35
70,Fail,38,38,0,14,24
70,Fail,45,38,0,14,31
70,Fail,58,23,0,16,42
70,Fail,45,38,1,16,29
70,Fail,47,32,0,16,31
70,Fail,47,39,7,7,40
70,Fail,54,33,0,12,42
70,Fail,48,33,0,14,34
70,Fail,45,43,0,10,35
70,Fail,47,37,4,12,35
70,Fail,47,32,0,12,35
70,Fail,44,42,0,13,31
70,Fail,49,33,5,13,36
70,Fail,44,34,0,14,30
70,Fail,47,40,0,8,39
70,Fail,49,40,0,10,39
70,Fail,40,28,0,17,23
70,Fail,53,32,0,13,40
70,Fail,48,37,0,15,33
70,Fail,46,39,5,10,36
70,Fail,53,28,0,15,38
70,Fail,39,45,9,7,32
70,Fail,42,36,7,15,27
70,Fail,49,37,2,12,37
70,Fail,42,38,9,11,31
70,Fail,52,34,2,12,40
70,Fail,51,37,0,12,39
70,Fail,45,37,0,16,29
70,Fail,54,34,0,12,42
70,Fail,51,37,1,11,40
70,Fail,52,32,0,13,39
70,Fail,50,38,1,11,39
70,Fail,43,36,2,19,24
70,Fail,49,39,0,11,38
70,Fail,48,36,0,14,34
70,Fail,51,33,4,12,39
70,Fail,48,38,0,12,36
70,Fail,48,34,5,13,35
70,Fail,51,36,0,7,44
70,Fail,47,38,0,11,36
70,Fail,51,36,1,12,39
70,Fail,51,30,9,10,41
70,Fail,49,32,3,16,33
70,Fail,51,38,1,10,41
70,Fail,51,27,12,10,41
70,Fail,49,37,0,5,44
70,Fail,46,36,0,17,29
70,Fail,43,35,4,18,25
70,Fail,46,35,0,18,28
70,Fail,39,37,9,15,24
70,Fail,40,43,4,13,27
70,Fail,55,30,1,14,41
70,Fail,48,41,1,10,38
70,Fail,42,37,0,14,28
70,Fail,54,30,0,12,42
70,Fail,39,44,4,13,26
70,Fail,50,30,0,20,30
70,Fail,52,37,0,9,43
70,Fail,46,43,0,10,36
70,Fail,57,34,3,6,51
70,Fail,47,44,0,7,40
70,Fail,44,30,0,13,31
70,Fail,47,35,3,15,32
70,Fail,50,37,0,12,38
70,Fail,44,32,0,14,30
70,Fail,45,36,0,15,30
70,Fail,50,29,0,11,39
70,Fail,48,31,7,14,34
70,Fail,56,39,0,5,51
70,Fail,41,43,6,10,31
70,Fail,53,40,4,3,50
70,Fail,50,32,3,15,35
70,Fail,35,40,0,17,18
70,Fail,45,41,3,11,34
70,Fail,44,37,0,14,30
70,Fail,45,36,3,16,29
70,Fail,45,41,0,14,31
70,Fail,54,31,0,13,41
70,Fail,50,37,1,12,38
70,Fail,50,33,3,14,36
70,Fail,54,30,0,11,43
70,Fail,46,41,1,12,34
70,Fail,41,42,6,11,30
70,Fail,42,40,4,14,28
70,Fail,49,31,12,8,41
70,Fail,58,36,0,6,52
70,Fail,52,33,0,11,41
70,Fail,45,37,7,11,34
70,Fail,47,40,1,12,35
70,Fail,51,35,4,10,41
70,Fail,45,34,9,12,33
70,Fail,39,38,0,15,24
70,Fail,39,35,9,17,22
70,Fail,50,31,6,13,37
70,Fail,39,42,5,14,25
70,Fail,47,32,4,17,30
70,Fail,48,37,0,11,37
70,Fail,49,33,0,10,39
70,Fail,42,37,6,15,27
70,Fail,48,31,0,16,32
70,Fail,49,38,0,10,39
70,Fail,40,44,0,11,29
70,Fail,47,39,0,14,33
70,Fail,47,41,0,8,39
70,Fail,41,40,0,16,25
70,Fail,51,33,6,10,41
70,Fail,53,38,1,8,45
70,Fail,48,35,5,12,36
70,Fail,45,32,1,22,23
70,Fail,50,38,0,12,38
70,Fail,48,36,0,11,37
70,Fail,48,38,0,8,40
70,Fail,47,38,0,8,39
70,Fail,44,34,0,17,27
70,Fail,50,30,0,17,33
70,Fail,47,38,5,10,37
70,Fail,41,40,9,10,31
70,Fail,51,31,0,14,37
70,Fail,47,33,3,17,30
70,Fail,47,38,1,14,33
70,Fail,44,36,0,17,27
70,Fail,53,33,0,11,42
70,Fail,53,30,2,15,38
70,Fail,49,38,1,12,37
70,Fail,47,39,5,9,38
70,Fail,54,30,0,14,40
70,Fail,38,37,7,18,20
70,Fail,48,35,8,9,39
70,Fail,57,31,1,11,46
70,Fail,45,35,5,15,30
70,Fail,45,42,0,9,36
70,Fail,40,43,3,14,26
70,Fail,44,37,0,16,28
70,Fail,47,42,0,11,36
70,Fail,47,32,0,21,26
70,Fail,46,34,5,15,31
70,Fail,45,37,3,15,30
70,Fail,51,32,7,10,41
70,Fail,51,40,2,7,44
70,Fail,45,32,11,12,33
70,Fail,49,35,5,11,38
70,Fail,50,34,6,10,40
70,Fail,46,40,3,11,35
70,Fail,52,32,0,15,37
70,Fail,45,38,7,10,35
70,Fail,49,37,0,11,38
70,Fail,45,28,0,19,26
70,Fail,48,39,0,11,37
70,Fail,42,38,1,19,23
70,Fail,47,41,0,12,35
70,Fail,46,40,0,12,34
70,Fail,44,49,0,6,38
70,Fail,52,31,0,17,35
70,Fail,49,28,0,17,32
70,Fail,42,47,2,9,33
70,Fail,39,35,0,15,24
70,Fail,45,36,8,11,34
70,Fail,59,30,0,9,50
70,Fail,53,32,5,10,43
70,Fail,41,34,4,21,20
70,Fail,49,29,9,13,36
70,Fail,49,40,0,11,38
70,Fail,45,34,7,14,31
70,Fail,39,38,11,12,27
70,Fail,45,37,0,13,32
70,Fail,48,40,7,5,43
70,Fail,46,38,4,12,34
70,Fail,49,34,6,11,38
70,Fail,50,36,0,10,40
70,Fail,53,37,3,7,46
70,Fail,54,25,8,13,41
70,Fail,40,35,0,19,21
70,Fail,54,31,5,10,44
70,Fail,44,35,7,14,30
70,Fail,45,35,0,17,28
70,Fail,49,37,0,14,35
70,Fail,47,32,4,17,30
70,Fail,51,28,2,19,32
70,Fail,40,41,9,10,30
70,Fail,42,35,7,16,26
70,Fail,49,35,0,14,35
70,Fail,50,36,0,9,41
70,Fail,46,38,4,12,34
70,Fail,51,30,0,11,40
70,Fail,48,37,2,13,35
70,Fail,54,31,4,11,43
70,Fail,53,31,5,11,42
70,Fail,51,37,0,11,40
70,Fail,49,34,3,14,35
70,Fail,48,34,0,7,41
70,Fail,46,38,0,16,30
70,Fail,45,39,4,12,33
70,Fail,45,40,2,13,32
70,Fail,52,28,8,12,40
70,Fail,55,34,2,9,46
70,Fail,53,34,3,10,43
70,Fail,52,41,0,7,45
70,Fail,46,33,5,16,30
70,Fail,45,43,0,8,37
70,Fail,53,32,0,14,39
70,Fail,56,33,4,7,49
70,Fail,46,32,0,16,30
70,Fail,53,34,0,7,46
70,Fail,48,39,0,11,37
70,Fail,44,32,0,16,28
70,Fail,40,39,7,14,26
70,Fail,43,37,0,14,29
70,Fail,59,32,2,7,52
70,Fail,38,36,9,17,21
70,Fail,46,38,0,8,38
70,Fail,44,41,2,13,31
70,Fail,45,37,0,12,33
70,Fail,41,33,0,17,24
70,Fail,43,35,0,14,29
70,Fail,44,32,0,17,27
70,Fail,49,37,0,12,37
70,Fail,49,35,0,13,36
70,Fail,55,29,0,12,43
70,Fail,44,42,2,12,32
70,Fail,50,33,6,11,39
70,Fail,41,42,0,10,31
70,Fail,41,41,0,14,27
70,Fail,50,34,0,14,36
70,Fail,50,35,0,10,40
70,Fail,50,37,3,10,40
70,Fail,56,29,4,11,45
70,Fail,44,40,0,16,28
70,Fail,49,38,0,13,36
70,Fail,40,47,3,10,30
70,Fail,52,34,0,14,38
70,Fail,49,34,0,16,33
70,Fail,51,35,7,7,44
70,Fail,47,39,2,12,35
70,Fail,41,38,4,17,24
70,Fail,49,34,0,14,35
70,Fail,49,38,0,12,37
70,Fail,44,38,0,16,28
70,Fail,52,32,0,13,39
70,Fail,56,31,0,12,44
70,Fail,51,28,8,13,38
70,Fail,47,37,3,13,34
70,Fail,51,37,0,10,41
70,Fail,55,32,0,9,46
70,Fail,47,26,15,12,35
70,Fail,48,33,4,15,33
70,Fail,53,35,2,10,43
70,Fail,58,32,0,10,48
70,Fail,45,33,0,19,26
70,Fail,51,37,4,8,43
70,Fail,46,32,0,19,27
70,Fail,54,30,0,9,45
70,Fail,42,37,10,11,31
70,Fail,51,39,0,10,41
70,Fail,50,36,0,13,37
70,Fail,50,40,1,9,41
70,Fail,45,37,0,16,29
70,Fail,54,36,1,9,45
70,Fail,54,32,1,13,41
70,Fail,57,29,6,8,49
70,Fail,49,34,5,12,37
70,Fail,53,27,0,17,36
70,Fail,46,45,0,6,40
70,Fail,49,33,0,15,34
70,Fail,53,35,0,9,44
70,Fail,41,32,0,15,26
70,Fail,52,37,0,7,45
70,Fail,52,29,0,14,38
70,Fail,53,35,5,7,46
70,Fail,49,39,0,11,38
70,Fail,52,33,5,10,42
70,Fail,55,29,0,13,42
70,Fail,50,42,0,7,43
70,Fail,44,37,8,11,33
70,Fail,51,38,0,7,44
70,Fail,37,42,4,17,20
70,Fail,44,37,0,18,26
70,Fail,48,33,0,11,37
70,Fail,47,34,7,12,35
70,Fail,50,35,0,11,39
70,Fail,46,35,0,15,31
70,Fail,47,39,0,11,36
70,Fail,51,38,0,9,42
70,Fail,49,34,7,10,39
70,Fail,50,40,0,9,41
70,Fail,55,29,4,12,43
70,Fail,47,38,1,14,33
70,Fail,49,38,0,8,41
70,Fail,52,38,0,9,43
70,Fail,46,35,11,8,38
70,Fail,45,34,0,18,27
70,Fail,48,39,0,13,35
70,Fail,48,36,1,15,33
70,Fail,52,36,0,9,43
70,Fail,49,39,2,10,39
70,Fail,48,39,0,12,36
70,Fail,50,37,1,12,38
70,Fail,47,42,0,11,36
70,Fail,52,35,2,11,41
70,Fail,49,32,4,15,34
70,Fail,42,41,5,12,30
70,Fail,41,39,7,13,28
70,Fail,51,37,2,10,41
70,Fail,57,32,0,9,48
70,Fail,52,33,3,12,40
70,Fail,48,34,0,12,36
70,Fail,46,44,0,7,39
70,Fail,46,31,0,15,31
70,Fail,53,32,3,12,41
70,Fail,49,41,0,10,39
70,Fail,50,37,3,10,40
70,Fail,52,28,0,10,42
70,Fail,52,42,1,5,47
70,Fail,41,36,0,14,27
70,Fail,49,41,0,9,40
70,Fail,51,39,0,10,41
70,Fail,46,35,0,13,33
70,Fail,46,46,1,7,39
70,Fail,41,39,2,18,23
70,Fail,47,38,0,10,37
70,Fail,50,34,0,11,39
70,Fail,54,30,4,12,42
70,Fail,46,41,1,12,34
70,Fail,50,36,0,11,39
70,Fail,52,33,0,14,38
70,Fail,47,29,0,16,31
70,Fail,48,37,2,13,35
70,Fail,48,35,0,15,33
70,Fail,48,37,0,14,34
70,Fail,50,37,1,12,38
70,Fail,50,37,5,8,42
70,Fail,45,36,0,17,28
70,Fail,47,37,0,7,40
70,Fail,45,34,0,18,27
70,Fail,42,30,0,17,25
70,Fail,51,31,0,13,38
70,Fail,52,27,0,16,36
70,Fail,50,36,6,8,42
70,Fail,48,28,0,13,35
70,Fail,47,38,3,12,35
70,Fail,44,35,0,13,31
70,Fail,43,38,0,14,29
70,Fail,47,40,3,10,37
70,Fail,48,38,0,10,38
70,Fail,49,36,4,11,38
70,Fail,50,35,0,13,37
70,Fail,48,41,0,6,42
70,Fail,43,42,0,7,36
70,Fail,42,41,0,14,28
70,Fail,46,38,3,13,33
70,Fail,50,36,0,10,40
70,Fail,50,39,2,9,41
70,Fail,46,36,0,11,35
70,Fail,47,40,0,13,34
70,Fail,42,42,3,13,29
70,Fail,54,31,3,12,42
70,Fail,52,34,0,12,40
70,Fail,44,37,3,16,28
70,Fail,54,38,1,7,47
70,Fail,49,35,0,14,35
70,Fail,50,35,0,12,38
70,Fail,48,33,0,6,42
70,Fail,52,37,0,10,42
70,Fail,49,32,0,13,36
70,Fail,48,37,0,12,36
70,Fail,56,34,0,8,48
70,Fail,59,26,3,12,47
70,Fail,42,47,0,9,33
70,Fail,59,27,1,13,46
70,Fail,52,35,0,9,43
70,Fail,49,29,3,19,30
70,Fail,48,41,0,9,39
70,Fail,49,37,2,12,37
70,Fail,41,36,7,16,25
70,Fail,50,37,0,9,41
70,Fail,45,40,0,13,32
70,Fail,55,31,1,13,42
70,Fail,50,37,0,8,42
70,Fail,43,39,9,9,34
70,Fail,47,29,0,13,34
70,Fail,47,37,0,13,34
70,Fail,53,31,3,13,40
70,Fail,44,37,2,17,27
70,Fail,56,29,2,13,43
70,Fail,47,38,5,10,37
70,Fail,55,35,0,10,45
70,Fail,55,35,0,9,46
70,Fail,53,33,0,11,42
70,Fail,48,40,0,8,40
70,Fail,49,35,0,10,39
70,Fail,48,34,4,14,34
70,Fail,55,30,0,12,43
70,Fail,42,47,0,10,32
70,Fail,42,33,12,13,29
70,Fail,40,43,0,14,26
70,Fail,52,34,0,12,40
70,Fail,50,35,0,10,40
70,Fail,47,28,0,16,31
70,Fail,44,33,0,15,29
70,Fail,53,34,0,11,42
70,Fail,48,36,0,8,40
70,Fail,50,30,0,9,41
70,Fail,46,28,0,12,34
70,Fail,49,40,0,11,38
70,Fail,47,39,2,12,35
70,Fail,53,31,0,16,37
70,Fail,50,34,1,15,35
70,Fail,48,36,2,14,34
70,Fail,45,34,0,19,26
70,Fail,46,33,0,15,31
70,Fail,52,34,2,12,40
70,Fail,48,39,0,11,37
70,Fail,43,36,4,17,26
70,Fail,46,42,3,9,37
70,Fail,34,36,0,16,18
70,Fail,43,38,5,14,29
70,Fail,43,37,4,16,27
70,Fail,45,37,0,18,27
70,Fail,42,34,0,14,28
70,Fail,48,42,0,7,41
70,Fail,46,32,11,11,35
70,Fail,52,38,2,8,44
70,Fail,39,42,3,16,23
70,Fail,48,41,0,11,37
70,Fail,46,34,0,20,26
70,Fail,45,42,0,11,34
70,Fail,47,32,6,15,32
70,Fail,51,41,0,8,43
70,Fail,41,43,2,14,27
70,Fail,49,37,0,13,36
70,Fail,43,37,4,16,27
70,Fail,41,38,7,14,27
70,Fail,46,41,5,8,38
70,Fail,44,43,0,11,33
70,Fail,39,37,0,20,19
70,Fail,40,36,10,14,26
70,Fail,44,30,12,14,30
70,Fail,49,31,0,14,35
70,Fail,42,43,0,15,27
70,Fail,48,39,4,9,39
70,Fail,42,41,0,14,28
70,Fail,46,40,1,13,33
70,Fail,49,35,0,13,36
70,Fail,50,37,0,9,41
70,Fail,34,38,0,20,14
70,Fail,54,31,0,14,40
70,Fail,51,32,6,11,40
70,Fail,38,41,7,14,24
70,Fail,47,33,0,18,29
70,Fail,47,36,0,13,34
70,Fail,49,38,0,11,38
70,Fail,37,48,2,13,24
70,Fail,46,31,0,15,31
70,Fail,44,30,0,21,23
70,Fail,48,38,2,12,36
70,Fail,46,29,0,20,26
70,Fail,44,35,3,18,26
70,Fail,49,34,2,15,34
70,Fail,44,38,1,17,27
70,Fail,49,36,0,13,36
70,Fail,45,38,0,16,29
70,Fail,48,35,0,8,40
70,Fail,43,34,0,9,34
70,Fail,51,26,0,13,38
70,Fail,44,40,0,14,30
70,Fail,53,28,2,17,36
70,Fail,51,39,0,9,42
70,Fail,55,34,1,10,45
70,Fail,53,33,2,12,41
70,Fail,44,43,0,13,31
70,Fail,41,45,0,12,29
70,Fail,50,38,5,7,43
70,Fail,35,44,10,11,24
70,Fail,43,36,0,14,29
70,Fail,49,36,0,15,34
70,Fail,42,44,0,14,28
70,Fail,54,33,0,11,43
70,Fail,51,35,7,7,44
70,Fail,49,40,0,7,42
70,Fail,51,35,0,11,40
70,Fail,43,43,0,14,29
70,Fail,43,45,5,7,36
70,Fail,49,42,0,8,41
70,Fail,58,29,0,11,47
70,Fail,58,29,0,11,47
70,Fail,44,39,3,14,30
70,Fail,47,42,3,8,39
70,Fail,39,45,5,11,28
70,Fail,39,47,0,12,27
70,Fail,44,40,0,11,33
70,Fail,48,34,0,16,32
70,Fail,41,35,0,17,24
70,Fail,57,35,0,7,50
70,Fail,39,42,5,14,25
70,Fail,50,33,2,15,35
70,Fail,55,32,4,9,46
70,Fail,49,37,0,14,35
70,Fail,41,34,9,16,25
70,Fail,49,39,0,11,38
70,Fail,45,40,0,9,36
70,Fail,50,32,0,11,39
70,Fail,53,32,1,14,39
70,Fail,57,27,2,14,43
70,Fail,54,36,0,8,46
70,Fail,50,27,5,18,32
70,Fail,48,39,1,12,36
70,Fail,50,38,0,10,40
70,Fail,41,35,10,14,27
70,Fail,50,41,1,8,42
70,Fail,47,30,11,12,35
70,Fail,50,31,0,12,38
70,Fail,48,35,0,15,33
70,Fail,48,42,0,10,38
70,Fail,46,36,0,14,32
70,Fail,45,41,3,11,34
70,Fail,44,33,9,14,30
70,Fail,47,35,0,13,34
70,Fail,46,38,0,11,35
70,Fail,49,31,0,14,35
70,Fail,57,29,0,12,45
70,Fail,61,27,4,8,53
70,Fail,49,32,5,14,35
70,Fail,52,39,2,7,45
70,Fail,47,39,7,7,40
70,Fail,39,33,9,19,20
70,Fail,51,38,1,10,41
70,Fail,46,34,4,16,30
70,Fail,45,40,0,11,34
70,Fail,52,31,0,10,42
70,Fail,51,32,0,13,38
70,Fail,45,34,7,14,31
70,Fail,47,39,0,8,39
70,Fail,43,42,4,11,32
70,Fail,47,28,8,17,30
70,Fail,50,36,0,14,36
70,Fail,55,30,0,8,47
70,Fail,51,38,2,9,42
70,Fail,44,40,0,12,32
70,Fail,40,46,4,10,30
70,Fail,49,36,0,15,34
70,Fail,50,37,5,8,42
70,Fail,50,33,0,13,37
70,Fail,49,37,2,12,37
70,Fail,52,32,0,16,36
70,Fail,43,36,0,15,28
70,Fail,49,35,5,11,38
70,Fail,46,32,9,13,33
70,Fail,45,33,8,14,31
70,Fail,50,33,0,12,38
70,Fail,46,34,0,18,28
70,Fail,51,35,1,13,38
70,Fail,45,36,4,15,30
70,Fail,45,37,0,12,33
70,Fail,44,42,7,7,37
70,Fail,56,28,2,14,42
70,Fail,39,38,2,21,18
70,Fail,50,36,1,13,37
70,Fail,47,38,0,14,33
70,Fail,51,26,0,14,37
70,Fail,39,48,0,12,27
70,Fail,44,32,0,18,26
70,Fail,47,39,0,13,34
70,Fail,54,37,1,8,46
70,Fail,45,35,7,13,32
70,Fail,48,39,0,11,37
70,Fail,53,30,0,13,40
70,Fail,51,27,0,18,33
70,Fail,49,34,0,17,32
70,Fail,46,28,9,17,29
70,Fail,52,35,0,6,46
70,Fail,53,37,0,9,44
70,Fail,48,34,1,17,31
70,Fail,49,33,7,11,38
70,Fail,37,33,14,16,21
70,Fail,48,38,0,14,34
70,Fail,51,34,0,12,39
70,Fail,56,28,0,11,45
70,Fail,39,37,0,15,24
70,Fail,49,39,0,9,40
70,Fail,49,36,0,15,34
70,Fail,47,34,0,13,34
70,Fail,50,30,6,14,36
70,Fail,45,33,5,17,28
70,Fail,51,33,3,13,38
70,Fail,48,36,0,13,35
70,Fail,54,24,0,18,36
70,Fail,50,36,0,10,40
70,Fail,43,34,0,8,35
70,Fail,50,28,2,20,30
70,Fail,45,35,5,15,30
70,Fail,48,32,7,13,35
70,Fail,51,30,1,18,33
70,Fail,41,40,7,12,29
70,Fail,52,30,0,12,40
70,Fail,42,44,4,10,32
70,Fail,40,34,13,13,27
70,Fail,46,32,11,11,35
70,Fail,44,38,4,14,30
70,Fail,54,27,0,15,39
70,Fail,56,38,1,5,51
70,Fail,45,41,0,14,31
70,Fail,60,27,0,9,51
70,Fail,52,29,0,13,39
70,Fail,48,35,6,11,37
70,Fail,55,33,5,7,48
70,Fail,43,39,0,14,29
70,Fail,48,42,0,10,38
70,Fail,51,36,0,11,40
70,Fail,48,37,5,10,38
70,Fail,47,33,3,17,30
70,Fail,55,35,0,10,45
70,Fail,49,35,2,14,35
70,Fail,54,34,0,12,42
70,Fail,50,31,0,14,36
70,Fail,53,35,0,11,42
70,Fail,51,38,3,8,43
70,Fail,47,37,0,13,34
70,Fail,51,37,3,9,42
70,Fail,42,36,0,20,22
70,Fail,57,29,0,12,45
70,Fail,47,31,0,16,31
70,Fail,47,35,6,12,35
70,Fail,44,33,0,14,30
70,Fail,48,43,0,8,40
70,Fail,47,37,1,15,32
70,Fail,43,32,0,17,26
70,Fail,52,34,1,13,39
70,Fail,46,38,0,14,32
70,Fail,53,28,1,18,35
70,Fail,49,35,1,15,34
70,Fail,42,34,7,17,25
70,Fail,46,40,3,11,35
70,Fail,49,30,0,19,30
70,Fail,47,33,0,12,35
70,Fail,56,28,0,13,43
70,Fail,51,37,2,10,41
70,Fail,53,35,0,9,44
70,Fail,48,32,7,13,35
70,Fail,45,39,3,13,32
70,Fail,50,29,0,15,35
70,Fail,43,37,0,17,26
70,Fail,52,33,4,11,41
70,Fail,58,27,0,8,50
70,Fail,50,37,0,9,41
70,Fail,49,42,0,8,41
70,Fail,45,43,8,4,41
70,Fail,53,31,0,9,44
70,Fail,47,38,0,12,35
70,Fail,46,36,5,13,33
70,Fail,47,33,4,16,31
70,Fail,41,46,0,10,31
70,Fail,49,36,0,12,37
70,Fail,51,40,0,9,42
70,Fail,39,35,11,15,24
70,Fail,46,40,3,11,35
70,Fail,41,38,6,15,26
70,Fail,43,41,5,11,32
70,Fail,47,39,0,12,35
70,Fail,43,44,2,11,32
70,Fail,45,40,0,11,34
70,Fail,56,30,2,12,44
70,Fail,45,37,0,15,30
70,Fail,48,41,1,10,38
70,Fail,47,39,0,14,33
70,Fail,52,40,2,6,46
70,Fail,40,42,0,17,23
70,Fail,43,41,0,14,29
70,Fail,49,37,0,11,38
70,Fail,54,24,5,17,37
70,Fail,46,35,2,17,29
70,Fail,48,43,3,6,42
70,Fail,51,36,0,11,40
70,Fail,51,29,9,11,40
70,Fail,54,25,8,13,41
70,Fail,57,31,1,11,46
70,Fail,45,42,0,6,39
70,Fail,55,32,4,9,46
70,Fail,45,36,0,14,31
70,Fail,45,47,1,7,38
70,Fail,44,36,0,17,27
70,Fail,50,36,0,11,39
70,Fail,41,40,0,15,26
70,Fail,44,44,3,9,35
70,Fail,39,45,0,12,27
70,Fail,47,32,0,18,29
70,Fail,55,32,0,13,42
70,Fail,43,35,13,9,34
70,Fail,47,32,10,11,36
70,Fail,46,33,0,16,30
70,Fail,51,33,0,15,36
70,Fail,48,33,6,13,35
70,Fail,44,34,0,16,28
70,Fail,51,38,2,9,42
70,Fail,40,36,0,15,25
70,Fail,34,41,0,11,23
70,Fail,53,33,0,14,39
70,Fail,41,43,2,14,27
70,Fail,46,38,0,10,36
70,Fail,50,39,3,8,42
70,Fail,46,26,11,17,29
70,Fail,48,35,0,9,39
70,Fail,42,33,9,16,26
70,Fail,52,31,1,16,36
70,Fail,49,35,0,14,35
70,Fail,46,36,0,16,30
70,Fail,43,37,0,19,24
70,Fail,43,36,8,13,30
70,Fail,49,41,4,6,43
70,Fail,54,33,4,9,45
70,Fail,47,39,0,13,34
70,Fail,44,33,2,21,23
70,Fail,48,36,2,14,34
70,Fail,45,40,2,13,32
70,Fail,45,32,4,19,26
70,Fail,46,28,0,17,29
70,Fail,40,39,0,17,23
70,Fail,39,43,0,17,22
70,Fail,53,26,0,6,47
70,Fail,51,34,1,14,37
70,Fail,50,35,0,15,35
70,Fail,48,34,9,9,39
70,Fail,42,33,10,15,27
70,Fail,42,38,0,18,24
70,Fail,47,42,0,7,40
70,Fail,49,37,4,10,39
70,Fail,52,27,13,8,44
70,Fail,51,35,1,13,38
70,Fail,47,42,0,11,36
70,Fail,43,47,0,9,34
70,Fail,50,25,0,17,33
70,Fail,51,31,0,13,38
70,Fail,43,43,0,14,29
70,Fail,57,33,0,10,47
70,Fail,44,40,0,15,29
70,Fail,53,31,0,13,40
70,Fail,46,41,0,9,37
70,Fail,54,36,3,7,47
70,Fail,57,29,3,11,46
70,Fail,42,34,7,17,25
70,Fail,45,34,0,16,29
70,Fail,51,39,1,9,42
70,Fail,61,22,7,10,51
70,Fail,41,39,0,16,25
70,Fail,43,30,0,21,22
70,Fail,45,38,0,12,33
70,Fail,47,39,1,13,34
70,Fail,45,38,0,13,32
70,Fail,54,35,0,11,43
70,Fail,50,31,0,18,32
70,Fail,47,41,2,10,37
70,Fail,44,31,7,18,26
70,Fail,50,40,0,10,40
70,Fail,45,42,4,9,36
70,Fail,50,36,6,8,42
70,Fail,61,28,0,11,50
70,Fail,52,35,1,12,40
70,Fail,44,41,3,12,32
70,Fail,54,30,6,10,44
70,Fail,53,34,2,11,42
70,Fail,54,37,1,8,46
70,Fail,45,38,0,14,31
70,Fail,46,45,3,6,40
70,Fail,43,32,8,17,26
70,Fail,49,34,0,8,41
70,Fail,50,39,0,10,40
70,Fail,46,31,1,22,24
70,Fail,46,38,0,14,32
70,Fail,53,34,0,9,44
70,Fail,42,34,15,9,33
70,Fail,52,35,5,8,44
70,Fail,49,34,1,16,33
70,Fail,45,42,6,7,38
70,Fail,35,42,0,16,19
70,Fail,44,39,1,16,28
70,Fail,54,28,11,7,47
70,Fail,51,36,0,12,39
70,Fail,49,29,9,13,36
70,Fail,51,34,0,15,36
70,Fail,52,36,4,8,44
70,Fail,52,38,0,7,45
70,Fail,44,39,4,13,31
70,Fail,47,34,3,16,31
70,Fail,45,36,0,15,30
70,Fail,48,39,0,13,35
70,Fail,46,37,0,11,35
70,Fail,47,32,9,12,35
70,Fail,46,38,0,13,33
70,Fail,39,47,0,11,28
70,Fail,45,36,7,12,33
70,Fail,46,41,0,11,35
70,Fail,46,34,8,12,34
70,Fail,43,37,6,14,29
70,Fail,45,32,0,19,26
70,Fail,51,34,0,6,45
70,Fail,47,39,0,8,39
70,Fail,51,38,0,6,45
70,Fail,49,29,10,12,37
70,Fail,52,28,10,10,42
70,Fail,49,40,0,10,39
70,Fail,46,33,6,15,31
70,Fail,53,38,0,9,44
70,Fail,54,34,0,8,46
70,Fail,46,37,0,15,31
70,Fail,48,35,4,13,35
70,Fail,54,36,1,9,45
70,Fail,40,47,0,12,28
70,Fail,47,32,4,17,30
70,Fail,45,32,8,15,30
70,Fail,49,40,0,9,40
70,Fail,47,32,7,14,33
70,Fail,51,30,0,19,32
70,Fail,49,31,0,12,37
70,Fail,52,31,7,10,42
70,Fail,53,31,4,12,41
70,Fail,52,32,0,13,39
70,Fail,53,31,5,11,42
70,Fail,51,33,1,15,36
70,Fail,46,38,1,15,31
70,Fail,50,36,0,13,37
70,Fail,47,31,0,21,26
70,Fail,44,38,0,13,31
70,Fail,52,31,2,15,37
70,Fail,49,28,9,14,35
70,Fail,58,27,3,12,46
70,Fail,49,35,2,14,35
70,Fail,45,39,0,12,33
70,Fail,53,35,0,10,43
70,Fail,43,38,3,16,27
70,Fail,42,38,0,15,27
70,Fail,49,32,5,14,35
70,Fail,50,29,5,16,34
70,Fail,45,40,7,8,37
70,Fail,46,32,7,15,31
70,Fail,51,34,0,11,40
70,Fail,56,30,0,12,44
70,Fail,36,43,3,18,18
70,Fail,50,34,0,16,34
70,Fail,53,39,1,7,46
70,Fail,39,37,0,17,22
70,Fail,49,28,5,18,31
70,Fail,49,33,7,11,38
70,Fail,48,30,0,22,26
70,Fail,49,30,12,9,40
70,Fail,47,37,0,9,38
70,Fail,53,28,0,14,39
70,Fail,44,37,11,8,36
70,Fail,44,35,11,10,34
70,Fail,47,40,0,12,35
70,Fail,51,32,6,11,40
70,Fail,43,37,0,16,27
70,Fail,49,35,0,16,33
70,Fail,50,38,0,9,41
70,Fail,52,31,3,14,38
70,Fail,40,33,12,15,25
70,Fail,44,39,3,14,30
70,Fail,50,36,0,14,36
70,Fail,43,33,5,19,24
70,Fail,42,45,0,7,35
70,Fail,45,33,9,13,32
70,Fail,51,37,0,9,42
70,Fail,43,38,0,16,27
70,Fail,55,32,2,11,44
70,Fail,46,38,8,8,38
70,Fail,43,36,10,11,32
70,Fail,51,36,4,9,42
70,Fail,50,40,0,10,40
70,Fail,46,41,0,13,33
70,Fail,51,32,0,8,43
70,Fail,52,39,1,8,44
70,Fail,48,39,3,10,38
70,Fail,45,44,0,10,35
70,Fail,45,37,6,12,33
70,Fail,51,32,3,14,37
70,Fail,51,30,7,12,39
70,Fail,51,25,8,16,35
70,Fail,44,42,0,12,32
70,Fail,54,32,0,11,43
70,Fail,48,30,0,20,28
70,Fail,41,41,0,11,30
70,Fail,52,34,0,14,38
70,Fail,44,39,0,13,31
70,Fail,52,37,0,8,44
70,Fail,57,30,4,9,48
70,Fail,45,42,0,7,38
70,Fail,42,36,0,13,29
70,Fail,51,43,2,4,47
70,Fail,48,36,0,14,34
70,Fail,47,38,1,14,33
70,Fail,36,33,0,17,19
70,Fail,45,38,0,11,34
70,Fail,55,34,1,10,45
70,Fail,52,38,0,10,42
70,Fail,45,39,0,13,32
70,Fail,49,35,0,10,39
70,Fail,55,33,0,11,44
70,Fail,44,38,3,15,29
70,Fail,52,41,0,6,46
70,Fail,41,42,5,12,29
70,Fail,46,40,4,10,36
70,Fail,49,34,5,12,37
70,Fail,44,41,5,10,34
70,Fail,46,30,12,12,34
70,Fail,49,33,0,15,34
70,Fail,44,47,0,7,37
70,Fail,47,34,0,17,30
70,Fail,50,35,0,14,36
70,Fail,54,35,0,11,43
70,Fail,39,33,0,18,21
70,Fail,52,29,0,12,40
70,Fail,48,34,0,14,34
70,Fail,53,39,0,7,46
70,Fail,51,33,6,10,41
70,Fail,37,39,0,14,23
70,Fail,46,37,6,11,35
70,Fail,48,30,6,16,32
70,Fail,42,38,0,18,24
70,Fail,51,34,0,15,36
70,Fail,57,35,0,7,50
70,Fail,52,38,0,10,42
70,Fail,47,33,0,10,37
70,Fail,50,31,5,14,36
70,Fail,50,29,0,18,32
70,Fail,42,36,0,21,21
70,Fail,42,35,0,20,22
70,Fail,38,44,9,9,29
70,Fail,53,31,0,13,40
70,Fail,53,36,0,11,42
70,Fail,61,34,0,5,56
70,Fail,54,29,8,9,45
70,Fail,48,36,0,11,37
70,Fail,42,34,6,18,24
70,Fail,54,32,1,13,41
70,Fail,36,48,3,13,23
70,Fail,54,31,0,10,44
70,Fail,51,34,1,14,37
70,Fail,46,40,1,13,33
70,Fail,48,31,0,20,28
70,Fail,41,40,2,17,24
70,Fail,38,43,3,16,22
70,Fail,54,30,0,16,38
70,Fail,47,36,0,17,30
70,Fail,42,37,0,16,26
70,Fail,50,32,1,17,33
70,Fail,43,38,3,16,27
70,Fail,44,43,0,13,31
70,Fail,50,39,1,10,40
70,Fail,48,38,0,11,37
70,Fail,43,32,0,18,25
70,Fail,55,32,5,8,47
70,Fail,39,46,0,13,26
70,Fail,39,36,11,14,25
70,Fail,52,34,0,14,38
70,Fail,49,39,0,12,37
70,Fail,45,42,0,11,34
70,Fail,47,37,7,9,38
70,Fail,51,31,0,16,35
70,Fail,52,26,0,13,39
70,Fail,55,31,5,9,46
70,Fail,49,35,5,11,38
70,Fail,50,34,6,10,40
70,Fail,40,34,7,19,21
70,Fail,54,39,0,7,47
70,Fail,49,32,0,12,37
70,Fail,51,34,7,8,43
70,Fail,47,36,0,16,31
70,Fail,49,33,2,16,33
70,Fail,43,41,0,13,30
70,Fail,48,34,0,16,32
70,Fail,42,39,0,11,31
70,Fail,49,32,0,9,40
70,Fail,45,40,0,6,39
70,Fail,54,34,3,9,45
70,Fail,48,38,0,10,38
70,Fail,53,27,7,13,40
70,Fail,45,46,0,8,37
70,Fail,52,41,1,6,46
70,Fail,49,32,0,12,37
70,Fail,55,29,3,13,42
70,Fail,47,42,1,10,37
70,Fail,50,33,2,15,35
70,Fail,39,37,12,12,27
70,Fail,43,43,3,11,32
70,Fail,50,41,0,8,42
70,Fail,49,36,0,11,38
70,Fail,53,37,0,7,46
70,Fail,47,38,0,11,36
70,Fail,46,38,2,14,32
70,Fail,54,31,0,13,41
70,Fail,45,36,0,16,29
70,Fail,38,41,0,13,25
70,Fail,53,30,0,14,39
70,Fail,43,22,0,15,28
70,Fail,47,42,1,10,37
70,Fail,45,39,0,11,34
70,Fail,48,37,4,11,37
70,Fail,44,36,9,11,33
70,Fail,48,35,3,14,34
70,Fail,48,25,0,18,30
70,Fail,45,33,7,15,30
70,Fail,50,38,0,9,41
70,Fail,49,37,0,11,38
70,Fail,47,28,10,15,32
70,Fail,46,41,3,10,36
70,Fail,45,45,3,7,38
70,Fail,44,41,2,13,31
70,Fail,48,38,0,11,37
70,Fail,50,27,0,17,33
70,Fail,53,32,0,11,42
70,Fail,43,36,0,17,26
70,Fail,48,36,3,13,35
70,Fail,50,38,0,10,40
70,Fail,49,37,1,13,36
70,Fail,45,34,8,13,32
70,Fail,48,33,0,17,31
70,Fail,47,41,2,10,37
70,Fail,45,39,6,10,35
70,Fail,52,37,0,10,42
70,Fail,56,34,0,10,46
70,Fail,50,33,0,14,36
70,Fail,47,35,0,8,39
70,Fail,40,44,3,13,27
70,Fail,48,39,3,10,38
70,Fail,56,32,0,9,47
70,Fail,51,34,2,13,38
70,Fail,42,36,0,16,26
70,Fail,46,35,7,12,34
70,Fail,47,38,1,14,33
70,Fail,42,35,9,14,28
70,Fail,47,36,8,9,38
70,Fail,51,40,0,9,42
70,Fail,46,42,0,12,34
70,Fail,54,34,0,12,42
70,Fail,48,38,0,11,37
70,Fail,42,37,5,16,26
70,Fail,48,33,7,12,36
70,Fail,47,36,3,14,33
70,Fail,42,34,12,12,30
70,Fail,49,34,0,12,37
70,Fail,43,39,0,15,28
70,Fail,54,31,5,10,44
70,Fail,47,32,0,13,34
70,Fail,42,35,0,18,24
70,Fail,54,23,0,16,38
70,Fail,40,39,9,12,28
70,Fail,56,33,0,10,46
70,Fail,53,27,0,15,38
70,Fail,50,40,2,8,42
70,Fail,47,35,0,16,31
70,Fail,46,35,3,16,30
70,Fail,51,33,0,13,38
70,Fail,54,29,1,16,38
70,Fail,56,37,0,5,51
70,Fail,48,37,1,14,34
70,Fail,53,33,0,13,40
70,Fail,56,37,1,6,50
70,Fail,48,29,9,14,34
70,Fail,42,38,0,16,26
70,Fail,52,38,0,6,46
70,Fail,59,22,0,17,42
70,Fail,41,37,0,14,27
70,Fail,56,37,1,6,50
70,Fail,39,43,6,12,27
70,Fail,45,37,0,11,34
70,Fail,48,39,6,7,41
70,Fail,47,31,4,18,29
70,Fail,51,37,2,10,41
70,Fail,40,42,0,16,24
70,Fail,54,31,0,11,43
70,Fail,45,40,6,9,36
70,Fail,47,39,0,7,40
70,Fail,48,38,2,12,36
70,Fail,48,32,5,15,33
70,Fail,56,30,3,11,45
70,Fail,48,33,4,15,33
70,Fail,51,35,0,9,42
70,Fail,41,35,4,20,21
70,Fail,56,32,2,10,46
70,Fail,45,40,0,14,31
70,Fail,58,27,1,14,44
70,Fail,45,38,1,16,29
70,Fail,50,32,8,10,40
70,Fail,47,31,0,8,39
70,Fail,39,45,0,13,26
70,Fail,45,36,0,10,35
70,Fail,45,36,0,13,32
70,Fail,44,41,5,10,34
70,Fail,40,40,10,10,30
70,Fail,46,36,1,17,29
70,Fail,41,32,15,12,29
70,Fail,49,36,0,14,35
70,Fail,43,35,6,16,27
70,Fail,42,36,0,13,29
70,Fail,49,33,0,16,33
70,Fail,52,35,0,9,43
70,Fail,46,34,0,15,31
70,Fail,53,31,0,15,38
70,Fail,49,40,0,11,38
70,Fail,50,37,1,12,38
70,Fail,50,32,0,17,33
70,Fail,36,43,0,16,20
70,Fail,47,39,1,13,34
70,Fail,45,40,0,14,31
70,Fail,52,35,0,13,39
70,Fail,55,28,0,14,41
70,Fail,46,32,4,18,28
70,Fail,46,32,5,17,29
70,Fail,50,30,6,14,36
70,Fail,47,36,0,11,36
70,Fail,50,32,0,14,36
70,Fail,43,36,8,13,30
70,Fail,51,36,5,8,43
70,Fail,50,39,0,10,40
70,Fail,44,42,0,11,33
70,Fail,57,35,1,7,50
70,Fail,47,44,2,7,40
70,Fail,49,35,0,15,34
70,Fail,43,39,6,12,31
70,Fail,39,40,0,17,22
70,Fail,53,36,0,5,48
70,Fail,46,45,0,9,37
70,Fail,48,40,1,11,37
70,Fail,53,32,5,10,43
70,Fail,46,37,0,13,33
70,Fail,43,40,0,13,30
70,Fail,52,40,0,8,44
70,Fail,54,26,0,16,38
70,Fail,48,38,0,11,37
70,Fail,52,29,6,13,39
70,Fail,50,38,0,12,38
70,Fail,48,36,0,13,35
70,Fail,53,25,0,15,38
70,Fail,55,34,0,8,47
70,Fail,41,42,4,13,28
70,Fail,50,33,5,12,38
70,Fail,57,30,3,10,47
70,Fail,50,36,0,12,38
70,Fail,56,37,0,7,49
70,Fail,45,37,7,11,34
70,Fail,53,37,1,9,44
70,Fail,44,37,5,14,30
70,Fail,53,35,0,7,46
70,Fail,46,35,0,14,32
70,Fail,50,35,0,11,39
70,Fail,53,27,0,15,38
70,Fail,54,31,4,11,43
70,Fail,53,31,7,9,44
70,Fail,37,39,10,14,23
70,Fail,54,32,0,13,41
70,Fail,54,34,0,10,44
70,Fail,51,37,0,9,42
70,Fail,48,38,5,9,39
70,Fail,50,29,6,15,35
70,Fail,42,39,0,16,26
70,Fail,45,36,0,11,34
70,Fail,50,40,1,9,41
70,Fail,46,45,2,7,39
70,Fail,50,27,0,13,37
70,Fail,48,30,9,13,35
70,Fail,47,42,2,9,38
70,Fail,49,35,0,13,36
70,Fail,51,32,0,17,34
70,Fail,47,31,9,13,34
70,Fail,49,35,3,13,36
70,Fail,55,36,2,7,48
70,Fail,50,36,0,7,43
70,Fail,50,27,0,19,31
70,Fail,49,34,7,10,39
70,Fail,53,36,3,8,45
70,Fail,48,35,1,16,32
70,Fail,56,23,0,14,42
70,Fail,52,37,1,10,42
70,Fail,52,34,0,9,43
70,Fail,49,38,5,8,41
70,Fail,48,32,0,12,36
70,Fail,52,30,0,18,34
70,Fail,50,35,3,12,38
70,Fail,40,41,6,13,27
70,Fail,50,36,1,13,37
70,Fail,48,34,6,12,36
70,Fail,51,33,7,9,42
70,Fail,46,37,5,12,34
70,Fail,47,34,0,15,32
70,Fail,51,36,0,12,39
70,Fail,46,40,1,13,33
70,Fail,45,47,0,8,37
70,Fail,46,38,6,10,36
70,Fail,49,35,0,9,40
70,Fail,42,31,11,16,26
70,Fail,51,37,2,10,41
70,Fail,39,41,0,12,27
70,Fail,47,36,0,13,34
70,Fail,46,33,0,14,32
70,Fail,45,33,0,14,31
70,Fail,52,30,3,15,37
70,Fail,44,43,0,13,31
70,Fail,55,33,3,9,46
70,Fail,47,39,1,13,34
70,Fail,49,35,0,9,40
70,Fail,45,38,0,15,30
70,Fail,50,36,0,11,39
70,Fail,55,31,1,13,42
70,Fail,46,34,7,13,33
70,Fail,49,39,6,6,43
70,Fail,43,36,7,14,29
70,Fail,45,28,12,15,30
70,Fail,47,31,3,19,28
70,Fail,47,36,0,15,32
70,Fail,45,39,2,14,31
70,Fail,42,28,11,19,23
70,Fail,57,30,0,13,44
70,Fail,45,37,3,15,30
70,Fail,55,38,0,6,49
70,Fail,46,39,0,9,37
70,Fail,48,45,0,3,45
70,Fail,47,33,4,16,31
70,Fail,43,28,13,16,27
70,Fail,53,36,0,6,47
70,Fail,38,40,3,19,19
70,Fail,51,25,6,18,33
70,Fail,48,35,0,14,34
70,Fail,49,39,2,10,39
70,Fail,51,33,5,11,40
70,Fail,44,27,11,18,26
70,Fail,42,41,3,14,28
70,Fail,50,34,0,14,36
70,Fail,53,37,0,10,43
70,Fail,48,32,0,14,34
70,Fail,45,40,2,13,32
70,Fail,58,32,0,10,48
70,Fail,47,38,0,10,37
70,Fail,51,36,0,12,39
70,Fail,48,32,0,15,33
70,Fail,56,31,0,10,46
70,Fail,51,31,3,15,36
70,Fail,40,38,0,15,25
70,Fail,46,32,0,19,27
70,Fail,45,32,0,19,26
70,Fail,47,35,0,11,36
70,Fail,41,35,11,13,28
70,Fail,52,33,5,10,42
70,Fail,43,44,0,10,33
70,Fail,48,38,2,12,36
70,Fail,42,38,0,14,28
70,Fail,52,38,0,8,44
70,Fail,56,29,0,14,42
70,Fail,43,38,0,12,31
70,Fail,45,37,0,18,27
70,Fail,48,35,0,14,34
70,Fail,46,32,6,16,30
70,Fail,44,27,0,12,32
70,Fail,52,37,0,9,43
70,Fail,45,38,0,17,28
70,Fail,54,33,0,10,44
70,Fail,51,36,0,12,39
70,Fail,55,31,4,10,45
70,Fail,53,36,0,11,42
70,Fail,48,37,0,13,35
70,Fail,53,33,3,11,42
70,Fail,38,31,14,17,21
70,Fail,49,35,0,14,35
70,Fail,52,34,1,13,39
70,Fail,41,40,0,13,28
70,Fail,48,44,3,5,43
70,Fail,46,36,0,17,29
70,Fail,49,32,5,14,35
70,Fail,46,39,0,15,31
70,Fail,50,40,0,8,42
70,Fail,47,33,9,11,36
70,Fail,50,32,1,17,33
70,Fail,45,37,7,11,34
70,Fail,59,31,1,9,50
70,Fail,58,30,0,10,48
70,Fail,48,30,9,13,35
70,Fail,52,31,6,11,41
70,Fail,47,34,0,12,35
70,Fail,49,35,7,9,40
70,Fail,55,29,3,13,42
70,Fail,47,33,0,16,31
70,Fail,48,35,1,16,32
70,Fail,47,35,0,13,34
70,Fail,40,38,4,18,22
70,Fail,42,41,1,16,26
70,Fail,50,39,0,10,40
70,Fail,46,40,0,13,33
70,Fail,48,39,3,10,38
70,Fail,42,40,0,9,33
70,Fail,40,37,0,15,25
70,Fail,45,38,1,16,29
70,Fail,54,34,3,9,45
70,Fail,44,35,0,14,30
70,Fail,51,34,3,12,39
70,Fail,41,37,10,12,29
70,Fail,53,31,4,12,41
70,Fail,52,35,3,10,42
70,Fail,44,40,0,11,33
70,Fail,48,38,0,13,35
70,Fail,49,42,0,9,40
70,Fail,49,37,2,12,37
70,Fail,46,36,4,14,32
70,Fail,50,29,6,15,35
70,Fail,39,45,2,14,25
70,Fail,45,40,4,11,34
70,Fail,49,39,0,11,38
70,Fail,52,35,0,9,43
70,Fail,49,36,0,13,36
70,Fail,43,35,7,15,28
70,Fail,50,37,1,12,38
70,Fail,45,43,1,11,34
70,Fail,49,36,0,12,37
70,Fail,50,31,6,13,37
70,Fail,55,29,0,15,40
70,Fail,44,45,1,10,34
70,Fail,48,35,3,14,34
70,Fail,51,29,2,18,33
70,Fail,58,30,0,10,48
70,Fail,54,30,5,11,43
70,Fail,43,45,0,12,31
70,Fail,50,33,0,13,37
70,Fail,53,30,2,15,38
70,Fail,45,38,4,13,32
70,Fail,46,32,0,15,31
70,Fail,36,49,2,13,23
70,Fail,50,31,0,15,35
70,Fail,46,39,0,10,36
70,Fail,50,37,0,12,38
70,Fail,48,35,1,16,32
70,Fail,48,30,4,18,30
70,Fail,43,23,13,21,22
70,Fail,40,45,6,9,31
70,Fail,46,34,0,20,26
70,Fail,47,38,0,10,37
70,Fail,51,34,3,12,39
70,Fail,54,30,0,16,38
70,Fail,46,43,1,10,36
70,Fail,53,37,0,8,45
70,Fail,50,35,4,11,39
70,Fail,50,31,7,12,38
70,Fail,40,38,0,19,21
70,Fail,39,43,0,15,24
70,Fail,39,43,0,14,25
70,Fail,46,46,0,5,41
70,Fail,52,34,6,8,44
70,Fail,50,36,1,13,37
70,Fail,53,35,0,12,41
70,Fail,48,38,0,12,36
70,Fail,47,39,0,14,33
70,Fail,38,41,0,18,20
70,Fail,56,29,2,13,43
70,Fail,42,39,6,13,29
70,Fail,48,38,0,13,35
70,Fail,43,41,4,12,31
70,Fail,49,33,0,15,34
70,Fail,48,34,9,9,39
70,Fail,48,38,0,13,35
70,Fail,54,34,0,9,45
70,Fail,45,37,5,13,32
70,Fail,45,34,0,11,34
70,Fail,54,35,0,10,44
70,Fail,46,38,0,16,30
70,Fail,46,40,4,10,36
70,Fail,49,36,0,12,37
70,Fail,34,41,0,24,10
70,Fail,52,32,4,12,40
70,Fail,49,22,10,19,30
70,Fail,55,25,3,17,38
70,Fail,46,36,2,16,30
70,Fail,43,35,0,12,31
70,Fail,49,33,2,16,33
70,Fail,48,42,0,8,40
70,Fail,47,28,0,13,34
70,Fail,50,37,0,12,38
70,Fail,43,34,9,14,29
70,Fail,42,42,2,14,28
70,Fail,50,33,0,12,38
70,Fail,52,33,0,14,38
70,Fail,54,32,0,8,46
70,Fail,53,31,1,15,38
70,Fail,43,41,3,13,30
70,Fail,46,37,0,11,35
70,Fail,56,30,1,13,43
70,Fail,43,41,0,16,27
70,Fail,53,35,5,7,46
70,Fail,37,42,0,10,27
70,Fail,50,38,0,12,38
70,Fail,47,33,0,15,32
70,Fail,47,29,7,17,30
70,Fail,49,36,3,12,37
70,Fail,44,32,0,16,28
70,Fail,49,32,0,15,34
70,Fail,55,33,1,11,44
70,Fail,50,40,0,9,41
70,Fail,51,31,0,10,41
70,Fail,52,28,0,10,42
70,Fail,50,41,2,7,43
70,Fail,49,37,0,9,40
70,Fail,50,36,0,11,39
70,Fail,47,33,0,15,32
70,Fail,51,34,0,12,39
70,Fail,53,30,0,17,36
70,Fail,48,35,2,15,33
70,Fail,43,40,5,12,31
70,Fail,45,37,6,12,33
70,Fail,49,38,0,10,39
70,Fail,53,35,3,9,44
70,Fail,47,34,8,11,36
70,Fail,51,35,1,13,38
70,Fail,50,29,6,15,35
70,Fail,39,44,3,14,25
70,Fail,45,41,0,13,32
70,Fail,50,30,3,17,33
70,Fail,46,34,0,6,40
70,Fail,49,35,4,12,37
70,Fail,44,39,0,11,33
70,Fail,44,35,6,15,29
70,Fail,43,41,0,12,31
70,Fail,40,42,0,15,25
70,Fail,46,36,0,17,29
70,Fail,48,34,7,11,37
70,Fail,51,36,2,11,40
70,Fail,42,40,4,14,28
70,Fail,41,39,0,20,21
70,Fail,47,32,8,13,34
70,Fail,53,34,0,12,41
70,Fail,51,35,0,13,38
70,Fail,44,39,5,12,32
70,Fail,49,36,0,10,39
70,Fail,53,31,1,15,38
70,Fail,40,39,4,17,23
70,Fail,51,33,3,13,38
70,Fail,49,35,4,12,37
70,Fail,55,31,0,11,44
70,Fail,44,42,5,9,35
70,Fail,50,28,0,17,33
70,Fail,43,42,0,11,32
70,Fail,44,34,0,15,29
70,Fail,48,31,0,20,28
70,Fail,47,34,0,13,34
70,Fail,53,33,0,13,40
70,Fail,49,39,2,10,39
70,Fail,46,37,0,12,34
70,Fail,52,35,0,10,42
70,Fail,50,36,2,12,38
70,Fail,48,36,0,15,33
70,Fail,49,32,0,14,35
70,Fail,45,39,1,15,30
70,Fail,57,32,3,8,49
70,Fail,47,43,0,10,37
70,Fail,46,33,6,15,31
70,Fail,46,35,0,19,27
70,Fail,54,34,3,9,45
70,Fail,56,29,0,12,44
70,Fail,53,36,1,10,43
70,Fail,49,32,2,17,32
70,Fail,54,29,0,12,42
70,Fail,50,36,1,13,37
70,Fail,42,41,2,15,27
70,Fail,44,35,13,8,36
70,Fail,43,38,7,12,31
70,Fail,51,31,0,13,38
70,Fail,44,36,0,17,27
70,Fail,50,37,5,8,42
70,Fail,52,41,0,6,46
70,Fail,53,31,3,13,40
70,Fail,50,35,3,12,38
70,Fail,41,43,3,13,28
70,Fail,47,38,3,12,35
70,Fail,44,37,2,17,27
70,Fail,46,35,0,18,28
70,Fail,49,34,0,13,36
70,Fail,50,38,0,11,39
70,Fail,46,36,7,11,35
70,Fail,50,30,0,12,38
70,Fail,43,34,7,16,27
70,Fail,48,33,0,15,33
70,Fail,52,36,0,10,42
70,Fail,45,37,0,16,29
70,Fail,52,39,0,9,43
70,Fail,54,32,0,12,42
70,Fail,44,39,3,14,30
70,Fail,48,36,0,13,35
70,Fail,52,27,0,14,38
70,Fail,47,42,0,9,38
70,Fail,54,29,0,10,44
70,Fail,53,33,2,12,41
70,Fail,40,35,10,15,25
70,Fail,44,34,0,16,28
70,Fail,43,47,0,8,35
70,Fail,41,34,0,17,24
70,Fail,48,33,6,13,35
70,Fail,55,33,2,10,45
70,Fail,48,40,0,12,36
70,Fail,48,33,0,13,35
70,Fail,40,41,10,9,31
70,Fail,53,33,0,11,42
70,Fail,45,38,0,12,33
70,Fail,45,43,0,11,34
70,Fail,48,32,0,16,32
70,Fail,44,35,0,21,23
70,Fail,49,32,3,16,33
70,Fail,48,32,0,17,31
70,Fail,36,39,0,17,19
70,Fail,43,33,6,18,25
70,Fail,51,36,0,11,40
70,Fail,48,39,2,11,37
70,Fail,47,39,1,13,34
70,Fail,43,40,0,13,30
70,Fail,44,34,4,18,26
70,Fail,45,37,2,16,29
70,Fail,45,34,0,14,31
70,Fail,50,26,12,12,38
70,Fail,57,35,0,6,51
70,Fail,44,38,6,12,32
70,Fail,49,44,1,6,43
70,Fail,51,33,0,13,38
70,Fail,38,34,0,27,11
70,Fail,49,36,0,15,34
70,Fail,44,41,3,12,32
70,Fail,42,31,12,15,27
70,Fail,44,39,5,12,32
70,Fail,45,39,0,11,34
70,Fail,47,33,8,12,35
70,Fail,47,38,0,12,35
70,Fail,47,34,2,17,30
70,Fail,45,32,0,16,29
70,Fail,47,37,3,13,34
70,Fail,56,35,0,9,47
70,Fail,41,42,0,17,24
70,Fail,42,41,8,9,33
70,Fail,45,36,8,11,34
70,Fail,50,34,3,13,37
70,Fail,51,34,0,14,37
70,Fail,49,36,3,12,37
70,Fail,34,45,0,16,18
70,Fail,51,33,0,12,39
70,Fail,47,40,3,10,37
70,Fail,52,36,1,11,41
70,Fail,50,32,0,16,34
70,Fail,56,19,11,14,42
70,Fail,43,40,3,14,29
70,Fail,50,32,6,12,38
70,Fail,42,33,6,19,23
70,Fail,43,38,4,15,28
70,Fail,48,37,0,12,36
70,Fail,45,29,12,14,31
70,Fail,44,46,0,7,37
70,Fail,51,35,6,8,43
70,Fail,57,34,0,9,48
70,Fail,55,33,2,10,45
70,Fail,55,30,2,13,42
70,Fail,48,39,0,12,36
70,Fail,43,48,0,8,35
70,Fail,41,35,0,14,27
70,Fail,44,43,3,10,34
70,Fail,55,34,6,5,50
70,Fail,49,40,2,9,40
70,Fail,54,36,0,9,45
70,Fail,54,33,0,10,44
70,Fail,45,37,0,13,32
70,Fail,48,35,4,13,35
70,Fail,55,35,0,7,48
70,Fail,54,40,2,4,50
70,Fail,51,27,6,16,35
70,Fail,49,40,1,10,39
70,Fail,50,27,0,19,31
70,Fail,42,40,7,11,31
70,Fail,47,43,0,5,42
70,Fail,45,41,0,9,36
70,Fail,49,31,5,15,34
70,Fail,49,35,2,14,35
70,Fail,48,35,1,16,32
70,Fail,54,35,0,10,44
70,Fail,51,33,2,14,37
70,Fail,36,41,0,23,13
70,Fail,43,42,1,14,29
70,Fail,41,37,8,14,27
70,Fail,50,36,1,13,37
70,Fail,37,43,6,14,23
70,Fail,49,39,1,11,38
70,Fail,51,33,2,14,37
70,Fail,46,44,0,7,39
70,Fail,51,29,0,14,37
70,Fail,48,37,0,15,33
70,Fail,46,38,6,10,36
70,Fail,45,34,4,17,28
70,Fail,48,34,9,9,39
70,Fail,45,38,1,16,29
70,Fail,46,38,8,8,38
70,Fail,53,25,8,14,39
70,Fail,51,39,0,9,42
70,Fail,42,36,5,17,25
70,Fail,48,35,6,11,37
70,Fail,51,35,0,12,39
70,Fail,49,34,0,12,37
70,Fail,51,37,4,8,43
70,Fail,52,30,3,15,37
70,Fail,39,39,0,13,26
70,Fail,49,33,1,17,32
70,Fail,50,36,2,12,38
70,Fail,42,34,0,13,29
70,Fail,41,40,4,15,26
70,Fail,54,32,1,13,41
70,Fail,52,34,1,13,39
70,Fail,54,29,6,11,43
70,Fail,47,35,0,14,33
70,Fail,55,32,8,5,50
70,Fail,49,37,5,9,40
70,Fail,37,38,0,15,22
70,Fail,48,26,10,16,32
70,Fail,43,37,0,16,27
70,Fail,47,32,9,12,35
70,Fail,39,37,0,15,24
70,Fail,49,38,0,8,41
70,Fail,48,45,0,6,42
70,Fail,52,38,2,8,44
70,Fail,45,38,5,12,33
70,Fail,45,43,0,11,34
70,Fail,48,31,0,16,32
70,Fail,53,31,3,13,40
70,Fail,41,35,7,17,24
70,Fail,57,26,0,13,44
70,Fail,49,36,2,13,36
70,Fail,54,36,1,9,45
70,Fail,49,34,5,12,37
70,Fail,47,33,11,9,38
70,Fail,45,32,0,13,32
70,Fail,46,33,0,16,30
70,Fail,50,39,0,10,40
70,Fail,41,28,0,19,22
70,Fail,49,35,5,11,38
70,Fail,44,36,0,13,31
70,Fail,51,33,6,10,41
70,Fail,51,36,0,12,39
70,Fail,41,43,1,15,26
70,Fail,48,37,0,10,38
70,Fail,51,42,0,6,45
70,Fail,49,32,1,18,31
70,Fail,50,35,2,13,37
70,Fail,51,34,0,12,39
70,Fail,48,33,6,13,35
70,Fail,50,41,4,5,45
70,Fail,47,31,11,11,36
70,Fail,53,33,5,9,44
70,Fail,45,35,6,14,31
70,Fail,49,31,0,14,35
70,Fail,50,31,3,16,34
70,Fail,52,34,0,6,46
70,Fail,45,34,2,19,26
70,Fail,45,36,0,13,32
70,Fail,47,35,0,17,30
70,Fail,43,37,8,12,31
70,Fail,54,32,0,13,41
70,Fail,48,35,2,15,33
70,Fail,47,29,0,15,32
70,Fail,44,42,0,12,32
70,Fail,46,41,4,9,37
70,Fail,48,37,0,8,40
70,Fail,50,39,0,10,40
70,Fail,46,34,7,13,33
70,Fail,46,36,4,14,32
70,Fail,49,37,0,9,40
70,Fail,38,45,0,13,25
70,Fail,54,28,0,14,40
70,Fail,41,34,0,18,23
70,Fail,46,38,0,14,32
70,Fail,40,43,1,16,24
70,Fail,47,26,11,16,31
70,Fail,47,38,0,12,35
70,Fail,49,32,0,19,30
70,Fail,47,31,0,17,30
70,Fail,48,40,0,11,37
70,Fail,58,30,0,9,49
70,Fail,43,35,4,18,25
70,Fail,51,27,0,14,37
70,Fail,50,37,0,13,37
70,Fail,55,35,0,9,46
70,Fail,54,33,0,10,44
70,Fail,47,34,0,18,29
70,Fail,53,33,0,13,40
70,Fail,46,37,0,14,32
70,Fail,51,37,5,7,44
70,Fail,48,36,0,12,36
70,Fail,52,36,0,11,41
70,Fail,54,28,6,12,42
70,Fail,51,37,0,12,39
70,Fail,49,45,0,5,44
70,Fail,54,26,0,14,40
70,Fail,51,33,0,12,39
70,Fail,46,36,3,15,31
70,Fail,53,30,3,14,39
70,Fail,44,34,10,12,32
70,Fail,36,42,0,15,21
70,Fail,51,31,2,16,35
70,Fail,39,36,8,17,22
70,Fail,46,35,0,15,31
70,Fail,45,42,3,10,35
70,Fail,51,40,0,8,43
70,Fail,47,33,0,15,32
70,Fail,48,31,5,16,32
70,Fail,54,30,0,13,41
70,Fail,49,35,6,10,39
70,Fail,54,29,0,16,38
70,Fail,45,36,0,17,28
70,Fail,47,31,5,17,30
70,Fail,48,33,0,11,37
70,Fail,50,38,0,11,39
70,Fail,49,33,0,18,31
70,Fail,45,34,4,17,28
70,Fail,46,40,5,9,37
70,Fail,51,30,7,12,39
70,Fail,45,40,6,9,36
70,Fail,53,34,2,11,42
70,Fail,49,31,0,16,33
70,Fail,53,35,5,7,46
70,Fail,55,33,4,8,47
70,Fail,45,38,0,17,28
70,Fail,49,27,0,16,33
70,Fail,45,31,10,14,31
70,Fail,43,45,0,11,32
70,Fail,42,41,2,15,27
70,Fail,49,40,3,8,41
70,Fail,45,37,5,13,32
70,Fail,49,38,2,11,38
70,Fail,44,40,0,12,32
70,Fail,51,31,2,16,35
70,Fail,53,31,0,9,44
70,Fail,46,38,0,12,34
70,Fail,43,41,0,16,27
70,Fail,49,30,0,15,34
70,Fail,51,32,0,11,40
70,Fail,41,42,5,12,29
70,Fail,48,37,0,12,36
70,Fail,54,33,0,13,41
70,Fail,46,33,6,15,31
70,Fail,47,31,4,18,29
70,Fail,48,35,10,7,41
70,Fail,60,30,1,9,51
70,Fail,47,35,1,17,30
70,Fail,46,36,2,16,30
70,Fail,49,21,0,20,29
70,Fail,50,39,0,9,41
70,Fail,53,38,1,8,45
70,Fail,42,35,6,17,25
70,Fail,49,40,0,11,38
70,Fail,47,36,0,12,35
70,Fail,50,35,5,10,40
70,Fail,46,40,0,13,33
70,Fail,52,32,0,10,42
70,Fail,51,40,0,9,42
70,Fail,45,36,5,14,31
70,Fail,49,38,0,11,38
70,Fail,43,28,19,10,33
70,Fail,46,38,2,14,32
70,Fail,48,33,3,16,32
70,Fail,51,36,0,12,39
70,Fail,38,42,0,14,24
70,Fail,48,31,0,19,29
70,Fail,48,36,5,11,37
70,Fail,47,29,8,16,31
70,Fail,51,38,0,11,40
70,Fail,51,34,2,13,38
70,Fail,54,28,0,12,42
70,Fail,50,42,0,8,42
70,Fail,50,32,0,18,32
70,Fail,45,33,0,18,27
70,Fail,43,40,0,7,36
70,Fail,52,34,0,14,38
70,Fail,49,38,0,8,41
70,Fail,44,42,1,13,31
70,Fail,47,37,0,15,32
70,Fail,51,36,5,8,43
70,Fail,44,35,0,12,32
70,Fail,52,33,0,12,40
70,Fail,48,39,0,12,36
70,Fail,58,24,6,12,46
70,Fail,56,35,0,9,47
70,Fail,47,34,2,17,30
70,Fail,40,35,9,16,24
70,Fail,55,35,0,9,46
70,Fail,48,33,0,15,33
70,Fail,48,37,0,9,39
70,Fail,46,30,0,19,27
70,Fail,44,39,0,13,31
70,Fail,42,40,6,12,30
70,Fail,43,39,2,16,27
70,Fail,49,33,0,16,33
70,Fail,53,35,0,10,43
70,Fail,48,40,0,12,36
70,Fail,41,33,0,14,27
70,Fail,38,50,0,11,27
70,Fail,44,40,6,10,34
70,Fail,50,34,0,14,36
70,Fail,43,40,1,16,27
70,Fail,54,30,3,13,41
70,Fail,47,33,7,13,34
70,Fail,55,36,0,7,48
70,Fail,48,35,0,16,32
70,Fail,48,34,0,15,33
70,Fail,48,36,0,14,34
70,Fail,49,37,0,11,38
70,Fail,49,36,0,11,38
70,Fail,49,36,4,11,38
70,Fail,52,32,1,15,37
70,Fail,35,37,13,15,20
70,Fail,47,35,0,13,34
70,Fail,45,42,1,12,33
70,Fail,53,39,3,5,48
70,Fail,52,39,2,7,45
70,Fail,50,35,2,13,37
70,Fail,44,35,3,18,26
70,Fail,48,37,4,11,37
70,Fail,48,37,0,13,35
70,Fail,52,37,0,11,41
70,Fail,48,35,0,13,35
70,Fail,47,41,0,10,37
70,Fail,50,35,0,14,36
70,Fail,41,40,7,12,29
70,Fail,52,37,0,11,41
70,Fail,47,31,0,11,36
70,Fail,53,31,0,11,42
70,Fail,53,34,0,13,40
70,Fail,43,34,0,14,29
70,Fail,40,35,12,13,27
70,Fail,44,43,6,7,37
70,Fail,47,35,0,18,29
70,Fail,50,35,0,15,35
70,Fail,51,36,0,13,38
70,Fail,44,39,0,7,37
70,Fail,43,42,0,13,30
70,Fail,44,32,5,19,25
70,Fail,50,33,0,11,39
70,Fail,53,33,0,10,43
70,Fail,42,42,2,14,28
70,Fail,50,28,3,19,31
70,Fail,50,34,4,12,38
70,Fail,36,37,0,22,14
70,Fail,55,32,0,12,43
70,Fail,55,30,3,12,43
70,Fail,52,27,0,18,34
70,Fail,43,40,4,13,30
70,Fail,45,37,0,15,30
70,Fail,55,27,7,11,44
70,Fail,43,47,4,6,37
70,Fail,38,44,0,14,24
70,Fail,40,44,6,10,30
70,Fail,43,39,0,14,29
70,Fail,45,34,0,16,29
70,Fail,51,28,6,15,36
70,Fail,51,35,4,10,41
70,Fail,47,36,2,15,32
70,Fail,45,41,0,14,31
70,Fail,57,25,13,5,52
70,Fail,50,24,0,14,36
70,Fail,48,38,0,13,35
70,Fail,47,34,0,16,31
70,Fail,43,36,0,13,30
70,Fail,48,43,3,6,42
70,Fail,54,37,2,7,47
70,Fail,51,34,2,13,38
70,Fail,54,33,2,11,43
70,Fail,52,31,5,12,40
70,Fail,49,36,0,11,38
70,Fail,55,28,0,13,42
70,Fail,46,38,6,10,36
70,Fail,39,33,14,14,25
70,Fail,59,33,0,5,54
70,Fail,51,31,0,11,40
70,Fail,48,33,3,16,32
70,Fail,47,31,0,20,27
70,Fail,48,36,0,14,34
70,Fail,46,35,1,18,28
70,Fail,43,38,5,14,29
70,Fail,49,34,0,8,41
70,Fail,52,34,3,11,41
70,Fail,46,39,0,12,34
70,Fail,47,37,4,12,35
70,Fail,40,37,0,19,21
70,Fail,48,34,0,16,32
70,Fail,45,45,3,7,38
70,Fail,48,32,0,13,35
70,Fail,48,39,0,12,36
70,Fail,55,27,0,18,37
70,Fail,45,44,2,9,36
70,Fail,53,34,0,12,41
70,Fail,55,31,0,13,42
70,Fail,47,37,0,11,36
70,Fail,50,32,0,13,37
70,Fail,44,41,0,13,31
70,Fail,47,39,0,14,33
70,Fail,52,35,1,12,40
70,Fail,49,37,0,10,39
70,Fail,55,36,0,7,48
70,Fail,50,31,0,13,37
70,Fail,51,31,0,12,39
70,Fail,44,34,0,18,26
70,Fail,42,37,0,12,30
70,Fail,52,36,0,11,41
70,Fail,46,38,1,15,31
70,Fail,40,34,0,22,18
70,Fail,54,33,3,10,44
70,Fail,46,45,0,8,38
70,Fail,37,43,0,18,19
70,Fail,49,34,0,6,43
70,Fail,56,32,0,10,46
70,Fail,50,32,0,12,38
70,Fail,45,40,0,14,31
70,Fail,46,36,5,13,33
70,Fail,58,30,0,11,47
70,Fail,47,40,2,11,36
70,Fail,55,31,5,9,46
70,Fail,52,33,0,14,38
70,Fail,50,34,2,14,36
70,Fail,53,35,3,9,44
70,Fail,48,30,0,17,31
70,Fail,51,27,7,15,36
70,Fail,47,34,2,17,30
70,Fail,48,39,2,11,37
70,Fail,49,36,6,9,40
70,Fail,50,40,0,7,43
70,Fail,54,33,1,12,42
70,Fail,55,34,0,10,45
70,Fail,52,34,7,7,45
70,Fail,42,38,8,12,30
70,Fail,53,29,2,16,37
70,Fail,57,27,0,13,44
70,Fail,46,32,8,14,32
70,Fail,43,40,7,10,33
70,Fail,51,36,0,10,41
70,Fail,43,41,0,15,28
70,Fail,53,36,1,10,43
70,Fail,51,38,1,10,41
70,Fail,48,39,0,10,38
70,Fail,41,40,0,16,25
70,Fail,49,36,2,13,36
70,Fail,52,32,0,16,36
70,Fail,49,30,7,14,35
70,Fail,51,29,7,13,38
70,Fail,50,38,0,11,39
70,Fail,49,34,0,16,33
70,Fail,48,39,2,11,37
70,Fail,49,28,9,14,35
70,Fail,45,42,0,9,36
70,Fail,51,38,1,10,41
70,Fail,41,33,11,15,26
70,Fail,41,31,13,15,26
70,Fail,52,27,7,14,38
70,Fail,44,42,3,11,33
70,Fail,47,30,13,10,37
70,Fail,54,34,3,9,45
70,Fail,52,32,0,11,41
70,Fail,46,31,6,17,29
70,Fail,46,27,7,20,26
70,Fail,50,32,5,13,37
70,Fail,54,37,0,9,45
70,Fail,41,38,0,18,23
70,Fail,43,41,0,11,32
70,Fail,50,38,1,11,39
70,Fail,52,39,0,8,44
70,Fail,43,40,0,14,29
70,Fail,42,42,0,15,27
70,Fail,45,32,3,20,25
70,Fail,43,37,0,20,23
70,Fail,51,36,0,11,40
70,Fail,48,37,1,14,34
70,Fail,51,26,0,16,35
70,Fail,46,38,0,11,35
70,Fail,46,29,8,17,29
70,Fail,44,31,3,22,22
70,Fail,50,30,0,17,33
70,Fail,42,45,0,8,34
70,Fail,56,34,0,9,47
70,Fail,52,40,2,6,46
70,Fail,42,35,0,11,31
70,Fail,50,33,0,13,37
70,Fail,38,46,0,11,27
70,Fail,38,44,4,14,24
70,Fail,52,37,2,9,43
70,Fail,49,35,0,11,38
70,Fail,42,36,0,15,27
70,Fail,44,33,8,15,29
70,Fail,50,38,3,9,41
70,Fail,61,32,0,7,54
70,Fail,47,40,1,12,35
70,Fail,39,35,0,19,20
70,Fail,50,28,0,14,36
70,Fail,41,42,1,16,25
70,Fail,49,36,0,13,36
70,Fail,44,41,0,13,31
70,Fail,44,43,0,11,33
70,Fail,46,27,13,14,32
70,Fail,50,36,6,8,42
70,Fail,50,35,0,15,35
70,Fail,49,35,6,10,39
70,Fail,51,37,0,12,39
70,Fail,53,35,2,10,43
70,Fail,48,40,0,10,38
70,Fail,46,32,0,5,41
70,Fail,54,35,2,9,45
70,Fail,44,47,0,7,37
70,Fail,50,36,0,11,39
70,Fail,44,35,3,18,26
70,Fail,52,39,2,7,45
70,Fail,53,31,1,15,38
70,Fail,42,38,3,17,25
70,Fail,37,43,8,12,25
70,Fail,56,29,0,11,45
70,Fail,46,42,0,11,35
70,Fail,48,31,10,11,37
70,Fail,44,39,0,16,28
70,Fail,55,30,0,10,45
70,Fail,50,36,0,12,38
70,Fail,50,32,0,15,35
70,Fail,46,37,0,11,35
70,Fail,51,33,6,10,41
70,Fail,41,43,3,13,28
70,Fail,41,30,0,26,15
70,Fail,46,39,2,13,33
70,Fail,44,37,9,10,34
70,Fail,51,35,4,10,41
70,Fail,50,38,0,10,40
70,Fail,46,34,5,15,31
70,Fail,49,34,0,13,36
70,Fail,50,36,2,12,38
70,Fail,46,39,0,11,35
70,Fail,49,36,0,13,36
70,Fail,53,37,0,7,46
70,Fail,48,33,9,10,38
70,Fail,53,28,8,11,42
70,Fail,47,34,5,14,33
70,Fail,48,39,0,9,39
70,Fail,52,25,5,18,34
70,Fail,48,39,0,8,40
70,Fail,50,33,0,12,38
70,Fail,49,33,0,13,36
70,Fail,46,37,0,12,34
70,Fail,54,34,0,12,42
70,Fail,56,33,0,11,45
70,Fail,42,34,0,16,26
70,Fail,51,36,1,12,39
70,Fail,43,35,6,16,27
70,Fail,42,48,0,9,33
70,Fail,43,40,4,13,30
70,Fail,48,39,0,12,36
70,Fail,41,39,5,15,26
70,Fail,49,38,1,12,37
70,Fail,50,37,0,13,37
70,Fail,43,35,0,14,29
70,Fail,44,31,6,19,25
70,Fail,54,30,5,11,43
70,Fail,46,33,0,19,27
70,Fail,48,43,4,5,43
70,Fail,43,41,1,15,28
70,Fail,50,38,0,9,41
70,Fail,51,32,1,16,35
70,Fail,47,38,0,9,38
70,Fail,49,38,0,11,38
70,Fail,55,31,3,11,44
70,Fail,43,36,4,17,26
70,Fail,47,41,0,11,36
70,Fail,44,38,6,12,32
70,Fail,43,47,0,9,34
70,Fail,49,35,1,15,34
70,Fail,43,46,0,11,32
70,Fail,48,37,0,11,37
70,Fail,40,36,3,21,19
70,Fail,46,35,0,14,32
70,Fail,50,38,0,9,41
70,Fail,47,37,0,11,36
70,Fail,53,34,1,12,41
70,Fail,55,30,0,10,45
70,Fail,53,28,0,13,40
70,Fail,52,26,9,13,39
70,Fail,49,38,4,9,40
70,Fail,51,38,0,10,41
70,Fail,50,34,0,9,41
70,Fail,60,32,0,6,54
70,Fail,48,33,0,12,36
70,Fail,49,34,0,15,34
70,Fail,54,37,0,9,45
70,Fail,51,30,0,7,44
70,Fail,46,33,0,13,33
70,Fail,47,42,0,9,38
70,Fail,45,40,0,14,31
70,Fail,58,23,0,15,43
70,Fail,53,29,5,13,40
70,Fail,49,39,4,8,41
70,Fail,50,35,4,11,39
70,Fail,49,31,0,17,32
70,Fail,45,38,0,16,29
70,Fail,53,37,0,7,46
70,Fail,45,44,0,11,34
70,Fail,56,31,0,13,43
70,Fail,46,35,0,9,37
70,Fail,41,48,0,10,31
70,Fail,49,30,9,12,37
70,Fail,55,32,3,10,45
70,Fail,40,37,6,17,23
70,Fail,57,35,0,8,49
70,Fail,43,36,0,15,28
70,Fail,51,40,2,7,44
70,Fail,50,30,6,14,36
70,Fail,47,31,0,13,34
70,Fail,45,38,2,15,30
70,Fail,47,35,5,13,34
70,Fail,53,33,4,10,43
70,Fail,60,30,0,10,50
70,Fail,48,37,4,11,37
70,Fail,53,33,0,9,44
70,Fail,46,39,0,11,35
70,Fail,40,43,0,10,30
70,Fail,44,39,2,15,29
70,Fail,52,30,0,17,35
70,Fail,48,40,0,11,37
70,Fail,46,40,0,12,34
70,Fail,53,40,0,7,46
70,Fail,41,30,0,22,19
70,Fail,49,28,9,14,35
70,Fail,42,39,2,17,25
70,Fail,55,28,0,10,45
70,Fail,50,42,0,8,42
70,Fail,48,32,5,15,33
70,Fail,48,37,0,15,33
70,Fail,50,34,0,10,40
70,Fail,48,31,3,18,30
70,Fail,42,38,7,13,29
70,Fail,49,42,0,9,40
70,Fail,47,34,0,18,29
70,Fail,55,31,0,9,46
70,Fail,53,31,0,16,37
70,Fail,50,29,1,20,30
70,Fail,51,36,0,13,38
70,Fail,37,44,2,17,20
70,Fail,50,34,1,15,35
70,Fail,55,37,0,8,47
70,Fail,49,33,0,14,35
70,Fail,52,34,0,12,40
70,Fail,47,38,0,15,32
70,Fail,49,36,3,12,37
70,Fail,46,37,2,15,31
70,Fail,39,46,0,13,26
70,Fail,46,41,0,8,38
70,Fail,42,34,12,12,30
70,Fail,44,40,0,14,30
70,Fail,53,30,0,10,43
70,Fail,48,40,0,12,36
70,Fail,41,34,0,13,28
70,Fail,53,27,0,11,42
70,Fail,46,31,4,19,27
70,Fail,49,37,0,14,35
70,Fail,40,33,0,14,26
70,Fail,54,29,7,10,44
70,Fail,47,34,6,13,34
70,Fail,51,34,0,6,45
70,Fail,46,37,3,14,32
70,Fail,49,32,0,18,31
70,Fail,47,37,4,12,35
70,Fail,49,28,0,7,42
70,Fail,45,35,5,15,30
70,Fail,48,38,0,14,34
70,Fail,54,35,2,9,45
70,Fail,52,29,0,16,36
70,Fail,46,32,10,12,34
70,Fail,52,26,0,17,35
70,Fail,41,36,9,14,27
70,Fail,49,36,0,15,34
70,Fail,49,36,7,8,41
70,Fail,46,38,2,14,32
70,Fail,55,35,0,8,47
70,Fail,45,33,4,18,27
70,Fail,40,38,3,19,21
70,Fail,47,32,8,13,34
70,Fail,51,36,3,10,41
70,Fail,50,34,5,11,39
70,Fail,45,39,5,11,34
70,Fail,54,37,1,8,46
70,Fail,55,32,0,11,44
70,Fail,49,37,0,13,36
70,Fail,57,34,5,4,53
70,Fail,48,36,6,10,38
70,Fail,44,40,0,14,30
70,Fail,48,39,0,9,39
70,Fail,50,42,0,8,42
70,Fail,45,40,0,6,39
70,Fail,45,30,7,18,27
70,Fail,47,39,1,13,34
70,Fail,55,31,0,11,44
70,Fail,54,33,0,7,47
70,Fail,43,33,0,14,29
70,Fail,44,39,5,12,32
70,Fail,42,39,0,18,24
70,Fail,47,32,10,11,36
70,Fail,49,37,0,9,40
70,Fail,44,36,2,18,26
70,Fail,50,38,2,10,40
70,Fail,44,40,7,9,35
70,Fail,42,39,1,18,24
70,Fail,52,36,0,11,41
70,Fail,54,37,1,8,46
70,Fail,42,24,18,16,26
70,Fail,47,39,0,10,37
70,Fail,50,30,7,13,37
70,Fail,50,35,8,7,43
70,Fail,41,34,9,16,25
70,Fail,48,38,0,11,37
70,Fail,46,37,5,12,34
70,Fail,46,36,0,17,29
70,Fail,53,34,0,10,43
70,Fail,50,33,0,17,33
70,Fail,50,34,2,14,36
70,Fail,48,34,0,6,42
70,Fail,46,36,5,13,33
70,Fail,45,32,7,16,29
70,Fail,47,40,4,9,38
70,Fail,46,37,3,14,32
70,Fail,52,34,3,11,41
70,Fail,49,31,0,12,37
70,Fail,49,37,1,13,36
70,Fail,50,33,9,8,42
70,Fail,42,38,9,11,31
70,Fail,46,34,7,13,33
70,Fail,46,31,0,18,28
70,Fail,53,29,6,12,41
70,Fail,43,36,7,14,29
70,Fail,49,30,8,13,36
70,Fail,46,40,4,10,36
70,Fail,42,39,0,17,25
70,Fail,55,31,7,7,48
70,Fail,46,31,11,12,34
70,Fail,50,29,8,13,37
70,Fail,53,30,2,15,38
70,Fail,45,39,3,13,32
70,Fail,45,32,0,8,37
70,Fail,50,28,1,21,29
70,Fail,55,34,4,7,48
70,Fail,51,32,3,14,37
70,Fail,48,38,3,11,37
70,Fail,47,39,0,12,35
70,Fail,52,38,3,7,45
70,Fail,52,27,10,11,41
70,Fail,48,38,5,9,39
70,Fail,41,39,0,16,25
70,Fail,40,40,5,15,25
70,Fail,48,36,0,14,34
70,Fail,48,35,0,15,33
70,Fail,39,39,7,15,24
70,Fail,44,38,0,15,29
70,Fail,51,34,1,14,37
70,Fail,42,42,1,15,27
70,Fail,50,36,5,9,41
70,Fail,47,33,8,12,35
70,Fail,42,38,0,12,30
70,Fail,60,27,0,12,48
70,Fail,51,38,0,11,40
70,Fail,45,39,0,16,29
70,Fail,46,35,9,10,36
70,Fail,54,34,1,11,43
70,Fail,48,32,0,20,28
70,Fail,45,38,0,16,29
70,Fail,51,37,2,10,41
70,Fail,44,37,0,14,30
70,Fail,47,36,2,15,32
70,Fail,50,33,1,16,34
70,Fail,49,32,5,14,35
70,Fail,54,37,2,7,47
70,Fail,52,37,0,10,42
70,Fail,45,44,0,11,34
70,Fail,45,36,0,14,31
70,Fail,62,22,7,9,53
70,Fail,50,26,0,17,33
70,Fail,49,36,0,9,40
70,Fail,53,37,0,10,43
70,Fail,42,35,5,18,24
70,Fail,54,35,0,8,46
70,Fail,49,42,0,7,42
70,Fail,47,36,5,12,35
70,Fail,47,39,0,11,36
70,Fail,47,30,10,13,34
70,Fail,56,32,0,10,46
70,Fail,53,34,3,10,43
70,Fail,51,35,0,13,38
70,Fail,44,43,5,8,36
70,Fail,44,32,8,16,28
70,Fail,49,36,0,11,38
70,Fail,47,42,3,8,39
70,Fail,40,36,9,15,25
70,Fail,46,36,6,12,34
70,Fail,41,38,1,20,21
70,Fail,46,36,0,17,29
70,Fail,42,38,0,15,27
70,Fail,51,32,4,13,38
70,Fail,48,27,0,18,30
70,Fail,54,36,3,7,47
70,Fail,52,39,2,7,45
70,Fail,47,37,0,9,38
70,Fail,52,38,0,10,42
70,Fail,44,41,1,14,30
70,Fail,48,40,0,10,38
70,Fail,52,34,0,14,38
70,Fail,53,37,2,8,45
70,Fail,48,32,0,16,32
70,Fail,40,44,3,13,27
70,Fail,50,36,0,11,39
70,Fail,48,37,0,12,36
70,Fail,48,36,5,11,37
70,Fail,50,32,6,12,38
70,Fail,45,31,0,15,30
70,Fail,54,36,2,8,46
70,Fail,45,40,5,10,35
70,Fail,48,41,0,11,37
70,Fail,51,35,1,13,38
70,Fail,42,38,0,13,29
70,Fail,50,41,2,7,43
70,Fail,59,32,0,9,50
70,Fail,47,35,7,11,36
70,Fail,41,37,0,16,25
70,Fail,43,39,1,17,26
70,Fail,43,41,3,13,30
70,Fail,48,37,0,11,37
70,Fail,42,34,9,15,27
70,Fail,47,35,1,17,30
70,Fail,51,39,0,10,41
70,Fail,43,42,0,13,30
70,Fail,51,31,6,12,39
70,Fail,48,35,0,13,35
70,Fail,48,38,0,11,37
70,Fail,55,31,0,11,44
70,Fail,42,38,0,17,25
70,Fail,54,35,0,10,44
70,Fail,49,33,0,13,36
70,Fail,46,42,1,11,35
70,Fail,46,35,0,14,32
70,Fail,42,38,0,15,27
70,Fail,44,38,0,10,34
70,Fail,46,39,4,11,35
70,Fail,50,29,7,14,36
70,Fail,46,33,2,19,27
70,Fail,49,42,1,8,41
70,Fail,39,43,0,13,26
70,Fail,49,33,0,15,34
70,Fail,57,34,0,9,48
70,Fail,46,33,0,15,31
70,Fail,38,36,0,17,21
70,Fail,55,23,0,17,38
70,Fail,34,40,0,20,14
70,Fail,48,33,0,10,38
70,Fail,48,40,1,11,37
70,Fail,55,36,0,9,46
70,Fail,47,37,3,13,34
70,Fail,43,33,6,18,25
70,Fail,50,35,4,11,39
70,Fail,44,39,0,14,30
70,Fail,44,42,0,14,30
70,Fail,52,24,0,17,35
70,Fail,49,31,0,16,33
70,Fail,56,35,0,9,47
70,Fail,47,38,0,9,38
70,Fail,59,28,0,10,49
70,Fail,44,40,0,12,32
70,Fail,52,33,0,9,43
70,Fail,44,38,0,5,39
70,Fail,50,38,0,12,38
70,Fail,49,32,0,14,35
70,Fail,47,33,0,17,30
70,Fail,49,39,1,11,38
70,Fail,56,29,2,13,43
70,Fail,50,36,7,7,43
70,Fail,55,33,0,12,43
70,Fail,38,37,0,14,24
70,Fail,51,34,0,12,39
70,Fail,48,31,0,16,32
70,Fail,48,30,2,20,28
70,Fail,43,34,0,16,27
70,Fail,49,37,0,10,39
70,Fail,48,39,5,8,40
70,Fail,45,35,3,17,28
70,Fail,51,38,0,11,40
70,Fail,41,36,5,18,23
70,Fail,53,33,0,11,42
70,Fail,52,32,1,15,37
70,Fail,48,41,0,11,37
70,Fail,54,35,0,7,47
70,Fail,50,37,4,9,41
70,Fail,52,33,7,8,44
70,Fail,46,39,1,14,32
70,Fail,43,35,10,12,31
70,Fail,45,41,1,13,32
70,Fail,47,38,2,13,34
70,Fail,46,42,4,8,38
70,Fail,46,33,0,15,31
70,Fail,53,31,0,14,39
70,Fail,58,25,0,14,44
70,Fail,49,36,0,8,41
70,Fail,56,37,2,5,51
70,Fail,54,36,0,8,46
70,Fail,49,35,0,14,35
70,Fail,44,40,0,14,30
70,Fail,54,32,0,14,40
70,Fail,50,35,5,10,40
70,Fail,44,38,1,17,27
70,Fail,52,32,5,11,41
70,Fail,48,43,1,8,40
70,Fail,45,38,0,13,32
70,Fail,47,37,1,15,32
70,Fail,45,37,3,15,30
70,Fail,50,32,0,13,37
70,Fail,41,44,0,11,30
70,Fail,52,37,1,10,42
70,Fail,48,38,3,11,37
70,Fail,44,37,0,16,28
70,Fail,40,47,0,8,32
70,Fail,49,36,0,13,36
70,Fail,53,32,4,11,42
70,Fail,41,44,0,9,32
70,Fail,52,32,0,14,38
70,Fail,50,30,0,9,41
70,Fail,47,38,0,13,34
70,Fail,50,29,0,13,37
70,Fail,53,32,2,13,40
70,Fail,49,37,3,11,38
70,Fail,50,32,0,15,35
70,Fail,59,29,0,9,50
70,Fail,43,38,2,17,26
70,Fail,47,40,0,12,35
70,Fail,47,33,8,12,35
70,Fail,55,29,0,13,42
70,Fail,47,40,1,12,35
70,Fail,50,41,0,6,44
70,Fail,44,41,0,15,29
70,Fail,50,31,0,16,34
70,Fail,53,40,0,7,46
70,Fail,48,38,1,13,35
70,Fail,53,32,0,14,39
70,Fail,55,34,0,11,44
70,Fail,43,39,0,13,30
70,Fail,41,39,0,16,25
70,Fail,49,36,4,11,38
70,Fail,48,34,1,17,31
70,Fail,44,38,8,10,34
70,Fail,47,39,7,7,40
70,Fail,50,43,0,6,44
70,Fail,52,34,0,12,40
70,Fail,55,38,0,7,48
70,Fail,51,32,5,12,39
70,Fail,49,40,0,11,38
70,Fail,46,35,5,14,32
70,Fail,46,32,4,18,28
70,Fail,45,40,0,11,34
70,Fail,45,43,0,10,35
70,Fail,47,42,0,9,38
70,Fail,42,34,0,18,24
70,Fail,44,42,0,11,33
70,Fail,45,34,5,16,29
70,Fail,49,34,0,13,36
70,Fail,50,36,1,13,37
70,Fail,50,34,7,9,41
70,Fail,46,41,0,11,35
70,Fail,38,46,0,15,23
70,Fail,46,27,0,22,24
70,Fail,48,42,0,8,40
70,Fail,46,40,2,12,34
70,Fail,46,33,0,15,31
70,Fail,49,43,0,8,41
70,Fail,46,33,0,14,32
70,Fail,57,30,0,9,48
70,Fail,52,33,0,11,41
70,Fail,49,40,0,10,39
70,Fail,49,35,0,15,34
70,Fail,48,39,0,12,36
70,Fail,40,39,10,11,29
70,Fail,46,38,0,13,33
70,Fail,50,34,3,13,37
70,Fail,42,41,0,12,30
70,Fail,51,28,0,13,38
70,Fail,48,34,0,13,35
70,Fail,46,37,7,10,36
70,Fail,45,40,0,15,30
70,Fail,54,33,0,13,41
70,Fail,43,43,5,9,34
70,Fail,46,38,0,14,32
70,Fail,45,37,0,14,31
70,Fail,38,37,7,18,20
70,Fail,47,36,0,11,36
70,Fail,50,34,0,15,35
70,Fail,52,31,3,14,38
70,Fail,46,41,0,10,36
70,Fail,48,35,5,12,36
70,Fail,48,37,8,7,41
70,Fail,48,31,4,17,31
70,Fail,51,34,0,11,40
70,Fail,46,39,0,11,35
70,Fail,46,41,0,8,38
70,Fail,54,28,0,18,36
70,Fail,53,36,4,7,46
70,Fail,50,32,0,15,35
70,Fail,42,36,5,17,25
70,Fail,52,32,1,15,37
70,Fail,43,29,11,17,26
70,Fail,53,35,0,10,43
70,Fail,52,36,0,12,40
70,Fail,50,34,0,16,34
70,Fail,47,34,0,10,37
70,Fail,42,36,0,11,31
70,Fail,51,41,0,8,43
70,Fail,46,42,4,8,38
70,Fail,50,26,0,15,35
70,Fail,45,32,0,14,31
70,Fail,51,40,0,9,42
70,Fail,50,36,0,8,42
70,Fail,46,39,0,10,36
70,Fail,45,39,6,10,35
70,Fail,56,31,0,6,50
70,Fail,47,37,0,16,31
70,Fail,53,31,5,11,42
70,Fail,50,33,5,12,38
70,Fail,39,42,5,14,25
70,Fail,47,32,0,10,37
70,Fail,46,36,0,13,33
70,Fail,44,38,0,10,34
70,Fail,46,37,0,15,31
70,Fail,53,32,0,13,40
70,Fail,47,38,1,14,33
70,Fail,44,39,0,9,35
70,Fail,44,36,0,13,31
70,Fail,48,30,7,15,33
70,Fail,49,35,2,14,35
70,Fail,53,30,5,12,41
70,Fail,50,33,6,11,39
70,Fail,53,32,0,15,38
70,Fail,54,31,0,11,43
70,Fail,37,33,0,21,16
70,Fail,51,38,0,6,45
70,Fail,52,34,3,11,41
70,Fail,42,29,0,23,19
70,Fail,51,33,2,14,37
70,Fail,55,37,0,8,47
70,Fail,50,33,6,11,39
70,Fail,51,30,0,17,34
70,Fail,42,36,0,17,25
70,Fail,50,38,0,8,42
70,Fail,47,32,0,12,35
70,Fail,52,33,0,15,37
70,Fail,39,39,4,18,21
70,Fail,39,45,0,10,29
70,Fail,44,41,4,11,33
70,Fail,47,37,3,13,34
70,Fail,54,36,0,8,46
70,Fail,47,40,0,11,36
70,Fail,45,32,0,14,31
70,Fail,49,33,2,16,33
70,Fail,50,38,3,9,41
70,Fail,53,31,0,9,44
70,Fail,41,41,0,13,28
70,Fail,54,35,0,7,47
70,Fail,52,31,4,13,39
70,Fail,48,36,0,9,39
70,Fail,49,41,1,9,40
70,Fail,47,27,11,15,32
70,Fail,47,38,4,11,36
70,Fail,37,40,0,9,28
70,Fail,43,37,0,12,31
70,Fail,45,38,1,16,29
70,Fail,49,35,0,9,40
70,Fail,51,26,0,11,40
70,Fail,49,31,9,11,38
70,Fail,45,35,6,14,31
70,Fail,47,31,10,12,35
70,Fail,52,35,0,9,43
70,Fail,51,32,0,13,38
70,Fail,38,39,4,19,19
70,Fail,45,31,7,17,28
70,Fail,43,34,11,12,31
70,Fail,54,35,2,9,45
70,Fail,50,38,2,10,40
70,Fail,57,34,0,9,48
70,Fail,50,35,0,12,38
70,Fail,39,44,2,15,24
70,Fail,47,38,0,14,33
70,Fail,41,42,0,11,30
70,Fail,49,38,0,11,38
70,Fail,48,34,0,14,34
70,Fail,41,42,2,15,26
70,Fail,48,36,2,14,34
70,Fail,37,40,0,15,22
70,Fail,47,35,3,15,32
70,Fail,48,29,0,16,32
70,Fail,51,32,0,17,34
70,Fail,43,34,0,19,24
70,Fail,50,33,0,16,34
70,Fail,45,33,1,21,24
70,Fail,47,34,3,16,31
70,Fail,42,45,0,9,33
70,Fail,48,40,0,11,37
70,Fail,46,36,5,13,33
70,Fail,42,39,0,16,26
70,Fail,48,33,0,12,36
70,Fail,46,37,2,15,31
70,Fail,44,31,8,17,27
70,Fail,48,37,0,13,35
70,Fail,41,42,0,11,30
70,Fail,52,28,5,15,37
70,Fail,50,33,0,15,35
70,Fail,51,24,6,19,32
70,Fail,51,30,0,15,36
70,Fail,53,31,3,13,40
70,Fail,50,30,0,14,36
70,Fail,41,39,0,16,25
70,Fail,41,43,5,11,30
70,Fail,45,30,0,16,29
70,Fail,49,36,0,13,36
70,Fail,45,38,0,12,33
70,Fail,50,37,7,6,44
70,Fail,41,40,0,17,24
70,Fail,44,38,4,14,30
70,Fail,44,39,0,17,27
70,Fail,39,37,9,15,24
70,Fail,50,39,2,9,41
70,Fail,49,33,0,14,35
70,Fail,43,37,2,18,25
70,Fail,53,31,3,13,40
70,Fail,50,40,0,7,43
70,Fail,52,29,5,14,38
70,Fail,47,39,3,11,36
70,Fail,48,36,0,16,32
70,Fail,52,31,0,13,39
70,Fail,45,36,3,16,29
70,Fail,44,36,0,11,33
70,Fail,45,37,0,13,32
70,Fail,49,41,1,9,40
70,Fail,49,32,0,16,33
70,Fail,43,37,2,18,25
70,Fail,42,34,0,16,26
70,Fail,39,37,0,13,26
70,Fail,47,38,0,14,33
70,Fail,47,36,5,12,35
70,Fail,44,43,0,11,33
70,Fail,47,40,0,11,36
70,Fail,54,32,0,13,41
70,Fail,46,33,3,18,28
70,Fail,49,36,0,15,34
70,Fail,52,33,6,9,43
70,Fail,46,42,0,9,37
70,Fail,50,34,4,12,38
70,Fail,49,29,0,19,30
70,Fail,50,38,3,9,41
70,Fail,50,36,3,11,39
70,Fail,52,27,9,12,40
70,Fail,51,39,1,9,42
70,Fail,43,31,0,22,21
70,Fail,46,46,0,5,41
70,Fail,37,42,0,14,23
70,Fail,49,29,3,19,30
70,Fail,49,38,0,12,37
70,Fail,51,27,0,14,37
70,Fail,46,42,2,10,36
70,Fail,48,39,1,12,36
70,Fail,44,29,9,18,26
70,Fail,45,35,0,10,35
70,Fail,44,31,0,17,27
70,Fail,39,38,7,16,23
70,Fail,45,36,4,15,30
70,Fail,46,37,0,17,29
70,Fail,48,32,0,16,32
70,Fail,47,37,5,11,36
70,Fail,52,37,0,9,43
70,Fail,46,35,7,12,34
70,Fail,50,35,0,13,37
70,Fail,46,36,1,17,29
70,Fail,49,38,0,13,36
70,Fail,46,39,5,10,36
70,Fail,52,31,0,11,41
70,Fail,50,39,3,8,42
70,Fail,50,35,0,10,40
70,Fail,54,29,1,16,38
70,Fail,44,42,0,14,30
70,Fail,54,37,0,6,48
70,Fail,43,26,0,22,21
70,Fail,50,37,0,9,41
70,Fail,45,35,0,15,30
70,Fail,60,28,6,6,54
70,Fail,42,36,2,20,22
70,Fail,51,33,0,15,36
70,Fail,49,41,0,10,39
70,Fail,52,28,0,16,36
70,Fail,50,29,0,10,40
70,Fail,50,28,0,17,33
70,Fail,48,31,0,14,34
70,Fail,50,39,3,8,42
70,Fail,43,34,8,15,28
70,Fail,53,41,0,5,48
70,Fail,41,33,0,14,27
70,Fail,43,43,4,10,33
70,Fail,43,37,0,18,25
70,Fail,48,36,0,13,35
70,Fail,54,27,0,16,38
70,Fail,48,41,2,9,39
70,Fail,49,30,0,14,35
70,Fail,42,37,0,14,28
70,Fail,41,40,0,9,32
70,Fail,49,32,5,14,35
70,Fail,47,37,0,15,32
70,Fail,58,27,0,9,49
70,Fail,46,33,0,9,37
70,Fail,39,44,0,14,25
70,Fail,46,35,7,12,34
70,Fail,48,38,2,12,36
70,Fail,60,24,1,15,45
70,Fail,48,31,0,16,32
70,Fail,46,35,9,10,36
70,Fail,51,36,0,11,40
70,Fail,44,35,5,16,28
70,Fail,44,40,0,14,30
70,Fail,49,39,2,10,39
70,Fail,49,35,4,12,37
70,Fail,51,38,0,11,40
70,Fail,51,29,3,17,34
70,Fail,53,36,4,7,46
70,Fail,45,44,0,9,36
70,Fail,47,40,3,10,37
70,Fail,56,27,10,7,49
70,Fail,42,43,2,13,29
70,Fail,47,41,0,12,35
70,Fail,47,37,0,12,35
70,Fail,44,45,0,10,34
70,Fail,49,37,2,12,37
70,Fail,49,38,2,11,38
70,Fail,39,34,5,22,17
70,Fail,41,44,1,14,27
70,Fail,46,40,0,11,35
70,Fail,42,34,0,12,30
70,Fail,54,29,7,10,44
70,Fail,45,39,2,14,31
70,Fail,48,33,0,14,34
70,Fail,44,37,6,13,31
70,Fail,45,36,0,10,35
70,Fail,49,37,0,13,36
70,Fail,48,39,2,11,37
70,Fail,46,32,0,13,33
70,Fail,50,33,1,16,34
70,Fail,40,40,0,13,27
70,Fail,49,45,1,5,44
70,Fail,51,43,0,6,45
70,Fail,40,39,6,15,25
70,Fail,48,35,0,13,35
70,Fail,46,42,5,7,39
70,Fail,43,45,0,12,31
70,Fail,50,38,0,11,39
70,Fail,46,37,4,13,33
70,Fail,48,38,0,13,35
70,Fail,48,38,4,10,38
70,Fail,41,39,0,14,27
70,Fail,49,31,5,15,34
70,Fail,48,31,0,11,37
70,Fail,48,31,9,12,36
70,Fail,40,34,11,15,25
70,Fail,46,31,0,10,36
70,Fail,50,34,1,15,35
70,Fail,53,36,1,10,43
70,Fail,49,38,0,13,36
70,Fail,46,40,0,11,35
70,Fail,43,39,0,10,33
70,Fail,50,33,7,10,40
70,Fail,52,32,3,13,39
70,Fail,50,35,3,12,38
70,Fail,52,35,1,12,40
70,Fail,53,34,0,11,42
70,Fail,54,30,2,14,40
70,Fail,50,35,0,14,36
70,Fail,54,38,2,6,48
70,Fail,51,33,6,10,41
70,Fail,52,35,1,12,40
70,Fail,49,35,0,10,39
70,Fail,43,41,0,16,27
70,Fail,51,31,0,14,37
70,Fail,41,43,0,12,29
70,Fail,48,39,0,7,41
70,Fail,49,32,2,17,32
70,Fail,42,38,0,14,28
70,Fail,47,33,0,16,31
70,Fail,42,44,0,9,33
70,Fail,47,39,0,12,35
70,Fail,45,36,0,16,29
70,Fail,55,34,2,9,46
70,Fail,56,34,0,5,51
70,Fail,48,38,1,13,35
70,Fail,53,31,0,9,44
70,Fail,49,36,5,10,39
70,Fail,55,29,0,15,40
70,Fail,43,35,10,12,31
70,Fail,41,41,0,9,32
70,Fail,49,42,0,8,41
70,Fail,40,37,7,16,24
70,Fail,45,38,6,11,34
70,Fail,49,37,3,11,38
70,Fail,53,38,0,9,44
70,Fail,48,39,0,13,35
70,Fail,56,31,0,13,43
70,Fail,37,35,0,20,17
70,Fail,45,35,1,19,26
70,Fail,41,41,8,10,31
70,Fail,49,30,3,18,31
70,Fail,47,36,0,15,32
70,Fail,49,35,4,12,37
70,Fail,53,30,0,17,36
70,Fail,46,33,0,14,32
70,Fail,47,26,0,15,32
70,Fail,56,25,0,14,42
70,Fail,49,36,5,10,39
70,Fail,55,28,0,14,41
70,Fail,32,39,11,18,14
70,Fail,45,32,0,14,31
70,Fail,47,39,0,10,37
70,Fail,39,30,13,18,21
70,Fail,47,34,0,16,31
70,Fail,35,43,0,15,20
70,Fail,56,31,0,10,46
70,Fail,52,34,0,13,39
70,Fail,49,36,0,11,38
70,Fail,53,36,0,10,43
70,Fail,53,28,2,17,36
70,Fail,41,34,4,21,20
70,Fail,52,31,0,12,40
70,Fail,42,41,0,17,25
70,Fail,48,40,1,11,37
70,Fail,50,36,3,11,39
70,Fail,46,26,13,15,31
70,Fail,53,32,1,14,39
70,Fail,49,35,0,8,41
70,Fail,46,39,0,10,36
70,Fail,50,31,9,10,40
70,Fail,47,35,1,17,30
70,Fail,55,30,0,11,44
70,Fail,53,30,5,12,41
70,Fail,47,33,0,11,36
70,Fail,52,36,0,5,47
70,Fail,49,43,2,6,43
70,Fail,47,33,0,14,33
70,Fail,48,38,0,14,34
70,Fail,46,48,0,5,41
70,Fail,48,41,2,9,39
70,Fail,46,24,0,23,23
70,Fail,53,32,4,11,42
70,Fail,56,38,0,6,50
70,Fail,52,32,1,15,37
70,Fail,51,36,0,11,40
70,Fail,45,40,5,10,35
70,Fail,53,33,0,11,42
70,Fail,57,28,0,11,46
70,Fail,41,37,0,17,24
70,Fail,45,41,3,11,34
70,Fail,48,38,2,12,36
70,Fail,51,33,0,10,41
70,Fail,50,38,0,11,39
70,Fail,46,37,0,9,37
70,Fail,53,36,1,10,43
70,Fail,47,33,9,11,36
70,Fail,44,44,0,10,34
70,Fail,49,36,0,12,37
70,Fail,47,37,0,15,32
70,Fail,48,36,6,10,38
70,Fail,50,30,3,17,33
70,Fail,58,34,1,7,51
70,Fail,38,33,10,19,19
70,Fail,45,36,0,11,34
70,Fail,52,35,3,10,42
70,Fail,49,29,6,16,33
70,Fail,49,35,5,11,38
70,Fail,49,30,8,13,36
70,Fail,49,38,0,12,37
70,Fail,50,35,2,13,37
70,Fail,49,39,0,10,39
70,Fail,51,27,0,11,40
70,Fail,48,41,0,8,40
70,Fail,48,41,1,10,38
70,Fail,41,36,0,20,21
70,Fail,45,37,0,18,27
70,Fail,53,37,0,10,43
70,Fail,43,40,0,16,27
70,Fail,47,35,1,17,30
70,Fail,49,36,0,14,35
70,Fail,47,36,3,14,33
70,Fail,51,34,0,12,39
70,Fail,52,42,2,4,48
70,Fail,42,46,2,10,32
70,Fail,46,38,3,13,33
70,Fail,44,38,0,16,28
70,Fail,37,32,0,17,20
70,Fail,47,38,0,13,34
70,Fail,39,40,0,17,22
70,Fail,43,36,0,12,31
70,Fail,48,40,0,10,38
70,Fail,45,32,7,16,29
70,Fail,48,35,0,10,38
70,Fail,56,35,0,9,47
70,Fail,48,41,0,9,39
70,Fail,49,33,0,13,36
70,Fail,43,29,0,20,23
70,Fail,46,38,4,12,34
70,Fail,53,31,0,12,41
70,Fail,53,39,0,4,49
70,Fail,52,32,5,11,41
70,Fail,54,35,0,7,47
70,Fail,59,29,0,10,49
70,Fail,42,35,0,10,32
70,Fail,45,42,0,9,36
70,Fail,48,35,3,14,34
70,Fail,46,40,4,10,36
70,Fail,49,33,2,16,33
70,Fail,49,38,0,7,42
70,Fail,47,28,11,14,33
70,Fail,46,36,0,16,30
70,Fail,49,42,0,8,41
70,Fail,51,35,0,12,39
70,Fail,50,37,1,12,38
70,Fail,55,28,4,13,42
70,Fail,48,34,0,13,35
70,Fail,45,47,0,8,37
70,Fail,42,41,0,8,34
70,Fail,47,35,9,9,38
70,Fail,45,41,4,10,35
70,Fail,53,37,2,8,45
70,Fail,46,39,5,10,36
70,Fail,52,34,2,12,40
70,Fail,44,40,0,11,33
70,Fail,52,37,0,11,41
70,Fail,52,34,5,9,43
70,Fail,46,37,3,14,32
70,Fail,51,27,6,16,35
70,Fail,46,35,0,10,36
70,Fail,62,22,0,13,49
70,Fail,45,40,0,15,30
70,Fail,44,38,3,15,29
70,Fail,46,39,0,11,35
70,Fail,50,34,7,9,41
70,Fail,45,39,0,15,30
70,Fail,51,35,5,9,42
70,Fail,51,40,0,9,42
70,Fail,49,38,0,13,36
70,Fail,44,43,0,13,31
70,Fail,47,36,0,11,36
70,Fail,50,34,0,9,41
70,Fail,55,30,0,10,45
70,Fail,50,36,2,12,38
70,Fail,52,39,1,8,44
70,Fail,51,38,0,9,42
70,Fail,43,44,1,12,31
70,Fail,49,36,0,11,38
70,Fail,49,34,4,13,36
70,Fail,48,36,0,16,32
70,Fail,58,29,0,12,46
70,Fail,49,35,1,15,34
70,Fail,48,32,0,16,32
70,Fail,55,30,6,9,46
70,Fail,46,38,0,13,33
70,Fail,49,31,4,16,33
70,Fail,45,40,0,15,30
70,Fail,47,39,0,11,36
70,Fail,52,29,0,16,36
70,Fail,56,32,3,9,47
70,Fail,43,30,0,16,27
70,Fail,57,30,2,11,46
70,Fail,48,35,7,10,38
70,Fail,48,37,5,10,38
70,Fail,48,31,0,16,32
70,Fail,55,31,0,10,45
70,Fail,41,33,8,18,23
70,Fail,44,35,7,14,30
70,Fail,53,38,0,8,45
70,Fail,44,39,0,13,31
70,Fail,51,24,8,17,34
70,Fail,50,30,7,13,37
70,Fail,51,39,0,9,42
70,Fail,46,30,0,15,31
70,Fail,50,28,5,17,33
70,Fail,46,39,0,9,37
70,Fail,55,37,0,8,47
70,Fail,49,35,0,12,37
70,Fail,60,30,1,9,51
70,Fail,47,41,3,9,38
70,Fail,49,34,0,10,39
70,Fail,49,33,0,12,37
70,Fail,47,36,5,12,35
70,Fail,48,35,0,10,38
70,Fail,40,38,0,16,24
70,Fail,47,36,0,16,31
70,Fail,44,35,0,17,27
70,Fail,44,44,0,11,33
70,Fail,51,37,0,10,41
70,Fail,42,39,3,16,26
70,Fail,55,34,3,8,47
70,Fail,50,38,0,11,39
70,Fail,45,36,0,17,28
70,Fail,45,38,0,15,30
70,Fail,44,42,0,13,31
70,Fail,48,28,12,12,36
70,Fail,42,37,11,10,32
70,Fail,50,29,5,16,34
70,Fail,46,40,1,13,33
70,Fail,53,32,0,10,43
70,Fail,47,36,0,17,30
70,Fail,50,35,0,12,38
70,Fail,37,40,4,19,18
70,Fail,43,42,3,12,31
70,Fail,51,31,5,13,38
70,Fail,41,45,0,13,28
70,Fail,43,39,8,10,33
70,Fail,47,39,1,13,34
70,Fail,48,36,0,11,37
70,Fail,41,37,0,15,26
70,Fail,54,31,0,13,41
70,Fail,44,40,2,14,30
70,Fail,51,37,2,10,41
70,Fail,47,40,0,12,35
70,Fail,42,32,5,21,21
70,Fail,51,34,8,7,44
70,Fail,46,35,0,14,32
70,Fail,42,41,0,12,30
70,Fail,40,46,0,13,27
70,Fail,47,46,0,7,40
70,Fail,45,37,4,14,31
70,Fail,54,30,0,9,45
70,Fail,54,28,0,9,45
70,Fail,55,32,0,12,43
70,Fail,42,41,0,16,26
70,Fail,53,29,0,11,42
70,Fail,46,34,0,10,36
70,Fail,48,39,2,11,37
70,Fail,38,33,0,21,17
70,Fail,48,35,0,11,37
70,Fail,50,32,0,15,35
70,Fail,42,33,0,19,23
70,Fail,47,38,4,11,36
70,Fail,47,38,0,14,33
70,Fail,47,35,0,14,33
70,Fail,49,36,6,9,40
70,Fail,45,44,0,9,36
70,Fail,45,36,1,18,27
70,Fail,48,34,0,7,41
70,Fail,42,46,0,10,32
70,Fail,45,40,0,12,33
70,Fail,48,31,0,13,35
70,Fail,46,35,4,15,31
70,Fail,47,29,9,15,32
70,Fail,50,27,0,17,33
70,Fail,48,36,0,9,39
70,Fail,55,32,5,8,47
70,Fail,48,38,4,10,38
70,Fail,45,31,0,11,34
70,Fail,45,32,0,20,25
70,Fail,53,34,5,8,45
70,Fail,38,31,6,25,13
70,Fail,51,32,0,15,36
70,Fail,52,35,2,11,41
70,Fail,52,36,4,8,44
70,Fail,45,41,0,6,39
70,Fail,49,36,0,10,39
70,Fail,44,42,2,12,32
70,Fail,45,33,0,18,27
70,Fail,47,29,10,14,33
70,Fail,49,32,7,12,37
70,Fail,53,36,1,10,43
70,Fail,51,38,4,7,44
70,Fail,45,32,6,17,28
70,Fail,40,46,1,13,27
70,Fail,52,38,0,10,42
70,Fail,49,36,6,9,40
70,Fail,49,43,1,7,42
70,Fail,41,47,0,9,32
70,Fail,56,30,0,14,42
70,Fail,51,29,0,19,32
70,Fail,46,38,0,14,32
70,Fail,50,28,7,15,35
70,Fail,43,44,0,13,30
70,Fail,40,42,0,14,26
70,Fail,49,44,0,6,43
70,Fail,46,38,1,15,31
70,Fail,43,39,6,12,31
70,Fail,50,39,0,11,39
70,Fail,53,30,3,14,39
70,Fail,46,40,0,11,35
70,Fail,47,29,0,13,34
70,Fail,53,35,0,11,42
70,Fail,38,36,0,17,21
70,Fail,58,32,0,9,49
70,Fail,49,33,5,13,36
70,Fail,56,31,1,12,44
70,Fail,53,29,7,11,42
70,Fail,55,28,1,16,39
70,Fail,48,38,1,13,35
70,Fail,44,41,6,9,35
70,Fail,46,39,0,14,32
70,Fail,54,36,0,7,47
70,Fail,47,38,1,14,33
70,Fail,50,36,0,9,41
70,Fail,45,44,3,8,37
70,Fail,43,38,10,9,34
70,Fail,50,34,0,16,34
70,Fail,49,38,0,13,36
70,Fail,42,36,0,14,28
70,Fail,39,43,1,17,22
70,Fail,51,38,0,10,41
70,Fail,42,35,0,15,27
70,Fail,44,26,14,16,28
70,Fail,46,32,0,13,33
70,Fail,48,31,9,12,36
70,Fail,47,32,0,16,31
70,Fail,47,41,0,11,36
70,Fail,43,33,0,14,29
70,Fail,48,34,0,16,32
70,Fail,52,28,0,20,32
70,Fail,52,28,7,13,39
70,Fail,42,31,0,22,20
70,Fail,46,43,0,11,35
70,Fail,40,42,0,8,32
70,Fail,53,36,1,10,43
70,Fail,44,38,0,10,34
70,Fail,49,37,0,12,37
70,Fail,37,44,3,16,21
70,Fail,49,40,0,10,39
70,Fail,46,32,0,18,28
70,Fail,45,30,0,16,29
70,Fail,46,38,6,10,36
70,Fail,51,37,0,9,42
70,Fail,52,32,0,8,44
70,Fail,43,41,6,10,33
70,Fail,41,41,0,13,28
70,Fail,46,33,7,14,32
70,Fail,45,42,1,12,33
70,Fail,47,40,0,10,37
70,Fail,48,35,1,16,32
70,Fail,49,31,6,14,35
70,Fail,38,35,8,19,19
70,Fail,53,31,0,13,40
70,Fail,51,29,0,17,34
70,Fail,47,35,0,15,32
70,Fail,53,33,0,14,39
70,Fail,41,37,8,14,27
70,Fail,49,32,3,16,33
70,Fail,40,46,0,13,27
70,Fail,45,40,3,12,33
70,Fail,57,30,1,12,45
70,Fail,51,39,1,9,42
70,Fail,48,40,0,7,41
70,Fail,52,30,0,14,38
70,Fail,48,27,0,16,32
70,Fail,51,35,0,14,37
70,Fail,52,32,2,14,38
70,Fail,49,36,0,13,36
70,Fail,52,33,3,12,40
70,Fail,53,37,0,10,43
70,Fail,49,36,4,11,38
70,Fail,45,39,0,11,34
70,Fail,42,49,0,8,34
70,Fail,52,31,6,11,41
70,Fail,48,36,1,15,33
70,Fail,45,38,6,11,34
70,Fail,53,31,7,9,44
70,Fail,51,33,2,14,37
70,Fail,48,31,10,11,37
70,Fail,46,38,4,12,34
70,Fail,48,29,7,16,32
70,Fail,51,37,0,12,39
70,Fail,50,34,0,14,36
70,Fail,51,32,0,11,40
70,Fail,46,46,0,7,39
70,Fail,56,33,1,10,46
70,Fail,42,41,4,13,29
70,Fail,56,32,0,10,46
70,Fail,59,27,1,13,46
70,Fail,43,40,2,15,28
70,Fail,48,30,12,10,38
70,Fail,50,35,3,12,38
70,Fail,47,39,6,8,39
70,Fail,48,39,0,13,35
70,Fail,53,29,0,17,36
70,Fail,46,33,0,19,27
70,Fail,39,41,0,14,25
70,Fail,43,34,7,16,27
70,Fail,41,43,0,11,30
70,Fail,45,31,0,16,29
70,Fail,40,39,0,13,27
70,Fail,59,22,5,14,45
70,Fail,45,35,0,13,32
70,Fail,48,34,0,11,37
70,Fail,42,42,4,12,30
70,Fail,58,30,0,10,48
70,Fail,53,35,6,6,47
70,Fail,52,33,7,8,44
70,Fail,42,37,0,15,27
70,Fail,50,32,0,13,37
70,Fail,46,40,1,13,33
70,Fail,54,32,0,10,44
70,Fail,56,36,0,8,48
70,Fail,44,35,0,17,27
70,Fail,48,32,6,14,34
70,Fail,48,43,0,6,42
70,Fail,49,40,0,10,39
70,Fail,49,32,0,19,30
70,Fail,51,37,0,8,43
70,Fail,49,40,0,9,40
70,Fail,44,36,5,15,29
70,Fail,46,39,7,8,38
70,Fail,48,36,0,14,34
70,Fail,41,36,0,19,22
70,Fail,51,37,4,8,43
70,Fail,57,31,0,12,45
70,Fail,49,40,0,9,40
70,Fail,46,25,0,18,28
70,Fail,44,39,5,12,32
70,Fail,48,40,0,10,38
70,Fail,54,34,2,10,44
70,Fail,55,30,0,14,41
70,Fail,39,42,0,9,30
70,Fail,50,33,4,13,37
70,Fail,49,40,1,10,39
70,Fail,42,37,0,15,27
70,Fail,50,36,4,10,40
70,Fail,53,32,0,7,46
70,Fail,44,27,10,19,25
70,Fail,46,39,5,10,36
70,Fail,46,43,0,10,36
70,Fail,55,25,2,18,37
70,Fail,50,38,0,10,40
70,Fail,55,35,0,8,47
70,Fail,52,35,3,10,42
70,Fail,42,42,0,12,30
70,Fail,36,31,0,20,16
70,Fail,50,37,0,11,39
70,Fail,45,36,0,18,27
70,Fail,51,35,7,7,44
70,Fail,47,37,3,13,34
70,Fail,45,39,0,16,29
70,Fail,47,43,0,8,39
70,Fail,39,46,2,13,26
70,Fail,47,38,0,15,32
70,Fail,42,39,0,14,28
70,Fail,42,47,0,11,31
70,Fail,50,37,0,9,41
70,Fail,51,36,3,10,41
70,Fail,39,29,14,18,21
70,Fail,46,34,0,13,33
70,Fail,51,32,0,14,37
70,Fail,50,40,0,10,40
70,Fail,48,41,4,7,41
70,Fail,43,36,6,15,28
70,Fail,49,28,7,16,33
70,Fail,44,36,3,17,27
70,Fail,50,35,0,9,41
70,Fail,51,33,1,15,36
70,Fail,45,35,1,19,26
70,Fail,43,38,3,16,27
70,Fail,56,35,0,7,49
70,Fail,47,35,5,13,34
70,Fail,52,29,0,17,35
70,Fail,40,39,3,18,22
70,Fail,46,38,0,15,31
70,Fail,47,32,0,14,33
70,Fail,55,28,3,14,41
70,Fail,47,32,4,17,30
70,Fail,46,38,0,9,37
70,Fail,50,39,0,11,39
70,Fail,52,34,5,9,43
70,Fail,48,36,5,11,37
70,Fail,44,42,0,10,34
70,Fail,50,36,3,11,39
70,Fail,46,36,0,10,36
70,Fail,54,38,0,8,46
70,Fail,45,40,2,13,32
70,Fail,53,35,3,9,44
70,Fail,55,29,0,13,42
70,Fail,42,37,9,12,30
70,Fail,51,32,0,11,40
70,Fail,48,33,3,16,32
70,Fail,43,32,0,15,28
70,Fail,59,36,0,5,54
70,Fail,45,36,1,18,27
70,Fail,48,30,7,15,33
70,Fail,52,37,0,11,41
70,Fail,49,34,0,15,34
70,Fail,45,32,0,17,28
70,Fail,45,39,0,8,37
70,Fail,53,28,0,14,39
70,Fail,44,38,0,13,31
70,Fail,55,29,0,14,41
70,Fail,52,37,1,10,42
70,Fail,49,30,4,17,32
70,Fail,48,33,0,16,32
70,Fail,44,37,6,13,31
70,Fail,47,39,3,11,36
70,Fail,54,36,2,8,46
70,Fail,43,43,0,12,31
70,Fail,51,38,0,10,41
70,Fail,43,41,4,12,31
70,Fail,45,39,0,12,33
70,Fail,54,32,2,12,42
70,Fail,41,39,3,17,24
70,Fail,53,37,0,8,45
70,Fail,48,35,0,15,33
70,Fail,42,38,5,15,27
70,Fail,51,38,0,8,43
70,Fail,43,38,9,10,33
70,Fail,50,35,0,13,37
70,Fail,43,42,0,10,33
70,Fail,43,39,4,14,29
70,Fail,45,42,0,12,33
70,Fail,49,33,0,13,36
70,Fail,46,39,0,12,34
70,Fail,50,38,3,9,41
70,Fail,45,35,0,14,31
70,Fail,51,38,0,10,41
70,Fail,47,44,2,7,40
70,Fail,47,34,7,12,35
70,Fail,52,31,0,12,40
70,Fail,53,36,1,10,43
70,Fail,40,38,0,14,26
70,Fail,39,36,0,11,28
70,Fail,55,25,6,14,41
70,Fail,43,39,1,17,26
70,Fail,36,37,8,19,17
70,Fail,46,40,0,12,34
70,Fail,55,34,0,9,46
70,Fail,51,31,0,15,36
70,Fail,49,40,0,11,38
70,Fail,53,33,0,12,41
70,Fail,45,45,0,7,38
70,Fail,52,41,3,4,48
70,Fail,50,35,0,11,39
70,Fail,43,36,2,19,24
70,Fail,50,38,4,8,42
70,Fail,45,34,7,14,31
70,Fail,53,32,1,14,39
70,Fail,54,33,1,12,42
70,Fail,50,31,6,13,37
70,Fail,47,38,1,14,33
70,Fail,42,33,0,14,28
70,Fail,50,41,0,9,41
70,Fail,44,35,10,11,33
70,Fail,52,26,10,12,40
70,Fail,52,36,2,10,42
70,Fail,43,33,0,15,28
70,Fail,43,38,0,17,26
70,Fail,42,43,3,12,30
70,Fail,46,35,7,12,34
70,Fail,49,41,0,10,39
70,Fail,54,33,0,12,42
70,Fail,49,35,0,16,33
70,Fail,42,41,3,14,28
70,Fail,56,31,6,7,49
70,Fail,48,36,3,13,35
70,Fail,44,40,0,12,32
70,Fail,46,38,3,13,33
70,Fail,46,35,0,14,32
70,Fail,51,32,0,11,40
70,Fail,47,38,0,13,34
70,Fail,43,37,0,12,31
70,Fail,46,40,0,13,33
70,Fail,50,39,2,9,41
70,Fail,47,36,0,13,34
70,Fail,45,39,4,12,33
70,Fail,49,27,12,12,37
70,Fail,46,36,0,14,32
70,Fail,41,43,0,13,28
70,Fail,46,30,0,15,31
70,Fail,42,40,3,15,27
70,Fail,48,38,0,12,36
70,Fail,46,37,4,13,33
70,Fail,56,36,0,8,48
70,Fail,59,29,0,10,49
70,Fail,46,40,1,13,33
70,Fail,50,35,2,13,37
70,Fail,49,36,0,10,39
70,Fail,42,41,5,12,30
70,Fail,49,36,0,10,39
70,Fail,47,40,0,12,35
70,Fail,51,36,5,8,43
70,Fail,51,29,0,16,35
70,Fail,58,31,0,9,49
70,Fail,39,33,16,12,27
70,Fail,54,29,0,12,42
70,Fail,53,29,0,13,40
70,Fail,47,33,6,14,33
70,Fail,52,37,0,11,41
70,Fail,55,31,0,12,43
70,Fail,41,33,8,18,23
70,Fail,49,35,0,14,35
70,Fail,48,43,0,6,42
70,Fail,43,38,0,14,29
70,Fail,52,31,2,15,37
70,Fail,52,35,0,13,39
70,Fail,48,34,5,13,35
70,Fail,55,32,0,10,45
70,Fail,51,35,0,13,38
70,Fail,45,33,3,19,26
70,Fail,48,37,0,12,36
70,Fail,43,42,4,11,32
70,Fail,50,34,6,10,40
70,Fail,51,35,0,14,37
70,Fail,47,37,4,12,35
70,Fail,45,40,1,14,31
70,Fail,49,35,2,14,35
70,Fail,52,33,0,12,40
70,Fail,49,37,0,10,39
70,Fail,44,39,0,14,30
70,Fail,42,40,0,12,30
70,Fail,51,33,2,14,37
70,Fail,50,28,6,16,34
70,Fail,46,36,8,10,36
70,Fail,50,32,0,11,39
70,Fail,51,30,0,16,35
70,Fail,39,33,0,14,25
70,Fail,48,39,1,12,36
70,Fail,40,40,5,15,25
70,Fail,45,37,4,14,31
70,Fail,50,37,3,10,40
70,Fail,43,42,0,9,34
70,Fail,49,38,0,10,39
70,Fail,50,38,6,6,44
70,Fail,42,43,4,11,31
70,Fail,45,31,6,18,27
70,Fail,40,42,0,15,25
70,Fail,48,33,0,18,30
70,Fail,46,40,0,14,32
70,Fail,44,42,3,11,33
70,Fail,46,38,6,10,36
70,Fail,48,28,5,19,29
70,Fail,52,30,0,15,37
70,Fail,55,32,0,13,42
70,Fail,57,37,0,6,51
70,Fail,50,36,2,12,38
70,Fail,48,39,0,11,37
70,Fail,54,33,0,11,43
70,Fail,45,38,0,11,34
70,Fail,51,30,0,15,36
70,Fail,45,42,0,9,36
70,Fail,52,36,0,10,42
70,Fail,54,26,6,14,40
70,Fail,39,31,0,15,24
70,Fail,45,27,7,21,24
70,Fail,53,38,0,8,45
70,Fail,49,40,0,11,38
70,Fail,46,35,0,17,29
70,Fail,40,35,0,16,24
70,Fail,46,38,1,15,31
70,Fail,47,38,1,14,33
70,Fail,43,36,0,20,23
70,Fail,44,39,0,13,31
70,Fail,51,33,4,12,39
70,Fail,52,31,0,17,35
70,Fail,54,28,0,13,41
70,Fail,47,40,1,12,35
70,Fail,53,35,4,8,45
70,Fail,48,29,10,13,35
70,Fail,53,27,0,14,39
70,Fail,48,31,0,17,31
70,Fail,46,41,2,11,35
70,Fail,47,32,7,14,33
70,Fail,47,27,11,15,32
70,Fail,52,34,0,9,43
70,Fail,41,38,0,16,25
70,Fail,50,29,9,12,38
70,Fail,58,25,6,11,47
70,Fail,42,41,2,15,27
70,Fail,43,43,0,11,32
70,Fail,56,28,2,14,42
70,Fail,45,37,2,16,29
70,Fail,47,42,0,8,39
70,Fail,46,37,0,16,30
70,Fail,44,38,2,16,28
70,Fail,44,38,4,14,30
70,Fail,53,35,3,9,44
70,Fail,51,38,0,7,44
70,Fail,54,30,0,13,41
70,Fail,48,30,0,13,35
70,Fail,47,33,0,12,35
70,Fail,46,39,0,13,33
70,Fail,47,32,6,15,32
70,Fail,51,41,0,8,43
70,Fail,56,31,0,13,43
70,Fail,51,28,10,11,40
70,Fail,52,30,2,16,36
70,Fail,42,39,6,13,29
70,Fail,54,32,1,13,41
70,Fail,50,37,0,13,37
70,Fail,38,36,0,20,18
70,Fail,56,28,2,14,42
70,Fail,50,34,0,15,35
70,Fail,49,36,1,14,35
70,Fail,46,37,0,12,34
70,Fail,39,45,0,11,28
70,Fail,54,32,4,10,44
70,Fail,49,35,7,9,40
70,Fail,47,32,7,14,33
70,Fail,47,40,0,10,37
70,Fail,52,37,0,8,44
70,Fail,49,35,6,10,39
70,Fail,53,34,0,7,46
70,Fail,49,38,0,8,41
70,Fail,46,39,1,14,32
70,Fail,49,40,4,7,42
70,Fail,40,42,8,10,30
70,Fail,45,37,6,12,33
70,Fail,48,42,1,9,39
70,Fail,47,34,4,15,32
70,Fail,46,34,3,17,29
70,Fail,48,30,8,14,34
70,Fail,49,34,0,10,39
70,Fail,45,32,0,23,22
70,Fail,50,35,1,14,36
70,Fail,41,34,2,23,18
70,Fail,51,34,4,11,40
70,Fail,53,30,2,15,38
70,Fail,53,32,2,13,40
70,Fail,53,29,0,17,36
70,Fail,40,46,0,10,30
70,Fail,54,32,5,9,45
70,Fail,50,34,0,12,38
70,Fail,48,35,5,12,36
70,Fail,47,39,3,11,36
70,Fail,38,37,4,21,17
70,Fail,55,28,0,9,46
70,Fail,46,40,0,6,40
70,Fail,40,40,0,16,24
70,Fail,47,40,2,11,36
70,Fail,51,33,0,14,37
70,Fail,42,31,11,16,26
70,Fail,50,37,2,11,39
70,Fail,52,33,0,11,41
70,Fail,46,37,1,16,30
70,Fail,55,35,0,9,46
70,Fail,54,35,0,9,45
70,Fail,49,36,0,13,36
70,Fail,39,40,3,18,21
70,Fail,54,34,0,8,46
70,Fail,48,37,0,14,34
70,Fail,44,42,0,9,35
70,Fail,54,31,3,12,42
70,Fail,44,45,3,8,36
70,Fail,44,38,0,18,26
70,Fail,43,41,4,12,31
70,Fail,52,29,0,15,37
70,Fail,48,27,0,12,36
70,Fail,47,38,0,15,32
70,Fail,45,35,7,13,32
70,Fail,42,41,6,11,31
70,Fail,46,38,3,13,33
70,Fail,50,38,0,9,41
70,Fail,48,36,0,15,33
70,Fail,46,39,3,12,34
70,Fail,45,34,1,20,25
70,Fail,49,30,0,16,33
70,Fail,54,33,0,13,41
70,Fail,53,34,0,10,43
70,Fail,53,39,0,8,45
70,Fail,45,38,0,14,31
70,Fail,52,29,0,10,42
70,Fail,46,41,0,12,34
70,Fail,49,35,0,11,38
70,Fail,50,28,14,8,42
70,Fail,52,34,0,12,40
70,Fail,44,34,7,15,29
70,Fail,53,31,0,12,41
70,Fail,46,33,9,12,34
70,Fail,50,34,0,11,39
70,Fail,36,44,0,13,23
70,Fail,50,41,1,8,42
70,Fail,45,35,0,11,34
70,Fail,45,37,4,14,31
70,Fail,46,35,4,15,31
70,Fail,58,23,0,17,41
70,Fail,42,42,0,8,34
70,Fail,35,41,12,12,23
70,Fail,53,29,0,12,41
70,Fail,53,29,4,14,39
70,Fail,49,37,2,12,37
70,Fail,60,31,0,6,54
70,Fail,50,28,0,21,29
70,Fail,51,29,5,15,36
70,Fail,48,32,0,20,28
70,Fail,45,39,5,11,34
70,Fail,48,34,0,11,37
70,Fail,50,33,0,9,41
70,Fail,46,27,0,14,32
70,Fail,53,35,1,11,42
70,Fail,43,31,0,18,25
70,Fail,45,42,1,12,33
70,Fail,52,36,0,12,40
70,Fail,45,35,0,12,33
70,Fail,43,35,0,13,30
70,Fail,53,26,0,21,32
70,Fail,45,40,0,9,36
70,Fail,59,30,0,9,50
70,Fail,48,37,0,8,40
70,Fail,43,39,0,13,30
70,Fail,43,38,2,17,26
70,Fail,45,39,7,9,36
70,Fail,47,34,0,15,32
70,Fail,45,34,0,12,33
70,Fail,48,30,7,15,33
70,Fail,51,34,0,14,37
70,Fail,45,34,0,13,32
70,Fail,51,30,0,14,37
70,Fail,54,26,0,13,41
70,Fail,43,40,1,16,27
70,Fail,48,35,0,16,32
70,Fail,46,43,0,10,36
70,Fail,51,30,4,15,36
70,Fail,52,37,2,9,43
70,Fail,50,39,0,9,41
70,Fail,49,40,1,10,39
70,Fail,49,34,2,15,34
70,Fail,49,42,0,7,42
70,Fail,39,32,0,18,21
70,Fail,55,30,0,15,40
70,Fail,52,30,0,8,44
70,Fail,51,35,3,11,40
70,Fail,43,38,8,11,32
70,Fail,43,44,1,12,31
70,Fail,45,30,10,15,30
70,Fail,50,36,0,13,37
70,Fail,46,36,0,9,37
70,Fail,58,29,0,9,49
70,Fail,47,38,5,10,37
70,Fail,49,38,0,12,37
70,Fail,45,37,0,15,30
70,Fail,49,35,0,15,34
70,Fail,49,33,5,13,36
70,Fail,47,35,0,17,30
70,Fail,47,31,10,12,35
70,Fail,50,37,2,11,39
70,Fail,41,49,2,8,33
70,Fail,54,29,6,11,43
70,Fail,49,35,4,12,37
70,Fail,43,42,0,13,30
70,Fail,50,32,3,15,35
70,Fail,42,40,6,12,30
70,Fail,52,38,2,8,44
70,Fail,52,23,0,20,32
70,Fail,47,42,1,10,37
70,Fail,40,37,0,17,23
70,Fail,39,41,0,10,29
70,Fail,61,28,2,9,52
70,Fail,44,42,0,14,30
70,Fail,44,35,6,15,29
70,Fail,43,40,0,12,31
70,Fail,47,34,0,10,37
70,Fail,45,42,1,12,33
70,Fail,49,33,3,15,34
70,Fail,52,33,0,15,37
70,Fail,47,39,1,13,34
70,Fail,52,36,0,9,43
70,Fail,41,35,0,19,22
70,Fail,54,34,0,8,46
70,Fail,50,35,0,15,35
70,Fail,53,31,5,11,42
70,Fail,55,30,3,12,43
70,Fail,53,35,4,8,45
70,Fail,45,37,3,15,30
70,Fail,49,26,0,18,31
70,Fail,51,37,0,9,42
70,Fail,46,38,0,13,33
70,Fail,41,37,0,15,26
70,Fail,43,44,2,11,32
70,Fail,45,44,2,9,36
70,Fail,52,36,1,11,41
70,Fail,50,31,0,11,39
70,Fail,49,40,0,11,38
70,Fail,56,32,4,8,48
70,Fail,47,32,0,17,30
70,Fail,52,33,4,11,41
70,Fail,42,37,0,16,26
70,Fail,40,29,16,15,25
70,Fail,50,38,2,10,40
70,Fail,41,34,0,17,24
70,Fail,47,32,6,15,32
70,Fail,51,38,1,10,41
70,Fail,34,39,0,16,18
70,Fail,49,28,5,18,31
70,Fail,50,35,0,12,38
70,Fail,48,37,4,11,37
70,Fail,52,36,2,10,42
70,Fail,41,34,0,22,19
70,Fail,52,36,2,10,42
70,Fail,48,35,0,11,37
70,Fail,42,36,10,12,30
70,Fail,45,38,10,7,38
70,Fail,55,25,8,12,43
70,Fail,49,36,0,13,36
70,Fail,53,35,0,10,43
70,Fail,44,37,0,18,26
70,Fail,47,33,0,15,32
70,Fail,52,31,0,14,38
70,Fail,44,28,0,18,26
70,Fail,46,31,6,17,29
70,Fail,52,35,0,11,41
70,Fail,47,33,0,13,34
70,Fail,43,42,0,8,35
70,Fail,46,43,0,11,35
70,Fail,48,35,0,15,33
70,Fail,55,33,0,8,47
70,Fail,46,32,0,17,29
70,Fail,51,36,0,12,39
70,Fail,45,43,0,12,33
70,Fail,48,36,6,10,38
70,Fail,49,34,0,13,36
70,Fail,55,36,0,9,46
70,Fail,44,34,4,18,26
70,Fail,51,33,2,14,37
70,Fail,40,36,0,15,25
70,Fail,51,25,0,19,32
70,Fail,43,35,7,15,28
70,Fail,51,33,7,9,42
70,Fail,49,38,0,8,41
70,Fail,54,37,0,8,46
70,Fail,48,37,3,12,36
70,Fail,55,36,0,8,47
70,Fail,42,39,4,15,27
70,Fail,46,33,4,17,29
70,Fail,55,34,0,11,44
70,Fail,44,38,0,12,32
70,Fail,51,34,0,10,41
70,Fail,54,27,3,16,38
70,Fail,45,33,0,16,29
70,Fail,51,33,4,12,39
70,Fail,48,41,1,10,38
70,Fail,44,38,6,12,32
70,Fail,46,34,0,16,30
70,Fail,44,31,8,17,27
70,Fail,47,28,11,14,33
70,Fail,41,34,0,15,26
70,Fail,46,37,6,11,35
70,Fail,41,34,0,14,27
70,Fail,42,38,5,15,27
70,Fail,44,34,0,16,28
70,Fail,51,30,10,9,42
70,Fail,54,26,0,15,39
70,Fail,48,40,3,9,39
70,Fail,52,37,2,9,43
70,Fail,46,33,0,17,29
70,Fail,49,41,0,10,39
70,Fail,50,35,0,11,39
70,Fail,49,28,0,16,33
70,Fail,39,36,0,17,22
70,Fail,52,25,0,19,33
70,Fail,49,34,4,13,36
70,Fail,47,37,1,15,32
70,Fail,52,34,3,11,41
70,Fail,51,39,2,8,43
70,Fail,42,38,4,16,26
70,Fail,51,32,0,15,36
70,Fail,52,40,2,6,46
70,Fail,47,39,0,12,35
70,Fail,46,33,0,11,35
70,Fail,43,41,2,14,29
70,Fail,50,34,1,15,35
70,Fail,46,41,0,13,33
70,Fail,51,30,5,14,37
70,Fail,51,30,0,15,36
70,Fail,48,36,4,12,36
70,Fail,40,44,0,13,27
70,Fail,39,35,9,17,22
70,Fail,51,36,4,9,42
70,Fail,55,32,0,7,48
70,Fail,43,43,0,14,29
70,Fail,50,33,5,12,38
70,Fail,50,34,1,15,35
70,Fail,41,31,12,16,25
70,Fail,54,26,0,16,38
70,Fail,53,29,6,12,41
70,Fail,48,36,3,13,35
70,Fail,52,31,1,16,36
70,Fail,55,27,0,13,42
70,Fail,47,36,0,16,31
70,Fail,49,39,1,11,38
70,Fail,49,29,3,19,30
70,Fail,51,31,0,15,36
70,Fail,44,42,7,7,37
70,Fail,45,35,6,14,31
70,Fail,51,38,2,9,42
70,Fail,48,28,10,14,34
70,Fail,51,31,5,13,38
70,Fail,52,29,0,12,40
70,Fail,49,36,0,12,37
70,Fail,45,33,4,18,27
70,Fail,53,38,0,7,46
70,Fail,51,36,0,8,43
70,Fail,51,38,0,8,43
70,Fail,50,37,0,10,40
70,Fail,47,35,1,17,30
70,Fail,41,35,0,17,24
70,Fail,54,28,0,15,39
70,Fail,46,45,1,8,38
70,Fail,52,35,0,11,41
70,Fail,55,36,2,7,48
70,Fail,48,33,0,11,37
70,Fail,45,39,0,15,30
70,Fail,49,40,0,6,43
70,Fail,45,34,7,14,31
70,Fail,52,33,0,14,38
70,Fail,46,36,1,17,29
70,Fail,48,36,0,14,34
70,Fail,44,38,0,16,28
70,Fail,45,41,2,12,33
70,Fail,45,31,0,11,34
70,Fail,40,39,9,12,28
70,Fail,48,35,1,16,32
70,Fail,44,38,0,12,32
70,Fail,46,41,1,12,34
70,Fail,48,33,0,17,31
70,Fail,52,33,1,14,38
70,Fail,57,26,4,13,44
70,Fail,53,35,1,11,42
70,Fail,49,31,3,17,32
70,Fail,51,39,0,9,42
70,Fail,36,41,9,14,22
70,Fail,45,39,6,10,35
70,Fail,51,28,0,20,31
70,Fail,54,33,0,10,44
70,Fail,57,32,3,8,49
70,Fail,46,41,0,10,36
70,Fail,42,41,4,13,29
70,Fail,40,41,0,15,25
70,Fail,49,35,0,14,35
70,Fail,44,37,0,16,28
70,Fail,48,37,0,11,37
70,Fail,47,36,0,14,33
70,Fail,44,38,7,11,33
70,Fail,46,35,8,11,35
70,Fail,45,38,1,16,29
70,Fail,42,43,0,12,30
70,Fail,47,32,6,15,32
70,Fail,47,40,0,12,35
70,Fail,48,40,0,8,40
70,Fail,44,41,2,13,31
70,Fail,51,34,4,11,40
70,Fail,47,40,4,9,38
70,Fail,43,37,6,14,29
70,Fail,51,30,4,15,36
70,Fail,51,32,5,12,39
70,Fail,43,33,7,17,26
70,Fail,48,40,0,6,42
70,Fail,47,40,0,11,36
70,Fail,52,33,2,13,39
70,Fail,52,36,0,12,40
70,Fail,51,34,0,14,37
70,Fail,43,29,11,17,26
70,Fail,48,36,0,14,34
70,Fail,45,39,6,10,35
70,Fail,52,31,0,11,41
70,Fail,44,41,2,13,31
70,Fail,42,41,0,13,29
70,Fail,43,33,5,19,24
70,Fail,39,37,0,14,25
70,Fail,51,40,4,5,46
70,Fail,44,39,0,14,30
70,Fail,52,34,2,12,40
70,Fail,47,32,0,18,29
70,Fail,46,37,0,15,31
70,Fail,48,27,0,13,35
70,Fail,47,36,0,13,34
70,Fail,48,35,0,14,34
70,Fail,54,37,0,6,48
70,Fail,53,33,2,12,41
70,Fail,40,37,4,19,21
70,Fail,46,39,1,14,32
70,Fail,53,37,2,8,45
70,Fail,49,31,7,13,36
70,Fail,41,44,1,14,27
70,Fail,38,35,0,19,19
70,Fail,45,30,9,16,29
70,Fail,45,35,5,15,30
70,Fail,46,37,2,15,31
70,Fail,50,35,0,11,39
70,Fail,43,33,1,23,20
70,Fail,48,38,6,8,40
70,Fail,59,32,3,6,53
70,Fail,54,26,5,15,39
70,Fail,50,36,2,12,38
70,Fail,52,36,1,11,41
70,Fail,45,44,2,9,36
70,Fail,45,39,6,10,35
70,Fail,48,32,2,18,30
70,Fail,55,29,1,15,40
70,Fail,51,36,0,13,38
70,Fail,43,33,4,20,23
70,Fail,48,42,1,9,39
70,Fail,42,41,0,12,30
70,Fail,45,32,8,15,30
70,Fail,47,37,0,16,31
70,Fail,48,31,6,15,33
70,Fail,51,35,8,6,45
70,Fail,51,34,4,11,40
70,Fail,52,30,3,15,37
70,Fail,50,32,4,14,36
70,Fail,46,37,4,13,33
70,Fail,40,45,6,9,31
70,Fail,54,30,0,8,46
70,Fail,53,35,2,10,43
70,Fail,45,33,0,18,27
70,Fail,57,32,0,8,49
70,Fail,49,31,4,16,33
70,Fail,47,35,6,12,35
70,Fail,53,30,0,15,38
70,Fail,50,27,0,14,36
70,Fail,43,38,0,15,28
70,Fail,43,41,1,15,28
70,Fail,59,33,0,8,51
70,Fail,42,28,0,18,24
70,Fail,46,40,0,9,37
70,Fail,43,43,0,13,30
70,Fail,55,32,0,12,43
70,Fail,48,37,0,14,34
70,Fail,42,39,3,16,26
70,Fail,48,37,8,7,41
70,Fail,47,39,5,9,38
70,Fail,54,34,0,9,45
70,Fail,55,38,0,7,48
70,Fail,57,26,0,10,47
70,Fail,43,35,4,18,25
70,Fail,50,37,0,10,40
70,Fail,43,30,0,17,26
70,Fail,46,30,0,21,25
70,Fail,49,35,3,13,36
70,Fail,50,37,0,13,37
70,Fail,53,33,6,8,45
70,Fail,45,32,6,17,28
70,Fail,51,33,3,13,38
70,Fail,42,42,0,14,28
70,Fail,54,34,3,9,45
70,Fail,49,35,0,12,37
70,Fail,43,39,0,9,34
70,Fail,43,44,4,9,34
70,Fail,44,39,0,10,34
70,Fail,49,36,0,15,34
70,Fail,43,36,9,12,31
70,Fail,58,29,1,12,46
70,Fail,48,34,4,14,34
70,Fail,56,33,0,11,45
70,Fail,61,27,0,10,51
70,Fail,53,36,4,7,46
70,Fail,41,37,5,17,24
70,Fail,52,33,0,15,37
70,Fail,45,35,0,18,27
70,Fail,43,33,0,14,29
70,Fail,52,32,0,13,39
70,Fail,46,37,2,15,31
70,Fail,50,34,6,10,40
70,Fail,41,35,12,12,29
70,Fail,44,37,0,11,33
70,Fail,49,39,0,11,38
70,Fail,48,37,10,5,43
70,Fail,50,39,0,11,39
70,Fail,47,33,0,18,29
70,Fail,47,35,12,6,41
70,Fail,45,41,0,14,31
70,Fail,46,39,0,13,33
70,Fail,46,38,0,10,36
70,Fail,44,37,6,13,31
70,Fail,50,36,4,10,40
70,Fail,49,36,0,15,34
70,Fail,46,38,0,16,30
70,Fail,41,34,0,15,26
70,Fail,46,42,1,11,35
70,Fail,54,33,0,8,46
70,Fail,54,28,5,13,41
70,Fail,50,35,5,10,40
70,Fail,50,33,6,11,39
70,Fail,52,35,1,12,40
70,Fail,36,47,8,9,27
70,Fail,50,39,4,7,43
70,Fail,49,36,3,12,37
70,Fail,46,39,5,10,36
70,Fail,45,32,0,14,31
70,Fail,52,36,0,11,41
70,Fail,54,30,0,12,42
70,Fail,45,32,5,18,27
70,Fail,45,40,0,11,34
70,Fail,50,34,0,16,34
70,Fail,50,36,0,14,36
70,Fail,53,32,3,12,41
70,Fail,50,32,0,15,35
70,Fail,48,28,0,11,37
70,Fail,47,29,9,15,32
70,Fail,44,39,5,12,32
70,Fail,36,41,0,19,17
70,Fail,51,34,6,9,42
70,Fail,43,38,0,14,29
70,Fail,46,39,1,14,32
70,Fail,48,38,1,13,35
70,Fail,49,28,0,16,33
70,Fail,48,36,0,8,40
70,Fail,44,29,0,20,24
70,Fail,49,28,3,20,29
70,Fail,48,36,5,11,37
70,Fail,46,38,0,14,32
70,Fail,48,36,0,16,32
70,Fail,46,29,0,15,31
70,Fail,42,41,4,13,29
70,Fail,44,38,3,15,29
70,Fail,48,36,3,13,35
70,Fail,49,38,1,12,37
70,Fail,51,33,0,11,40
70,Fail,38,40,0,18,20
70,Fail,54,37,0,9,45
70,Fail,39,41,3,17,22
70,Fail,44,35,7,14,30
70,Fail,48,32,6,14,34
70,Fail,50,33,0,14,36
70,Fail,44,35,0,15,29
70,Fail,51,41,4,4,47
70,Fail,45,35,4,16,29
70,Fail,46,39,0,11,35
70,Fail,52,33,0,10,42
70,Fail,47,37,0,15,32
70,Fail,38,44,0,18,20
70,Fail,53,32,0,13,40
70,Fail,52,41,2,5,47
70,Fail,47,33,8,12,35
70,Fail,40,47,0,11,29
70,Fail,46,37,0,11,35
70,Fail,47,39,0,10,37
70,Fail,48,39,0,11,37
70,Fail,51,34,1,14,37
70,Fail,53,33,3,11,42
70,Fail,41,38,0,18,23
70,Fail,41,43,0,15,26
70,Fail,51,34,0,13,38
70,Fail,47,41,2,10,37
70,Fail,49,36,0,10,39
70,Fail,56,23,5,16,40
70,Fail,44,31,0,12,32
70,Fail,42,28,12,18,24
70,Fail,52,29,4,15,37
70,Fail,51,37,0,5,46
70,Fail,53,38,1,8,45
70,Fail,56,30,3,11,45
70,Fail,47,38,0,11,36
70,Fail,47,39,0,11,36
70,Fail,43,33,7,17,26
70,Fail,53,35,2,10,43
70,Fail,53,42,0,4,49
70,Fail,49,35,0,14,35
70,Fail,41,32,9,18,23
70,Fail,42,39,7,12,30
70,Fail,54,36,2,8,46
70,Fail,54,29,0,12,42
70,Fail,45,36,4,15,30
70,Fail,34,38,0,21,13
70,Fail,55,28,3,14,41
70,Fail,54,38,0,8,46
70,Fail,39,35,0,26,13
70,Fail,46,38,0,12,34
70,Fail,44,46,0,10,34
70,Fail,54,40,3,3,51
70,Fail,42,38,8,12,30
70,Fail,49,27,12,12,37
70,Fail,46,27,13,14,32
70,Fail,48,38,2,12,36
70,Fail,45,31,11,13,32
70,Fail,42,38,4,16,26
70,Fail,43,40,4,13,30
70,Fail,49,36,2,13,36
70,Fail,44,33,5,18,26
70,Fail,53,37,0,10,43
70,Fail,47,32,5,16,31
70,Fail,44,41,1,14,30
70,Fail,48,41,2,9,39
70,Fail,45,35,2,18,27
70,Fail,45,39,5,11,34
70,Fail,44,35,0,13,31
70,Fail,42,43,0,10,32
70,Fail,49,41,1,9,40
70,Fail,45,35,4,16,29
70,Fail,47,32,0,21,26
70,Fail,46,31,10,13,33
70,Fail,52,39,0,9,43
70,Fail,47,39,0,8,39
70,Fail,40,43,0,10,30
70,Fail,47,41,2,10,37
70,Fail,53,34,0,10,43
70,Fail,50,36,4,10,40
70,Fail,39,42,1,18,21
70,Fail,48,30,0,15,33
70,Fail,45,34,0,14,31
70,Fail,44,38,0,13,31
70,Fail,51,34,2,13,38
70,Fail,53,30,0,14,39
70,Fail,56,29,0,10,46
70,Fail,47,29,6,18,29
70,Fail,51,36,6,7,44
70,Fail,48,31,8,13,35
70,Fail,45,36,0,13,32
70,Fail,50,35,8,7,43
70,Fail,53,37,1,9,44
70,Fail,46,38,0,15,31
70,Fail,53,30,0,10,43
70,Fail,45,37,3,15,30
70,Fail,52,33,0,11,41
70,Fail,50,36,7,7,43
70,Fail,47,38,0,15,32
70,Fail,61,25,0,8,53
70,Fail,47,30,0,17,30
70,Fail,50,35,0,13,37
70,Fail,46,41,5,8,38
70,Fail,53,33,0,10,43
70,Fail,51,37,6,6,45
70,Fail,51,35,2,12,39
70,Fail,47,34,12,7,40
70,Fail,57,33,2,8,49
70,Fail,52,38,0,6,46
70,Fail,45,41,0,10,35
70,Fail,49,37,0,14,35
70,Fail,50,30,0,17,33
70,Fail,50,32,0,13,37
70,Fail,49,38,5,8,41
70,Fail,50,34,3,13,37
70,Fail,46,39,3,12,34
70,Fail,50,32,0,9,41
70,Fail,57,25,4,14,43
70,Fail,46,33,3,18,28
70,Fail,40,43,3,14,26
70,Fail,56,27,0,17,39
70,Fail,46,32,0,16,30
70,Fail,41,39,0,14,27
70,Fail,42,36,0,16,26
70,Fail,54,34,1,11,43
70,Fail,52,38,1,9,43
70,Fail,45,42,0,13,32
70,Fail,52,38,0,10,42
70,Fail,50,36,0,8,42
70,Fail,54,34,0,10,44
70,Fail,50,33,4,13,37
70,Fail,38,36,0,15,23
70,Fail,48,39,0,12,36
70,Fail,53,34,3,10,43
70,Fail,53,35,1,11,42
70,Fail,55,35,0,10,45
70,Fail,53,31,0,12,41
70,Fail,48,37,0,11,37
70,Fail,39,30,0,12,27
70,Fail,54,38,3,5,49
70,Fail,47,43,0,10,37
70,Fail,40,36,10,14,26
70,Fail,42,39,0,18,24
70,Fail,56,31,0,13,43
70,Fail,48,38,0,11,37
70,Fail,43,33,0,14,29
70,Fail,47,35,1,17,30
70,Fail,48,34,0,14,34
70,Fail,43,31,0,21,22
70,Fail,51,31,4,14,37
70,Fail,45,22,16,17,28
70,Fail,48,32,6,14,34
70,Fail,53,33,5,9,44
70,Fail,51,37,0,12,39
70,Fail,41,40,0,14,27
70,Fail,57,20,0,18,39
70,Fail,50,32,0,12,38
70,Fail,45,34,9,12,33
70,Fail,53,27,0,17,36
70,Fail,49,28,0,15,34
70,Fail,42,44,0,14,28
70,Fail,48,37,0,11,37
70,Fail,43,30,6,21,22
70,Fail,43,34,0,17,26
70,Fail,41,45,0,14,27
70,Fail,44,41,0,14,30
70,Fail,53,34,6,7,46
70,Fail,47,39,1,13,34
70,Fail,38,42,2,18,20
70,Fail,48,36,5,11,37
70,Fail,44,36,0,20,24
70,Fail,36,37,10,17,19
70,Fail,47,36,0,17,30
70,Fail,52,34,0,13,39
70,Fail,54,35,2,9,45
70,Fail,41,44,1,14,27
70,Fail,52,34,2,12,40
70,Fail,48,37,0,9,39
70,Fail,46,36,0,18,28
70,Fail,53,35,6,6,47
70,Fail,56,29,4,11,45
70,Fail,47,36,4,13,34
70,Fail,39,35,0,18,21
70,Fail,47,34,0,18,29
70,Fail,55,28,0,15,40
70,Fail,48,30,5,17,31
70,Fail,49,34,1,16,33
70,Fail,60,28,2,10,50
70,Fail,44,39,6,11,33
70,Fail,41,42,0,10,31
70,Fail,44,39,0,15,29
70,Fail,42,38,0,16,26
70,Fail,45,38,5,12,33
70,Fail,45,37,3,15,30
70,Fail,57,33,0,10,47
70,Fail,49,33,2,16,33
70,Fail,41,45,2,12,29
70,Fail,45,41,0,13,32
70,Fail,45,39,2,14,31
70,Fail,48,35,0,16,32
70,Fail,46,41,3,10,36
70,Fail,54,30,4,12,42
70,Fail,45,40,0,10,35
70,Fail,50,35,5,10,40
70,Fail,50,36,0,13,37
70,Fail,56,34,0,9,47
70,Fail,51,37,0,11,40
70,Fail,51,39,0,10,41
70,Fail,47,42,0,6,41
70,Fail,45,38,2,15,30
70,Fail,45,43,2,10,35
70,Fail,56,35,2,7,49
70,Fail,50,32,5,13,37
70,Fail,42,31,0,16,26
70,Fail,47,35,0,15,32
70,Fail,46,38,2,14,32
70,Fail,47,40,0,10,37
70,Fail,49,35,0,11,38
70,Fail,45,34,0,14,31
70,Fail,47,34,0,14,33
70,Fail,48,31,6,15,33
70,Fail,58,33,0,8,50
70,Fail,46,38,3,13,33
70,Fail,45,39,0,15,30
70,Fail,54,33,1,12,42
70,Fail,43,35,0,12,31
70,Fail,46,36,0,9,37
70,Fail,50,31,0,15,35
70,Fail,49,32,3,16,33
70,Fail,53,35,0,11,42
70,Fail,51,26,5,18,33
70,Fail,53,38,2,7,46
70,Fail,46,39,0,15,31
70,Fail,43,34,0,18,25
70,Fail,49,38,3,10,39
70,Fail,46,35,2,17,29
70,Fail,48,37,0,9,39
70,Fail,46,39,0,12,34
70,Fail,56,34,0,10,46
70,Fail,40,42,1,17,23
70,Fail,47,41,4,8,39
70,Fail,54,34,0,11,43
70,Fail,50,37,3,10,40
70,Fail,45,38,6,11,34
70,Fail,58,32,1,9,49
70,Fail,55,37,3,5,50
70,Fail,47,31,5,17,30
70,Fail,47,34,0,13,34
70,Fail,47,37,6,10,37
70,Fail,54,35,3,8,46
70,Fail,44,32,0,17,27
70,Fail,47,38,0,10,37
70,Fail,43,38,3,16,27
70,Fail,47,39,0,14,33
70,Fail,48,36,3,13,35
70,Fail,34,46,0,17,17
70,Fail,48,33,8,11,37
70,Fail,53,31,4,12,41
70,Fail,46,34,5,15,31
70,Fail,45,29,10,16,29
70,Fail,48,34,0,11,37
70,Fail,49,35,0,10,39
70,Fail,46,41,6,7,39
70,Fail,42,37,0,16,26
70,Fail,49,36,0,13,36
70,Fail,44,42,0,11,33
70,Fail,41,40,3,16,25
70,Fail,41,37,10,12,29
70,Fail,44,32,0,17,27
70,Fail,56,28,0,12,44
70,Fail,47,39,3,11,36
70,Fail,53,31,0,13,40
70,Fail,47,41,3,9,38
70,Fail,50,41,2,7,43
70,Fail,45,39,1,15,30
70,Fail,47,37,4,12,35
70,Fail,51,33,0,14,37
70,Fail,44,42,1,13,31
70,Fail,43,38,0,15,28
70,Fail,56,31,1,12,44
70,Fail,52,33,3,12,40
70,Fail,48,34,1,17,31
70,Fail,52,28,0,16,36
70,Fail,47,34,5,14,33
70,Fail,51,39,0,9,42
70,Fail,50,35,0,10,40
70,Fail,46,38,1,15,31
70,Fail,43,29,0,16,27
70,Fail,43,34,0,15,28
70,Fail,46,40,0,10,36
70,Fail,44,38,0,18,26
70,Fail,44,42,0,10,34
70,Fail,48,32,0,14,34
70,Fail,42,37,3,18,24
70,Fail,50,27,9,14,36
70,Fail,52,29,0,14,38
70,Fail,49,31,7,13,36
70,Fail,44,38,4,14,30
70,Fail,45,38,3,14,31
70,Fail,53,33,0,13,40
70,Fail,48,37,4,11,37
70,Fail,53,36,0,10,43
70,Fail,48,35,0,14,34
70,Fail,51,30,0,14,37
70,Fail,49,33,3,15,34
70,Fail,52,37,0,10,42
70,Fail,49,41,0,10,39
70,Fail,53,38,0,9,44
70,Fail,46,37,0,15,31
70,Fail,52,31,2,15,37
70,Fail,45,40,0,12,33
70,Fail,52,30,0,10,42
70,Fail,47,30,0,17,30
70,Fail,49,38,0,12,37
70,Fail,41,42,3,14,27
70,Fail,42,34,0,18,24
70,Fail,44,35,0,20,24
70,Fail,43,37,0,19,24
70,Fail,42,41,0,17,25
70,Fail,47,39,0,11,36
70,Fail,45,36,6,13,32
70,Fail,48,32,6,14,34
70,Fail,50,33,4,13,37
70,Fail,40,39,5,16,24
70,Fail,44,34,3,19,25
70,Fail,51,35,2,12,39
70,Fail,49,33,0,9,40
70,Fail,46,43,3,8,38
70,Fail,44,40,3,13,31
70,Fail,45,32,5,18,27
70,Fail,50,33,3,14,36
70,Fail,51,36,5,8,43
70,Fail,52,37,0,6,46
70,Fail,50,36,6,8,42
70,Fail,53,31,1,15,38
70,Fail,52,29,1,18,34
70,Fail,45,44,0,9,36
70,Fail,45,39,2,14,31
70,Fail,55,32,1,12,43
70,Fail,49,35,0,12,37
70,Fail,44,35,0,17,27
70,Fail,50,33,0,12,38
70,Fail,50,32,7,11,39
70,Fail,48,30,5,17,31
70,Fail,49,34,0,9,40
70,Fail,48,38,1,13,35
70,Fail,54,32,3,11,43
70,Fail,57,34,0,8,49
70,Fail,50,33,2,15,35
70,Fail,46,31,10,13,33
70,Fail,50,33,0,14,36
70,Fail,55,30,0,12,43
70,Fail,46,38,1,15,31
70,Fail,45,37,2,16,29
70,Fail,47,35,2,16,31
70,Fail,43,41,0,13,30
70,Fail,45,35,7,13,32
70,Fail,46,36,0,10,36
70,Fail,51,38,0,9,42
70,Fail,45,42,0,13,32
70,Fail,45,32,10,13,32
70,Fail,44,36,6,14,30
70,Fail,50,36,0,11,39
70,Fail,50,33,5,12,38
70,Fail,52,32,0,10,42
70,Fail,47,37,3,13,34
70,Fail,39,36,0,18,21
70,Fail,49,36,0,14,35
70,Fail,45,41,0,11,34
70,Fail,48,30,5,17,31
70,Fail,43,38,3,16,27
70,Fail,53,32,0,12,41
70,Fail,41,41,3,15,26
70,Fail,48,35,0,16,32
70,Fail,48,25,0,16,32
70,Fail,48,35,3,14,34
70,Fail,49,34,4,13,36
70,Fail,48,35,0,17,31
70,Fail,40,45,3,12,28
70,Fail,46,39,0,15,31
70,Fail,45,38,0,14,31
70,Fail,46,34,0,13,33
70,Fail,54,28,6,12,42
70,Fail,49,40,2,9,40
70,Fail,51,34,8,7,44
70,Fail,52,35,1,12,40
70,Fail,48,37,0,15,33
70,Fail,49,36,2,13,36
70,Fail,45,31,6,18,27
70,Fail,62,28,0,10,52
70,Fail,53,37,0,9,44
70,Fail,49,36,0,13,36
70,Fail,44,39,0,12,32
70,Fail,41,38,0,16,25
70,Fail,45,36,6,13,32
70,Fail,49,37,0,10,39
70,Fail,47,37,6,10,37
70,Fail,49,35,3,13,36
70,Fail,45,42,1,12,33
70,Fail,39,45,3,13,26
70,Fail,43,38,5,14,29
70,Fail,46,33,9,12,34
70,Fail,51,34,0,15,36
70,Fail,47,37,1,15,32
70,Fail,51,34,0,15,36
70,Fail,54,25,0,12,42
70,Fail,47,41,0,11,36
70,Fail,46,49,0,5,41
70,Fail,42,30,14,14,28
70,Fail,44,39,10,7,37
70,Fail,37,44,0,15,22
70,Fail,46,36,0,13,33
70,Fail,52,31,0,14,38
70,Fail,41,33,4,22,19
70,Fail,47,37,2,14,33
70,Fail,39,38,11,12,27
70,Fail,50,38,3,9,41
70,Fail,43,33,0,20,23
70,Fail,44,37,0,11,33
70,Fail,47,39,4,10,37
70,Fail,46,34,3,17,29
70,Fail,47,31,0,13,34
70,Fail,50,36,5,9,41
70,Fail,47,40,1,12,35
70,Fail,36,46,7,11,25
70,Fail,37,42,2,19,18
70,Fail,53,35,2,10,43
70,Fail,43,39,0,14,29
70,Fail,51,32,6,11,40
70,Fail,43,35,0,17,26
70,Fail,43,42,4,11,32
70,Fail,41,39,0,18,23
70,Fail,57,30,0,9,48
70,Fail,56,28,0,14,42
70,Fail,48,36,0,14,34
70,Fail,48,37,0,13,35
70,Fail,55,30,0,14,41
70,Fail,48,40,1,11,37
70,Fail,47,30,5,18,29
70,Fail,51,38,0,11,40
70,Fail,41,43,0,11,30
70,Fail,42,37,3,18,24
70,Fail,55,33,0,12,43
70,Fail,42,32,0,21,21
70,Fail,50,26,4,20,30
70,Fail,40,44,0,13,27
70,Fail,50,42,0,8,42
70,Fail,46,36,0,11,35
70,Fail,50,39,0,9,41
70,Fail,46,42,0,12,34
70,Fail,43,40,2,15,28
70,Fail,46,31,14,9,37
70,Fail,47,33,3,17,30
70,Fail,56,36,1,7,49
70,Fail,39,43,7,11,28
70,Fail,36,30,0,21,15
70,Fail,49,36,2,13,36
70,Fail,45,34,4,17,28
70,Fail,47,34,0,11,36
70,Fail,50,27,0,12,38
70,Fail,54,31,0,8,46
70,Fail,51,30,5,14,37
70,Fail,51,28,0,14,37
70,Fail,49,33,5,13,36
70,Fail,46,41,0,12,34
70,Fail,49,39,0,10,39
70,Fail,49,37,2,12,37
70,Fail,47,35,0,9,38
70,Fail,52,38,1,9,43
70,Fail,40,37,0,15,25
70,Fail,49,40,0,8,41
70,Fail,47,32,0,16,31
70,Fail,48,38,5,9,39
70,Fail,44,40,1,15,29
70,Fail,44,31,0,13,31
70,Fail,48,36,2,14,34
70,Fail,50,33,0,15,35
70,Fail,52,38,0,7,45
70,Fail,51,39,2,8,43
70,Fail,59,26,0,10,49
70,Fail,51,35,0,13,38
70,Fail,48,39,0,8,40
70,Fail,55,30,3,12,43
70,Fail,50,34,4,12,38
70,Fail,53,34,0,8,45
70,Fail,46,33,0,16,30
70,Fail,46,34,11,9,37
70,Fail,54,25,2,19,35
70,Fail,43,36,8,13,30
70,Fail,50,34,5,11,39
70,Fail,47,34,0,13,34
70,Fail,42,33,0,10,32
70,Fail,50,37,3,10,40
70,Fail,54,40,0,5,49
70,Fail,48,32,7,13,35
70,Fail,47,34,8,11,36
70,Fail,49,36,1,14,35
70,Fail,43,35,7,15,28
70,Fail,46,39,3,12,34
70,Fail,50,27,6,17,33
70,Fail,49,37,3,11,38
70,Fail,46,43,0,9,37
70,Fail,48,38,0,10,38
70,Fail,42,35,10,13,29
70,Fail,40,41,0,16,24
70,Fail,49,36,3,12,37
70,Fail,49,36,0,13,36
70,Fail,43,41,0,7,36
70,Fail,53,33,0,14,39
70,Fail,53,30,0,12,41
70,Fail,52,30,6,12,40
70,Fail,50,31,0,18,32
70,Fail,48,38,6,8,40
70,Fail,48,41,3,8,40
70,Fail,42,33,10,15,27
70,Fail,43,40,4,13,30
70,Fail,45,36,0,17,28
70,Fail,54,34,0,9,45
70,Fail,51,34,3,12,39
70,Fail,49,36,4,11,38
70,Fail,47,39,0,14,33
70,Fail,50,37,0,13,37
70,Fail,46,37,5,12,34
70,Fail,48,31,2,19,29
70,Fail,39,40,0,16,23
70,Fail,42,45,0,10,32
70,Fail,57,34,0,8,49
70,Fail,46,43,2,9,37
70,Fail,45,35,0,15,30
70,Fail,53,31,4,12,41
70,Fail,46,25,9,20,26
70,Fail,43,28,0,18,25
70,Fail,45,35,0,13,32
70,Fail,51,40,0,8,43
70,Fail,49,36,0,15,34
70,Fail,49,38,0,10,39
70,Fail,53,35,1,11,42
70,Fail,50,36,0,14,36
70,Fail,51,36,0,10,41
70,Fail,51,39,0,9,42
70,Fail,48,31,6,15,33
70,Fail,53,36,0,8,45
70,Fail,47,36,0,9,38
70,Fail,41,36,0,17,24
70,Fail,42,41,4,13,29
70,Fail,54,41,0,4,50
70,Fail,52,30,1,17,35
70,Fail,51,29,8,12,39
70,Fail,45,36,2,17,28
70,Fail,41,44,5,10,31
70,Fail,45,35,11,9,36
70,Fail,51,30,6,13,38
70,Fail,53,24,0,18,35
70,Fail,52,31,0,8,44
70,Fail,38,38,0,16,22
70,Fail,56,35,2,7,49
70,Fail,43,37,0,14,29
70,Fail,45,33,0,17,28
70,Fail,51,34,0,14,37
70,Fail,44,40,5,11,33
70,Fail,49,37,0,13,36
70,Fail,45,38,0,15,30
70,Fail,47,33,6,14,33
70,Fail,49,35,2,14,35
70,Fail,44,44,0,12,32
70,Fail,41,41,2,16,25
70,Fail,63,26,1,10,53
70,Fail,40,37,0,18,22
70,Fail,41,36,0,14,27
70,Fail,56,34,1,9,47
70,Fail,50,39,3,8,42
70,Fail,49,31,0,15,34
70,Fail,46,42,0,10,36
70,Fail,54,37,0,8,46
70,Fail,50,34,0,14,36
70,Fail,53,35,1,11,42
70,Fail,47,35,5,13,34
70,Fail,44,34,0,15,29
70,Fail,53,39,0,7,46
70,Fail,40,40,3,17,23
70,Fail,52,37,5,6,46
70,Fail,44,36,0,16,28
70,Fail,44,39,0,16,28
70,Fail,51,34,5,10,41
70,Fail,53,33,0,9,44
70,Fail,41,39,7,13,28
70,Fail,46,35,0,16,30
70,Fail,44,39,0,13,31
70,Fail,58,32,2,8,50
70,Fail,49,37,0,13,36
70,Fail,42,35,0,14,28
70,Fail,41,32,0,23,18
70,Fail,52,36,0,12,40
70,Fail,43,41,0,4,39
70,Fail,49,34,4,13,36
70,Fail,39,38,0,18,21
70,Fail,51,30,0,19,32
70,Fail,47,35,6,12,35
70,Fail,48,38,0,13,35
70,Fail,53,31,0,13,40
70,Fail,54,34,2,10,44
70,Fail,46,39,3,12,34
70,Fail,53,31,0,15,38
70,Fail,43,41,0,12,31
70,Fail,51,33,5,11,40
70,Fail,47,36,4,13,34
70,Fail,52,33,1,14,38
70,Fail,50,40,4,6,44
70,Fail,42,35,0,13,29
70,Fail,48,37,0,14,34
70,Fail,49,34,0,10,39
70,Fail,41,44,0,12,29
70,Fail,50,32,0,16,34
70,Fail,52,31,1,16,36
70,Fail,42,39,1,18,24
70,Fail,53,27,5,15,38
70,Fail,45,38,0,16,29
70,Fail,51,33,1,15,36
70,Fail,44,40,5,11,33
70,Fail,50,34,9,7,43
70,Fail,40,37,0,15,25
70,Fail,42,39,0,12,30
70,Fail,57,26,4,13,44
70,Fail,52,32,0,9,43
70,Fail,41,41,3,15,26
70,Fail,49,34,3,14,35
70,Fail,44,45,0,9,35
70,Fail,51,32,0,17,34
70,Fail,51,28,0,15,36
70,Fail,50,38,0,12,38
70,Fail,45,33,0,17,28
70,Fail,51,31,0,16,35
70,Fail,52,30,0,10,42
70,Fail,44,33,9,14,30
70,Fail,62,30,0,7,55
70,Fail,42,36,0,19,23
70,Fail,46,40,3,11,35
70,Fail,47,38,6,9,38
70,Fail,54,36,1,9,45
70,Fail,52,34,7,7,45
70,Fail,52,34,3,11,41
70,Fail,47,31,0,17,30
70,Fail,41,25,11,23,18
70,Fail,45,42,1,12,33
70,Fail,47,37,2,14,33
70,Fail,48,33,8,11,37
70,Fail,52,30,5,13,39
70,Fail,46,37,0,16,30
70,Fail,47,37,5,11,36
70,Fail,44,34,10,12,32
70,Fail,47,30,0,11,36
70,Fail,38,37,0,17,21
70,Fail,53,38,0,7,46
70,Fail,55,28,5,12,43
70,Fail,46,37,7,10,36
70,Fail,47,39,0,8,39
70,Fail,51,33,0,13,38
70,Fail,58,29,2,11,47
70,Fail,50,30,0,14,36
70,Fail,47,44,0,9,38
70,Fail,46,39,0,11,35
70,Fail,44,33,0,9,35
70,Fail,52,34,2,12,40
70,Fail,53,30,0,14,39
70,Fail,43,34,0,17,26
70,Fail,43,36,0,14,29
70,Fail,49,34,0,16,33
70,Fail,45,31,10,14,31
70,Fail,45,34,0,19,26
70,Fail,47,32,11,10,37
70,Fail,43,28,7,22,21
70,Fail,43,32,0,19,24
70,Fail,48,38,0,6,42
70,Fail,44,34,0,14,30
70,Fail,55,33,0,11,44
70,Fail,46,26,0,16,30
70,Fail,50,34,0,10,40
70,Fail,55,31,4,10,45
70,Fail,40,35,10,15,25
70,Fail,50,36,2,12,38
70,Fail,50,37,2,11,39
70,Fail,53,34,1,12,41
70,Fail,50,31,0,19,31
70,Fail,56,28,3,13,43
70,Fail,53,39,0,8,45
70,Fail,46,36,0,12,34
70,Fail,51,30,0,12,39
70,Fail,49,39,1,11,38
70,Fail,46,50,0,3,43
70,Fail,52,39,0,8,44
70,Fail,50,33,0,12,38
70,Fail,49,37,0,11,38
70,Fail,53,32,0,12,41
70,Fail,49,36,0,15,34
70,Fail,57,30,0,13,44
70,Fail,50,35,1,14,36
70,Fail,55,31,3,11,44
70,Fail,41,38,3,18,23
70,Fail,52,34,2,12,40
70,Fail,52,40,0,6,46
70,Fail,53,31,1,15,38
70,Fail,54,33,6,7,47
70,Fail,50,39,1,10,40
70,Fail,43,34,10,13,30
70,Fail,45,38,4,13,32
70,Fail,51,39,2,8,43
70,Fail,49,32,8,11,38
70,Fail,46,39,0,14,32
70,Fail,49,31,6,14,35
70,Fail,43,32,0,12,31
70,Fail,50,27,5,18,32
70,Fail,48,42,0,9,39
70,Fail,51,30,0,15,36
70,Fail,56,32,2,10,46
70,Fail,52,32,0,10,42
70,Fail,40,38,3,19,21
70,Fail,50,34,0,13,37
70,Fail,53,30,0,16,37
70,Fail,54,31,3,12,42
70,Fail,55,31,2,12,43
70,Fail,43,45,2,10,33
70,Fail,57,33,2,8,49
70,Fail,47,33,0,13,34
70,Fail,43,41,0,10,33
70,Fail,46,40,1,13,33
70,Fail,46,39,3,12,34
70,Fail,47,33,0,15,32
70,Fail,45,34,0,18,27
70,Fail,48,35,0,9,39
70,Fail,53,34,0,12,41
70,Fail,47,38,0,13,34
70,Fail,49,33,0,12,37
70,Fail,45,36,0,15,30
70,Fail,50,28,6,16,34
70,Fail,50,35,0,10,40
70,Fail,54,33,0,13,41
70,Fail,52,33,6,9,43
70,Fail,46,39,0,12,34
70,Fail,53,34,4,9,44
70,Fail,50,39,0,6,44
70,Fail,43,33,8,16,27
70,Fail,49,34,0,10,39
70,Fail,46,43,0,10,36
70,Fail,44,37,3,16,28
70,Fail,45,36,0,11,34
70,Fail,48,33,0,13,35
70,Fail,43,39,0,17,26
70,Fail,54,32,0,14,40
70,Fail,53,35,2,10,43
70,Fail,47,37,6,10,37
70,Fail,49,35,5,11,38
70,Fail,45,36,0,16,29
70,Fail,49,36,3,12,37
70,Fail,48,27,0,12,36
70,Fail,44,45,0,7,37
70,Fail,50,35,0,15,35
70,Fail,44,37,0,18,26
70,Fail,43,43,3,11,32
70,Fail,52,33,0,7,45
70,Fail,49,36,2,13,36
70,Fail,55,30,0,12,43
70,Fail,58,30,2,10,48
70,Fail,48,37,0,11,37
70,Fail,42,37,7,14,28
70,Fail,48,37,0,15,33
70,Fail,44,47,0,7,37
70,Fail,49,31,7,13,36
70,Fail,46,31,0,13,33
70,Fail,54,34,4,8,46
70,Fail,47,35,5,13,34
70,Fail,53,34,2,11,42
70,Fail,46,39,0,10,36
70,Fail,52,31,5,12,40
70,Fail,46,36,0,11,35
70,Fail,42,42,5,11,31
70,Fail,53,35,1,11,42
70,Fail,50,41,1,8,42
70,Fail,45,42,0,13,32
70,Fail,47,36,0,10,37
70,Fail,41,39,3,17,24
70,Fail,46,39,0,14,32
70,Fail,48,35,0,14,34
70,Fail,56,39,1,4,52
70,Fail,52,41,0,6,46
70,Fail,58,25,3,14,44
70,Fail,44,40,0,9,35
70,Fail,57,29,0,7,50
70,Fail,52,37,5,6,46
70,Fail,48,31,4,17,31
70,Fail,47,38,2,13,34
70,Fail,44,38,0,13,31
70,Fail,47,40,0,9,38
70,Fail,41,41,0,16,25
70,Fail,45,38,1,16,29
70,Fail,51,32,6,11,40
70,Fail,59,33,2,6,53
70,Fail,49,32,0,11,38
70,Fail,56,32,0,10,46
70,Fail,48,36,0,12,36
70,Fail,50,42,0,7,43
70,Fail,45,31,0,15,30
70,Fail,54,31,2,13,41
70,Fail,54,29,0,16,38
70,Fail,49,40,0,9,40
70,Fail,57,34,0,9,48
70,Fail,46,34,5,15,31
70,Fail,40,47,0,11,29
70,Fail,46,33,0,21,25
70,Fail,40,42,0,15,25
70,Fail,55,28,0,15,40
70,Fail,45,32,7,16,29
70,Fail,47,38,4,11,36
70,Fail,48,27,0,10,38
70,Fail,50,40,0,10,40
70,Fail,56,34,0,7,49
70,Fail,43,31,16,10,33
70,Fail,46,34,0,17,29
70,Fail,44,34,8,14,30
70,Fail,43,42,6,9,34
70,Fail,47,39,0,13,34
70,Fail,47,33,0,17,30
70,Fail,54,27,0,16,38
70,Fail,47,29,0,12,35
70,Fail,41,36,0,10,31
70,Fail,45,41,0,14,31
70,Fail,48,41,0,8,40
70,Fail,58,33,0,9,49
70,Fail,44,34,6,16,28
70,Fail,53,31,0,9,44
70,Fail,55,30,6,9,46
70,Fail,46,38,5,11,35
70,Fail,45,37,0,13,32
70,Fail,46,36,0,14,32
70,Fail,47,36,0,15,32
70,Fail,42,38,0,15,27
70,Fail,52,30,6,12,40
70,Fail,53,31,0,15,38
70,Fail,49,39,0,11,38
70,Fail,49,33,9,9,40
70,Fail,53,35,0,7,46
70,Fail,47,36,1,16,31
70,Fail,45,45,0,10,35
70,Fail,47,36,7,10,37
70,Fail,46,34,0,13,33
70,Fail,47,33,0,17,30
70,Fail,50,40,0,10,40
70,Fail,48,36,2,14,34
70,Fail,49,35,0,8,41
70,Fail,47,37,4,12,35
70,Fail,40,39,1,20,20
70,Fail,49,32,0,16,33
70,Fail,35,39,0,15,20
70,Fail,44,40,0,12,32
70,Fail,49,35,5,11,38
70,Fail,48,35,0,12,36
70,Fail,56,32,0,10,46
70,Fail,48,41,0,11,37
70,Fail,51,36,0,10,41
70,Fail,51,33,0,12,39
70,Fail,47,40,3,10,37
70,Fail,41,42,9,8,33
70,Fail,53,37,0,8,45
70,Fail,45,38,0,13,32
70,Fail,40,40,0,16,24
70,Fail,50,34,0,14,36
70,Fail,57,32,0,9,48
70,Fail,50,36,4,10,40
70,Fail,48,34,0,7,41
70,Fail,50,34,3,13,37
70,Fail,45,39,3,13,32
70,Fail,45,29,14,12,33
70,Fail,49,36,0,12,37
70,Fail,50,33,0,14,36
70,Fail,45,35,0,15,30
70,Fail,50,31,0,17,33
70,Fail,47,41,0,10,37
70,Fail,51,33,3,13,38
70,Fail,54,38,1,7,47
70,Fail,53,38,1,8,45
70,Fail,49,31,0,17,32
70,Fail,42,42,2,14,28
70,Fail,46,34,0,15,31
70,Fail,51,33,8,8,43
70,Fail,51,36,0,13,38
70,Fail,47,44,1,8,39
70,Fail,39,38,0,23,16
70,Fail,51,33,3,13,38
70,Fail,45,41,4,10,35
70,Fail,45,34,1,20,25
70,Fail,49,28,0,12,37
70,Fail,46,40,1,13,33
70,Fail,57,34,0,9,48
70,Fail,48,42,0,8,40
70,Fail,50,32,4,14,36
70,Fail,48,43,1,8,40
70,Fail,45,39,3,13,32
70,Fail,53,37,1,9,44
70,Fail,51,34,0,14,37
70,Fail,48,34,0,15,33
70,Fail,41,40,6,13,28
70,Fail,47,39,0,10,37
70,Fail,45,34,7,14,31
70,Fail,49,38,0,10,39
70,Fail,53,31,0,10,43
70,Fail,38,41,0,14,24
70,Fail,50,34,3,13,37
70,Fail,55,34,3,8,47
70,Fail,53,33,5,9,44
70,Fail,44,41,4,11,33
70,Fail,42,39,0,10,32
70,Fail,51,29,0,14,37
70,Fail,51,32,6,11,40
70,Fail,50,29,5,16,34
70,Fail,50,34,2,14,36
70,Fail,52,34,2,12,40
70,Fail,46,36,4,14,32
70,Fail,42,40,0,16,26
70,Fail,53,37,0,8,45
70,Fail,51,35,0,12,39
70,Fail,40,29,14,17,23
70,Fail,45,36,0,17,28
70,Fail,52,38,0,9,43
70,Fail,42,47,2,9,33
70,Fail,45,34,0,14,31
70,Fail,40,38,3,19,21
70,Fail,54,30,0,10,44
70,Fail,47,32,0,19,28
70,Fail,44,31,12,13,31
70,Fail,50,32,5,13,37
70,Fail,58,29,4,9,49
70,Fail,53,33,0,11,42
70,Fail,43,41,6,10,33
70,Fail,58,32,6,4,54
70,Fail,48,35,3,14,34
70,Fail,45,40,0,13,32
70,Fail,50,31,0,15,35
70,Fail,46,38,3,13,33
70,Fail,48,40,1,11,37
70,Fail,53,27,8,12,41
70,Fail,43,40,1,16,27
70,Fail,46,41,0,12,34
70,Fail,41,35,0,18,23
70,Fail,43,43,4,10,33
70,Fail,51,35,0,8,43
70,Fail,52,35,0,13,39
70,Fail,54,36,2,8,46
70,Fail,50,33,0,16,34
70,Fail,41,42,5,12,29
70,Fail,47,34,5,14,33
70,Fail,42,43,3,12,30
70,Fail,45,38,5,12,33
70,Fail,37,34,0,14,23
70,Fail,51,35,2,12,39
70,Fail,44,37,1,18,26
70,Fail,52,34,0,14,38
70,Fail,40,41,7,12,28
70,Fail,50,33,7,10,40
70,Fail,45,33,6,16,29
70,Fail,44,42,0,10,34
70,Fail,45,45,0,10,35
70,Fail,43,39,0,10,33
70,Fail,42,37,0,21,21
70,Fail,48,36,4,12,36
70,Fail,39,35,6,20,19
70,Fail,51,34,0,14,37
70,Fail,47,41,3,9,38
70,Fail,47,41,4,8,39
70,Fail,43,35,7,15,28
70,Fail,41,45,0,14,27
70,Fail,48,42,5,5,43
70,Fail,46,30,5,19,27
70,Fail,52,34,0,7,45
70,Fail,52,37,3,8,44
70,Fail,44,38,0,14,30
70,Fail,49,34,3,14,35
70,Fail,43,27,6,24,19
70,Fail,44,35,0,18,26
70,Fail,42,44,0,8,34
70,Fail,50,23,11,16,34
70,Fail,50,35,1,14,36
70,Fail,54,28,3,15,39
70,Fail,49,44,0,3,46
70,Fail,53,34,0,13,40
70,Fail,48,30,0,21,27
70,Fail,50,36,0,13,37
70,Fail,42,37,0,8,34
70,Fail,50,43,2,5,45
70,Fail,40,38,0,15,25
70,Fail,50,36,1,13,37
70,Fail,40,42,7,11,29
70,Fail,57,32,0,11,46
70,Fail,53,36,2,9,44
70,Fail,42,41,5,12,30
70,Fail,53,31,1,15,38
70,Fail,52,32,4,12,40
70,Fail,51,32,0,12,39
70,Fail,41,37,0,15,26
70,Fail,46,34,0,20,26
70,Fail,50,38,4,8,42
70,Fail,48,35,0,17,31
70,Fail,49,32,0,16,33
70,Fail,44,37,0,16,28
70,Fail,58,32,4,6,52
70,Fail,43,44,0,11,32
70,Fail,43,36,0,14,29
70,Fail,53,32,0,15,38
70,Fail,49,36,2,13,36
70,Fail,50,28,7,15,35
70,Fail,55,28,5,12,43
70,Fail,49,29,12,10,39
70,Fail,50,36,2,12,38
70,Fail,48,28,10,14,34
70,Fail,47,29,10,14,33
70,Fail,48,33,2,17,31
70,Fail,50,36,6,8,42
70,Fail,51,37,2,10,41
70,Fail,42,33,0,15,27
70,Fail,54,33,0,13,41
70,Fail,45,37,0,13,32
70,Fail,47,35,5,13,34
70,Fail,55,28,4,13,42
70,Fail,48,35,0,14,34
70,Fail,50,29,0,17,33
70,Fail,37,43,0,14,23
70,Fail,48,40,0,10,38
70,Fail,40,31,0,14,26
70,Fail,42,30,0,20,22
70,Fail,47,31,4,18,29
70,Fail,44,36,6,14,30
70,Fail,41,39,0,14,27
70,Fail,43,37,3,17,26
70,Fail,49,45,0,6,43
70,Fail,46,35,4,15,31
70,Fail,48,36,3,13,35
70,Fail,50,32,0,17,33
70,Fail,49,36,0,12,37
70,Fail,49,37,0,12,37
70,Fail,49,40,0,10,39
70,Fail,49,29,0,14,35
70,Fail,53,32,2,13,40
70,Fail,44,39,2,15,29
70,Fail,48,37,0,12,36
70,Fail,47,39,0,12,35
70,Fail,50,37,2,11,39
70,Fail,43,32,10,15,28
70,Fail,49,34,0,12,37
70,Fail,55,33,1,11,44
70,Fail,52,31,0,13,39
70,Fail,47,39,3,11,36
70,Fail,51,36,0,9,42
70,Fail,39,42,7,12,27
70,Fail,50,36,1,13,37
70,Fail,44,38,0,7,37
70,Fail,50,33,3,14,36
70,Fail,40,42,0,16,24
70,Fail,47,39,2,12,35
70,Fail,47,29,7,17,30
70,Fail,46,33,0,16,30
70,Fail,48,36,0,13,35
70,Fail,40,44,3,13,27
70,Fail,48,39,5,8,40
70,Fail,42,41,0,14,28
70,Fail,44,40,0,15,29
70,Fail,44,42,1,13,31
70,Fail,45,37,3,15,30
70,Fail,51,31,0,12,39
70,Fail,56,37,1,6,50
70,Fail,51,31,0,18,33
70,Fail,38,39,0,15,23
70,Fail,43,33,0,13,30
70,Fail,47,38,3,12,35
70,Fail,55,36,2,7,48
70,Fail,53,35,0,12,41
70,Fail,51,34,3,12,39
70,Fail,51,31,2,16,35
70,Fail,34,44,8,14,20
70,Fail,51,37,3,9,42
70,Fail,39,46,0,13,26
70,Fail,47,35,4,14,33
70,Fail,53,41,0,6,47
70,Fail,44,39,0,14,30
70,Fail,47,39,0,11,36
70,Fail,45,38,0,15,30
70,Fail,51,37,3,9,42
70,Fail,50,35,2,13,37
70,Fail,47,37,2,14,33
70,Fail,45,34,0,15,30
70,Fail,45,40,4,11,34
70,Fail,46,31,0,19,27
70,Fail,39,36,8,17,22
70,Fail,50,37,2,11,39
70,Fail,46,30,0,15,31
70,Fail,43,35,5,17,26
70,Fail,45,37,2,16,29
70,Fail,42,35,7,16,26
70,Fail,53,28,6,13,40
70,Fail,49,35,1,15,34
70,Fail,48,26,7,19,29
70,Fail,48,36,0,11,37
70,Fail,54,33,0,12,42
70,Fail,48,35,4,13,35
70,Fail,57,29,6,8,49
70,Fail,55,38,1,6,49
70,Fail,44,41,5,10,34
70,Fail,49,35,2,14,35
70,Fail,49,24,0,22,27
70,Fail,46,35,0,17,29
70,Fail,56,28,0,11,45
70,Fail,50,36,2,12,38
70,Fail,52,35,0,12,40
70,Fail,50,33,0,15,35
70,Fail,50,32,1,17,33
70,Fail,52,27,0,15,37
70,Fail,47,37,0,12,35
70,Fail,48,38,0,10,38
70,Fail,48,32,7,13,35
70,Fail,49,36,8,7,42
70,Fail,53,34,0,13,40
70,Fail,46,36,0,15,31
70,Fail,53,38,0,9,44
70,Fail,54,35,2,9,45
70,Fail,46,44,3,7,39
70,Fail,49,30,0,13,36
70,Fail,44,35,0,17,27
70,Fail,53,29,9,9,44
70,Fail,49,32,6,13,36
70,Fail,49,31,3,17,32
70,Fail,44,37,4,15,29
70,Fail,57,36,0,6,51
70,Fail,46,37,0,14,32
70,Fail,50,42,0,8,42
70,Fail,42,38,0,15,27
70,Fail,48,34,0,15,33
70,Fail,47,41,3,9,38
70,Fail,41,46,0,11,30
70,Fail,50,40,0,8,42
70,Fail,40,47,0,12,28
70,Fail,46,38,4,12,34
70,Fail,41,42,2,15,26
70,Fail,54,29,3,14,40
70,Fail,48,39,2,11,37
70,Fail,52,31,0,16,36
70,Fail,45,34,0,17,28
70,Fail,52,31,0,17,35
70,Fail,41,40,0,14,27
70,Fail,35,44,0,15,20
70,Fail,57,30,1,12,45
70,Fail,56,32,0,12,44
70,Fail,53,33,0,10,43
70,Fail,55,25,7,13,42
70,Fail,52,32,0,16,36
70,Fail,51,35,4,10,41
70,Fail,40,34,9,17,23
70,Fail,49,31,7,13,36
70,Fail,47,37,9,7,40
70,Fail,51,39,0,8,43
70,Fail,47,37,4,12,35
70,Fail,42,39,6,13,29
70,Fail,45,39,8,8,37
70,Fail,54,31,4,11,43
70,Fail,42,37,0,19,23
70,Fail,44,47,0,7,37
70,Fail,45,38,0,12,33
70,Fail,45,42,0,8,37
70,Fail,38,43,0,11,27
70,Fail,51,37,0,12,39
70,Fail,48,36,0,12,36
70,Fail,48,35,0,11,37
70,Fail,52,31,3,14,38
70,Fail,54,32,2,12,42
70,Fail,58,35,2,5,53
70,Fail,39,37,9,15,24
70,Fail,52,36,0,11,41
70,Fail,45,35,5,15,30
70,Fail,42,34,5,19,23
70,Fail,51,37,0,11,40
70,Fail,55,37,1,7,48
70,Fail,53,39,1,7,46
70,Fail,40,43,6,11,29
70,Fail,45,39,0,12,33
70,Fail,45,38,0,10,35
70,Fail,45,40,1,14,31
70,Fail,44,32,0,10,34
70,Fail,51,34,3,12,39
70,Fail,58,29,0,11,47
70,Fail,49,35,0,12,37
70,Fail,44,36,0,17,27
70,Fail,58,31,2,9,49
70,Fail,45,35,7,13,32
70,Fail,46,34,0,16,30
70,Fail,43,38,8,11,32
70,Fail,52,38,1,9,43
70,Fail,44,39,0,17,27
70,Fail,52,35,0,10,42
70,Fail,45,42,0,11,34
70,Fail,49,40,0,8,41
70,Fail,56,29,4,11,45
70,Fail,34,40,0,14,20
70,Fail,44,33,7,16,28
70,Fail,45,40,0,12,33
70,Fail,50,32,6,12,38
70,Fail,45,40,4,11,34
70,Fail,42,39,5,14,28
70,Fail,43,38,5,14,29
70,Fail,50,26,0,19,31
70,Fail,45,33,0,19,26
70,Fail,53,28,0,17,36
70,Fail,57,33,0,7,50
70,Fail,49,36,0,7,42
70,Fail,44,45,4,7,37
70,Fail,56,31,0,11,45
70,Fail,40,37,0,16,24
70,Fail,55,28,0,14,41
70,Fail,45,31,8,16,29
70,Fail,50,35,1,14,36
70,Fail,45,40,1,14,31
70,Fail,51,38,0,9,42
70,Fail,48,38,3,11,37
70,Fail,50,37,6,7,43
70,Fail,56,35,0,7,49
70,Fail,49,39,0,11,38
70,Fail,41,38,4,17,24
70,Fail,48,40,0,8,40
70,Fail,46,36,3,15,31
70,Fail,42,37,3,18,24
70,Fail,52,34,0,10,42
70,Fail,54,36,0,9,45
70,Fail,45,39,5,11,34
70,Fail,50,37,3,10,40
70,Fail,52,31,0,12,40
70,Fail,48,35,3,14,34
70,Fail,49,33,0,16,33
70,Fail,47,36,4,13,34
70,Fail,47,37,4,12,35
70,Fail,54,26,6,14,40
70,Fail,53,32,0,8,45
70,Fail,46,36,7,11,35
70,Fail,48,35,0,14,34
70,Fail,55,31,2,12,43
70,Fail,49,32,0,7,42
70,Fail,40,38,10,12,28
70,Fail,49,35,0,11,38
70,Fail,54,28,5,13,41
70,Fail,47,31,0,13,34
70,Fail,53,32,0,10,43
70,Fail,46,42,0,8,38
70,Fail,52,38,1,9,43
70,Fail,54,30,0,14,40
70,Fail,51,38,1,10,41
70,Fail,51,31,0,14,37
70,Fail,44,40,1,15,29
70,Fail,52,31,0,17,35
70,Fail,54,29,2,15,39
70,Fail,53,33,0,11,42
70,Fail,49,34,0,13,36
70,Fail,54,34,0,10,44
70,Fail,48,38,0,10,38
70,Fail,48,40,1,11,37
70,Fail,46,36,4,14,32
70,Fail,48,35,0,10,38
70,Fail,48,41,0,8,40
70,Fail,53,31,0,12,41
70,Fail,54,34,0,10,44
70,Fail,51,33,3,13,38
70,Fail,52,28,0,19,33
70,Fail,52,37,2,9,43
70,Fail,50,32,0,13,37
70,Fail,41,43,0,11,30
70,Fail,46,36,0,15,31
70,Fail,56,29,2,13,43
70,Fail,48,32,0,16,32
70,Fail,46,38,0,13,33
70,Fail,54,33,0,12,42
70,Fail,38,34,7,21,17
70,Fail,46,38,0,16,30
70,Fail,50,40,0,8,42
70,Fail,37,45,0,17,20
70,Fail,48,34,0,12,36
70,Fail,52,31,0,15,37
70,Fail,43,39,0,9,34
70,Fail,45,42,2,11,34
70,Fail,47,31,0,16,31
70,Fail,46,39,7,8,38
70,Fail,48,38,3,11,37
70,Fail,46,33,0,15,31
70,Fail,44,40,0,9,35
70,Fail,44,43,4,9,35
70,Fail,52,31,0,12,40
70,Fail,47,34,9,10,37
70,Fail,54,28,3,15,39
70,Fail,47,40,0,12,35
70,Fail,41,35,3,21,20
70,Fail,53,35,2,10,43
70,Fail,48,39,4,9,39
70,Fail,51,41,0,6,45
70,Fail,40,50,2,8,32
70,Fail,48,32,4,16,32
70,Fail,48,35,0,15,33
70,Fail,52,33,0,13,39
70,Fail,43,35,0,13,30
70,Fail,45,47,0,8,37
70,Fail,49,34,0,13,36
70,Fail,45,38,0,12,33
70,Fail,39,42,0,16,23
70,Fail,56,33,0,10,46
70,Fail,48,36,0,16,32
70,Fail,47,33,8,12,35
70,Fail,45,42,0,10,35
70,Fail,49,37,0,13,36
70,Fail,48,41,0,10,38
70,Fail,43,37,7,13,30
70,Fail,46,35,6,13,33
70,Fail,47,39,0,14,33
70,Fail,50,34,0,13,37
70,Fail,48,32,2,18,30
70,Fail,47,36,0,13,34
70,Fail,45,40,0,13,32
70,Fail,46,37,0,12,34
70,Fail,42,32,7,19,23
70,Fail,52,31,2,15,37
70,Fail,55,33,2,10,45
70,Fail,40,38,10,12,28
70,Fail,54,34,2,10,44
70,Fail,51,43,0,6,45
70,Fail,47,40,3,10,37
70,Fail,46,39,5,10,36
70,Fail,50,31,4,15,35
70,Fail,46,40,0,13,33
70,Fail,54,37,0,8,46
70,Fail,48,33,0,12,36
70,Fail,48,37,0,12,36
70,Fail,58,29,0,12,46
70,Fail,57,28,7,8,49
70,Fail,49,42,3,6,43
70,Fail,46,41,0,9,37
70,Fail,57,28,2,13,44
70,Fail,50,36,0,10,40
70,Fail,47,40,1,12,35
70,Fail,49,37,0,10,39
70,Fail,51,32,0,15,36
70,Fail,53,38,1,8,45
70,Fail,53,32,5,10,43
70,Fail,53,38,1,8,45
70,Fail,40,45,0,11,29
70,Fail,44,44,0,9,35
70,Fail,44,43,5,8,36
70,Fail,41,38,0,10,31
70,Fail,40,37,8,15,25
70,Fail,43,32,0,18,25
70,Fail,39,43,0,15,24
70,Fail,42,36,0,17,25
70,Fail,51,28,0,18,33
70,Fail,45,42,0,11,34
70,Fail,49,37,0,10,39
70,Fail,47,36,3,14,33
70,Fail,45,37,6,12,33
70,Fail,47,35,9,9,38
70,Fail,42,48,0,7,35
70,Fail,43,40,2,15,28
70,Fail,47,39,3,11,36
70,Fail,44,40,5,11,33
70,Fail,48,37,0,15,33
70,Fail,45,35,3,17,28
70,Fail,48,38,1,13,35
70,Fail,52,36,0,11,41
70,Fail,45,33,0,14,31
70,Fail,51,34,3,12,39
70,Fail,49,32,2,17,32
70,Fail,44,36,5,15,29
70,Fail,49,34,3,14,35
70,Fail,48,40,0,7,41
70,Fail,51,37,4,8,43
70,Fail,48,35,6,11,37
70,Fail,48,36,0,8,40
70,Fail,54,31,0,13,41
70,Fail,49,39,0,9,40
70,Fail,42,42,3,13,29
70,Fail,51,35,0,12,39
70,Fail,48,33,0,15,33
70,Fail,48,37,0,8,40
70,Fail,46,41,4,9,37
70,Fail,49,32,2,17,32
70,Fail,53,31,2,14,39
70,Fail,41,34,0,10,31
70,Fail,48,34,0,18,30
70,Fail,46,33,0,12,34
70,Fail,55,30,3,12,43
70,Fail,55,30,10,5,50
70,Fail,51,26,0,18,33
70,Fail,51,34,4,11,40
70,Fail,40,40,0,12,28
70,Fail,42,40,0,15,27
70,Fail,46,37,3,14,32
70,Fail,48,32,0,9,39
70,Fail,49,37,0,11,38
70,Fail,51,37,1,11,40
70,Fail,47,34,0,15,32
70,Fail,45,41,0,12,33
70,Fail,55,33,0,9,46
70,Fail,50,34,0,14,36
70,Fail,48,34,0,14,34
70,Fail,45,41,2,12,33
70,Fail,50,41,2,7,43
70,Fail,56,34,0,6,50
70,Fail,49,35,8,8,41
70,Fail,50,34,0,10,40
70,Fail,48,31,6,15,33
70,Fail,52,32,3,13,39
70,Fail,52,37,0,8,44
70,Fail,61,29,0,10,51
70,Fail,47,43,0,9,38
70,Fail,51,31,0,12,39
70,Fail,44,37,0,13,31
70,Fail,44,38,2,16,28
70,Fail,50,35,0,12,38
70,Fail,52,30,0,10,42
70,Fail,55,33,0,12,43
70,Fail,45,33,0,16,29
70,Fail,50,32,2,16,34
70,Fail,51,35,0,8,43
70,Fail,47,33,0,11,36
70,Fail,48,35,0,13,35
70,Fail,44,39,8,9,35
70,Fail,48,37,0,13,35
70,Fail,49,38,1,12,37
70,Fail,44,39,4,13,31
70,Fail,54,30,0,12,42
70,Fail,45,29,11,15,30
70,Fail,51,26,4,19,32
70,Fail,46,36,0,14,32
70,Fail,46,43,2,9,37
70,Fail,52,32,0,11,41
70,Fail,46,45,1,8,38
70,Fail,52,32,0,16,36
70,Fail,47,36,0,12,35
70,Fail,57,34,4,5,52
70,Fail,41,44,0,15,26
70,Fail,43,48,1,8,35
70,Fail,48,32,4,16,32
70,Fail,44,35,6,15,29
70,Fail,49,30,0,13,36
70,Fail,54,29,7,10,44
70,Fail,46,38,4,12,34
70,Fail,49,34,5,12,37
70,Fail,57,22,7,14,43
70,Fail,52,36,0,11,41
70,Fail,44,36,0,11,33
70,Fail,45,45,0,9,36
70,Fail,41,47,0,8,33
70,Fail,44,34,0,16,28
70,Fail,38,46,0,13,25
70,Fail,50,36,0,13,37
70,Fail,46,37,0,12,34
70,Fail,39,39,1,21,18
70,Fail,53,34,0,10,43
70,Fail,50,33,3,14,36
70,Fail,48,39,0,13,35
70,Fail,55,21,9,15,40
70,Fail,41,41,3,15,26
70,Fail,49,34,0,10,39
70,Fail,41,37,3,19,22
70,Fail,48,33,5,14,34
70,Fail,54,31,2,13,41
70,Fail,57,32,2,9,48
70,Fail,44,30,10,16,28
70,Fail,48,26,12,14,34
70,Fail,42,38,7,13,29
70,Fail,48,30,0,17,31
70,Fail,45,38,0,15,30
70,Fail,50,36,0,10,40
70,Fail,46,37,5,12,34
70,Fail,45,33,10,12,33
70,Fail,45,38,3,14,31
70,Fail,56,34,0,5,51
70,Fail,52,37,1,10,42
70,Fail,54,33,0,12,42
70,Fail,49,34,4,13,36
70,Fail,52,33,0,8,44
70,Fail,48,34,5,13,35
70,Fail,46,38,0,11,35
70,Fail,50,39,0,11,39
70,Fail,50,31,0,15,35
70,Fail,49,37,1,13,36
70,Fail,49,32,3,16,33
70,Fail,41,35,0,18,23
70,Fail,54,36,0,9,45
70,Fail,49,28,0,20,29
70,Fail,46,39,3,12,34
70,Fail,53,32,0,14,39
70,Fail,50,39,0,9,41
70,Fail,46,36,6,12,34
70,Fail,50,32,0,12,38
70,Fail,50,32,3,15,35
70,Fail,53,33,5,9,44
70,Fail,61,33,0,4,57
70,Fail,56,28,8,8,48
70,Fail,40,37,0,9,31
70,Fail,52,32,4,12,40
70,Fail,52,35,0,12,40
70,Fail,50,37,3,10,40
70,Fail,50,36,5,9,41
70,Fail,48,42,0,8,40
70,Fail,50,33,0,14,36
70,Fail,53,35,0,12,41
70,Fail,48,40,0,6,42
70,Fail,48,33,0,9,39
70,Fail,49,38,4,9,40
70,Fail,45,32,0,12,33
70,Fail,49,34,1,16,33
70,Fail,44,30,16,10,34
70,Fail,52,30,0,14,38
70,Fail,44,36,6,14,30
70,Fail,59,27,4,10,49
70,Fail,48,41,0,11,37
70,Fail,51,36,0,12,39
70,Fail,47,33,6,14,33
70,Fail,56,31,0,12,44
70,Fail,51,31,0,15,36
70,Fail,49,34,0,13,36
70,Fail,48,33,3,16,32
70,Fail,46,39,0,14,32
70,Fail,48,39,0,11,37
70,Fail,45,37,0,16,29
70,Fail,47,34,0,9,38
70,Fail,44,37,2,17,27
70,Fail,50,33,4,13,37
70,Fail,47,30,0,13,34
70,Fail,48,36,0,9,39
70,Fail,44,27,0,20,24
70,Fail,47,33,0,15,32
70,Fail,41,37,5,17,24
70,Fail,47,34,3,16,31
70,Fail,52,35,0,10,42
70,Fail,45,39,0,10,35
70,Fail,50,28,7,15,35
70,Fail,46,35,0,15,31
70,Fail,40,36,7,17,23
70,Fail,47,39,0,13,34
70,Fail,49,34,3,14,35
70,Fail,52,35,0,12,40
70,Fail,43,36,9,12,31
70,Fail,49,32,0,15,34
70,Fail,42,31,0,22,20
70,Fail,43,39,0,16,27
70,Fail,47,32,0,13,34
70,Fail,60,30,0,9,51
70,Fail,52,39,0,9,43
70,Fail,52,33,3,12,40
70,Fail,48,36,0,11,37
70,Fail,45,38,0,11,34
70,Fail,48,35,5,12,36
70,Fail,48,32,0,16,32
70,Fail,50,35,1,14,36
70,Fail,55,37,0,8,47
70,Fail,47,42,0,8,39
70,Fail,46,41,0,11,35
70,Fail,50,34,0,14,36
70,Fail,40,39,0,13,27
70,Fail,56,33,0,10,46
70,Fail,57,29,0,10,47
70,Fail,42,35,0,14,28
70,Fail,43,37,3,17,26
70,Fail,52,38,1,9,43
70,Fail,48,42,0,8,40
70,Fail,44,37,3,16,28
70,Fail,37,36,0,22,15
70,Fail,47,33,7,13,34
70,Fail,41,32,11,16,25
70,Fail,54,34,0,8,46
70,Fail,51,40,1,8,43
70,Fail,49,30,0,17,32
70,Fail,56,33,0,10,46
70,Fail,39,47,6,8,31
70,Fail,52,37,0,5,47
70,Fail,43,39,5,13,30
70,Fail,47,34,6,13,34
70,Fail,48,25,0,14,34
70,Fail,48,36,0,13,35
70,Fail,46,31,0,19,27
70,Fail,53,32,0,15,38
70,Fail,45,31,9,15,30
70,Fail,49,29,0,12,37
70,Fail,46,38,0,13,33
70,Fail,44,41,0,9,35
70,Fail,40,40,8,12,28
70,Fail,47,37,4,12,35
70,Fail,42,37,0,16,26
70,Fail,48,35,0,16,32
70,Fail,47,36,0,14,33
70,Fail,54,37,3,6,48
70,Fail,49,39,0,11,38
70,Fail,55,38,0,7,48
70,Fail,39,35,0,21,18
70,Fail,47,39,3,11,36
70,Fail,43,33,0,19,24
70,Fail,46,36,2,16,30
70,Fail,57,29,0,14,43
70,Fail,48,31,9,12,36
70,Fail,48,36,0,11,37
70,Fail,45,44,0,9,36
70,Fail,49,36,0,12,37
70,Fail,53,39,0,7,46
70,Fail,50,38,1,11,39
70,Fail,41,48,0,10,31
70,Fail,44,43,2,11,33
70,Fail,49,36,5,10,39
70,Fail,42,43,7,8,34
70,Fail,51,33,4,12,39
70,Fail,41,37,6,16,25
70,Fail,45,30,0,15,30
70,Fail,51,36,3,10,41
70,Fail,45,39,2,14,31
70,Fail,54,35,0,9,45
70,Fail,50,34,0,13,37
70,Fail,52,33,1,14,38
70,Fail,52,35,1,12,40
70,Fail,47,36,0,15,32
70,Fail,48,31,0,17,31
70,Fail,46,41,4,9,37
70,Fail,50,38,1,11,39
70,Fail,38,36,0,16,22
70,Fail,56,31,0,9,47
70,Fail,55,29,0,11,44
70,Fail,44,36,2,18,26
70,Fail,50,35,0,13,37
70,Fail,46,34,7,13,33
70,Fail,53,30,6,11,42
70,Fail,44,36,0,16,28
70,Fail,50,32,0,12,38
70,Fail,48,32,6,14,34
70,Fail,43,38,0,13,30
70,Fail,50,33,0,9,41
70,Fail,53,37,1,9,44
70,Fail,49,38,0,9,40
70,Fail,43,36,0,12,31
70,Fail,44,36,7,13,31
70,Fail,50,35,1,14,36
70,Fail,47,33,0,14,33
70,Fail,52,34,4,10,42
70,Fail,52,38,0,6,46
70,Fail,47,40,0,12,35
70,Fail,41,40,0,13,28
70,Fail,44,42,0,12,32
70,Fail,51,29,7,13,38
70,Fail,51,32,0,12,39
70,Fail,48,41,0,11,37
70,Fail,38,39,6,17,21
70,Fail,38,42,0,15,23
70,Fail,43,30,7,20,23
70,Fail,48,36,7,9,39
70,Fail,54,35,0,9,45
70,Fail,45,44,2,9,36
70,Fail,49,36,0,12,37
70,Fail,51,36,0,12,39
70,Fail,49,41,1,9,40
70,Fail,43,40,0,14,29
70,Fail,46,33,7,14,32
70,Fail,54,33,0,12,42
70,Fail,53,30,6,11,42
70,Fail,52,30,5,13,39
70,Fail,50,35,2,13,37
70,Fail,44,37,6,13,31
70,Fail,46,35,0,15,31
70,Fail,57,31,2,10,47
70,Fail,54,35,0,11,43
70,Fail,40,40,0,14,26
70,Fail,52,42,0,6,46
70,Fail,54,35,1,10,44
70,Fail,43,45,3,9,34
70,Fail,48,39,0,12,36
70,Fail,50,32,5,13,37
70,Fail,45,34,6,15,30
70,Fail,48,37,3,12,36
70,Fail,39,46,0,13,26
70,Fail,47,36,0,15,32
70,Fail,45,39,1,15,30
70,Fail,41,42,0,12,29
70,Fail,44,40,2,14,30
70,Fail,46,33,0,19,27
70,Fail,53,33,6,8,45
70,Fail,50,38,0,12,38
70,Fail,48,37,0,10,38
70,Fail,46,38,0,9,37
70,Fail,49,33,0,12,37
70,Fail,41,39,4,16,25
70,Fail,47,41,0,9,38
70,Fail,52,34,3,11,41
70,Fail,50,30,2,18,32
70,Fail,48,41,1,10,38
70,Fail,50,37,1,12,38
70,Fail,43,37,0,11,32
70,Fail,49,35,0,7,42
70,Fail,44,39,5,12,32
70,Fail,41,36,0,16,25
70,Fail,49,33,0,11,38
70,Fail,44,44,0,12,32
70,Fail,50,32,0,17,33
70,Fail,45,39,6,10,35
70,Fail,45,29,0,24,21
70,Fail,48,40,0,10,38
70,Fail,50,34,0,10,40
70,Fail,46,35,0,11,35
70,Fail,52,31,0,15,37
70,Fail,46,39,1,14,32
70,Fail,50,39,4,7,43
70,Fail,49,37,3,11,38
70,Fail,45,32,11,12,33
70,Fail,56,35,1,8,48
70,Fail,36,45,6,13,23
70,Fail,43,41,0,16,27
70,Fail,53,32,3,12,41
70,Fail,45,40,3,12,33
70,Fail,47,31,11,11,36
70,Fail,45,42,0,12,33
70,Fail,48,37,1,14,34
70,Fail,50,35,0,11,39
70,Fail,41,31,9,19,22
70,Fail,44,42,0,8,36
70,Fail,42,35,0,18,24
70,Fail,48,27,6,19,29
70,Fail,49,33,0,15,34
70,Fail,39,43,0,14,25
70,Fail,46,34,4,16,30
70,Fail,39,36,14,11,28
70,Fail,55,28,3,14,41
70,Fail,45,31,0,22,23
70,Fail,48,29,7,16,32
70,Fail,44,36,0,14,30
70,Fail,50,39,0,10,40
70,Fail,51,36,0,12,39
70,Fail,45,44,2,9,36
70,Fail,52,33,0,10,42
70,Fail,42,39,0,16,26
70,Fail,49,35,0,12,37
70,Fail,48,40,0,11,37
70,Fail,49,32,3,16,33
70,Fail,44,34,0,17,27
70,Fail,60,29,0,9,51
70,Fail,48,36,2,14,34
70,Fail,45,38,6,11,34
70,Fail,44,39,6,11,33
70,Fail,43,46,3,8,35
70,Fail,40,34,10,16,24
70,Fail,47,33,0,16,31
70,Fail,44,40,0,10,34
70,Fail,44,35,3,18,26
70,Fail,48,34,0,13,35
70,Fail,46,25,14,15,31
70,Fail,42,44,6,8,34
70,Fail,38,37,0,17,21
70,Fail,49,36,1,14,35
70,Fail,48,40,0,11,37
70,Fail,55,31,6,8,47
70,Fail,46,41,0,13,33
70,Fail,46,38,0,15,31
70,Fail,43,28,8,21,22
70,Fail,50,38,2,10,40
70,Fail,48,39,0,12,36
70,Fail,40,36,0,19,21
70,Fail,41,36,5,18,23
70,Fail,51,35,1,13,38
70,Fail,53,38,1,8,45
70,Fail,46,36,0,17,29
70,Fail,53,33,0,11,42
70,Fail,41,36,0,17,24
70,Fail,47,33,5,15,32
70,Fail,52,37,0,10,42
70,Fail,47,35,6,12,35
70,Fail,52,35,1,12,40
70,Fail,47,34,0,8,39
70,Fail,48,34,0,12,36
70,Fail,53,26,7,14,39
70,Fail,52,36,0,11,41
70,Fail,45,36,9,10,35
70,Fail,52,33,4,11,41
70,Fail,49,37,0,10,39
70,Fail,49,39,0,12,37
70,Fail,52,33,0,14,38
70,Fail,51,39,3,7,44
70,Fail,44,37,6,13,31
70,Fail,45,37,0,16,29
70,Fail,53,32,1,14,39
70,Fail,47,35,2,16,31
70,Fail,47,32,0,16,31
70,Fail,51,29,0,14,37
70,Fail,48,39,0,12,36
70,Fail,54,23,5,18,36
70,Fail,46,36,0,9,37
70,Fail,43,46,0,11,32
70,Fail,52,39,0,9,43
70,Fail,44,35,5,16,28
70,Fail,54,34,1,11,43
70,Fail,49,33,0,12,37
70,Fail,37,36,0,15,22
70,Fail,46,34,0,15,31
70,Fail,54,33,0,13,41
70,Fail,54,32,3,11,43
70,Fail,56,37,0,7,49
70,Fail,44,39,3,14,30
70,Fail,52,34,0,7,45
70,Fail,41,42,3,14,27
70,Fail,52,39,0,6,46
70,Fail,47,33,4,16,31
70,Fail,50,35,2,13,37
70,Fail,57,32,0,10,47
70,Fail,53,34,4,9,44
70,Fail,55,35,1,9,46
70,Fail,48,34,0,15,33
70,Fail,49,31,2,18,31
70,Fail,45,41,3,11,34
70,Fail,46,35,5,14,32
70,Fail,50,40,0,10,40
70,Fail,45,37,0,13,32
70,Fail,43,37,10,10,33
70,Fail,43,38,6,13,30
70,Fail,46,35,8,11,35
70,Fail,51,31,1,17,34
70,Fail,56,37,0,5,51
70,Fail,48,40,1,11,37
70,Fail,50,36,4,10,40
70,Fail,58,33,1,8,50
70,Fail,56,31,0,12,44
70,Fail,46,32,0,14,32
70,Fail,55,34,1,10,45
70,Fail,47,30,17,6,41
70,Fail,44,33,0,18,26
70,Fail,49,39,0,9,40
70,Fail,44,31,0,18,26
70,Fail,45,39,0,12,33
70,Fail,38,34,10,18,20
70,Fail,44,40,2,14,30
70,Fail,42,39,0,16,26
70,Fail,49,34,6,11,38
70,Fail,48,33,0,14,34
70,Fail,41,38,5,16,25
70,Fail,50,32,0,10,40
70,Fail,49,38,0,10,39
70,Fail,47,37,3,13,34
70,Fail,37,36,0,20,17
70,Fail,46,33,9,12,34
70,Fail,40,42,0,18,22
70,Fail,50,33,0,13,37
70,Fail,44,40,2,14,30
70,Fail,45,37,5,13,32
70,Fail,55,30,3,12,43
70,Fail,45,40,6,9,36
70,Fail,53,33,3,11,42
70,Fail,42,33,8,17,25
70,Fail,51,36,0,11,40
70,Fail,54,28,3,15,39
70,Fail,57,31,0,11,46
70,Fail,49,33,1,17,32
70,Fail,45,44,0,9,36
70,Fail,49,31,2,18,31
70,Fail,44,36,0,10,34
70,Fail,44,35,8,13,31
70,Fail,52,41,0,6,46
70,Fail,44,41,1,14,30
70,Fail,48,40,0,8,40
70,Fail,51,29,5,15,36
70,Fail,50,35,0,11,39
70,Fail,48,34,0,16,32
70,Fail,50,43,0,6,44
70,Fail,41,33,9,17,24
70,Fail,47,38,0,15,32
70,Fail,51,36,4,9,42
70,Fail,45,43,1,11,34
70,Fail,48,36,0,16,32
70,Fail,52,33,0,15,37
70,Fail,47,32,0,16,31
70,Fail,53,26,0,10,43
70,Fail,46,27,0,17,29
70,Fail,40,35,7,18,22
70,Fail,49,44,3,4,45
70,Fail,45,35,4,16,29
70,Fail,47,32,0,16,31
70,Fail,52,39,0,9,43
70,Fail,51,31,0,14,37
70,Fail,51,33,7,9,42
70,Fail,51,33,7,9,42
70,Fail,53,33,5,9,44
70,Fail,36,47,7,10,26
70,Fail,47,36,5,12,35
70,Fail,47,39,0,10,37
70,Fail,50,38,0,12,38
70,Fail,50,33,0,8,42
70,Fail,35,43,0,19,16
70,Fail,43,35,9,13,30
70,Fail,55,27,0,16,39
70,Fail,50,40,0,10,40
70,Fail,48,38,4,10,38
70,Fail,51,29,0,15,36
70,Fail,51,36,0,11,40
70,Fail,48,35,0,17,31
70,Fail,45,38,0,10,35
70,Fail,36,40,11,13,23
70,Fail,42,44,0,12,30
70,Fail,45,38,0,15,30
70,Fail,48,39,0,11,37
70,Fail,55,31,0,14,41
70,Fail,52,35,0,13,39
70,Fail,55,36,0,7,48
70,Fail,46,39,0,12,34
70,Fail,42,42,0,15,27
70,Fail,34,42,0,17,17
70,Fail,48,31,0,11,37
70,Fail,46,35,2,17,29
70,Fail,51,31,0,16,35
70,Fail,42,34,0,15,27
70,Fail,55,31,4,10,45
70,Fail,43,34,0,17,26
70,Fail,45,33,7,15,30
70,Fail,40,41,0,18,22
70,Fail,48,30,0,18,30
70,Fail,46,29,0,19,27
70,Fail,45,35,12,8,37
70,Fail,46,42,0,9,37
70,Fail,52,31,0,10,42
70,Fail,62,28,1,9,53
70,Fail,55,35,1,9,46
70,Fail,47,41,1,11,36
70,Fail,45,36,0,13,32
70,Fail,52,39,0,9,43
70,Fail,48,34,3,15,33
70,Fail,54,31,1,14,40
70,Fail,41,43,0,12,29
70,Fail,51,35,0,13,38
70,Fail,53,34,0,12,41
70,Fail,53,39,2,6,47
70,Fail,44,40,0,15,29
70,Fail,44,27,13,16,28
70,Fail,47,33,4,16,31
70,Fail,58,26,2,14,44
70,Fail,42,36,10,12,30
70,Fail,54,37,0,7,47
70,Fail,49,38,0,11,38
70,Fail,43,39,0,10,33
70,Fail,45,39,1,15,30
70,Fail,45,41,0,14,31
70,Fail,47,37,0,12,35
70,Fail,51,34,7,8,43
70,Fail,44,30,0,12,32
70,Fail,52,31,4,13,39
70,Fail,51,32,1,16,35
70,Fail,44,38,2,16,28
70,Fail,57,33,0,9,48
70,Fail,40,32,11,17,23
70,Fail,49,31,1,19,30
70,Fail,48,36,2,14,34
70,Fail,52,35,0,13,39
70,Fail,49,34,0,12,37
70,Fail,44,44,3,9,35
70,Fail,42,35,7,16,26
70,Fail,39,48,0,3,36
70,Fail,51,35,3,11,40
70,Fail,50,34,8,8,42
70,Fail,50,39,0,8,42
70,Fail,50,35,1,14,36
70,Fail,48,31,4,17,31
70,Fail,45,34,0,16,29
70,Fail,49,33,3,15,34
70,Fail,48,33,5,14,34
70,Fail,52,32,3,13,39
70,Fail,51,31,3,15,36
70,Fail,53,35,0,7,46
70,Fail,46,43,0,9,37
70,Fail,40,46,5,9,31
70,Fail,54,37,0,9,45
70,Fail,43,36,3,18,25
70,Fail,54,28,6,12,42
70,Fail,46,22,0,21,25
70,Fail,46,37,0,14,32
70,Fail,41,38,9,12,29
70,Fail,42,43,0,13,29
70,Fail,48,37,7,8,40
70,Fail,47,36,5,12,35
70,Fail,49,32,3,16,33
70,Fail,48,37,2,13,35
70,Fail,45,40,4,11,34
70,Fail,52,34,0,14,38
70,Fail,51,30,0,12,39
70,Fail,51,34,0,15,36
70,Fail,53,36,0,9,44
70,Fail,45,38,0,16,29
70,Fail,47,34,0,17,30
70,Fail,51,31,3,15,36
70,Fail,49,37,1,13,36
70,Fail,48,36,0,15,33
70,Fail,42,41,4,13,29
70,Fail,48,36,0,15,33
70,Fail,43,36,0,19,24
70,Fail,51,36,1,12,39
70,Fail,42,43,1,14,28
70,Fail,44,43,0,12,32
70,Fail,53,36,0,10,43
70,Fail,50,32,0,13,37
70,Fail,47,39,2,12,35
70,Fail,49,33,0,18,31
70,Fail,44,40,2,14,30
70,Fail,56,30,0,14,42
70,Fail,44,40,3,13,31
70,Fail,47,37,1,15,32
70,Fail,42,35,8,15,27
70,Fail,56,32,0,10,46
70,Fail,46,38,0,12,34
70,Fail,50,29,0,16,34
70,Fail,41,39,8,12,29
70,Fail,52,36,0,8,44
70,Fail,45,42,1,12,33
70,Fail,42,32,10,16,26
70,Fail,45,39,4,12,33
70,Fail,43,30,0,15,28
70,Fail,52,36,2,10,42
70,Fail,47,33,10,10,37
70,Fail,44,40,0,10,34
70,Fail,58,30,0,10,48
70,Fail,52,39,0,8,44
70,Fail,50,39,0,11,39
70,Fail,53,32,0,14,39
70,Fail,46,34,4,16,30
70,Fail,48,37,0,11,37
70,Fail,46,40,2,12,34
70,Fail,50,39,0,10,40
70,Fail,54,29,2,15,39
70,Fail,53,26,0,13,40
70,Fail,50,37,2,11,39
70,Fail,52,38,0,7,45
70,Fail,49,38,0,7,42
70,Fail,47,29,0,22,25
70,Fail,43,40,0,16,27
70,Fail,51,34,1,14,37
70,Fail,39,32,15,14,25
70,Fail,46,36,6,12,34
70,Fail,39,44,9,8,31
70,Fail,47,31,0,15,32
70,Fail,45,44,0,7,38
70,Fail,53,35,2,10,43
70,Fail,60,23,5,12,48
70,Fail,43,40,8,9,34
70,Fail,52,36,3,9,43
70,Fail,40,37,3,20,20
70,Fail,50,39,3,8,42
70,Fail,52,34,5,9,43
70,Fail,60,31,0,8,52
70,Fail,57,31,0,10,47
70,Fail,52,39,1,8,44
70,Fail,49,32,0,14,35
70,Fail,44,38,0,12,32
70,Fail,51,39,1,9,42
70,Fail,54,32,1,13,41
70,Fail,52,33,0,11,41
70,Fail,47,42,0,7,40
70,Fail,41,37,0,20,21
70,Fail,45,41,0,10,35
70,Fail,50,34,0,13,37
70,Fail,44,35,12,9,35
70,Fail,43,45,0,7,36
70,Fail,52,37,0,9,43
70,Fail,48,35,8,9,39
70,Fail,58,30,0,10,48
70,Fail,51,34,0,13,38
70,Fail,46,35,7,12,34
70,Fail,49,40,3,8,41
70,Fail,55,34,0,11,44
70,Fail,45,34,3,18,27
70,Fail,46,33,10,11,35
70,Fail,47,35,1,17,30
70,Fail,48,30,10,12,36
70,Fail,39,37,0,18,21
70,Fail,45,42,1,12,33
70,Fail,60,35,1,4,56
70,Fail,42,43,2,13,29
70,Fail,52,33,0,14,38
70,Fail,45,38,4,13,32
70,Fail,52,29,6,13,39
70,Fail,51,33,5,11,40
70,Fail,55,34,0,8,47
70,Fail,42,33,0,18,24
70,Fail,43,43,0,8,35
70,Fail,41,39,0,13,28
70,Fail,41,41,0,16,25
70,Fail,48,34,1,17,31
70,Fail,47,38,2,13,34
70,Fail,52,41,0,7,45
70,Fail,42,37,6,15,27
70,Fail,45,35,4,16,29
70,Fail,49,36,7,8,41
70,Fail,46,32,7,15,31
70,Fail,46,46,4,4,42
70,Fail,47,30,0,15,32
70,Fail,49,36,0,14,35
70,Fail,41,42,0,10,31
70,Fail,48,40,0,9,39
70,Fail,51,37,3,9,42
70,Fail,50,39,4,7,43
70,Fail,47,35,0,10,37
70,Fail,45,42,0,12,33
70,Fail,54,32,6,8,46
70,Fail,49,36,0,8,41
70,Fail,50,37,1,12,38
70,Fail,34,42,12,12,22
70,Fail,53,36,0,10,43
70,Fail,57,29,4,10,47
70,Fail,51,33,3,13,38
70,Fail,47,34,0,16,31
70,Fail,48,28,12,12,36
70,Fail,40,40,0,13,27
70,Fail,43,39,0,15,28
70,Fail,47,31,7,15,32
70,Fail,43,43,0,13,30
70,Fail,43,35,4,18,25
70,Fail,54,35,0,11,43
70,Fail,54,33,0,9,45
70,Fail,46,38,8,8,38
70,Fail,40,39,0,16,24
70,Fail,59,28,6,7,52
70,Fail,55,31,0,14,41
70,Fail,46,36,3,15,31
70,Fail,43,44,3,10,33
70,Fail,43,40,5,12,31
70,Fail,43,37,0,17,26
70,Fail,51,31,0,14,37
70,Fail,50,34,8,8,42
70,Fail,55,28,7,10,45
70,Fail,49,38,0,11,38
70,Fail,39,43,0,11,28
70,Fail,55,33,2,10,45
70,Fail,50,39,0,10,40
70,Fail,44,33,4,19,25
70,Fail,43,37,0,15,28
70,Fail,42,36,0,13,29
70,Fail,51,40,0,9,42
70,Fail,43,34,5,18,25
70,Fail,52,33,2,13,39
70,Fail,41,40,4,15,26
70,Fail,43,35,0,9,34
70,Fail,49,31,8,12,37
70,Fail,45,39,1,15,30
70,Fail,46,40,0,10,36
70,Fail,52,37,0,10,42
70,Fail,47,38,0,12,35
70,Fail,50,35,0,11,39
70,Fail,45,40,0,10,35
70,Fail,51,26,7,16,35
70,Fail,46,36,4,14,32
70,Fail,47,34,4,15,32
70,Fail,48,35,0,13,35
70,Fail,48,40,1,11,37
70,Fail,49,40,0,11,38
70,Fail,46,40,0,9,37
70,Fail,50,38,0,11,39
70,Fail,47,35,4,14,33
70,Fail,55,36,4,5,50
70,Fail,50,34,8,8,42
70,Fail,45,42,0,10,35
70,Fail,51,39,3,7,44
70,Fail,55,33,0,7,48
70,Fail,41,42,2,15,26
70,Fail,55,37,1,7,48
70,Fail,47,35,0,8,39
70,Fail,51,30,0,16,35
70,Fail,51,34,2,13,38
70,Fail,52,37,0,7,45
70,Fail,55,35,0,7,48
70,Fail,54,36,0,8,46
70,Fail,44,37,0,16,28
70,Fail,53,29,0,13,40
70,Fail,52,32,0,8,44
70,Fail,49,32,5,14,35
70,Fail,41,41,0,13,28
70,Fail,42,39,0,11,31
70,Fail,55,31,0,8,47
70,Fail,49,32,0,14,35
70,Fail,46,34,0,16,30
70,Fail,53,33,0,9,44
70,Fail,55,28,0,12,43
70,Fail,50,33,6,11,39
70,Fail,49,39,1,11,38
70,Fail,39,36,0,21,18
70,Fail,52,36,1,11,41
70,Fail,45,32,11,12,33
70,Fail,42,45,2,11,31
70,Fail,52,30,0,15,37
70,Fail,44,32,6,18,26
70,Fail,49,36,1,14,35
70,Fail,56,29,4,11,45
70,Fail,46,39,0,12,34
70,Fail,46,34,0,19,27
70,Fail,42,46,1,11,31
70,Fail,42,33,0,21,21
70,Fail,49,38,3,10,39
70,Fail,43,30,0,15,28
70,Fail,47,35,4,14,33
70,Fail,46,37,0,13,33
70,Fail,46,40,3,11,35
70,Fail,45,36,0,14,31
70,Fail,50,35,0,13,37
70,Fail,55,24,0,13,42
70,Fail,46,31,0,12,34
70,Fail,44,40,0,10,34
70,Fail,46,33,0,16,30
70,Fail,44,33,0,15,29
70,Fail,51,37,1,11,40
70,Fail,52,36,0,8,44
70,Fail,49,34,3,14,35
70,Fail,49,32,7,12,37
70,Fail,51,25,5,19,32
70,Fail,47,34,4,15,32
70,Fail,46,37,0,17,29
70,Fail,51,35,0,11,40
70,Fail,44,36,0,18,26
70,Fail,43,44,7,6,37
70,Fail,48,29,7,16,32
70,Fail,44,38,0,15,29
70,Fail,51,35,0,11,40
70,Fail,51,35,0,14,37
70,Fail,45,30,12,13,32
70,Fail,47,40,3,10,37
70,Fail,43,37,7,13,30
70,Fail,44,30,10,16,28
70,Fail,50,39,2,9,41
70,Fail,50,34,0,12,38
70,Fail,45,25,0,17,28
70,Fail,56,29,0,9,47
70,Fail,42,40,0,14,28
70,Fail,50,33,11,6,44
70,Fail,47,33,2,18,29
70,Fail,48,37,0,13,35
70,Fail,53,32,1,14,39
70,Fail,49,33,0,14,35
70,Fail,53,35,5,7,46
70,Fail,51,33,0,14,37
70,Fail,52,35,0,9,43
70,Fail,44,32,6,18,26
70,Fail,56,30,0,10,46
70,Fail,60,31,0,8,52
70,Fail,50,36,3,11,39
70,Fail,57,28,3,12,45
70,Fail,47,39,3,11,36
70,Fail,49,39,3,9,40
70,Fail,36,46,6,12,24
70,Fail,44,35,3,18,26
70,Fail,41,29,11,19,22
70,Fail,43,37,11,9,34
70,Fail,44,38,0,13,31
70,Fail,43,41,0,13,30
70,Fail,54,31,5,10,44
70,Fail,51,34,0,14,37
70,Fail,53,27,4,16,37
70,Fail,50,30,0,19,31
70,Fail,46,33,8,13,33
70,Fail,51,32,0,14,37
70,Fail,52,36,2,10,42
70,Fail,46,43,2,9,37
70,Fail,49,27,3,21,28
70,Fail,44,37,0,18,26
70,Fail,59,30,0,11,48
70,Fail,42,35,0,14,28
70,Fail,39,41,0,19,20
70,Fail,40,39,0,15,25
70,Fail,45,31,0,19,26
70,Fail,44,36,0,14,30
70,Fail,46,37,0,13,33
70,Fail,41,35,9,15,26
70,Fail,52,33,0,8,44
70,Fail,52,34,0,13,39
70,Fail,53,39,0,8,45
70,Fail,38,42,10,10,28
70,Fail,50,33,3,14,36
70,Fail,52,29,3,16,36
70,Fail,43,42,0,13,30
70,Fail,41,44,0,13,28
70,Fail,46,34,0,14,32
70,Fail,52,26,8,14,38
70,Fail,47,30,0,18,29
70,Fail,45,40,1,14,31
70,Fail,50,36,0,9,41
70,Fail,55,33,2,10,45
70,Fail,47,31,0,14,33
70,Fail,52,37,0,11,41
70,Fail,41,41,0,15,26
70,Fail,48,33,0,16,32
70,Fail,49,41,1,9,40
70,Fail,48,45,0,7,41
70,Fail,53,31,2,14,39
70,Fail,53,32,6,9,44
70,Fail,41,34,0,19,22
70,Fail,51,31,2,16,35
70,Fail,53,30,5,12,41
70,Fail,53,28,0,17,36
70,Fail,46,38,0,14,32
70,Fail,48,41,0,9,39
70,Fail,55,27,0,11,44
70,Fail,45,39,0,11,34
70,Fail,45,38,0,15,30
70,Fail,48,41,3,8,40
70,Fail,42,42,1,15,27
70,Fail,40,41,5,14,26
70,Fail,44,42,0,13,31
70,Fail,54,32,4,10,44
70,Fail,57,30,0,11,46
70,Fail,47,37,0,10,37
70,Fail,52,36,0,12,40
70,Fail,57,30,0,10,47
70,Fail,49,42,0,9,40
70,Fail,51,30,7,12,39
70,Fail,54,28,0,12,42
70,Fail,48,31,0,18,30
70,Fail,53,30,0,13,40
70,Fail,42,34,0,20,22
70,Fail,48,31,0,11,37
70,Fail,41,44,0,9,32
70,Fail,50,35,0,10,40
70,Fail,37,29,0,19,18
70,Fail,51,38,3,8,43
70,Fail,42,33,0,16,26
70,Fail,47,33,0,18,29
70,Fail,53,26,9,12,41
70,Fail,52,36,0,11,41
70,Fail,38,33,9,20,18
70,Fail,46,28,0,16,30
70,Fail,48,36,0,8,40
70,Fail,43,43,1,13,30
70,Fail,51,35,2,12,39
70,Fail,48,29,0,18,30
70,Fail,53,31,0,16,37
70,Fail,48,41,0,11,37
70,Fail,50,29,0,21,29
70,Fail,52,30,0,15,37
70,Fail,49,29,4,18,31
70,Fail,52,31,0,8,44
70,Fail,56,28,0,12,44
70,Fail,44,36,6,14,30
70,Fail,48,31,9,12,36
70,Fail,53,30,9,8,45
70,Fail,51,29,8,12,39
70,Fail,54,30,1,15,39
70,Fail,52,36,3,9,43
70,Fail,38,42,0,13,25
70,Fail,50,33,5,12,38
70,Fail,45,39,1,15,30
70,Fail,47,37,3,13,34
70,Fail,57,35,0,6,51
70,Fail,50,39,0,11,39
70,Fail,45,28,0,21,24
70,Fail,48,31,9,12,36
70,Fail,51,31,1,17,34
70,Fail,49,39,0,11,38
70,Fail,50,33,6,11,39
70,Fail,45,37,0,13,32
70,Fail,48,41,0,11,37
70,Fail,46,39,0,13,33
70,Fail,47,32,6,15,32
70,Fail,45,36,0,16,29
70,Fail,51,31,3,15,36
70,Fail,50,33,0,14,36
70,Fail,48,39,0,13,35
70,Fail,56,38,0,5,51
70,Fail,54,28,0,12,42
70,Fail,47,42,0,10,37
70,Fail,45,43,4,8,37
70,Fail,42,36,8,14,28
70,Fail,49,35,0,12,37
70,Fail,40,41,4,15,25
70,Fail,51,29,3,17,34
70,Fail,43,34,0,6,37
70,Fail,50,35,0,11,39
70,Fail,50,28,0,17,33
70,Fail,52,34,0,11,41
70,Fail,56,25,1,18,38
70,Fail,43,39,2,16,27
70,Fail,52,32,0,9,43
70,Fail,42,44,0,11,31
70,Fail,45,38,1,16,29
70,Fail,44,38,0,14,30
70,Fail,51,34,0,13,38
70,Fail,44,34,9,13,31
70,Fail,48,37,0,10,38
70,Fail,44,32,0,17,27
70,Fail,43,37,0,15,28
70,Fail,51,38,0,11,40
70,Fail,47,33,0,13,34
70,Fail,44,36,6,14,30
70,Fail,51,35,3,11,40
70,Fail,48,35,0,16,32
70,Fail,53,34,4,9,44
70,Fail,51,32,3,14,37
70,Fail,54,38,3,5,49
70,Fail,49,34,3,14,35
70,Fail,36,40,9,15,21
70,Fail,45,43,0,12,33
70,Fail,45,40,0,11,34
70,Fail,43,44,3,10,33
70,Fail,51,39,4,6,45
70,Fail,43,42,2,13,30
70,Fail,47,44,1,8,39
70,Fail,53,34,0,11,42
70,Fail,52,31,2,15,37
70,Fail,47,32,0,16,31
70,Fail,49,40,0,11,38
70,Fail,43,29,0,18,25
70,Fail,53,35,0,12,41
70,Fail,45,37,0,13,32
70,Fail,52,33,3,12,40
70,Fail,49,31,7,13,36
70,Fail,45,42,5,8,37
70,Fail,45,38,0,17,28
70,Fail,51,36,4,9,42
70,Fail,54,34,0,12,42
70,Fail,54,36,0,8,46
70,Fail,51,30,0,18,33
70,Fail,51,37,5,7,44
70,Fail,43,35,0,17,26
70,Fail,52,38,1,9,43
70,Fail,45,41,0,14,31
70,Fail,48,42,0,10,38
70,Fail,45,36,4,15,30
70,Fail,59,28,0,11,48
70,Fail,43,34,0,21,22
70,Fail,52,32,2,14,38
70,Fail,47,39,2,12,35
70,Fail,57,33,1,9,48
70,Fail,43,43,0,10,33
70,Fail,50,40,0,10,40
70,Fail,42,35,0,15,27
70,Fail,46,34,8,12,34
70,Fail,50,33,0,17,33
70,Fail,50,35,3,12,38
70,Fail,44,34,10,12,32
70,Fail,55,26,0,13,42
70,Fail,55,33,0,8,47
70,Fail,44,40,0,16,28
70,Fail,56,32,0,11,45
70,Fail,50,38,0,11,39
70,Fail,45,42,1,12,33
70,Fail,49,32,0,10,39
70,Fail,47,34,8,11,36
70,Fail,54,28,4,14,40
70,Fail,48,32,6,14,34
70,Fail,50,35,0,10,40
70,Fail,44,44,0,10,34
70,Fail,51,36,0,12,39
70,Fail,44,42,0,11,33
70,Fail,48,38,0,14,34
70,Fail,60,30,0,10,50
70,Fail,49,33,0,16,33
70,Fail,55,34,2,9,46
70,Fail,50,34,1,15,35
70,Fail,47,34,0,16,31
70,Fail,51,31,0,15,36
70,Fail,44,35,6,15,29
70,Fail,56,25,8,11,45
70,Fail,42,37,0,12,30
70,Fail,50,38,0,11,39
70,Fail,52,31,0,12,40
70,Fail,55,34,3,8,47
70,Fail,55,28,0,16,39
70,Fail,44,34,0,20,24
70,Fail,43,30,0,15,28
70,Fail,51,34,4,11,40
70,Fail,49,31,2,18,31
70,Fail,44,44,3,9,35
70,Fail,45,30,12,13,32
70,Fail,45,39,2,14,31
70,Fail,51,32,6,11,40
70,Fail,47,35,5,13,34
70,Fail,51,35,1,13,38
70,Fail,54,30,1,15,39
70,Fail,40,43,0,17,23
70,Fail,52,36,0,12,40
70,Fail,45,37,0,15,30
70,Fail,45,36,0,17,28
70,Fail,42,35,11,12,30
70,Fail,33,33,16,18,15
70,Fail,38,39,0,15,23
70,Fail,52,33,1,14,38
70,Fail,57,31,0,7,50
70,Fail,46,39,3,12,34
70,Fail,53,30,0,17,36
70,Fail,50,35,0,14,36
70,Fail,49,39,0,9,40
70,Fail,44,43,0,9,35
70,Fail,41,37,0,17,24
70,Fail,49,40,0,10,39
70,Fail,42,38,0,15,27
70,Fail,40,36,0,10,30
70,Fail,36,35,0,15,21
70,Fail,50,37,0,12,38
70,Fail,54,34,1,11,43
70,Fail,51,37,0,12,39
70,Fail,45,37,0,15,30
70,Fail,33,41,0,19,14
70,Fail,57,34,1,8,49
70,Fail,49,36,2,13,36
70,Fail,43,42,2,13,30
70,Fail,47,35,0,16,31
70,Fail,49,40,0,10,39
70,Fail,41,46,3,10,31
70,Fail,44,35,8,13,31
70,Fail,47,37,4,12,35
70,Fail,51,39,0,9,42
70,Fail,50,34,3,13,37
70,Fail,49,29,5,17,32
70,Fail,45,33,0,16,29
70,Fail,47,35,0,13,34
70,Fail,41,32,5,22,19
70,Fail,51,30,0,14,37
70,Fail,46,38,2,14,32
70,Fail,49,38,0,5,44
70,Fail,51,33,0,9,42
70,Fail,44,36,0,11,33
70,Fail,54,31,3,12,42
70,Fail,48,28,10,14,34
70,Fail,48,38,0,14,34
70,Fail,46,37,1,16,30
70,Fail,47,37,0,13,34
70,Fail,48,31,0,16,32
70,Fail,50,34,4,12,38
70,Fail,53,39,1,7,46
70,Fail,44,35,9,12,32
70,Fail,49,36,0,15,34
70,Fail,48,31,0,15,33
70,Fail,42,41,0,14,28
70,Fail,49,35,3,13,36
70,Fail,48,39,1,12,36
70,Fail,48,38,1,13,35
70,Fail,46,41,0,10,36
70,Fail,48,37,0,13,35
70,Fail,51,34,3,12,39
70,Fail,41,41,6,12,29
70,Fail,42,40,0,14,28
70,Fail,52,33,1,14,38
70,Fail,45,44,0,9,36
70,Fail,35,33,0,15,20
70,Fail,49,33,0,15,34
70,Fail,51,32,3,14,37
70,Fail,50,32,0,18,32
70,Fail,52,36,0,10,42
70,Fail,44,36,0,16,28
70,Fail,55,29,8,8,47
70,Fail,50,31,0,11,39
70,Fail,57,32,0,11,46
70,Fail,47,32,1,20,27
70,Fail,46,42,2,10,36
70,Fail,51,30,5,14,37
70,Fail,59,30,0,9,50
70,Fail,47,43,0,8,39
70,Fail,45,34,4,17,28
70,Fail,42,37,11,10,32
70,Fail,50,38,4,8,42
70,Fail,47,36,0,17,30
70,Fail,43,38,1,18,25
70,Fail,51,36,0,13,38
70,Fail,43,49,0,6,37
70,Fail,48,33,0,12,36
70,Fail,44,45,1,10,34
70,Fail,42,35,5,18,24
70,Fail,51,38,0,9,42
70,Fail,52,32,0,11,41
70,Fail,45,36,1,18,27
70,Fail,44,43,0,10,34
70,Fail,46,31,0,17,29
70,Fail,45,30,8,17,28
70,Fail,52,32,4,12,40
70,Fail,58,33,0,7,51
70,Fail,42,34,8,16,26
70,Fail,40,36,9,15,25
70,Fail,46,33,0,18,28
70,Fail,47,35,0,13,34
70,Fail,39,38,2,21,18
70,Fail,45,38,0,13,32
70,Fail,56,34,0,6,50
70,Fail,55,32,1,12,43
70,Fail,44,42,0,9,35
70,Fail,38,33,0,14,24
70,Fail,42,37,0,16,26
70,Fail,49,37,1,13,36
70,Fail,46,40,1,13,33
70,Fail,41,35,7,17,24
70,Fail,52,35,0,10,42
70,Fail,51,36,0,10,41
70,Fail,42,36,6,16,26
70,Fail,42,41,0,16,26
70,Fail,43,41,0,15,28
70,Fail,50,35,5,10,40
70,Fail,47,29,0,19,28
70,Fail,49,34,0,10,39
70,Fail,51,36,0,10,41
70,Fail,51,39,4,6,45
70,Fail,43,31,6,20,23
70,Fail,49,36,2,13,36
70,Fail,49,41,1,9,40
70,Fail,48,29,0,16,32
70,Fail,49,41,1,9,40
70,Fail,44,28,0,18,26
70,Fail,43,42,0,13,30
70,Fail,45,35,0,17,28
70,Fail,47,35,4,14,33
70,Fail,45,38,2,15,30
70,Fail,52,31,2,15,37
70,Fail,53,29,0,13,40
70,Fail,38,47,0,11,27
70,Fail,51,31,0,14,37
70,Fail,38,34,12,16,22
70,Fail,39,42,5,14,25
70,Fail,46,38,0,16,30
70,Fail,49,34,3,14,35
70,Fail,39,39,4,18,21
70,Fail,46,31,4,19,27
70,Fail,43,38,3,16,27
70,Fail,51,31,3,15,36
70,Fail,43,35,3,19,24
70,Fail,49,32,0,15,34
70,Fail,49,32,0,17,32
70,Fail,51,31,0,10,41
70,Fail,41,38,0,12,29
70,Fail,53,33,0,10,43
70,Fail,54,33,0,11,43
70,Fail,45,39,2,14,31
70,Fail,53,31,6,10,43
70,Fail,46,38,3,13,33
70,Fail,42,38,6,14,28
70,Fail,43,35,0,18,25
70,Fail,47,35,0,14,33
70,Fail,48,41,0,9,39
70,Fail,46,37,0,13,33
70,Fail,42,41,5,12,30
70,Fail,44,38,0,11,33
70,Fail,48,34,0,15,33
70,Fail,45,41,0,10,35
70,Fail,51,31,7,11,40
70,Fail,49,32,7,12,37
70,Fail,40,44,5,11,29
70,Fail,51,30,0,15,36
70,Fail,43,29,0,23,20
70,Fail,54,34,0,11,43
70,Fail,37,41,9,13,24
70,Fail,46,29,0,16,30
70,Fail,49,35,0,11,38
70,Fail,41,37,0,17,24
70,Fail,47,36,0,15,32
70,Fail,56,33,1,10,46
70,Fail,50,38,0,9,41
70,Fail,46,36,0,16,30
70,Fail,54,32,5,9,45
70,Fail,58,30,4,8,50
70,Fail,44,38,0,16,28
70,Fail,53,34,0,12,41
70,Fail,46,25,0,21,25
70,Fail,54,37,0,9,45
70,Fail,53,32,5,10,43
70,Fail,52,32,4,12,40
70,Fail,53,27,0,13,40
70,Fail,51,34,2,13,38
70,Fail,46,31,0,21,25
70,Fail,44,31,11,14,30
70,Fail,49,33,3,15,34
70,Fail,50,27,0,16,34
70,Fail,48,34,0,17,31
70,Fail,45,30,15,10,35
70,Fail,52,42,2,4,48
70,Fail,46,34,0,13,33
70,Fail,42,40,3,15,27
70,Fail,52,36,3,9,43
70,Fail,46,42,0,11,35
70,Fail,45,42,0,13,32
70,Fail,57,29,3,11,46
70,Fail,50,36,0,10,40
70,Fail,53,32,0,14,39
70,Fail,43,35,0,15,28
70,Fail,42,45,0,13,29
70,Fail,45,45,4,6,39
70,Fail,48,37,0,12,36
70,Fail,49,35,5,11,38
70,Fail,57,36,0,5,52
70,Fail,45,42,0,13,32
70,Fail,45,39,4,12,33
70,Fail,47,33,0,16,31
70,Fail,40,37,7,16,24
70,Fail,49,36,0,15,34
70,Fail,46,43,1,10,36
70,Fail,51,36,2,11,40
70,Fail,45,41,0,14,31
70,Fail,51,35,0,7,44
70,Fail,51,32,3,14,37
70,Fail,48,36,0,13,35
70,Fail,48,30,0,14,34
70,Fail,43,33,0,16,27
70,Fail,47,37,3,13,34
70,Fail,54,32,1,13,41
70,Fail,43,33,0,19,24
70,Fail,48,33,0,14,34
70,Fail,39,36,0,13,26
70,Fail,55,29,7,9,46
70,Fail,47,37,0,14,33
70,Fail,51,32,0,15,36
70,Fail,48,32,0,13,35
70,Fail,50,35,6,9,41
70,Fail,47,29,0,20,27
70,Fail,49,32,4,15,34
70,Fail,46,36,6,12,34
70,Fail,44,37,0,16,28
70,Fail,48,38,3,11,37
70,Fail,48,31,0,14,34
70,Fail,47,38,2,13,34
70,Fail,51,41,0,8,43
70,Fail,46,44,0,9,37
70,Fail,52,36,4,8,44
70,Fail,54,35,1,10,44
70,Fail,45,37,7,11,34
70,Fail,50,38,0,6,44
70,Fail,42,37,8,13,29
70,Fail,51,31,14,4,47
70,Fail,47,38,0,14,33
70,Fail,46,33,0,9,37
70,Fail,46,27,5,22,24
70,Fail,56,31,0,13,43
70,Fail,51,35,0,10,41
70,Fail,51,30,4,15,36
70,Fail,51,27,6,16,35
70,Fail,51,32,0,17,34
70,Fail,52,37,1,10,42
70,Fail,55,27,5,13,42
70,Fail,49,35,2,14,35
70,Fail,50,34,8,8,42
70,Fail,58,33,0,9,49
70,Fail,49,36,2,13,36
70,Fail,50,39,2,9,41
70,Fail,46,38,0,9,37
70,Fail,43,38,3,16,27
70,Fail,52,33,0,13,39
70,Fail,54,34,0,11,43
70,Fail,46,37,0,11,35
70,Fail,49,35,0,12,37
70,Fail,45,36,1,18,27
70,Fail,48,39,0,11,37
70,Fail,47,39,0,11,36
70,Fail,45,37,3,15,30
70,Fail,40,40,7,13,27
70,Fail,50,34,2,14,36
70,Fail,55,36,0,9,46
70,Fail,54,35,0,11,43
70,Fail,45,42,0,9,36
70,Fail,47,37,0,15,32
70,Fail,48,35,0,15,33
70,Fail,36,37,9,18,18
70,Fail,49,35,0,13,36
70,Fail,56,30,2,12,44
70,Fail,51,25,0,21,30
70,Fail,51,39,0,10,41
70,Fail,46,39,0,15,31
70,Fail,49,39,3,9,40
70,Fail,49,33,0,16,33
70,Fail,46,36,0,18,28
70,Fail,52,36,5,7,45
70,Fail,49,30,9,12,37
70,Fail,53,35,0,10,43
70,Fail,50,30,0,15,35
70,Fail,42,40,0,16,26
70,Fail,47,41,0,9,38
70,Fail,47,34,4,15,32
70,Fail,55,29,0,16,39
70,Fail,49,37,3,11,38
70,Fail,46,40,5,9,37
70,Fail,50,33,0,17,33
70,Fail,47,36,0,14,33
70,Fail,46,33,0,17,29
70,Fail,54,34,3,9,45
70,Fail,47,33,8,12,35
70,Fail,45,38,5,12,33
70,Fail,45,38,0,13,32
70,Fail,53,33,0,10,43
70,Fail,49,32,0,16,33
70,Fail,52,31,4,13,39
70,Fail,45,39,7,9,36
70,Fail,48,32,6,14,34
70,Fail,49,33,12,6,43
70,Fail,57,33,0,9,48
70,Fail,55,32,0,12,43
70,Fail,39,38,0,18,21
70,Fail,52,33,0,15,37
70,Fail,46,40,2,12,34
70,Fail,49,43,0,8,41
70,Fail,50,33,5,12,38
70,Fail,48,40,1,11,37
70,Fail,50,35,4,11,39
70,Fail,52,38,0,7,45
70,Fail,55,34,0,11,44
70,Fail,48,38,0,10,38
70,Fail,54,34,0,12,42
70,Fail,40,49,0,8,32
70,Fail,48,28,12,12,36
70,Fail,49,32,3,16,33
70,Fail,41,40,4,15,26
70,Fail,47,32,6,15,32
70,Fail,50,30,8,12,38
70,Fail,49,38,0,11,38
70,Fail,45,35,8,12,33
70,Fail,50,41,0,7,43
70,Fail,54,35,0,9,45
70,Fail,54,43,0,3,51
70,Fail,50,40,1,9,41
70,Fail,32,44,8,16,16
70,Fail,48,31,4,17,31
70,Fail,52,34,1,13,39
70,Fail,58,34,0,8,50
70,Fail,52,33,3,12,40
70,Fail,45,38,0,13,32
70,Fail,46,40,1,13,33
70,Fail,51,39,2,8,43
70,Fail,46,37,0,13,33
70,Fail,47,40,0,9,38
70,Fail,42,41,0,13,29
70,Fail,47,29,0,16,31
70,Fail,50,41,0,8,42
70,Fail,53,32,0,13,40
70,Fail,45,33,12,10,35
70,Fail,52,34,0,13,39
70,Fail,50,35,0,13,37
70,Fail,55,25,0,12,43
70,Fail,49,39,0,12,37
70,Fail,44,39,5,12,32
70,Fail,48,32,0,12,36
70,Fail,49,38,0,10,39
70,Fail,51,32,0,15,36
70,Fail,43,38,0,16,27
70,Fail,54,29,0,11,43
70,Fail,50,32,3,15,35
70,Fail,47,35,0,13,34
70,Fail,48,39,0,11,37
70,Fail,50,38,0,9,41
70,Fail,48,32,8,12,36
70,Fail,43,35,11,11,32
70,Fail,43,41,6,10,33
70,Fail,46,41,0,12,34
70,Fail,49,38,0,10,39
70,Fail,44,35,8,13,31
70,Fail,58,33,4,5,53
70,Fail,52,29,0,15,37
70,Fail,51,38,0,10,41
70,Fail,44,36,10,10,34
70,Fail,44,35,4,17,27
70,Fail,37,40,0,19,18
70,Fail,51,35,0,11,40
70,Fail,38,35,0,16,22
70,Fail,37,35,0,12,25
70,Fail,50,29,4,17,33
70,Fail,49,35,3,13,36
70,Fail,42,39,0,19,23
70,Fail,50,32,0,17,33
70,Fail,49,32,0,17,32
70,Fail,57,38,0,4,53
70,Fail,44,35,10,11,33
70,Fail,47,42,4,7,40
70,Fail,43,39,0,14,29
70,Fail,49,27,0,23,26
70,Fail,41,39,9,11,30
70,Fail,53,34,0,13,40
70,Fail,41,34,0,17,24
70,Fail,53,34,4,9,44
70,Fail,44,40,2,14,30
70,Fail,38,37,0,19,19
70,Fail,37,42,0,9,28
70,Fail,48,34,7,11,37
70,Fail,56,28,0,14,42
70,Fail,47,36,1,16,31
70,Fail,50,33,0,10,40
70,Fail,48,38,0,13,35
70,Fail,49,36,0,14,35
70,Fail,48,35,0,8,40
70,Fail,47,35,0,14,33
70,Fail,48,33,0,18,30
70,Fail,52,36,2,10,42
70,Fail,53,34,0,8,45
70,Fail,47,40,0,11,36
70,Fail,46,36,6,12,34
70,Fail,47,39,0,11,36
70,Fail,50,30,4,16,34
70,Fail,46,41,1,12,34
70,Fail,51,32,2,15,36
70,Fail,39,40,8,13,26
70,Fail,47,36,3,14,33
70,Fail,49,40,2,9,40
70,Fail,43,47,0,10,33
70,Fail,45,34,4,17,28
70,Fail,44,39,4,13,31
70,Fail,47,42,0,7,40
70,Fail,50,34,2,14,36
70,Fail,46,33,4,17,29
70,Fail,50,39,0,7,43
70,Fail,50,35,2,13,37
70,Fail,59,33,3,5,54
70,Fail,48,36,0,12,36
70,Fail,47,43,1,9,38
70,Fail,47,37,0,11,36
70,Fail,50,33,0,11,39
70,Fail,43,24,14,19,24
70,Fail,43,29,11,17,26
70,Fail,54,25,8,13,41
70,Fail,34,37,7,22,12
70,Fail,58,33,3,6,52
70,Fail,57,32,0,11,46
70,Fail,54,33,1,12,42
70,Fail,46,37,3,14,32
70,Fail,47,35,3,15,32
70,Fail,46,39,2,13,33
70,Fail,47,44,3,6,41
70,Fail,45,36,5,14,31
70,Fail,43,38,0,14,29
70,Fail,54,28,8,10,44
70,Fail,37,41,9,13,24
70,Fail,44,33,7,16,28
70,Fail,42,37,0,19,23
70,Fail,45,41,1,13,32
70,Fail,38,43,5,14,24
70,Fail,39,46,0,11,28
70,Fail,52,38,0,9,43
70,Fail,45,38,0,11,34
70,Fail,47,37,0,10,37
70,Fail,63,25,0,11,52
70,Fail,51,32,0,13,38
70,Fail,44,31,9,16,28
70,Fail,46,44,0,10,36
70,Fail,51,36,0,12,39
70,Fail,48,40,0,12,36
70,Fail,55,27,5,13,42
70,Fail,38,37,4,21,17
70,Fail,42,41,0,13,29
70,Fail,49,37,0,13,36
70,Fail,48,33,0,15,33
70,Fail,39,36,10,15,24
70,Fail,45,44,2,9,36
70,Fail,49,32,0,14,35
70,Fail,49,32,0,13,36
70,Fail,46,31,6,17,29
70,Fail,45,38,4,13,32
70,Fail,40,46,0,10,30
70,Fail,51,39,4,6,45
70,Fail,49,33,3,15,34
70,Fail,44,34,4,18,26
70,Fail,47,40,0,11,36
70,Fail,47,44,1,8,39
70,Fail,57,37,0,5,52
70,Fail,33,38,11,18,15
70,Fail,52,30,3,15,37
70,Fail,43,35,0,18,25
70,Fail,42,34,10,14,28
70,Fail,47,33,0,12,35
70,Fail,51,35,1,13,38
70,Fail,51,36,1,12,39
70,Fail,52,32,1,15,37
70,Fail,54,27,6,13,41
70,Fail,48,39,0,11,37
70,Fail,52,35,3,10,42
70,Fail,50,35,5,10,40
70,Fail,42,37,0,16,26
70,Fail,44,39,0,14,30
70,Fail,56,29,2,13,43
70,Fail,40,46,4,10,30
70,Fail,42,36,0,16,26
70,Fail,50,36,1,13,37
70,Fail,48,38,0,11,37
70,Fail,49,33,6,12,37
70,Fail,46,36,7,11,35
70,Fail,49,35,0,15,34
70,Fail,52,36,0,11,41
70,Fail,47,28,12,13,34
70,Fail,47,36,5,12,35
70,Fail,49,37,0,13,36
70,Fail,50,34,1,15,35
70,Fail,57,33,1,9,48
70,Fail,53,31,0,10,43
70,Fail,48,38,0,11,37
70,Fail,48,29,0,13,35
70,Fail,48,38,0,12,36
70,Fail,47,37,0,14,33
70,Fail,46,40,0,11,35
70,Fail,45,39,4,12,33
70,Fail,41,44,0,11,30
70,Fail,45,34,1,20,25
70,Fail,44,38,5,13,31
70,Fail,42,42,5,11,31
70,Fail,36,46,0,12,24
70,Fail,45,38,2,15,30
70,Fail,45,43,4,8,37
70,Fail,45,36,3,16,29
70,Fail,40,42,0,11,29
70,Fail,41,34,5,20,21
70,Fail,47,36,0,9,38
70,Fail,47,35,4,14,33
70,Fail,44,40,3,13,31
70,Fail,46,30,6,18,28
70,Fail,51,34,5,10,41
70,Fail,36,45,0,14,22
70,Fail,50,33,4,13,37
70,Fail,41,45,0,12,29
70,Fail,46,39,4,11,35
70,Fail,56,35,0,9,47
70,Fail,45,25,14,16,29
70,Fail,42,45,0,10,32
70,Fail,47,39,0,14,33
70,Fail,39,37,0,14,25
70,Fail,49,39,0,8,41
70,Fail,49,32,9,10,39
70,Fail,44,33,0,19,25
70,Fail,45,38,1,16,29
70,Fail,44,40,0,13,31
70,Fail,40,40,8,12,28
70,Fail,49,30,6,15,34
70,Fail,46,35,0,16,30
70,Fail,48,36,6,10,38
70,Fail,57,34,0,9,48
70,Fail,48,41,0,11,37
70,Fail,36,42,0,14,22
70,Fail,45,43,2,10,35
70,Fail,52,38,1,9,43
70,Fail,49,28,0,15,34
70,Fail,51,33,0,8,43
70,Fail,41,40,4,15,26
70,Fail,49,42,0,9,40
70,Fail,50,35,0,11,39
70,Fail,47,31,9,13,34
70,Fail,52,35,1,12,40
70,Fail,54,35,0,11,43
70,Fail,55,30,0,13,42
70,Fail,46,43,0,11,35
70,Fail,47,39,1,13,34
70,Fail,56,34,1,9,47
70,Fail,46,36,0,12,34
70,Fail,42,38,0,9,33
70,Fail,52,32,0,15,37
70,Fail,41,42,0,16,25
70,Fail,51,31,0,7,44
70,Fail,45,34,0,17,28
70,Fail,55,31,4,10,45
70,Fail,58,32,2,8,50
70,Fail,44,41,5,10,34
70,Fail,44,39,2,15,29
70,Fail,49,34,0,13,36
70,Fail,60,29,0,6,54
70,Fail,47,39,0,11,36
70,Fail,45,41,0,13,32
70,Fail,51,35,3,11,40
70,Fail,50,35,0,15,35
70,Fail,55,33,0,12,43
70,Fail,41,37,10,12,29
70,Fail,57,34,0,8,49
70,Fail,49,33,0,13,36
70,Fail,52,33,0,12,40
70,Fail,50,37,0,12,38
70,Fail,46,37,0,16,30
70,Fail,48,29,0,14,34
70,Fail,47,33,6,14,33
70,Fail,44,41,2,13,31
70,Fail,51,33,0,15,36
70,Fail,48,41,0,7,41
70,Fail,55,32,4,9,46
70,Fail,43,34,9,14,29
70,Fail,45,37,0,13,32
70,Fail,42,37,0,12,30
70,Fail,50,39,4,7,43
70,Fail,60,32,0,8,52
70,Fail,50,29,0,10,40
70,Fail,48,33,4,15,33
70,Fail,46,36,0,10,36
70,Fail,53,33,3,11,42
70,Fail,45,40,1,14,31
70,Fail,53,34,0,9,44
70,Fail,45,39,0,15,30
70,Fail,46,41,2,11,35
70,Fail,41,41,0,8,33
70,Fail,51,36,0,10,41
70,Fail,51,34,3,12,39
70,Fail,51,37,0,11,40
70,Fail,53,34,0,11,42
70,Fail,49,26,8,17,32
70,Fail,47,34,0,12,35
70,Fail,49,38,6,7,42
70,Fail,46,40,0,7,39
70,Fail,51,35,1,13,38
70,Fail,44,21,0,17,27
70,Fail,44,36,3,17,27
70,Fail,49,39,1,11,38
70,Fail,53,36,1,10,43
70,Fail,48,38,0,10,38
70,Fail,43,35,6,16,27
70,Fail,53,31,1,15,38
70,Fail,48,34,1,17,31
70,Fail,43,37,0,18,25
70,Fail,51,36,1,12,39
70,Fail,40,43,0,17,23
70,Fail,58,31,3,8,50
70,Fail,49,42,1,8,41
70,Fail,36,42,5,17,19
70,Fail,46,35,0,18,28
70,Fail,43,39,0,11,32
70,Fail,51,32,2,15,36
70,Fail,51,42,0,5,46
70,Fail,52,36,4,8,44
70,Fail,44,41,0,13,31
70,Fail,43,39,0,18,25
70,Fail,57,31,0,10,47
70,Fail,49,36,1,14,35
70,Fail,50,31,0,14,36
70,Fail,46,44,0,10,36
70,Fail,50,33,7,10,40
70,Fail,45,37,13,5,40
70,Fail,49,35,1,15,34
70,Fail,58,32,0,9,49
70,Fail,47,34,1,18,29
70,Fail,39,41,2,18,21
70,Fail,49,33,4,14,35
70,Fail,49,34,0,11,38
70,Fail,52,34,0,12,40
70,Fail,53,35,5,7,46
70,Fail,49,35,3,13,36
70,Fail,47,36,3,14,33
70,Fail,44,39,7,10,34
70,Fail,41,38,7,14,27
70,Fail,42,35,0,15,27
70,Fail,43,39,4,14,29
70,Fail,47,39,7,7,40
70,Fail,46,39,0,8,38
70,Fail,48,34,0,11,37
70,Fail,48,39,0,9,39
70,Fail,48,35,0,12,36
70,Fail,52,39,0,8,44
70,Fail,47,37,0,15,32
70,Fail,48,32,0,14,34
70,Fail,43,35,0,13,30
70,Fail,51,37,1,11,40
70,Fail,55,31,1,13,42
70,Fail,47,34,0,15,32
70,Fail,47,38,0,9,38
70,Fail,54,29,3,14,40
70,Fail,53,30,0,17,36
70,Fail,53,33,5,9,44
70,Fail,48,41,0,10,38
70,Fail,39,40,0,16,23
70,Fail,47,40,3,10,37
70,Fail,50,27,9,14,36
70,Fail,52,25,13,10,42
70,Fail,39,40,0,13,26
70,Fail,54,34,1,11,43
70,Fail,48,39,0,11,37
70,Fail,48,30,0,15,33
70,Fail,47,33,0,16,31
70,Fail,51,27,3,19,32
70,Fail,50,37,0,9,41
70,Fail,56,31,1,12,44
70,Fail,41,28,0,15,26
70,Fail,51,28,0,19,32
70,Fail,43,38,7,12,31
70,Fail,49,35,3,13,36
70,Fail,40,43,0,12,28
70,Fail,41,31,0,21,20
70,Fail,49,30,3,18,31
70,Fail,46,36,0,10,36
70,Fail,50,32,0,11,39
70,Fail,46,28,0,20,26
70,Fail,48,42,0,10,38
70,Fail,48,30,0,12,36
70,Fail,62,29,0,4,58
70,Fail,53,30,0,16,37
70,Fail,48,35,6,11,37
70,Fail,47,33,0,12,35
70,Fail,49,38,0,10,39
70,Fail,49,35,0,11,38
70,Fail,51,28,6,15,36
70,Fail,50,37,2,11,39
70,Fail,49,33,0,10,39
70,Fail,52,35,1,12,40
70,Fail,53,31,0,9,44
70,Fail,47,36,4,13,34
70,Fail,47,38,2,13,34
70,Fail,44,39,5,12,32
70,Fail,48,28,0,14,34
70,Fail,41,30,0,19,22
70,Fail,42,39,0,18,24
70,Fail,51,34,0,15,36
70,Fail,50,35,0,12,38
70,Fail,45,42,0,9,36
70,Fail,48,37,4,11,37
70,Fail,45,35,0,14,31
70,Fail,50,37,0,12,38
70,Fail,51,41,2,6,45
70,Fail,52,31,0,14,38
70,Fail,47,45,1,7,40
70,Fail,49,41,2,8,41
70,Fail,51,30,0,14,37
70,Fail,50,29,2,19,31
70,Fail,49,33,3,15,34
70,Fail,43,30,0,17,26
70,Fail,61,25,4,10,51
70,Fail,56,30,0,14,42
70,Fail,48,36,0,11,37
70,Fail,48,37,4,11,37
70,Fail,44,33,0,12,32
70,Fail,51,37,0,9,42
70,Fail,44,41,0,10,34
70,Fail,49,38,0,10,39
70,Fail,47,38,0,9,38
70,Fail,44,31,0,17,27
70,Fail,38,39,4,19,19
70,Fail,58,29,0,9,49
70,Fail,45,39,3,13,32
70,Fail,47,38,5,10,37
70,Fail,46,34,8,12,34
70,Fail,49,39,3,9,40
70,Fail,44,39,0,15,29
70,Fail,45,30,11,14,31
70,Fail,41,40,8,11,30
70,Fail,50,35,5,10,40
70,Fail,48,36,4,12,36
70,Fail,57,31,0,11,46
70,Fail,40,39,6,15,25
70,Fail,47,36,4,13,34
70,Fail,49,37,2,12,37
70,Fail,45,32,9,14,31
70,Fail,48,37,6,9,39
70,Fail,46,36,0,17,29
70,Fail,40,39,6,15,25
70,Fail,45,44,0,11,34
70,Fail,50,38,0,9,41
70,Fail,49,40,0,10,39
70,Fail,44,38,0,15,29
70,Fail,56,30,2,12,44
70,Fail,51,25,7,17,34
70,Fail,49,33,0,16,33
70,Fail,39,36,8,17,22
70,Fail,47,35,2,16,31
70,Fail,48,33,0,13,35
70,Fail,46,31,0,18,28
70,Fail,56,32,1,11,45
70,Fail,45,36,7,12,33
70,Fail,52,34,0,11,41
70,Fail,45,36,3,16,29
70,Fail,53,33,0,10,43
70,Fail,50,33,0,16,34
70,Fail,39,36,0,18,21
70,Fail,47,37,1,15,32
70,Fail,54,29,0,13,41
70,Fail,42,28,17,13,29
70,Fail,48,39,7,6,42
70,Fail,46,36,4,14,32
70,Fail,44,30,0,13,31
70,Fail,48,36,1,15,33
70,Fail,41,36,5,18,23
70,Fail,45,35,0,20,25
70,Fail,55,32,6,7,48
70,Fail,53,34,0,13,40
70,Fail,41,33,0,18,23
70,Fail,46,36,0,15,31
70,Fail,42,44,0,14,28
70,Fail,51,38,0,9,42
70,Fail,43,38,4,15,28
70,Fail,45,42,0,5,40
70,Fail,41,32,0,12,29
70,Fail,48,39,0,11,37
70,Fail,49,39,0,10,39
70,Fail,51,30,6,13,38
70,Fail,53,33,0,13,40
70,Fail,51,32,7,10,41
70,Fail,45,35,8,12,33
70,Fail,46,41,1,12,34
70,Fail,44,45,1,10,34
70,Fail,47,31,0,19,28
70,Fail,51,39,0,9,42
70,Fail,44,34,7,15,29
70,Fail,49,33,7,11,38
70,Fail,52,33,0,15,37
70,Fail,45,39,2,14,31
70,Fail,54,33,1,12,42
70,Fail,50,32,0,18,32
70,Fail,45,37,0,13,32
70,Fail,46,39,5,10,36
70,Fail,48,33,0,15,33
70,Fail,46,41,0,13,33
70,Fail,46,43,0,9,37
70,Fail,60,31,0,9,51
70,Fail,41,35,1,23,18
70,Fail,52,36,0,9,43
70,Fail,50,30,7,13,37
70,Fail,45,34,0,11,34
70,Fail,48,39,2,11,37
70,Fail,50,34,6,10,40
70,Fail,49,34,0,10,39
70,Fail,53,33,2,12,41
70,Fail,52,34,0,10,42
70,Fail,49,41,0,10,39
70,Fail,50,31,0,11,39
70,Fail,50,34,5,11,39
70,Fail,53,37,3,7,46
70,Fail,52,36,0,12,40
70,Fail,48,32,7,13,35
70,Fail,52,36,0,12,40
70,Fail,53,38,4,5,48
70,Fail,50,32,3,15,35
70,Fail,44,33,12,11,33
70,Fail,51,33,0,16,35
70,Fail,48,33,0,17,31
70,Fail,44,43,2,11,33
70,Fail,51,34,0,13,38
70,Fail,47,29,9,15,32
70,Fail,52,30,0,16,36
70,Fail,50,41,0,7,43
70,Fail,47,45,1,7,40
70,Fail,51,30,0,13,38
70,Fail,49,29,0,20,29
70,Fail,49,37,2,12,37
70,Fail,51,39,0,10,41
70,Fail,51,42,0,5,46
70,Fail,48,36,0,15,33
70,Fail,43,39,0,13,30
70,Fail,52,31,0,12,40
70,Fail,54,36,0,10,44
70,Fail,49,36,0,11,38
70,Fail,44,39,1,16,28
70,Fail,47,41,0,10,37
70,Fail,48,32,0,14,34
70,Fail,46,35,4,15,31
70,Fail,42,27,16,15,27
70,Fail,53,36,0,7,46
70,Fail,47,34,0,18,29
70,Fail,55,31,1,13,42
70,Fail,53,29,0,16,37
70,Fail,51,32,3,14,37
70,Fail,50,35,0,14,36
70,Fail,47,33,4,16,31
70,Fail,42,36,0,13,29
70,Fail,47,31,0,19,28
70,Fail,52,31,0,15,37
70,Fail,50,37,3,10,40
70,Fail,35,38,0,21,14
70,Fail,47,36,0,12,35
70,Fail,48,31,0,18,30
70,Fail,53,35,0,10,43
70,Fail,46,31,0,17,29
70,Fail,55,30,0,11,44
70,Fail,45,35,5,15,30
70,Fail,51,36,1,12,39
70,Fail,40,40,6,14,26
70,Fail,53,37,0,9,44
70,Fail,51,40,0,9,42
70,Fail,39,40,0,15,24
70,Fail,41,42,8,9,32
70,Fail,40,39,7,14,26
70,Fail,50,30,3,17,33
70,Fail,53,35,2,10,43
70,Fail,43,37,4,16,27
70,Fail,48,35,5,12,36
70,Fail,50,38,0,12,38
70,Fail,44,35,0,14,30
70,Fail,58,31,0,11,47
70,Fail,45,43,0,10,35
70,Fail,55,32,4,9,46
70,Fail,44,36,4,16,28
70,Fail,51,36,0,11,40
70,Fail,45,36,7,12,33
70,Fail,51,38,0,11,40
70,Fail,48,35,6,11,37
70,Fail,52,26,0,14,38
70,Fail,47,36,0,14,33
70,Fail,47,32,8,13,34
70,Fail,51,30,0,13,38
70,Fail,47,35,6,12,35
70,Fail,46,35,0,19,27
70,Fail,50,42,0,7,43
70,Fail,43,35,0,12,31
70,Fail,48,38,0,13,35
70,Fail,44,40,1,15,29
70,Fail,43,35,3,19,24
70,Fail,44,32,11,13,31
70,Fail,47,39,1,13,34
70,Fail,51,32,4,13,38
70,Fail,46,33,6,15,31
70,Fail,44,32,0,11,33
70,Fail,47,41,2,10,37
70,Fail,49,43,0,8,41
70,Fail,52,32,0,14,38
70,Fail,48,34,0,18,30
70,Fail,44,37,0,12,32
70,Fail,54,33,0,10,44
70,Fail,48,34,6,12,36
70,Fail,51,26,0,13,38
70,Fail,46,35,7,12,34
70,Fail,53,21,1,25,28
70,Fail,50,38,3,9,41
70,Fail,57,32,4,7,50
70,Fail,53,30,0,15,38
70,Fail,50,31,3,16,34
70,Fail,37,42,0,17,20
70,Fail,45,38,1,16,29
70,Fail,50,36,3,11,39
70,Fail,47,35,0,17,30
70,Fail,50,28,0,14,36
70,Fail,44,39,0,14,30
70,Fail,47,37,0,13,34
70,Fail,43,41,0,12,31
70,Fail,54,31,6,9,45
70,Fail,50,30,5,15,35
70,Fail,46,35,9,10,36
70,Fail,39,38,0,13,26
70,Fail,48,35,3,14,34
70,Fail,53,38,0,7,46
70,Fail,55,35,2,8,47
70,Fail,43,31,0,15,28
70,Fail,43,38,0,16,27
70,Fail,33,41,4,22,11
70,Fail,47,36,0,15,32
70,Fail,53,35,0,10,43
70,Fail,43,30,11,16,27
70,Fail,54,37,1,8,46
70,Fail,51,34,0,14,37
70,Fail,49,36,2,13,36
70,Fail,49,35,6,10,39
70,Fail,48,40,0,11,37
70,Fail,54,38,3,5,49
70,Fail,63,25,0,8,55
70,Fail,54,33,1,12,42
70,Fail,47,35,0,13,34
70,Fail,50,36,0,12,38
70,Fail,42,40,0,15,27
70,Fail,45,37,0,16,29
70,Fail,56,31,1,12,44
70,Fail,52,33,0,11,41
70,Fail,53,28,0,15,38
70,Fail,46,37,4,13,33
70,Fail,47,41,3,9,38
70,Fail,49,36,0,8,41
70,Fail,41,37,6,16,25
70,Fail,55,33,0,10,45
70,Fail,51,38,0,10,41
70,Fail,52,30,0,18,34
70,Fail,48,40,0,8,40
70,Fail,45,39,2,14,31
70,Fail,42,43,5,10,32
70,Fail,52,41,2,5,47
70,Fail,48,32,3,17,31
70,Fail,46,40,3,11,35
70,Fail,45,36,0,8,37
70,Fail,42,39,3,16,26
70,Fail,41,44,0,14,27
70,Fail,51,35,0,11,40
70,Fail,45,37,1,17,28
70,Fail,45,42,0,11,34
70,Fail,40,45,4,11,29
70,Fail,49,32,7,12,37
70,Fail,46,41,3,10,36
70,Fail,45,32,4,19,26
70,Fail,54,29,0,8,46
70,Fail,53,28,0,10,43
70,Fail,42,32,0,16,26
70,Fail,46,39,2,13,33
70,Fail,51,30,0,8,43
70,Fail,46,35,0,16,30
70,Fail,43,36,5,16,27
70,Fail,51,35,0,11,40
70,Fail,43,33,0,19,24
70,Fail,45,30,0,23,22
70,Fail,52,29,0,12,40
70,Fail,42,38,6,14,28
70,Fail,41,35,0,15,26
70,Fail,54,31,0,11,43
70,Fail,54,29,0,10,44
70,Fail,52,37,0,11,41
70,Fail,51,31,0,14,37
70,Fail,41,39,6,14,27
70,Fail,44,40,4,12,32
70,Fail,50,38,0,11,39
70,Fail,55,33,0,9,46
70,Fail,47,34,8,11,36
70,Fail,44,34,0,19,25
70,Fail,46,38,2,14,32
70,Fail,51,32,3,14,37
70,Fail,48,39,0,11,37
70,Fail,47,34,4,15,32
70,Fail,50,34,3,13,37
70,Fail,43,36,0,16,27
70,Fail,47,43,0,9,38
70,Fail,45,36,0,16,29
70,Fail,53,29,0,13,40
70,Fail,47,39,1,13,34
70,Fail,53,32,5,10,43
70,Fail,48,35,0,15,33
70,Fail,55,32,0,13,42
70,Fail,50,34,0,11,39
70,Fail,50,41,0,9,41
70,Fail,50,34,3,13,37
70,Fail,55,34,3,8,47
70,Fail,48,36,0,13,35
70,Fail,47,29,8,16,31
70,Fail,60,29,0,10,50
70,Fail,52,29,5,14,38
70,Fail,44,33,0,15,29
70,Fail,39,45,3,13,26
70,Fail,46,39,0,15,31
70,Fail,52,33,3,12,40
70,Fail,49,37,0,13,36
70,Fail,45,36,0,13,32
70,Fail,50,33,0,16,34
70,Fail,53,27,10,10,43
70,Fail,48,40,0,10,38
70,Fail,53,36,2,9,44
70,Fail,40,38,9,13,27
70,Fail,44,35,0,19,25
70,Fail,51,37,2,10,41
70,Fail,49,34,0,14,35
70,Fail,44,33,0,15,29
70,Fail,42,30,0,14,28
70,Fail,53,35,0,12,41
70,Fail,46,43,0,11,35
70,Fail,55,31,0,10,45
70,Fail,46,35,0,12,34
70,Fail,50,30,0,14,36
70,Fail,51,35,0,14,37
70,Fail,41,38,0,17,24
70,Fail,51,31,0,13,38
70,Fail,47,40,0,12,35
70,Fail,54,30,5,11,43
70,Fail,47,28,11,14,33
70,Fail,46,41,0,11,35
70,Fail,50,39,0,11,39
70,Fail,45,33,0,14,31
70,Fail,44,36,0,18,26
70,Fail,45,34,2,19,26
70,Fail,56,36,0,8,48
70,Fail,60,31,0,9,51
70,Fail,46,36,3,15,31
70,Fail,58,28,0,13,45
70,Fail,45,37,5,13,32
70,Fail,47,35,0,11,36
70,Fail,47,35,7,11,36
70,Fail,44,43,2,11,33
70,Fail,53,35,4,8,45
70,Fail,52,39,0,6,46
70,Fail,55,32,3,10,45
70,Fail,48,40,0,8,40
70,Fail,44,36,9,11,33
70,Fail,55,32,5,8,47
70,Fail,48,33,4,15,33
70,Fail,47,40,0,11,36
70,Fail,43,32,0,18,25
70,Fail,50,34,3,13,37
70,Fail,41,42,6,11,30
70,Fail,48,33,3,16,32
70,Fail,54,27,0,13,41
70,Fail,45,32,0,14,31
70,Fail,37,36,6,21,16
70,Fail,53,38,0,8,45
70,Fail,43,39,5,13,30
70,Fail,49,42,0,8,41
70,Fail,47,35,0,14,33
70,Fail,58,30,0,7,51
70,Fail,52,27,0,17,35
70,Fail,45,36,0,18,27
70,Fail,55,28,0,12,43
70,Fail,46,31,0,10,36
70,Fail,55,28,8,9,46
70,Fail,44,33,8,15,29
70,Fail,47,40,4,9,38
70,Fail,54,31,3,12,42
70,Fail,55,30,0,13,42
70,Fail,50,27,10,13,37
70,Fail,48,28,0,14,34
70,Fail,50,35,0,14,36
70,Fail,43,39,3,15,28
70,Fail,42,35,11,12,30
70,Fail,51,33,1,15,36
70,Fail,41,36,8,15,26
70,Fail,43,43,0,14,29
70,Fail,49,39,0,9,40
70,Fail,53,32,1,14,39
70,Fail,45,37,1,17,28
70,Fail,42,36,0,10,32
70,Fail,42,42,0,14,28
70,Fail,56,31,0,13,43
70,Fail,55,32,0,13,42
70,Fail,48,38,4,10,38
70,Fail,48,38,0,10,38
70,Fail,46,37,1,16,30
70,Fail,42,51,1,6,36
70,Fail,49,38,0,13,36
70,Fail,47,40,0,12,35
70,Fail,48,35,0,16,32
70,Fail,46,33,0,17,29
70,Fail,49,29,8,14,35
70,Fail,52,34,0,13,39
70,Fail,40,38,3,19,21
70,Fail,55,41,0,4,51
70,Fail,46,34,0,18,28
70,Fail,48,40,1,11,37
70,Fail,50,29,0,15,35
70,Fail,40,46,3,11,29
70,Fail,50,31,5,14,36
70,Fail,51,38,1,10,41
70,Fail,47,38,0,12,35
70,Fail,51,33,3,13,38
70,Fail,43,38,7,12,31
70,Fail,45,35,0,17,28
70,Fail,54,40,0,6,48
70,Fail,50,37,4,9,41
70,Fail,45,31,3,21,24
70,Fail,54,35,0,11,43
70,Fail,54,31,0,12,42
70,Fail,55,30,0,12,43
70,Fail,49,32,1,18,31
70,Fail,53,27,5,15,38
70,Fail,51,40,0,8,43
70,Fail,55,38,0,6,49
70,Fail,43,40,3,14,29
70,Fail,47,46,3,4,43
70,Fail,54,37,0,9,45
70,Fail,52,33,3,12,40
70,Fail,45,39,5,11,34
70,Fail,51,37,0,11,40
70,Fail,42,36,3,19,23
70,Fail,54,32,1,13,41
70,Fail,53,35,1,11,42
70,Fail,43,34,0,14,29
70,Fail,57,33,1,9,48
70,Fail,55,33,0,12,43
70,Fail,47,39,1,13,34
70,Fail,46,39,1,14,32
70,Fail,52,31,3,14,38
70,Fail,47,38,0,12,35
70,Fail,45,39,0,11,34
70,Fail,40,37,10,13,27
70,Fail,44,37,0,17,27
70,Fail,52,28,4,16,36
70,Fail,50,43,1,6,44
70,Fail,43,39,0,10,33
70,Fail,50,40,0,7,43
70,Fail,47,37,5,11,36
70,Fail,49,37,3,11,38
70,Fail,46,39,0,14,32
70,Fail,40,44,4,12,28
70,Fail,46,31,0,17,29
70,Fail,38,44,5,13,25
70,Fail,42,33,0,20,22
70,Fail,46,32,0,15,31
70,Fail,41,29,15,15,26
70,Fail,50,30,8,12,38
70,Fail,44,37,8,11,33
70,Fail,57,28,0,15,42
70,Fail,47,31,8,14,33
70,Fail,49,40,1,10,39
70,Fail,49,40,0,10,39
70,Fail,42,43,2,13,29
70,Fail,39,40,2,19,20
70,Fail,47,31,0,13,34
70,Fail,38,42,6,14,24
70,Fail,56,29,0,13,43
70,Fail,56,36,1,7,49
70,Fail,49,34,1,16,33
70,Fail,41,33,0,15,26
70,Fail,49,37,2,12,37
70,Fail,51,34,2,13,38
70,Fail,46,43,3,8,38
70,Fail,48,33,3,16,32
70,Fail,49,36,0,11,38
70,Fail,52,39,2,7,45
70,Fail,51,36,5,8,43
70,Fail,52,36,0,12,40
70,Fail,53,27,0,13,40
70,Fail,45,37,0,16,29
70,Fail,42,33,0,18,24
70,Fail,52,35,3,10,42
70,Fail,54,24,0,13,41
70,Fail,52,35,2,11,41
70,Fail,49,37,0,10,39
70,Fail,37,34,17,12,25
70,Fail,46,32,0,12,34
70,Fail,45,42,4,9,36
70,Fail,43,35,0,17,26
70,Fail,48,35,9,8,40
70,Fail,49,31,0,16,33
70,Fail,46,39,0,14,32
70,Fail,53,34,1,12,41
70,Fail,49,40,3,8,41
70,Fail,49,37,0,13,36
70,Fail,48,39,0,11,37
70,Fail,50,32,7,11,39
70,Fail,51,34,0,10,41
70,Fail,53,32,0,12,41
70,Fail,51,29,4,16,35
70,Fail,40,33,0,18,22
70,Fail,42,46,0,10,32
70,Fail,47,36,0,12,35
70,Fail,43,36,0,19,24
70,Fail,47,35,0,17,30
70,Fail,42,41,0,14,28
70,Fail,55,31,1,13,42
70,Fail,47,32,0,13,34
70,Fail,47,34,4,15,32
70,Fail,38,40,8,14,24
70,Fail,49,31,9,11,38
70,Fail,53,31,7,9,44
70,Fail,48,30,4,18,30
70,Fail,54,37,2,7,47
70,Fail,55,28,9,8,47
70,Fail,54,26,0,16,38
70,Fail,52,29,0,17,35
70,Fail,48,37,2,13,35
70,Fail,45,43,1,11,34
70,Fail,49,31,8,12,37
70,Fail,49,31,3,17,32
70,Fail,46,37,0,13,33
70,Fail,51,35,4,10,41
70,Fail,48,40,1,11,37
70,Fail,55,33,3,9,46
70,Fail,49,34,0,15,34
70,Fail,43,37,6,14,29
70,Fail,51,30,4,15,36
70,Fail,47,39,0,14,33
70,Fail,45,29,0,16,29
70,Fail,52,31,0,13,39
70,Fail,47,34,0,13,34
70,Fail,54,27,0,8,46
70,Fail,46,43,0,11,35
70,Fail,48,36,0,13,35
70,Fail,48,32,0,13,35
70,Fail,46,34,0,17,29
70,Fail,51,34,0,12,39
70,Fail,47,33,0,18,29
70,Fail,44,39,0,5,39
70,Fail,48,34,6,12,36
70,Fail,48,40,1,11,37
70,Fail,53,40,0,5,48
70,Fail,41,39,0,16,25
70,Fail,51,37,1,11,40
70,Fail,45,41,3,11,34
70,Fail,46,36,3,15,31
70,Fail,50,38,1,11,39
70,Fail,45,40,5,10,35
70,Fail,52,30,0,11,41
70,Fail,44,32,0,18,26
70,Fail,52,34,2,12,40
70,Fail,49,35,4,12,37
70,Fail,45,34,0,15,30
70,Fail,49,34,0,14,35
70,Fail,47,45,0,7,40
70,Fail,52,31,7,10,42
70,Fail,44,40,0,16,28
70,Fail,44,36,5,15,29
70,Fail,47,35,6,12,35
70,Fail,40,37,7,16,24
70,Fail,47,40,4,9,38
70,Fail,43,45,0,12,31
70,Fail,49,33,3,15,34
70,Fail,55,31,6,8,47
70,Fail,47,34,0,15,32
70,Fail,45,45,0,10,35
70,Fail,53,32,0,15,38
70,Fail,49,39,0,12,37
70,Fail,43,37,0,15,28
70,Fail,47,30,0,16,31
70,Fail,49,35,0,15,34
70,Fail,47,36,0,14,33
70,Fail,55,36,0,9,46
70,Fail,53,31,1,15,38
70,Fail,50,35,2,13,37
70,Fail,51,35,0,12,39
70,Fail,43,35,5,17,26
70,Fail,45,40,0,14,31
70,Fail,49,36,0,15,34
70,Fail,48,34,5,13,35
70,Fail,50,41,1,8,42
70,Fail,34,38,0,20,14
70,Fail,52,27,7,14,38
70,Fail,51,31,6,12,39
70,Fail,49,34,6,11,38
70,Fail,51,34,0,15,36
70,Fail,40,43,4,13,27
70,Fail,45,35,0,13,32
70,Fail,47,39,0,11,36
70,Fail,55,35,0,9,46
70,Fail,37,39,8,16,21
70,Fail,50,34,0,16,34
70,Fail,58,33,0,7,51
70,Fail,55,27,6,12,43
70,Fail,51,32,0,12,39
70,Fail,49,32,0,17,32
70,Fail,44,34,12,10,34
70,Fail,51,31,0,14,37
70,Fail,42,44,0,11,31
70,Fail,52,37,2,9,43
70,Fail,52,33,0,8,44
70,Fail,47,36,3,14,33
70,Fail,52,35,2,11,41
70,Fail,42,42,0,13,29
70,Fail,46,38,0,16,30
70,Fail,53,34,1,12,41
70,Fail,49,40,5,6,43
70,Fail,51,35,0,12,39
70,Fail,45,33,3,19,26
70,Fail,47,26,0,17,30
70,Fail,50,36,0,13,37
70,Fail,46,43,5,6,40
70,Fail,46,36,5,13,33
70,Fail,49,39,0,6,43
70,Fail,53,33,3,11,42
70,Fail,60,24,0,15,45
70,Fail,43,31,8,18,25
70,Fail,47,35,3,15,32
70,Fail,39,46,0,14,25
70,Fail,46,37,5,12,34
70,Fail,48,25,0,17,31
70,Fail,53,33,0,9,44
70,Fail,54,27,0,15,39
70,Fail,55,36,2,7,48
70,Fail,43,31,8,18,25
70,Fail,45,36,0,16,29
70,Fail,48,33,0,14,34
70,Fail,49,37,3,11,38
70,Fail,50,29,0,21,29
70,Fail,47,39,1,13,34
70,Fail,44,37,7,12,32
70,Fail,54,34,0,12,42
70,Fail,54,34,0,11,43
70,Fail,53,38,0,9,44
70,Fail,44,42,2,12,32
70,Fail,52,37,0,10,42
70,Fail,45,37,5,13,32
70,Fail,49,35,3,13,36
70,Fail,47,44,3,6,41
70,Fail,51,35,3,11,40
70,Fail,54,39,1,6,48
70,Fail,40,40,0,17,23
70,Fail,49,31,0,18,31
70,Fail,42,32,0,20,22
70,Fail,50,37,0,13,37
70,Fail,48,37,1,14,34
70,Fail,41,46,2,11,30
70,Fail,42,42,0,14,28
70,Fail,48,35,2,15,33
70,Fail,51,36,0,12,39
70,Fail,53,28,4,15,38
70,Fail,48,36,4,12,36
70,Fail,53,35,0,12,41
70,Fail,48,37,3,12,36
70,Fail,55,33,0,12,43
70,Fail,48,39,0,10,38
70,Fail,49,36,5,10,39
70,Fail,49,32,2,17,32
70,Fail,43,38,0,11,32
70,Fail,55,36,0,9,46
70,Fail,41,42,0,17,24
70,Fail,58,32,2,8,50
70,Fail,48,39,3,10,38
70,Fail,54,27,7,12,42
70,Fail,49,40,3,8,41
70,Fail,43,38,0,15,28
70,Fail,52,33,4,11,41
70,Fail,49,33,2,16,33
70,Fail,51,32,2,15,36
70,Fail,46,38,1,15,31
70,Fail,55,34,0,10,45
70,Fail,49,37,0,13,36
70,Fail,51,32,0,14,37
70,Fail,48,34,0,11,37
70,Fail,44,41,0,14,30
70,Fail,49,36,2,13,36
70,Fail,48,31,9,12,36
70,Fail,47,33,0,10,37
70,Fail,46,35,0,13,33
70,Fail,53,34,0,12,41
70,Fail,48,38,3,11,37
70,Fail,51,34,0,11,40
70,Fail,45,35,0,15,30
70,Fail,48,36,2,14,34
70,Fail,55,34,3,8,47
70,Fail,45,37,0,17,28
70,Fail,45,36,4,15,30
70,Fail,49,39,3,9,40
70,Fail,60,27,2,11,49
70,Fail,47,44,0,9,38
70,Fail,52,33,0,14,38
70,Fail,53,35,0,12,41
70,Fail,45,33,4,18,27
70,Fail,50,33,1,16,34
70,Fail,53,34,0,11,42
70,Fail,42,35,0,20,22
70,Fail,36,40,9,15,21
70,Fail,48,38,5,9,39
70,Fail,49,36,0,15,34
70,Fail,45,33,10,12,33
70,Fail,51,34,0,11,40
70,Fail,40,40,0,13,27
70,Fail,49,28,5,18,31
70,Fail,51,38,0,9,42
70,Fail,48,34,0,12,36
70,Fail,53,35,3,9,44
70,Fail,45,38,0,11,34
70,Fail,51,32,4,13,38
70,Fail,39,43,0,15,24
70,Fail,45,36,5,14,31
70,Fail,49,35,4,12,37
70,Fail,52,33,4,11,41
70,Fail,55,27,6,12,43
70,Fail,47,40,5,8,39
70,Fail,50,25,0,21,29
70,Fail,47,39,0,13,34
70,Fail,56,32,0,11,45
70,Fail,51,27,0,14,37
70,Fail,48,32,11,9,39
70,Fail,48,34,0,12,36
70,Fail,49,36,5,10,39
70,Fail,54,34,1,11,43
70,Fail,51,40,0,7,44
70,Fail,46,36,0,13,33
70,Fail,55,34,0,10,45
70,Fail,43,40,0,13,30
70,Fail,49,43,0,8,41
70,Fail,44,34,0,20,24
70,Fail,49,35,0,16,33
70,Fail,49,24,11,16,33
70,Fail,48,37,3,12,36
70,Fail,44,43,0,11,33
70,Fail,54,25,0,17,37
70,Fail,52,29,0,11,41
70,Fail,50,33,1,16,34
70,Fail,51,40,0,8,43
70,Fail,51,27,10,12,39
70,Fail,48,35,2,15,33
70,Fail,52,32,0,11,41
70,Fail,56,30,0,13,43
70,Fail,41,30,11,18,23
70,Fail,48,42,0,8,40
70,Fail,47,33,8,12,35
70,Fail,45,44,2,9,36
70,Fail,42,36,0,20,22
70,Fail,35,46,9,10,25
70,Fail,45,38,0,17,28
70,Fail,50,41,2,7,43
70,Fail,44,37,1,18,26
70,Fail,49,35,2,14,35
70,Fail,45,34,0,14,31
70,Fail,51,35,1,13,38
70,Fail,50,30,0,12,38
70,Fail,51,31,6,12,39
70,Fail,44,44,0,11,33
70,Fail,52,29,0,18,34
70,Fail,49,36,0,11,38
70,Fail,49,36,0,12,37
70,Fail,49,38,0,13,36
70,Fail,53,33,0,11,42
70,Fail,40,38,6,16,24
70,Fail,46,39,0,15,31
70,Fail,45,42,2,11,34
70,Fail,47,38,0,12,35
70,Fail,51,35,6,8,43
70,Fail,51,31,1,17,34
70,Fail,52,33,0,12,40
70,Fail,44,37,4,15,29
70,Fail,46,40,1,13,33
70,Fail,52,34,4,10,42
70,Fail,48,36,0,12,36
70,Fail,49,38,8,5,44
70,Fail,50,40,0,10,40
70,Fail,52,36,0,7,45
70,Fail,40,40,10,10,30
70,Fail,41,33,0,16,25
70,Fail,52,34,0,14,38
70,Fail,45,35,6,14,31
70,Fail,58,31,1,10,48
70,Fail,40,40,6,14,26
70,Fail,51,39,0,10,41
70,Fail,46,32,8,14,32
70,Fail,49,29,0,16,33
70,Fail,42,38,0,15,27
70,Fail,41,38,0,13,28
70,Fail,50,37,1,12,38
70,Fail,44,42,0,12,32
70,Fail,51,29,0,17,34
70,Fail,52,28,0,14,38
70,Fail,51,36,5,8,43
70,Fail,44,36,0,11,33
70,Fail,54,37,1,8,46
70,Fail,39,43,5,13,26
70,Fail,47,43,1,9,38
70,Fail,42,41,0,16,26
70,Fail,48,34,8,10,38
70,Fail,43,41,7,9,34
70,Fail,51,30,0,14,37
70,Fail,52,36,2,10,42
70,Fail,48,34,0,10,38
70,Fail,45,32,5,18,27
70,Fail,42,36,8,14,28
70,Fail,47,30,0,15,32
70,Fail,53,31,2,14,39
70,Fail,40,40,3,17,23
70,Fail,55,35,1,9,46
70,Fail,42,36,0,17,25
70,Fail,46,38,0,15,31
70,Fail,39,45,0,16,23
70,Fail,49,31,9,11,38
70,Fail,43,42,0,12,31
70,Fail,49,35,5,11,38
70,Fail,56,35,0,7,49
70,Fail,44,38,3,15,29
70,Fail,43,45,2,10,33
70,Fail,53,28,3,16,37
70,Fail,45,36,0,15,30
70,Fail,43,41,0,14,29
70,Fail,49,40,0,8,41
70,Fail,56,33,0,10,46
70,Fail,49,34,0,11,38
70,Fail,45,34,7,14,31
70,Fail,50,35,0,12,38
70,Fail,34,40,11,15,19
70,Fail,38,40,7,15,23
70,Fail,58,26,0,14,44
70,Fail,47,35,0,14,33
70,Fail,46,36,7,11,35
70,Fail,47,33,1,19,28
70,Fail,41,35,7,17,24
70,Fail,49,38,0,12,37
70,Fail,48,34,0,8,40
70,Fail,48,38,0,11,37
70,Fail,52,33,0,11,41
70,Fail,47,40,0,12,35
70,Fail,49,36,0,12,37
70,Fail,46,34,0,15,31
70,Fail,44,38,0,15,29
70,Fail,47,42,1,10,37
70,Fail,49,39,2,10,39
70,Fail,43,42,0,10,33
70,Fail,49,36,1,14,35
70,Fail,52,31,0,14,38
70,Fail,46,29,0,17,29
70,Fail,56,34,3,7,49
70,Fail,51,36,5,8,43
70,Fail,55,35,0,10,45
70,Fail,49,36,7,8,41
70,Fail,49,39,1,11,38
70,Fail,49,40,0,10,39
70,Fail,46,34,6,14,32
70,Fail,49,40,0,9,40
70,Fail,50,38,0,10,40
70,Fail,41,40,7,12,29
70,Fail,49,37,0,13,36
70,Fail,52,37,2,9,43
70,Fail,49,33,6,12,37
70,Fail,51,31,0,9,42
70,Fail,57,34,4,5,52
70,Fail,44,38,0,14,30
70,Fail,43,32,0,17,26
70,Fail,57,33,0,10,47
70,Fail,47,31,0,10,37
70,Fail,46,36,0,14,32
70,Fail,50,35,0,11,39
70,Fail,47,39,2,12,35
70,Fail,46,39,0,14,32
70,Fail,45,33,14,8,37
70,Fail,43,38,2,17,26
70,Fail,47,33,7,13,34
70,Fail,52,38,0,8,44
70,Fail,55,30,5,10,45
70,Fail,51,35,0,14,37
70,Fail,48,40,0,11,37
70,Fail,50,31,0,15,35
70,Fail,52,36,0,11,41
70,Fail,50,35,0,10,40
70,Fail,49,34,4,13,36
70,Fail,41,37,2,20,21
70,Fail,52,35,0,13,39
70,Fail,50,38,1,11,39
70,Fail,44,40,0,16,28
70,Fail,53,36,0,5,48
70,Fail,48,37,0,9,39
70,Fail,58,33,0,9,49
70,Fail,50,33,6,11,39
70,Fail,49,37,0,8,41
70,Fail,48,43,0,9,39
70,Fail,48,31,3,18,30
70,Fail,42,46,2,10,32
70,Fail,50,36,1,13,37
70,Fail,50,34,8,8,42
70,Fail,51,26,1,22,29
70,Fail,56,33,0,9,47
70,Fail,46,31,4,19,27
70,Fail,54,33,1,12,42
70,Fail,47,34,0,15,32
70,Fail,46,41,3,10,36
70,Fail,45,38,0,16,29
70,Fail,53,32,4,11,42
70,Fail,48,31,0,16,32
70,Fail,52,30,11,7,45
70,Fail,41,40,0,11,30
70,Fail,41,31,10,18,23
70,Fail,52,31,3,14,38
70,Fail,47,39,1,13,34
70,Fail,42,31,0,16,26
70,Fail,42,34,0,17,25
70,Fail,49,31,0,14,35
70,Fail,46,30,9,15,31
70,Fail,52,37,3,8,44
70,Fail,54,32,0,12,42
70,Fail,53,29,0,15,38
70,Fail,42,43,0,14,28
70,Fail,50,32,0,17,33
70,Fail,59,34,0,7,52
70,Fail,44,38,0,14,30
70,Fail,45,33,0,21,24
70,Fail,41,43,0,14,27
70,Fail,46,37,6,11,35
70,Fail,48,37,0,11,37
70,Fail,52,32,0,8,44
70,Fail,56,33,0,6,50
70,Fail,46,43,2,9,37
70,Fail,50,35,0,11,39
70,Fail,46,35,0,15,31
70,Fail,53,30,9,8,45
70,Fail,54,36,2,8,46
70,Fail,49,28,3,20,29
70,Fail,46,33,3,18,28
70,Fail,47,34,0,11,36
70,Fail,59,30,4,7,52
70,Fail,51,33,0,13,38
70,Fail,48,29,7,16,32
70,Fail,53,29,8,10,43
70,Fail,54,35,0,11,43
70,Fail,50,38,1,11,39
70,Fail,41,42,5,12,29
70,Fail,53,28,5,14,39
70,Fail,50,28,10,12,38
70,Fail,47,42,0,10,37
70,Fail,48,38,0,13,35
70,Fail,46,37,1,16,30
70,Fail,48,34,5,13,35
70,Fail,52,34,3,11,41
70,Fail,47,37,1,15,32
70,Fail,49,31,0,18,31
70,Fail,48,28,12,12,36
70,Fail,50,37,3,10,40
70,Fail,49,36,4,11,38
70,Fail,45,24,0,15,30
70,Fail,46,35,0,9,37
70,Fail,45,27,7,21,24
70,Fail,58,28,4,10,48
70,Fail,52,32,2,14,38
70,Fail,56,36,0,8,48
70,Fail,43,40,2,15,28
70,Fail,46,42,3,9,37
70,Fail,44,41,0,10,34
70,Fail,54,35,0,10,44
70,Fail,39,40,0,14,25
70,Fail,48,29,0,15,33
70,Fail,48,36,0,15,33
70,Fail,40,39,0,9,31
70,Fail,48,40,0,10,38
70,Fail,41,39,0,20,21
70,Fail,41,39,1,19,22
70,Fail,45,35,0,15,30
70,Fail,50,35,1,14,36
70,Fail,42,35,6,17,25
70,Fail,48,37,4,11,37
70,Fail,49,38,0,11,38
70,Fail,46,39,0,12,34
70,Fail,50,40,2,8,42
70,Fail,54,34,0,12,42
70,Fail,46,39,0,14,32
70,Fail,53,34,3,10,43
70,Fail,48,37,2,13,35
70,Fail,56,32,2,10,46
70,Fail,46,36,5,13,33
70,Fail,47,34,0,13,34
70,Fail,44,38,0,15,29
70,Fail,40,31,0,19,21
70,Fail,45,36,8,11,34
70,Fail,48,36,2,14,34
70,Fail,55,28,0,16,39
70,Fail,48,39,0,11,37
80,Fail,51,27,0,16,35
80,Fail,40,42,7,11,29
80,Fail,39,38,6,17,22
80,Fail,49,35,0,16,33
80,Fail,49,35,0,15,34
80,Fail,54,25,0,15,39
80,Fail,47,37,0,15,32
80,Fail,43,42,1,14,29
80,Fail,46,41,0,13,33
80,Fail,42,40,0,13,29
80,Fail,56,28,4,12,44
80,Fail,48,36,1,15,33
80,Fail,53,36,0,10,43
80,Fail,48,35,6,11,37
80,Fail,48,28,0,14,34
80,Fail,46,42,4,8,38
80,Fail,42,39,0,17,25
80,Fail,48,42,0,9,39
80,Fail,42,40,3,15,27
80,Fail,52,35,2,11,41
80,Fail,46,34,0,15,31
80,Fail,51,40,0,9,42
80,Fail,44,39,8,9,35
80,Fail,47,35,3,15,32
80,Fail,49,34,4,13,36
80,Fail,50,34,0,12,38
80,Fail,60,21,7,12,48
80,Fail,49,38,0,12,37
80,Fail,46,41,0,11,35
80,Fail,40,40,0,14,26
80,Fail,42,38,0,12,30
80,Fail,37,38,12,13,24
80,Fail,42,36,5,17,25
80,Fail,36,36,0,19,17
80,Fail,42,33,9,16,26
80,Fail,47,37,1,15,32
80,Fail,51,34,3,12,39
80,Fail,49,34,4,13,36
80,Fail,43,41,5,11,32
80,Fail,52,34,5,9,43
80,Fail,58,30,2,10,48
80,Fail,40,41,0,14,26
80,Fail,44,41,0,10,34
80,Fail,50,39,1,10,40
80,Fail,47,34,8,11,36
80,Fail,39,38,11,12,27
80,Fail,48,38,7,7,41
80,Fail,51,30,2,17,34
80,Fail,53,33,0,8,45
80,Fail,49,27,0,15,34
80,Fail,50,36,0,9,41
80,Fail,45,41,0,12,33
80,Fail,46,40,0,14,32
80,Fail,43,39,0,15,28
80,Fail,52,37,0,10,42
80,Fail,54,36,2,8,46
80,Fail,48,36,3,13,35
80,Fail,49,36,5,10,39
80,Fail,51,34,0,12,39
80,Fail,48,36,0,11,37
80,Fail,46,38,0,13,33
80,Fail,57,30,8,5,52
80,Fail,56,34,0,6,50
80,Fail,49,36,0,15,34
80,Fail,52,36,0,12,40
80,Fail,48,28,0,19,29
80,Fail,56,31,0,13,43
80,Fail,52,36,0,10,42
80,Fail,56,28,0,14,42
80,Fail,52,33,0,13,39
80,Fail,46,39,0,11,35
80,Fail,53,30,3,14,39
80,Fail,47,39,0,12,35
80,Fail,50,31,0,15,35
80,Fail,51,28,0,16,35
80,Fail,42,45,0,11,31
80,Fail,41,37,0,14,27
80,Fail,36,42,8,14,22
80,Fail,46,35,0,14,32
80,Fail,48,22,0,17,31
80,Fail,49,37,1,13,36
80,Fail,45,35,0,19,26
80,Fail,51,34,0,9,42
80,Fail,54,29,0,14,40
80,Fail,46,40,0,11,35
80,Fail,43,37,7,13,30
80,Fail,50,38,4,8,42
80,Fail,57,30,1,12,45
80,Fail,51,38,0,9,42
80,Fail,43,38,0,13,30
80,Fail,44,39,0,7,37
80,Fail,49,37,2,12,37
80,Fail,45,32,11,12,33
80,Fail,44,39,0,9,35
80,Fail,48,36,0,15,33
80,Fail,46,34,4,16,30
80,Fail,50,31,0,13,37
80,Fail,58,26,0,16,42
80,Fail,43,36,5,16,27
80,Fail,56,35,2,7,49
80,Fail,50,32,2,16,34
80,Fail,43,34,5,18,25
80,Fail,44,40,1,15,29
80,Fail,53,29,0,12,41
80,Fail,43,42,0,12,31
80,Fail,53,31,0,16,37
80,Fail,53,35,1,11,42
80,Fail,56,31,2,11,45
80,Fail,47,40,1,12,35
80,Fail,35,43,9,13,22
80,Fail,56,26,3,15,41
80,Fail,47,32,0,13,34
80,Fail,48,36,3,13,35
80,Fail,45,38,0,13,32
80,Fail,52,34,1,13,39
80,Fail,46,42,1,11,35
80,Fail,47,36,0,11,36
80,Fail,52,33,0,14,38
80,Fail,48,44,0,8,40
80,Fail,46,40,6,8,38
80,Fail,53,31,0,11,42
80,Fail,51,34,0,9,42
80,Fail,48,34,6,12,36
80,Fail,54,35,0,10,44
80,Fail,40,44,0,11,29
80,Fail,51,36,0,11,40
80,Fail,36,43,4,17,19
80,Fail,48,37,0,13,35
80,Fail,45,35,0,19,26
80,Fail,43,32,2,23,20
80,Fail,47,38,1,14,33
80,Fail,49,31,0,11,38
80,Fail,44,36,6,14,30
80,Fail,47,34,4,15,32
80,Fail,44,44,0,12,32
80,Fail,47,39,4,10,37
80,Fail,47,32,0,15,32
80,Fail,55,35,0,8,47
80,Fail,49,35,2,14,35
80,Fail,43,39,5,13,30
80,Fail,45,30,0,18,27
80,Fail,51,35,3,11,40
80,Fail,44,38,5,13,31
80,Fail,52,35,3,10,42
80,Fail,42,39,2,17,25
80,Fail,44,42,1,13,31
80,Fail,44,36,6,14,30
80,Fail,49,39,2,10,39
80,Fail,40,38,4,18,22
80,Fail,44,39,0,13,31
80,Fail,50,32,0,13,37
80,Fail,46,40,0,12,34
80,Fail,52,34,0,13,39
80,Fail,41,48,0,9,32
80,Fail,41,41,6,12,29
80,Fail,55,32,1,12,43
80,Fail,51,33,0,13,38
80,Fail,48,39,6,7,41
80,Fail,48,42,0,8,40
80,Fail,52,35,3,10,42
80,Fail,51,35,4,10,41
80,Fail,46,34,0,13,33
80,Fail,50,32,0,16,34
80,Fail,45,39,0,16,29
80,Fail,49,32,1,18,31
80,Fail,56,33,0,10,46
80,Fail,51,34,0,11,40
80,Fail,46,38,3,13,33
80,Fail,52,33,0,12,40
80,Fail,49,37,5,9,40
80,Fail,53,30,4,13,40
80,Fail,43,33,11,13,30
80,Fail,46,34,0,15,31
80,Fail,46,40,3,11,35
80,Fail,38,40,0,7,31
80,Fail,43,28,0,15,28
80,Fail,43,40,0,11,32
80,Fail,48,43,0,9,39
80,Fail,47,36,4,13,34
80,Fail,51,34,0,13,38
80,Fail,43,37,0,17,26
80,Fail,53,23,0,22,31
80,Fail,54,34,0,7,47
80,Fail,46,39,0,10,36
80,Fail,49,34,0,14,35
80,Fail,44,37,1,18,26
80,Fail,47,44,0,8,39
80,Fail,45,37,6,12,33
80,Fail,45,37,5,13,32
80,Fail,47,42,0,11,36
80,Fail,47,35,5,13,34
80,Fail,54,36,0,10,44
80,Fail,44,40,3,13,31
80,Fail,52,32,2,14,38
80,Fail,44,34,0,21,23
80,Fail,46,32,5,17,29
80,Fail,48,38,0,11,37
80,Fail,54,37,0,7,47
80,Fail,47,45,1,7,40
80,Fail,50,34,0,12,38
80,Fail,44,38,4,14,30
80,Fail,45,42,0,13,32
80,Fail,45,33,0,17,28
80,Fail,53,31,3,13,40
80,Fail,46,39,3,12,34
80,Fail,44,34,0,14,30
80,Fail,47,31,6,16,31
80,Fail,52,30,3,15,37
80,Fail,50,30,0,18,32
80,Fail,51,36,0,13,38
80,Fail,48,32,0,16,32
80,Fail,44,41,0,14,30
80,Fail,51,29,6,14,37
80,Fail,40,36,7,17,23
80,Fail,44,40,3,13,31
80,Fail,41,41,0,13,28
80,Fail,50,38,2,10,40
80,Fail,37,43,0,16,21
80,Fail,50,35,0,12,38
80,Fail,46,31,0,16,30
80,Fail,53,31,2,14,39
80,Fail,51,34,0,14,37
80,Fail,51,38,0,8,43
80,Fail,49,37,2,12,37
80,Fail,48,39,0,12,36
80,Fail,55,31,0,9,46
80,Fail,44,41,5,10,34
80,Fail,43,32,0,16,27
80,Fail,44,39,2,15,29
80,Fail,53,35,4,8,45
80,Fail,45,39,0,14,31
80,Fail,42,38,10,10,32
80,Fail,45,43,0,11,34
80,Fail,52,36,1,11,41
80,Fail,44,37,1,18,26
80,Fail,48,36,2,14,34
80,Fail,40,44,7,9,31
80,Fail,49,37,0,11,38
80,Fail,50,37,3,10,40
80,Fail,44,45,0,10,34
80,Fail,49,33,6,12,37
80,Fail,47,37,3,13,34
80,Fail,39,38,0,16,23
80,Fail,43,33,0,16,27
80,Fail,45,31,1,23,22
80,Fail,40,41,6,13,27
80,Fail,44,35,6,15,29
80,Fail,46,38,0,14,32
80,Fail,42,34,0,15,27
80,Fail,45,41,3,11,34
80,Fail,44,37,0,11,33
80,Fail,45,38,9,8,37
80,Fail,55,31,6,8,47
80,Fail,49,38,0,11,38
80,Fail,42,37,0,17,25
80,Fail,39,41,5,15,24
80,Fail,45,33,0,16,29
80,Fail,47,40,0,13,34
80,Fail,45,41,0,13,32
80,Fail,42,35,0,10,32
80,Fail,52,35,2,11,41
80,Fail,40,43,0,9,31
80,Fail,49,29,2,20,29
80,Fail,39,37,0,20,19
80,Fail,48,30,6,16,32
80,Fail,40,45,0,10,30
80,Fail,51,38,1,10,41
80,Fail,46,38,0,13,33
80,Fail,46,32,0,11,35
80,Fail,45,35,4,16,29
80,Fail,48,23,0,19,29
80,Fail,50,31,5,14,36
80,Fail,42,29,0,16,26
80,Fail,49,39,0,11,38
80,Fail,50,30,7,13,37
80,Fail,38,41,7,14,24
80,Fail,41,40,6,13,28
80,Fail,43,41,0,16,27
80,Fail,50,37,3,10,40
80,Fail,37,39,0,15,22
80,Fail,47,37,2,14,33
80,Fail,58,28,0,11,47
80,Fail,46,34,0,11,35
80,Fail,46,31,0,17,29
80,Fail,48,25,0,18,30
80,Fail,48,32,5,15,33
80,Fail,50,39,0,9,41
80,Fail,53,34,0,12,41
80,Fail,51,35,0,13,38
80,Fail,47,36,5,12,35
80,Fail,51,32,3,14,37
80,Fail,56,39,1,4,52
80,Fail,48,41,2,9,39
80,Fail,46,36,2,16,30
80,Fail,53,31,0,14,39
80,Fail,54,33,0,12,42
80,Fail,54,29,3,14,40
80,Fail,54,27,5,14,40
80,Fail,51,33,7,9,42
80,Fail,48,40,1,11,37
80,Fail,49,39,2,10,39
80,Fail,52,23,0,14,38
80,Fail,46,37,5,12,34
80,Fail,51,33,0,12,39
80,Fail,51,37,4,8,43
80,Fail,45,37,5,13,32
80,Fail,45,39,4,12,33
80,Fail,49,38,1,12,37
80,Fail,53,32,0,14,39
80,Fail,54,29,0,12,42
80,Fail,52,29,0,12,40
80,Fail,42,31,0,17,25
80,Fail,46,37,0,12,34
80,Fail,46,42,0,11,35
80,Fail,46,47,0,6,40
80,Fail,48,40,0,9,39
80,Fail,41,35,4,20,21
80,Fail,50,35,0,10,40
80,Fail,45,38,0,17,28
80,Fail,38,44,7,11,27
80,Fail,49,36,0,13,36
80,Fail,54,34,0,12,42
80,Fail,47,28,11,14,33
80,Fail,49,33,0,14,35
80,Fail,38,37,0,16,22
80,Fail,52,34,0,8,44
80,Fail,49,40,0,9,40
80,Fail,49,33,2,16,33
80,Fail,42,41,2,15,27
80,Fail,42,38,0,15,27
80,Fail,50,30,0,16,34
80,Fail,47,38,2,13,34
80,Fail,45,36,0,13,32
80,Fail,42,45,3,10,32
80,Fail,56,33,2,9,47
80,Fail,51,29,11,9,42
80,Fail,44,35,0,14,30
80,Fail,51,35,3,11,40
80,Fail,53,27,0,17,36
80,Fail,49,35,0,9,40
80,Fail,46,38,2,14,32
80,Fail,44,42,1,13,31
80,Fail,40,38,0,17,23
80,Fail,49,33,0,13,36
80,Fail,45,28,0,13,32
80,Fail,47,37,0,14,33
80,Fail,39,35,5,21,18
80,Fail,49,40,2,9,40
80,Fail,45,38,1,16,29
80,Fail,47,44,0,8,39
80,Fail,44,39,0,13,31
80,Fail,51,40,0,9,42
80,Fail,48,39,0,8,40
80,Fail,54,36,2,8,46
80,Fail,51,32,0,17,34
80,Fail,50,37,0,13,37
80,Fail,50,31,4,15,35
80,Fail,57,26,2,15,42
80,Fail,42,43,2,13,29
80,Fail,44,40,0,9,35
80,Fail,43,41,2,14,29
80,Fail,49,34,0,9,40
80,Fail,48,35,3,14,34
80,Fail,48,41,0,10,38
80,Fail,47,42,0,11,36
80,Fail,48,27,10,15,33
80,Fail,45,31,0,17,28
80,Fail,54,31,0,14,40
80,Fail,44,42,4,10,34
80,Fail,45,32,0,12,33
80,Fail,46,34,3,17,29
80,Fail,42,40,0,17,25
80,Fail,49,34,0,14,35
80,Fail,46,35,0,10,36
80,Fail,46,42,3,9,37
80,Fail,54,31,0,10,44
80,Fail,46,36,5,13,33
80,Fail,38,38,5,19,19
80,Fail,53,32,0,15,38
80,Fail,40,45,0,10,30
80,Fail,35,48,0,11,24
80,Fail,40,44,8,8,32
80,Fail,52,31,1,16,36
80,Fail,46,39,0,14,32
80,Fail,45,37,0,13,32
80,Fail,51,31,0,11,40
80,Fail,47,36,0,16,31
80,Fail,50,37,4,9,41
80,Fail,55,35,0,9,46
80,Fail,46,32,4,18,28
80,Fail,52,34,0,8,44
80,Fail,58,35,0,6,52
80,Fail,46,37,4,13,33
80,Fail,46,41,0,9,37
80,Fail,46,34,6,14,32
80,Fail,43,36,4,17,26
80,Fail,47,41,0,12,35
80,Fail,49,38,1,12,37
80,Fail,55,34,0,8,47
80,Fail,52,32,0,14,38
80,Fail,48,36,6,10,38
80,Fail,48,25,9,18,30
80,Fail,46,35,6,13,33
80,Fail,46,38,0,16,30
80,Fail,44,44,0,11,33
80,Fail,44,38,0,15,29
80,Fail,48,32,1,19,29
80,Fail,42,42,7,9,33
80,Fail,33,38,0,13,20
80,Fail,55,29,2,14,41
80,Fail,44,41,0,15,29
80,Fail,49,34,0,12,37
80,Fail,42,33,0,15,27
80,Fail,55,32,0,11,44
80,Fail,44,34,9,13,31
80,Fail,37,41,7,15,22
80,Fail,42,36,9,13,29
80,Fail,52,37,0,11,41
80,Fail,50,30,0,13,37
80,Fail,44,31,11,14,30
80,Fail,46,43,0,9,37
80,Fail,55,27,0,18,37
80,Fail,52,35,0,13,39
80,Fail,52,39,2,7,45
80,Fail,45,33,0,15,30
80,Fail,48,37,0,11,37
80,Fail,54,28,5,13,41
80,Fail,54,30,3,13,41
80,Fail,56,30,0,9,47
80,Fail,51,33,5,11,40
80,Fail,40,44,2,14,26
80,Fail,45,35,0,20,25
80,Fail,45,40,4,11,34
80,Fail,52,40,0,7,45
80,Fail,50,31,0,17,33
80,Fail,45,40,0,12,33
80,Fail,49,39,0,12,37
80,Fail,48,34,0,14,34
80,Fail,47,36,5,12,35
80,Fail,57,34,1,8,49
80,Fail,45,39,0,14,31
80,Fail,52,38,0,7,45
80,Fail,56,31,5,8,48
80,Fail,44,35,4,17,27
80,Fail,49,40,0,10,39
80,Fail,43,33,0,13,30
80,Fail,46,39,4,11,35
80,Fail,54,32,6,8,46
80,Fail,48,37,4,11,37
80,Fail,58,30,1,11,47
80,Fail,58,26,0,15,43
80,Fail,45,30,0,19,26
80,Fail,51,35,4,10,41
80,Fail,46,37,0,10,36
80,Fail,52,43,0,3,49
80,Fail,51,30,11,8,43
80,Fail,48,34,3,15,33
80,Fail,52,39,0,9,43
80,Fail,49,34,0,17,32
80,Fail,48,39,3,10,38
80,Fail,54,33,0,10,44
80,Fail,49,35,8,8,41
80,Fail,45,41,0,11,34
80,Fail,47,38,0,9,38
80,Fail,47,34,0,15,32
80,Fail,44,37,0,14,30
80,Fail,44,31,5,20,24
80,Fail,44,39,0,14,30
80,Fail,49,37,0,14,35
80,Fail,49,39,0,11,38
80,Fail,38,45,0,13,25
80,Fail,48,30,0,16,32
80,Fail,52,35,0,9,43
80,Fail,42,36,0,16,26
80,Fail,41,37,0,14,27
80,Fail,51,34,3,12,39
80,Fail,41,32,11,16,25
80,Fail,43,39,5,13,30
80,Fail,51,33,5,11,40
80,Fail,47,31,0,14,33
80,Fail,44,43,0,11,33
80,Fail,44,42,0,10,34
80,Fail,49,32,0,13,36
80,Fail,52,30,0,10,42
80,Fail,53,32,2,13,40
80,Fail,47,37,4,12,35
80,Fail,44,38,5,13,31
80,Fail,50,36,6,8,42
80,Fail,48,35,0,14,34
80,Fail,51,35,2,12,39
80,Fail,51,33,6,10,41
80,Fail,44,34,0,12,32
80,Fail,47,34,10,9,38
80,Fail,43,37,7,13,30
80,Fail,42,49,0,9,33
80,Fail,50,34,0,14,36
80,Fail,48,41,0,8,40
80,Fail,40,38,0,21,19
80,Fail,42,40,3,15,27
80,Fail,43,36,0,14,29
80,Fail,41,36,0,16,25
80,Fail,48,36,5,11,37
80,Fail,55,30,0,12,43
80,Fail,40,36,0,20,20
80,Fail,45,40,0,13,32
80,Fail,52,37,0,11,41
80,Fail,49,33,0,17,32
80,Fail,56,29,0,12,44
80,Fail,46,32,0,17,29
80,Fail,49,39,0,12,37
80,Fail,45,37,10,8,37
80,Fail,58,32,2,8,50
80,Fail,41,30,0,15,26
80,Fail,50,26,7,17,33
80,Fail,54,27,5,14,40
80,Fail,48,31,0,11,37
80,Fail,53,32,0,14,39
80,Fail,54,24,7,15,39
80,Fail,49,40,2,9,40
80,Fail,49,40,0,11,38
80,Fail,45,33,8,14,31
80,Fail,47,36,5,12,35
80,Fail,42,42,0,15,27
80,Fail,40,36,0,16,24
80,Fail,50,38,0,11,39
80,Fail,50,27,8,15,35
80,Fail,52,31,7,10,42
80,Fail,43,36,0,11,32
80,Fail,48,41,1,10,38
80,Fail,53,25,0,19,34
80,Fail,48,40,1,11,37
80,Fail,53,34,0,13,40
80,Fail,54,30,0,14,40
80,Fail,44,44,0,10,34
80,Fail,48,32,0,11,37
80,Fail,49,40,4,7,42
80,Fail,49,32,0,19,30
80,Fail,45,33,0,19,26
80,Fail,40,48,0,9,31
80,Fail,41,34,0,18,23
80,Fail,46,39,3,12,34
80,Fail,55,35,4,6,49
80,Fail,50,30,11,9,41
80,Fail,43,38,3,16,27
80,Fail,48,36,0,13,35
80,Fail,50,30,0,14,36
80,Fail,53,32,2,13,40
80,Fail,56,36,0,3,53
80,Fail,51,36,0,13,38
80,Fail,46,45,0,6,40
80,Fail,50,36,4,10,40
80,Fail,46,34,0,16,30
80,Fail,50,25,0,16,34
80,Fail,55,29,0,11,44
80,Fail,50,35,1,14,36
80,Fail,52,40,0,8,44
80,Fail,52,30,2,16,36
80,Fail,37,34,0,18,19
80,Fail,43,34,0,20,23
80,Fail,49,30,0,16,33
80,Fail,55,31,0,10,45
80,Fail,49,38,1,12,37
80,Fail,44,34,0,19,25
80,Fail,47,38,0,15,32
80,Fail,45,25,13,17,28
80,Fail,44,35,0,11,33
80,Fail,55,38,0,7,48
80,Fail,42,29,8,21,21
80,Fail,50,37,4,9,41
80,Fail,54,28,4,14,40
80,Fail,52,40,3,5,47
80,Fail,43,39,4,14,29
80,Fail,41,38,4,17,24
80,Fail,48,31,0,16,32
80,Fail,45,42,5,8,37
80,Fail,46,37,4,13,33
80,Fail,53,37,0,6,47
80,Fail,54,29,2,15,39
80,Fail,48,34,0,15,33
80,Fail,49,35,2,14,35
80,Fail,49,36,0,15,34
80,Fail,42,49,1,8,34
80,Fail,56,29,4,11,45
80,Fail,49,30,7,14,35
80,Fail,41,38,0,12,29
80,Fail,52,34,0,9,43
80,Fail,45,37,0,17,28
80,Fail,50,34,0,11,39
80,Fail,51,30,0,16,35
80,Fail,43,38,3,16,27
80,Fail,46,35,5,14,32
80,Fail,49,37,0,12,37
80,Fail,56,26,0,12,44
80,Fail,52,29,0,17,35
80,Fail,45,34,3,18,27
80,Fail,45,40,0,10,35
80,Fail,50,32,5,13,37
80,Fail,52,29,5,14,38
80,Fail,52,34,0,12,40
80,Fail,46,35,4,15,31
80,Fail,53,33,0,11,42
80,Fail,42,41,1,16,26
80,Fail,51,43,0,6,45
80,Fail,55,33,1,11,44
80,Fail,43,35,0,14,29
80,Fail,45,35,12,8,37
80,Fail,47,27,0,18,29
80,Fail,56,35,0,8,48
80,Fail,49,35,3,13,36
80,Fail,48,38,0,10,38
80,Fail,48,35,0,11,37
80,Fail,48,41,0,11,37
80,Fail,51,33,0,12,39
80,Fail,55,35,3,7,48
80,Fail,51,35,0,12,39
80,Fail,39,47,1,13,26
80,Fail,54,26,0,17,37
80,Fail,47,40,0,13,34
80,Fail,43,35,7,15,28
80,Fail,35,41,0,17,18
80,Fail,45,41,0,13,32
80,Fail,48,40,1,11,37
80,Fail,46,40,3,11,35
80,Fail,43,43,1,13,30
80,Fail,51,28,8,13,38
80,Fail,53,35,3,9,44
80,Fail,45,40,10,5,40
80,Fail,43,41,6,10,33
80,Fail,49,30,0,19,30
80,Fail,60,30,1,9,51
80,Fail,45,36,4,15,30
80,Fail,51,36,0,13,38
80,Fail,44,46,1,9,35
80,Fail,46,35,6,13,33
80,Fail,50,36,1,13,37
80,Fail,47,26,9,18,29
80,Fail,51,38,1,10,41
80,Fail,54,27,7,12,42
80,Fail,47,31,0,16,31
80,Fail,47,35,3,15,32
80,Fail,49,39,2,10,39
80,Fail,32,47,8,13,19
80,Fail,46,41,0,12,34
80,Fail,51,33,0,13,38
80,Fail,48,42,0,8,40
80,Fail,47,39,7,7,40
80,Fail,51,30,0,14,37
80,Fail,56,30,2,12,44
80,Fail,44,40,3,13,31
80,Fail,58,33,0,9,49
80,Fail,46,38,0,14,32
80,Fail,47,38,0,10,37
80,Fail,48,35,0,16,32
80,Fail,50,35,0,12,38
80,Fail,49,30,4,17,32
80,Fail,45,34,0,17,28
80,Fail,52,27,4,17,35
80,Fail,55,30,3,12,43
80,Fail,44,33,0,16,28
80,Fail,46,39,5,10,36
80,Fail,44,41,1,14,30
80,Fail,53,33,0,12,41
80,Fail,51,39,0,8,43
80,Fail,45,37,0,16,29
80,Fail,43,41,1,15,28
80,Fail,51,35,0,13,38
80,Fail,43,37,0,13,30
80,Fail,49,31,0,12,37
80,Fail,49,32,1,18,31
80,Fail,48,37,1,14,34
80,Fail,54,35,0,10,44
80,Fail,39,36,0,12,27
80,Fail,51,31,9,9,42
80,Fail,45,35,4,16,29
80,Fail,43,39,0,17,26
80,Fail,47,29,5,19,28
80,Fail,50,36,2,12,38
80,Fail,49,35,0,14,35
80,Fail,49,36,3,12,37
80,Fail,50,32,0,12,38
80,Fail,55,29,0,12,43
80,Fail,55,30,7,8,47
80,Fail,46,37,0,13,33
80,Fail,49,32,5,14,35
80,Fail,52,30,0,13,39
80,Fail,51,36,0,8,43
80,Fail,50,42,3,5,45
80,Fail,52,35,0,13,39
80,Fail,48,34,5,13,35
80,Fail,39,37,10,14,25
80,Fail,48,36,0,8,40
80,Fail,53,30,0,11,42
80,Fail,47,36,4,13,34
80,Fail,47,39,3,11,36
80,Fail,40,34,0,19,21
80,Fail,37,39,7,17,20
80,Fail,47,38,4,11,36
80,Fail,42,28,16,14,28
80,Fail,47,33,7,13,34
80,Fail,46,35,0,16,30
80,Fail,40,44,0,15,25
80,Fail,51,32,5,12,39
80,Fail,47,38,1,14,33
80,Fail,49,37,2,12,37
80,Fail,52,27,0,16,36
80,Fail,38,36,11,15,23
80,Fail,48,35,0,10,38
80,Fail,50,38,0,11,39
80,Fail,56,26,0,12,44
80,Fail,52,36,0,12,40
80,Fail,54,34,2,10,44
80,Fail,50,34,0,14,36
80,Fail,46,38,7,9,37
80,Fail,48,33,6,13,35
80,Fail,45,45,0,9,36
80,Fail,40,39,2,19,21
80,Fail,50,30,2,18,32
80,Fail,45,39,0,11,34
80,Fail,43,39,10,8,35
80,Fail,50,38,0,12,38
80,Fail,48,34,2,16,32
80,Fail,45,36,0,16,29
80,Fail,47,40,3,10,37
80,Fail,48,33,0,15,33
80,Fail,49,27,0,16,33
80,Fail,42,37,0,12,30
80,Fail,57,27,0,12,45
80,Fail,46,41,0,11,35
80,Fail,42,43,0,14,28
80,Fail,50,36,0,12,38
80,Fail,49,37,1,13,36
80,Fail,53,33,0,11,42
80,Fail,51,32,0,14,37
80,Fail,53,36,0,9,44
80,Fail,47,36,0,17,30
80,Fail,51,34,0,15,36
80,Fail,45,39,0,14,31
80,Fail,45,39,5,11,34
80,Fail,48,33,7,12,36
80,Fail,46,39,0,7,39
80,Fail,51,35,0,9,42
80,Fail,53,37,0,8,45
80,Fail,44,30,0,15,29
80,Fail,49,33,0,13,36
80,Fail,63,27,0,9,54
80,Fail,50,32,0,14,36
80,Fail,51,38,0,8,43
80,Fail,45,33,5,17,28
80,Fail,41,44,4,11,30
80,Fail,49,42,0,6,43
80,Fail,42,40,0,13,29
80,Fail,47,33,0,15,32
80,Fail,45,32,0,13,32
80,Fail,51,33,0,15,36
80,Fail,55,27,6,12,43
80,Fail,40,39,5,16,24
80,Fail,47,37,0,9,38
80,Fail,45,40,1,14,31
80,Fail,50,36,4,10,40
80,Fail,48,35,1,16,32
80,Fail,52,31,4,13,39
80,Fail,42,33,14,11,31
80,Fail,50,34,3,13,37
80,Fail,53,33,0,14,39
80,Fail,42,40,2,16,26
80,Fail,44,42,0,10,34
80,Fail,48,36,0,9,39
80,Fail,46,34,7,13,33
80,Fail,45,32,13,10,35
80,Fail,54,34,0,10,44
80,Fail,50,37,0,10,40
80,Fail,47,29,0,19,28
80,Fail,50,36,0,14,36
80,Fail,48,39,0,11,37
80,Fail,42,35,0,17,25
80,Fail,47,31,0,14,33
80,Fail,45,26,0,21,24
80,Fail,50,35,2,13,37
80,Fail,46,38,0,9,37
80,Fail,46,40,1,13,33
80,Fail,49,39,0,12,37
80,Fail,48,29,0,18,30
80,Fail,42,38,5,15,27
80,Fail,44,30,10,16,28
80,Fail,56,37,1,6,50
80,Fail,48,37,6,9,39
80,Fail,42,29,0,16,26
80,Fail,52,33,9,6,46
80,Fail,54,31,2,13,41
80,Fail,43,36,0,16,27
80,Fail,48,35,0,14,34
80,Fail,53,33,0,11,42
80,Fail,49,30,0,9,40
80,Fail,42,33,9,16,26
80,Fail,42,39,0,15,27
80,Fail,56,34,1,9,47
80,Fail,46,45,1,8,38
80,Fail,52,33,4,11,41
80,Fail,55,32,0,10,45
80,Fail,55,27,0,10,45
80,Fail,49,36,1,14,35
80,Fail,45,40,0,7,38
80,Fail,48,39,1,12,36
80,Fail,50,33,4,13,37
80,Fail,51,29,7,13,38
80,Fail,42,42,0,11,31
80,Fail,39,36,0,21,18
80,Fail,43,35,5,17,26
80,Fail,43,35,0,15,28
80,Fail,53,34,5,8,45
80,Fail,53,33,0,14,39
80,Fail,48,32,4,16,32
80,Fail,46,35,8,11,35
80,Fail,50,37,0,8,42
80,Fail,54,33,5,8,46
80,Fail,45,33,0,14,31
80,Fail,38,47,3,12,26
80,Fail,43,32,0,21,22
80,Fail,43,38,0,12,31
80,Fail,42,40,4,14,28
80,Fail,52,33,7,8,44
80,Fail,49,39,1,11,38
80,Fail,46,36,7,11,35
80,Fail,52,29,4,15,37
80,Fail,46,41,0,12,34
80,Fail,49,31,0,14,35
80,Fail,48,31,0,17,31
80,Fail,51,37,5,7,44
80,Fail,50,37,0,10,40
80,Fail,51,37,0,10,41
80,Fail,46,35,0,10,36
80,Fail,47,36,0,13,34
80,Fail,54,35,2,9,45
80,Fail,45,36,0,18,27
80,Fail,53,35,4,8,45
80,Fail,52,33,0,14,38
80,Fail,46,38,7,9,37
80,Fail,46,31,0,14,32
80,Fail,39,40,0,19,20
80,Fail,55,32,1,12,43
80,Fail,46,37,4,13,33
80,Fail,48,32,0,13,35
80,Fail,54,33,0,7,47
80,Fail,46,35,0,13,33
80,Fail,49,30,12,9,40
80,Fail,49,34,5,12,37
80,Fail,46,38,2,14,32
80,Fail,44,45,0,11,33
80,Fail,45,37,4,14,31
80,Fail,47,33,0,14,33
80,Fail,45,30,7,18,27
80,Fail,40,33,0,19,21
80,Fail,45,37,0,12,33
80,Fail,45,37,0,15,30
80,Fail,48,35,4,13,35
80,Fail,47,34,6,13,34
80,Fail,48,39,0,9,39
80,Fail,47,35,0,10,37
80,Fail,49,35,0,12,37
80,Fail,52,33,0,12,40
80,Fail,46,38,2,14,32
80,Fail,44,35,0,11,33
80,Fail,49,38,0,9,40
80,Fail,51,42,0,6,45
80,Fail,45,35,0,11,34
80,Fail,52,33,0,13,39
80,Fail,48,38,7,7,41
80,Fail,49,36,0,14,35
80,Fail,47,37,0,11,36
80,Fail,45,34,0,17,28
80,Fail,50,29,0,9,41
80,Fail,45,36,0,14,31
80,Fail,48,36,0,15,33
80,Fail,47,35,4,14,33
80,Fail,49,33,0,16,33
80,Fail,48,42,0,9,39
80,Fail,49,36,5,10,39
80,Fail,41,39,0,14,27
80,Fail,49,42,2,7,42
80,Fail,49,33,0,12,37
80,Fail,54,30,3,13,41
80,Fail,42,41,4,13,29
80,Fail,42,40,0,10,32
80,Fail,43,36,0,15,28
80,Fail,48,31,8,13,35
80,Fail,49,38,0,9,40
80,Fail,59,28,3,10,49
80,Fail,50,35,2,13,37
80,Fail,47,34,7,12,35
80,Fail,47,35,0,15,32
80,Fail,56,37,3,4,52
80,Fail,48,39,0,10,38
80,Fail,41,38,0,17,24
80,Fail,43,32,10,15,28
80,Fail,41,41,4,14,27
80,Fail,48,36,1,15,33
80,Fail,47,37,0,10,37
80,Fail,45,38,8,9,36
80,Fail,49,33,0,17,32
80,Fail,43,38,3,16,27
80,Fail,47,39,1,13,34
80,Fail,42,32,8,18,24
80,Fail,54,33,5,8,46
80,Fail,47,33,7,13,34
80,Fail,50,28,4,18,32
80,Fail,39,29,17,15,24
80,Fail,51,32,0,12,39
80,Fail,43,33,0,17,26
80,Fail,46,35,3,16,30
80,Fail,48,30,7,15,33
80,Fail,48,38,0,10,38
80,Fail,49,39,0,10,39
80,Fail,42,32,9,17,25
80,Fail,46,37,4,13,33
80,Fail,43,40,4,13,30
80,Fail,59,34,0,6,53
80,Fail,48,37,0,12,36
80,Fail,52,33,0,13,39
80,Fail,51,19,12,18,33
80,Fail,47,37,3,13,34
80,Fail,41,40,2,17,24
80,Fail,55,30,6,9,46
80,Fail,48,37,0,12,36
80,Fail,41,38,11,10,31
80,Fail,41,37,7,15,26
80,Fail,49,30,2,19,30
80,Fail,52,35,0,7,45
80,Fail,51,29,7,13,38
80,Fail,46,35,0,12,34
80,Fail,55,33,0,12,43
80,Fail,42,37,0,19,23
80,Fail,48,35,0,9,39
80,Fail,49,36,0,10,39
80,Fail,52,35,0,13,39
80,Fail,41,42,0,13,28
80,Fail,46,37,0,13,33
80,Fail,52,30,0,15,37
80,Fail,51,27,10,12,39
80,Fail,43,40,3,14,29
80,Fail,38,46,0,12,26
80,Fail,51,32,0,13,38
80,Fail,53,35,2,10,43
80,Fail,47,40,2,11,36
80,Fail,43,38,0,17,26
80,Fail,46,42,2,10,36
80,Fail,52,35,0,13,39
80,Fail,40,40,5,15,25
80,Fail,43,40,0,13,30
80,Fail,50,29,0,15,35
80,Fail,47,40,0,9,38
80,Fail,44,39,5,12,32
80,Fail,41,35,0,13,28
80,Fail,48,39,0,11,37
80,Fail,52,35,1,12,40
80,Fail,50,34,2,14,36
80,Fail,43,39,4,14,29
80,Fail,50,35,0,11,39
80,Fail,49,35,0,15,34
80,Fail,52,40,0,8,44
80,Fail,47,38,0,12,35
80,Fail,53,32,3,12,41
80,Fail,47,26,0,18,29
80,Fail,47,34,6,13,34
80,Fail,48,33,0,11,37
80,Fail,41,33,0,22,19
80,Fail,42,40,0,12,30
80,Fail,48,39,0,13,35
80,Fail,44,39,0,13,31
80,Fail,55,31,0,13,42
80,Fail,52,31,6,11,41
80,Fail,57,34,2,7,50
80,Fail,47,35,1,17,30
80,Fail,47,28,0,18,29
80,Fail,43,36,2,19,24
80,Fail,47,37,0,13,34
80,Fail,46,40,0,11,35
80,Fail,45,37,0,15,30
80,Fail,43,40,1,16,27
80,Fail,50,38,2,10,40
80,Fail,50,42,0,8,42
80,Fail,53,39,0,3,50
80,Fail,40,39,6,15,25
80,Fail,52,36,0,11,41
80,Fail,47,36,0,14,33
80,Fail,52,36,4,8,44
80,Fail,51,30,4,15,36
80,Fail,51,34,0,14,37
80,Fail,50,41,1,8,42
80,Fail,45,35,0,17,28
80,Fail,63,23,2,12,51
80,Fail,53,24,4,19,34
80,Fail,48,29,0,16,32
80,Fail,40,44,2,14,26
80,Fail,48,43,0,5,43
80,Fail,56,32,0,10,46
80,Fail,43,43,0,12,31
80,Fail,46,36,7,11,35
80,Fail,51,40,0,9,42
80,Fail,43,41,0,15,28
80,Fail,47,34,9,10,37
80,Fail,53,37,0,10,43
80,Fail,42,37,5,16,26
80,Fail,55,33,1,11,44
80,Fail,55,30,1,14,41
80,Fail,55,32,0,11,44
80,Fail,51,30,7,12,39
80,Fail,43,41,0,15,28
80,Fail,45,38,2,15,30
80,Fail,42,43,0,14,28
80,Fail,50,35,0,15,35
80,Fail,55,30,1,14,41
80,Fail,49,42,1,8,41
80,Fail,47,43,4,6,41
80,Fail,53,30,4,13,40
80,Fail,42,36,0,16,26
80,Fail,40,42,3,15,25
80,Fail,51,31,6,12,39
80,Fail,44,35,0,16,28
80,Fail,44,40,0,16,28
80,Fail,52,31,1,16,36
80,Fail,50,30,0,15,35
80,Fail,47,34,9,10,37
80,Fail,49,31,0,17,32
80,Fail,51,37,1,11,40
80,Fail,36,38,0,15,21
80,Fail,53,32,6,9,44
80,Fail,51,36,1,12,39
80,Fail,56,32,1,11,45
80,Fail,44,43,0,10,34
80,Fail,50,36,4,10,40
80,Fail,52,37,0,10,42
80,Fail,47,33,9,11,36
80,Fail,44,36,0,19,25
80,Fail,39,38,0,13,26
80,Fail,49,33,0,18,31
80,Fail,48,33,3,16,32
80,Fail,57,35,1,7,50
80,Fail,43,34,0,14,29
80,Fail,58,25,5,12,46
80,Fail,48,37,2,13,35
80,Fail,47,40,0,12,35
80,Fail,57,22,0,18,39
80,Fail,52,39,0,9,43
80,Fail,51,36,5,8,43
80,Fail,49,35,0,10,39
80,Fail,57,26,1,16,41
80,Fail,42,42,3,13,29
80,Fail,45,40,1,14,31
80,Fail,45,41,0,9,36
80,Fail,44,49,0,7,37
80,Fail,44,41,5,10,34
80,Fail,41,42,0,9,32
80,Fail,46,42,1,11,35
80,Fail,48,33,5,14,34
80,Fail,50,34,3,13,37
80,Fail,44,45,0,9,35
80,Fail,47,30,7,16,31
80,Fail,50,36,0,11,39
80,Fail,48,41,0,11,37
80,Fail,51,37,4,8,43
80,Fail,51,39,0,10,41
80,Fail,48,37,0,15,33
80,Fail,59,27,5,9,50
80,Fail,51,34,0,13,38
80,Fail,41,35,5,19,22
80,Fail,55,35,0,9,46
80,Fail,49,38,3,10,39
80,Fail,45,42,0,13,32
80,Fail,50,36,2,12,38
80,Fail,45,38,0,17,28
80,Fail,57,26,6,11,46
80,Fail,44,27,0,16,28
80,Fail,52,35,0,12,40
80,Fail,49,39,0,9,40
80,Fail,43,45,1,11,32
80,Fail,44,37,0,12,32
80,Fail,50,35,1,14,36
80,Fail,49,36,0,13,36
80,Fail,47,35,0,12,35
80,Fail,51,37,0,12,39
80,Fail,56,33,1,10,46
80,Fail,54,36,2,8,46
80,Fail,52,36,1,11,41
80,Fail,53,31,0,15,38
80,Fail,46,36,0,12,34
80,Fail,44,35,0,18,26
80,Fail,47,38,3,12,35
80,Fail,57,34,0,9,48
80,Fail,56,32,0,11,45
80,Fail,51,35,0,9,42
80,Fail,46,42,0,10,36
80,Fail,47,36,0,8,39
80,Fail,45,42,2,11,34
80,Fail,45,40,0,15,30
80,Fail,45,39,11,5,40
80,Fail,47,46,0,7,40
80,Fail,48,30,9,13,35
80,Fail,46,35,1,18,28
80,Fail,46,38,0,13,33
80,Fail,38,36,8,18,20
80,Fail,50,34,4,12,38
80,Fail,46,35,0,17,29
80,Fail,45,32,7,16,29
80,Fail,31,42,10,17,14
80,Fail,51,34,0,10,41
80,Fail,43,42,0,14,29
80,Fail,43,38,3,16,27
80,Fail,56,34,0,10,46
80,Fail,52,35,1,12,40
80,Fail,44,34,2,20,24
80,Fail,48,36,0,15,33
80,Fail,49,30,11,10,39
80,Fail,45,41,0,13,32
80,Fail,52,32,2,14,38
80,Fail,43,42,5,10,33
80,Fail,46,33,0,17,29
80,Fail,50,30,0,12,38
80,Fail,47,37,0,8,39
80,Fail,53,27,4,16,37
80,Fail,39,36,0,14,25
80,Fail,43,30,5,22,21
80,Fail,49,35,1,15,34
80,Fail,52,33,0,11,41
80,Fail,53,26,11,10,43
80,Fail,50,40,2,8,42
80,Fail,49,40,3,8,41
80,Fail,40,43,0,16,24
80,Fail,51,31,0,9,42
80,Fail,46,41,1,12,34
80,Fail,47,40,0,11,36
80,Fail,48,29,7,16,32
80,Fail,60,30,1,9,51
80,Fail,42,46,1,11,31
80,Fail,49,27,0,20,29
80,Fail,52,33,9,6,46
80,Fail,50,36,0,12,38
80,Fail,38,39,12,11,27
80,Fail,45,37,0,14,31
80,Fail,42,37,3,18,24
80,Fail,48,32,8,12,36
80,Fail,54,31,0,15,39
80,Fail,50,28,0,19,31
80,Fail,51,35,0,7,44
80,Fail,40,36,0,17,23
80,Fail,48,39,0,8,40
80,Fail,54,32,2,12,42
80,Fail,53,38,2,7,46
80,Fail,53,37,0,7,46
80,Fail,50,40,2,8,42
80,Fail,46,38,7,9,37
80,Fail,40,43,4,13,27
80,Fail,32,36,12,20,12
80,Fail,48,41,1,10,38
80,Fail,50,34,0,14,36
80,Fail,42,40,1,17,25
80,Fail,48,36,4,12,36
80,Fail,40,45,0,14,26
80,Fail,55,33,1,11,44
80,Fail,53,37,0,10,43
80,Fail,47,35,3,15,32
80,Fail,42,39,3,16,26
80,Fail,49,37,0,14,35
80,Fail,46,38,0,12,34
80,Fail,49,38,0,12,37
80,Fail,46,33,5,16,30
80,Fail,47,34,0,9,38
80,Fail,44,36,0,17,27
80,Fail,46,31,9,14,32
80,Fail,51,33,1,15,36
80,Fail,50,30,4,16,34
80,Fail,44,35,0,14,30
80,Fail,48,42,0,6,42
80,Fail,50,33,0,12,38
80,Fail,50,40,0,9,41
80,Fail,47,37,0,15,32
80,Fail,46,32,1,21,25
80,Fail,52,31,0,13,39
80,Fail,53,31,7,9,44
80,Fail,56,34,1,9,47
80,Fail,46,32,6,16,30
80,Fail,53,34,0,12,41
80,Fail,43,38,0,17,26
80,Fail,50,35,3,12,38
80,Fail,47,36,5,12,35
80,Fail,47,37,0,16,31
80,Fail,55,32,0,10,45
80,Fail,53,35,1,11,42
80,Fail,51,33,5,11,40
80,Fail,40,33,0,15,25
80,Fail,43,32,15,10,33
80,Fail,44,40,0,15,29
80,Fail,54,29,0,17,37
80,Fail,46,36,4,14,32
80,Fail,51,34,0,11,40
80,Fail,51,30,0,16,35
80,Fail,47,40,0,12,35
80,Fail,44,38,0,18,26
80,Fail,42,38,9,11,31
80,Fail,55,27,0,12,43
80,Fail,42,39,5,14,28
80,Fail,56,33,0,11,45
80,Fail,53,30,5,12,41
80,Fail,44,43,0,10,34
80,Fail,49,36,1,14,35
80,Fail,49,36,2,13,36
80,Fail,47,35,4,14,33
80,Fail,48,40,1,11,37
80,Fail,39,45,0,14,25
80,Fail,50,34,2,14,36
80,Fail,53,30,0,15,38
80,Fail,43,37,0,13,30
80,Fail,52,41,0,2,50
80,Fail,51,33,0,15,36
80,Fail,45,36,8,11,34
80,Fail,40,43,0,9,31
80,Fail,48,28,0,17,31
80,Fail,47,36,2,15,32
80,Fail,44,42,0,10,34
80,Fail,41,42,0,11,30
80,Fail,48,36,0,11,37
80,Fail,45,41,0,14,31
80,Fail,47,40,0,11,36
80,Fail,54,38,0,8,46
80,Fail,39,44,0,13,26
80,Fail,53,34,2,11,42
80,Fail,49,37,0,13,36
80,Fail,48,34,1,17,31
80,Fail,44,40,0,13,31
80,Fail,42,31,6,21,21
80,Fail,52,35,0,13,39
80,Fail,52,36,0,10,42
80,Fail,39,45,3,13,26
80,Fail,37,38,6,19,18
80,Fail,45,39,3,13,32
80,Fail,50,31,0,11,39
80,Fail,53,29,0,15,38
80,Fail,54,38,0,7,47
80,Fail,49,33,0,18,31
80,Fail,53,31,0,13,40
80,Fail,51,31,10,8,43
80,Fail,44,40,0,13,31
80,Fail,46,42,0,11,35
80,Fail,52,31,6,11,41
80,Fail,54,35,0,11,43
80,Fail,49,34,8,9,40
80,Fail,47,38,5,10,37
80,Fail,52,36,0,11,41
80,Fail,41,45,2,12,29
80,Fail,42,42,0,8,34
80,Fail,44,41,3,12,32
80,Fail,44,41,0,13,31
80,Fail,43,41,2,14,29
80,Fail,51,34,0,12,39
80,Fail,44,39,2,15,29
80,Fail,40,37,6,17,23
80,Fail,55,34,0,5,50
80,Fail,44,41,0,11,33
80,Fail,44,43,2,11,33
80,Fail,53,31,0,16,37
80,Fail,46,37,0,8,38
80,Fail,47,29,0,20,27
80,Fail,35,35,0,21,14
80,Fail,49,36,0,11,38
80,Fail,48,35,3,14,34
80,Fail,39,34,4,23,16
80,Fail,48,33,4,15,33
80,Fail,40,39,4,17,23
80,Fail,51,34,0,7,44
80,Fail,52,42,0,5,47
80,Fail,49,30,0,13,36
80,Fail,46,38,2,14,32
80,Fail,56,31,0,12,44
80,Fail,45,38,1,16,29
80,Fail,45,42,0,10,35
80,Fail,46,30,15,9,37
80,Fail,46,40,0,14,32
80,Fail,57,28,1,14,43
80,Fail,52,38,0,8,44
80,Fail,48,45,4,3,45
80,Fail,54,32,2,12,42
80,Fail,44,33,4,19,25
80,Fail,48,36,0,13,35
80,Fail,45,41,1,13,32
80,Fail,47,45,0,8,39
80,Fail,43,39,8,10,33
80,Fail,42,36,5,17,25
80,Fail,51,38,1,10,41
80,Fail,47,32,0,14,33
80,Fail,46,31,4,19,27
80,Fail,43,36,2,19,24
80,Fail,54,30,0,12,42
80,Fail,43,45,1,11,32
80,Fail,43,31,11,15,28
80,Fail,52,38,0,9,43
80,Fail,52,33,0,10,42
80,Fail,46,37,0,15,31
80,Fail,53,33,6,8,45
80,Fail,40,42,0,15,25
80,Fail,65,23,1,11,54
80,Fail,52,36,0,10,42
80,Fail,53,38,0,9,44
80,Fail,42,40,4,14,28
80,Fail,52,34,3,11,41
80,Fail,40,44,0,11,29
80,Fail,55,31,0,11,44
80,Fail,46,33,0,15,31
80,Fail,48,40,0,10,38
80,Fail,39,43,3,15,24
80,Fail,44,24,15,17,27
80,Fail,46,31,0,17,29
80,Fail,51,37,2,10,41
80,Fail,57,27,6,10,47
80,Fail,53,39,0,7,46
80,Fail,42,40,5,13,29
80,Fail,43,39,4,14,29
80,Fail,54,38,2,6,48
80,Fail,46,40,0,11,35
80,Fail,61,28,0,10,51
80,Fail,39,30,0,16,23
80,Fail,57,28,0,13,44
80,Fail,48,38,0,13,35
80,Fail,50,32,3,15,35
80,Fail,50,35,7,8,42
80,Fail,50,37,1,12,38
80,Fail,39,45,0,15,24
80,Fail,46,35,3,16,30
80,Fail,46,39,1,14,32
80,Fail,45,40,2,13,32
80,Fail,57,31,0,10,47
80,Fail,49,31,4,16,33
80,Fail,55,32,0,13,42
80,Fail,46,39,0,11,35
80,Fail,56,30,0,11,45
80,Fail,50,34,2,14,36
80,Fail,41,40,4,15,26
80,Fail,48,34,1,17,31
80,Fail,50,40,1,9,41
80,Fail,38,33,7,22,16
80,Fail,47,34,0,5,42
80,Fail,55,33,0,9,46
80,Fail,51,30,0,15,36
80,Fail,40,36,11,13,27
80,Fail,50,36,1,13,37
80,Fail,48,35,1,16,32
80,Fail,43,41,0,10,33
80,Fail,46,34,8,12,34
80,Fail,48,39,0,10,38
80,Fail,48,40,0,11,37
80,Fail,50,33,0,12,38
80,Fail,49,23,16,12,37
80,Fail,41,28,13,18,23
80,Fail,50,31,6,13,37
80,Fail,49,33,0,14,35
80,Fail,39,35,12,14,25
80,Fail,38,33,0,19,19
80,Fail,50,32,5,13,37
80,Fail,45,38,4,13,32
80,Fail,49,33,0,12,37
80,Fail,47,29,9,15,32
80,Fail,45,35,6,14,31
80,Fail,40,39,3,18,22
80,Fail,48,34,8,10,38
80,Fail,44,35,7,14,30
80,Fail,52,37,1,10,42
80,Fail,49,37,1,13,36
80,Fail,51,31,4,14,37
80,Fail,40,39,6,15,25
80,Fail,45,32,0,18,27
80,Fail,50,32,0,11,39
80,Fail,44,39,0,11,33
80,Fail,48,37,0,11,37
80,Fail,43,33,10,14,29
80,Fail,48,35,4,13,35
80,Fail,52,37,2,9,43
80,Fail,46,37,0,17,29
80,Fail,47,35,0,12,35
80,Fail,55,29,0,13,42
80,Fail,43,43,1,13,30
80,Fail,50,38,0,9,41
80,Fail,48,27,0,19,29
80,Fail,46,33,7,14,32
80,Fail,47,35,0,14,33
80,Fail,46,42,0,11,35
80,Fail,47,35,3,15,32
80,Fail,47,42,3,8,39
80,Fail,46,30,0,17,29
80,Fail,47,27,5,21,26
80,Fail,48,37,2,13,35
80,Fail,55,33,0,10,45
80,Fail,49,36,1,14,35
80,Fail,52,35,0,11,41
80,Fail,49,31,5,15,34
80,Fail,53,32,0,15,38
80,Fail,48,28,13,11,37
80,Fail,44,42,2,12,32
80,Fail,46,38,0,13,33
80,Fail,46,36,0,16,30
80,Fail,48,32,5,15,33
80,Fail,51,34,5,10,41
80,Fail,38,40,0,19,19
80,Fail,48,40,0,8,40
80,Fail,51,32,0,15,36
80,Fail,39,38,0,10,29
80,Fail,44,36,7,13,31
80,Fail,45,25,0,17,28
80,Fail,40,38,10,12,28
80,Fail,55,34,1,10,45
80,Fail,44,32,0,14,30
80,Fail,46,38,0,16,30
80,Fail,44,28,8,20,24
80,Fail,40,50,0,8,32
80,Fail,42,42,6,10,32
80,Fail,44,40,6,10,34
80,Fail,45,37,1,17,28
80,Fail,53,27,0,16,37
80,Fail,49,34,7,10,39
80,Fail,45,41,5,9,36
80,Fail,48,38,0,10,38
80,Fail,48,42,1,9,39
80,Fail,48,33,0,17,31
80,Fail,47,40,0,13,34
80,Fail,49,36,5,10,39
80,Fail,47,34,7,12,35
80,Fail,41,44,1,14,27
80,Fail,37,45,0,13,24
80,Fail,52,36,0,12,40
80,Fail,42,32,0,20,22
80,Fail,47,38,3,12,35
80,Fail,48,40,0,11,37
80,Fail,57,29,0,12,45
80,Fail,54,34,0,7,47
80,Fail,48,35,2,15,33
80,Fail,46,39,0,15,31
80,Fail,49,36,9,6,43
80,Fail,43,41,3,13,30
80,Fail,47,38,1,14,33
80,Fail,61,30,0,6,55
80,Fail,53,33,0,11,42
80,Fail,45,34,5,16,29
80,Fail,48,40,3,9,39
80,Fail,44,37,5,14,30
80,Fail,48,39,2,11,37
80,Fail,53,28,4,15,38
80,Fail,46,42,1,11,35
80,Fail,41,34,0,17,24
80,Fail,50,36,3,11,39
80,Fail,55,29,0,13,42
80,Fail,43,42,6,9,34
80,Fail,53,32,2,13,40
80,Fail,45,36,4,15,30
80,Fail,51,34,0,12,39
80,Fail,47,36,0,9,38
80,Fail,51,29,0,13,38
80,Fail,52,35,7,6,46
80,Fail,50,32,5,13,37
80,Fail,45,41,0,13,32
80,Fail,35,48,0,8,27
80,Fail,52,33,0,14,38
80,Fail,45,35,5,15,30
80,Fail,50,36,5,9,41
80,Fail,45,38,7,10,35
80,Fail,50,39,1,10,40
80,Fail,47,27,11,15,32
80,Fail,47,34,7,12,35
80,Fail,44,33,5,18,26
80,Fail,49,41,0,9,40
80,Fail,48,36,0,12,36
80,Fail,50,32,0,10,40
80,Fail,48,28,0,18,30
80,Fail,52,31,0,11,41
80,Fail,49,33,3,15,34
80,Fail,50,36,0,11,39
80,Fail,46,35,4,15,31
80,Fail,50,41,0,9,41
80,Fail,53,38,0,8,45
80,Fail,54,30,0,11,43
80,Fail,48,36,4,12,36
80,Fail,48,37,0,14,34
80,Fail,51,30,3,16,35
80,Fail,54,28,3,15,39
80,Fail,46,44,0,9,37
80,Fail,56,31,0,9,47
80,Fail,49,37,1,13,36
80,Fail,56,32,0,9,47
80,Fail,53,37,0,10,43
80,Fail,45,36,12,7,38
80,Fail,42,42,0,15,27
80,Fail,43,38,0,14,29
80,Fail,63,29,0,8,55
80,Fail,50,26,0,17,33
80,Fail,44,39,0,13,31
80,Fail,56,32,0,10,46
80,Fail,34,46,8,12,22
80,Fail,48,28,5,19,29
80,Fail,47,37,0,11,36
80,Fail,50,33,0,10,40
80,Fail,45,43,0,11,34
80,Fail,40,42,0,18,22
80,Fail,51,35,0,13,38
80,Fail,39,46,4,11,28
80,Fail,46,32,13,9,37
80,Fail,50,31,6,13,37
80,Fail,44,33,0,16,28
80,Fail,46,45,0,7,39
80,Fail,45,37,3,15,30
80,Fail,47,39,1,13,34
80,Fail,53,35,0,9,44
80,Fail,49,33,8,10,39
80,Fail,45,43,0,11,34
80,Fail,50,35,2,13,37
80,Fail,49,27,0,13,36
80,Fail,47,39,0,13,34
80,Fail,41,35,0,15,26
80,Fail,49,33,6,12,37
80,Fail,55,33,0,11,44
80,Fail,44,40,0,7,37
80,Fail,50,30,0,18,32
80,Fail,52,35,3,10,42
80,Fail,44,37,6,13,31
80,Fail,53,33,1,13,40
80,Fail,41,40,0,16,25
80,Fail,36,45,6,13,23
80,Fail,45,36,8,11,34
80,Fail,49,31,0,16,33
80,Fail,48,34,0,11,37
80,Fail,45,43,0,9,36
80,Fail,54,38,0,7,47
80,Fail,45,40,1,14,31
80,Fail,50,26,0,15,35
80,Fail,48,41,0,10,38
80,Fail,50,34,3,13,37
80,Fail,47,41,0,12,35
80,Fail,44,46,1,9,35
80,Fail,56,32,0,9,47
80,Fail,48,29,0,10,38
80,Fail,46,42,0,12,34
80,Fail,50,38,5,7,43
80,Fail,47,33,0,17,30
80,Fail,41,39,4,16,25
80,Fail,42,30,12,16,26
80,Fail,52,32,4,12,40
80,Fail,46,39,5,10,36
80,Fail,45,32,8,15,30
80,Fail,49,36,1,14,35
80,Fail,45,37,1,17,28
80,Fail,39,42,0,16,23
80,Fail,47,36,4,13,34
80,Fail,44,42,0,11,33
80,Fail,48,34,7,11,37
80,Fail,43,38,8,11,32
80,Fail,46,34,1,19,27
80,Fail,48,34,0,9,39
80,Fail,40,39,8,13,27
80,Fail,51,31,0,16,35
80,Fail,41,29,0,14,27
80,Fail,54,36,2,8,46
80,Fail,53,37,0,10,43
80,Fail,48,33,7,12,36
80,Fail,43,40,0,12,31
80,Fail,48,35,0,14,34
80,Fail,50,30,6,14,36
80,Fail,43,33,13,11,32
80,Fail,50,34,0,16,34
80,Fail,52,27,2,19,33
80,Fail,48,37,0,14,34
80,Fail,47,31,0,16,31
80,Fail,49,35,4,12,37
80,Fail,49,30,0,16,33
80,Fail,54,28,0,11,43
80,Fail,56,29,0,13,43
80,Fail,50,38,3,9,41
80,Fail,46,38,0,15,31
80,Fail,55,30,0,13,42
80,Fail,46,39,1,14,32
80,Fail,49,35,0,10,39
80,Fail,41,34,10,15,26
80,Fail,45,39,0,10,35
80,Fail,48,42,0,10,38
80,Fail,52,38,0,10,42
80,Fail,45,32,10,13,32
80,Fail,48,36,0,9,39
80,Fail,48,34,5,13,35
80,Fail,52,38,4,6,46
80,Fail,50,30,8,12,38
80,Fail,49,37,0,10,39
80,Fail,53,35,0,12,41
80,Fail,42,38,3,17,25
80,Fail,51,34,0,13,38
80,Fail,45,37,1,17,28
80,Fail,42,38,3,17,25
80,Fail,48,37,2,13,35
80,Fail,44,46,0,7,37
80,Fail,55,30,0,14,41
80,Fail,47,36,6,11,36
80,Fail,48,41,3,8,40
80,Fail,47,33,0,14,33
80,Fail,53,33,0,9,44
80,Fail,44,44,2,10,34
80,Fail,38,41,0,15,23
80,Fail,52,35,0,10,42
80,Fail,38,37,8,17,21
80,Fail,45,37,0,15,30
80,Fail,54,35,2,9,45
80,Fail,55,35,0,9,46
80,Fail,48,42,0,5,43
80,Fail,50,33,2,15,35
80,Fail,49,39,0,10,39
80,Fail,53,33,0,14,39
80,Fail,50,37,0,10,40
80,Fail,44,37,0,16,28
80,Fail,50,43,0,5,45
80,Fail,51,36,0,12,39
80,Fail,49,36,0,14,35
80,Fail,53,35,1,11,42
80,Fail,50,39,0,10,40
80,Fail,52,40,2,6,46
80,Fail,53,29,9,9,44
80,Fail,53,35,3,9,44
80,Fail,49,32,1,18,31
80,Fail,50,28,9,13,37
80,Fail,47,34,0,12,35
80,Fail,51,34,3,12,39
80,Fail,53,36,1,10,43
80,Fail,48,33,0,13,35
80,Fail,50,34,0,14,36
80,Fail,48,36,0,13,35
80,Fail,42,43,2,13,29
80,Fail,42,41,5,12,30
80,Fail,45,39,0,14,31
80,Fail,46,31,13,10,36
80,Fail,46,34,0,13,33
80,Fail,49,38,0,8,41
80,Fail,55,25,0,11,44
80,Fail,40,36,5,19,21
80,Fail,48,31,5,16,32
80,Fail,51,28,2,19,32
80,Fail,47,34,3,16,31
80,Fail,56,34,0,7,49
80,Fail,53,33,0,14,39
80,Fail,41,39,0,15,26
80,Fail,46,35,0,16,30
80,Fail,49,36,5,10,39
80,Fail,54,30,0,14,40
80,Fail,46,34,5,15,31
80,Fail,52,30,5,13,39
80,Fail,51,36,2,11,40
80,Fail,53,37,0,8,45
80,Fail,50,37,1,12,38
80,Fail,42,39,8,11,31
80,Fail,52,34,3,11,41
80,Fail,45,38,0,14,31
80,Fail,48,38,3,11,37
80,Fail,52,26,2,20,32
80,Fail,43,31,0,12,31
80,Fail,47,38,0,15,32
80,Fail,45,32,6,17,28
80,Fail,45,40,2,13,32
80,Fail,48,37,0,12,36
80,Fail,48,37,0,14,34
80,Fail,51,35,1,13,38
80,Fail,56,28,4,12,44
80,Fail,52,41,0,5,47
80,Fail,51,31,3,15,36
80,Fail,47,35,0,10,37
80,Fail,47,31,8,14,33
80,Fail,39,44,0,13,26
80,Fail,39,46,0,12,27
80,Fail,51,31,3,15,36
80,Fail,39,47,0,12,27
80,Fail,37,50,0,11,26
80,Fail,48,30,0,13,35
80,Fail,49,31,5,15,34
80,Fail,42,40,0,9,33
80,Fail,39,39,0,17,22
80,Fail,53,36,0,11,42
80,Fail,39,42,4,15,24
80,Fail,42,38,0,13,29
80,Fail,46,42,2,10,36
80,Fail,50,30,11,9,41
80,Fail,42,42,3,13,29
80,Fail,45,40,0,11,34
80,Fail,45,38,4,13,32
80,Fail,50,34,2,14,36
80,Fail,40,32,0,17,23
80,Fail,45,35,6,14,31
80,Fail,50,36,0,12,38
80,Fail,44,42,0,12,32
80,Fail,41,43,5,11,30
80,Fail,48,40,1,11,37
80,Fail,42,35,7,16,26
80,Fail,47,35,8,10,37
80,Fail,44,37,5,14,30
80,Fail,48,37,0,13,35
80,Fail,48,28,9,15,33
80,Fail,45,34,3,18,27
80,Fail,63,29,0,8,55
80,Fail,55,35,0,9,46
80,Fail,45,37,0,18,27
80,Fail,45,39,0,15,30
80,Fail,43,42,4,11,32
80,Fail,56,29,0,12,44
80,Fail,41,40,0,12,29
80,Fail,53,30,4,13,40
80,Fail,46,35,0,14,32
80,Fail,43,39,4,14,29
80,Fail,45,36,0,14,31
80,Fail,43,35,0,18,25
80,Fail,53,29,1,17,36
80,Fail,46,43,0,11,35
80,Fail,46,33,8,13,33
80,Fail,51,38,0,9,42
80,Fail,51,34,0,9,42
80,Fail,54,33,0,13,41
80,Fail,53,34,3,10,43
80,Fail,42,41,4,13,29
80,Fail,49,32,0,18,31
80,Fail,49,36,0,12,37
80,Fail,58,28,3,11,47
80,Fail,42,38,8,12,30
80,Fail,53,27,0,12,41
80,Fail,54,32,1,13,41
80,Fail,46,36,0,12,34
80,Fail,45,34,2,19,26
80,Fail,48,36,0,16,32
80,Fail,51,34,10,5,46
80,Fail,44,36,5,15,29
80,Fail,43,40,3,14,29
80,Fail,50,37,1,12,38
80,Fail,47,34,0,17,30
80,Fail,55,36,0,9,46
80,Fail,53,34,4,9,44
80,Fail,52,37,0,11,41
80,Fail,45,34,5,16,29
80,Fail,60,27,4,9,51
80,Fail,42,38,0,14,28
80,Fail,49,41,0,9,40
80,Fail,44,39,1,16,28
80,Fail,45,43,1,11,34
80,Fail,43,37,3,17,26
80,Fail,53,33,0,14,39
80,Fail,44,37,3,16,28
80,Fail,43,38,5,14,29
80,Fail,53,37,0,6,47
80,Fail,46,34,0,13,33
80,Fail,44,28,0,16,28
80,Fail,47,38,0,10,37
80,Fail,54,28,0,15,39
80,Fail,47,34,5,14,33
80,Fail,49,38,0,11,38
80,Fail,53,35,0,11,42
80,Fail,50,39,1,10,40
80,Fail,44,36,4,16,28
80,Fail,44,29,14,13,31
80,Fail,53,37,0,10,43
80,Fail,49,37,1,13,36
80,Fail,49,38,1,12,37
80,Fail,56,32,0,11,45
80,Fail,47,39,3,11,36
80,Fail,44,31,0,13,31
80,Fail,51,32,0,16,35
80,Fail,55,34,0,10,45
80,Fail,53,30,0,15,38
80,Fail,52,35,2,11,41
80,Fail,43,37,3,17,26
80,Fail,42,43,0,14,28
80,Fail,53,34,0,11,42
80,Fail,45,32,0,20,25
80,Fail,51,34,6,9,42
80,Fail,52,41,1,6,46
80,Fail,44,41,0,11,33
80,Fail,44,38,0,17,27
80,Fail,53,33,6,8,45
80,Fail,50,42,0,8,42
80,Fail,52,39,0,6,46
80,Fail,42,34,0,15,27
80,Fail,47,39,3,11,36
80,Fail,55,29,5,11,44
80,Fail,49,37,0,12,37
80,Fail,46,32,10,12,34
80,Fail,46,35,5,14,32
80,Fail,50,40,0,9,41
80,Fail,44,30,0,18,26
80,Fail,49,31,0,16,33
80,Fail,46,35,0,10,36
80,Fail,54,31,7,8,46
80,Fail,48,31,0,15,33
80,Fail,48,40,0,12,36
80,Fail,44,37,0,11,33
80,Fail,46,36,0,6,40
80,Fail,48,27,10,15,33
80,Fail,44,38,4,14,30
80,Fail,51,27,8,14,37
80,Fail,43,42,0,13,30
80,Fail,46,38,0,14,32
80,Fail,53,39,1,7,46
80,Fail,41,35,7,17,24
80,Fail,49,37,1,13,36
80,Fail,45,45,2,8,37
80,Fail,45,38,0,13,32
80,Fail,51,34,0,15,36
80,Fail,49,36,4,11,38
80,Fail,42,33,0,18,24
80,Fail,50,35,0,13,37
80,Fail,47,40,0,8,39
80,Fail,54,32,0,14,40
80,Fail,48,30,1,21,27
80,Fail,50,26,4,20,30
80,Fail,52,35,3,10,42
80,Fail,42,39,2,17,25
80,Fail,48,39,0,12,36
80,Fail,33,43,7,17,16
80,Fail,50,36,6,8,42
80,Fail,52,35,1,12,40
80,Fail,48,35,0,14,34
80,Fail,43,33,9,15,28
80,Fail,49,39,0,12,37
80,Fail,48,33,2,17,31
80,Fail,49,30,0,12,37
80,Fail,44,44,1,11,33
80,Fail,39,37,0,11,28
80,Fail,50,29,6,15,35
80,Fail,53,35,0,11,42
80,Fail,45,39,0,14,31
80,Fail,37,41,8,14,23
80,Fail,45,35,0,20,25
80,Fail,49,36,0,14,35
80,Fail,50,36,1,13,37
80,Fail,45,47,3,5,40
80,Fail,41,36,7,16,25
80,Fail,53,34,0,11,42
80,Fail,51,35,3,11,40
80,Fail,54,29,3,14,40
80,Fail,49,38,5,8,41
80,Fail,43,43,0,12,31
80,Fail,48,36,0,16,32
80,Fail,44,41,4,11,33
80,Fail,51,37,3,9,42
80,Fail,54,32,0,11,43
80,Fail,59,28,1,12,47
80,Fail,52,38,0,10,42
80,Fail,51,32,6,11,40
80,Fail,49,32,2,17,32
80,Fail,49,34,0,14,35
80,Fail,45,30,0,18,27
80,Fail,54,28,0,13,41
80,Fail,45,38,0,15,30
80,Fail,48,38,0,11,37
80,Fail,43,43,0,9,34
80,Fail,42,48,1,9,33
80,Fail,44,33,0,10,34
80,Fail,49,36,0,14,35
80,Fail,46,40,0,11,35
80,Fail,47,38,0,9,38
80,Fail,49,39,1,11,38
80,Fail,51,37,0,7,44
80,Fail,50,35,2,13,37
80,Fail,44,34,0,16,28
80,Fail,55,22,12,11,44
80,Fail,48,35,8,9,39
80,Fail,48,32,0,16,32
80,Fail,48,39,0,13,35
80,Fail,54,34,0,11,43
80,Fail,50,36,0,12,38
80,Fail,52,32,5,11,41
80,Fail,52,37,1,10,42
80,Fail,46,40,0,7,39
80,Fail,50,35,0,15,35
80,Fail,44,36,5,15,29
80,Fail,42,37,6,15,27
80,Fail,47,34,7,12,35
80,Fail,53,31,0,8,45
80,Fail,48,39,0,13,35
80,Fail,51,30,0,15,36
80,Fail,50,37,0,11,39
80,Fail,44,34,9,13,31
80,Fail,46,38,0,16,30
80,Fail,52,33,0,12,40
80,Fail,43,43,2,12,31
80,Fail,48,39,5,8,40
80,Fail,52,32,0,11,41
80,Fail,52,34,0,13,39
80,Fail,50,35,0,15,35
80,Fail,47,38,0,14,33
80,Fail,51,35,0,13,38
80,Fail,44,41,3,12,32
80,Fail,51,39,0,9,42
80,Fail,47,39,0,14,33
80,Fail,47,35,0,17,30
80,Fail,49,38,4,9,40
80,Fail,43,40,0,13,30
80,Fail,49,36,4,11,38
80,Fail,44,41,0,13,31
80,Fail,53,32,0,10,43
80,Fail,42,45,0,7,35
80,Fail,49,36,3,12,37
80,Fail,54,34,1,11,43
80,Fail,51,39,1,9,42
80,Fail,50,29,0,20,30
80,Fail,40,38,11,11,29
80,Fail,57,31,2,10,47
80,Fail,50,32,0,11,39
80,Fail,46,41,3,10,36
80,Fail,46,35,2,17,29
80,Fail,51,36,2,11,40
80,Fail,51,31,0,13,38
80,Fail,37,44,8,11,26
80,Fail,53,36,0,11,42
80,Fail,48,39,1,12,36
80,Fail,47,36,0,13,34
80,Fail,49,39,5,7,42
80,Fail,52,32,0,14,38
80,Fail,48,36,9,7,41
80,Fail,41,35,10,14,27
80,Fail,41,40,0,14,27
80,Fail,47,40,0,10,37
80,Fail,49,35,0,9,40
80,Fail,50,37,0,12,38
80,Fail,46,38,0,14,32
80,Fail,51,39,0,10,41
80,Fail,44,32,6,18,26
80,Fail,47,36,0,9,38
80,Fail,46,32,8,14,32
80,Fail,46,35,6,13,33
80,Fail,41,37,0,10,31
80,Fail,47,33,0,11,36
80,Fail,60,32,0,8,52
80,Fail,45,37,2,16,29
80,Fail,51,35,1,13,38
80,Fail,47,37,0,12,35
80,Fail,46,34,0,16,30
80,Fail,50,34,6,10,40
80,Fail,49,27,0,12,37
80,Fail,52,27,4,17,35
80,Fail,46,35,0,16,30
80,Fail,46,40,0,12,34
80,Fail,48,34,4,14,34
80,Fail,56,32,1,11,45
80,Fail,55,33,2,10,45
80,Fail,45,42,0,10,35
80,Fail,45,37,4,14,31
80,Fail,46,37,1,16,30
80,Fail,46,36,3,15,31
80,Fail,49,32,0,14,35
80,Fail,47,29,2,22,25
80,Fail,48,38,0,12,36
80,Fail,49,38,4,9,40
80,Fail,46,33,3,18,28
80,Fail,42,45,0,11,31
80,Fail,50,32,4,14,36
80,Fail,53,29,0,13,40
80,Fail,50,29,5,16,34
80,Fail,40,41,0,15,25
80,Fail,51,32,0,15,36
80,Fail,56,22,0,19,37
80,Fail,44,33,6,17,27
80,Fail,50,33,0,13,37
80,Fail,49,31,7,13,36
80,Fail,49,36,1,14,35
80,Fail,46,38,1,15,31
80,Fail,47,40,0,13,34
80,Fail,51,35,1,13,38
80,Fail,49,36,5,10,39
80,Fail,46,37,4,13,33
80,Fail,55,30,0,10,45
80,Fail,45,41,0,14,31
80,Fail,51,37,0,9,42
80,Fail,43,38,6,13,30
80,Fail,43,36,0,13,30
80,Fail,44,40,4,12,32
80,Fail,47,31,7,15,32
80,Fail,45,44,0,8,37
80,Fail,52,38,1,9,43
80,Fail,42,38,0,17,25
80,Fail,46,34,6,14,32
80,Fail,49,34,3,14,35
80,Fail,49,41,0,8,41
80,Fail,46,39,0,14,32
80,Fail,48,36,0,15,33
80,Fail,48,42,0,7,41
80,Fail,46,36,0,18,28
80,Fail,46,35,0,19,27
80,Fail,44,40,0,16,28
80,Fail,42,39,4,15,27
80,Fail,48,36,0,8,40
80,Fail,51,34,0,9,42
80,Fail,38,40,0,15,23
80,Fail,39,44,1,16,23
80,Fail,49,40,0,11,38
80,Fail,41,32,0,18,23
80,Fail,47,28,0,16,31
80,Fail,43,30,0,14,29
80,Fail,48,31,4,17,31
80,Fail,50,36,0,13,37
80,Fail,45,44,0,6,39
80,Fail,49,32,3,16,33
80,Fail,42,37,12,9,33
80,Fail,45,35,0,10,35
80,Fail,52,31,0,13,39
80,Fail,40,41,3,16,24
80,Fail,45,38,2,15,30
80,Fail,52,38,0,10,42
80,Fail,47,36,0,17,30
80,Fail,49,40,0,8,41
80,Fail,45,39,0,14,31
80,Fail,56,29,0,14,42
80,Fail,55,31,0,10,45
80,Fail,40,38,10,12,28
80,Fail,53,42,1,4,49
80,Fail,45,40,2,13,32
80,Fail,48,40,5,7,41
80,Fail,49,28,0,17,32
80,Fail,43,29,0,16,27
80,Fail,42,36,9,13,29
80,Fail,50,36,2,12,38
80,Fail,53,35,0,12,41
80,Fail,44,36,7,13,31
80,Fail,54,34,0,10,44
80,Fail,51,37,0,11,40
80,Fail,52,35,0,12,40
80,Fail,45,38,0,14,31
80,Fail,48,33,3,16,32
80,Fail,44,33,0,15,29
80,Fail,55,37,1,7,48
80,Fail,39,42,0,19,20
80,Fail,53,31,0,11,42
80,Fail,47,37,2,14,33
80,Fail,46,33,7,14,32
80,Fail,46,39,0,11,35
80,Fail,43,37,0,14,29
80,Fail,46,38,0,12,34
80,Fail,50,28,0,9,41
80,Fail,53,27,0,11,42
80,Fail,50,39,0,11,39
80,Fail,54,34,3,9,45
80,Fail,47,33,0,12,35
80,Fail,54,35,0,10,44
80,Fail,39,37,0,15,24
80,Fail,43,39,0,14,29
80,Fail,46,31,11,12,34
80,Fail,50,28,0,12,38
80,Fail,55,31,0,14,41
80,Fail,49,35,4,12,37
80,Fail,45,40,0,12,33
80,Fail,43,43,8,6,37
80,Fail,54,27,6,13,41
80,Fail,44,39,1,16,28
80,Fail,42,40,0,14,28
80,Fail,51,35,0,7,44
80,Fail,55,30,0,8,47
80,Fail,50,37,0,11,39
80,Fail,39,36,14,11,28
80,Fail,51,33,0,13,38
80,Fail,45,36,0,19,26
80,Fail,50,40,0,9,41
80,Fail,54,32,5,9,45
80,Fail,47,32,7,14,33
80,Fail,43,42,5,10,33
80,Fail,52,41,2,5,47
80,Fail,50,30,0,15,35
80,Fail,47,41,0,12,35
80,Fail,47,38,3,12,35
80,Fail,44,40,4,12,32
80,Fail,40,44,6,10,30
80,Fail,49,38,0,10,39
80,Fail,46,28,0,15,31
80,Fail,44,36,2,18,26
80,Fail,47,44,0,8,39
80,Fail,53,32,4,11,42
80,Fail,34,43,9,14,20
80,Fail,46,33,1,20,26
80,Fail,44,41,3,12,32
80,Fail,46,36,0,15,31
80,Fail,46,36,0,15,31
80,Fail,43,44,1,12,31
80,Fail,54,29,5,12,42
80,Fail,47,37,6,10,37
80,Fail,40,30,0,14,26
80,Fail,48,42,1,9,39
80,Fail,50,33,0,14,36
80,Fail,55,34,0,5,50
80,Fail,45,37,0,18,27
80,Fail,54,32,0,8,46
80,Fail,52,36,0,12,40
80,Fail,50,35,0,14,36
80,Fail,56,33,4,7,49
80,Fail,54,38,2,6,48
80,Fail,48,37,2,13,35
80,Fail,53,37,0,8,45
80,Fail,49,34,6,11,38
80,Fail,51,30,4,15,36
80,Fail,49,40,3,8,41
80,Fail,50,37,0,9,41
80,Fail,44,36,0,16,28
80,Fail,53,42,0,5,48
80,Fail,45,36,7,12,33
80,Fail,54,37,0,6,48
80,Fail,51,35,1,13,38
80,Fail,50,34,1,15,35
80,Fail,42,37,0,19,23
80,Fail,49,35,5,11,38
80,Fail,49,33,0,13,36
80,Fail,50,38,5,7,43
80,Fail,45,32,9,14,31
80,Fail,49,34,1,16,33
80,Fail,40,36,12,12,28
80,Fail,52,31,0,12,40
80,Fail,40,41,0,14,26
80,Fail,50,29,4,17,33
80,Fail,37,38,0,17,20
80,Fail,50,28,7,15,35
80,Fail,52,32,4,12,40
80,Fail,52,38,0,9,43
80,Fail,42,40,9,9,33
80,Fail,46,27,9,18,28
80,Fail,47,40,0,13,34
80,Fail,45,40,0,9,36
80,Fail,45,37,2,16,29
80,Fail,56,33,4,7,49
80,Fail,43,34,0,23,20
80,Fail,52,36,6,6,46
80,Fail,44,38,0,12,32
80,Fail,55,30,2,13,42
80,Fail,41,34,7,18,23
80,Fail,59,31,0,9,50
80,Fail,50,38,0,8,42
80,Fail,47,34,1,18,29
80,Fail,56,31,0,9,47
80,Fail,48,35,0,13,35
80,Fail,42,46,0,11,31
80,Fail,50,37,0,12,38
80,Fail,47,33,0,17,30
80,Fail,53,34,2,11,42
80,Fail,51,34,0,9,42
80,Fail,50,31,0,14,36
80,Fail,46,43,6,5,41
80,Fail,37,41,3,19,18
80,Fail,41,40,2,17,24
80,Fail,48,40,2,10,38
80,Fail,51,35,0,9,42
80,Fail,46,35,2,17,29
80,Fail,54,30,0,15,39
80,Fail,42,38,0,20,22
80,Fail,45,33,0,17,28
80,Fail,49,33,7,11,38
80,Fail,47,36,0,13,34
80,Fail,52,33,0,13,39
80,Fail,51,34,1,14,37
80,Fail,50,33,1,16,34
80,Fail,54,35,1,10,44
80,Fail,53,35,0,11,42
80,Fail,48,29,9,14,34
80,Fail,47,38,3,12,35
80,Fail,42,38,0,13,29
80,Fail,43,38,0,12,31
80,Fail,52,41,0,7,45
80,Fail,47,35,0,14,33
80,Fail,52,32,0,10,42
80,Fail,47,39,0,12,35
80,Fail,48,36,0,10,38
80,Fail,50,32,1,17,33
80,Fail,43,35,0,10,33
80,Fail,46,31,0,23,23
80,Fail,50,33,0,16,34
80,Fail,61,30,0,6,55
80,Fail,37,42,4,17,20
80,Fail,49,39,0,12,37
80,Fail,47,36,0,16,31
80,Fail,41,36,5,18,23
80,Fail,49,41,0,10,39
80,Fail,57,32,0,8,49
80,Fail,42,34,0,14,28
80,Fail,46,38,7,9,37
80,Fail,47,35,0,10,37
80,Fail,53,29,0,17,36
80,Fail,53,36,0,11,42
80,Fail,45,35,6,14,31
80,Fail,48,33,6,13,35
80,Fail,48,36,3,13,35
80,Fail,43,41,4,12,31
80,Fail,55,31,0,12,43
80,Fail,45,36,0,18,27
80,Fail,49,32,0,18,31
80,Fail,55,27,7,11,44
80,Fail,46,38,2,14,32
80,Fail,49,36,0,11,38
80,Fail,46,36,0,16,30
80,Fail,44,38,0,13,31
80,Fail,49,32,0,13,36
80,Fail,41,43,0,15,26
80,Fail,39,43,1,17,22
80,Fail,48,27,7,18,30
80,Fail,38,33,0,19,19
80,Fail,47,41,5,7,40
80,Fail,55,24,5,16,39
80,Fail,56,33,0,8,48
80,Fail,42,38,0,19,23
80,Fail,43,41,0,12,31
80,Fail,53,33,1,13,40
80,Fail,40,37,0,17,23
80,Fail,52,37,0,8,44
80,Fail,47,38,0,15,32
80,Fail,45,38,0,7,38
80,Fail,45,38,5,12,33
80,Fail,46,40,0,11,35
80,Fail,48,32,3,17,31
80,Fail,46,32,0,18,28
80,Fail,49,37,1,13,36
80,Fail,55,35,0,9,46
80,Fail,45,39,0,13,32
80,Fail,43,43,1,13,30
80,Fail,43,39,0,7,36
80,Fail,45,40,0,9,36
80,Fail,45,39,2,14,31
80,Fail,51,34,3,12,39
80,Fail,46,36,0,7,39
80,Fail,40,32,0,15,25
80,Fail,46,34,0,14,32
80,Fail,47,42,0,10,37
80,Fail,52,37,2,9,43
80,Fail,45,44,3,8,37
80,Fail,46,33,9,12,34
80,Fail,46,35,0,9,37
80,Fail,40,44,3,13,27
80,Fail,51,36,6,7,44
80,Fail,46,37,2,15,31
80,Fail,56,34,0,9,47
80,Fail,43,37,0,14,29
80,Fail,43,36,0,16,27
80,Fail,46,35,0,15,31
80,Fail,37,31,14,18,19
80,Fail,44,36,5,15,29
80,Fail,44,37,6,13,31
80,Fail,52,34,0,12,40
80,Fail,50,37,0,13,37
80,Fail,50,34,0,14,36
80,Fail,41,39,0,18,23
80,Fail,45,31,12,12,33
80,Fail,51,30,0,18,33
80,Fail,44,32,2,22,22
80,Fail,45,42,0,13,32
80,Fail,47,39,5,9,38
80,Fail,47,38,0,14,33
80,Fail,48,29,9,14,34
80,Fail,52,39,1,8,44
80,Fail,52,29,0,6,46
80,Fail,46,26,15,13,33
80,Fail,54,33,0,10,44
80,Fail,55,29,5,11,44
80,Fail,49,33,5,13,36
80,Fail,48,38,0,9,39
80,Fail,51,33,0,9,42
80,Fail,52,38,2,8,44
80,Fail,46,38,0,13,33
80,Fail,44,38,1,17,27
80,Fail,45,38,0,14,31
80,Fail,52,38,0,9,43
80,Fail,46,35,7,12,34
80,Fail,41,38,6,15,26
80,Fail,48,37,0,14,34
80,Fail,53,30,6,11,42
80,Fail,44,33,0,19,25
80,Fail,41,36,0,13,28
80,Fail,41,41,0,16,25
80,Fail,57,31,3,9,48
80,Fail,40,40,0,13,27
80,Fail,47,42,1,10,37
80,Fail,41,41,0,15,26
80,Fail,48,40,1,11,37
80,Fail,45,32,0,16,29
80,Fail,57,29,2,12,45
80,Fail,52,33,4,11,41
80,Fail,45,34,6,15,30
80,Fail,50,35,0,14,36
80,Fail,48,31,4,17,31
80,Fail,44,30,0,24,20
80,Fail,45,29,0,14,31
80,Fail,45,38,1,16,29
80,Fail,49,39,2,10,39
80,Fail,47,30,0,19,28
80,Fail,36,40,0,15,21
80,Fail,45,29,14,12,33
80,Fail,51,33,8,8,43
80,Fail,47,32,0,13,34
80,Fail,50,30,0,16,34
80,Fail,47,34,0,13,34
80,Fail,46,41,0,9,37
80,Fail,43,36,0,18,25
80,Fail,45,40,0,14,31
80,Fail,47,40,0,12,35
80,Fail,51,36,0,7,44
80,Fail,41,47,2,10,31
80,Fail,51,35,0,11,40
80,Fail,51,39,0,9,42
80,Fail,49,35,0,10,39
80,Fail,44,33,0,18,26
80,Fail,52,40,1,7,45
80,Fail,44,39,8,9,35
80,Fail,41,42,7,10,31
80,Fail,44,41,0,12,32
80,Fail,43,42,0,11,32
80,Fail,52,32,0,13,39
80,Fail,47,35,1,17,30
80,Fail,50,35,5,10,40
80,Fail,57,25,0,16,41
80,Fail,47,42,4,7,40
80,Fail,53,37,2,8,45
80,Fail,63,24,0,12,51
80,Fail,48,30,0,16,32
80,Fail,47,38,0,13,34
80,Fail,55,27,0,16,39
80,Fail,49,33,3,15,34
80,Fail,47,36,0,13,34
80,Fail,44,35,8,13,31
80,Fail,44,37,0,16,28
80,Fail,48,43,0,8,40
80,Fail,46,45,0,6,40
80,Fail,53,36,3,8,45
80,Fail,47,40,0,11,36
80,Fail,42,34,0,21,21
80,Fail,59,31,0,9,50
80,Fail,44,33,0,16,28
80,Fail,47,36,2,15,32
80,Fail,40,43,0,15,25
80,Fail,40,36,10,14,26
80,Fail,50,36,0,12,38
80,Fail,51,34,2,13,38
80,Fail,43,37,6,14,29
80,Fail,48,42,0,10,38
80,Fail,53,34,1,12,41
80,Fail,46,43,2,9,37
80,Fail,48,35,0,12,36
80,Fail,52,34,1,13,39
80,Fail,45,37,2,16,29
80,Fail,42,39,6,13,29
80,Fail,52,38,0,10,42
80,Fail,45,32,5,18,27
80,Fail,46,38,0,16,30
80,Fail,47,30,0,19,28
80,Fail,53,27,4,16,37
80,Fail,48,32,5,15,33
80,Fail,42,39,5,14,28
80,Fail,48,32,2,18,30
80,Fail,41,39,3,17,24
80,Fail,43,36,0,18,25
80,Fail,48,35,4,13,35
80,Fail,51,34,0,10,41
80,Fail,41,35,16,8,33
80,Fail,43,39,3,15,28
80,Fail,44,40,0,14,30
80,Fail,49,34,0,14,35
80,Fail,53,31,0,7,46
80,Fail,46,41,2,11,35
80,Fail,44,40,3,13,31
80,Fail,51,37,1,11,40
80,Fail,53,28,0,14,39
80,Fail,43,38,7,12,31
80,Fail,33,41,8,18,15
80,Fail,57,32,2,9,48
80,Fail,34,45,0,18,16
80,Fail,55,36,3,6,49
80,Fail,54,27,8,11,43
80,Fail,46,32,0,20,26
80,Fail,45,44,0,9,36
80,Fail,44,38,0,15,29
80,Fail,53,33,0,13,40
80,Fail,47,37,0,16,31
80,Fail,44,39,4,13,31
80,Fail,47,38,3,12,35
80,Fail,41,39,0,14,27
80,Fail,41,47,0,12,29
80,Fail,45,42,0,11,34
80,Fail,49,34,0,10,39
80,Fail,49,38,3,10,39
80,Fail,50,29,0,16,34
80,Fail,56,30,0,13,43
80,Fail,46,39,1,14,32
80,Fail,44,38,0,17,27
80,Fail,51,33,1,15,36
80,Fail,52,35,0,13,39
80,Fail,47,39,0,8,39
80,Fail,55,27,1,17,38
80,Fail,45,41,0,9,36
80,Fail,48,30,4,18,30
80,Fail,40,35,17,8,32
80,Fail,47,37,8,8,39
80,Fail,47,37,0,16,31
80,Fail,56,29,4,11,45
80,Fail,52,30,0,15,37
80,Fail,39,42,0,13,26
80,Fail,43,45,2,10,33
80,Fail,50,35,3,12,38
80,Fail,43,41,4,12,31
80,Fail,40,41,4,15,25
80,Fail,43,41,0,13,30
80,Fail,52,35,6,7,45
80,Fail,48,37,4,11,37
80,Fail,47,35,0,14,33
80,Fail,41,44,1,14,27
80,Fail,47,34,0,10,37
80,Fail,56,33,0,11,45
80,Fail,50,40,0,9,41
80,Fail,49,28,0,14,35
80,Fail,52,34,0,11,41
80,Fail,54,30,7,9,45
80,Fail,47,37,0,12,35
80,Fail,51,34,0,11,40
80,Fail,44,41,0,10,34
80,Fail,44,44,1,11,33
80,Fail,52,35,0,6,46
80,Fail,49,32,0,12,37
80,Fail,49,42,0,9,40
80,Fail,59,27,0,14,45
80,Fail,51,36,0,12,39
80,Fail,45,38,0,14,31
80,Fail,58,32,0,9,49
80,Fail,45,42,1,12,33
80,Fail,40,35,8,17,23
80,Fail,43,37,2,18,25
80,Fail,52,33,0,11,41
80,Fail,53,34,0,13,40
80,Fail,42,42,0,14,28
80,Fail,49,38,0,11,38
80,Fail,45,34,8,13,32
80,Fail,50,38,0,12,38
80,Fail,54,39,0,4,50
80,Fail,56,27,0,14,42
80,Fail,48,33,0,16,32
80,Fail,43,41,0,11,32
80,Fail,48,36,2,14,34
80,Fail,47,38,3,12,35
80,Fail,44,36,0,14,30
80,Fail,51,26,0,16,35
80,Fail,45,35,0,11,34
80,Fail,51,32,0,15,36
80,Fail,44,35,0,13,31
80,Fail,42,40,0,12,30
80,Fail,49,39,6,6,43
80,Fail,46,42,0,12,34
80,Fail,43,41,0,12,31
80,Fail,56,34,1,9,47
80,Fail,45,33,0,16,29
80,Fail,56,32,3,9,47
80,Fail,48,40,2,10,38
80,Fail,46,35,6,13,33
80,Fail,50,36,0,12,38
80,Fail,44,38,0,18,26
80,Fail,48,34,0,14,34
80,Fail,57,32,0,9,48
80,Fail,53,32,5,10,43
80,Fail,49,33,3,15,34
80,Fail,46,34,6,14,32
80,Fail,51,41,0,8,43
80,Fail,52,33,0,10,42
80,Fail,44,36,8,12,32
80,Fail,48,34,0,13,35
80,Fail,47,33,4,16,31
80,Fail,43,38,0,16,27
80,Fail,43,41,5,11,32
80,Fail,47,35,0,18,29
80,Fail,44,38,0,14,30
80,Fail,41,34,12,13,28
80,Fail,51,26,0,12,39
80,Fail,41,38,2,19,22
80,Fail,52,32,0,12,40
80,Fail,45,37,0,11,34
80,Fail,49,34,7,10,39
80,Fail,49,34,2,15,34
80,Fail,59,28,2,11,48
80,Fail,41,31,13,15,26
80,Fail,50,34,7,9,41
80,Fail,45,40,0,11,34
80,Fail,50,35,4,11,39
80,Fail,41,40,8,11,30
80,Fail,43,40,3,14,29
80,Fail,49,35,0,14,35
80,Fail,45,33,0,12,33
80,Fail,53,36,1,10,43
80,Fail,50,41,0,8,42
80,Fail,47,31,0,15,32
80,Fail,52,34,0,7,45
80,Fail,45,32,0,16,29
80,Fail,37,34,9,20,17
80,Fail,53,40,2,5,48
80,Fail,47,31,7,15,32
80,Fail,45,36,0,17,28
80,Fail,52,27,0,14,38
80,Fail,47,36,4,13,34
80,Fail,50,41,0,6,44
80,Fail,58,29,0,12,46
80,Fail,40,37,8,15,25
80,Fail,57,25,0,12,45
80,Fail,55,27,0,12,43
80,Fail,44,35,0,15,29
80,Fail,48,33,0,12,36
80,Fail,49,34,4,13,36
80,Fail,45,38,1,16,29
80,Fail,48,38,2,12,36
80,Fail,45,41,0,14,31
80,Fail,49,31,0,16,33
80,Fail,44,41,2,13,31
80,Fail,42,40,0,16,26
80,Fail,42,37,0,19,23
80,Fail,41,37,0,16,25
80,Fail,45,42,0,11,34
80,Fail,47,38,4,11,36
80,Fail,45,31,9,15,30
80,Fail,47,40,0,13,34
80,Fail,46,38,0,14,32
80,Fail,48,32,10,10,38
80,Fail,48,34,10,8,40
80,Fail,49,36,1,14,35
80,Fail,48,38,0,12,36
80,Fail,45,39,0,11,34
80,Fail,50,38,0,11,39
80,Fail,52,36,0,8,44
80,Fail,44,34,0,18,26
80,Fail,45,39,3,13,32
80,Fail,49,34,0,16,33
80,Fail,44,40,3,13,31
80,Fail,48,37,0,14,34
80,Fail,48,38,4,10,38
80,Fail,42,39,0,11,31
80,Fail,55,34,0,10,45
80,Fail,52,31,2,15,37
80,Fail,48,35,3,14,34
80,Fail,49,29,5,17,32
80,Fail,44,41,3,12,32
80,Fail,50,38,0,11,39
80,Fail,55,36,0,7,48
80,Fail,50,37,0,11,39
80,Fail,50,28,0,10,40
80,Fail,53,31,2,14,39
80,Fail,47,35,0,14,33
80,Fail,38,39,2,21,17
80,Fail,39,40,7,14,25
80,Fail,53,37,0,10,43
80,Fail,44,36,8,12,32
80,Fail,48,37,0,15,33
80,Fail,50,40,2,8,42
80,Fail,52,37,1,10,42
80,Fail,48,42,0,9,39
80,Fail,52,37,2,9,43
80,Fail,43,39,4,14,29
80,Fail,43,33,0,16,27
80,Fail,50,36,2,12,38
80,Fail,45,37,6,12,33
80,Fail,42,42,0,16,26
80,Fail,50,31,0,16,34
80,Fail,45,41,0,10,35
80,Fail,45,37,0,14,31
80,Fail,50,31,0,18,32
80,Fail,46,44,0,10,36
80,Fail,44,40,0,11,33
80,Fail,45,37,3,15,30
80,Fail,58,31,1,10,48
80,Fail,44,35,8,13,31
80,Fail,46,40,0,11,35
80,Fail,47,35,4,14,33
80,Fail,42,41,3,14,28
80,Fail,49,34,0,11,38
80,Fail,48,40,3,9,39
80,Fail,49,36,2,13,36
80,Fail,48,33,0,18,30
80,Fail,54,34,0,10,44
80,Fail,45,42,1,12,33
80,Fail,40,41,7,12,28
80,Fail,45,34,0,18,27
80,Fail,39,34,0,25,14
80,Fail,48,34,0,12,36
80,Fail,42,37,0,15,27
80,Fail,47,33,0,18,29
80,Fail,49,39,3,9,40
80,Fail,47,42,0,7,40
80,Fail,48,33,4,15,33
80,Fail,47,38,5,10,37
80,Fail,50,29,1,20,30
80,Fail,50,37,1,12,38
80,Fail,49,33,0,14,35
80,Fail,48,31,7,14,34
80,Fail,42,38,5,15,27
80,Fail,51,36,0,13,38
80,Fail,49,41,0,9,40
80,Fail,47,40,0,11,36
80,Fail,49,32,5,14,35
80,Fail,50,31,0,18,32
80,Fail,46,36,0,12,34
80,Fail,35,37,0,22,13
80,Fail,47,36,6,11,36
80,Fail,56,33,0,11,45
80,Fail,54,28,3,15,39
80,Fail,41,39,0,14,27
80,Fail,38,43,0,14,24
80,Fail,54,25,1,20,34
80,Fail,53,28,0,15,38
80,Fail,59,30,0,11,48
80,Fail,46,30,10,14,32
80,Fail,49,32,3,16,33
80,Fail,51,39,0,6,45
80,Fail,48,36,0,11,37
80,Fail,43,32,7,18,25
80,Fail,43,44,0,9,34
80,Fail,49,36,1,14,35
80,Fail,40,41,0,12,28
80,Fail,48,34,0,16,32
80,Fail,43,44,5,8,35
80,Fail,41,43,1,15,26
80,Fail,51,35,0,11,40
80,Fail,45,44,1,10,35
80,Fail,47,39,0,10,37
80,Fail,51,37,0,6,45
80,Fail,46,44,0,10,36
80,Fail,45,41,0,13,32
80,Fail,46,35,2,17,29
80,Fail,53,35,0,10,43
80,Fail,54,34,1,11,43
80,Fail,50,34,3,13,37
80,Fail,47,37,0,13,34
80,Fail,43,37,8,12,31
80,Fail,50,36,0,13,37
80,Fail,43,37,0,14,29
80,Fail,48,40,0,9,39
80,Fail,49,40,0,11,38
80,Fail,45,39,6,10,35
80,Fail,35,50,0,14,21
80,Fail,49,37,0,11,38
80,Fail,48,31,8,13,35
80,Fail,53,35,0,10,43
80,Fail,45,36,9,10,35
80,Fail,50,35,3,12,38
80,Fail,41,38,0,14,27
80,Fail,46,34,4,16,30
80,Fail,56,27,0,13,43
80,Fail,49,34,6,11,38
80,Fail,46,46,0,7,39
80,Fail,50,36,4,10,40
80,Fail,48,36,7,9,39
80,Fail,44,36,0,16,28
80,Fail,48,36,1,15,33
80,Fail,52,34,3,11,41
80,Fail,50,25,0,16,34
80,Fail,46,39,0,15,31
80,Fail,51,33,0,12,39
80,Fail,40,43,4,13,27
80,Fail,52,32,0,12,40
80,Fail,55,28,1,16,39
80,Fail,41,34,11,14,27
80,Fail,50,34,2,14,36
80,Fail,51,33,5,11,40
80,Fail,48,40,0,9,39
80,Fail,38,32,0,18,20
80,Fail,44,38,0,15,29
80,Fail,47,31,5,17,30
80,Fail,56,30,0,11,45
80,Fail,50,37,2,11,39
80,Fail,46,36,7,11,35
80,Fail,55,30,6,9,46
80,Fail,50,28,5,17,33
80,Fail,52,39,0,8,44
80,Fail,45,42,1,12,33
80,Fail,62,28,2,8,54
80,Fail,41,33,11,15,26
80,Fail,53,35,0,12,41
80,Fail,46,40,5,9,37
80,Fail,44,33,0,17,27
80,Fail,43,37,0,15,28
80,Fail,45,42,2,11,34
80,Fail,55,31,0,10,45
80,Fail,45,38,0,11,34
80,Fail,45,39,0,14,31
80,Fail,49,40,0,11,38
80,Fail,46,39,0,14,32
80,Fail,51,33,2,14,37
80,Fail,50,38,0,12,38
80,Fail,51,28,0,11,40
80,Fail,51,28,0,16,35
80,Fail,46,41,1,12,34
80,Fail,49,38,2,11,38
80,Fail,46,38,0,13,33
80,Fail,53,29,6,12,41
80,Fail,54,28,0,15,39
80,Fail,52,31,9,8,44
80,Fail,42,38,0,14,28
80,Fail,48,36,0,16,32
80,Fail,38,42,1,19,19
80,Fail,47,34,0,12,35
80,Fail,57,29,3,11,46
80,Fail,51,42,0,6,45
80,Fail,42,41,1,16,26
80,Fail,56,38,0,6,50
80,Fail,47,34,4,15,32
80,Fail,57,26,4,13,44
80,Fail,47,30,0,12,35
80,Fail,51,30,2,17,34
80,Fail,50,38,4,8,42
80,Fail,57,26,1,16,41
80,Fail,52,38,1,9,43
80,Fail,51,32,0,16,35
80,Fail,57,27,0,13,44
80,Fail,46,39,0,15,31
80,Fail,48,33,0,13,35
80,Fail,48,36,3,13,35
80,Fail,44,39,2,15,29
80,Fail,48,32,0,16,32
80,Fail,49,37,0,11,38
80,Fail,44,32,0,15,29
80,Fail,51,34,3,12,39
80,Fail,42,43,2,13,29
80,Fail,45,39,2,14,31
80,Fail,48,36,5,11,37
80,Fail,41,39,0,18,23
80,Fail,53,29,0,15,38
80,Fail,52,34,3,11,41
80,Fail,42,36,0,18,24
80,Fail,49,33,0,13,36
80,Fail,53,32,1,14,39
80,Fail,44,35,0,16,28
80,Fail,51,36,0,12,39
80,Fail,43,38,0,11,32
80,Fail,43,35,0,17,26
80,Fail,47,35,8,10,37
80,Fail,50,29,4,17,33
80,Fail,50,31,0,13,37
80,Fail,51,33,4,12,39
80,Fail,48,33,5,14,34
80,Fail,53,29,5,13,40
80,Fail,56,32,3,9,47
80,Fail,46,41,2,11,35
80,Fail,47,35,7,11,36
80,Fail,43,37,0,17,26
80,Fail,51,37,0,9,42
80,Fail,40,33,10,17,23
80,Fail,51,30,5,14,37
80,Fail,37,36,10,17,20
80,Fail,48,38,0,11,37
80,Fail,47,41,2,10,37
80,Fail,48,40,2,10,38
80,Fail,46,33,0,17,29
80,Fail,44,38,0,16,28
80,Fail,46,30,8,16,30
80,Fail,47,35,0,13,34
80,Fail,51,33,0,15,36
80,Fail,45,37,0,16,29
80,Fail,44,37,7,12,32
80,Fail,42,44,0,12,30
80,Fail,52,37,0,7,45
80,Fail,48,29,5,18,30
80,Fail,50,37,1,12,38
80,Fail,48,33,0,19,29
80,Fail,50,36,0,11,39
80,Fail,53,34,0,9,44
80,Fail,43,36,0,18,25
80,Fail,47,39,0,14,33
80,Fail,55,29,2,14,41
80,Fail,46,30,9,15,31
80,Fail,44,44,0,8,36
80,Fail,48,35,0,11,37
80,Fail,57,36,0,4,53
80,Fail,39,40,9,12,27
80,Fail,54,31,0,15,39
80,Fail,43,44,2,11,32
80,Fail,53,33,2,12,41
80,Fail,53,28,4,15,38
80,Fail,46,31,0,11,35
80,Fail,48,37,5,10,38
80,Fail,59,31,0,10,49
80,Fail,52,30,0,13,39
80,Fail,53,31,0,13,40
80,Fail,51,31,0,12,39
80,Fail,47,37,3,13,34
80,Fail,46,39,1,14,32
80,Fail,50,38,2,10,40
80,Fail,50,34,0,11,39
80,Fail,52,37,0,11,41
80,Fail,47,31,0,12,35
80,Fail,49,38,2,11,38
80,Fail,42,45,1,12,30
80,Fail,46,35,0,9,37
80,Fail,55,27,0,15,40
80,Fail,51,34,0,13,38
80,Fail,48,37,4,11,37
80,Fail,51,32,4,13,38
80,Fail,47,36,4,13,34
80,Fail,48,30,2,20,28
80,Fail,48,32,5,15,33
80,Fail,49,30,10,11,38
80,Fail,53,36,0,8,45
80,Fail,48,39,2,11,37
80,Fail,47,37,0,12,35
80,Fail,55,32,5,8,47
80,Fail,47,35,0,18,29
80,Fail,38,37,7,18,20
80,Fail,55,32,3,10,45
80,Fail,48,39,0,12,36
80,Fail,54,35,1,10,44
80,Fail,52,27,0,14,38
80,Fail,47,33,0,12,35
80,Fail,48,33,0,16,32
80,Fail,44,40,1,15,29
80,Fail,55,35,2,8,47
80,Fail,36,37,0,13,23
80,Fail,43,32,9,16,27
80,Fail,55,28,0,14,41
80,Fail,44,36,0,15,29
80,Fail,48,36,0,15,33
80,Fail,53,34,0,12,41
80,Fail,40,34,0,21,19
80,Fail,49,29,10,12,37
80,Fail,50,38,0,10,40
80,Fail,39,40,0,15,24
80,Fail,54,29,2,15,39
80,Fail,54,31,3,12,42
80,Fail,46,38,0,11,35
80,Fail,46,32,0,21,25
80,Fail,51,28,0,15,36
80,Fail,37,47,0,14,23
80,Fail,54,37,0,9,45
80,Fail,38,41,0,15,23
80,Fail,48,32,0,12,36
80,Fail,45,34,0,14,31
80,Fail,49,32,3,16,33
80,Fail,53,29,2,16,37
80,Fail,45,34,4,17,28
80,Fail,51,38,0,11,40
80,Fail,45,31,9,15,30
80,Fail,48,37,8,7,41
80,Fail,59,29,1,11,48
80,Fail,47,34,0,11,36
80,Fail,50,32,4,14,36
80,Fail,42,40,0,11,31
80,Fail,56,34,0,10,46
80,Fail,51,35,3,11,40
80,Fail,48,31,0,13,35
80,Fail,46,32,0,16,30
80,Fail,49,45,0,4,45
80,Fail,40,32,14,14,26
80,Fail,47,36,0,12,35
80,Fail,43,39,4,14,29
80,Fail,43,35,8,14,29
80,Fail,46,33,2,19,27
80,Fail,44,34,10,12,32
80,Fail,42,36,7,15,27
80,Fail,53,34,0,11,42
80,Fail,57,28,0,14,43
80,Fail,35,39,0,17,18
80,Fail,47,38,0,9,38
80,Fail,49,32,1,18,31
80,Fail,49,37,0,12,37
80,Fail,55,31,2,12,43
80,Fail,57,37,1,5,52
80,Fail,46,39,0,12,34
80,Fail,43,32,0,17,26
80,Fail,54,26,0,13,41
80,Fail,44,38,0,14,30
80,Fail,45,39,2,14,31
80,Fail,50,27,8,15,35
80,Fail,43,36,8,13,30
80,Fail,48,37,0,11,37
80,Fail,51,31,0,14,37
80,Fail,47,36,0,11,36
80,Fail,57,33,3,7,50
80,Fail,52,33,0,11,41
80,Fail,51,31,4,14,37
80,Fail,43,35,0,18,25
80,Fail,47,33,5,15,32
80,Fail,46,28,0,16,30
80,Fail,46,33,0,12,34
80,Fail,46,34,0,16,30
80,Fail,47,40,6,7,40
80,Fail,56,32,0,10,46
80,Fail,49,28,8,15,34
80,Fail,52,41,1,6,46
80,Fail,44,39,7,10,34
80,Fail,53,28,6,13,40
80,Fail,53,32,4,11,42
80,Fail,52,29,0,15,37
80,Fail,53,34,0,10,43
80,Fail,47,35,5,13,34
80,Fail,46,40,0,12,34
80,Fail,42,43,0,11,31
80,Fail,49,33,0,12,37
80,Fail,43,39,0,15,28
80,Fail,46,34,0,17,29
80,Fail,52,35,0,13,39
80,Fail,51,32,4,13,38
80,Fail,53,35,2,10,43
80,Fail,58,35,3,4,54
80,Fail,51,38,0,10,41
80,Fail,48,37,0,15,33
80,Fail,43,39,0,16,27
80,Fail,50,26,0,18,32
80,Fail,45,34,0,16,29
80,Fail,43,43,2,12,31
80,Fail,51,33,0,12,39
80,Fail,44,32,4,20,24
80,Fail,50,30,4,16,34
80,Fail,50,38,0,8,42
80,Fail,50,29,4,17,33
80,Fail,46,41,3,10,36
80,Fail,49,30,7,14,35
80,Fail,48,34,0,14,34
80,Fail,47,33,0,14,33
80,Fail,52,37,0,8,44
80,Fail,58,28,0,13,45
80,Fail,47,34,0,13,34
80,Fail,38,36,0,14,24
80,Fail,50,37,1,12,38
80,Fail,41,40,0,18,23
80,Fail,51,26,4,19,32
80,Fail,45,32,11,12,33
80,Fail,44,39,0,13,31
80,Fail,48,40,0,11,37
80,Fail,49,36,5,10,39
80,Fail,52,37,3,8,44
80,Fail,51,39,0,10,41
80,Fail,50,37,0,12,38
80,Fail,48,35,3,14,34
80,Fail,50,38,0,4,46
80,Fail,44,26,18,12,32
80,Fail,58,31,0,9,49
80,Fail,49,33,6,12,37
80,Fail,58,28,0,11,47
80,Fail,54,31,0,14,40
80,Fail,51,34,1,14,37
80,Fail,52,33,0,12,40
80,Fail,47,34,9,10,37
80,Fail,49,35,1,15,34
80,Fail,46,30,0,14,32
80,Fail,50,34,1,15,35
80,Fail,44,40,2,14,30
80,Fail,49,31,0,15,34
80,Fail,49,29,6,16,33
80,Fail,43,35,6,16,27
80,Fail,45,38,0,15,30
80,Fail,47,32,5,16,31
80,Fail,48,37,0,9,39
80,Fail,45,40,2,13,32
80,Fail,55,33,0,7,48
80,Fail,50,30,0,16,34
80,Fail,50,38,3,9,41
80,Fail,49,38,0,11,38
80,Fail,50,38,3,9,41
80,Fail,46,35,0,12,34
80,Fail,46,42,2,10,36
80,Fail,47,33,7,13,34
80,Fail,46,32,6,16,30
80,Fail,56,29,0,13,43
80,Fail,52,36,2,10,42
80,Fail,50,37,0,10,40
80,Fail,46,39,3,12,34
80,Fail,46,39,0,13,33
80,Fail,48,35,0,7,41
80,Fail,48,34,2,16,32
80,Fail,50,41,0,6,44
80,Fail,43,42,0,8,35
80,Fail,47,42,0,10,37
80,Fail,49,24,0,19,30
80,Fail,53,34,0,11,42
80,Fail,45,42,3,10,35
80,Fail,51,31,8,10,41
80,Fail,50,36,3,11,39
80,Fail,50,32,0,18,32
80,Fail,47,39,0,11,36
80,Fail,49,31,0,16,33
80,Fail,54,36,0,9,45
80,Fail,49,37,0,13,36
80,Fail,42,37,0,17,25
80,Fail,49,36,5,10,39
80,Fail,49,29,3,19,30
80,Fail,43,32,0,20,23
80,Fail,37,41,9,13,24
80,Fail,43,43,1,13,30
80,Fail,53,27,0,20,33
80,Fail,47,38,6,9,38
80,Fail,47,34,0,18,29
80,Fail,56,27,0,17,39
80,Fail,51,31,1,17,34
80,Fail,48,36,2,14,34
80,Fail,43,45,0,9,34
80,Fail,45,30,12,13,32
80,Fail,47,38,2,13,34
80,Fail,48,36,4,12,36
80,Fail,45,41,5,9,36
80,Fail,52,32,0,10,42
80,Fail,45,37,0,17,28
80,Fail,53,32,7,8,45
80,Fail,52,34,0,14,38
80,Fail,42,47,0,10,32
80,Fail,39,33,10,18,21
80,Fail,48,35,5,12,36
80,Fail,43,37,0,12,31
80,Fail,49,28,0,12,37
80,Fail,47,38,0,11,36
80,Fail,39,39,11,11,28
80,Fail,56,29,3,12,44
80,Fail,49,35,0,16,33
80,Fail,50,35,0,15,35
80,Fail,50,32,0,12,38
80,Fail,43,35,6,16,27
80,Fail,39,44,5,12,27
80,Fail,45,39,0,13,32
80,Fail,43,40,0,13,30
80,Fail,48,39,0,12,36
80,Fail,44,42,3,11,33
80,Fail,53,24,5,18,35
80,Fail,50,33,0,15,35
80,Fail,51,32,3,14,37
80,Fail,51,31,2,16,35
80,Fail,46,42,0,9,37
80,Fail,49,30,0,20,29
80,Fail,46,34,0,15,31
80,Fail,41,29,11,19,22
80,Fail,53,32,0,9,44
80,Fail,47,32,0,17,30
80,Fail,48,31,8,13,35
80,Fail,52,28,6,14,38
80,Fail,44,40,0,11,33
80,Fail,52,38,0,8,44
80,Fail,44,36,4,16,28
80,Fail,48,41,0,10,38
80,Fail,55,31,0,12,43
80,Fail,39,41,7,13,26
80,Fail,56,27,0,12,44
80,Fail,47,37,0,13,34
80,Fail,47,39,0,14,33
80,Fail,40,41,0,15,25
80,Fail,48,38,0,9,39
80,Fail,42,32,8,18,24
80,Fail,46,38,0,13,33
80,Fail,45,33,7,15,30
80,Fail,50,33,2,15,35
80,Fail,46,35,0,16,30
80,Fail,47,38,0,9,38
80,Fail,49,32,7,12,37
80,Fail,53,35,0,9,44
80,Fail,46,34,7,13,33
80,Fail,57,30,2,11,46
80,Fail,54,29,0,10,44
80,Fail,41,41,0,13,28
80,Fail,53,31,3,13,40
80,Fail,41,39,1,19,22
80,Fail,42,34,0,15,27
80,Fail,51,27,8,14,37
80,Fail,49,32,4,15,34
80,Fail,53,37,2,8,45
80,Fail,39,28,0,19,20
80,Fail,48,34,0,15,33
80,Fail,49,21,8,22,27
80,Fail,53,36,1,10,43
80,Fail,41,45,0,12,29
80,Fail,45,26,13,16,29
80,Fail,50,37,2,11,39
80,Fail,51,31,11,7,44
80,Fail,44,34,7,15,29
80,Fail,38,38,11,13,25
80,Fail,52,37,1,10,42
80,Fail,48,40,0,12,36
80,Fail,51,35,1,13,38
80,Fail,48,36,1,15,33
80,Fail,51,32,0,13,38
80,Fail,51,34,0,14,37
80,Fail,50,33,0,15,35
80,Fail,43,41,6,10,33
80,Fail,44,39,3,14,30
80,Fail,50,41,2,7,43
80,Fail,51,39,0,10,41
80,Fail,50,34,4,12,38
80,Fail,50,37,3,10,40
80,Fail,43,37,0,14,29
80,Fail,48,40,6,6,42
80,Fail,44,42,0,10,34
80,Fail,55,28,0,14,41
80,Fail,47,40,3,10,37
80,Fail,49,38,1,12,37
80,Fail,45,33,0,14,31
80,Fail,48,33,0,15,33
80,Fail,50,39,3,8,42
80,Fail,50,38,5,7,43
80,Fail,37,49,5,9,28
80,Fail,53,27,5,15,38
80,Fail,42,34,0,21,21
80,Fail,38,30,7,25,13
80,Fail,48,35,5,12,36
80,Fail,52,35,2,11,41
80,Fail,51,31,0,15,36
80,Fail,46,35,0,17,29
80,Fail,50,36,1,13,37
80,Fail,49,39,0,9,40
80,Fail,46,42,0,6,40
80,Fail,50,34,0,14,36
80,Fail,51,40,3,6,45
80,Fail,54,31,3,12,42
80,Fail,46,39,0,13,33
80,Fail,51,28,1,20,31
80,Fail,43,35,0,11,32
80,Fail,44,39,0,15,29
80,Fail,53,29,0,15,38
80,Fail,53,34,1,12,41
80,Fail,47,40,0,9,38
80,Fail,56,30,4,10,46
80,Fail,51,36,0,11,40
80,Fail,41,40,0,10,31
80,Fail,50,36,0,14,36
80,Fail,58,30,2,10,48
80,Fail,42,46,0,7,35
80,Fail,58,28,2,12,46
80,Fail,47,42,2,9,38
80,Fail,47,33,0,15,32
80,Fail,49,34,0,14,35
80,Fail,57,26,0,11,46
80,Fail,49,35,0,12,37
80,Fail,56,32,0,11,45
80,Fail,50,32,0,18,32
80,Fail,53,39,0,7,46
80,Fail,47,39,4,10,37
80,Fail,46,38,1,15,31
80,Fail,45,34,4,17,28
80,Fail,51,36,0,13,38
80,Fail,43,40,0,14,29
80,Fail,51,38,0,10,41
80,Fail,47,41,0,5,42
80,Fail,39,44,0,14,25
80,Fail,59,29,2,10,49
80,Fail,52,34,2,12,40
80,Fail,44,38,5,13,31
80,Fail,46,32,4,18,28
80,Fail,56,32,0,11,45
80,Fail,45,39,0,11,34
80,Fail,47,35,0,16,31
80,Fail,43,33,6,18,25
80,Fail,50,36,2,12,38
80,Fail,60,26,0,12,48
80,Fail,44,35,0,18,26
80,Fail,48,31,4,17,31
80,Fail,47,30,0,15,32
80,Fail,44,33,0,12,32
80,Fail,46,31,9,14,32
80,Fail,49,34,6,11,38
80,Fail,42,43,2,13,29
80,Fail,49,36,2,13,36
80,Fail,46,40,1,13,33
80,Fail,37,47,4,12,25
80,Fail,43,42,0,13,30
80,Fail,43,42,0,13,30
80,Fail,48,35,1,16,32
80,Fail,46,29,0,21,25
80,Fail,48,32,0,12,36
80,Fail,48,33,0,12,36
80,Fail,41,36,0,15,26
80,Fail,49,38,3,10,39
80,Fail,46,39,2,13,33
80,Fail,48,39,0,11,37
80,Fail,42,37,0,13,29
80,Fail,45,34,8,13,32
80,Fail,43,38,0,12,31
80,Fail,49,35,0,11,38
80,Fail,52,37,0,9,43
80,Fail,52,39,1,8,44
80,Fail,60,28,0,10,50
80,Fail,43,39,0,17,26
80,Fail,46,38,0,13,33
80,Fail,43,32,0,23,20
80,Fail,46,42,0,11,35
80,Fail,48,33,0,14,34
80,Fail,45,38,0,15,30
80,Fail,46,35,0,15,31
80,Fail,52,34,2,12,40
80,Fail,51,30,4,15,36
80,Fail,51,36,0,9,42
80,Fail,43,40,5,12,31
80,Fail,45,37,0,17,28
80,Fail,53,34,1,12,41
80,Fail,58,28,0,13,45
80,Fail,44,36,5,15,29
80,Fail,43,41,5,11,32
80,Fail,44,43,5,8,36
80,Fail,55,35,2,8,47
80,Fail,52,36,0,12,40
80,Fail,46,35,0,16,30
80,Fail,55,32,2,11,44
80,Fail,50,37,0,11,39
80,Fail,51,29,3,17,34
80,Fail,59,24,0,12,47
80,Fail,39,42,0,18,21
80,Fail,47,35,2,16,31
80,Fail,42,36,7,15,27
80,Fail,55,31,0,11,44
80,Fail,46,32,8,14,32
80,Fail,47,36,0,10,37
80,Fail,56,36,0,7,49
80,Fail,46,34,0,14,32
80,Fail,45,35,0,13,32
80,Fail,41,36,4,19,22
80,Fail,38,46,0,14,24
80,Fail,51,37,3,9,42
80,Fail,44,29,6,21,23
80,Fail,50,34,5,11,39
80,Fail,45,39,5,11,34
80,Fail,44,37,0,15,29
80,Fail,44,33,0,21,23
80,Fail,52,37,0,6,46
80,Fail,50,34,3,13,37
80,Fail,55,32,0,9,46
80,Fail,48,31,0,13,35
80,Fail,52,40,0,7,45
80,Fail,50,34,0,15,35
80,Fail,50,39,0,9,41
80,Fail,47,33,8,12,35
80,Fail,45,36,0,15,30
80,Fail,42,39,5,14,28
80,Fail,54,33,0,11,43
80,Fail,50,37,1,12,38
80,Fail,44,36,0,16,28
80,Fail,44,36,3,17,27
80,Fail,46,33,0,18,28
80,Fail,51,29,5,15,36
80,Fail,56,31,0,12,44
80,Fail,48,36,4,12,36
80,Fail,47,45,2,6,41
80,Fail,51,35,0,10,41
80,Fail,46,33,0,18,28
80,Fail,54,34,0,12,42
80,Fail,58,27,3,12,46
80,Fail,45,35,0,12,33
80,Fail,51,33,0,12,39
80,Fail,49,35,3,13,36
80,Fail,54,22,0,11,43
80,Fail,52,29,0,18,34
80,Fail,40,33,0,21,19
80,Fail,47,36,4,13,34
80,Fail,50,35,0,13,37
80,Fail,51,30,0,9,42
80,Fail,49,33,7,11,38
80,Fail,56,28,0,13,43
80,Fail,53,35,1,11,42
80,Fail,52,33,1,14,38
80,Fail,52,32,1,15,37
80,Fail,43,36,5,16,27
80,Fail,56,33,0,11,45
80,Fail,39,38,0,19,20
80,Fail,47,35,5,13,34
80,Fail,50,27,7,16,34
80,Fail,48,39,2,11,37
80,Fail,51,28,0,19,32
80,Fail,51,29,4,16,35
80,Fail,52,37,0,9,43
80,Fail,51,38,0,10,41
80,Fail,54,38,0,7,47
80,Fail,48,33,0,12,36
80,Fail,49,35,9,7,42
80,Fail,57,31,0,12,45
80,Fail,45,34,6,15,30
80,Fail,49,35,0,13,36
80,Fail,50,33,4,13,37
80,Fail,53,31,0,14,39
80,Fail,40,39,7,14,26
80,Fail,50,34,1,15,35
80,Fail,49,33,5,13,36
80,Fail,47,33,0,13,34
80,Fail,40,44,0,12,28
80,Fail,44,40,2,14,30
80,Fail,52,34,1,13,39
80,Fail,42,37,9,12,30
80,Fail,60,30,1,9,51
80,Fail,52,34,2,12,40
80,Fail,56,31,0,11,45
80,Fail,48,34,3,15,33
80,Fail,54,31,0,14,40
80,Fail,53,34,0,10,43
80,Fail,45,34,0,14,31
80,Fail,49,40,0,7,42
80,Fail,45,39,0,10,35
80,Fail,41,36,5,18,23
80,Fail,51,33,0,16,35
80,Fail,42,39,4,15,27
80,Fail,46,37,5,12,34
80,Fail,50,39,0,10,40
80,Fail,52,35,0,10,42
80,Fail,50,35,0,11,39
80,Fail,46,31,0,20,26
80,Fail,43,34,12,11,32
80,Fail,50,36,3,11,39
80,Fail,42,42,4,12,30
80,Fail,47,37,0,11,36
80,Fail,44,37,0,10,34
80,Fail,44,30,0,19,25
80,Fail,56,34,0,10,46
80,Fail,50,35,0,10,40
80,Fail,48,39,0,10,38
80,Fail,42,35,0,19,23
80,Fail,45,37,0,15,30
80,Fail,48,39,0,13,35
80,Fail,46,45,1,8,38
80,Fail,50,33,2,15,35
80,Fail,50,31,0,18,32
80,Fail,57,32,4,7,50
80,Fail,48,35,0,17,31
80,Fail,51,34,0,9,42
80,Fail,48,39,1,12,36
80,Fail,42,36,0,13,29
80,Fail,48,37,1,14,34
80,Fail,47,37,0,15,32
80,Fail,52,34,0,10,42
80,Fail,53,35,0,9,44
80,Fail,57,30,1,12,45
80,Fail,53,29,0,16,37
80,Fail,48,38,0,14,34
80,Fail,44,36,0,18,26
80,Fail,46,38,0,12,34
80,Fail,47,37,8,8,39
80,Fail,41,44,4,11,30
80,Fail,52,34,0,12,40
80,Fail,53,29,0,15,38
80,Fail,41,39,0,9,32
80,Fail,40,47,4,9,31
80,Fail,52,35,0,7,45
80,Fail,49,33,2,16,33
80,Fail,51,38,0,6,45
80,Fail,48,42,1,9,39
80,Fail,48,38,0,14,34
80,Fail,45,28,11,16,29
80,Fail,49,33,5,13,36
80,Fail,53,30,6,11,42
80,Fail,51,32,2,15,36
80,Fail,47,37,2,14,33
80,Fail,40,34,0,17,23
80,Fail,36,46,1,17,19
80,Fail,39,39,5,17,22
80,Fail,48,34,0,13,35
80,Fail,45,31,8,16,29
80,Fail,42,43,0,14,28
80,Fail,46,32,7,15,31
80,Fail,47,34,1,18,29
80,Fail,43,34,0,11,32
80,Fail,47,33,8,12,35
80,Fail,50,36,1,13,37
80,Fail,45,40,0,14,31
80,Fail,41,37,7,15,26
80,Fail,54,32,0,11,43
80,Fail,47,36,0,11,36
80,Fail,51,35,0,13,38
80,Fail,50,34,1,15,35
80,Fail,51,36,0,11,40
80,Fail,49,34,0,11,38
80,Fail,54,31,4,11,43
80,Fail,35,35,0,18,17
80,Fail,48,39,2,11,37
80,Fail,45,46,1,8,37
80,Fail,48,31,7,14,34
80,Fail,51,36,0,13,38
80,Fail,46,30,6,18,28
80,Fail,42,30,17,11,31
80,Fail,50,28,0,12,38
80,Fail,42,42,3,13,29
80,Fail,50,30,0,15,35
80,Fail,36,37,10,17,19
80,Fail,51,32,0,16,35
80,Fail,47,39,5,9,38
80,Fail,47,31,4,18,29
80,Fail,42,40,4,14,28
80,Fail,45,33,0,15,30
80,Fail,49,34,0,13,36
80,Fail,44,41,4,11,33
80,Fail,44,36,7,13,31
80,Fail,46,33,6,15,31
80,Fail,43,40,4,13,30
80,Fail,51,28,0,19,32
80,Fail,52,32,3,13,39
80,Fail,52,30,0,10,42
80,Fail,42,44,2,12,30
80,Fail,47,34,0,15,32
80,Fail,48,35,0,13,35
80,Fail,57,31,0,12,45
80,Fail,42,39,0,11,31
80,Fail,46,32,6,16,30
80,Fail,49,34,0,14,35
80,Fail,52,34,0,14,38
80,Fail,47,35,0,15,32
80,Fail,46,40,0,10,36
80,Fail,50,34,0,12,38
80,Fail,39,37,0,17,22
80,Fail,50,30,7,13,37
80,Fail,38,42,3,17,21
80,Fail,53,38,0,7,46
80,Fail,45,35,4,16,29
80,Fail,54,33,1,12,42
80,Fail,46,39,0,13,33
80,Fail,43,38,0,16,27
80,Fail,50,36,0,12,38
80,Fail,58,26,1,15,43
80,Fail,51,29,0,10,41
80,Fail,57,29,0,11,46
80,Fail,49,31,0,13,36
80,Fail,50,32,6,12,38
80,Fail,57,28,3,12,45
80,Fail,47,40,2,11,36
80,Fail,48,31,0,15,33
80,Fail,56,27,0,9,47
80,Fail,50,34,0,16,34
80,Fail,52,39,0,8,44
80,Fail,53,35,3,9,44
80,Fail,54,26,5,15,39
80,Fail,44,34,1,21,23
80,Fail,64,21,0,12,52
80,Fail,47,33,3,17,30
80,Fail,54,35,2,9,45
80,Fail,48,35,0,6,42
80,Fail,47,32,0,12,35
80,Fail,44,39,0,17,27
80,Fail,53,31,0,13,40
80,Fail,47,33,11,9,38
80,Fail,48,41,0,11,37
80,Fail,42,32,0,18,24
80,Fail,54,36,1,9,45
80,Fail,50,39,2,9,41
80,Fail,54,32,0,11,43
80,Fail,41,31,0,15,26
80,Fail,48,40,0,7,41
80,Fail,48,42,1,9,39
80,Fail,46,35,6,13,33
80,Fail,56,32,0,11,45
80,Fail,58,27,3,12,46
80,Fail,50,36,3,11,39
80,Fail,47,33,0,13,34
80,Fail,45,41,1,13,32
80,Fail,50,41,0,7,43
80,Fail,46,45,0,8,38
80,Fail,47,36,2,15,32
80,Fail,52,28,0,15,37
80,Fail,54,33,2,11,43
80,Fail,48,32,0,15,33
80,Fail,48,36,1,15,33
80,Fail,47,30,9,14,33
80,Fail,51,35,2,12,39
80,Fail,44,42,1,13,31
80,Fail,52,36,1,11,41
80,Fail,45,34,0,19,26
80,Fail,48,35,7,10,38
80,Fail,47,33,5,15,32
80,Fail,39,44,0,10,29
80,Fail,50,34,3,13,37
80,Fail,39,40,0,15,24
80,Fail,55,32,3,10,45
80,Fail,50,30,0,17,33
80,Fail,57,31,0,11,46
80,Fail,49,25,0,13,36
80,Fail,44,34,5,17,27
80,Fail,37,42,0,21,16
80,Fail,41,44,0,13,28
80,Fail,39,32,0,21,18
80,Fail,47,36,0,16,31
80,Fail,47,41,2,10,37
80,Fail,48,32,0,15,33
80,Fail,55,34,3,8,47
80,Fail,44,39,0,15,29
80,Fail,44,35,1,20,24
80,Fail,38,32,0,15,23
80,Fail,55,34,1,10,45
80,Fail,43,32,0,15,28
80,Fail,41,46,0,12,29
80,Fail,45,39,3,13,32
80,Fail,49,35,4,12,37
80,Fail,49,35,2,14,35
80,Fail,37,43,0,20,17
80,Fail,50,34,0,16,34
80,Fail,36,37,5,22,14
80,Fail,56,32,4,8,48
80,Fail,43,38,0,17,26
80,Fail,51,35,0,11,40
80,Fail,58,31,0,9,49
80,Fail,49,33,0,10,39
80,Fail,53,35,0,12,41
80,Fail,42,40,0,18,24
80,Fail,51,27,3,19,32
80,Fail,42,44,3,11,31
80,Fail,50,45,0,5,45
80,Fail,55,35,0,10,45
80,Fail,52,34,5,9,43
80,Fail,53,34,0,8,45
80,Fail,55,32,0,12,43
80,Fail,42,43,0,12,30
80,Fail,46,36,2,16,30
80,Fail,55,31,0,10,45
80,Fail,48,32,0,18,30
80,Fail,55,38,1,6,49
80,Fail,50,43,0,7,43
80,Fail,51,34,0,10,41
80,Fail,49,38,2,11,38
80,Fail,50,38,0,12,38
80,Fail,47,32,4,17,30
80,Fail,44,35,0,16,28
80,Fail,58,27,8,7,51
80,Fail,45,37,0,12,33
80,Fail,52,30,0,18,34
80,Fail,45,42,0,12,33
80,Fail,50,35,0,10,40
80,Fail,42,38,0,17,25
80,Fail,46,40,0,12,34
80,Fail,49,36,7,8,41
80,Fail,48,32,8,12,36
80,Fail,41,34,10,15,26
80,Fail,48,38,3,11,37
80,Fail,45,31,0,18,27
80,Fail,46,40,0,11,35
80,Fail,50,39,0,10,40
80,Fail,52,35,0,7,45
80,Fail,51,37,0,11,40
80,Fail,49,37,0,12,37
80,Fail,55,30,4,11,44
80,Fail,54,28,1,17,37
80,Fail,46,36,2,16,30
80,Fail,47,32,9,12,35
80,Fail,40,47,3,10,30
80,Fail,53,36,5,6,47
80,Fail,41,40,3,16,25
80,Fail,48,39,0,11,37
80,Fail,47,37,0,16,31
80,Fail,51,37,3,9,42
80,Fail,48,34,0,15,33
80,Fail,48,34,1,17,31
80,Fail,53,38,0,7,46
80,Fail,51,38,2,9,42
80,Fail,41,43,3,13,28
80,Fail,48,35,0,13,35
80,Fail,47,33,0,13,34
80,Fail,50,34,0,14,36
80,Fail,42,38,0,11,31
80,Fail,52,26,12,10,42
80,Fail,48,41,0,8,40
80,Fail,46,35,2,17,29
80,Fail,51,32,0,15,36
80,Fail,44,35,9,12,32
80,Fail,49,38,0,11,38
80,Fail,39,37,5,19,20
80,Fail,43,39,3,15,28
80,Fail,47,31,0,18,29
80,Fail,47,40,0,13,34
80,Fail,43,44,0,13,30
80,Fail,48,38,1,13,35
80,Fail,51,42,1,6,45
80,Fail,50,39,0,8,42
80,Fail,37,40,0,15,22
80,Fail,51,35,2,12,39
80,Fail,46,39,0,13,33
80,Fail,47,37,7,9,38
80,Fail,51,35,6,8,43
80,Fail,53,39,0,7,46
80,Fail,52,37,1,10,42
80,Fail,48,32,4,16,32
80,Fail,50,37,2,11,39
80,Fail,41,32,10,17,24
80,Fail,47,40,2,11,36
80,Fail,47,34,0,12,35
80,Fail,50,30,8,12,38
80,Fail,46,39,0,14,32
80,Fail,45,43,0,11,34
80,Fail,47,38,0,14,33
80,Fail,45,42,0,10,35
80,Fail,53,34,0,12,41
80,Fail,43,38,0,10,33
80,Fail,48,41,0,10,38
80,Fail,44,33,8,15,29
80,Fail,54,38,0,8,46
80,Fail,43,40,0,11,32
80,Fail,56,29,0,13,43
80,Fail,62,31,0,6,56
80,Fail,53,39,1,7,46
80,Fail,52,26,4,18,34
80,Fail,53,33,0,14,39
80,Fail,48,39,7,6,42
80,Fail,50,38,0,11,39
80,Fail,40,30,8,22,18
80,Fail,51,33,0,13,38
80,Fail,59,25,7,9,50
80,Fail,53,29,0,17,36
80,Fail,49,39,0,7,42
80,Fail,41,38,6,15,26
80,Fail,50,42,0,5,45
80,Fail,50,34,0,12,38
80,Fail,58,24,1,17,41
80,Fail,49,34,0,15,34
80,Fail,38,40,5,17,21
80,Fail,50,36,3,11,39
80,Fail,47,37,2,14,33
80,Fail,39,38,5,18,21
80,Fail,46,34,4,16,30
80,Fail,50,35,0,9,41
80,Fail,48,42,0,10,38
80,Fail,45,34,7,14,31
80,Fail,52,32,3,13,39
80,Fail,53,37,2,8,45
80,Fail,47,37,0,13,34
80,Fail,41,47,3,9,32
80,Fail,42,34,0,21,21
80,Fail,49,38,0,11,38
80,Fail,45,37,6,12,33
80,Fail,44,44,0,11,33
80,Fail,48,40,0,12,36
80,Fail,47,37,5,11,36
80,Fail,43,32,0,19,24
80,Fail,42,35,0,15,27
80,Fail,41,38,0,15,26
80,Fail,49,34,7,10,39
80,Fail,52,39,0,9,43
80,Fail,49,37,0,14,35
80,Fail,43,44,0,12,31
80,Fail,44,38,2,16,28
80,Fail,45,35,0,16,29
80,Fail,41,41,2,16,25
80,Fail,45,38,1,16,29
80,Fail,49,34,0,17,32
80,Fail,41,37,0,16,25
80,Fail,56,28,0,12,44
80,Fail,55,27,0,13,42
80,Fail,51,36,4,9,42
80,Fail,50,32,0,15,35
80,Fail,47,36,3,14,33
80,Fail,53,32,0,12,41
80,Fail,45,36,4,15,30
80,Fail,44,37,0,14,30
80,Fail,52,33,0,14,38
80,Fail,49,33,5,13,36
80,Fail,57,29,5,9,48
80,Fail,42,37,0,13,29
80,Fail,43,37,3,17,26
80,Fail,53,39,1,7,46
80,Fail,49,36,0,15,34
80,Fail,47,28,6,19,28
80,Fail,56,32,4,8,48
80,Fail,49,33,0,17,32
80,Fail,47,36,0,16,31
80,Fail,49,37,0,14,35
80,Fail,49,36,0,8,41
80,Fail,44,33,8,15,29
80,Fail,53,26,0,18,35
80,Fail,49,31,5,15,34
80,Fail,48,34,7,11,37
80,Fail,54,25,8,13,41
80,Fail,51,34,1,14,37
80,Fail,52,28,0,19,33
80,Fail,46,25,0,18,28
80,Fail,55,33,0,11,44
80,Fail,43,39,1,17,26
80,Fail,52,28,5,15,37
80,Fail,48,29,7,16,32
80,Fail,46,48,0,6,40
80,Fail,50,33,0,16,34
80,Fail,51,39,1,9,42
80,Fail,44,36,5,15,29
80,Fail,53,29,4,14,39
80,Fail,44,41,0,15,29
80,Fail,53,33,2,12,41
80,Fail,48,38,0,12,36
80,Fail,46,33,0,13,33
80,Fail,43,37,7,13,30
80,Fail,39,34,9,18,21
80,Fail,50,35,0,10,40
80,Fail,47,39,5,9,38
80,Fail,49,42,1,8,41
80,Fail,49,32,8,11,38
80,Fail,55,35,2,8,47
80,Fail,44,36,7,13,31
80,Fail,49,32,4,15,34
80,Fail,50,31,0,8,42
80,Fail,47,33,0,15,32
80,Fail,56,39,0,5,51
80,Fail,52,33,5,10,42
80,Fail,47,36,1,16,31
80,Fail,41,40,8,11,30
80,Fail,47,38,2,13,34
80,Fail,45,37,5,13,32
80,Fail,36,48,0,14,22
80,Fail,52,35,0,12,40
80,Fail,46,40,1,13,33
80,Fail,43,41,1,15,28
80,Fail,40,36,9,15,25
80,Fail,51,32,0,14,37
80,Fail,50,31,2,17,33
80,Fail,50,34,1,15,35
80,Fail,42,31,11,16,26
80,Fail,43,42,0,10,33
80,Fail,46,45,0,6,40
80,Fail,37,39,11,13,24
80,Fail,38,42,0,15,23
80,Fail,46,38,0,10,36
80,Fail,49,32,0,12,37
80,Fail,42,36,5,17,25
80,Fail,47,43,0,10,37
80,Fail,45,30,0,18,27
80,Fail,51,30,0,19,32
80,Fail,45,31,0,15,30
80,Fail,43,36,5,16,27
80,Fail,46,42,1,11,35
80,Fail,57,29,0,12,45
80,Fail,47,41,1,11,36
80,Fail,50,35,0,6,44
80,Fail,44,41,2,13,31
80,Fail,50,32,5,13,37
80,Fail,44,37,7,12,32
80,Fail,46,36,6,12,34
80,Fail,47,39,0,12,35
80,Fail,50,32,0,15,35
80,Fail,46,33,0,16,30
80,Fail,49,34,0,11,38
80,Fail,49,33,1,17,32
80,Fail,56,35,0,8,48
80,Fail,53,29,7,11,42
80,Fail,49,34,4,13,36
80,Fail,51,29,3,17,34
80,Fail,49,37,0,13,36
80,Fail,40,43,0,13,27
80,Fail,49,40,0,8,41
80,Fail,56,22,0,18,38
80,Fail,46,36,2,16,30
80,Fail,56,36,0,8,48
80,Fail,51,33,0,13,38
80,Fail,52,29,5,14,38
80,Fail,42,31,9,18,24
80,Fail,58,30,0,11,47
80,Fail,47,44,0,8,39
80,Fail,40,47,0,8,32
80,Fail,53,34,0,13,40
80,Fail,42,39,2,17,25
80,Fail,41,45,0,12,29
80,Fail,49,31,9,11,38
80,Fail,43,44,1,12,31
80,Fail,53,34,0,13,40
80,Fail,52,35,0,10,42
80,Fail,48,33,4,15,33
80,Fail,46,39,3,12,34
80,Fail,52,34,0,10,42
80,Fail,47,31,0,16,31
80,Fail,48,31,0,17,31
80,Fail,44,38,5,13,31
80,Fail,47,40,4,9,38
80,Fail,47,34,9,10,37
80,Fail,43,38,0,14,29
80,Fail,51,34,6,9,42
80,Fail,51,34,0,12,39
80,Fail,45,35,0,18,27
80,Fail,46,38,5,11,35
80,Fail,43,41,0,13,30
80,Fail,46,42,1,11,35
80,Fail,57,37,0,5,52
80,Fail,43,40,4,13,30
80,Fail,48,38,0,13,35
80,Fail,47,37,0,12,35
80,Fail,57,29,1,13,44
80,Fail,49,34,0,15,34
80,Fail,48,35,2,15,33
80,Fail,51,30,0,13,38
80,Fail,51,35,0,14,37
80,Fail,48,35,3,14,34
80,Fail,55,37,0,5,50
80,Fail,53,33,3,11,42
80,Fail,43,35,0,12,31
80,Fail,42,38,0,15,27
80,Fail,58,35,1,6,52
80,Fail,54,27,0,14,40
80,Fail,44,42,7,7,37
80,Fail,47,30,4,19,28
80,Fail,40,44,8,8,32
80,Fail,49,35,0,16,33
80,Fail,56,28,1,15,41
80,Fail,55,34,0,8,47
80,Fail,50,39,2,9,41
80,Fail,48,39,0,13,35
80,Fail,52,33,1,14,38
80,Fail,54,36,0,10,44
80,Fail,46,35,9,10,36
80,Fail,48,34,0,13,35
80,Fail,43,33,6,18,25
80,Fail,50,36,3,11,39
80,Fail,51,34,2,13,38
80,Fail,49,41,0,10,39
80,Fail,46,37,0,16,30
80,Fail,52,37,1,10,42
80,Fail,50,31,0,18,32
80,Fail,50,35,0,12,38
80,Fail,51,32,2,15,36
80,Fail,57,36,0,7,50
80,Fail,53,22,13,12,41
80,Fail,37,35,12,16,21
80,Fail,46,36,6,12,34
80,Fail,42,40,0,10,32
80,Fail,43,37,8,12,31
80,Fail,50,36,1,13,37
80,Fail,49,32,0,15,34
80,Fail,47,36,9,8,39
80,Fail,47,36,0,17,30
80,Fail,52,37,0,10,42
80,Fail,59,35,0,6,53
80,Fail,40,39,0,19,21
80,Fail,48,37,0,12,36
80,Fail,49,41,0,10,39
80,Fail,49,38,0,12,37
80,Fail,42,46,0,12,30
80,Fail,38,38,12,12,26
80,Fail,47,35,7,11,36
80,Fail,44,41,0,14,30
80,Fail,47,39,0,12,35
80,Fail,53,33,4,10,43
80,Fail,53,34,1,12,41
80,Fail,47,35,0,10,37
80,Fail,44,39,5,12,32
80,Fail,53,33,1,13,40
80,Fail,54,33,0,10,44
80,Fail,46,32,7,15,31
80,Fail,46,40,0,9,37
80,Fail,50,33,4,13,37
80,Fail,49,33,4,14,35
80,Fail,42,41,7,10,32
80,Fail,51,31,0,15,36
80,Fail,41,45,0,8,33
80,Fail,54,29,3,14,40
80,Fail,42,46,0,7,35
80,Fail,44,39,3,14,30
80,Fail,56,31,0,12,44
80,Fail,49,35,0,10,39
80,Fail,48,38,0,10,38
80,Fail,51,33,0,12,39
80,Fail,56,31,3,10,46
80,Fail,49,35,0,11,38
80,Fail,43,32,0,13,30
80,Fail,49,33,1,17,32
80,Fail,53,29,0,13,40
80,Fail,44,34,5,17,27
80,Fail,56,33,2,9,47
80,Fail,45,39,0,11,34
80,Fail,50,33,0,10,40
80,Fail,41,46,4,9,32
80,Fail,49,32,7,12,37
80,Fail,49,30,6,15,34
80,Fail,52,29,6,13,39
80,Fail,45,37,3,15,30
80,Fail,48,32,0,19,29
80,Fail,47,36,5,12,35
80,Fail,54,29,0,16,38
80,Fail,49,33,0,15,34
80,Fail,51,36,0,11,40
80,Fail,49,30,0,16,33
80,Fail,51,38,0,7,44
80,Fail,44,39,0,8,36
80,Fail,50,36,4,10,40
80,Fail,46,35,0,15,31
80,Fail,45,37,0,16,29
80,Fail,48,35,9,8,40
80,Fail,38,33,0,24,14
80,Fail,40,43,0,14,26
80,Fail,54,25,7,14,40
80,Fail,47,33,0,16,31
80,Fail,50,37,0,8,42
80,Fail,40,40,7,13,27
80,Fail,49,38,3,10,39
80,Fail,47,39,0,13,34
80,Fail,49,37,0,13,36
80,Fail,42,41,1,16,26
80,Fail,38,40,0,16,22
80,Fail,44,41,0,13,31
80,Fail,50,24,11,15,35
80,Fail,43,36,0,16,27
80,Fail,47,37,4,12,35
80,Fail,42,37,0,10,32
80,Fail,45,41,2,12,33
80,Fail,43,40,3,14,29
80,Fail,44,36,0,18,26
80,Fail,59,26,2,13,46
80,Fail,51,30,0,11,40
80,Fail,46,36,8,10,36
80,Fail,46,41,0,13,33
80,Fail,43,41,0,14,29
80,Fail,49,30,11,10,39
80,Fail,49,35,1,15,34
80,Fail,47,33,6,14,33
80,Fail,55,29,6,10,45
80,Fail,41,33,12,14,27
80,Fail,55,28,0,17,38
80,Fail,49,35,5,11,38
80,Fail,40,37,0,15,25
80,Fail,54,33,0,8,46
80,Fail,46,35,9,10,36
80,Fail,54,31,5,10,44
80,Fail,39,31,13,17,22
80,Fail,49,37,8,6,43
80,Fail,52,33,0,14,38
80,Fail,42,45,0,13,29
80,Fail,48,23,0,19,29
80,Fail,48,36,1,15,33
80,Fail,49,32,0,17,32
80,Fail,44,37,0,14,30
80,Fail,47,36,4,13,34
80,Fail,57,27,0,12,45
80,Fail,34,45,6,15,19
80,Fail,52,34,2,12,40
80,Fail,51,35,3,11,40
80,Fail,48,40,2,10,38
80,Fail,40,41,0,15,25
80,Fail,46,45,1,8,38
80,Fail,41,39,4,16,25
80,Fail,39,36,13,12,27
80,Fail,49,29,6,16,33
80,Fail,41,40,1,18,23
80,Fail,44,47,0,8,36
80,Fail,50,33,2,15,35
80,Fail,44,36,3,17,27
80,Fail,42,43,4,11,31
80,Fail,52,32,6,10,42
80,Fail,47,36,3,14,33
80,Fail,39,34,5,22,17
80,Fail,47,39,0,14,33
80,Fail,42,42,0,14,28
80,Fail,47,35,0,16,31
80,Fail,51,39,0,8,43
80,Fail,40,33,8,19,21
80,Fail,46,28,0,14,32
80,Fail,45,37,0,11,34
80,Fail,51,32,3,14,37
80,Fail,52,35,4,9,43
80,Fail,41,37,0,13,28
80,Fail,43,40,0,16,27
80,Fail,55,27,0,14,41
80,Fail,45,35,2,18,27
80,Fail,42,43,5,10,32
80,Fail,45,35,0,16,29
80,Fail,49,39,7,5,44
80,Fail,48,37,0,14,34
80,Fail,46,38,2,14,32
80,Fail,47,34,6,13,34
80,Fail,53,31,4,12,41
80,Fail,51,39,0,10,41
80,Fail,44,45,0,9,35
80,Fail,48,40,0,9,39
80,Fail,49,39,0,12,37
80,Fail,49,36,5,10,39
80,Fail,46,36,0,13,33
80,Fail,53,33,5,9,44
80,Fail,51,37,0,8,43
80,Fail,54,30,3,13,41
80,Fail,50,34,0,15,35
80,Fail,46,42,2,10,36
80,Fail,47,39,2,12,35
80,Fail,51,31,0,13,38
80,Fail,48,34,3,15,33
80,Fail,45,34,0,18,27
80,Fail,43,41,2,14,29
80,Fail,42,37,0,19,23
80,Fail,49,40,0,11,38
80,Fail,47,29,0,17,30
80,Fail,40,38,0,15,25
80,Fail,43,40,1,16,27
80,Fail,57,32,0,11,46
80,Fail,51,34,1,14,37
80,Fail,51,31,4,14,37
80,Fail,56,28,0,14,42
80,Fail,46,36,6,12,34
80,Fail,47,38,3,12,35
80,Fail,44,33,0,14,30
80,Fail,50,35,2,13,37
80,Fail,49,37,0,12,37
80,Fail,52,38,0,9,43
80,Fail,52,35,2,11,41
80,Fail,51,35,0,13,38
80,Fail,52,33,0,14,38
80,Fail,53,37,1,9,44
80,Fail,48,41,1,10,38
80,Fail,53,31,0,10,43
80,Fail,52,27,0,13,39
80,Fail,51,26,0,14,37
80,Fail,54,33,0,11,43
80,Fail,46,32,5,17,29
80,Fail,45,39,0,15,30
80,Fail,45,33,0,13,32
80,Fail,43,36,0,13,30
80,Fail,46,35,0,9,37
80,Fail,54,35,3,8,46
80,Fail,45,36,0,19,26
80,Fail,45,40,0,14,31
80,Fail,45,36,3,16,29
80,Fail,50,32,0,13,37
80,Fail,54,31,3,12,42
80,Fail,42,38,4,16,26
80,Fail,53,35,0,12,41
80,Fail,42,33,5,20,22
80,Fail,56,33,2,9,47
80,Fail,49,28,0,16,33
80,Fail,49,36,0,14,35
80,Fail,41,42,3,14,27
80,Fail,50,34,0,14,36
80,Fail,45,39,4,12,33
80,Fail,46,34,3,17,29
80,Fail,45,36,1,18,27
80,Fail,48,37,1,14,34
80,Fail,52,39,0,9,43
80,Fail,48,38,7,7,41
80,Fail,48,40,0,11,37
80,Fail,43,43,0,9,34
80,Fail,48,40,0,10,38
80,Fail,50,32,0,13,37
80,Fail,49,30,0,17,32
80,Fail,53,34,0,9,44
80,Fail,50,34,0,15,35
80,Fail,48,38,4,10,38
80,Fail,58,33,0,8,50
80,Fail,42,36,0,16,26
80,Fail,47,38,0,13,34
80,Fail,53,29,0,15,38
80,Fail,50,39,0,9,41
80,Fail,47,31,0,15,32
80,Fail,51,30,1,18,33
80,Fail,50,38,0,8,42
80,Fail,52,34,4,10,42
80,Fail,53,36,2,9,44
80,Fail,51,37,1,11,40
80,Fail,56,31,0,9,47
80,Fail,52,39,0,7,45
80,Fail,51,33,0,10,41
80,Fail,39,39,0,17,22
80,Fail,48,27,0,12,36
80,Fail,38,42,0,16,22
80,Fail,50,37,3,10,40
80,Fail,46,36,8,10,36
80,Fail,37,45,6,12,25
80,Fail,51,34,6,9,42
80,Fail,53,32,6,9,44
80,Fail,48,41,0,8,40
80,Fail,45,34,0,17,28
80,Fail,50,38,2,10,40
80,Fail,44,36,0,19,25
80,Fail,47,32,0,17,30
80,Fail,55,35,1,9,46
80,Fail,45,37,0,17,28
80,Fail,52,28,0,13,39
80,Fail,55,32,0,12,43
80,Fail,48,30,0,12,36
80,Fail,49,40,0,6,43
80,Fail,48,40,0,11,37
80,Fail,46,30,5,19,27
80,Fail,50,40,0,8,42
80,Fail,44,45,1,10,34
80,Fail,48,28,15,9,39
80,Fail,48,34,0,11,37
80,Fail,53,31,0,10,43
80,Fail,50,37,0,8,42
80,Fail,51,34,0,11,40
80,Fail,53,35,2,10,43
80,Fail,49,38,0,13,36
80,Fail,47,32,5,16,31
80,Fail,53,35,1,11,42
80,Fail,45,34,0,15,30
80,Fail,48,35,0,17,31
80,Fail,47,31,6,16,31
80,Fail,48,31,0,15,33
80,Fail,53,30,8,9,44
80,Fail,50,32,4,14,36
80,Fail,47,44,0,9,38
80,Fail,51,32,1,16,35
80,Fail,45,36,0,16,29
80,Fail,50,31,0,17,33
80,Fail,50,37,3,10,40
80,Fail,52,31,0,12,40
80,Fail,46,36,7,11,35
80,Fail,44,32,11,13,31
80,Fail,55,33,2,10,45
80,Fail,48,36,4,12,36
80,Fail,48,34,0,14,34
80,Fail,53,34,0,9,44
80,Fail,43,41,0,12,31
80,Fail,57,32,0,9,48
80,Fail,55,34,4,7,48
80,Fail,49,38,1,12,37
80,Fail,45,35,5,15,30
80,Fail,56,34,0,6,50
80,Fail,49,40,0,11,38
80,Fail,42,35,4,19,23
80,Fail,54,30,2,14,40
80,Fail,42,34,8,16,26
80,Fail,54,31,0,9,45
80,Fail,53,35,0,11,42
80,Fail,42,38,0,9,33
80,Fail,45,38,3,14,31
80,Fail,50,31,0,16,34
80,Fail,48,30,0,20,28
80,Fail,45,44,0,8,37
80,Fail,57,33,0,8,49
80,Fail,45,34,6,15,30
80,Fail,53,35,2,10,43
80,Fail,52,35,1,12,40
80,Fail,46,30,0,16,30
80,Fail,49,35,2,14,35
80,Fail,51,37,0,12,39
80,Fail,50,28,7,15,35
80,Fail,43,33,15,9,34
80,Fail,51,30,2,17,34
80,Fail,50,33,0,11,39
80,Fail,56,29,4,11,45
80,Fail,42,43,2,13,29
80,Fail,51,36,2,11,40
80,Fail,51,29,0,16,35
80,Fail,44,40,6,10,34
80,Fail,47,35,0,17,30
80,Fail,53,32,0,12,41
80,Fail,51,38,0,11,40
80,Fail,57,25,6,12,45
80,Fail,57,35,0,8,49
80,Fail,54,32,0,12,42
80,Fail,50,40,1,9,41
80,Fail,44,33,9,14,30
80,Fail,49,35,6,10,39
80,Fail,50,39,0,9,41
80,Fail,48,40,1,11,37
80,Fail,48,34,1,17,31
80,Fail,54,31,4,11,43
80,Fail,52,33,0,11,41
80,Fail,46,40,2,12,34
80,Fail,49,40,3,8,41
80,Fail,44,44,1,11,33
80,Fail,53,40,0,7,46
80,Fail,52,34,7,7,45
80,Fail,56,33,0,10,46
80,Fail,49,36,6,9,40
80,Fail,46,40,0,11,35
80,Fail,50,38,0,11,39
80,Fail,48,34,0,14,34
80,Fail,47,36,6,11,36
80,Fail,44,31,8,17,27
80,Fail,39,34,0,14,25
80,Fail,51,36,4,9,42
80,Fail,48,40,1,11,37
80,Fail,51,32,0,11,40
80,Fail,47,38,0,6,41
80,Fail,51,30,1,18,33
80,Fail,50,37,0,6,44
80,Fail,46,40,0,14,32
80,Fail,50,36,0,14,36
80,Fail,49,34,1,16,33
80,Fail,46,35,1,18,28
80,Fail,41,34,14,11,30
80,Fail,45,34,0,12,33
80,Fail,43,43,2,12,31
80,Fail,48,41,4,7,41
80,Fail,52,36,6,6,46
80,Fail,52,28,0,11,41
80,Fail,38,39,13,10,28
80,Fail,50,35,0,12,38
80,Fail,50,38,4,8,42
80,Fail,50,33,0,12,38
80,Fail,41,35,0,24,17
80,Fail,45,39,0,9,36
80,Fail,44,44,3,9,35
80,Fail,55,29,0,13,42
80,Fail,50,37,0,8,42
80,Fail,42,46,0,9,33
80,Fail,45,40,0,14,31
80,Fail,46,37,0,15,31
80,Fail,39,37,9,15,24
80,Fail,45,38,4,13,32
80,Fail,55,29,3,13,42
80,Fail,42,49,0,9,33
80,Fail,50,41,0,7,43
80,Fail,46,36,4,14,32
80,Fail,47,39,4,10,37
80,Fail,57,30,0,10,47
80,Fail,43,38,0,15,28
80,Fail,45,39,0,11,34
80,Fail,46,40,0,11,35
80,Fail,51,34,0,13,38
80,Fail,41,40,0,15,26
80,Fail,47,34,9,10,37
80,Fail,48,36,0,13,35
80,Fail,48,41,2,9,39
80,Fail,50,39,0,11,39
80,Fail,50,36,4,10,40
80,Fail,48,40,2,10,38
80,Fail,46,44,0,7,39
80,Fail,55,27,7,11,44
80,Fail,39,41,0,16,23
80,Fail,52,32,0,15,37
80,Fail,45,33,0,13,32
80,Fail,49,37,1,13,36
80,Fail,50,41,4,5,45
80,Fail,48,43,0,9,39
80,Fail,46,29,13,12,34
80,Fail,54,35,5,6,48
80,Fail,54,36,2,8,46
80,Fail,54,31,4,11,43
80,Fail,51,35,0,12,39
80,Fail,47,40,3,10,37
80,Fail,46,37,2,15,31
80,Fail,46,41,0,10,36
80,Fail,54,28,0,14,40
80,Fail,48,38,0,11,37
80,Fail,42,31,12,15,27
80,Fail,56,29,0,14,42
80,Fail,50,29,7,14,36
80,Fail,44,40,0,14,30
80,Fail,51,36,6,7,44
80,Fail,50,35,2,13,37
80,Fail,48,43,0,9,39
80,Fail,49,39,3,9,40
80,Fail,48,35,0,15,33
80,Fail,46,37,5,12,34
80,Fail,48,25,9,18,30
80,Fail,43,48,0,9,34
80,Fail,49,33,0,14,35
80,Fail,55,30,4,11,44
80,Fail,46,36,3,15,31
80,Fail,40,43,5,12,28
80,Fail,52,36,2,10,42
80,Fail,52,36,0,11,41
80,Fail,47,34,5,14,33
80,Fail,52,32,4,12,40
80,Fail,56,32,0,11,45
80,Fail,42,37,1,20,22
80,Fail,42,39,2,17,25
80,Fail,48,37,5,10,38
80,Fail,51,35,4,10,41
80,Fail,49,38,0,13,36
80,Fail,54,29,0,10,44
80,Fail,45,44,4,7,38
80,Fail,43,38,7,12,31
80,Fail,43,37,0,18,25
80,Fail,49,41,1,9,40
80,Fail,46,33,7,14,32
80,Fail,43,39,4,14,29
80,Fail,52,29,8,11,41
80,Fail,51,33,9,7,44
80,Fail,48,25,11,16,32
80,Fail,65,30,0,4,61
80,Fail,54,33,4,9,45
80,Fail,44,31,10,15,29
80,Fail,52,30,0,13,39
80,Fail,46,36,0,11,35
80,Fail,54,31,0,14,40
80,Fail,59,33,0,8,51
80,Fail,40,39,0,19,21
80,Fail,50,31,0,14,36
80,Fail,56,36,0,8,48
80,Fail,47,37,0,13,34
80,Fail,52,36,0,12,40
80,Fail,60,30,0,9,51
80,Fail,46,34,5,15,31
80,Fail,52,28,0,12,40
80,Fail,45,34,9,12,33
80,Fail,51,35,0,13,38
80,Fail,44,36,0,10,34
80,Fail,46,36,3,15,31
80,Fail,43,42,6,9,34
80,Fail,53,26,10,11,42
80,Fail,42,42,6,10,32
80,Fail,57,30,2,11,46
80,Fail,49,35,0,12,37
80,Fail,50,36,4,10,40
80,Fail,54,34,0,12,42
80,Fail,48,36,0,13,35
80,Fail,49,36,0,15,34
80,Fail,52,31,2,15,37
80,Fail,55,36,0,6,49
80,Fail,48,37,3,12,36
80,Fail,50,40,1,9,41
80,Fail,55,30,0,11,44
80,Fail,46,32,0,16,30
80,Fail,47,35,0,10,37
80,Fail,49,35,0,12,37
80,Fail,43,40,5,12,31
80,Fail,54,25,9,12,42
80,Fail,45,33,0,19,26
80,Fail,56,31,0,10,46
80,Fail,47,39,0,14,33
80,Fail,44,46,0,9,35
80,Fail,50,36,0,14,36
80,Fail,50,33,0,16,34
80,Fail,40,33,12,15,25
80,Fail,48,37,1,14,34
80,Fail,47,30,5,18,29
80,Fail,46,38,0,12,34
80,Fail,45,35,6,14,31
80,Fail,52,40,2,6,46
80,Fail,41,38,0,16,25
80,Fail,43,38,8,11,32
80,Fail,52,37,0,11,41
80,Fail,51,34,4,11,40
80,Fail,45,39,0,11,34
80,Fail,45,37,0,10,35
80,Fail,47,38,0,13,34
80,Fail,39,47,1,13,26
80,Fail,49,32,0,16,33
80,Fail,54,33,3,10,44
80,Fail,47,32,0,12,35
80,Fail,44,34,0,14,30
80,Fail,46,39,0,13,33
80,Fail,36,42,0,21,15
80,Fail,50,31,0,18,32
80,Fail,54,25,0,17,37
80,Fail,55,33,1,11,44
80,Fail,54,26,3,17,37
80,Fail,51,38,0,11,40
80,Fail,55,35,2,8,47
80,Fail,43,39,12,6,37
80,Fail,43,37,0,16,27
80,Fail,50,32,0,15,35
80,Fail,39,33,0,18,21
80,Fail,53,33,2,12,41
80,Fail,43,36,0,18,25
80,Fail,51,32,2,15,36
80,Fail,47,36,0,12,35
80,Fail,54,41,0,4,50
80,Fail,41,35,0,17,24
80,Fail,42,42,0,10,32
80,Fail,46,46,0,8,38
80,Fail,44,32,0,17,27
80,Fail,45,43,1,11,34
80,Fail,49,37,0,14,35
80,Fail,50,36,4,10,40
80,Fail,47,34,0,12,35
80,Fail,56,36,3,5,51
80,Fail,50,35,0,14,36
80,Fail,50,36,3,11,39
80,Fail,36,37,8,19,17
80,Fail,40,42,0,16,24
80,Fail,51,37,0,10,41
80,Fail,45,36,0,13,32
80,Fail,44,30,0,20,24
80,Fail,47,40,0,12,35
80,Fail,56,25,0,17,39
80,Fail,58,28,0,13,45
80,Fail,45,36,6,13,32
80,Fail,56,35,0,4,52
80,Fail,47,33,2,18,29
80,Fail,51,36,1,12,39
80,Fail,54,32,0,14,40
80,Fail,44,41,0,12,32
80,Fail,48,34,0,15,33
80,Fail,51,36,0,13,38
80,Fail,51,33,7,9,42
80,Fail,46,34,0,13,33
80,Fail,42,44,2,12,30
80,Fail,53,30,0,10,43
80,Fail,53,35,0,12,41
80,Fail,52,33,4,11,41
80,Fail,46,40,2,12,34
80,Fail,49,38,2,11,38
80,Fail,47,38,0,14,33
80,Fail,53,30,11,6,47
80,Fail,56,32,1,11,45
80,Fail,50,28,0,13,37
80,Fail,58,32,0,8,50
80,Fail,41,45,3,11,30
80,Fail,51,37,0,11,40
80,Fail,40,39,8,13,27
80,Fail,49,42,2,7,42
80,Fail,50,31,7,12,38
80,Fail,42,42,0,15,27
80,Fail,43,44,0,11,32
80,Fail,45,35,0,7,38
80,Fail,56,29,0,12,44
80,Fail,44,40,4,12,32
80,Fail,46,36,0,9,37
80,Fail,45,37,0,15,30
80,Fail,45,39,5,11,34
80,Fail,46,38,3,13,33
80,Fail,46,34,7,13,33
80,Fail,47,36,0,13,34
80,Fail,37,43,0,15,22
80,Fail,48,44,1,7,41
80,Fail,53,33,0,9,44
80,Fail,47,40,0,12,35
80,Fail,50,33,0,16,34
80,Fail,44,36,6,14,30
80,Fail,47,34,3,16,31
80,Fail,49,37,1,13,36
80,Fail,58,32,1,9,49
80,Fail,48,32,0,15,33
80,Fail,44,41,0,10,34
80,Fail,50,33,7,10,40
80,Fail,54,25,0,11,43
80,Fail,43,44,1,12,31
80,Fail,47,35,2,16,31
80,Fail,44,42,2,12,32
80,Fail,42,36,0,15,27
80,Fail,55,31,0,12,43
80,Fail,54,34,0,8,46
80,Fail,46,36,0,16,30
80,Fail,48,30,3,19,29
80,Fail,45,35,0,16,29
80,Fail,50,45,0,5,45
80,Fail,50,36,0,13,37
80,Fail,44,31,0,20,24
80,Fail,54,32,0,7,47
80,Fail,49,34,0,12,37
80,Fail,52,38,0,9,43
80,Fail,54,34,0,8,46
80,Fail,44,34,3,19,25
80,Fail,46,36,5,13,33
80,Fail,37,42,0,13,24
80,Fail,45,36,2,17,28
80,Fail,53,30,2,15,38
80,Fail,53,28,0,14,39
80,Fail,50,36,2,12,38
80,Fail,39,40,8,13,26
80,Fail,46,39,0,13,33
80,Fail,46,31,0,12,34
80,Fail,45,36,0,18,27
80,Fail,48,38,0,12,36
80,Fail,46,32,14,8,38
80,Fail,42,38,0,14,28
80,Fail,39,42,8,11,28
80,Fail,48,29,0,17,31
80,Fail,38,35,0,16,22
80,Fail,50,33,5,12,38
80,Fail,50,33,0,13,37
80,Fail,44,41,0,15,29
80,Fail,53,37,0,8,45
80,Fail,52,33,5,10,42
80,Fail,48,36,0,13,35
80,Fail,50,30,3,17,33
80,Fail,48,35,0,15,33
80,Fail,40,44,1,15,25
80,Fail,53,32,2,13,40
80,Fail,48,33,0,15,33
80,Fail,49,34,0,11,38
80,Fail,58,31,0,10,48
80,Fail,47,38,1,14,33
80,Fail,48,34,0,17,31
80,Fail,46,38,0,10,36
80,Fail,45,34,7,14,31
80,Fail,55,32,0,10,45
80,Fail,46,37,0,16,30
80,Fail,47,35,0,13,34
80,Fail,37,35,0,17,20
80,Fail,50,36,0,12,38
80,Fail,47,42,2,9,38
80,Fail,51,34,2,13,38
80,Fail,51,31,5,13,38
80,Fail,53,35,0,11,42
80,Fail,52,29,0,13,39
80,Fail,53,30,0,17,36
80,Fail,43,36,5,16,27
80,Fail,53,35,2,10,43
80,Fail,49,35,2,14,35
80,Fail,53,36,0,9,44
80,Fail,51,37,3,9,42
80,Fail,43,43,0,14,29
80,Fail,48,42,6,4,44
80,Fail,50,29,0,14,36
80,Fail,45,37,0,17,28
80,Fail,35,41,0,18,17
80,Fail,54,26,0,15,39
80,Fail,58,29,1,12,46
80,Fail,56,29,0,13,43
80,Fail,49,36,1,14,35
80,Fail,55,34,0,9,46
80,Fail,46,36,7,11,35
80,Fail,44,35,0,18,26
80,Fail,45,32,12,11,34
80,Fail,45,42,0,8,37
80,Fail,44,42,7,7,37
80,Fail,49,41,0,9,40
80,Fail,49,35,0,10,39
80,Fail,45,40,4,11,34
80,Fail,45,41,0,12,33
80,Fail,47,37,1,15,32
80,Fail,49,30,0,17,32
80,Fail,51,38,0,11,40
80,Fail,44,39,1,16,28
80,Fail,54,38,2,6,48
80,Fail,48,33,6,13,35
80,Fail,43,34,0,13,30
80,Fail,39,38,9,14,25
80,Fail,45,34,0,10,35
80,Fail,39,42,0,16,23
80,Fail,43,39,0,16,27
80,Fail,46,31,0,17,29
80,Fail,45,38,7,10,35
80,Fail,37,41,9,13,24
80,Fail,49,33,0,15,34
80,Fail,50,41,1,8,42
80,Fail,48,31,0,13,35
80,Fail,43,38,0,12,31
80,Fail,50,28,0,13,37
80,Fail,45,39,0,15,30
80,Fail,39,31,11,19,20
80,Fail,50,35,0,11,39
80,Fail,44,39,4,13,31
80,Fail,47,36,4,13,34
80,Fail,45,37,2,16,29
80,Fail,45,33,1,21,24
80,Fail,45,37,5,13,32
80,Fail,46,38,3,13,33
80,Fail,48,32,4,16,32
80,Fail,54,31,0,11,43
80,Fail,47,35,0,8,39
80,Fail,48,40,0,10,38
80,Fail,48,37,0,6,42
80,Fail,52,38,2,8,44
80,Fail,47,32,0,17,30
80,Fail,40,37,0,14,26
80,Fail,43,31,9,17,26
80,Fail,40,30,0,14,26
80,Fail,52,34,0,14,38
80,Fail,49,38,0,8,41
80,Fail,50,38,1,11,39
80,Fail,50,37,0,13,37
80,Fail,51,34,0,13,38
80,Fail,53,35,0,7,46
80,Fail,53,31,6,10,43
80,Fail,49,40,4,7,42
80,Fail,50,34,1,15,35
80,Fail,42,39,0,12,30
80,Fail,55,34,0,9,46
80,Fail,49,31,7,13,36
80,Fail,52,37,0,10,42
80,Fail,47,34,0,14,33
80,Fail,49,40,0,11,38
80,Fail,51,34,0,11,40
80,Fail,52,32,7,9,43
80,Fail,49,31,12,8,41
80,Fail,49,29,12,10,39
80,Fail,41,37,11,11,30
80,Fail,49,33,3,15,34
80,Fail,49,29,5,17,32
80,Fail,45,35,0,12,33
80,Fail,54,28,3,15,39
80,Fail,48,33,5,14,34
80,Fail,47,33,0,19,28
80,Fail,41,39,0,17,24
80,Fail,49,31,0,16,33
80,Fail,54,39,0,7,47
80,Fail,32,41,0,17,15
80,Fail,53,34,4,9,44
80,Fail,45,38,5,12,33
80,Fail,50,33,8,9,41
80,Fail,43,37,0,13,30
80,Fail,45,38,0,13,32
80,Fail,55,39,1,5,50
80,Fail,48,35,0,16,32
80,Fail,56,29,2,13,43
80,Fail,50,26,0,16,34
80,Fail,42,39,4,15,27
80,Fail,47,30,4,19,28
80,Fail,50,36,0,14,36
80,Fail,48,36,1,15,33
80,Fail,49,35,0,13,36
80,Fail,47,37,0,11,36
80,Fail,44,37,6,13,31
80,Fail,48,34,0,11,37
80,Fail,52,39,1,8,44
80,Fail,50,37,2,11,39
80,Fail,54,34,2,10,44
80,Fail,56,35,0,8,48
80,Fail,45,38,1,16,29
80,Fail,52,37,1,10,42
80,Fail,47,34,6,13,34
80,Fail,41,34,0,14,27
80,Fail,44,34,0,15,29
80,Fail,45,39,0,14,31
80,Fail,51,34,0,13,38
80,Fail,46,47,0,7,39
80,Fail,51,42,1,6,45
80,Fail,46,38,0,15,31
80,Fail,48,40,0,12,36
80,Fail,49,39,2,10,39
80,Fail,42,39,6,13,29
80,Fail,53,29,2,16,37
80,Fail,46,22,0,11,35
80,Fail,51,33,0,10,41
80,Fail,53,35,2,10,43
80,Fail,49,32,1,18,31
80,Fail,57,29,0,8,49
80,Fail,41,42,2,15,26
80,Fail,48,34,0,13,35
80,Fail,54,37,0,9,45
80,Fail,47,39,4,10,37
80,Fail,48,35,9,8,40
80,Fail,45,38,7,10,35
80,Fail,52,39,0,9,43
80,Fail,46,33,0,17,29
80,Fail,47,38,0,13,34
80,Fail,52,41,0,7,45
80,Fail,46,38,2,14,32
80,Fail,47,37,0,10,37
80,Fail,47,32,9,12,35
80,Fail,55,35,0,9,46
80,Fail,43,38,3,16,27
80,Fail,40,45,0,14,26
80,Fail,49,39,0,12,37
80,Fail,53,36,5,6,47
80,Fail,50,35,0,11,39
80,Fail,50,34,4,12,38
80,Fail,47,40,0,11,36
80,Fail,44,39,6,11,33
80,Fail,49,38,3,10,39
80,Fail,48,33,0,14,34
80,Fail,41,41,2,16,25
80,Fail,50,32,0,10,40
80,Fail,52,35,1,12,40
80,Fail,43,38,0,11,32
80,Fail,53,34,0,13,40
80,Fail,49,34,4,13,36
80,Fail,52,34,0,10,42
80,Fail,50,35,0,14,36
80,Fail,52,37,1,10,42
80,Fail,40,41,5,14,26
80,Fail,45,33,0,15,30
80,Fail,52,33,3,12,40
80,Fail,55,36,0,9,46
80,Fail,52,36,0,11,41
80,Fail,40,47,1,12,28
80,Fail,45,34,7,14,31
80,Fail,56,25,0,10,46
80,Fail,43,45,2,10,33
80,Fail,48,33,0,11,37
80,Fail,50,31,1,18,32
80,Fail,32,51,0,12,20
80,Fail,46,39,0,10,36
80,Fail,50,35,0,7,43
80,Fail,39,37,2,22,17
80,Fail,55,35,2,8,47
80,Fail,53,28,0,15,38
80,Fail,47,34,0,13,34
80,Fail,51,37,2,10,41
80,Fail,46,37,2,15,31
80,Fail,48,35,0,16,32
80,Fail,46,32,0,14,32
80,Fail,40,37,0,14,26
80,Fail,50,39,0,9,41
80,Fail,48,34,5,13,35
80,Fail,35,41,10,14,21
80,Fail,49,40,0,11,38
80,Fail,49,34,1,16,33
80,Fail,45,29,8,18,27
80,Fail,48,38,4,10,38
80,Fail,51,30,6,13,38
80,Fail,46,39,4,11,35
80,Fail,37,39,0,15,22
80,Fail,46,42,0,11,35
80,Fail,53,31,2,14,39
80,Fail,44,34,6,16,28
80,Fail,48,35,4,13,35
80,Fail,45,37,0,12,33
80,Fail,46,34,4,16,30
80,Fail,52,33,0,10,42
80,Fail,46,28,0,18,28
80,Fail,48,38,0,13,35
80,Fail,50,33,0,9,41
80,Fail,45,38,0,12,33
80,Fail,46,29,0,22,24
80,Fail,47,25,13,15,32
80,Fail,48,34,12,6,42
80,Fail,48,39,0,11,37
80,Fail,42,38,7,13,29
80,Fail,52,31,2,15,37
80,Fail,44,38,0,9,35
80,Fail,48,37,6,9,39
80,Fail,41,40,2,17,24
80,Fail,47,32,0,13,34
80,Fail,50,38,2,10,40
80,Fail,40,40,3,17,23
80,Fail,57,25,0,8,49
80,Fail,50,33,0,11,39
80,Fail,50,35,0,12,38
80,Fail,46,39,0,13,33
80,Fail,44,39,6,11,33
80,Fail,46,36,8,10,36
80,Fail,46,41,4,9,37
80,Fail,50,32,0,15,35
80,Fail,56,32,0,12,44
80,Fail,48,35,0,16,32
80,Fail,50,35,0,12,38
80,Fail,44,31,9,16,28
80,Fail,49,32,0,17,32
80,Fail,49,40,0,7,42
80,Fail,52,39,0,9,43
80,Fail,48,36,0,11,37
80,Fail,55,32,0,13,42
80,Fail,52,32,9,7,45
80,Fail,48,38,0,13,35
80,Fail,39,48,0,8,31
80,Fail,55,31,1,13,42
80,Fail,48,34,6,12,36
80,Fail,49,36,1,14,35
80,Fail,50,33,0,17,33
80,Fail,45,38,0,11,34
80,Fail,49,36,3,12,37
80,Fail,46,42,0,6,40
80,Fail,45,41,1,13,32
80,Fail,40,37,0,14,26
80,Fail,56,30,2,12,44
80,Fail,52,31,2,15,37
80,Fail,48,43,0,8,40
80,Fail,48,34,2,16,32
80,Fail,52,37,0,8,44
80,Fail,49,36,0,4,45
80,Fail,52,34,0,10,42
80,Fail,46,34,0,15,31
80,Fail,44,36,0,15,29
80,Fail,48,31,0,16,32
80,Fail,45,29,8,18,27
80,Fail,48,34,0,14,34
80,Fail,42,38,0,16,26
80,Fail,47,36,0,11,36
80,Fail,50,36,3,11,39
80,Fail,55,33,0,9,46
80,Fail,53,27,0,13,40
80,Fail,54,31,0,11,43
80,Fail,44,37,0,19,25
80,Fail,38,36,0,19,19
80,Fail,41,37,14,8,33
80,Fail,55,32,0,13,42
80,Fail,44,41,2,13,31
80,Fail,54,31,0,12,42
80,Fail,40,38,7,15,25
80,Fail,48,42,2,8,40
80,Fail,47,33,0,14,33
80,Fail,40,41,6,13,27
80,Fail,41,39,0,12,29
80,Fail,49,38,6,7,42
80,Fail,42,43,0,8,34
80,Fail,56,35,0,8,48
80,Fail,51,30,0,13,38
80,Fail,41,37,0,16,25
80,Fail,46,37,0,17,29
80,Fail,47,37,0,11,36
80,Fail,41,40,5,14,27
80,Fail,43,42,1,14,29
80,Fail,52,30,1,17,35
80,Fail,44,34,4,18,26
80,Fail,52,26,7,15,37
80,Fail,51,30,0,12,39
80,Fail,51,37,0,11,40
80,Fail,47,31,0,13,34
80,Fail,47,33,3,17,30
80,Fail,51,33,4,12,39
80,Fail,44,39,0,17,27
80,Fail,50,33,0,14,36
80,Fail,51,34,0,9,42
80,Fail,45,36,0,7,38
80,Fail,48,34,6,12,36
80,Fail,49,38,3,10,39
80,Fail,52,32,4,12,40
80,Fail,53,38,2,7,46
80,Fail,48,29,0,21,27
80,Fail,53,25,7,15,38
80,Fail,51,36,2,11,40
80,Fail,49,27,0,14,35
80,Fail,56,34,0,9,47
80,Fail,51,36,0,10,41
80,Fail,55,27,0,18,37
80,Fail,57,28,0,14,43
80,Fail,47,38,5,10,37
80,Fail,54,33,0,13,41
80,Fail,50,41,0,9,41
80,Fail,49,31,4,16,33
80,Fail,54,31,0,13,41
80,Fail,57,34,0,7,50
80,Fail,48,42,0,9,39
80,Fail,60,28,1,11,49
80,Fail,47,40,0,10,37
80,Fail,50,38,1,11,39
80,Fail,42,34,0,18,24
80,Fail,47,37,1,15,32
80,Fail,47,37,0,16,31
80,Fail,49,37,0,13,36
80,Fail,50,36,0,8,42
80,Fail,45,37,0,12,33
80,Fail,50,35,0,13,37
80,Fail,48,38,3,11,37
80,Fail,48,35,5,12,36
80,Fail,47,40,0,12,35
80,Fail,47,34,0,16,31
80,Fail,49,34,0,10,39
80,Fail,48,32,0,14,34
80,Fail,50,34,2,14,36
80,Fail,50,36,3,11,39
80,Fail,41,37,7,15,26
80,Fail,49,34,4,13,36
80,Fail,43,33,5,19,24
80,Fail,58,30,1,11,47
80,Fail,53,37,0,7,46
80,Fail,49,39,0,11,38
80,Fail,45,32,0,16,29
80,Fail,48,28,11,13,35
80,Fail,48,34,7,11,37
80,Fail,49,40,0,8,41
80,Fail,44,27,10,19,25
80,Fail,46,40,0,12,34
80,Fail,51,31,5,13,38
80,Fail,40,46,1,13,27
80,Fail,42,35,8,15,27
80,Fail,49,30,0,15,34
80,Fail,44,36,0,17,27
80,Fail,45,35,3,17,28
80,Fail,50,35,0,13,37
80,Fail,44,42,2,12,32
80,Fail,53,33,4,10,43
80,Fail,45,38,0,7,38
80,Fail,52,36,0,12,40
80,Fail,49,38,0,9,40
80,Fail,45,38,0,14,31
80,Fail,56,38,1,5,51
80,Fail,53,29,5,13,40
80,Fail,51,32,0,11,40
80,Fail,45,42,0,10,35
80,Fail,46,39,0,9,37
80,Fail,47,30,0,15,32
80,Fail,50,38,1,11,39
80,Fail,46,38,0,11,35
80,Fail,51,28,7,14,37
80,Fail,45,35,7,13,32
80,Fail,45,37,3,15,30
80,Fail,48,34,0,13,35
80,Fail,54,31,4,11,43
80,Fail,52,33,0,12,40
80,Fail,53,36,0,10,43
80,Fail,58,30,1,11,47
80,Fail,47,32,7,14,33
80,Fail,43,36,0,15,28
80,Fail,38,46,0,12,26
80,Fail,46,40,0,13,33
80,Fail,47,36,8,9,38
80,Fail,49,31,2,18,31
80,Fail,48,32,0,9,39
80,Fail,47,29,11,13,34
80,Fail,50,31,5,14,36
80,Fail,47,36,0,14,33
80,Fail,52,33,0,11,41
80,Fail,46,37,2,15,31
80,Fail,50,40,0,9,41
80,Fail,50,37,0,13,37
80,Fail,53,32,6,9,44
80,Fail,40,39,9,12,28
80,Fail,47,32,3,18,29
80,Fail,55,29,0,16,39
80,Fail,55,31,2,12,43
80,Fail,57,32,0,10,47
80,Fail,46,27,0,17,29
80,Fail,54,32,0,13,41
80,Fail,48,34,0,16,32
80,Fail,44,35,1,20,24
80,Fail,45,47,0,8,37
80,Fail,53,30,0,14,39
80,Fail,48,36,1,15,33
80,Fail,52,37,0,8,44
80,Fail,46,40,0,14,32
80,Fail,47,32,0,13,34
80,Fail,48,39,6,7,41
80,Fail,50,31,0,18,32
80,Fail,46,37,0,16,30
80,Fail,51,30,5,14,37
80,Fail,44,39,0,15,29
80,Fail,51,30,5,14,37
80,Fail,43,39,3,15,28
80,Fail,56,31,1,12,44
80,Fail,47,33,0,13,34
80,Fail,52,35,0,13,39
80,Fail,43,35,7,15,28
80,Fail,52,30,0,15,37
80,Fail,44,34,0,18,26
80,Fail,44,45,0,8,36
80,Fail,52,35,0,10,42
80,Fail,51,36,1,12,39
80,Fail,42,37,2,19,23
80,Fail,40,43,7,10,30
80,Fail,50,35,8,7,43
80,Fail,39,31,0,10,29
80,Fail,43,39,3,15,28
80,Fail,41,33,0,16,25
80,Fail,44,42,1,13,31
80,Fail,48,34,0,14,34
80,Fail,48,37,5,10,38
80,Fail,49,33,0,12,37
80,Fail,48,28,0,16,32
80,Fail,51,38,0,10,41
80,Fail,45,35,6,14,31
80,Fail,52,34,0,14,38
80,Fail,51,32,0,9,42
80,Fail,49,38,2,11,38
80,Fail,49,32,0,14,35
80,Fail,43,39,0,13,30
80,Fail,53,31,1,15,38
80,Fail,51,33,0,15,36
80,Fail,45,33,6,16,29
80,Fail,41,36,0,14,27
80,Fail,49,34,0,9,40
80,Fail,50,37,1,12,38
80,Fail,45,38,0,15,30
80,Fail,50,34,3,13,37
80,Fail,53,34,3,10,43
80,Fail,47,35,0,13,34
80,Fail,57,30,4,9,48
80,Fail,48,37,0,11,37
80,Fail,54,34,4,8,46
80,Fail,49,33,0,15,34
80,Fail,47,33,12,8,39
80,Fail,45,38,0,17,28
80,Fail,43,45,1,11,32
80,Fail,48,40,2,10,38
80,Fail,51,41,0,8,43
80,Fail,44,45,0,11,33
80,Fail,48,41,0,10,38
80,Fail,50,39,2,9,41
80,Fail,52,32,0,15,37
80,Fail,46,33,10,11,35
80,Fail,38,33,13,16,22
80,Fail,43,37,0,12,31
80,Fail,46,23,0,16,30
80,Fail,45,44,4,7,38
80,Fail,34,40,0,14,20
80,Fail,41,41,0,14,27
80,Fail,43,34,5,18,25
80,Fail,42,44,0,14,28
80,Fail,44,34,5,17,27
80,Fail,49,33,0,11,38
80,Fail,55,31,0,12,43
80,Fail,52,36,3,9,43
80,Fail,48,36,4,12,36
80,Fail,47,42,0,11,36
80,Fail,58,33,0,9,49
80,Fail,40,41,5,14,26
80,Fail,46,37,0,16,30
80,Fail,47,38,1,14,33
80,Fail,44,34,0,14,30
80,Fail,48,42,0,10,38
80,Fail,44,39,0,14,30
80,Fail,54,35,0,11,43
80,Fail,52,38,0,8,44
80,Fail,46,41,3,10,36
80,Fail,45,43,0,8,37
80,Fail,48,35,0,13,35
80,Fail,46,41,0,12,34
80,Fail,51,37,0,12,39
80,Fail,53,23,0,16,37
80,Fail,58,31,0,10,48
80,Fail,43,42,0,13,30
80,Fail,48,37,6,9,39
80,Fail,42,38,0,13,29
80,Fail,42,41,2,15,27
80,Fail,42,39,4,15,27
80,Fail,45,29,12,14,31
80,Fail,51,38,2,9,42
80,Fail,49,40,0,11,38
80,Fail,45,31,10,14,31
80,Fail,44,33,6,17,27
80,Fail,41,42,2,15,26
80,Fail,48,34,2,16,32
80,Fail,49,29,7,15,34
80,Fail,46,34,0,16,30
80,Fail,48,29,1,22,26
80,Fail,44,42,4,10,34
80,Fail,56,32,1,11,45
80,Fail,46,41,1,12,34
80,Fail,54,34,4,8,46
80,Fail,43,31,9,17,26
80,Fail,57,27,0,12,45
80,Fail,44,38,1,17,27
80,Fail,50,38,0,12,38
80,Fail,48,35,3,14,34
80,Fail,46,41,2,11,35
80,Fail,55,33,0,9,46
80,Fail,42,41,0,17,25
80,Fail,41,40,7,12,29
80,Fail,55,36,0,8,47
80,Fail,52,30,3,15,37
80,Fail,51,36,0,10,41
80,Fail,43,43,0,14,29
80,Fail,47,40,0,9,38
80,Fail,52,38,0,5,47
80,Fail,43,32,8,17,26
80,Fail,48,37,0,13,35
80,Fail,49,33,0,14,35
80,Fail,50,38,5,7,43
80,Fail,52,30,5,13,39
80,Fail,50,37,0,7,43
80,Fail,49,29,0,14,35
80,Fail,52,36,0,12,40
80,Fail,52,30,2,16,36
80,Fail,44,37,0,9,35
80,Fail,53,33,5,9,44
80,Fail,55,33,1,11,44
80,Fail,55,37,0,7,48
80,Fail,49,35,4,12,37
80,Fail,45,38,0,16,29
80,Fail,42,38,0,17,25
80,Fail,47,34,0,17,30
80,Fail,51,36,1,12,39
80,Fail,54,33,1,12,42
80,Fail,45,37,9,9,36
80,Fail,51,28,0,12,39
80,Fail,48,40,4,8,40
80,Fail,55,34,0,10,45
80,Fail,51,34,0,8,43
80,Fail,56,34,1,9,47
80,Fail,57,35,1,7,50
80,Fail,55,28,0,13,42
80,Fail,46,42,0,10,36
80,Fail,46,41,1,12,34
80,Fail,39,41,5,15,24
80,Fail,47,34,0,11,36
80,Fail,45,36,0,18,27
80,Fail,40,39,0,19,21
80,Fail,49,34,0,13,36
80,Fail,50,37,0,11,39
80,Fail,44,40,0,12,32
80,Fail,51,34,0,14,37
80,Fail,53,36,3,8,45
80,Fail,53,30,2,15,38
80,Fail,38,38,0,11,27
80,Fail,43,37,0,12,31
80,Fail,44,29,13,14,30
80,Fail,49,36,0,14,35
80,Fail,45,30,0,17,28
80,Fail,50,30,0,13,37
80,Fail,50,42,0,7,43
80,Fail,51,35,0,11,40
80,Fail,40,40,0,20,20
80,Fail,62,29,1,8,54
80,Fail,49,37,0,12,37
80,Fail,50,29,0,16,34
80,Fail,50,35,4,11,39
80,Fail,43,32,8,17,26
80,Fail,44,43,0,13,31
80,Fail,44,48,1,7,37
80,Fail,41,38,11,10,31
80,Fail,44,45,0,11,33
80,Fail,56,30,2,12,44
80,Fail,47,41,1,11,36
80,Fail,61,32,0,7,54
80,Fail,45,38,0,17,28
80,Fail,49,41,2,8,41
80,Fail,49,25,0,17,32
80,Fail,47,33,2,18,29
80,Fail,46,36,0,15,31
80,Fail,44,37,6,13,31
80,Fail,50,40,0,9,41
80,Fail,52,31,3,14,38
80,Fail,46,41,5,8,38
80,Fail,50,32,0,13,37
80,Fail,53,39,0,8,45
80,Fail,49,35,2,14,35
80,Fail,41,39,0,19,22
80,Fail,46,35,3,16,30
80,Fail,45,40,0,12,33
80,Fail,52,38,0,10,42
80,Fail,55,34,0,11,44
80,Fail,52,37,1,10,42
80,Fail,55,31,3,11,44
80,Fail,39,36,0,11,28
80,Fail,42,36,0,17,25
80,Fail,44,42,0,10,34
80,Fail,47,32,0,17,30
80,Fail,43,35,5,17,26
80,Fail,55,28,6,11,44
80,Fail,54,35,3,8,46
80,Fail,55,32,0,12,43
80,Fail,50,31,0,16,34
80,Fail,45,34,4,17,28
80,Fail,42,35,0,18,24
80,Fail,45,33,0,11,34
80,Fail,59,21,11,9,50
80,Fail,44,39,4,13,31
80,Fail,45,38,3,14,31
80,Fail,47,23,8,22,25
80,Fail,51,37,0,12,39
80,Fail,46,30,7,17,29
80,Fail,46,40,5,9,37
80,Fail,50,38,0,10,40
80,Fail,40,47,0,9,31
80,Fail,51,38,2,9,42
80,Fail,47,40,1,12,35
80,Fail,46,35,0,12,34
80,Fail,48,33,0,12,36
80,Fail,47,40,0,13,34
80,Fail,42,41,1,16,26
80,Fail,40,42,0,13,27
80,Fail,42,40,5,13,29
80,Fail,44,44,0,10,34
80,Fail,48,43,0,7,41
80,Fail,52,36,0,12,40
80,Fail,52,35,1,12,40
80,Fail,50,35,2,13,37
80,Fail,44,37,0,10,34
80,Fail,46,41,0,11,35
80,Fail,49,39,0,9,40
80,Fail,42,37,10,11,31
80,Fail,47,37,4,12,35
80,Fail,44,35,7,14,30
80,Fail,51,37,0,11,40
80,Fail,49,38,5,8,41
80,Fail,53,34,0,12,41
80,Fail,44,41,0,13,31
80,Fail,48,37,0,12,36
80,Fail,49,36,6,9,40
80,Fail,56,34,0,7,49
80,Fail,48,30,0,17,31
80,Fail,51,36,2,11,40
80,Fail,52,31,7,10,42
80,Fail,43,37,4,16,27
80,Fail,45,40,0,13,32
80,Fail,46,31,0,18,28
80,Fail,49,40,0,10,39
80,Fail,51,39,5,5,46
80,Fail,46,44,0,7,39
80,Fail,52,33,5,10,42
80,Fail,47,37,2,14,33
80,Fail,50,37,4,9,41
80,Fail,48,43,0,9,39
80,Fail,47,28,9,16,31
80,Fail,50,37,0,13,37
80,Fail,43,39,0,12,31
80,Fail,50,38,0,12,38
80,Fail,49,32,0,14,35
80,Fail,41,38,0,16,25
80,Fail,47,38,0,8,39
80,Fail,46,39,0,15,31
80,Fail,46,37,1,16,30
80,Fail,47,37,5,11,36
80,Fail,45,35,4,16,29
80,Fail,44,41,0,15,29
80,Fail,41,39,2,18,23
80,Fail,48,39,5,8,40
80,Fail,44,43,0,8,36
80,Fail,51,34,0,15,36
80,Fail,49,35,1,15,34
80,Fail,45,42,0,10,35
80,Fail,45,38,5,12,33
80,Fail,43,31,0,17,26
80,Fail,60,31,0,8,52
80,Fail,53,29,0,11,42
80,Fail,43,38,4,15,28
80,Fail,47,38,7,8,39
80,Fail,47,30,4,19,28
80,Fail,51,29,0,13,38
80,Fail,43,44,0,10,33
80,Fail,47,34,5,14,33
80,Fail,49,39,1,11,38
80,Fail,47,21,0,18,29
80,Fail,52,29,4,15,37
80,Fail,50,35,6,9,41
80,Fail,52,37,0,7,45
80,Fail,47,39,0,11,36
80,Fail,51,40,0,7,44
80,Fail,48,28,0,16,32
80,Fail,46,35,0,14,32
80,Fail,47,36,0,14,33
80,Fail,50,35,4,11,39
80,Fail,51,29,0,17,34
80,Fail,54,33,2,11,43
80,Fail,43,46,0,9,34
80,Fail,29,39,0,17,12
80,Fail,48,34,0,15,33
80,Fail,49,39,2,10,39
80,Fail,45,45,0,10,35
80,Fail,56,32,1,11,45
80,Fail,49,38,5,8,41
80,Fail,45,36,0,11,34
80,Fail,48,38,2,12,36
80,Fail,47,29,0,15,32
80,Fail,51,30,0,15,36
80,Fail,42,35,0,14,28
80,Fail,47,35,5,13,34
80,Fail,46,40,3,11,35
80,Fail,46,32,0,16,30
80,Fail,45,38,0,10,35
80,Fail,42,43,0,13,29
80,Fail,48,27,0,12,36
80,Fail,50,32,0,12,38
80,Fail,47,34,8,11,36
80,Fail,52,27,0,14,38
80,Fail,48,40,0,7,41
80,Fail,50,32,3,15,35
80,Fail,54,29,0,11,43
80,Fail,44,32,8,16,28
80,Fail,51,31,0,16,35
80,Fail,56,30,0,14,42
80,Fail,46,39,6,9,37
80,Fail,49,30,0,12,37
80,Fail,53,39,0,8,45
80,Fail,47,37,0,15,32
80,Fail,48,33,10,9,39
80,Fail,41,40,0,16,25
80,Fail,44,42,1,13,31
80,Fail,47,34,6,13,34
80,Fail,45,39,3,13,32
80,Fail,46,42,4,8,38
80,Fail,49,30,0,15,34
80,Fail,52,33,4,11,41
80,Fail,46,43,2,9,37
80,Fail,45,35,0,17,28
80,Fail,52,33,1,14,38
80,Fail,54,36,0,9,45
80,Fail,56,32,2,10,46
80,Fail,56,33,1,10,46
80,Fail,49,36,2,13,36
80,Fail,46,33,0,14,32
80,Fail,45,37,0,10,35
80,Fail,45,37,0,16,29
80,Fail,53,35,1,11,42
80,Fail,51,33,3,13,38
80,Fail,43,42,6,9,34
80,Fail,48,34,0,16,32
80,Fail,53,37,0,7,46
80,Fail,46,30,0,20,26
80,Fail,50,38,1,11,39
80,Fail,46,41,3,10,36
80,Fail,50,29,0,16,34
80,Fail,52,32,0,13,39
80,Fail,38,41,10,11,27
80,Fail,46,36,1,17,29
80,Fail,50,36,0,5,45
80,Fail,47,31,8,14,33
80,Fail,56,29,0,12,44
80,Fail,44,29,9,18,26
80,Fail,48,37,0,12,36
80,Fail,52,36,0,9,43
80,Fail,40,43,3,14,26
80,Fail,48,32,0,12,36
80,Fail,46,38,9,7,39
80,Fail,51,42,1,6,45
80,Fail,51,24,14,11,40
80,Fail,47,35,5,13,34
80,Fail,46,34,4,16,30
80,Fail,49,36,7,8,41
80,Fail,45,35,11,9,36
80,Fail,51,36,0,12,39
80,Fail,56,32,0,11,45
80,Fail,50,27,0,20,30
80,Fail,50,36,0,12,38
80,Fail,41,44,0,12,29
80,Fail,51,37,0,11,40
80,Fail,47,37,7,9,38
80,Fail,39,37,8,16,23
80,Fail,51,36,0,11,40
80,Fail,41,38,0,16,25
80,Fail,47,37,0,9,38
80,Fail,53,33,2,12,41
80,Fail,45,32,8,15,30
80,Fail,49,30,9,12,37
80,Fail,49,33,5,13,36
80,Fail,48,34,9,9,39
80,Fail,42,36,6,16,26
80,Fail,54,30,7,9,45
80,Fail,50,35,2,13,37
80,Fail,43,42,0,12,31
80,Fail,41,38,7,14,27
80,Fail,42,37,10,11,31
80,Fail,49,32,2,17,32
80,Fail,45,32,0,14,31
80,Fail,45,29,0,20,25
80,Fail,46,39,0,9,37
80,Fail,46,28,0,13,33
80,Fail,48,40,0,12,36
80,Fail,48,30,0,15,33
80,Fail,47,29,0,14,33
80,Fail,45,38,2,15,30
80,Fail,38,42,0,17,21
80,Fail,43,36,8,13,30
80,Fail,46,43,2,9,37
80,Fail,51,33,0,11,40
80,Fail,51,37,2,10,41
80,Fail,47,39,0,11,36
80,Fail,47,42,1,10,37
80,Fail,49,39,0,6,43
80,Fail,46,35,0,15,31
80,Fail,46,36,0,16,30
80,Fail,52,31,1,16,36
80,Fail,46,37,6,11,35
80,Fail,45,34,0,17,28
80,Fail,52,32,3,13,39
80,Fail,48,36,6,10,38
80,Fail,43,39,0,11,32
80,Fail,51,38,0,9,42
80,Fail,42,43,0,12,30
80,Fail,44,40,2,14,30
80,Fail,50,37,3,10,40
80,Fail,56,29,0,10,46
80,Fail,51,28,3,18,33
80,Fail,44,36,1,19,25
80,Fail,49,33,0,12,37
80,Fail,41,33,9,17,24
80,Fail,51,28,0,19,32
80,Fail,50,32,4,14,36
80,Fail,49,29,0,17,32
80,Fail,49,30,0,18,31
80,Fail,54,32,0,12,42
80,Fail,51,36,0,13,38
80,Fail,51,37,0,6,45
80,Fail,44,33,6,17,27
80,Fail,50,33,5,12,38
80,Fail,50,38,1,11,39
80,Fail,49,30,3,18,31
80,Fail,53,28,4,15,38
80,Fail,45,39,0,10,35
80,Fail,52,31,0,13,39
80,Fail,51,36,0,13,38
80,Fail,48,35,0,12,36
80,Fail,45,32,0,13,32
80,Fail,43,42,3,12,31
80,Fail,47,32,0,13,34
80,Fail,50,40,0,9,41
80,Fail,51,34,1,14,37
80,Fail,48,40,0,5,43
80,Fail,56,26,0,15,41
80,Fail,42,35,4,19,23
80,Fail,59,27,0,10,49
80,Fail,53,33,3,11,42
80,Fail,44,40,3,13,31
80,Fail,57,27,0,14,43
80,Fail,40,37,0,8,32
80,Fail,50,30,0,14,36
80,Fail,48,32,8,12,36
80,Fail,56,32,0,8,48
80,Fail,48,37,0,11,37
80,Fail,41,42,0,12,29
80,Fail,53,37,0,6,47
80,Fail,43,45,3,9,34
80,Fail,49,40,0,11,38
80,Fail,47,35,0,18,29
80,Fail,45,39,2,14,31
80,Fail,50,35,2,13,37
80,Fail,46,39,6,9,37
80,Fail,42,43,5,10,32
80,Fail,57,28,3,12,45
80,Fail,50,33,2,15,35
80,Fail,49,31,0,17,32
80,Fail,55,29,7,9,46
80,Fail,57,32,0,10,47
80,Fail,50,32,1,17,33
80,Fail,44,42,0,12,32
80,Fail,53,29,0,12,41
80,Fail,46,36,0,12,34
80,Fail,40,41,4,15,25
80,Fail,51,38,0,9,42
80,Fail,52,34,5,9,43
80,Fail,47,36,0,13,34
80,Fail,42,37,5,16,26
80,Fail,51,36,0,13,38
80,Fail,44,35,0,20,24
80,Fail,45,36,9,10,35
80,Fail,45,41,5,9,36
80,Fail,43,32,11,14,29
80,Fail,58,28,0,13,45
80,Fail,42,41,5,12,30
80,Fail,39,39,0,16,23
80,Fail,46,30,10,14,32
80,Fail,42,47,0,11,31
80,Fail,48,33,0,15,33
80,Fail,46,39,3,12,34
80,Fail,52,36,2,10,42
80,Fail,48,31,2,19,29
80,Fail,49,33,0,17,32
80,Fail,37,39,0,15,22
80,Fail,45,37,5,13,32
80,Fail,42,39,9,10,32
80,Fail,47,37,0,16,31
80,Fail,47,30,7,16,31
80,Fail,47,32,7,14,33
80,Fail,40,44,0,16,24
80,Fail,44,35,8,13,31
80,Fail,49,39,1,11,38
80,Fail,47,40,0,10,37
80,Fail,43,39,0,13,30
80,Fail,50,41,1,8,42
80,Fail,51,31,0,13,38
80,Fail,43,42,3,12,31
80,Fail,50,26,0,16,34
80,Fail,46,41,0,12,34
80,Fail,49,30,0,12,37
80,Fail,44,32,0,13,31
80,Fail,48,33,4,15,33
80,Fail,48,30,5,17,31
80,Fail,44,42,5,9,35
80,Fail,45,36,0,14,31
80,Fail,55,32,1,12,43
80,Fail,37,27,0,19,18
80,Fail,41,50,3,6,35
80,Fail,47,37,3,13,34
80,Fail,45,38,0,17,28
80,Fail,53,35,0,7,46
80,Fail,47,41,1,11,36
80,Fail,50,32,1,17,33
80,Fail,49,40,0,9,40
80,Fail,53,35,0,10,43
80,Fail,52,34,0,13,39
80,Fail,43,39,5,13,30
80,Fail,52,37,0,11,41
80,Fail,52,31,4,13,39
80,Fail,53,36,1,10,43
80,Fail,49,36,0,13,36
80,Fail,43,34,0,12,31
80,Fail,46,37,0,13,33
80,Fail,43,38,0,13,30
80,Fail,42,37,9,12,30
80,Fail,43,40,9,8,35
80,Fail,48,35,0,11,37
80,Fail,47,32,0,16,31
80,Fail,42,39,16,3,39
80,Fail,53,27,7,13,40
80,Fail,48,41,0,11,37
80,Fail,45,38,0,15,30
80,Fail,42,43,3,12,30
80,Fail,46,38,0,11,35
80,Fail,47,37,0,14,33
80,Fail,47,33,0,13,34
80,Fail,48,36,6,10,38
80,Fail,40,42,1,17,23
80,Fail,46,38,0,9,37
80,Fail,55,34,0,8,47
80,Fail,41,38,8,13,28
80,Fail,53,34,4,9,44
80,Fail,45,33,5,17,28
80,Fail,44,41,0,10,34
80,Fail,56,35,1,8,48
80,Fail,48,33,7,12,36
80,Fail,40,41,1,18,22
80,Fail,42,40,0,13,29
80,Fail,50,31,0,17,33
80,Fail,49,38,0,11,38
80,Fail,50,30,0,10,40
80,Fail,52,38,2,8,44
80,Fail,52,40,1,7,45
80,Fail,40,36,11,13,27
80,Fail,46,32,3,19,27
80,Fail,50,26,8,16,34
80,Fail,45,35,0,13,32
80,Fail,48,30,4,18,30
80,Fail,49,29,12,10,39
80,Fail,42,46,0,9,33
80,Fail,50,37,0,9,41
80,Fail,51,26,0,17,34
80,Fail,48,40,0,12,36
80,Fail,56,31,0,8,48
80,Fail,50,35,2,13,37
80,Fail,49,38,3,10,39
80,Fail,54,35,4,7,47
80,Fail,46,40,1,13,33
80,Fail,50,40,0,10,40
80,Fail,46,34,0,11,35
80,Fail,48,36,4,12,36
80,Fail,49,38,0,10,39
80,Fail,53,39,0,8,45
80,Fail,53,34,1,12,41
80,Fail,43,37,0,15,28
80,Fail,44,34,5,17,27
80,Fail,49,38,5,8,41
80,Fail,58,31,1,10,48
80,Fail,42,35,0,14,28
80,Fail,43,48,2,7,36
80,Fail,55,31,2,12,43
80,Fail,54,32,0,13,41
80,Fail,44,34,11,11,33
80,Fail,45,35,0,14,31
80,Fail,45,33,0,17,28
80,Fail,45,35,1,19,26
80,Fail,41,37,0,15,26
80,Fail,51,35,0,12,39
80,Fail,45,44,2,9,36
80,Fail,42,34,0,15,27
80,Fail,48,30,7,15,33
80,Fail,49,39,1,11,38
80,Fail,51,36,0,10,41
80,Fail,44,43,4,9,35
80,Fail,54,36,0,9,45
80,Fail,47,30,8,15,32
80,Fail,38,44,0,16,22
80,Fail,50,35,0,13,37
80,Fail,44,39,5,12,32
80,Fail,56,34,3,7,49
80,Fail,50,36,0,9,41
80,Fail,50,32,2,16,34
80,Fail,54,26,0,10,44
80,Fail,51,35,0,13,38
80,Fail,40,38,0,16,24
80,Fail,51,35,0,10,41
80,Fail,61,29,1,9,52
80,Fail,46,33,0,15,31
80,Fail,51,33,1,15,36
80,Fail,47,33,0,17,30
80,Fail,45,39,8,8,37
80,Fail,50,35,4,11,39
80,Fail,47,37,2,14,33
80,Fail,49,37,0,14,35
80,Fail,46,43,0,11,35
80,Fail,47,34,3,16,31
80,Fail,42,32,0,16,26
80,Fail,45,37,0,14,31
80,Fail,42,30,7,21,21
80,Fail,48,33,7,12,36
80,Fail,53,35,0,11,42
80,Fail,51,37,0,12,39
80,Fail,46,38,0,10,36
80,Fail,48,37,0,15,33
80,Fail,51,31,0,17,34
80,Fail,45,35,6,14,31
80,Fail,42,38,8,12,30
80,Fail,54,38,0,7,47
80,Fail,42,35,0,14,28
80,Fail,53,39,3,5,48
80,Fail,49,37,3,11,38
80,Fail,46,40,2,12,34
80,Fail,52,35,4,9,43
80,Fail,44,32,7,17,27
80,Fail,41,36,0,16,25
80,Fail,48,30,3,19,29
80,Fail,40,35,0,18,22
80,Fail,44,36,8,12,32
80,Fail,50,32,6,12,38
80,Fail,41,38,3,18,23
80,Fail,48,38,0,14,34
80,Fail,42,44,0,10,32
80,Fail,45,36,3,16,29
80,Fail,46,35,6,13,33
80,Fail,51,40,0,9,42
80,Fail,47,36,0,16,31
80,Fail,46,39,0,12,34
80,Fail,39,37,6,18,21
80,Fail,39,46,0,13,26
80,Fail,51,36,5,8,43
80,Fail,53,31,4,12,41
80,Fail,48,33,5,14,34
80,Fail,49,34,0,9,40
80,Fail,46,40,0,10,36
80,Fail,49,33,0,15,34
80,Fail,46,42,3,9,37
80,Fail,51,35,4,10,41
80,Fail,50,39,0,9,41
80,Fail,49,38,0,6,43
80,Fail,47,40,6,7,40
80,Fail,37,35,0,19,18
80,Fail,49,29,0,17,32
80,Fail,52,32,3,13,39
80,Fail,51,31,0,17,34
80,Fail,45,36,0,15,30
80,Fail,49,36,0,12,37
80,Fail,56,34,0,9,47
80,Fail,46,36,0,9,37
80,Fail,48,31,0,20,28
80,Fail,52,39,2,7,45
80,Fail,46,29,4,21,25
80,Fail,40,41,3,16,24
80,Fail,47,35,3,15,32
80,Fail,37,44,0,13,24
80,Fail,46,32,0,12,34
80,Fail,46,37,1,16,30
80,Fail,48,38,0,13,35
80,Fail,48,27,0,20,28
80,Fail,52,31,0,13,39
80,Fail,56,28,0,15,41
80,Fail,48,30,0,14,34
80,Fail,50,33,2,15,35
80,Fail,39,39,7,15,24
80,Fail,55,29,0,10,45
80,Fail,53,38,0,7,46
80,Fail,47,42,0,10,37
80,Fail,43,32,0,19,24
80,Fail,42,35,6,17,25
80,Fail,46,31,5,18,28
80,Fail,52,32,5,11,41
80,Fail,50,32,0,14,36
80,Fail,48,38,0,10,38
80,Fail,44,33,0,19,25
80,Fail,45,29,1,25,20
80,Fail,52,38,0,8,44
80,Fail,54,30,0,12,42
80,Fail,55,27,2,16,39
80,Fail,52,37,0,10,42
80,Fail,39,28,0,26,13
80,Fail,47,31,9,13,34
80,Fail,54,36,0,8,46
80,Fail,52,35,4,9,43
80,Fail,51,33,6,10,41
80,Fail,36,37,14,13,23
80,Fail,47,39,4,10,37
80,Fail,49,40,1,10,39
80,Fail,49,34,4,13,36
80,Fail,52,31,0,14,38
80,Fail,50,41,0,8,42
80,Fail,49,37,4,10,39
80,Fail,53,30,9,8,45
80,Fail,51,33,0,10,41
80,Fail,49,30,0,17,32
80,Fail,50,36,0,12,38
80,Fail,51,30,2,17,34
80,Fail,51,34,1,14,37
80,Fail,54,31,0,13,41
80,Fail,50,37,0,9,41
80,Fail,45,46,0,9,36
80,Fail,51,36,4,9,42
80,Fail,55,34,0,11,44
80,Fail,41,37,9,13,28
80,Fail,46,31,10,13,33
80,Fail,45,29,0,17,28
80,Fail,49,34,0,14,35
80,Fail,58,32,0,10,48
80,Fail,48,41,2,9,39
80,Fail,47,32,10,11,36
80,Fail,46,39,1,14,32
80,Fail,46,37,0,15,31
80,Fail,41,42,1,16,25
80,Fail,42,37,7,14,28
80,Fail,42,44,0,14,28
80,Fail,41,36,0,16,25
80,Fail,53,31,2,14,39
80,Fail,43,41,3,13,30
80,Fail,43,31,0,17,26
80,Fail,53,32,0,14,39
80,Fail,50,34,0,13,37
80,Fail,54,34,2,10,44
80,Fail,52,39,2,7,45
80,Fail,55,29,3,13,42
80,Fail,45,37,1,17,28
80,Fail,51,32,0,13,38
80,Fail,51,31,6,12,39
80,Fail,49,40,1,10,39
80,Fail,42,45,0,9,33
80,Fail,45,37,0,13,32
80,Fail,47,34,4,15,32
80,Fail,55,32,0,13,42
80,Fail,52,31,4,13,39
80,Fail,46,38,0,11,35
80,Fail,42,39,0,15,27
80,Fail,47,33,7,13,34
80,Fail,47,38,0,12,35
80,Fail,43,42,0,13,30
80,Fail,50,39,0,11,39
80,Fail,59,37,0,4,55
80,Fail,50,42,0,7,43
80,Fail,41,36,0,15,26
80,Fail,50,31,2,17,33
80,Fail,48,39,3,10,38
80,Fail,49,37,0,12,37
80,Fail,50,36,0,8,42
80,Fail,41,41,10,8,33
80,Fail,51,31,4,14,37
80,Fail,44,36,4,16,28
80,Fail,42,42,1,15,27
80,Fail,47,34,0,16,31
80,Fail,59,28,0,12,47
80,Fail,42,36,0,16,26
80,Fail,51,31,0,15,36
80,Fail,44,38,0,10,34
80,Fail,47,30,0,14,33
80,Fail,57,31,1,11,46
80,Fail,55,31,4,10,45
80,Fail,41,37,4,18,23
80,Fail,45,36,0,16,29
80,Fail,51,37,4,8,43
80,Fail,52,38,0,10,42
80,Fail,44,32,0,23,21
80,Fail,48,37,0,14,34
80,Fail,46,35,8,11,35
80,Fail,52,41,0,6,46
80,Fail,46,40,1,13,33
80,Fail,47,36,0,11,36
80,Fail,50,34,4,12,38
80,Fail,49,42,0,8,41
80,Fail,52,30,0,12,40
80,Fail,48,36,0,14,34
80,Fail,49,29,12,10,39
80,Fail,56,34,0,10,46
80,Fail,48,40,3,9,39
80,Fail,46,42,2,10,36
80,Fail,50,35,0,13,37
80,Fail,48,41,3,8,40
80,Fail,38,41,8,13,25
80,Fail,48,37,0,13,35
80,Fail,45,37,4,14,31
80,Fail,47,33,4,16,31
80,Fail,55,29,0,11,44
80,Fail,51,38,0,10,41
80,Fail,48,32,0,13,35
80,Fail,49,32,4,15,34
80,Fail,48,37,2,13,35
80,Fail,49,41,2,8,41
80,Fail,51,37,4,8,43
80,Fail,50,39,1,10,40
80,Fail,52,29,0,18,34
80,Fail,47,36,0,15,32
80,Fail,50,33,4,13,37
80,Fail,49,30,0,17,32
80,Fail,51,38,0,8,43
80,Fail,48,43,0,9,39
80,Fail,35,41,3,21,14
80,Fail,49,32,5,14,35
80,Fail,49,34,0,10,39
80,Fail,47,35,0,13,34
80,Fail,40,42,7,11,29
80,Fail,47,38,4,11,36
80,Fail,47,36,0,7,40
80,Fail,49,34,2,15,34
80,Fail,50,37,2,11,39
80,Fail,44,43,0,13,31
80,Fail,47,39,2,12,35
80,Fail,50,39,0,11,39
80,Fail,49,31,0,16,33
80,Fail,52,38,0,9,43
80,Fail,48,37,0,14,34
80,Fail,39,37,0,18,21
80,Fail,54,35,0,11,43
80,Fail,44,41,0,14,30
80,Fail,52,30,0,11,41
80,Fail,52,34,2,12,40
80,Fail,45,37,0,11,34
80,Fail,41,36,0,15,26
80,Fail,56,32,4,8,48
80,Fail,47,35,0,17,30
80,Fail,41,48,0,11,30
80,Fail,50,37,0,11,39
80,Fail,48,32,0,15,33
80,Fail,46,33,0,20,26
80,Fail,47,39,1,13,34
80,Fail,54,31,4,11,43
80,Fail,42,37,9,12,30
80,Fail,48,37,0,13,35
80,Fail,49,32,6,13,36
80,Fail,55,36,4,5,50
80,Fail,44,35,0,15,29
80,Fail,50,30,0,16,34
80,Fail,52,28,0,20,32
80,Fail,53,29,4,14,39
80,Fail,41,35,0,15,26
80,Fail,53,38,0,8,45
80,Fail,56,36,3,5,51
80,Fail,55,33,0,11,44
80,Fail,51,38,0,6,45
80,Fail,48,35,5,12,36
80,Fail,48,41,0,9,39
80,Fail,41,38,4,17,24
80,Fail,51,35,0,10,41
80,Fail,51,37,0,3,48
80,Fail,49,40,0,11,38
80,Fail,52,35,1,12,40
80,Fail,45,41,0,11,34
80,Fail,53,39,0,7,46
80,Fail,54,36,0,9,45
80,Fail,44,35,0,17,27
80,Fail,44,33,0,14,30
80,Fail,49,40,2,9,40
80,Fail,46,39,5,10,36
80,Fail,46,44,0,9,37
80,Fail,42,39,0,13,29
80,Fail,47,43,2,8,39
80,Fail,50,35,0,14,36
80,Fail,46,31,8,15,31
80,Fail,47,41,5,7,40
80,Fail,46,37,0,16,30
80,Fail,42,45,1,12,30
80,Fail,57,32,0,11,46
80,Fail,49,32,1,18,31
80,Fail,48,35,0,15,33
80,Fail,46,28,0,16,30
80,Fail,46,39,0,15,31
80,Fail,51,32,5,12,39
80,Fail,49,41,2,8,41
80,Fail,53,26,0,11,42
80,Fail,50,38,2,10,40
80,Fail,39,37,0,13,26
80,Fail,42,34,0,17,25
80,Fail,47,37,0,14,33
80,Fail,41,42,3,14,27
80,Fail,45,37,2,16,29
80,Fail,52,32,0,11,41
80,Fail,54,36,1,9,45
80,Fail,33,44,0,19,14
80,Fail,49,37,0,11,38
80,Fail,49,33,8,10,39
80,Fail,43,42,1,14,29
80,Fail,49,36,2,13,36
80,Fail,44,33,4,19,25
80,Fail,45,33,6,16,29
80,Fail,51,35,0,13,38
80,Fail,50,28,4,18,32
80,Fail,44,35,4,17,27
80,Fail,42,39,6,13,29
80,Fail,50,33,0,16,34
80,Fail,39,41,0,12,27
80,Fail,54,33,1,12,42
80,Fail,51,37,0,11,40
80,Fail,51,34,3,12,39
80,Fail,53,34,2,11,42
80,Fail,54,32,0,14,40
80,Fail,55,33,0,11,44
80,Fail,48,31,5,16,32
80,Fail,45,36,5,14,31
80,Fail,50,37,1,12,38
80,Fail,45,43,0,8,37
80,Fail,46,37,0,16,30
80,Fail,45,39,3,13,32
80,Fail,50,33,6,11,39
80,Fail,42,33,10,15,27
80,Fail,50,37,0,13,37
80,Fail,43,35,0,10,33
80,Fail,47,35,0,18,29
80,Fail,43,41,0,11,32
80,Fail,44,37,7,12,32
80,Fail,58,33,0,8,50
80,Fail,52,25,9,14,38
80,Fail,52,36,0,11,41
80,Fail,51,34,0,15,36
80,Fail,53,36,2,9,44
80,Fail,46,37,0,16,30
80,Fail,42,42,0,14,28
80,Fail,47,36,7,10,37
80,Fail,48,29,5,18,30
80,Fail,49,32,0,12,37
80,Fail,50,37,3,10,40
80,Fail,56,30,0,12,44
80,Fail,57,31,0,10,47
80,Fail,46,37,0,11,35
80,Fail,51,34,0,11,40
80,Fail,48,37,0,11,37
80,Fail,57,26,0,8,49
80,Fail,48,35,1,16,32
80,Fail,48,39,3,10,38
80,Fail,45,30,0,16,29
80,Fail,44,34,8,14,30
80,Fail,51,40,0,5,46
80,Fail,52,36,0,11,41
80,Fail,49,33,0,13,36
80,Fail,46,35,3,16,30
80,Fail,47,38,0,14,33
80,Fail,43,37,0,19,24
80,Fail,39,40,0,16,23
80,Fail,52,36,1,11,41
80,Fail,48,38,0,12,36
80,Fail,51,32,0,11,40
80,Fail,47,35,0,12,35
80,Fail,46,35,0,9,37
80,Fail,48,34,0,16,32
80,Fail,48,39,2,11,37
80,Fail,44,38,0,17,27
80,Fail,42,45,0,13,29
80,Fail,44,36,0,19,25
80,Fail,45,36,0,10,35
80,Fail,43,40,5,12,31
80,Fail,46,41,2,11,35
80,Fail,40,41,0,10,30
80,Fail,48,35,1,16,32
80,Fail,47,38,2,13,34
80,Fail,49,38,0,7,42
80,Fail,48,35,0,11,37
80,Fail,42,28,5,25,17
80,Fail,53,37,0,10,43
80,Fail,49,38,0,11,38
80,Fail,49,30,7,14,35
80,Fail,48,34,6,12,36
80,Fail,53,37,0,8,45
80,Fail,45,38,0,11,34
80,Fail,43,39,0,16,27
80,Fail,45,39,3,13,32
80,Fail,53,36,0,10,43
80,Fail,52,29,1,18,34
80,Fail,50,39,4,7,43
80,Fail,43,35,0,17,26
80,Fail,54,29,0,15,39
80,Fail,55,26,7,12,43
80,Fail,49,25,6,20,29
80,Fail,46,36,0,10,36
80,Fail,52,43,0,5,47
80,Fail,52,29,0,12,40
80,Fail,48,32,0,19,29
80,Fail,52,30,0,17,35
80,Fail,44,41,1,14,30
80,Fail,42,35,0,15,27
80,Fail,54,31,5,10,44
80,Fail,57,30,5,8,49
80,Fail,51,37,0,11,40
80,Fail,43,41,9,7,36
80,Fail,46,35,0,15,31
80,Fail,49,34,8,9,40
80,Fail,36,41,3,20,16
80,Fail,47,32,0,15,32
80,Fail,51,34,0,7,44
80,Fail,45,30,0,19,26
80,Fail,49,38,0,12,37
80,Fail,45,38,0,11,34
80,Fail,55,31,0,11,44
80,Fail,49,35,2,14,35
80,Fail,50,38,1,11,39
80,Fail,51,34,0,13,38
80,Fail,42,39,9,10,32
80,Fail,52,42,1,5,47
80,Fail,46,40,3,11,35
80,Fail,46,40,0,12,34
80,Fail,47,38,1,14,33
80,Fail,55,34,0,10,45
80,Fail,48,38,3,11,37
80,Fail,54,34,0,12,42
80,Fail,54,25,6,15,39
80,Fail,56,30,4,10,46
80,Fail,44,34,5,17,27
80,Fail,48,40,8,4,44
80,Fail,47,23,14,16,31
80,Fail,46,41,0,13,33
80,Fail,48,29,6,17,31
80,Fail,48,30,10,12,36
80,Fail,54,27,4,15,39
80,Fail,48,38,0,14,34
80,Fail,51,39,2,8,43
80,Fail,49,32,0,14,35
80,Fail,51,33,1,15,36
80,Fail,51,36,0,13,38
80,Fail,52,39,0,9,43
80,Fail,43,38,5,14,29
80,Fail,57,25,0,12,45
80,Fail,46,34,7,13,33
80,Fail,51,35,0,12,39
80,Fail,53,34,5,8,45
80,Fail,42,35,8,15,27
80,Fail,49,38,0,13,36
80,Fail,47,33,1,19,28
80,Fail,47,34,5,14,33
80,Fail,53,32,6,9,44
80,Fail,59,31,0,10,49
80,Fail,45,35,0,13,32
80,Fail,45,36,0,18,27
80,Fail,47,33,0,19,28
80,Fail,55,38,0,7,48
80,Fail,50,30,6,14,36
80,Fail,50,41,0,8,42
80,Fail,50,38,0,12,38
80,Fail,46,37,7,10,36
80,Fail,49,29,0,14,35
80,Fail,53,34,2,11,42
80,Fail,54,38,0,7,47
80,Fail,51,36,0,13,38
80,Fail,49,32,0,17,32
80,Fail,56,38,0,4,52
80,Fail,53,32,0,13,40
80,Fail,48,27,7,18,30
80,Fail,49,35,2,14,35
80,Fail,40,47,0,12,28
80,Fail,46,30,7,17,29
80,Fail,51,35,2,12,39
80,Fail,45,32,7,16,29
80,Fail,47,39,0,11,36
80,Fail,46,34,0,16,30
80,Fail,50,40,0,5,45
80,Fail,50,35,0,15,35
80,Fail,52,31,0,16,36
80,Fail,46,34,7,13,33
80,Fail,59,34,0,6,53
80,Fail,54,37,0,8,46
80,Fail,48,38,0,13,35
80,Fail,46,38,6,10,36
80,Fail,50,33,4,13,37
80,Fail,58,30,0,8,50
80,Fail,48,37,0,11,37
80,Fail,60,29,0,9,51
80,Fail,38,38,6,18,20
80,Fail,47,32,0,16,31
80,Fail,52,30,4,14,38
80,Fail,47,42,0,10,37
80,Fail,47,28,2,23,24
80,Fail,51,36,0,11,40
80,Fail,59,30,2,9,50
80,Fail,54,28,2,16,38
80,Fail,42,40,6,12,30
80,Fail,48,34,0,11,37
80,Fail,45,36,0,16,29
80,Fail,53,34,2,11,42
80,Fail,61,30,0,7,54
80,Fail,54,32,2,12,42
80,Fail,48,35,1,16,32
80,Fail,51,35,6,8,43
80,Fail,47,32,0,14,33
80,Fail,48,35,5,12,36
80,Fail,45,36,0,15,30
80,Fail,41,38,0,17,24
80,Fail,51,29,0,13,38
80,Fail,55,32,0,10,45
80,Fail,48,30,2,20,28
80,Fail,53,31,0,12,41
80,Fail,53,33,2,12,41
80,Fail,55,30,0,11,44
80,Fail,49,39,1,11,38
80,Fail,53,38,2,7,46
80,Fail,51,36,0,13,38
80,Fail,32,43,11,14,18
80,Fail,47,29,0,19,28
80,Fail,46,40,5,9,37
80,Fail,61,30,0,9,52
80,Fail,44,38,8,10,34
80,Fail,50,31,5,14,36
80,Fail,49,32,0,13,36
80,Fail,42,36,0,17,25
80,Fail,46,33,0,15,31
80,Fail,46,28,10,16,30
80,Fail,41,46,0,10,31
80,Fail,55,29,5,11,44
80,Fail,47,36,0,13,34
80,Fail,43,39,0,12,31
80,Fail,43,36,0,12,31
80,Fail,40,45,0,13,27
80,Fail,44,35,10,11,33
80,Fail,46,36,2,16,30
80,Fail,47,36,0,13,34
80,Fail,47,30,0,12,35
80,Fail,51,31,1,17,34
80,Fail,50,37,6,7,43
80,Fail,49,33,0,16,33
80,Fail,44,42,0,9,35
80,Fail,42,36,0,12,30
80,Fail,44,35,5,16,28
80,Fail,41,37,0,14,27
80,Fail,43,28,13,16,27
80,Fail,45,31,6,18,27
80,Fail,44,40,0,13,31
80,Fail,38,35,10,17,21
80,Fail,48,42,2,8,40
80,Fail,47,40,2,11,36
80,Fail,53,30,0,15,38
80,Fail,47,31,0,13,34
80,Fail,49,34,0,10,39
80,Fail,42,42,1,15,27
80,Fail,49,35,0,13,36
80,Fail,54,34,0,11,43
80,Fail,53,30,4,13,40
80,Fail,57,27,0,14,43
80,Fail,56,38,0,6,50
80,Fail,48,37,0,15,33
80,Fail,48,39,5,8,40
80,Fail,43,37,0,10,33
80,Fail,55,28,3,14,41
80,Fail,44,41,0,12,32
80,Fail,53,32,0,10,43
80,Fail,39,35,5,21,18
80,Fail,47,40,0,11,36
80,Fail,53,33,5,9,44
80,Fail,43,41,0,16,27
80,Fail,41,45,0,13,28
80,Fail,54,32,8,6,48
80,Fail,45,32,8,15,30
80,Fail,44,32,11,13,31
80,Fail,50,34,2,14,36
80,Fail,45,43,3,9,36
80,Fail,47,30,0,20,27
80,Fail,44,43,3,10,34
80,Fail,42,40,2,16,26
80,Fail,41,34,0,20,21
80,Fail,50,32,4,14,36
80,Fail,46,43,1,10,36
80,Fail,52,35,0,11,41
80,Fail,55,33,0,10,45
80,Fail,43,38,9,10,33
80,Fail,52,30,0,12,40
80,Fail,46,40,0,9,37
80,Fail,48,30,0,19,29
80,Fail,43,30,0,14,29
80,Fail,49,36,6,9,40
80,Fail,45,34,4,17,28
80,Fail,42,32,0,16,26
80,Fail,38,43,8,11,27
80,Fail,53,31,0,16,37
80,Fail,44,36,0,11,33
80,Fail,46,36,0,9,37
80,Fail,46,33,3,18,28
80,Fail,60,29,1,10,50
80,Fail,48,36,0,10,38
80,Fail,42,39,2,17,25
80,Fail,39,42,0,14,25
80,Fail,50,32,0,17,33
80,Fail,47,38,0,14,33
80,Fail,51,35,2,12,39
80,Fail,45,39,1,15,30
80,Fail,53,35,3,9,44
80,Fail,44,38,0,16,28
80,Fail,43,38,5,14,29
80,Fail,41,38,3,18,23
80,Fail,43,33,0,11,32
80,Fail,44,29,0,21,23
80,Fail,49,40,1,10,39
80,Fail,54,26,10,10,44
80,Fail,49,42,0,8,41
80,Fail,38,45,3,14,24
80,Fail,45,35,0,13,32
80,Fail,47,37,0,13,34
80,Fail,55,33,1,11,44
80,Fail,45,41,0,14,31
80,Fail,51,40,2,7,44
80,Fail,34,43,8,15,19
80,Fail,44,36,0,15,29
80,Fail,53,36,1,10,43
80,Fail,56,30,0,11,45
80,Fail,39,47,5,9,30
80,Fail,55,32,0,9,46
80,Fail,50,29,0,17,33
80,Fail,55,36,0,9,46
80,Fail,47,43,0,8,39
80,Fail,39,45,2,14,25
80,Fail,48,40,6,6,42
80,Fail,56,30,0,9,47
80,Fail,40,43,3,14,26
80,Fail,50,38,0,12,38
80,Fail,47,37,0,12,35
80,Fail,44,37,3,16,28
80,Fail,47,35,0,10,37
80,Fail,48,34,0,10,38
80,Fail,55,33,1,11,44
80,Fail,53,36,5,6,47
80,Fail,46,42,8,4,42
80,Fail,46,37,0,17,29
80,Fail,42,42,0,15,27
80,Fail,52,28,0,14,38
80,Fail,43,32,0,16,27
80,Fail,53,34,3,10,43
80,Fail,47,41,0,12,35
80,Fail,41,39,0,19,22
80,Fail,48,40,0,11,37
80,Fail,48,36,0,13,35
80,Fail,49,39,2,10,39
80,Fail,39,36,0,22,17
80,Fail,48,32,0,16,32
80,Fail,48,33,0,18,30
80,Fail,46,34,0,14,32
80,Fail,49,38,0,13,36
80,Fail,39,39,10,12,27
80,Fail,43,32,9,16,27
80,Fail,46,35,0,11,35
80,Fail,46,40,0,12,34
80,Fail,46,34,0,20,26
80,Fail,49,39,0,6,43
80,Fail,53,33,5,9,44
80,Fail,55,33,0,12,43
80,Fail,45,42,0,11,34
80,Fail,40,31,0,19,21
80,Fail,48,43,2,7,41
80,Fail,41,35,8,16,25
80,Fail,52,35,0,10,42
80,Fail,53,34,0,9,44
80,Fail,41,35,0,17,24
80,Fail,44,42,0,12,32
80,Fail,46,32,0,10,36
80,Fail,50,32,0,14,36
80,Fail,52,29,0,14,38
80,Fail,55,26,0,15,40
80,Fail,50,32,0,16,34
80,Fail,47,39,2,12,35
80,Fail,50,33,0,14,36
80,Fail,57,27,6,10,47
80,Fail,49,32,6,13,36
80,Fail,46,35,8,11,35
80,Fail,55,33,0,12,43
80,Fail,52,31,0,13,39
80,Fail,47,37,1,15,32
80,Fail,49,32,0,17,32
80,Fail,46,29,4,21,25
80,Fail,49,37,0,13,36
80,Fail,46,33,0,11,35
80,Fail,49,34,4,13,36
80,Fail,51,37,0,9,42
80,Fail,47,40,0,12,35
80,Fail,45,31,0,15,30
80,Fail,52,32,2,14,38
80,Fail,53,33,4,10,43
80,Fail,54,28,0,15,39
80,Fail,53,39,2,6,47
80,Fail,52,33,3,12,40
80,Fail,49,37,5,9,40
80,Fail,55,32,3,10,45
80,Fail,56,34,0,7,49
80,Fail,47,39,1,13,34
80,Fail,61,21,3,15,46
80,Fail,46,41,0,13,33
80,Fail,57,28,0,12,45
80,Fail,48,43,0,8,40
80,Fail,48,36,0,10,38
80,Fail,46,44,0,10,36
80,Fail,48,34,9,9,39
80,Fail,48,35,5,12,36
80,Fail,56,32,1,11,45
80,Fail,51,29,0,13,38
80,Fail,47,39,0,13,34
80,Fail,52,29,5,14,38
80,Fail,54,35,0,10,44
80,Fail,43,43,2,12,31
80,Fail,44,40,0,16,28
80,Fail,53,37,1,9,44
80,Fail,43,40,5,12,31
80,Fail,51,39,0,10,41
80,Fail,54,36,1,9,45
80,Fail,46,41,1,12,34
80,Fail,40,33,10,17,23
80,Fail,59,31,0,10,49
80,Fail,55,36,0,9,46
80,Fail,48,37,0,11,37
80,Fail,43,38,0,16,27
80,Fail,43,39,2,16,27
80,Fail,55,36,2,7,48
80,Fail,54,30,7,9,45
80,Fail,50,34,0,13,37
80,Fail,52,40,1,7,45
80,Fail,53,35,0,11,42
80,Fail,46,33,0,21,25
80,Fail,42,34,9,15,27
80,Fail,45,39,0,11,34
80,Fail,42,43,4,11,31
80,Fail,41,39,1,19,22
80,Fail,48,30,5,17,31
80,Fail,54,34,0,7,47
80,Fail,47,36,0,13,34
80,Fail,49,31,0,17,32
80,Fail,42,36,10,12,30
80,Fail,44,37,6,13,31
80,Fail,43,37,0,20,23
80,Fail,53,35,1,11,42
80,Fail,47,33,3,17,30
80,Fail,54,35,4,7,47
80,Fail,48,39,0,8,40
80,Fail,54,36,0,9,45
80,Fail,53,36,1,10,43
80,Fail,48,34,0,16,32
80,Fail,47,31,0,15,32
80,Fail,50,38,0,12,38
80,Fail,43,38,10,9,34
80,Fail,52,30,0,15,37
80,Fail,47,42,3,8,39
80,Fail,52,40,0,7,45
80,Fail,51,28,0,16,35
80,Fail,36,40,14,10,26
80,Fail,31,41,10,18,13
80,Fail,45,28,11,16,29
80,Fail,46,27,7,20,26
80,Fail,53,23,11,13,40
80,Fail,48,37,0,15,33
80,Fail,42,39,0,12,30
80,Fail,50,41,0,9,41
80,Fail,44,35,6,15,29
80,Fail,49,37,1,13,36
80,Fail,48,28,12,12,36
80,Fail,41,32,5,22,19
80,Fail,48,39,2,11,37
80,Fail,51,31,0,17,34
80,Fail,51,39,0,10,41
80,Fail,50,38,0,8,42
80,Fail,44,40,0,12,32
80,Fail,46,39,0,10,36
80,Fail,46,37,9,8,38
80,Fail,50,31,11,8,42
80,Fail,50,33,0,10,40
80,Fail,42,45,0,12,30
80,Fail,48,44,1,7,41
80,Fail,49,30,4,17,32
80,Fail,52,30,3,15,37
80,Fail,51,33,7,9,42
80,Fail,48,32,0,14,34
80,Fail,45,31,8,16,29
80,Fail,46,39,0,14,32
80,Fail,46,39,1,14,32
80,Fail,44,35,0,16,28
80,Fail,49,37,0,13,36
80,Fail,50,36,0,14,36
80,Fail,48,35,0,15,33
80,Fail,45,33,8,14,31
80,Fail,51,36,1,12,39
80,Fail,44,37,3,16,28
80,Fail,38,48,0,12,26
80,Fail,51,32,0,17,34
80,Fail,47,41,0,8,39
80,Fail,49,35,3,13,36
80,Fail,49,32,0,13,36
80,Fail,44,41,3,12,32
80,Fail,57,29,4,10,47
80,Fail,47,26,6,21,26
80,Fail,47,34,0,15,32
80,Fail,44,37,0,10,34
80,Fail,50,37,2,11,39
80,Fail,44,45,0,8,36
80,Fail,50,32,9,9,41
80,Fail,51,42,2,5,46
80,Fail,52,32,4,12,40
80,Fail,49,36,0,14,35
80,Fail,45,36,2,17,28
80,Fail,46,36,3,15,31
80,Fail,42,33,0,16,26
80,Fail,48,37,4,11,37
80,Fail,49,37,0,12,37
80,Fail,48,37,0,14,34
80,Fail,44,26,0,23,21
80,Fail,41,43,0,13,28
80,Fail,42,32,0,14,28
80,Fail,51,34,0,15,36
80,Fail,42,40,4,14,28
80,Fail,50,36,1,13,37
80,Fail,51,32,3,14,37
80,Fail,51,31,1,17,34
80,Fail,46,34,8,12,34
80,Fail,44,35,0,15,29
80,Fail,47,37,3,13,34
80,Fail,49,36,0,13,36
80,Fail,51,33,0,12,39
80,Fail,52,38,0,9,43
80,Fail,51,36,5,8,43
80,Fail,59,31,2,8,51
80,Fail,52,34,4,10,42
80,Fail,48,35,5,12,36
80,Fail,50,40,0,8,42
80,Fail,50,37,2,11,39
80,Fail,42,30,11,17,25
80,Fail,47,35,0,11,36
80,Fail,51,29,0,17,34
80,Fail,52,34,0,14,38
80,Fail,52,42,1,5,47
80,Fail,42,40,0,13,29
80,Fail,48,28,9,15,33
80,Fail,50,33,0,14,36
80,Fail,44,34,7,15,29
80,Fail,61,24,8,7,54
80,Fail,52,41,1,6,46
80,Fail,50,34,2,14,36
80,Fail,44,39,0,15,29
80,Fail,47,41,1,11,36
80,Fail,48,37,0,15,33
80,Fail,41,33,0,17,24
80,Fail,51,29,0,8,43
80,Fail,51,31,3,15,36
80,Fail,43,37,5,15,28
80,Fail,46,44,0,10,36
80,Fail,47,31,0,15,32
80,Fail,45,37,4,14,31
80,Fail,52,31,1,16,36
80,Fail,55,33,0,8,47
80,Fail,47,34,0,16,31
80,Fail,49,35,0,13,36
80,Fail,47,39,2,12,35
80,Fail,44,37,1,18,26
80,Fail,53,32,3,12,41
80,Fail,40,40,0,19,21
80,Fail,40,37,11,12,28
80,Fail,47,36,2,15,32
80,Fail,48,37,3,12,36
80,Fail,51,33,2,14,37
80,Fail,53,33,0,9,44
80,Fail,50,39,1,10,40
80,Fail,48,41,5,6,42
80,Fail,45,41,0,11,34
80,Fail,45,39,0,12,33
80,Fail,51,41,0,4,47
80,Fail,55,30,0,13,42
80,Fail,38,41,0,18,20
80,Fail,52,37,1,10,42
80,Fail,51,30,7,12,39
80,Fail,43,35,0,13,30
80,Fail,43,40,3,14,29
80,Fail,48,37,2,13,35
80,Fail,40,29,0,18,22
80,Fail,53,36,0,10,43
80,Fail,49,36,1,14,35
80,Fail,42,31,0,24,18
80,Fail,52,32,0,16,36
80,Fail,46,43,3,8,38
80,Fail,46,44,1,9,37
80,Fail,43,40,2,15,28
80,Fail,46,41,0,11,35
80,Fail,47,41,0,8,39
80,Fail,45,38,0,11,34
80,Fail,49,37,7,7,42
80,Fail,49,40,0,7,42
80,Fail,59,28,0,10,49
80,Fail,49,37,6,8,41
80,Fail,51,32,5,12,39
80,Fail,41,37,7,15,26
80,Fail,40,43,5,12,28
80,Fail,45,36,6,13,32
80,Fail,49,31,7,13,36
80,Fail,42,47,0,9,33
80,Fail,42,42,0,13,29
80,Fail,43,45,0,11,32
80,Fail,49,35,5,11,38
80,Fail,43,30,0,21,22
80,Fail,51,34,0,15,36
80,Fail,49,39,0,11,38
80,Fail,51,28,9,12,39
80,Fail,41,41,0,15,26
80,Fail,41,38,2,19,22
80,Fail,53,30,4,13,40
80,Fail,41,39,4,16,25
80,Fail,43,39,1,17,26
80,Fail,46,32,0,13,33
80,Fail,61,30,2,7,54
80,Fail,53,30,0,13,40
80,Fail,46,42,0,10,36
80,Fail,55,31,3,11,44
80,Fail,44,33,0,20,24
80,Fail,50,33,6,11,39
80,Fail,43,41,0,13,30
80,Fail,54,36,0,8,46
80,Fail,50,41,0,7,43
80,Fail,48,34,0,10,38
80,Fail,47,34,0,12,35
80,Fail,43,36,0,11,32
80,Fail,42,36,0,14,28
80,Fail,51,32,0,12,39
80,Fail,36,46,0,6,30
80,Fail,46,40,0,14,32
80,Fail,48,37,0,12,36
80,Fail,52,25,9,14,38
80,Fail,47,39,1,13,34
80,Fail,44,35,0,10,34
80,Fail,56,32,1,11,45
80,Fail,43,42,0,13,30
80,Fail,49,35,0,12,37
80,Fail,50,33,0,14,36
80,Fail,51,29,10,10,41
80,Fail,49,32,7,12,37
80,Fail,53,34,0,9,44
80,Fail,46,40,0,12,34
80,Fail,49,33,0,17,32
80,Fail,51,38,0,6,45
80,Fail,49,44,0,6,43
80,Fail,42,39,0,15,27
80,Fail,48,31,0,17,31
80,Fail,49,30,0,19,30
80,Fail,48,33,4,15,33
80,Fail,48,40,1,11,37
80,Fail,48,41,0,8,40
80,Fail,51,28,0,17,34
80,Fail,49,37,1,13,36
80,Fail,49,38,0,9,40
80,Fail,47,40,1,12,35
80,Fail,48,32,0,18,30
80,Fail,53,30,5,12,41
80,Fail,49,39,0,8,41
80,Fail,46,30,0,16,30
80,Fail,45,33,5,17,28
80,Fail,54,32,3,11,43
80,Fail,53,33,0,14,39
80,Fail,52,34,0,12,40
80,Fail,46,38,4,12,34
80,Fail,53,32,2,13,40
80,Fail,39,41,6,14,25
80,Fail,48,28,0,22,26
80,Fail,46,39,3,12,34
80,Fail,45,39,5,11,34
80,Fail,48,29,11,12,36
80,Fail,45,38,0,16,29
80,Fail,43,36,5,16,27
80,Fail,39,38,3,20,19
80,Fail,46,37,0,15,31
80,Fail,48,43,0,6,42
80,Fail,54,39,2,5,49
80,Fail,41,37,7,15,26
80,Fail,48,34,5,13,35
80,Fail,59,32,0,9,50
80,Fail,47,34,4,15,32
80,Fail,52,36,0,10,42
80,Fail,49,29,0,12,37
80,Fail,47,36,0,13,34
80,Fail,47,38,1,14,33
80,Fail,44,36,0,19,25
80,Fail,50,28,9,13,37
80,Fail,51,39,4,6,45
80,Fail,50,37,0,12,38
80,Fail,55,28,5,12,43
80,Fail,35,36,0,19,16
80,Fail,55,33,0,12,43
80,Fail,52,36,0,9,43
80,Fail,58,32,0,7,51
80,Fail,46,33,5,16,30
80,Fail,52,39,1,8,44
80,Fail,50,37,1,12,38
80,Fail,48,37,0,13,35
80,Fail,35,46,0,9,26
80,Fail,45,42,0,10,35
80,Fail,44,38,0,12,32
80,Fail,54,38,0,6,48
80,Fail,41,32,0,13,28
80,Fail,54,33,1,12,42
80,Fail,42,41,0,16,26
80,Fail,46,44,0,9,37
80,Fail,53,41,0,5,48
80,Fail,53,38,0,6,47
80,Fail,45,43,0,11,34
80,Fail,49,33,3,15,34
80,Fail,53,35,1,11,42
80,Fail,50,33,0,16,34
80,Fail,54,34,5,7,47
80,Fail,49,39,0,12,37
80,Fail,53,35,3,9,44
80,Fail,50,27,9,14,36
80,Fail,60,31,0,9,51
80,Fail,46,29,5,20,26
80,Fail,46,30,0,18,28
80,Fail,39,38,2,21,18
80,Fail,51,31,1,17,34
80,Fail,55,29,3,13,42
80,Fail,48,31,0,16,32
80,Fail,57,32,2,9,48
80,Fail,48,24,12,16,32
80,Fail,41,37,0,16,25
80,Fail,49,35,10,6,43
80,Fail,40,40,6,14,26
80,Fail,52,30,0,17,35
80,Fail,43,36,0,20,23
80,Fail,51,34,0,12,39
80,Fail,49,38,0,13,36
80,Fail,51,37,0,12,39
80,Fail,44,32,0,18,26
80,Fail,45,37,4,14,31
80,Fail,49,34,4,13,36
80,Fail,52,29,2,17,35
80,Fail,53,31,0,14,39
80,Fail,46,38,0,14,32
80,Fail,56,27,0,14,42
80,Fail,46,43,2,9,37
80,Fail,51,38,6,5,46
80,Fail,47,39,0,10,37
80,Fail,43,34,5,18,25
80,Fail,36,35,0,10,26
80,Fail,50,37,5,8,42
80,Fail,52,32,0,12,40
80,Fail,52,31,1,16,36
80,Fail,45,32,0,14,31
80,Fail,51,38,4,7,44
80,Fail,52,34,0,14,38
80,Fail,56,30,0,9,47
80,Fail,51,30,5,14,37
80,Fail,46,39,0,7,39
80,Fail,48,29,3,20,28
80,Fail,50,42,0,7,43
80,Fail,46,43,2,9,37
80,Fail,40,36,0,19,21
80,Fail,44,40,5,11,33
80,Fail,50,36,0,12,38
80,Fail,45,36,4,15,30
80,Fail,52,36,0,12,40
80,Fail,51,36,3,10,41
80,Fail,42,51,0,6,36
80,Fail,48,41,1,10,38
80,Fail,53,31,2,14,39
80,Fail,45,41,0,11,34
80,Fail,45,29,0,16,29
80,Fail,53,38,2,7,46
80,Fail,43,36,0,15,28
80,Fail,50,33,0,14,36
80,Fail,51,36,3,10,41
80,Fail,47,40,0,13,34
80,Fail,51,35,0,10,41
80,Fail,50,36,2,12,38
80,Fail,48,42,0,10,38
80,Fail,51,34,0,13,38
80,Fail,42,36,12,10,32
80,Fail,47,34,0,14,33
80,Fail,43,39,0,13,30
80,Fail,40,38,2,20,20
80,Fail,50,32,6,12,38
80,Fail,53,33,0,9,44
80,Fail,51,41,1,7,44
80,Fail,36,43,6,15,21
80,Fail,46,36,0,12,34
80,Fail,52,34,0,10,42
80,Fail,51,31,0,10,41
80,Fail,49,36,5,10,39
80,Fail,48,39,0,12,36
80,Fail,44,37,5,14,30
80,Fail,46,39,2,13,33
80,Fail,48,31,0,21,27
80,Fail,51,25,0,16,35
80,Fail,57,35,1,7,50
80,Fail,47,35,6,12,35
80,Fail,48,39,0,12,36
80,Fail,55,33,0,11,44
80,Fail,48,37,1,14,34
80,Fail,49,40,0,11,38
80,Fail,52,30,0,12,40
80,Fail,46,32,7,15,31
80,Fail,44,41,3,12,32
80,Fail,45,31,0,18,27
80,Fail,46,35,7,12,34
80,Fail,52,35,0,12,40
80,Fail,59,27,1,13,46
80,Fail,48,35,0,11,37
80,Fail,50,37,0,13,37
80,Fail,39,40,0,14,25
80,Fail,46,33,3,18,28
80,Fail,51,38,0,10,41
80,Fail,58,27,2,13,45
80,Fail,51,37,1,11,40
80,Fail,47,32,0,15,32
80,Fail,47,38,0,14,33
80,Fail,44,40,5,11,33
80,Fail,44,38,0,9,35
80,Fail,54,32,0,12,42
80,Fail,43,34,0,16,27
80,Fail,49,34,0,15,34
80,Fail,47,31,5,17,30
80,Fail,44,40,6,10,34
80,Fail,45,39,0,12,33
80,Fail,53,33,0,13,40
80,Fail,50,34,5,11,39
80,Fail,50,41,1,8,42
80,Fail,51,33,1,15,36
80,Fail,47,37,4,12,35
80,Fail,49,34,0,9,40
80,Fail,46,39,4,11,35
80,Fail,54,33,1,12,42
80,Fail,44,37,0,16,28
80,Fail,52,32,0,12,40
80,Fail,46,28,6,20,26
80,Fail,44,34,6,16,28
80,Fail,45,37,6,12,33
80,Fail,49,40,3,8,41
80,Fail,55,33,0,8,47
80,Fail,37,40,0,16,21
80,Fail,48,36,3,13,35
80,Fail,49,38,1,12,37
80,Fail,46,35,2,17,29
80,Fail,50,38,0,10,40
80,Fail,47,34,0,19,28
80,Fail,49,33,1,17,32
80,Fail,48,25,13,14,34
80,Fail,43,42,0,15,28
80,Fail,45,36,6,13,32
80,Fail,49,34,4,13,36
80,Fail,44,38,3,15,29
80,Fail,40,38,0,14,26
80,Fail,54,30,0,16,38
80,Fail,48,35,9,8,40
80,Fail,37,36,0,18,19
80,Fail,52,34,4,10,42
80,Fail,46,33,7,14,32
80,Fail,44,41,0,13,31
80,Fail,49,31,8,12,37
80,Fail,46,42,1,11,35
80,Fail,47,35,0,16,31
80,Fail,47,40,0,12,35
80,Fail,41,40,0,14,27
80,Fail,49,33,0,18,31
80,Fail,50,35,2,13,37
80,Fail,46,34,0,16,30
80,Fail,45,46,0,9,36
80,Fail,48,34,0,13,35
80,Fail,44,38,1,17,27
80,Fail,48,41,0,9,39
80,Fail,52,28,0,11,41
80,Fail,48,39,0,9,39
80,Fail,48,36,7,9,39
80,Fail,48,43,1,8,40
80,Fail,54,38,2,6,48
80,Fail,57,34,0,8,49
80,Fail,44,34,0,15,29
80,Fail,43,46,4,7,36
80,Fail,49,33,4,14,35
80,Fail,47,34,0,17,30
80,Fail,48,37,5,10,38
80,Fail,45,38,0,16,29
80,Fail,46,32,0,14,32
80,Fail,53,34,0,13,40
80,Fail,43,36,0,14,29
80,Fail,48,36,2,14,34
80,Fail,45,40,4,11,34
80,Fail,40,35,0,16,24
80,Fail,50,42,1,7,43
80,Fail,45,38,5,12,33
80,Fail,49,37,0,14,35
80,Fail,42,39,7,12,30
80,Fail,39,40,1,20,19
80,Fail,44,37,0,15,29
80,Fail,51,35,1,13,38
80,Fail,43,36,9,12,31
80,Fail,50,42,1,7,43
80,Fail,43,32,0,19,24
80,Fail,52,37,0,9,43
80,Fail,45,40,3,12,33
80,Fail,47,38,0,8,39
80,Fail,42,46,1,11,31
80,Fail,45,37,0,13,32
80,Fail,53,31,0,13,40
80,Fail,57,32,0,11,46
80,Fail,50,31,4,15,35
80,Fail,40,42,0,12,28
80,Fail,54,31,0,15,39
80,Fail,50,33,0,14,36
80,Fail,55,33,2,10,45
80,Fail,45,41,0,12,33
80,Fail,48,36,4,12,36
80,Fail,51,37,0,12,39
80,Fail,43,44,0,10,33
80,Fail,53,42,0,5,48
80,Fail,41,33,6,20,21
80,Fail,47,33,4,16,31
80,Fail,47,39,0,12,35
80,Fail,59,32,2,7,52
80,Fail,49,29,0,18,31
80,Fail,34,41,0,13,21
80,Fail,55,29,5,11,44
80,Fail,45,37,4,14,31
80,Fail,47,34,6,13,34
80,Fail,53,31,0,6,47
80,Fail,47,39,1,13,34
80,Fail,45,40,1,14,31
80,Fail,49,35,0,12,37
80,Fail,50,41,0,8,42
80,Fail,56,34,0,8,48
80,Fail,51,36,0,12,39
80,Fail,48,36,3,13,35
80,Fail,47,28,13,12,35
80,Fail,49,29,0,19,30
80,Fail,51,36,2,11,40
80,Fail,49,32,7,12,37
80,Fail,42,38,1,19,23
80,Fail,46,44,1,9,37
80,Fail,56,29,0,9,47
80,Fail,47,38,0,13,34
80,Fail,51,27,5,17,34
80,Fail,49,41,0,6,43
80,Fail,47,31,7,15,32
80,Fail,50,38,0,11,39
80,Fail,45,35,1,19,26
80,Fail,48,31,4,17,31
80,Fail,56,34,1,9,47
80,Fail,47,31,6,16,31
80,Fail,47,40,0,11,36
80,Fail,44,40,0,15,29
80,Fail,57,29,0,12,45
80,Fail,53,39,1,7,46
80,Fail,50,39,3,8,42
80,Fail,50,33,6,11,39
80,Fail,51,37,0,12,39
80,Fail,41,38,8,13,28
80,Fail,40,44,2,14,26
80,Fail,47,42,3,8,39
80,Fail,48,34,0,12,36
80,Fail,44,39,8,9,35
80,Fail,50,35,5,10,40
80,Fail,40,40,0,15,25
80,Fail,49,34,0,11,38
80,Fail,52,36,0,8,44
80,Fail,52,34,0,10,42
80,Fail,49,38,2,11,38
80,Fail,49,37,0,14,35
80,Fail,54,34,2,10,44
80,Fail,56,31,0,13,43
80,Fail,43,42,0,15,28
80,Fail,47,35,0,14,33
80,Fail,45,40,0,15,30
80,Fail,44,37,0,11,33
80,Fail,48,34,0,14,34
80,Fail,43,32,6,19,24
80,Fail,49,40,0,11,38
80,Fail,49,37,0,11,38
80,Fail,57,23,0,14,43
80,Fail,47,37,0,11,36
80,Fail,50,41,0,5,45
80,Fail,51,39,7,3,48
80,Fail,47,32,12,9,38
80,Fail,45,36,0,15,30
80,Fail,54,39,0,6,48
80,Fail,45,37,7,11,34
80,Fail,50,39,1,10,40
80,Fail,44,38,0,12,32
80,Fail,50,37,0,9,41
80,Fail,52,32,0,12,40
80,Fail,47,39,0,9,38
80,Fail,45,36,0,15,30
80,Fail,48,33,4,15,33
80,Fail,51,34,0,13,38
80,Fail,53,39,0,4,49
80,Fail,45,36,4,15,30
80,Fail,56,29,0,15,41
80,Fail,55,32,1,12,43
80,Fail,59,31,5,5,54
80,Fail,46,39,0,15,31
80,Fail,46,40,2,12,34
80,Fail,50,29,0,19,31
80,Fail,53,29,0,10,43
80,Fail,52,37,0,10,42
80,Fail,53,36,0,10,43
80,Fail,47,34,5,14,33
80,Fail,60,21,0,14,46
80,Fail,41,44,0,15,26
80,Fail,48,29,0,16,32
80,Fail,59,29,2,10,49
80,Fail,50,33,0,12,38
80,Fail,50,39,3,8,42
80,Fail,36,39,4,21,15
80,Fail,49,32,0,17,32
80,Fail,44,36,6,14,30
80,Fail,42,33,0,14,28
80,Fail,44,37,0,16,28
80,Fail,47,35,0,17,30
80,Fail,49,33,0,16,33
80,Fail,38,36,0,14,24
80,Fail,43,33,11,13,30
80,Fail,54,36,2,8,46
80,Fail,40,43,4,13,27
80,Fail,43,40,0,15,28
80,Fail,46,35,0,18,28
80,Fail,54,33,0,13,41
80,Fail,45,38,1,16,29
80,Fail,44,40,0,10,34
80,Fail,45,36,5,14,31
80,Fail,51,36,0,12,39
80,Fail,49,33,0,12,37
80,Fail,53,33,1,13,40
80,Fail,53,37,4,6,47
80,Fail,52,35,0,12,40
80,Fail,46,39,1,14,32
80,Fail,45,42,0,7,38
80,Fail,51,28,4,17,34
80,Fail,48,37,0,13,35
80,Fail,49,34,5,12,37
80,Fail,47,33,6,14,33
80,Fail,40,38,8,14,26
80,Fail,46,35,5,14,32
80,Fail,45,35,6,14,31
80,Fail,51,34,1,14,37
80,Fail,48,32,5,15,33
80,Fail,46,43,0,11,35
80,Fail,45,42,2,11,34
80,Fail,50,32,0,15,35
80,Fail,45,37,2,16,29
80,Fail,47,34,0,18,29
80,Fail,48,35,5,12,36
80,Fail,42,33,0,14,28
80,Fail,52,35,0,11,41
80,Fail,54,40,0,4,50
80,Fail,55,34,0,8,47
80,Fail,47,42,0,9,38
80,Fail,47,42,1,10,37
80,Fail,52,34,0,11,41
80,Fail,48,32,0,16,32
80,Fail,45,36,6,13,32
80,Fail,47,36,1,16,31
80,Fail,51,38,1,10,41
80,Fail,49,39,0,12,37
80,Fail,55,35,0,10,45
80,Fail,48,40,4,8,40
80,Fail,46,42,2,10,36
80,Fail,49,39,0,9,40
80,Fail,49,40,3,8,41
80,Fail,52,36,1,11,41
80,Fail,50,32,5,13,37
80,Fail,54,33,0,10,44
80,Fail,39,44,1,16,23
80,Fail,52,36,0,9,43
80,Fail,52,33,7,8,44
80,Fail,55,33,0,10,45
80,Fail,46,41,0,11,35
80,Fail,49,31,0,15,34
80,Fail,42,37,6,15,27
80,Fail,48,39,0,13,35
80,Fail,48,41,0,11,37
80,Fail,50,32,0,17,33
80,Fail,43,35,0,15,28
80,Fail,46,35,0,8,38
80,Fail,42,37,6,15,27
80,Fail,55,34,0,11,44
80,Fail,46,40,5,9,37
80,Fail,51,33,2,14,37
80,Fail,41,40,4,15,26
80,Fail,53,37,0,9,44
80,Fail,50,35,0,10,40
80,Fail,48,32,0,15,33
80,Fail,51,32,6,11,40
80,Fail,48,42,0,10,38
80,Fail,49,39,0,8,41
80,Fail,50,42,1,7,43
80,Fail,46,40,0,9,37
80,Fail,44,33,9,14,30
80,Fail,51,33,3,13,38
80,Fail,42,39,7,12,30
80,Fail,46,34,0,12,34
80,Fail,48,36,0,11,37
80,Fail,38,33,7,22,16
80,Fail,49,37,0,10,39
80,Fail,51,30,0,11,40
80,Fail,45,36,0,11,34
80,Fail,50,28,0,15,35
80,Fail,49,38,4,9,40
80,Fail,42,36,3,19,23
80,Fail,51,36,0,13,38
80,Fail,42,39,3,16,26
80,Fail,44,41,0,11,33
80,Fail,53,34,3,10,43
80,Fail,42,34,0,17,25
80,Fail,54,35,0,10,44
80,Fail,49,29,5,17,32
80,Fail,46,36,6,12,34
80,Fail,47,26,7,20,27
80,Fail,57,30,0,5,52
80,Fail,53,36,0,10,43
80,Fail,54,30,6,10,44
80,Fail,42,42,0,12,30
80,Fail,39,30,7,24,15
80,Fail,51,31,3,15,36
80,Fail,50,29,4,17,33
80,Fail,49,38,0,12,37
80,Fail,47,34,0,14,33
80,Fail,45,36,8,11,34
80,Fail,48,41,0,9,39
80,Fail,56,37,0,5,51
80,Fail,46,23,0,19,27
80,Fail,46,34,0,13,33
80,Fail,46,34,0,14,32
80,Fail,46,46,2,6,40
80,Fail,53,37,1,9,44
80,Fail,44,44,1,11,33
80,Fail,45,43,0,11,34
80,Fail,52,32,2,14,38
80,Fail,51,42,0,7,44
80,Fail,46,39,0,11,35
80,Fail,46,45,0,5,41
80,Fail,42,34,5,19,23
80,Fail,45,36,7,12,33
80,Fail,47,38,5,10,37
80,Fail,47,40,0,10,37
80,Fail,55,27,3,15,40
80,Fail,53,32,0,13,40
80,Fail,35,43,5,17,18
80,Fail,34,50,0,16,18
80,Fail,43,40,3,14,29
80,Fail,44,40,0,16,28
80,Fail,49,39,0,8,41
80,Fail,42,37,0,15,27
80,Fail,52,35,0,10,42
80,Fail,44,34,12,10,34
80,Fail,53,37,0,8,45
80,Fail,56,29,0,11,45
80,Fail,49,35,7,9,40
80,Fail,50,33,8,9,41
80,Fail,52,30,0,12,40
80,Fail,60,26,0,14,46
80,Fail,48,27,4,21,27
80,Fail,49,28,13,10,39
80,Fail,40,36,6,18,22
80,Fail,44,46,0,8,36
80,Fail,48,37,1,14,34
80,Fail,50,34,4,12,38
80,Fail,49,32,1,18,31
80,Fail,58,31,1,10,48
80,Fail,42,43,2,13,29
80,Fail,41,40,0,15,26
80,Fail,42,38,11,9,33
80,Fail,48,43,0,8,40
80,Fail,42,41,1,16,26
80,Fail,44,37,9,10,34
80,Fail,52,30,0,14,38
80,Fail,53,39,1,7,46
80,Fail,51,35,0,9,42
80,Fail,46,33,8,13,33
80,Fail,40,39,0,12,28
80,Fail,41,36,8,15,26
80,Fail,51,23,0,21,30
80,Fail,41,37,0,19,22
80,Fail,41,37,0,16,25
80,Fail,46,41,0,8,38
80,Fail,45,31,8,16,29
80,Fail,51,35,0,14,37
80,Fail,46,36,0,14,32
80,Fail,52,32,0,10,42
80,Fail,50,31,8,11,39
80,Fail,52,31,3,14,38
80,Fail,40,39,0,19,21
80,Fail,49,37,0,13,36
80,Fail,49,32,1,18,31
80,Fail,51,36,0,7,44
80,Fail,40,42,0,11,29
80,Fail,44,34,10,12,32
80,Fail,46,39,0,13,33
80,Fail,54,34,5,7,47
80,Fail,45,44,0,11,34
80,Fail,48,32,0,18,30
80,Fail,39,37,8,16,23
80,Fail,46,34,0,17,29
80,Fail,46,33,0,16,30
80,Fail,51,33,6,10,41
80,Fail,55,33,0,9,46
80,Fail,53,33,0,12,41
80,Fail,48,36,0,10,38
80,Fail,59,24,0,10,49
80,Fail,46,40,2,12,34
80,Fail,51,40,0,9,42
80,Fail,49,28,0,11,38
80,Fail,45,35,2,18,27
80,Fail,45,29,0,14,31
80,Fail,57,27,5,11,46
80,Fail,45,34,0,14,31
80,Fail,45,46,0,7,38
80,Fail,50,34,0,10,40
80,Fail,52,32,0,15,37
80,Fail,52,35,0,10,42
80,Fail,45,35,0,11,34
80,Fail,54,36,2,8,46
80,Fail,51,34,0,10,41
80,Fail,48,44,0,8,40
80,Fail,53,30,0,15,38
80,Fail,40,43,4,13,27
80,Fail,43,40,0,14,29
80,Fail,42,45,0,9,33
80,Fail,49,28,0,19,30
80,Fail,58,31,3,8,50
80,Fail,48,37,0,8,40
80,Fail,38,42,0,9,29
80,Fail,42,41,5,12,30
80,Fail,50,39,0,11,39
80,Fail,47,36,0,12,35
80,Fail,52,32,3,13,39
80,Fail,53,36,0,7,46
80,Fail,53,30,2,15,38
80,Fail,38,32,0,16,22
80,Fail,50,36,2,12,38
80,Fail,42,40,0,15,27
80,Fail,47,31,0,14,33
80,Fail,46,40,0,12,34
80,Fail,49,32,0,10,39
80,Fail,52,33,3,12,40
80,Fail,52,38,0,9,43
80,Fail,52,33,0,14,38
80,Fail,44,40,0,11,33
80,Fail,52,34,1,13,39
80,Fail,54,28,2,16,38
80,Fail,47,38,1,14,33
80,Fail,42,37,2,19,23
80,Fail,46,38,0,11,35
80,Fail,53,33,0,7,46
80,Fail,45,43,0,8,37
80,Fail,50,39,0,11,39
80,Fail,49,35,3,13,36
80,Fail,52,30,6,12,40
80,Fail,44,46,2,8,36
80,Fail,47,35,9,9,38
80,Fail,43,36,7,14,29
80,Fail,49,37,0,12,37
80,Fail,43,43,0,11,32
80,Fail,47,38,1,14,33
80,Fail,54,27,5,14,40
80,Fail,50,39,0,11,39
80,Fail,49,27,4,20,29
80,Fail,49,39,5,7,42
80,Fail,43,35,8,14,29
80,Fail,54,31,0,11,43
80,Fail,48,35,0,15,33
80,Fail,43,38,0,17,26
80,Fail,52,33,0,11,41
80,Fail,51,38,2,9,42
80,Fail,39,38,8,15,24
80,Fail,44,33,6,17,27
80,Fail,54,28,0,14,40
80,Fail,47,36,0,15,32
80,Fail,43,39,0,10,33
80,Fail,46,36,2,16,30
80,Fail,45,35,8,12,33
80,Fail,53,32,0,14,39
80,Fail,53,31,0,13,40
80,Fail,47,35,0,13,34
80,Fail,53,34,0,8,45
80,Fail,46,31,0,14,32
80,Fail,49,36,3,12,37
80,Fail,46,36,8,10,36
80,Fail,51,40,3,6,45
80,Fail,44,40,1,15,29
80,Fail,44,37,0,16,28
80,Fail,53,40,1,6,47
80,Fail,57,25,0,18,39
80,Fail,46,36,0,14,32
80,Fail,46,37,2,15,31
80,Fail,52,32,0,15,37
80,Fail,47,40,2,11,36
80,Fail,51,38,1,10,41
80,Fail,40,28,0,17,23
80,Fail,48,36,1,15,33
80,Fail,46,43,1,10,36
80,Fail,45,43,0,12,33
80,Fail,46,42,0,10,36
80,Fail,47,39,1,13,34
80,Fail,52,32,4,12,40
80,Fail,51,34,4,11,40
80,Fail,50,37,0,11,39
80,Fail,56,33,1,10,46
80,Fail,52,36,0,11,41
80,Fail,46,37,0,12,34
80,Fail,46,34,6,14,32
80,Fail,51,35,0,14,37
80,Fail,54,27,2,17,37
80,Fail,51,36,1,12,39
80,Fail,44,32,0,18,26
80,Fail,54,31,0,12,42
80,Fail,52,33,5,10,42
80,Fail,50,31,4,15,35
80,Fail,59,31,0,9,50
80,Fail,48,36,4,12,36
80,Fail,48,40,0,12,36
80,Fail,43,38,0,12,31
80,Fail,37,36,0,13,24
80,Fail,46,36,0,12,34
80,Fail,39,41,4,16,23
80,Fail,53,35,0,11,42
80,Fail,52,27,7,14,38
80,Fail,46,38,0,14,32
80,Fail,39,38,0,14,25
80,Fail,52,34,0,14,38
80,Fail,47,38,3,12,35
80,Fail,51,30,0,12,39
80,Fail,46,33,0,14,32
80,Fail,46,40,0,12,34
80,Fail,50,33,2,15,35
80,Fail,48,26,0,16,32
80,Fail,51,34,0,12,39
80,Fail,47,34,0,11,36
80,Fail,40,38,0,13,27
80,Fail,45,38,2,15,30
80,Fail,47,30,0,12,35
80,Fail,55,37,0,8,47
80,Fail,48,34,7,11,37
80,Fail,47,35,1,17,30
80,Fail,54,37,0,9,45
80,Fail,46,34,0,13,33
80,Fail,54,39,1,6,48
80,Fail,46,42,0,7,39
80,Fail,51,34,0,15,36
80,Fail,49,36,5,10,39
80,Fail,50,36,0,11,39
80,Fail,43,34,6,17,26
80,Fail,43,38,4,15,28
80,Fail,43,39,1,17,26
80,Fail,51,34,6,9,42
80,Fail,45,32,0,15,30
80,Fail,49,32,6,13,36
80,Fail,41,41,0,11,30
80,Fail,45,44,0,11,34
80,Fail,44,35,10,11,33
80,Fail,51,38,7,4,47
80,Fail,47,42,0,9,38
80,Fail,45,39,4,12,33
80,Fail,52,29,0,15,37
80,Fail,50,37,0,10,40
80,Fail,52,32,0,12,40
80,Fail,36,39,0,15,21
80,Fail,47,33,7,13,34
80,Fail,55,28,4,13,42
80,Fail,45,34,0,11,34
80,Fail,44,38,0,16,28
80,Fail,54,28,0,16,38
80,Fail,46,31,0,18,28
80,Fail,55,31,5,9,46
80,Fail,51,37,1,11,40
80,Fail,48,32,0,12,36
80,Fail,42,41,2,15,27
80,Fail,44,36,6,14,30
80,Fail,42,39,0,14,28
80,Fail,47,34,0,16,31
80,Fail,52,32,3,13,39
80,Fail,54,29,0,17,37
80,Fail,58,26,0,13,45
80,Fail,48,36,0,16,32
80,Fail,48,34,0,10,38
80,Fail,46,41,0,5,41
80,Fail,41,42,5,12,29
80,Fail,41,43,0,12,29
80,Fail,41,32,0,17,24
80,Fail,44,40,0,14,30
80,Fail,44,42,0,13,31
80,Fail,42,45,1,12,30
80,Fail,46,37,0,13,33
80,Fail,46,33,6,15,31
80,Fail,42,40,3,15,27
80,Fail,47,27,6,20,27
80,Fail,52,34,0,11,41
80,Fail,47,39,0,13,34
80,Fail,52,26,0,19,33
80,Fail,50,40,0,7,43
80,Fail,48,35,7,10,38
80,Fail,50,35,4,11,39
80,Fail,48,41,0,9,39
80,Fail,47,39,5,9,38
80,Fail,42,41,8,9,33
80,Fail,41,36,0,15,26
80,Fail,55,35,0,10,45
80,Fail,43,37,0,17,26
80,Fail,44,42,3,11,33
80,Fail,45,37,6,12,33
80,Fail,47,30,0,17,30
80,Fail,43,41,0,16,27
80,Fail,58,32,1,9,49
80,Fail,53,33,0,10,43
80,Fail,44,38,0,17,27
80,Fail,57,22,11,10,47
80,Fail,45,32,0,19,26
80,Fail,47,40,1,12,35
80,Fail,55,35,0,10,45
80,Fail,46,34,6,14,32
80,Fail,46,39,0,12,34
80,Fail,51,38,0,11,40
80,Fail,37,38,16,9,28
80,Fail,48,38,0,10,38
80,Fail,49,33,0,15,34
80,Fail,50,33,5,12,38
80,Fail,46,37,3,14,32
80,Fail,49,30,0,16,33
80,Fail,45,44,0,11,34
80,Fail,45,35,3,17,28
80,Fail,47,41,2,10,37
80,Fail,53,32,0,14,39
80,Fail,58,32,0,9,49
80,Fail,43,36,3,18,25
80,Fail,47,31,7,15,32
80,Fail,45,38,1,16,29
80,Fail,45,34,0,13,32
80,Fail,53,26,4,17,36
80,Fail,48,27,10,15,33
80,Fail,56,28,0,8,48
80,Fail,54,40,1,5,49
80,Fail,48,40,1,11,37
80,Fail,52,33,3,12,40
80,Fail,41,34,0,14,27
80,Fail,51,35,0,13,38
80,Fail,41,30,5,24,17
80,Fail,50,37,1,12,38
80,Fail,41,36,4,19,22
80,Fail,50,38,1,11,39
80,Fail,56,35,0,9,47
80,Fail,50,34,0,13,37
80,Fail,44,37,0,16,28
80,Fail,58,31,0,11,47
80,Fail,47,33,7,13,34
80,Fail,50,35,4,11,39
80,Fail,50,37,0,12,38
80,Fail,50,41,0,5,45
80,Fail,52,31,0,10,42
80,Fail,53,27,6,14,39
80,Fail,45,39,0,10,35
80,Fail,44,43,2,11,33
80,Fail,40,39,0,11,29
80,Fail,43,42,5,10,33
80,Fail,49,41,0,8,41
80,Fail,45,42,0,12,33
80,Fail,42,44,0,11,31
80,Fail,40,38,0,18,22
80,Fail,45,30,0,16,29
80,Fail,51,35,0,14,37
80,Fail,50,33,0,12,38
80,Fail,46,37,1,16,30
80,Fail,48,37,0,7,41
80,Fail,47,37,4,12,35
80,Fail,45,35,0,18,27
80,Fail,42,40,0,15,27
80,Fail,39,39,0,17,22
80,Fail,39,39,6,16,23
80,Fail,50,35,2,13,37
80,Fail,50,33,0,14,36
80,Fail,47,39,2,12,35
80,Fail,51,34,0,11,40
80,Fail,43,36,5,16,27
80,Fail,43,38,3,16,27
80,Fail,41,41,6,12,29
80,Fail,56,33,4,7,49
80,Fail,49,35,1,15,34
80,Fail,40,41,6,13,27
80,Fail,49,35,1,15,34
80,Fail,47,30,0,18,29
80,Fail,46,35,3,16,30
80,Fail,47,33,0,14,33
80,Fail,52,31,0,16,36
80,Fail,55,33,0,12,43
80,Fail,50,33,0,9,41
80,Fail,46,38,4,12,34
80,Fail,50,33,0,13,37
80,Fail,45,39,0,14,31
80,Fail,40,37,0,22,18
80,Fail,48,34,7,11,37
80,Fail,43,41,7,9,34
80,Fail,55,30,4,11,44
80,Fail,48,35,0,13,35
80,Fail,48,37,0,13,35
80,Fail,51,35,0,10,41
80,Fail,54,35,4,7,47
80,Fail,50,38,0,11,39
80,Fail,34,47,6,13,21
80,Fail,49,38,0,13,36
80,Fail,52,31,0,13,39
80,Fail,43,34,0,16,27
80,Fail,48,45,0,7,41
80,Fail,42,33,8,17,25
80,Fail,49,36,4,11,38
80,Fail,57,33,0,10,47
80,Fail,57,34,1,8,49
80,Fail,52,31,3,14,38
80,Fail,40,40,4,16,24
80,Fail,43,40,0,15,28
80,Fail,53,31,1,15,38
80,Fail,43,34,0,13,30
80,Fail,57,29,6,8,49
80,Fail,54,34,0,12,42
80,Fail,45,34,3,18,27
80,Fail,40,32,12,16,24
80,Fail,47,36,5,12,35
80,Fail,54,29,1,16,38
80,Fail,45,31,1,23,22
80,Fail,58,30,4,8,50
80,Fail,50,33,5,12,38
80,Fail,51,35,1,13,38
80,Fail,44,35,7,14,30
80,Fail,47,42,0,9,38
80,Fail,49,36,0,15,34
80,Fail,48,37,2,13,35
80,Fail,49,35,5,11,38
80,Fail,51,35,0,6,45
80,Fail,45,31,0,16,29
80,Fail,60,26,1,13,47
80,Fail,55,36,1,8,47
80,Fail,51,34,0,10,41
80,Fail,50,35,4,11,39
80,Fail,53,35,0,9,44
80,Fail,49,34,7,10,39
80,Fail,44,34,0,15,29
80,Fail,48,37,2,13,35
80,Fail,49,39,0,10,39
80,Fail,48,35,2,15,33
80,Fail,50,35,0,13,37
80,Fail,46,35,0,11,35
80,Fail,50,37,0,13,37
80,Fail,49,36,1,14,35
80,Fail,48,35,0,17,31
80,Fail,48,33,5,14,34
80,Fail,50,38,0,10,40
80,Fail,47,28,13,12,35
80,Fail,52,37,0,10,42
80,Fail,42,35,1,22,20
80,Fail,45,37,0,15,30
80,Fail,47,36,2,15,32
80,Fail,51,39,1,9,42
80,Fail,53,34,0,11,42
80,Fail,48,35,2,15,33
80,Fail,52,34,0,13,39
80,Fail,51,38,0,8,43
80,Fail,36,43,0,11,25
80,Fail,45,32,0,16,29
80,Fail,48,33,0,15,33
80,Fail,50,22,0,16,34
80,Fail,49,36,6,9,40
80,Fail,43,43,1,13,30
80,Fail,62,30,0,6,56
80,Fail,46,35,8,11,35
80,Fail,44,36,6,14,30
80,Fail,50,29,5,16,34
80,Fail,47,36,0,15,32
80,Fail,57,30,2,11,46
80,Fail,39,43,0,15,24
80,Fail,46,43,3,8,38
80,Fail,45,42,3,10,35
80,Fail,54,29,0,13,41
80,Fail,41,42,2,15,26
80,Fail,47,42,0,11,36
80,Fail,49,36,0,12,37
80,Fail,47,40,0,11,36
80,Fail,40,40,0,16,24
80,Fail,50,32,7,11,39
80,Fail,53,34,0,10,43
80,Fail,53,35,0,12,41
80,Fail,47,30,5,18,29
80,Fail,51,36,0,13,38
80,Fail,46,37,2,15,31
80,Fail,53,29,5,13,40
80,Fail,52,32,1,15,37
80,Fail,41,41,6,12,29
80,Fail,49,34,3,14,35
80,Fail,50,36,0,12,38
80,Fail,46,34,0,17,29
80,Fail,47,33,0,15,32
80,Fail,54,27,0,12,42
80,Fail,43,36,0,17,26
80,Fail,54,32,0,9,45
80,Fail,53,27,5,15,38
80,Fail,50,30,0,18,32
80,Fail,45,34,5,16,29
80,Fail,47,33,6,14,33
80,Fail,46,35,2,17,29
80,Fail,48,35,0,13,35
80,Fail,45,35,4,16,29
80,Fail,47,39,0,13,34
80,Fail,45,39,0,15,30
80,Fail,54,30,0,10,44
80,Fail,46,36,0,12,34
80,Fail,51,34,0,13,38
80,Fail,48,34,0,12,36
80,Fail,45,39,1,15,30
80,Fail,40,44,5,11,29
80,Fail,44,48,0,7,37
80,Fail,46,34,7,13,33
80,Fail,39,38,0,15,24
80,Fail,58,31,2,9,49
80,Fail,46,38,2,14,32
80,Fail,49,40,1,10,39
80,Fail,54,38,0,8,46
80,Fail,47,40,0,13,34
80,Fail,50,31,0,10,40
80,Fail,51,36,0,12,39
80,Fail,53,36,0,10,43
80,Fail,47,45,0,8,39
80,Fail,48,32,10,10,38
80,Fail,39,36,0,14,25
80,Fail,52,37,2,9,43
80,Fail,46,36,0,16,30
80,Fail,53,35,0,10,43
80,Fail,46,43,0,11,35
80,Fail,48,30,7,15,33
80,Fail,49,36,0,14,35
80,Fail,51,40,1,8,43
80,Fail,45,39,5,11,34
80,Fail,50,36,4,10,40
80,Fail,48,38,0,13,35
80,Fail,49,40,4,7,42
80,Fail,52,38,0,8,44
80,Fail,40,44,0,14,26
80,Fail,54,33,5,8,46
80,Fail,45,35,3,17,28
80,Fail,54,31,2,13,41
80,Fail,52,32,0,15,37
80,Fail,44,36,0,13,31
80,Fail,51,30,0,12,39
80,Fail,45,37,0,12,33
80,Fail,50,36,4,10,40
80,Fail,48,37,0,13,35
80,Fail,54,35,0,11,43
80,Fail,47,42,2,9,38
80,Fail,49,34,2,15,34
80,Fail,63,23,3,11,52
80,Fail,46,40,0,13,33
80,Fail,51,29,4,16,35
80,Fail,43,38,0,18,25
80,Fail,44,43,1,12,32
80,Fail,53,35,0,9,44
80,Fail,55,35,0,8,47
80,Fail,52,34,0,13,39
80,Fail,50,29,0,17,33
80,Fail,48,36,0,12,36
80,Fail,50,38,3,9,41
80,Fail,54,32,4,10,44
80,Fail,42,41,3,14,28
80,Fail,51,36,0,13,38
80,Fail,54,38,0,6,48
80,Fail,50,33,4,13,37
80,Fail,44,31,11,14,30
80,Fail,43,38,5,14,29
80,Fail,45,32,5,18,27
80,Fail,53,31,0,12,41
80,Fail,44,38,6,12,32
80,Fail,45,31,0,16,29
80,Fail,46,41,3,10,36
80,Fail,46,39,0,11,35
80,Fail,48,38,0,10,38
80,Fail,43,41,2,14,29
80,Fail,45,35,0,11,34
80,Fail,47,45,1,7,40
80,Fail,54,32,0,11,43
80,Fail,46,40,2,12,34
80,Fail,40,36,9,15,25
80,Fail,48,33,0,19,29
80,Fail,43,40,0,13,30
80,Fail,40,44,0,13,27
80,Fail,49,35,1,15,34
80,Fail,55,34,2,9,46
80,Fail,43,43,0,12,31
80,Fail,50,35,3,12,38
80,Fail,50,35,0,12,38
80,Fail,55,36,0,9,46
80,Fail,54,31,2,13,41
80,Fail,47,38,0,10,37
80,Fail,44,43,0,10,34
80,Fail,45,39,2,14,31
80,Fail,52,37,0,11,41
80,Fail,44,37,5,14,30
80,Fail,51,30,0,13,38
80,Fail,48,37,1,14,34
80,Fail,49,40,3,8,41
80,Fail,45,35,0,13,32
80,Fail,46,36,1,17,29
80,Fail,48,35,0,13,35
80,Fail,53,37,0,10,43
80,Fail,53,39,2,6,47
80,Fail,48,30,0,15,33
80,Fail,52,31,0,14,38
80,Fail,47,38,0,12,35
80,Fail,54,37,1,8,46
80,Fail,47,39,0,9,38
80,Fail,44,40,5,11,33
80,Fail,44,34,10,12,32
80,Fail,54,27,6,13,41
80,Fail,48,37,0,14,34
80,Fail,46,33,1,20,26
80,Fail,41,35,0,14,27
80,Fail,48,31,0,14,34
80,Fail,50,38,0,12,38
80,Fail,49,36,2,13,36
80,Fail,55,32,0,10,45
80,Fail,46,28,5,21,25
80,Fail,52,32,8,8,44
80,Fail,50,35,0,9,41
80,Fail,55,30,7,8,47
80,Fail,52,39,0,9,43
80,Fail,48,42,2,8,40
80,Fail,52,36,0,11,41
80,Fail,54,29,0,9,45
80,Fail,51,40,0,9,42
80,Fail,51,35,0,8,43
80,Fail,48,41,0,10,38
80,Fail,54,32,3,11,43
80,Fail,51,33,6,10,41
80,Fail,48,32,0,13,35
80,Fail,47,38,1,14,33
80,Fail,55,32,1,12,43
80,Fail,52,29,0,14,38
80,Fail,44,39,0,14,30
80,Fail,51,34,0,10,41
80,Fail,51,31,4,14,37
80,Fail,47,39,4,10,37
80,Fail,48,35,3,14,34
80,Fail,53,36,0,7,46
80,Fail,59,33,2,6,53
80,Fail,54,28,10,8,46
80,Fail,50,33,6,11,39
80,Fail,45,34,0,14,31
80,Fail,52,35,2,11,41
80,Fail,48,37,0,13,35
80,Fail,37,48,7,8,29
80,Fail,52,37,0,11,41
80,Fail,45,42,0,10,35
80,Fail,54,29,2,15,39
80,Fail,48,38,4,10,38
80,Fail,48,36,0,15,33
80,Fail,46,30,9,15,31
80,Fail,50,30,3,17,33
80,Fail,42,36,9,13,29
80,Fail,45,38,0,13,32
80,Fail,44,39,0,11,33
80,Fail,40,46,3,11,29
80,Fail,52,33,0,12,40
80,Fail,40,37,12,11,29
80,Fail,51,30,0,14,37
80,Fail,50,34,2,14,36
80,Fail,47,32,7,14,33
80,Fail,56,30,2,12,44
80,Fail,40,31,10,19,21
80,Fail,48,37,1,14,34
80,Fail,54,34,0,11,43
80,Fail,49,34,1,16,33
80,Fail,53,34,0,12,41
80,Fail,43,38,3,16,27
80,Fail,49,37,0,9,40
80,Fail,60,29,0,6,54
80,Fail,42,34,11,13,29
80,Fail,45,36,5,14,31
80,Fail,49,42,0,8,41
80,Fail,51,38,2,9,42
80,Fail,49,36,1,14,35
80,Fail,46,35,0,13,33
80,Fail,47,34,12,7,40
80,Fail,54,28,5,13,41
80,Fail,48,35,0,14,34
80,Fail,47,32,7,14,33
80,Fail,52,38,0,7,45
80,Fail,48,40,0,12,36
80,Fail,46,43,0,10,36
80,Fail,50,37,4,9,41
80,Fail,42,41,0,15,27
80,Fail,44,31,0,13,31
80,Fail,48,29,9,14,34
80,Fail,46,36,0,11,35
80,Fail,49,38,0,10,39
80,Fail,47,38,0,10,37
80,Fail,46,39,7,8,38
80,Fail,53,36,0,11,42
80,Fail,47,38,0,13,34
80,Fail,52,31,3,14,38
80,Fail,50,32,4,14,36
80,Fail,56,38,0,6,50
80,Fail,42,45,3,10,32
80,Fail,49,33,4,14,35
80,Fail,46,33,0,16,30
80,Fail,46,39,0,15,31
80,Fail,48,35,0,10,38
80,Fail,41,44,0,15,26
80,Fail,41,41,0,11,30
80,Fail,44,38,0,14,30
80,Fail,48,36,0,14,34
80,Fail,42,37,0,13,29
80,Fail,42,44,0,12,30
80,Fail,41,41,0,14,27
80,Fail,45,36,3,16,29
80,Fail,53,38,0,8,45
80,Fail,55,30,0,12,43
80,Fail,49,36,0,13,36
80,Fail,45,41,2,12,33
80,Fail,44,40,0,11,33
80,Fail,38,41,2,19,19
80,Fail,45,38,0,14,31
80,Fail,52,32,6,10,42
80,Fail,48,34,1,17,31
80,Fail,47,37,0,10,37
80,Fail,52,33,0,11,41
80,Fail,50,34,0,10,40
80,Fail,45,32,0,14,31
80,Fail,55,32,3,10,45
80,Fail,67,26,0,5,62
80,Fail,47,41,3,9,38
80,Fail,40,36,0,16,24
80,Fail,49,35,0,15,34
80,Fail,53,39,0,6,47
80,Fail,56,29,0,14,42
80,Fail,46,38,1,15,31
80,Fail,51,32,1,16,35
80,Fail,41,43,0,14,27
80,Fail,51,34,0,12,39
80,Fail,51,34,4,11,40
80,Fail,46,37,5,12,34
80,Fail,40,36,11,13,27
80,Fail,47,38,0,12,35
80,Fail,45,36,0,14,31
80,Fail,47,39,7,7,40
80,Fail,49,37,0,11,38
80,Fail,45,39,7,9,36
80,Fail,51,25,11,13,38
80,Fail,56,31,3,10,46
80,Fail,47,33,0,12,35
80,Fail,46,38,6,10,36
80,Fail,55,31,0,12,43
80,Fail,51,30,5,14,37
80,Fail,49,33,0,15,34
80,Fail,35,43,0,14,21
80,Fail,48,27,0,19,29
80,Fail,47,27,7,19,28
80,Fail,46,34,0,12,34
80,Fail,49,32,0,13,36
80,Fail,54,25,0,12,42
80,Fail,53,36,0,7,46
80,Fail,52,33,5,10,42
80,Fail,56,37,0,7,49
80,Fail,52,36,0,12,40
80,Fail,56,38,1,5,51
80,Fail,45,33,0,13,32
80,Fail,59,34,1,6,53
80,Fail,47,37,5,11,36
80,Fail,45,42,0,11,34
80,Fail,52,35,0,8,44
80,Fail,50,33,0,14,36
80,Fail,47,34,2,17,30
80,Fail,48,39,0,13,35
80,Fail,42,41,0,13,29
80,Fail,52,35,0,8,44
80,Fail,52,35,0,13,39
80,Fail,48,37,0,13,35
80,Fail,47,32,1,20,27
80,Fail,44,40,0,12,32
80,Fail,49,38,0,12,37
80,Fail,43,33,4,20,23
80,Fail,49,35,1,15,34
80,Fail,45,33,0,17,28
80,Fail,49,30,0,12,37
80,Fail,48,36,0,13,35
80,Fail,48,35,0,13,35
80,Fail,49,30,8,13,36
80,Fail,54,37,0,9,45
80,Fail,41,36,0,13,28
80,Fail,56,28,0,16,40
80,Fail,53,29,0,15,38
80,Fail,49,33,0,13,36
80,Fail,48,41,0,6,42
80,Fail,49,34,0,16,33
80,Fail,48,35,5,12,36
80,Fail,50,36,2,12,38
80,Fail,49,36,0,11,38
80,Fail,47,36,0,17,30
80,Fail,56,31,1,12,44
80,Fail,43,37,6,14,29
80,Fail,52,38,2,8,44
80,Fail,52,32,2,14,38
80,Fail,47,34,0,15,32
80,Fail,46,41,1,12,34
80,Fail,49,34,0,12,37
80,Fail,48,38,7,7,41
80,Fail,47,39,0,13,34
80,Fail,43,39,1,17,26
80,Fail,50,38,2,10,40
80,Fail,45,43,0,11,34
80,Fail,52,37,0,9,43
80,Fail,47,41,0,11,36
80,Fail,55,34,0,10,45
80,Fail,46,33,0,12,34
80,Fail,45,39,3,13,32
80,Fail,52,39,0,7,45
80,Fail,53,32,1,14,39
80,Fail,52,37,1,10,42
80,Fail,44,41,3,12,32
80,Fail,35,42,0,12,23
80,Fail,53,37,0,8,45
80,Fail,48,30,10,12,36
80,Fail,48,32,6,14,34
80,Fail,50,38,0,11,39
80,Fail,50,32,6,12,38
80,Fail,52,39,0,6,46
80,Fail,48,42,0,9,39
80,Fail,40,38,0,15,25
80,Fail,52,34,0,10,42
80,Fail,49,33,0,16,33
80,Fail,45,42,0,12,33
80,Fail,46,41,0,12,34
80,Fail,53,34,0,13,40
80,Fail,48,35,10,7,41
80,Fail,52,32,0,14,38
80,Fail,55,35,0,9,46
80,Fail,54,32,0,13,41
80,Fail,54,32,0,13,41
80,Fail,48,43,0,9,39
80,Fail,47,36,0,13,34
80,Fail,52,37,0,10,42
80,Fail,43,38,0,17,26
80,Fail,43,38,10,9,34
80,Fail,48,25,10,17,31
80,Fail,52,39,0,7,45
80,Fail,48,36,0,16,32
80,Fail,52,33,4,11,41
80,Fail,55,39,0,5,50
80,Fail,50,39,0,10,40
80,Fail,51,28,0,11,40
80,Fail,49,33,0,15,34
80,Fail,47,33,9,11,36
80,Fail,46,34,0,13,33
80,Fail,38,41,7,14,24
80,Fail,46,36,0,15,31
80,Fail,45,43,1,11,34
80,Fail,49,39,0,8,41
80,Fail,49,34,5,12,37
80,Fail,45,40,1,14,31
80,Fail,48,38,3,11,37
80,Fail,47,39,0,14,33
80,Fail,46,32,0,16,30
80,Fail,52,34,0,12,40
80,Fail,53,31,2,14,39
80,Fail,49,34,0,13,36
80,Fail,51,37,1,11,40
80,Fail,47,36,4,13,34
80,Fail,54,35,0,11,43
80,Fail,47,30,8,15,32
80,Fail,34,32,10,24,10
80,Fail,50,32,0,16,34
80,Fail,46,30,7,17,29
80,Fail,51,31,0,14,37
80,Fail,49,31,0,14,35
80,Fail,50,39,2,9,41
80,Fail,51,36,0,12,39
80,Fail,49,32,5,14,35
80,Fail,50,41,0,3,47
80,Fail,52,36,2,10,42
80,Fail,53,30,4,13,40
80,Fail,43,30,14,13,30
80,Fail,52,36,4,8,44
80,Fail,41,44,4,11,30
80,Fail,46,33,7,14,32
80,Fail,50,38,2,10,40
80,Fail,54,33,0,7,47
80,Fail,41,41,0,17,24
80,Fail,44,35,0,14,30
80,Fail,46,33,0,21,25
80,Fail,50,34,0,13,37
80,Fail,39,41,1,19,20
80,Fail,45,34,0,15,30
80,Fail,47,33,0,12,35
80,Fail,47,36,2,15,32
80,Fail,51,28,0,16,35
80,Fail,52,32,1,15,37
80,Fail,50,29,3,18,32
80,Fail,48,39,1,12,36
80,Fail,45,31,0,16,29
80,Fail,47,38,7,8,39
80,Fail,44,36,4,16,28
80,Fail,51,35,0,14,37
80,Fail,45,40,0,11,34
80,Fail,49,37,0,7,42
80,Fail,47,38,3,12,35
80,Fail,47,34,4,15,32
80,Fail,45,35,5,15,30
80,Fail,44,36,0,11,33
80,Fail,53,34,4,9,44
80,Fail,45,40,0,10,35
80,Fail,49,28,0,17,32
80,Fail,44,40,0,9,35
80,Fail,46,37,0,16,30
80,Fail,44,33,9,14,30
80,Fail,49,39,1,11,38
80,Fail,46,35,1,18,28
80,Fail,43,37,1,19,24
80,Fail,43,41,3,13,30
80,Fail,60,28,0,11,49
80,Fail,52,40,0,8,44
80,Fail,44,36,0,14,30
80,Fail,47,39,0,12,35
80,Fail,57,31,0,11,46
80,Fail,41,37,13,9,32
80,Fail,45,36,0,13,32
80,Fail,51,33,0,12,39
80,Fail,47,40,3,10,37
80,Fail,52,33,0,15,37
80,Fail,53,35,6,6,47
80,Fail,48,40,1,11,37
80,Fail,50,32,0,14,36
80,Fail,51,30,3,16,35
80,Fail,49,31,0,12,37
80,Fail,48,34,0,15,33
80,Fail,47,41,0,10,37
80,Fail,51,30,9,10,41
80,Fail,48,37,3,12,36
80,Fail,51,31,6,12,39
80,Fail,46,37,1,16,30
80,Fail,53,31,0,8,45
80,Fail,51,32,0,14,37
80,Fail,43,36,0,12,31
80,Fail,46,38,0,14,32
80,Fail,42,35,0,14,28
80,Fail,45,40,5,10,35
80,Fail,47,38,3,12,35
80,Fail,52,35,3,10,42
80,Fail,50,33,0,15,35
80,Fail,51,26,0,18,33
80,Fail,47,38,0,8,39
80,Fail,54,31,0,10,44
80,Fail,45,33,0,15,30
80,Fail,57,28,0,14,43
80,Fail,47,35,0,9,38
80,Fail,41,41,4,14,27
80,Fail,54,29,0,10,44
80,Fail,57,33,2,8,49
80,Fail,45,34,0,17,28
80,Fail,48,39,4,9,39
80,Fail,52,34,0,13,39
80,Fail,44,38,3,15,29
80,Fail,39,46,0,12,27
80,Fail,47,40,0,13,34
80,Fail,46,31,10,13,33
80,Fail,45,34,0,18,27
80,Fail,47,38,0,15,32
80,Fail,49,43,1,7,42
80,Fail,49,36,5,10,39
80,Fail,50,32,5,13,37
80,Fail,43,47,2,8,35
80,Fail,49,31,0,19,30
80,Fail,48,42,0,9,39
80,Fail,51,35,0,9,42
80,Fail,50,35,0,13,37
80,Fail,42,46,0,6,36
80,Fail,44,38,3,15,29
80,Fail,51,35,0,13,38
80,Fail,46,38,3,13,33
80,Fail,51,27,0,17,34
80,Fail,42,33,12,13,29
80,Fail,55,31,0,12,43
80,Fail,49,44,0,5,44
80,Fail,46,40,1,13,33
80,Fail,50,42,0,8,42
80,Fail,49,32,5,14,35
80,Fail,44,39,2,15,29
80,Fail,44,38,1,17,27
80,Fail,42,42,5,11,31
80,Fail,54,33,0,11,43
80,Fail,52,33,0,8,44
80,Fail,43,37,2,18,25
80,Fail,53,38,0,7,46
80,Fail,49,38,0,13,36
80,Fail,57,34,0,8,49
80,Fail,46,29,0,15,31
80,Fail,49,34,0,12,37
80,Fail,52,36,0,9,43
80,Fail,48,34,0,14,34
80,Fail,50,34,4,12,38
80,Fail,48,29,0,13,35
80,Fail,48,35,0,16,32
80,Fail,47,37,6,10,37
80,Fail,56,27,3,14,42
80,Fail,48,37,2,13,35
80,Fail,48,35,0,8,40
80,Fail,55,31,0,8,47
80,Fail,47,35,0,9,38
80,Fail,40,34,0,19,21
80,Fail,42,38,5,15,27
80,Fail,46,40,1,13,33
80,Fail,47,36,5,12,35
80,Fail,43,41,2,14,29
80,Fail,46,37,0,14,32
80,Fail,44,35,0,19,25
80,Fail,47,36,5,12,35
80,Fail,49,33,5,13,36
80,Fail,50,37,2,11,39
80,Fail,53,27,6,14,39
80,Fail,54,32,3,11,43
80,Fail,45,35,7,13,32
80,Fail,40,35,6,19,21
80,Fail,47,35,0,10,37
80,Fail,43,35,0,17,26
80,Fail,47,37,2,14,33
80,Fail,47,41,4,8,39
80,Fail,44,35,8,13,31
80,Fail,53,32,0,14,39
80,Fail,49,34,0,13,36
80,Fail,52,34,0,13,39
80,Fail,59,33,1,7,52
80,Fail,44,27,13,16,28
80,Fail,37,35,10,18,19
80,Fail,61,27,0,11,50
80,Fail,43,36,0,14,29
80,Fail,50,38,1,11,39
80,Fail,39,37,0,11,28
80,Fail,46,32,0,16,30
80,Fail,51,41,1,7,44
80,Fail,49,36,0,13,36
80,Fail,51,32,5,12,39
80,Fail,46,37,3,14,32
80,Fail,51,32,0,12,39
80,Fail,53,33,0,14,39
80,Fail,49,38,0,11,38
80,Fail,50,32,4,14,36
80,Fail,49,35,0,16,33
80,Fail,56,31,0,12,44
80,Fail,50,35,4,11,39
80,Fail,46,28,14,12,34
80,Fail,52,31,0,17,35
80,Fail,47,30,0,16,31
80,Fail,43,38,0,14,29
80,Fail,49,34,3,14,35
80,Fail,52,36,0,7,45
80,Fail,44,39,4,13,31
80,Fail,42,34,13,11,31
80,Fail,48,38,0,12,36
80,Fail,48,39,0,11,37
80,Fail,55,35,0,9,46
80,Fail,50,39,0,9,41
80,Fail,45,47,3,5,40
80,Fail,48,39,2,11,37
80,Fail,46,37,0,14,32
80,Fail,49,37,0,12,37
80,Fail,44,36,6,14,30
80,Fail,46,38,3,13,33
80,Fail,50,39,0,6,44
80,Fail,44,32,0,19,25
80,Fail,57,26,0,16,41
80,Fail,42,36,0,15,27
80,Fail,44,31,9,16,28
80,Fail,53,32,0,12,41
80,Fail,53,40,0,3,50
80,Fail,48,34,5,13,35
80,Fail,46,40,0,13,33
80,Fail,50,35,0,10,40
80,Fail,49,27,7,17,32
80,Fail,48,37,8,7,41
80,Fail,47,38,6,9,38
80,Fail,52,37,3,8,44
80,Fail,53,31,0,8,45
80,Fail,38,43,7,12,26
80,Fail,43,35,3,19,24
80,Fail,49,35,0,8,41
80,Fail,45,40,6,9,36
80,Fail,47,33,3,17,30
80,Fail,51,37,0,10,41
80,Fail,41,43,2,14,27
80,Fail,51,31,1,17,34
80,Fail,51,31,0,14,37
80,Fail,53,29,5,13,40
80,Fail,46,37,0,13,33
80,Fail,47,34,7,12,35
80,Fail,41,35,1,23,18
80,Fail,42,42,0,12,30
80,Fail,51,40,1,8,43
80,Fail,50,33,0,15,35
80,Fail,51,33,0,14,37
80,Fail,46,39,0,12,34
80,Fail,40,34,12,14,26
80,Fail,55,31,5,9,46
80,Fail,59,31,0,7,52
80,Fail,50,32,0,12,38
80,Fail,46,33,0,16,30
80,Fail,49,39,3,9,40
80,Fail,48,36,0,15,33
80,Fail,53,35,0,8,45
80,Fail,48,40,0,9,39
80,Fail,52,38,0,5,47
80,Fail,44,37,7,12,32
80,Fail,47,36,3,14,33
80,Fail,62,32,0,6,56
80,Fail,48,44,0,7,41
80,Fail,55,31,0,10,45
80,Fail,41,45,1,13,28
80,Fail,46,41,0,8,38
80,Fail,46,40,0,10,36
80,Fail,43,37,3,17,26
80,Fail,46,39,3,12,34
80,Fail,51,29,9,11,40
80,Fail,46,34,10,10,36
80,Fail,47,35,5,13,34
80,Fail,49,39,0,10,39
80,Fail,54,36,0,8,46
80,Fail,48,40,1,11,37
80,Fail,47,41,1,11,36
80,Fail,53,33,0,11,42
80,Fail,48,29,7,16,32
80,Fail,44,40,2,14,30
80,Fail,47,30,0,13,34
80,Fail,54,35,1,10,44
80,Fail,44,43,3,10,34
80,Fail,46,37,0,11,35
80,Fail,47,32,6,15,32
80,Fail,52,36,0,12,40
80,Fail,39,38,0,15,24
80,Fail,35,40,0,19,16
80,Fail,46,41,3,10,36
80,Fail,52,31,0,11,41
80,Fail,48,31,0,13,35
80,Fail,40,33,0,16,24
80,Fail,54,29,6,11,43
80,Fail,48,30,0,19,29
80,Fail,51,34,5,10,41
80,Fail,47,34,0,15,32
80,Fail,52,29,0,16,36
80,Fail,45,42,0,12,33
80,Fail,49,36,3,12,37
80,Fail,43,40,4,13,30
80,Fail,50,32,3,15,35
80,Fail,53,31,1,15,38
80,Fail,46,42,2,10,36
80,Fail,40,42,1,17,23
80,Fail,48,38,3,11,37
80,Fail,47,39,0,13,34
80,Fail,46,31,6,17,29
80,Fail,50,30,6,14,36
80,Fail,58,30,0,10,48
80,Fail,52,34,0,8,44
80,Fail,44,32,12,12,32
80,Fail,56,27,8,9,47
80,Fail,46,36,0,14,32
80,Fail,48,36,0,16,32
80,Fail,50,37,3,10,40
80,Fail,45,34,7,14,31
80,Fail,50,37,0,13,37
80,Fail,55,29,3,13,42
80,Fail,47,37,0,14,33
80,Fail,47,32,0,16,31
80,Fail,40,37,10,13,27
80,Fail,48,30,3,19,29
80,Fail,57,33,0,8,49
80,Fail,55,28,0,10,45
80,Fail,39,45,1,15,24
80,Fail,52,36,4,8,44
80,Fail,53,37,0,8,45
80,Fail,45,33,4,18,27
80,Fail,41,43,4,12,29
80,Fail,47,31,0,13,34
80,Fail,52,37,3,8,44
80,Fail,57,31,3,9,48
80,Fail,47,33,4,16,31
80,Fail,51,35,6,8,43
80,Fail,50,35,2,13,37
80,Fail,41,37,0,21,20
80,Fail,47,32,0,9,38
80,Fail,43,39,3,15,28
80,Fail,46,39,0,10,36
80,Fail,47,35,6,12,35
80,Fail,54,34,2,10,44
80,Fail,49,37,0,11,38
80,Fail,51,30,0,14,37
80,Fail,48,38,0,8,40
80,Fail,37,43,0,16,21
80,Fail,49,38,0,11,38
80,Fail,48,32,0,8,40
80,Fail,51,37,0,9,42
80,Fail,48,34,0,11,37
80,Fail,45,35,5,15,30
80,Fail,48,32,0,12,36
80,Fail,50,31,7,12,38
80,Fail,52,38,0,9,43
80,Fail,52,36,4,8,44
80,Fail,53,35,2,10,43
80,Fail,51,36,1,12,39
80,Fail,44,36,4,16,28
80,Fail,42,42,1,15,27
80,Fail,49,36,0,12,37
80,Fail,45,37,0,13,32
80,Fail,44,32,0,18,26
80,Fail,49,37,1,13,36
80,Fail,51,35,0,7,44
80,Fail,56,30,1,13,43
80,Fail,41,37,0,16,25
80,Fail,53,39,1,7,46
80,Fail,42,41,6,11,31
80,Fail,43,32,0,13,30
80,Fail,47,42,0,7,40
80,Fail,53,32,4,11,42
80,Fail,45,34,0,17,28
80,Fail,43,39,6,12,31
80,Fail,41,37,6,16,25
80,Fail,50,36,0,9,41
80,Fail,45,41,0,11,34
80,Fail,44,41,0,15,29
80,Fail,47,36,2,15,32
80,Fail,47,40,4,9,38
80,Fail,48,38,0,11,37
80,Fail,36,38,8,18,18
80,Fail,54,33,0,9,45
80,Fail,42,39,0,14,28
80,Fail,49,35,0,15,34
80,Fail,48,37,0,15,33
80,Fail,52,38,0,6,46
80,Fail,51,33,4,12,39
80,Fail,44,41,0,10,34
80,Fail,43,33,9,15,28
80,Fail,52,29,6,13,39
80,Fail,52,31,0,13,39
80,Fail,50,33,2,15,35
80,Fail,47,32,3,18,29
80,Fail,40,40,4,16,24
80,Fail,52,29,4,15,37
80,Fail,45,44,3,8,37
80,Fail,48,36,0,14,34
80,Fail,49,34,1,16,33
80,Fail,45,38,4,13,32
80,Fail,49,41,0,10,39
80,Fail,50,32,0,12,38
80,Fail,54,31,0,11,43
80,Fail,46,39,0,13,33
80,Fail,56,33,3,8,48
80,Fail,52,33,4,11,41
80,Fail,47,40,0,13,34
80,Fail,47,43,0,8,39
80,Fail,51,35,0,14,37
80,Fail,43,43,1,13,30
80,Fail,49,32,4,15,34
80,Fail,48,39,0,8,40
80,Fail,53,36,0,9,44
80,Fail,46,38,0,7,39
80,Fail,52,37,0,11,41
80,Fail,41,44,0,9,32
80,Fail,48,33,3,16,32
80,Fail,49,40,2,9,40
80,Fail,44,47,1,8,36
80,Fail,52,32,1,15,37
80,Fail,44,39,0,13,31
80,Fail,46,39,0,9,37
80,Fail,50,32,2,16,34
80,Fail,48,36,0,13,35
80,Fail,53,34,0,13,40
80,Fail,49,38,3,10,39
80,Fail,43,38,3,16,27
80,Fail,49,40,2,9,40
80,Fail,53,27,12,8,45
80,Fail,52,34,0,9,43
80,Fail,47,39,0,14,33
80,Fail,48,27,7,18,30
80,Fail,51,32,3,14,37
80,Fail,49,29,0,19,30
80,Fail,48,40,0,12,36
80,Fail,50,36,5,9,41
80,Fail,43,38,0,15,28
80,Fail,50,40,0,10,40
80,Fail,44,41,1,14,30
80,Fail,49,29,0,8,41
80,Fail,56,27,0,16,40
80,Fail,47,39,2,12,35
80,Fail,46,46,0,6,40
80,Fail,39,37,11,13,26
80,Fail,43,33,0,14,29
80,Fail,52,36,0,7,45
80,Fail,46,34,0,12,34
80,Fail,52,34,4,10,42
80,Fail,53,35,0,11,42
80,Fail,51,28,0,16,35
80,Fail,52,38,0,8,44
80,Fail,49,37,0,9,40
80,Fail,40,43,7,10,30
80,Fail,56,38,2,4,52
80,Fail,42,31,13,14,28
80,Fail,48,31,0,13,35
80,Fail,52,37,1,10,42
80,Fail,45,33,7,15,30
80,Fail,55,32,3,10,45
80,Fail,50,32,0,17,33
80,Fail,51,39,3,7,44
80,Fail,47,44,0,8,39
80,Fail,48,43,0,8,40
80,Fail,47,35,5,13,34
80,Fail,52,30,0,18,34
80,Fail,49,32,1,18,31
80,Fail,49,39,0,10,39
80,Fail,44,37,0,17,27
80,Fail,52,38,0,9,43
80,Fail,51,35,0,13,38
80,Fail,41,40,5,14,27
80,Fail,52,34,0,11,41
80,Fail,50,31,4,15,35
80,Fail,50,33,3,14,36
80,Fail,39,44,7,10,29
80,Fail,51,27,5,17,34
80,Fail,54,32,3,11,43
80,Fail,47,31,7,15,32
80,Fail,47,33,0,11,36
80,Fail,39,36,0,13,26
80,Fail,39,38,0,23,16
80,Fail,45,40,0,12,33
80,Fail,42,34,0,16,26
80,Fail,44,42,1,13,31
80,Fail,43,41,0,8,35
80,Fail,46,34,0,11,35
80,Fail,39,43,5,13,26
80,Fail,46,39,1,14,32
80,Fail,50,35,2,13,37
80,Fail,48,30,10,12,36
80,Fail,49,35,0,14,35
80,Fail,49,33,1,17,32
80,Fail,51,29,0,12,39
80,Fail,46,36,0,15,31
80,Fail,51,37,0,10,41
80,Fail,50,36,1,13,37
80,Fail,52,39,0,6,46
80,Fail,52,38,0,9,43
80,Fail,48,37,0,12,36
80,Fail,44,31,6,19,25
80,Fail,50,35,0,9,41
80,Fail,46,42,0,11,35
80,Fail,47,44,0,9,38
80,Fail,51,35,0,12,39
80,Fail,41,32,0,21,20
80,Fail,45,39,1,15,30
80,Fail,44,39,0,12,32
80,Fail,51,26,6,17,34
80,Fail,43,34,0,20,23
80,Fail,51,34,2,13,38
80,Fail,56,30,0,9,47
80,Fail,47,32,0,15,32
80,Fail,47,39,0,8,39
80,Fail,55,36,1,8,47
80,Fail,49,35,0,15,34
80,Fail,49,36,0,15,34
80,Fail,45,38,4,13,32
80,Fail,48,35,5,12,36
80,Fail,61,30,0,9,52
80,Fail,45,32,6,17,28
80,Fail,43,36,6,15,28
80,Fail,54,28,0,14,40
80,Fail,51,30,3,16,35
80,Fail,44,39,5,12,32
80,Fail,44,40,0,10,34
80,Fail,47,35,6,12,35
80,Fail,45,43,1,11,34
80,Fail,45,40,3,12,33
80,Fail,47,32,9,12,35
80,Fail,51,32,0,7,44
80,Fail,51,42,2,5,46
80,Fail,47,28,5,20,27
80,Fail,58,35,0,5,53
80,Fail,46,31,0,12,34
80,Fail,47,35,4,14,33
80,Fail,48,36,2,14,34
80,Fail,46,41,0,13,33
80,Fail,47,41,0,10,37
80,Fail,50,33,0,12,38
80,Fail,46,30,2,22,24
80,Fail,60,24,0,12,48
80,Fail,43,41,0,15,28
80,Fail,50,34,6,10,40
80,Fail,54,33,0,10,44
80,Fail,42,32,0,22,20
80,Fail,45,40,4,11,34
80,Fail,42,36,6,16,26
80,Fail,51,37,0,11,40
80,Fail,51,35,0,11,40
80,Fail,41,38,0,18,23
80,Fail,44,35,0,13,31
80,Fail,50,38,0,10,40
80,Fail,45,31,0,17,28
80,Fail,43,36,0,13,30
80,Fail,50,34,4,12,38
80,Fail,45,37,4,14,31
80,Fail,39,46,0,6,33
80,Fail,48,37,3,12,36
80,Fail,46,37,0,17,29
80,Fail,55,30,3,12,43
80,Fail,46,36,0,14,32
80,Fail,55,30,0,13,42
80,Fail,49,37,0,10,39
80,Fail,48,28,7,17,31
80,Fail,41,41,0,11,30
80,Fail,44,33,10,13,31
80,Fail,53,30,6,11,42
80,Fail,52,34,0,12,40
80,Fail,49,31,0,11,38
80,Fail,47,36,7,10,37
80,Fail,53,33,0,11,42
80,Fail,35,37,0,21,14
80,Fail,40,40,0,12,28
80,Fail,44,38,1,17,27
80,Fail,48,29,8,15,33
80,Fail,55,33,3,9,46
80,Fail,49,35,0,10,39
80,Fail,50,36,0,12,38
80,Fail,55,32,0,10,45
80,Fail,54,31,0,11,43
80,Fail,53,30,5,12,41
80,Fail,46,35,5,14,32
80,Fail,48,32,4,16,32
80,Fail,50,41,0,9,41
80,Fail,42,45,1,12,30
80,Fail,55,27,2,16,39
80,Fail,43,42,5,10,33
80,Fail,48,33,2,17,31
80,Fail,54,28,0,15,39
80,Fail,38,46,8,8,30
80,Fail,46,37,0,12,34
80,Fail,56,34,0,8,48
80,Fail,47,31,0,16,31
80,Fail,43,39,0,16,27
80,Fail,49,28,12,11,38
80,Fail,43,31,0,14,29
80,Fail,44,35,6,15,29
80,Fail,53,32,2,13,40
80,Fail,46,35,4,15,31
80,Fail,46,39,0,12,34
80,Fail,53,38,0,9,44
80,Fail,56,33,0,11,45
80,Fail,52,30,0,18,34
80,Fail,49,39,5,7,42
80,Fail,46,39,1,14,32
80,Fail,54,35,0,10,44
80,Fail,45,35,0,13,32
80,Fail,42,45,2,11,31
80,Fail,53,27,0,14,39
80,Fail,44,36,0,13,31
80,Fail,40,41,1,18,22
80,Fail,40,49,0,10,30
80,Fail,43,26,0,14,29
80,Fail,53,28,0,9,44
80,Fail,48,37,0,12,36
80,Fail,49,39,2,10,39
80,Fail,57,25,0,15,42
80,Fail,51,32,0,16,35
80,Fail,50,44,2,4,46
80,Fail,55,34,0,10,45
80,Fail,48,35,2,15,33
80,Fail,51,37,2,10,41
80,Fail,55,35,0,9,46
80,Fail,46,36,0,11,35
80,Fail,41,42,1,16,25
80,Fail,49,31,0,16,33
80,Fail,48,43,1,8,40
80,Fail,60,33,0,6,54
80,Fail,40,45,0,11,29
80,Fail,47,36,0,17,30
80,Fail,51,26,7,16,35
80,Fail,51,29,4,16,35
80,Fail,51,29,6,14,37
80,Fail,47,33,7,13,34
80,Fail,48,40,0,5,43
80,Fail,44,38,0,14,30
80,Fail,47,36,0,15,32
80,Fail,50,31,8,11,39
80,Fail,49,38,0,10,39
80,Fail,55,34,0,8,47
80,Fail,54,28,0,10,44
80,Fail,43,41,0,14,29
80,Fail,53,33,3,11,42
80,Fail,48,34,0,12,36
80,Fail,58,28,0,12,46
80,Fail,45,40,2,13,32
80,Fail,55,34,0,10,45
80,Fail,48,34,0,18,30
80,Fail,46,39,0,12,34
80,Fail,51,35,0,7,44
80,Fail,50,33,0,14,36
80,Fail,53,31,0,12,41
80,Fail,42,43,0,14,28
80,Fail,48,40,2,10,38
80,Fail,47,42,3,8,39
80,Fail,47,32,11,10,37
80,Fail,49,34,0,15,34
80,Fail,39,44,0,16,23
80,Fail,50,36,0,12,38
80,Fail,41,37,9,13,28
80,Fail,58,33,0,9,49
80,Fail,47,32,0,13,34
80,Fail,41,36,0,18,23
80,Fail,53,34,7,6,47
80,Fail,60,27,3,10,50
80,Fail,53,38,0,6,47
80,Fail,49,31,0,10,39
80,Fail,54,30,4,12,42
80,Fail,49,38,1,12,37
80,Fail,57,34,0,8,49
80,Fail,43,39,0,12,31
80,Fail,43,39,6,12,31
80,Fail,57,32,0,8,49
80,Fail,42,34,11,13,29
80,Fail,42,39,3,16,26
80,Fail,53,30,2,15,38
80,Fail,51,32,0,15,36
80,Fail,42,39,0,9,33
80,Fail,45,39,0,14,31
80,Fail,49,44,0,6,43
80,Fail,42,34,0,15,27
80,Fail,52,37,3,8,44
80,Fail,50,32,0,17,33
80,Fail,47,41,0,12,35
80,Fail,40,39,0,17,23
80,Fail,41,40,5,14,27
80,Fail,43,38,10,9,34
80,Fail,46,35,5,14,32
80,Fail,48,30,7,15,33
80,Fail,50,35,0,12,38
80,Fail,47,41,3,9,38
80,Fail,48,42,0,10,38
80,Fail,57,35,1,7,50
80,Fail,48,29,6,17,31
80,Fail,51,38,0,11,40
80,Fail,58,29,0,13,45
80,Fail,53,30,0,10,43
80,Fail,48,33,5,14,34
80,Fail,48,38,0,13,35
80,Fail,50,36,2,12,38
80,Fail,48,38,0,12,36
80,Fail,54,34,1,11,43
80,Fail,42,38,0,15,27
80,Fail,49,36,3,12,37
80,Fail,48,29,11,12,36
80,Fail,50,32,0,11,39
80,Fail,57,30,0,11,46
80,Fail,43,40,6,11,32
80,Fail,44,28,9,19,25
80,Fail,54,31,2,13,41
80,Fail,47,34,0,16,31
80,Fail,53,35,2,10,43
80,Fail,53,36,3,8,45
80,Fail,57,33,0,7,50
80,Fail,55,32,3,10,45
80,Fail,40,37,6,17,23
80,Fail,49,32,0,12,37
80,Fail,50,34,0,14,36
80,Fail,50,35,0,12,38
80,Fail,42,42,0,15,27
80,Fail,49,30,9,12,37
80,Fail,47,34,0,17,30
80,Fail,49,42,0,9,40
80,Fail,49,37,6,8,41
80,Fail,51,34,0,9,42
80,Fail,53,34,0,12,41
80,Fail,57,26,4,13,44
80,Fail,52,36,3,9,43
80,Fail,48,34,0,16,32
80,Fail,49,35,0,11,38
80,Fail,45,34,4,17,28
80,Fail,46,46,0,8,38
80,Fail,45,41,0,12,33
80,Fail,54,34,0,12,42
80,Fail,41,37,11,11,30
80,Fail,48,36,1,15,33
80,Fail,60,36,1,3,57
80,Fail,51,33,0,11,40
80,Fail,57,29,0,11,46
80,Fail,47,33,0,15,32
80,Fail,52,31,2,15,37
80,Fail,51,31,1,17,34
80,Fail,46,34,5,15,31
80,Fail,47,35,0,13,34
80,Fail,49,32,6,13,36
80,Fail,39,38,8,15,24
80,Fail,51,33,1,15,36
80,Fail,43,39,3,15,28
80,Fail,46,38,0,16,30
80,Fail,48,36,3,13,35
80,Fail,57,33,0,7,50
80,Fail,52,26,0,13,39
80,Fail,42,40,0,16,26
80,Fail,51,35,0,14,37
80,Fail,51,36,0,13,38
80,Fail,48,34,9,9,39
80,Fail,43,42,6,9,34
80,Fail,54,28,0,12,42
80,Fail,48,32,0,18,30
80,Fail,52,33,0,10,42
80,Fail,55,34,0,5,50
80,Fail,42,34,0,15,27
80,Fail,40,38,0,18,22
80,Fail,51,35,0,12,39
80,Fail,45,35,0,13,32
80,Fail,46,39,4,11,35
80,Fail,56,27,10,7,49
80,Fail,43,36,0,13,30
80,Fail,47,34,0,12,35
80,Fail,45,37,5,13,32
80,Fail,53,38,0,9,44
80,Fail,49,36,4,11,38
80,Fail,55,34,3,8,47
80,Fail,45,38,4,13,32
80,Fail,48,39,0,13,35
80,Fail,52,33,0,12,40
80,Fail,43,42,5,10,33
80,Fail,52,35,6,7,45
80,Fail,56,32,2,10,46
80,Fail,45,34,6,15,30
80,Fail,47,35,5,13,34
80,Fail,50,36,0,13,37
80,Fail,52,31,2,15,37
80,Fail,48,34,0,16,32
80,Fail,46,40,0,10,36
80,Fail,48,30,0,16,32
80,Fail,45,41,0,13,32
80,Fail,42,36,0,19,23
80,Fail,51,36,1,12,39
80,Fail,58,23,0,12,46
80,Fail,45,39,0,13,32
80,Fail,49,42,2,7,42
80,Fail,48,36,0,13,35
80,Fail,43,42,6,9,34
80,Fail,51,35,1,13,38
80,Fail,54,31,0,13,41
80,Fail,45,30,13,12,33
80,Fail,45,35,0,14,31
80,Fail,49,36,0,8,41
80,Fail,44,28,0,19,25
80,Fail,51,40,1,8,43
80,Fail,48,36,2,14,34
80,Fail,48,31,0,17,31
80,Fail,45,36,8,11,34
80,Fail,48,28,7,17,31
80,Fail,46,39,2,13,33
80,Fail,52,33,0,10,42
80,Fail,42,44,0,13,29
80,Fail,57,37,0,6,51
80,Fail,42,44,0,11,31
80,Fail,45,37,9,9,36
80,Fail,53,34,0,11,42
80,Fail,52,25,0,13,39
80,Fail,53,33,1,13,40
80,Fail,47,39,2,12,35
80,Fail,47,33,4,16,31
80,Fail,53,34,2,11,42
80,Fail,55,27,0,16,39
80,Fail,46,39,3,12,34
80,Fail,57,35,0,8,49
80,Fail,45,36,0,14,31
80,Fail,43,45,0,10,33
80,Fail,47,35,2,16,31
80,Fail,43,39,4,14,29
80,Fail,49,29,0,18,31
80,Fail,53,28,0,12,41
80,Fail,45,39,0,15,30
80,Fail,43,35,8,14,29
80,Fail,48,38,0,12,36
80,Fail,45,36,1,18,27
80,Fail,51,33,0,15,36
80,Fail,50,30,1,19,31
80,Fail,50,31,4,15,35
80,Fail,51,36,0,9,42
80,Fail,47,33,0,19,28
80,Fail,50,37,1,12,38
80,Fail,46,36,7,11,35
80,Fail,50,44,0,4,46
80,Fail,53,35,4,8,45
80,Fail,42,32,0,15,27
80,Fail,44,30,9,17,27
80,Fail,53,31,5,11,42
80,Fail,45,35,0,18,27
80,Fail,45,32,12,11,34
80,Fail,49,39,0,7,42
80,Fail,51,26,0,12,39
80,Fail,41,34,0,15,26
80,Fail,55,36,0,9,46
80,Fail,52,32,4,12,40
80,Fail,39,28,16,17,22
80,Fail,52,28,0,13,39
80,Fail,46,37,0,12,34
80,Fail,52,32,0,16,36
80,Fail,54,30,0,10,44
80,Fail,56,35,1,8,48
80,Fail,55,32,0,12,43
80,Fail,49,36,0,9,40
80,Fail,38,48,4,10,28
80,Fail,44,39,4,13,31
80,Fail,47,37,0,13,34
80,Fail,43,38,5,14,29
80,Fail,48,33,5,14,34
80,Fail,48,25,8,19,29
80,Fail,54,30,0,15,39
80,Fail,52,30,0,17,35
80,Fail,50,31,0,17,33
80,Fail,48,40,0,10,38
80,Fail,50,30,0,14,36
80,Fail,45,40,3,12,33
80,Fail,44,35,0,18,26
80,Fail,57,33,0,7,50
80,Fail,41,43,1,15,26
80,Fail,44,36,6,14,30
80,Fail,50,35,0,9,41
80,Fail,46,37,1,16,30
80,Fail,49,37,0,14,35
80,Fail,45,37,1,17,28
80,Fail,43,37,0,18,25
80,Fail,46,37,0,10,36
80,Fail,44,35,4,17,27
80,Fail,49,36,2,13,36
80,Fail,39,35,0,15,24
80,Fail,49,36,1,14,35
80,Fail,44,37,6,13,31
80,Fail,52,36,0,8,44
80,Fail,53,30,0,14,39
80,Fail,47,30,0,15,32
80,Fail,44,31,0,16,28
80,Fail,48,34,0,10,38
80,Fail,47,43,0,9,38
80,Fail,49,39,0,12,37
80,Fail,47,34,5,14,33
80,Fail,50,24,0,19,31
80,Fail,48,35,0,10,38
80,Fail,42,45,2,11,31
80,Fail,45,44,0,11,34
80,Fail,54,31,0,15,39
80,Fail,40,43,0,14,26
80,Fail,50,35,0,9,41
80,Fail,53,32,5,10,43
80,Fail,52,34,3,11,41
80,Fail,45,40,0,13,32
80,Fail,49,38,0,11,38
80,Fail,47,41,0,12,35
80,Fail,51,30,0,5,46
80,Fail,43,46,0,10,33
80,Fail,47,36,1,16,31
80,Fail,52,26,0,11,41
80,Fail,49,33,1,17,32
80,Fail,44,35,0,10,34
80,Fail,48,41,0,9,39
80,Fail,52,35,0,13,39
80,Fail,50,41,0,9,41
80,Fail,51,29,0,16,35
80,Fail,40,46,2,12,28
80,Fail,50,38,0,11,39
80,Fail,55,35,2,8,47
80,Fail,48,29,8,15,33
80,Fail,54,37,0,7,47
80,Fail,53,33,8,6,47
80,Fail,45,44,1,10,35
80,Fail,46,39,0,12,34
80,Fail,48,41,0,6,42
80,Fail,45,40,1,14,31
80,Fail,51,33,0,15,36
80,Fail,53,33,0,12,41
80,Fail,47,35,0,12,35
80,Fail,50,26,0,18,32
80,Fail,33,44,0,15,18
80,Fail,50,36,0,11,39
80,Fail,46,46,1,7,39
80,Fail,48,37,4,11,37
80,Fail,47,38,3,12,35
80,Fail,47,39,0,12,35
80,Fail,54,34,4,8,46
80,Fail,45,35,0,15,30
80,Fail,50,39,5,6,44
80,Fail,50,36,0,10,40
80,Fail,49,31,0,16,33
80,Fail,46,35,0,16,30
80,Fail,42,32,11,15,27
80,Fail,44,34,5,17,27
80,Fail,52,35,0,12,40
80,Fail,57,29,0,8,49
80,Fail,38,36,11,15,23
80,Fail,51,34,8,7,44
80,Fail,48,34,2,16,32
80,Fail,42,33,11,14,28
80,Fail,50,35,0,12,38
80,Fail,44,40,3,13,31
80,Fail,56,34,0,8,48
80,Fail,49,38,1,12,37
80,Fail,52,36,4,8,44
80,Fail,50,33,0,5,45
80,Fail,46,33,0,16,30
80,Fail,51,33,0,13,38
80,Fail,43,39,0,18,25
80,Fail,43,29,0,16,27
80,Fail,41,44,0,10,31
80,Fail,48,35,0,15,33
80,Fail,45,32,1,22,23
80,Fail,41,36,7,16,25
80,Fail,46,34,3,17,29
80,Fail,49,29,4,18,31
80,Fail,49,36,0,12,37
80,Fail,49,37,5,9,40
80,Fail,47,39,0,11,36
80,Fail,50,33,0,11,39
80,Fail,48,34,7,11,37
80,Fail,47,31,4,18,29
80,Fail,44,38,3,15,29
80,Fail,47,39,3,11,36
80,Fail,49,40,0,8,41
80,Fail,45,31,10,14,31
80,Fail,45,37,0,12,33
80,Fail,45,39,4,12,33
80,Fail,46,39,0,9,37
80,Fail,51,36,0,12,39
80,Fail,49,31,0,13,36
80,Fail,55,37,0,8,47
80,Fail,45,40,5,10,35
80,Fail,46,42,0,9,37
80,Fail,49,31,0,18,31
80,Fail,46,34,0,14,32
80,Fail,54,31,0,13,41
80,Fail,46,36,5,13,33
80,Fail,52,39,0,6,46
80,Fail,49,34,0,14,35
80,Fail,45,37,3,15,30
80,Fail,52,35,3,10,42
80,Fail,48,37,0,10,38
80,Fail,45,37,3,15,30
80,Fail,43,31,9,17,26
80,Fail,46,36,4,14,32
80,Fail,46,34,0,16,30
80,Fail,46,41,0,13,33
80,Fail,55,33,0,12,43
80,Fail,59,31,0,9,50
80,Fail,50,35,0,13,37
80,Fail,45,29,11,15,30
80,Fail,43,37,2,18,25
80,Fail,45,37,3,15,30
80,Fail,41,37,0,10,31
80,Fail,53,30,0,11,42
80,Fail,47,37,5,11,36
80,Fail,48,38,0,12,36
80,Fail,53,40,0,7,46
80,Fail,50,35,0,12,38
80,Fail,43,30,8,19,24
80,Fail,39,53,2,6,33
80,Fail,44,38,0,16,28
80,Fail,48,33,6,13,35
80,Fail,52,36,0,12,40
80,Fail,41,37,6,16,25
80,Fail,49,36,3,12,37
80,Fail,45,41,2,12,33
80,Fail,46,32,6,16,30
80,Fail,47,41,0,12,35
80,Fail,46,34,3,17,29
80,Fail,53,35,6,6,47
80,Fail,50,33,5,12,38
80,Fail,54,34,0,12,42
80,Fail,39,34,14,13,26
80,Fail,51,29,9,11,40
80,Fail,46,34,4,16,30
80,Fail,47,30,0,14,33
80,Fail,51,35,3,11,40
80,Fail,51,33,2,14,37
80,Fail,52,29,0,13,39
80,Fail,53,31,5,11,42
80,Fail,56,32,0,12,44
80,Fail,50,34,0,8,42
80,Fail,51,31,4,14,37
80,Fail,50,37,1,12,38
80,Fail,46,35,0,15,31
80,Fail,44,43,1,12,32
80,Fail,41,42,6,11,30
80,Fail,48,35,3,14,34
80,Fail,46,37,0,9,37
80,Fail,43,40,0,11,32
80,Fail,45,33,0,12,33
80,Fail,50,36,0,10,40
80,Fail,39,49,0,10,29
80,Fail,41,37,6,16,25
80,Fail,52,33,0,14,38
80,Fail,54,26,6,14,40
80,Fail,47,38,5,10,37
80,Fail,56,33,1,10,46
80,Fail,50,36,0,12,38
80,Fail,49,34,0,15,34
80,Fail,54,32,4,10,44
80,Fail,56,36,0,6,50
80,Fail,50,39,0,7,43
80,Fail,45,36,8,11,34
80,Fail,46,41,2,11,35
80,Fail,48,39,1,12,36
80,Fail,45,37,7,11,34
80,Fail,51,28,0,14,37
80,Fail,44,36,3,17,27
80,Fail,44,41,0,15,29
80,Fail,49,31,3,17,32
80,Fail,48,36,1,15,33
80,Fail,48,38,5,9,39
80,Fail,40,31,8,21,19
80,Fail,48,38,0,12,36
80,Fail,48,35,0,16,32
80,Fail,53,32,8,7,46
80,Fail,44,33,0,16,28
80,Fail,45,40,0,13,32
80,Fail,47,32,0,16,31
80,Fail,49,37,0,9,40
80,Fail,48,37,0,12,36
80,Fail,43,45,3,9,34
80,Fail,44,30,7,19,25
80,Fail,47,33,9,11,36
80,Fail,52,38,0,9,43
80,Fail,50,25,9,16,34
80,Fail,42,46,4,8,34
80,Fail,43,38,10,9,34
80,Fail,45,36,0,14,31
80,Fail,49,29,0,17,32
80,Fail,45,48,0,7,38
80,Fail,60,32,4,4,56
80,Fail,51,34,0,14,37
80,Fail,49,34,4,13,36
80,Fail,43,39,6,12,31
80,Fail,46,45,2,7,39
80,Fail,58,28,2,12,46
80,Fail,46,39,1,14,32
80,Fail,44,44,3,9,35
80,Fail,53,32,0,15,38
80,Fail,44,34,0,16,28
80,Fail,59,25,2,14,45
80,Fail,38,40,7,15,23
80,Fail,48,30,9,13,35
80,Fail,55,35,0,10,45
80,Fail,36,47,0,13,23
80,Fail,50,33,2,15,35
80,Fail,45,36,8,11,34
80,Fail,48,34,7,11,37
80,Fail,38,37,8,17,21
80,Fail,40,41,0,18,22
80,Fail,43,31,0,19,24
80,Fail,49,33,5,13,36
80,Fail,52,35,0,12,40
80,Fail,47,44,0,9,38
80,Fail,45,35,4,16,29
80,Fail,47,26,0,12,35
80,Fail,48,37,0,11,37
80,Fail,46,32,0,16,30
80,Fail,41,42,0,13,28
80,Fail,51,30,0,19,32
80,Fail,28,43,14,15,13
80,Fail,51,28,9,12,39
80,Fail,43,43,0,12,31
80,Fail,60,22,0,13,47
80,Fail,48,43,1,8,40
80,Fail,43,38,4,15,28
80,Fail,47,32,0,11,36
80,Fail,45,38,0,12,33
80,Fail,47,33,0,16,31
80,Fail,48,36,0,14,34
80,Fail,50,36,2,12,38
80,Fail,45,35,0,15,30
80,Fail,43,39,0,10,33
80,Fail,50,34,2,14,36
80,Fail,48,34,0,13,35
80,Fail,51,35,0,12,39
80,Fail,47,39,0,12,35
80,Fail,48,32,1,19,29
80,Fail,51,34,4,11,40
80,Fail,50,37,0,11,39
80,Fail,46,34,7,13,33
80,Fail,43,34,0,15,28
80,Fail,57,34,0,8,49
80,Fail,58,27,0,13,45
80,Fail,47,37,2,14,33
80,Fail,45,42,0,6,39
80,Fail,48,40,3,9,39
80,Fail,50,37,0,9,41
80,Fail,46,29,6,19,27
80,Fail,49,33,0,16,33
80,Fail,47,33,5,15,32
80,Fail,53,38,0,7,46
80,Fail,52,30,7,11,41
80,Fail,45,36,0,18,27
80,Fail,42,36,0,18,24
80,Fail,46,40,0,13,33
80,Fail,41,43,0,12,29
80,Fail,48,37,1,14,34
80,Fail,47,36,0,7,40
80,Fail,49,37,0,8,41
80,Fail,49,39,0,11,38
80,Fail,50,37,0,12,38
80,Fail,54,35,0,11,43
80,Fail,51,37,5,7,44
80,Fail,60,26,2,12,48
80,Fail,52,34,0,9,43
80,Fail,45,42,0,12,33
80,Fail,43,37,0,17,26
80,Fail,50,36,0,11,39
80,Fail,40,43,0,13,27
80,Fail,47,38,3,12,35
80,Fail,43,39,0,16,27
80,Fail,43,41,3,13,30
80,Fail,54,31,0,11,43
80,Fail,47,35,11,7,40
80,Fail,51,33,8,8,43
80,Fail,51,38,4,7,44
80,Fail,48,31,0,21,27
80,Fail,43,41,1,15,28
80,Fail,40,49,0,10,30
80,Fail,40,37,0,14,26
80,Fail,47,38,4,11,36
80,Fail,50,42,0,4,46
80,Fail,47,35,0,16,31
80,Fail,46,38,4,12,34
80,Fail,48,33,3,16,32
80,Fail,53,34,2,11,42
80,Fail,44,33,6,17,27
80,Fail,46,36,0,14,32
80,Fail,48,35,0,17,31
80,Fail,47,37,0,14,33
80,Fail,43,38,7,12,31
80,Fail,40,37,8,15,25
80,Fail,60,29,5,6,54
80,Fail,45,38,0,12,33
80,Fail,47,38,0,15,32
80,Fail,44,44,1,11,33
80,Fail,50,38,2,10,40
80,Fail,47,42,0,10,37
80,Fail,46,34,8,12,34
80,Fail,49,33,0,14,35
80,Fail,51,34,0,12,39
80,Fail,46,40,0,12,34
80,Fail,53,36,0,9,44
80,Fail,48,30,0,14,34
80,Fail,51,41,1,7,44
80,Fail,47,38,2,13,34
80,Fail,44,37,6,13,31
80,Fail,55,35,0,10,45
80,Fail,40,34,0,16,24
80,Fail,51,42,3,4,47
80,Fail,48,36,4,12,36
80,Fail,47,35,0,17,30
80,Fail,53,34,0,12,41
80,Fail,44,34,0,19,25
80,Fail,38,45,0,17,21
80,Fail,50,25,0,20,30
80,Fail,49,33,0,10,39
80,Fail,46,32,1,21,25
80,Fail,47,34,0,15,32
80,Fail,54,35,1,10,44
80,Fail,46,42,2,10,36
80,Fail,39,31,0,21,18
80,Fail,52,35,4,9,43
80,Fail,41,34,13,12,29
80,Fail,47,38,0,14,33
80,Fail,50,34,2,14,36
80,Fail,47,31,10,12,35
80,Fail,46,41,0,12,34
80,Fail,56,30,0,13,43
80,Fail,57,29,0,12,45
80,Fail,51,30,0,17,34
80,Fail,47,24,13,16,31
80,Fail,49,36,0,15,34
80,Fail,53,34,0,12,41
80,Fail,58,30,0,10,48
80,Fail,54,31,0,14,40
80,Fail,46,39,0,9,37
80,Fail,47,34,2,17,30
80,Fail,51,37,0,9,42
80,Fail,38,40,8,14,24
80,Fail,41,39,0,10,31
80,Fail,46,42,0,9,37
80,Fail,53,34,6,7,46
80,Fail,48,27,0,17,31
80,Fail,40,38,0,20,20
80,Fail,48,35,0,14,34
80,Fail,44,41,2,13,31
80,Fail,45,33,0,15,30
80,Fail,49,34,0,11,38
80,Fail,43,39,5,13,30
80,Fail,46,45,0,9,37
80,Fail,50,32,2,16,34
80,Fail,45,32,9,14,31
80,Fail,49,38,0,12,37
80,Fail,46,41,1,12,34
80,Fail,40,39,0,13,27
80,Fail,48,27,8,17,31
80,Fail,48,34,0,15,33
80,Fail,43,33,0,20,23
80,Fail,44,37,2,17,27
80,Fail,45,32,0,16,29
80,Fail,48,38,0,12,36
80,Fail,47,35,0,14,33
80,Fail,47,33,0,10,37
80,Fail,47,40,6,7,40
80,Fail,46,41,0,9,37
80,Fail,56,24,7,13,43
80,Fail,45,39,0,16,29
80,Fail,51,33,2,14,37
80,Fail,52,27,12,9,43
80,Fail,44,41,0,15,29
80,Fail,42,39,6,13,29
80,Fail,54,34,0,12,42
80,Fail,43,34,6,17,26
80,Fail,43,33,0,20,23
80,Fail,53,31,0,14,39
80,Fail,54,26,7,13,41
80,Fail,44,34,4,18,26
80,Fail,48,30,4,18,30
80,Fail,42,38,0,11,31
80,Fail,48,37,0,15,33
80,Fail,43,38,0,8,35
80,Fail,43,39,4,14,29
80,Fail,45,34,0,14,31
80,Fail,50,35,0,11,39
80,Fail,52,32,0,15,37
80,Fail,44,35,0,14,30
80,Fail,51,30,0,19,32
80,Fail,45,32,11,12,33
80,Fail,59,29,0,9,50
80,Fail,49,36,3,12,37
80,Fail,44,41,0,11,33
80,Fail,48,39,0,10,38
80,Fail,51,33,0,14,37
80,Fail,39,42,3,16,23
80,Fail,53,37,3,7,46
80,Fail,46,39,4,11,35
80,Fail,46,41,0,12,34
80,Fail,50,30,0,15,35
80,Fail,40,41,2,17,23
80,Fail,48,33,6,13,35
80,Fail,55,34,0,7,48
80,Fail,49,38,0,11,38
80,Fail,56,26,4,14,42
80,Fail,49,30,9,12,37
80,Fail,42,37,2,19,23
80,Fail,45,39,0,14,31
80,Fail,39,39,0,14,25
80,Fail,48,39,0,10,38
80,Fail,47,36,2,15,32
80,Fail,43,40,5,12,31
80,Fail,45,35,5,15,30
80,Fail,50,40,1,9,41
80,Fail,42,32,9,17,25
80,Fail,48,33,0,18,30
80,Fail,39,41,0,14,25
80,Fail,49,33,0,12,37
80,Fail,52,34,0,11,41
80,Fail,42,43,0,11,31
80,Fail,43,41,0,15,28
80,Fail,45,34,7,14,31
80,Fail,51,31,4,14,37
80,Fail,52,31,0,15,37
80,Fail,54,29,7,10,44
80,Fail,49,35,3,13,36
80,Fail,54,39,0,6,48
80,Fail,48,38,0,10,38
80,Fail,52,39,1,8,44
80,Fail,49,39,3,9,40
80,Fail,47,39,0,12,35
80,Fail,55,26,7,12,43
80,Fail,51,32,0,12,39
80,Fail,53,32,3,12,41
80,Fail,54,34,0,12,42
80,Fail,52,33,1,14,38
80,Fail,46,40,3,11,35
80,Fail,46,30,0,20,26
80,Fail,52,35,3,10,42
80,Fail,48,38,0,14,34
80,Fail,51,38,1,10,41
80,Fail,51,33,8,8,43
80,Fail,53,37,3,7,46
80,Fail,49,37,0,14,35
80,Fail,61,32,0,5,56
80,Fail,48,33,7,12,36
80,Fail,52,33,0,13,39
80,Fail,42,37,0,14,28
80,Fail,44,39,0,16,28
80,Fail,47,31,8,14,33
80,Fail,42,32,0,19,23
80,Fail,49,40,0,11,38
80,Fail,50,35,2,13,37
80,Fail,39,44,4,13,26
80,Fail,42,38,5,15,27
80,Fail,47,38,7,8,39
80,Fail,49,34,0,15,34
80,Fail,55,23,0,14,41
80,Fail,48,34,0,11,37
80,Fail,45,38,0,12,33
80,Fail,46,39,4,11,35
80,Fail,56,31,2,11,45
80,Fail,53,33,0,13,40
80,Fail,49,34,0,13,36
80,Fail,51,37,0,12,39
80,Fail,52,34,1,13,39
80,Fail,38,37,13,12,26
80,Fail,54,38,0,8,46
80,Fail,50,40,0,9,41
80,Fail,33,46,5,16,17
80,Fail,45,34,2,19,26
80,Fail,52,31,2,15,37
80,Fail,44,30,11,15,29
80,Fail,47,33,0,14,33
80,Fail,49,38,0,10,39
80,Fail,49,29,0,14,35
80,Fail,48,27,15,10,38
80,Fail,46,36,0,15,31
80,Fail,37,41,0,13,24
80,Fail,45,37,0,12,33
80,Fail,47,30,10,13,34
80,Fail,50,31,2,17,33
80,Fail,45,36,3,16,29
80,Fail,52,29,1,18,34
80,Fail,59,30,5,6,53
80,Fail,54,34,0,12,42
80,Fail,52,41,2,5,47
80,Fail,51,28,0,10,41
80,Fail,50,34,0,15,35
80,Fail,45,37,7,11,34
80,Fail,50,31,0,16,34
80,Fail,55,35,0,10,45
80,Fail,45,36,0,15,30
80,Fail,50,34,1,15,35
80,Fail,43,40,5,12,31
80,Fail,50,32,5,13,37
80,Fail,41,30,0,14,27
80,Fail,46,32,0,21,25
80,Fail,45,36,5,14,31
80,Fail,48,38,2,12,36
80,Fail,42,42,3,13,29
80,Fail,61,31,0,8,53
80,Fail,48,42,1,9,39
80,Fail,46,29,0,18,28
80,Fail,46,40,3,11,35
80,Fail,45,44,0,11,34
80,Fail,46,33,0,16,30
80,Fail,52,35,0,13,39
80,Fail,48,31,8,13,35
80,Fail,44,42,0,14,30
80,Fail,48,43,0,8,40
80,Fail,49,34,3,14,35
80,Fail,49,34,6,11,38
80,Fail,55,33,0,11,44
80,Fail,50,36,0,9,41
80,Fail,53,39,0,8,45
80,Fail,42,39,4,15,27
80,Fail,47,34,5,14,33
80,Fail,49,32,4,15,34
80,Fail,52,32,3,13,39
80,Fail,46,33,9,12,34
80,Fail,48,35,5,12,36
80,Fail,50,41,0,9,41
80,Fail,43,35,6,16,27
80,Fail,42,46,3,9,33
80,Fail,54,29,0,15,39
80,Fail,47,40,5,8,39
80,Fail,51,34,0,9,42
80,Fail,54,32,0,13,41
80,Fail,48,32,9,11,37
80,Fail,50,35,1,14,36
80,Fail,44,41,0,12,32
80,Fail,46,37,3,14,32
80,Fail,50,33,0,16,34
80,Fail,50,35,6,9,41
80,Fail,50,36,1,13,37
80,Fail,43,44,3,10,33
80,Fail,48,31,0,20,28
80,Fail,54,34,0,8,46
80,Fail,50,32,4,14,36
80,Fail,54,38,0,5,49
80,Fail,46,35,1,18,28
80,Fail,44,35,5,16,28
80,Fail,60,32,0,7,53
80,Fail,43,44,0,12,31
80,Fail,50,35,0,13,37
80,Fail,45,38,2,15,30
80,Fail,45,40,0,11,34
80,Fail,42,43,0,11,31
80,Fail,47,30,0,16,31
80,Fail,53,30,1,16,37
80,Fail,52,32,2,14,38
80,Fail,54,32,3,11,43
80,Fail,45,44,1,10,35
80,Fail,55,28,5,12,43
80,Fail,53,37,1,9,44
80,Fail,54,29,0,15,39
80,Fail,51,31,0,12,39
80,Fail,53,35,1,11,42
80,Fail,49,42,0,9,40
80,Fail,44,36,0,17,27
80,Fail,53,36,0,7,46
80,Fail,55,33,3,9,46
80,Fail,43,44,2,11,32
80,Fail,53,30,0,12,41
80,Fail,48,35,0,13,35
80,Fail,48,31,1,20,28
80,Fail,51,37,0,9,42
80,Fail,56,29,2,13,43
80,Fail,48,37,3,12,36
80,Fail,48,42,0,10,38
80,Fail,45,38,0,10,35
80,Fail,48,38,5,9,39
80,Fail,48,39,0,10,38
80,Fail,50,37,0,11,39
80,Fail,44,38,2,16,28
80,Fail,55,27,0,15,40
80,Fail,50,39,2,9,41
80,Fail,43,39,0,16,27
80,Fail,56,25,10,9,47
80,Fail,55,35,3,7,48
80,Fail,54,33,2,11,43
80,Fail,50,37,0,9,41
80,Fail,51,39,0,8,43
80,Fail,48,38,0,3,45
80,Fail,41,40,5,14,27
80,Fail,53,30,5,12,41
80,Fail,55,36,1,8,47
80,Fail,54,29,0,16,38
80,Fail,42,39,5,14,28
80,Fail,50,32,0,18,32
80,Fail,43,35,5,17,26
80,Fail,41,40,0,14,27
80,Fail,52,33,0,11,41
80,Fail,55,31,0,13,42
80,Fail,46,36,0,16,30
80,Fail,43,36,6,15,28
80,Fail,49,31,7,13,36
80,Fail,48,34,0,14,34
80,Fail,52,35,0,12,40
80,Fail,48,39,0,11,37
80,Fail,53,33,0,11,42
80,Fail,48,38,0,13,35
80,Fail,46,32,0,11,35
80,Fail,56,33,0,8,48
80,Fail,37,37,0,12,25
80,Fail,41,42,0,9,32
80,Fail,45,43,1,11,34
80,Fail,50,35,0,10,40
80,Fail,52,34,0,8,44
80,Fail,56,25,0,17,39
80,Fail,49,33,2,16,33
80,Fail,37,46,0,14,23
80,Fail,47,34,5,14,33
80,Fail,41,37,8,14,27
80,Fail,46,28,9,17,29
80,Fail,49,34,0,17,32
80,Fail,51,44,0,5,46
80,Fail,44,41,0,14,30
80,Fail,49,42,0,9,40
80,Fail,47,32,0,15,32
80,Fail,43,43,0,12,31
80,Fail,43,41,0,11,32
80,Fail,48,37,3,12,36
80,Fail,54,35,0,11,43
80,Fail,37,54,1,8,29
80,Fail,47,40,0,10,37
80,Fail,51,35,4,10,41
80,Fail,43,40,0,17,26
80,Fail,47,37,0,14,33
80,Fail,55,34,3,8,47
80,Fail,43,40,4,13,30
80,Fail,56,25,5,14,42
80,Fail,49,31,0,10,39
80,Fail,42,33,11,14,28
80,Fail,46,32,12,10,36
80,Fail,41,42,2,15,26
80,Fail,47,34,4,15,32
80,Fail,46,32,11,11,35
80,Fail,60,23,7,10,50
80,Fail,48,36,2,14,34
80,Fail,50,33,4,13,37
80,Fail,51,27,8,14,37
80,Fail,56,28,0,10,46
80,Fail,44,34,0,15,29
80,Fail,46,38,3,13,33
80,Fail,48,35,1,16,32
80,Fail,51,37,0,12,39
80,Fail,50,33,2,15,35
80,Fail,47,29,8,16,31
80,Fail,50,30,5,15,35
80,Fail,43,37,0,11,32
80,Fail,50,34,5,11,39
80,Fail,41,40,0,10,31
80,Fail,48,34,2,16,32
80,Fail,50,34,0,14,36
80,Fail,56,25,0,13,43
80,Fail,51,27,0,13,38
80,Fail,41,41,0,13,28
80,Fail,47,37,5,11,36
80,Fail,47,36,2,15,32
80,Fail,46,39,0,9,37
80,Fail,52,34,2,12,40
80,Fail,35,47,0,17,18
80,Fail,46,36,5,13,33
80,Fail,47,36,0,12,35
80,Fail,48,30,7,15,33
80,Fail,50,33,0,16,34
80,Fail,46,30,0,20,26
80,Fail,48,36,0,11,37
80,Fail,43,38,4,15,28
80,Fail,49,32,0,15,34
80,Fail,50,38,0,12,38
80,Fail,51,33,0,16,35
80,Fail,42,42,5,11,31
80,Fail,42,36,8,14,28
80,Fail,46,38,0,16,30
80,Fail,47,34,3,16,31
80,Fail,51,40,0,8,43
80,Fail,49,36,2,13,36
80,Fail,36,41,0,16,20
80,Fail,54,31,4,11,43
80,Fail,45,37,5,13,32
80,Fail,40,37,0,15,25
80,Fail,41,34,11,14,27
80,Fail,53,33,0,13,40
80,Fail,55,34,1,10,45
80,Fail,40,43,1,16,24
80,Fail,45,40,0,15,30
80,Fail,45,39,0,12,33
80,Fail,55,35,0,8,47
80,Fail,48,38,0,13,35
80,Fail,51,39,2,8,43
80,Fail,55,29,0,15,40
80,Fail,47,41,3,9,38
80,Fail,44,38,0,9,35
80,Fail,53,39,0,8,45
80,Fail,41,46,4,9,32
80,Fail,43,39,3,15,28
80,Fail,48,40,1,11,37
80,Fail,50,38,2,10,40
80,Fail,47,35,0,13,34
80,Fail,51,37,0,9,42
80,Fail,48,35,5,12,36
80,Fail,43,41,3,13,30
80,Fail,44,39,2,15,29
80,Fail,52,34,0,12,40
80,Fail,50,36,0,11,39
80,Fail,48,36,0,10,38
80,Fail,59,26,0,14,45
80,Fail,51,31,0,12,39
80,Fail,47,42,0,9,38
80,Fail,43,33,0,17,26
80,Fail,42,45,0,11,31
80,Fail,40,43,0,16,24
80,Fail,46,33,0,16,30
80,Fail,48,40,0,7,41
80,Fail,47,37,6,10,37
80,Fail,40,31,0,15,25
80,Fail,42,37,0,10,32
80,Fail,52,37,2,9,43
80,Fail,46,39,0,14,32
80,Fail,48,33,0,15,33
80,Fail,51,32,0,10,41
80,Fail,49,35,1,15,34
80,Fail,49,36,0,15,34
80,Fail,48,35,0,13,35
80,Fail,47,38,0,15,32
80,Fail,45,42,0,11,34
80,Fail,46,32,0,13,33
80,Fail,49,37,0,12,37
80,Fail,51,36,5,8,43
80,Fail,48,37,0,15,33
80,Fail,56,36,0,5,51
80,Fail,43,39,0,15,28
80,Fail,47,34,1,18,29
80,Fail,43,39,0,18,25
80,Fail,40,36,0,15,25
80,Fail,44,44,2,10,34
80,Fail,44,43,1,12,32
80,Fail,38,37,4,21,17
80,Fail,52,34,2,12,40
80,Fail,51,31,2,16,35
80,Fail,50,38,0,12,38
80,Fail,54,30,3,13,41
80,Fail,50,33,0,12,38
80,Fail,53,27,0,14,39
80,Fail,43,29,0,16,27
80,Fail,50,39,0,3,47
80,Fail,50,40,1,9,41
80,Fail,45,36,0,14,31
80,Fail,45,34,0,13,32
80,Fail,40,40,0,14,26
80,Fail,45,35,5,15,30
80,Fail,47,28,9,16,31
80,Fail,49,33,4,14,35
80,Fail,58,25,0,14,44
80,Fail,50,36,1,13,37
80,Fail,57,32,4,7,50
80,Fail,50,38,0,8,42
80,Fail,42,40,6,12,30
80,Fail,42,40,0,17,25
80,Fail,39,36,9,16,23
80,Fail,54,32,0,7,47
80,Fail,53,35,3,9,44
80,Fail,53,33,0,10,43
80,Fail,49,39,0,12,37
80,Fail,43,36,0,13,30
80,Fail,48,34,0,12,36
80,Fail,48,34,2,16,32
80,Fail,42,37,5,16,26
80,Fail,51,37,2,10,41
80,Fail,49,34,0,12,37
80,Fail,55,33,3,9,46
80,Fail,48,37,0,12,36
80,Fail,47,37,0,12,35
80,Fail,54,23,9,14,40
80,Fail,44,38,5,13,31
80,Fail,51,36,0,12,39
80,Fail,49,32,0,14,35
80,Fail,45,37,7,11,34
80,Fail,49,41,0,7,42
80,Fail,45,36,1,18,27
80,Fail,52,32,0,14,38
80,Fail,49,24,0,16,33
80,Fail,40,47,2,11,29
80,Fail,37,40,0,19,18
80,Fail,59,26,4,11,48
80,Fail,53,31,0,12,41
80,Fail,49,29,0,18,31
80,Fail,44,36,0,13,31
80,Fail,56,32,0,9,47
80,Fail,48,32,0,14,34
80,Fail,56,33,1,10,46
80,Fail,50,36,6,8,42
80,Fail,41,36,0,20,21
80,Fail,45,44,0,9,36
80,Fail,53,26,0,14,39
80,Fail,50,37,0,11,39
80,Fail,45,31,0,18,27
80,Fail,49,30,0,13,36
80,Fail,52,31,2,15,37
80,Fail,40,37,0,11,29
80,Fail,48,35,4,13,35
80,Fail,47,37,0,15,32
80,Fail,47,32,5,16,31
80,Fail,49,36,3,12,37
80,Fail,46,37,1,16,30
80,Fail,44,36,6,14,30
80,Fail,45,36,4,15,30
80,Fail,50,32,6,12,38
80,Fail,46,34,0,18,28
80,Fail,54,34,0,12,42
80,Fail,52,30,0,17,35
80,Fail,45,32,3,20,25
80,Fail,44,29,6,21,23
80,Fail,42,40,0,8,34
80,Fail,47,39,2,12,35
80,Fail,49,37,4,10,39
80,Fail,51,28,0,19,32
80,Fail,48,36,2,14,34
80,Fail,42,43,0,13,29
80,Fail,47,42,1,10,37
80,Fail,54,36,0,9,45
80,Fail,46,34,1,19,27
80,Fail,39,42,7,12,27
80,Fail,53,37,0,9,44
80,Fail,50,34,2,14,36
80,Fail,51,34,0,14,37
80,Fail,52,37,2,9,43
80,Fail,55,35,1,9,46
80,Fail,50,37,6,7,43
80,Fail,51,31,6,12,39
80,Fail,47,32,0,14,33
80,Fail,48,39,0,10,38
80,Fail,39,46,1,14,25
80,Fail,43,39,0,16,27
80,Fail,44,39,0,12,32
80,Fail,42,42,2,14,28
80,Fail,43,35,9,13,30
80,Fail,41,39,0,13,28
80,Fail,44,35,0,15,29
80,Fail,45,41,0,10,35
80,Fail,49,34,2,15,34
80,Fail,43,36,0,12,31
80,Fail,48,32,0,19,29
80,Fail,45,33,7,15,30
80,Fail,48,32,1,19,29
80,Fail,43,39,0,14,29
80,Fail,54,34,1,11,43
80,Fail,51,31,3,15,36
80,Fail,48,39,0,13,35
80,Fail,55,33,0,12,43
80,Fail,47,33,0,18,29
80,Fail,51,33,0,14,37
80,Fail,43,44,0,12,31
80,Fail,47,34,6,13,34
80,Fail,50,34,7,9,41
80,Fail,44,36,4,16,28
80,Fail,47,32,0,16,31
80,Fail,46,33,4,17,29
80,Fail,48,40,0,11,37
80,Fail,55,27,1,17,38
80,Fail,50,36,0,13,37
80,Fail,42,37,5,16,26
80,Fail,54,32,4,10,44
80,Fail,53,33,0,11,42
80,Fail,51,33,4,12,39
80,Fail,60,28,0,11,49
80,Fail,49,37,0,13,36
80,Fail,46,41,6,7,39
80,Fail,47,34,7,12,35
80,Fail,42,34,0,14,28
80,Fail,62,23,9,6,56
80,Fail,43,39,0,16,27
80,Fail,47,35,5,13,34
80,Fail,56,36,2,6,50
80,Fail,48,34,0,16,32
80,Fail,46,31,13,10,36
80,Fail,49,36,7,8,41
80,Fail,47,29,12,12,35
80,Fail,52,32,0,15,37
80,Fail,58,34,0,8,50
80,Fail,40,39,3,18,22
80,Fail,42,47,0,11,31
80,Fail,49,37,0,14,35
80,Fail,43,35,4,18,25
80,Fail,52,36,0,12,40
80,Fail,54,37,1,8,46
80,Fail,41,37,0,19,22
80,Fail,45,35,4,16,29
80,Fail,50,32,3,15,35
80,Fail,38,39,0,11,27
80,Fail,56,31,4,9,47
80,Fail,40,36,3,21,19
80,Fail,50,37,0,12,38
80,Fail,45,34,10,11,34
80,Fail,44,38,0,11,33
80,Fail,46,31,10,13,33
80,Fail,58,34,1,7,51
80,Fail,46,30,0,14,32
80,Fail,52,35,0,12,40
80,Fail,52,30,0,18,34
80,Fail,49,33,0,12,37
80,Fail,36,45,0,9,27
80,Fail,50,29,3,18,32
80,Fail,46,41,3,10,36
80,Fail,43,41,2,14,29
80,Fail,50,34,0,12,38
80,Fail,55,35,0,10,45
80,Fail,47,33,8,12,35
80,Fail,49,37,0,11,38
80,Fail,48,34,2,16,32
80,Fail,53,26,7,14,39
80,Fail,46,34,0,13,33
80,Fail,47,31,0,14,33
80,Fail,40,45,1,14,26
80,Fail,52,32,4,12,40
80,Fail,49,40,1,10,39
80,Fail,48,30,7,15,33
80,Fail,50,35,0,9,41
80,Fail,51,30,5,14,37
80,Fail,45,43,1,11,34
80,Fail,50,35,0,14,36
80,Fail,43,35,2,20,23
80,Fail,43,36,0,20,23
80,Fail,54,36,0,9,45
80,Fail,53,36,0,9,44
80,Fail,45,34,5,16,29
80,Fail,44,39,0,14,30
80,Fail,53,33,1,13,40
80,Fail,50,33,0,14,36
80,Fail,42,47,1,10,32
80,Fail,53,33,0,14,39
80,Fail,46,41,5,8,38
80,Fail,46,36,0,16,30
80,Fail,47,34,0,16,31
80,Fail,42,40,3,15,27
80,Fail,48,37,0,7,41
80,Fail,44,39,1,16,28
80,Fail,49,36,0,15,34
80,Fail,52,34,0,9,43
80,Fail,54,30,7,9,45
80,Fail,49,37,0,11,38
80,Fail,49,29,11,11,38
80,Fail,43,39,3,15,28
80,Fail,47,33,0,20,27
80,Fail,49,25,9,17,32
80,Fail,52,38,0,10,42
80,Fail,46,39,4,11,35
80,Fail,44,36,0,11,33
80,Fail,54,36,0,10,44
80,Fail,44,29,0,17,27
80,Fail,54,30,1,15,39
80,Fail,58,27,0,15,43
80,Fail,45,34,0,17,28
80,Fail,45,33,10,12,33
80,Fail,43,42,1,14,29
80,Fail,47,38,0,13,34
80,Fail,47,31,0,17,30
80,Fail,47,41,0,12,35
80,Fail,51,28,11,10,41
80,Fail,46,46,0,7,39
80,Fail,47,31,0,12,35
80,Fail,42,37,0,10,32
80,Fail,51,43,0,6,45
80,Fail,40,42,5,13,27
80,Fail,46,29,0,18,28
80,Fail,46,35,1,18,28
80,Fail,51,31,4,14,37
80,Fail,48,37,0,8,40
80,Fail,41,38,3,18,23
80,Fail,55,30,2,13,42
80,Fail,52,37,0,9,43
80,Fail,47,43,0,10,37
80,Fail,54,32,2,12,42
80,Fail,46,39,0,10,36
80,Fail,45,44,2,9,36
80,Fail,49,39,0,11,38
80,Fail,49,44,0,6,43
80,Fail,49,34,5,12,37
80,Fail,51,34,4,11,40
80,Fail,44,32,0,20,24
80,Fail,48,34,0,11,37
80,Fail,47,43,0,7,40
80,Fail,46,40,4,10,36
80,Fail,58,30,0,9,49
80,Fail,57,35,0,8,49
80,Fail,53,34,3,10,43
80,Fail,38,43,0,18,20
80,Fail,48,35,6,11,37
80,Fail,44,46,0,9,35
80,Fail,50,31,0,13,37
80,Fail,47,41,2,10,37
80,Fail,50,34,0,14,36
80,Fail,54,31,2,13,41
80,Fail,48,40,0,9,39
80,Fail,51,38,1,10,41
80,Fail,56,26,0,13,43
80,Fail,51,38,0,8,43
80,Fail,54,37,1,8,46
80,Fail,41,35,7,17,24
80,Fail,46,40,0,12,34
80,Fail,46,31,10,13,33
80,Fail,42,36,3,19,23
80,Fail,45,34,5,16,29
80,Fail,47,37,6,10,37
80,Fail,41,42,0,17,24
80,Fail,45,32,9,14,31
80,Fail,47,40,0,10,37
80,Fail,46,36,0,16,30
80,Fail,51,30,3,16,35
80,Fail,47,37,0,8,39
80,Fail,40,41,0,14,26
80,Fail,59,30,4,7,52
80,Fail,47,28,0,16,31
80,Fail,47,34,0,15,32
80,Fail,55,31,4,10,45
80,Fail,49,39,0,12,37
80,Fail,46,39,0,10,36
80,Fail,45,42,0,7,38
80,Fail,51,35,0,11,40
80,Fail,50,41,3,6,44
80,Fail,44,31,0,22,22
80,Fail,52,28,3,17,35
80,Fail,43,39,4,14,29
80,Fail,43,33,0,14,29
80,Fail,51,36,0,11,40
80,Fail,44,44,1,11,33
80,Fail,48,31,0,11,37
80,Fail,41,40,0,12,29
80,Fail,48,32,3,17,31
80,Fail,49,40,0,11,38
80,Fail,51,35,1,13,38
80,Fail,48,40,0,10,38
80,Fail,43,39,0,18,25
80,Fail,56,33,0,8,48
80,Fail,57,32,1,10,47
80,Fail,53,34,4,9,44
80,Fail,49,30,8,13,36
80,Fail,54,34,0,11,43
80,Fail,43,35,5,17,26
80,Fail,45,37,11,7,38
80,Fail,44,41,0,10,34
80,Fail,44,38,3,15,29
80,Fail,45,33,0,13,32
80,Fail,50,30,6,14,36
80,Fail,37,43,4,16,21
80,Fail,44,36,0,16,28
80,Fail,45,30,8,17,28
80,Fail,53,41,1,5,48
80,Fail,49,37,6,8,41
80,Fail,39,39,0,14,25
80,Fail,48,38,0,6,42
80,Fail,49,36,7,8,41
80,Fail,52,37,0,11,41
80,Fail,42,38,7,13,29
80,Fail,48,34,6,12,36
80,Fail,51,31,5,13,38
80,Fail,46,32,7,15,31
80,Fail,45,31,0,15,30
80,Fail,51,34,0,14,37
80,Fail,44,37,6,13,31
80,Fail,46,40,0,13,33
80,Fail,48,31,7,14,34
80,Fail,52,30,0,8,44
80,Fail,57,33,0,8,49
80,Fail,51,35,3,11,40
80,Fail,45,38,4,13,32
80,Fail,46,33,11,10,36
80,Fail,48,39,0,13,35
80,Fail,54,28,10,8,46
80,Fail,45,31,0,11,34
80,Fail,52,25,4,19,33
80,Fail,53,37,0,9,44
80,Fail,50,37,0,12,38
80,Fail,44,42,3,11,33
80,Fail,37,40,8,15,22
80,Fail,48,36,0,16,32
80,Fail,46,30,0,11,35
80,Fail,52,34,4,10,42
80,Fail,45,39,2,14,31
80,Fail,50,33,5,12,38
80,Fail,48,35,6,11,37
80,Fail,45,34,4,17,28
80,Fail,44,38,0,14,30
80,Fail,52,35,0,11,41
80,Fail,50,31,1,18,32
80,Fail,51,39,0,10,41
80,Fail,57,27,0,13,44
80,Fail,51,39,0,10,41
80,Fail,48,35,0,11,37
80,Fail,51,24,9,16,35
80,Fail,45,38,7,10,35
80,Fail,46,35,3,16,30
80,Fail,57,30,3,10,47
80,Fail,51,30,6,13,38
80,Fail,47,31,5,17,30
80,Fail,43,41,1,15,28
80,Fail,48,32,0,16,32
80,Fail,46,32,5,17,29
80,Fail,47,35,5,13,34
80,Fail,43,36,11,10,33
80,Fail,41,39,0,13,28
80,Fail,41,37,0,17,24
80,Fail,44,41,0,14,30
80,Fail,47,36,4,13,34
80,Fail,34,40,0,16,18
80,Fail,53,41,0,6,47
80,Fail,45,31,9,15,30
80,Fail,42,42,4,12,30
80,Fail,57,34,1,8,49
80,Fail,46,36,0,13,33
80,Fail,50,31,4,15,35
80,Fail,50,31,2,17,33
80,Fail,48,37,0,15,33
80,Fail,37,31,0,16,21
80,Fail,53,31,6,10,43
80,Fail,48,33,0,19,29
80,Fail,51,31,3,15,36
80,Fail,47,28,6,19,28
80,Fail,52,36,1,11,41
80,Fail,42,40,0,12,30
80,Fail,49,25,9,17,32
80,Fail,46,37,0,13,33
80,Fail,50,36,0,10,40
80,Fail,47,44,0,9,38
80,Fail,46,36,3,15,31
80,Fail,51,33,0,15,36
80,Fail,54,36,0,10,44
80,Fail,48,38,0,9,39
80,Fail,48,41,0,8,40
80,Fail,49,40,0,11,38
80,Fail,44,37,6,13,31
80,Fail,49,29,8,14,35
80,Fail,47,41,0,12,35
80,Fail,46,41,3,10,36
80,Fail,51,36,0,11,40
80,Fail,58,30,1,11,47
80,Fail,46,35,0,10,36
80,Fail,46,32,6,16,30
80,Fail,54,31,2,13,41
80,Fail,47,42,1,10,37
80,Fail,39,30,0,18,21
80,Fail,51,39,0,9,42
80,Fail,55,27,4,14,41
80,Fail,50,41,4,5,45
80,Fail,45,36,0,15,30
80,Fail,43,38,0,8,35
80,Fail,45,35,0,15,30
80,Fail,49,36,1,14,35
80,Fail,49,34,3,14,35
80,Fail,51,30,3,16,35
80,Fail,51,31,0,14,37
80,Fail,46,35,6,13,33
80,Fail,52,34,0,13,39
80,Fail,45,42,0,11,34
80,Fail,46,26,0,21,25
80,Fail,44,32,9,15,29
80,Fail,44,35,0,16,28
80,Fail,43,39,0,9,34
80,Fail,56,25,0,16,40
80,Fail,48,37,1,14,34
80,Fail,49,33,0,14,35
80,Fail,47,38,1,14,33
80,Fail,45,38,0,14,31
80,Fail,40,31,0,15,25
80,Fail,49,33,2,16,33
80,Fail,55,31,0,12,43
80,Fail,47,30,0,15,32
80,Fail,56,32,0,10,46
80,Fail,48,33,4,15,33
80,Fail,51,29,8,12,39
80,Fail,41,41,2,16,25
80,Fail,48,37,0,12,36
80,Fail,49,34,0,11,38
80,Fail,46,35,7,12,34
80,Fail,50,34,5,11,39
80,Fail,53,33,0,8,45
80,Fail,48,36,4,12,36
80,Fail,50,31,2,17,33
80,Fail,51,35,8,6,45
80,Fail,40,35,0,19,21
80,Fail,48,39,0,13,35
80,Fail,44,32,0,15,29
80,Fail,55,28,3,14,41
80,Fail,45,39,0,11,34
80,Fail,54,36,0,10,44
80,Fail,52,27,0,14,38
80,Fail,52,31,0,16,36
80,Fail,47,33,0,17,30
80,Fail,58,23,0,16,42
80,Fail,48,32,6,14,34
80,Fail,59,27,0,10,49
80,Fail,44,34,0,18,26
80,Fail,48,43,0,9,39
80,Fail,57,33,0,7,50
80,Fail,47,43,0,9,38
80,Fail,48,41,0,11,37
80,Fail,46,41,0,11,35
80,Fail,51,35,3,11,40
80,Fail,44,39,0,11,33
80,Fail,49,34,3,14,35
80,Fail,50,34,1,15,35
80,Fail,49,31,0,7,42
80,Fail,46,40,5,9,37
80,Fail,55,29,0,13,42
80,Fail,35,42,6,17,18
80,Fail,50,32,0,15,35
80,Fail,50,39,0,11,39
80,Fail,56,29,3,12,44
80,Fail,43,39,0,11,32
80,Fail,46,39,0,12,34
80,Fail,55,31,0,11,44
80,Fail,55,31,4,10,45
80,Fail,45,35,0,17,28
80,Fail,51,31,0,15,36
80,Fail,55,36,0,6,49
80,Fail,48,37,0,12,36
80,Fail,43,38,0,17,26
80,Fail,46,41,5,8,38
80,Fail,49,40,0,11,38
80,Fail,44,31,8,17,27
80,Fail,49,30,0,18,31
80,Fail,46,39,2,13,33
80,Fail,46,35,0,12,34
80,Fail,53,32,0,12,41
80,Fail,52,35,0,12,40
80,Fail,44,46,1,9,35
80,Fail,43,38,5,14,29
80,Fail,53,33,0,13,40
80,Fail,52,37,0,11,41
80,Fail,49,33,0,16,33
80,Fail,46,40,0,13,33
80,Fail,56,33,2,9,47
80,Fail,42,40,3,15,27
80,Fail,44,37,0,13,31
80,Fail,43,35,6,16,27
80,Fail,43,37,10,10,33
80,Fail,48,31,0,14,34
80,Fail,53,38,0,9,44
80,Fail,50,35,1,14,36
80,Fail,50,35,2,13,37
80,Fail,48,38,0,12,36
80,Fail,46,35,2,17,29
80,Fail,57,37,0,6,51
80,Fail,49,28,15,8,41
80,Fail,47,34,6,13,34
80,Fail,52,36,0,9,43
80,Fail,53,28,0,15,38
80,Fail,50,39,0,11,39
80,Fail,44,40,0,16,28
80,Fail,47,34,9,10,37
80,Fail,47,35,0,14,33
80,Fail,53,33,0,10,43
80,Fail,51,31,5,13,38
80,Fail,45,28,0,14,31
80,Fail,51,36,1,12,39
80,Fail,53,25,0,16,37
80,Fail,45,43,1,11,34
80,Fail,54,39,1,6,48
80,Fail,47,36,3,14,33
80,Fail,43,42,0,14,29
80,Fail,46,32,8,14,32
80,Fail,49,41,0,10,39
80,Fail,50,37,0,12,38
80,Fail,56,31,2,11,45
80,Fail,56,32,3,9,47
80,Fail,47,30,0,16,31
80,Fail,44,39,2,15,29
80,Fail,49,39,3,9,40
80,Fail,42,38,5,15,27
80,Fail,48,33,0,14,34
80,Fail,44,36,8,12,32
80,Fail,43,44,0,11,32
80,Fail,44,39,0,16,28
80,Fail,48,32,0,13,35
80,Fail,50,27,0,12,38
80,Fail,46,37,0,14,32
80,Fail,41,48,0,11,30
80,Fail,44,40,0,15,29
80,Fail,47,33,0,17,30
80,Fail,54,31,7,8,46
80,Fail,43,34,0,16,27
80,Fail,50,33,2,15,35
80,Fail,46,43,1,10,36
80,Fail,46,36,0,14,32
80,Fail,52,34,2,12,40
80,Fail,49,39,0,12,37
80,Fail,49,42,0,5,44
80,Fail,56,32,1,11,45
80,Fail,51,35,0,10,41
80,Fail,42,37,4,17,25
80,Fail,36,48,0,14,22
80,Fail,44,40,0,14,30
80,Fail,55,29,5,11,44
80,Fail,47,37,0,14,33
80,Fail,52,34,0,13,39
80,Fail,60,29,0,11,49
80,Fail,49,38,3,10,39
80,Fail,50,41,0,8,42
80,Fail,45,36,0,14,31
80,Fail,49,39,0,10,39
80,Fail,56,25,0,16,40
80,Fail,47,42,0,8,39
80,Fail,47,37,4,12,35
80,Fail,51,35,0,8,43
80,Fail,45,26,6,23,22
80,Fail,43,37,0,11,32
80,Fail,44,37,9,10,34
80,Fail,51,36,2,11,40
80,Fail,46,37,5,12,34
80,Fail,57,29,0,11,46
80,Fail,49,38,0,10,39
80,Fail,46,37,2,15,31
80,Fail,55,36,0,8,47
80,Fail,52,37,1,10,42
80,Fail,44,39,7,10,34
80,Fail,45,33,1,21,24
80,Fail,46,34,2,18,28
80,Fail,57,30,3,10,47
80,Fail,53,29,0,12,41
80,Fail,51,30,0,13,38
80,Fail,49,39,0,9,40
80,Fail,39,42,0,17,22
80,Fail,42,39,0,13,29
80,Fail,47,35,7,11,36
80,Fail,49,35,3,13,36
80,Fail,51,36,0,11,40
80,Fail,52,28,0,17,35
80,Fail,48,36,2,14,34
80,Fail,53,27,4,16,37
80,Fail,45,34,4,17,28
80,Fail,55,36,3,6,49
80,Fail,50,32,8,10,40
80,Fail,48,36,0,14,34
80,Fail,43,36,6,15,28
80,Fail,39,46,6,9,30
80,Fail,45,34,0,13,32
80,Fail,48,36,3,13,35
80,Fail,40,45,0,14,26
80,Fail,39,45,5,11,28
80,Fail,47,28,5,20,27
80,Fail,43,44,3,10,33
80,Fail,47,37,2,14,33
80,Fail,46,37,0,12,34
80,Fail,44,40,4,12,32
80,Fail,44,38,1,17,27
80,Fail,44,44,1,11,33
80,Fail,45,41,0,14,31
80,Fail,43,42,0,15,28
80,Fail,45,36,3,16,29
80,Fail,47,45,1,7,40
80,Fail,51,27,6,16,35
80,Fail,48,34,7,11,37
80,Fail,52,36,0,8,44
80,Fail,51,36,0,13,38
80,Fail,46,29,0,20,26
80,Fail,42,40,1,17,25
80,Fail,47,35,0,10,37
80,Fail,52,39,1,8,44
80,Fail,56,35,0,7,49
80,Fail,54,24,0,17,37
80,Fail,52,31,2,15,37
80,Fail,42,35,8,15,27
80,Fail,49,36,0,14,35
80,Fail,51,37,2,10,41
80,Fail,58,30,0,12,46
80,Fail,47,34,0,15,32
80,Fail,58,26,1,15,43
80,Fail,42,43,2,13,29
80,Fail,47,32,5,16,31
80,Fail,50,32,0,14,36
80,Fail,51,32,0,12,39
80,Fail,50,36,0,9,41
80,Fail,54,34,3,9,45
80,Fail,39,40,8,13,26
80,Fail,54,33,0,12,42
80,Fail,48,36,3,13,35
80,Fail,53,32,5,10,43
80,Fail,46,41,0,11,35
80,Fail,46,38,0,13,33
80,Fail,48,38,0,7,41
80,Fail,46,36,0,18,28
80,Fail,43,36,0,17,26
80,Fail,44,41,0,9,35
80,Fail,52,31,7,10,42
80,Fail,51,28,3,18,33
80,Fail,56,36,0,5,51
80,Fail,51,34,2,13,38
80,Fail,47,40,1,12,35
80,Fail,48,42,0,7,41
80,Fail,50,39,0,10,40
80,Fail,45,36,0,13,32
80,Fail,41,45,0,11,30
80,Fail,42,38,0,14,28
80,Fail,49,38,0,11,38
80,Fail,50,38,0,9,41
80,Fail,52,31,0,10,42
90,Fail,45,41,0,9,36
90,Fail,48,38,0,13,35
90,Fail,45,46,0,9,36
90,Fail,55,33,1,11,44
90,Fail,56,32,0,9,47
90,Fail,49,34,7,10,39
90,Fail,47,37,0,14,33
90,Fail,40,36,9,15,25
90,Fail,54,36,0,10,44
90,Fail,47,37,0,12,35
90,Fail,48,31,0,10,38
90,Fail,49,37,0,10,39
90,Fail,46,42,1,11,35
90,Fail,53,28,0,10,43
90,Fail,46,23,0,22,24
90,Fail,45,36,3,16,29
90,Fail,55,31,3,11,44
90,Fail,42,31,0,16,26
90,Fail,56,33,0,9,47
90,Fail,50,31,0,15,35
90,Fail,40,40,6,14,26
90,Fail,42,36,0,18,24
90,Fail,42,40,7,11,31
90,Fail,41,36,4,19,22
90,Fail,51,29,6,14,37
90,Fail,48,34,4,14,34
90,Fail,50,39,1,10,40
90,Fail,46,46,1,7,39
90,Fail,41,35,0,17,24
90,Fail,48,41,0,9,39
90,Fail,50,34,7,9,41
90,Fail,46,43,0,9,37
90,Fail,51,35,0,9,42
90,Fail,51,30,0,13,38
90,Fail,52,34,3,11,41
90,Fail,48,36,0,13,35
90,Fail,52,38,2,8,44
90,Fail,46,39,2,13,33
90,Fail,44,39,0,12,32
90,Fail,53,35,0,11,42
90,Fail,48,34,0,12,36
90,Fail,46,33,10,11,35
90,Fail,47,39,0,11,36
90,Fail,56,30,0,7,49
90,Fail,43,34,6,17,26
90,Fail,54,34,1,11,43
90,Fail,56,27,0,13,43
90,Fail,52,27,9,12,40
90,Fail,44,38,3,15,29
90,Fail,51,34,4,11,40
90,Fail,46,36,0,14,32
90,Fail,51,34,7,8,43
90,Fail,55,31,0,13,42
90,Fail,52,33,0,8,44
90,Fail,43,35,5,17,26
90,Fail,55,31,0,13,42
90,Fail,52,33,0,9,43
90,Fail,44,36,0,14,30
90,Fail,47,37,4,12,35
90,Fail,46,31,6,17,29
90,Fail,54,34,0,12,42
90,Fail,46,40,1,13,33
90,Fail,55,22,0,10,45
90,Fail,49,32,0,11,38
90,Fail,47,37,0,11,36
90,Fail,40,50,0,10,30
90,Fail,49,29,5,17,32
90,Fail,45,35,0,19,26
90,Fail,42,39,0,14,28
90,Fail,50,34,3,13,37
90,Fail,46,41,4,9,37
90,Fail,50,36,0,11,39
90,Fail,53,32,2,13,40
90,Fail,55,37,0,8,47
90,Fail,49,33,8,10,39
90,Fail,52,39,0,8,44
90,Fail,48,36,0,11,37
90,Fail,45,36,0,14,31
90,Fail,50,42,0,6,44
90,Fail,51,31,4,14,37
90,Fail,54,31,0,10,44
90,Fail,55,35,0,9,46
90,Fail,45,36,4,15,30
90,Fail,50,30,7,13,37
90,Fail,58,26,1,15,43
90,Fail,51,38,2,9,42
90,Fail,50,39,0,11,39
90,Fail,44,41,0,13,31
90,Fail,41,36,7,16,25
90,Fail,48,33,0,14,34
90,Fail,41,39,3,17,24
90,Fail,45,43,0,11,34
90,Fail,45,43,2,10,35
90,Fail,45,36,1,18,27
90,Fail,46,41,0,11,35
90,Fail,49,31,3,17,32
90,Fail,41,39,1,19,22
90,Fail,51,38,1,10,41
90,Fail,51,39,3,7,44
90,Fail,46,36,0,15,31
90,Fail,51,34,5,10,41
90,Fail,51,38,5,6,45
90,Fail,49,28,8,15,34
90,Fail,53,30,6,11,42
90,Fail,50,32,0,15,35
90,Fail,48,36,0,14,34
90,Fail,51,27,0,11,40
90,Fail,34,40,0,16,18
90,Fail,49,36,0,12,37
90,Fail,44,42,0,11,33
90,Fail,49,25,6,20,29
90,Fail,43,42,3,12,31
90,Fail,47,33,8,12,35
90,Fail,47,39,1,13,34
90,Fail,51,33,1,15,36
90,Fail,59,28,2,11,48
90,Fail,57,33,0,8,49
90,Fail,53,22,0,20,33
90,Fail,45,38,1,16,29
90,Fail,54,31,0,14,40
90,Fail,41,45,1,13,28
90,Fail,47,31,0,18,29
90,Fail,47,34,0,16,31
90,Fail,49,35,0,16,33
90,Fail,46,36,2,16,30
90,Fail,58,31,0,10,48
90,Fail,45,43,0,11,34
90,Fail,52,40,0,7,45
90,Fail,41,36,9,14,27
90,Fail,49,34,3,14,35
90,Fail,49,32,0,18,31
90,Fail,62,31,2,5,57
90,Fail,48,38,1,13,35
90,Fail,43,34,0,15,28
90,Fail,39,43,0,14,25
90,Fail,46,37,0,14,32
90,Fail,52,34,0,12,40
90,Fail,43,40,4,13,30
90,Fail,46,41,0,8,38
90,Fail,49,32,0,19,30
90,Fail,47,38,0,13,34
90,Fail,45,36,9,10,35
90,Fail,51,35,0,11,40
90,Fail,48,33,6,13,35
90,Fail,42,40,0,12,30
90,Fail,43,40,7,10,33
90,Fail,46,36,3,15,31
90,Fail,54,29,0,11,43
90,Fail,53,32,0,9,44
90,Fail,52,33,5,10,42
90,Fail,50,34,3,13,37
90,Fail,54,40,0,5,49
90,Fail,40,43,4,13,27
90,Fail,46,35,3,16,30
90,Fail,43,37,0,10,33
90,Fail,45,40,0,14,31
90,Fail,49,36,1,14,35
90,Fail,48,37,0,15,33
90,Fail,51,37,0,10,41
90,Fail,43,42,6,9,34
90,Fail,50,37,4,9,41
90,Fail,43,44,1,12,31
90,Fail,48,37,5,10,38
90,Fail,38,35,0,20,18
90,Fail,49,33,0,14,35
90,Fail,57,33,2,8,49
90,Fail,46,40,0,13,33
90,Fail,47,37,0,5,42
90,Fail,51,41,0,7,44
90,Fail,47,34,0,17,30
90,Fail,48,39,1,12,36
90,Fail,47,47,0,3,44
90,Fail,50,33,4,13,37
90,Fail,39,40,1,20,19
90,Fail,50,30,3,17,33
90,Fail,46,41,3,10,36
90,Fail,48,41,0,10,38
90,Fail,47,35,0,16,31
90,Fail,58,28,0,12,46
90,Fail,48,35,0,12,36
90,Fail,52,29,2,17,35
90,Fail,38,41,0,15,23
90,Fail,53,31,5,11,42
90,Fail,51,34,3,12,39
90,Fail,48,32,0,19,29
90,Fail,48,32,4,16,32
90,Fail,49,32,0,17,32
90,Fail,44,32,0,18,26
90,Fail,48,32,2,18,30
90,Fail,53,40,2,5,48
90,Fail,48,36,0,10,38
90,Fail,45,39,1,15,30
90,Fail,48,42,2,8,40
90,Fail,48,30,0,18,30
90,Fail,44,35,8,13,31
90,Fail,50,35,2,13,37
90,Fail,48,40,3,9,39
90,Fail,46,31,0,17,29
90,Fail,49,36,3,12,37
90,Fail,50,30,8,12,38
90,Fail,50,28,0,18,32
90,Fail,51,36,3,10,41
90,Fail,51,29,4,16,35
90,Fail,51,34,2,13,38
90,Fail,46,39,2,13,33
90,Fail,44,32,10,14,30
90,Fail,54,28,0,14,40
90,Fail,55,29,0,11,44
90,Fail,55,33,0,11,44
90,Fail,49,28,3,20,29
90,Fail,49,40,0,11,38
90,Fail,54,26,3,17,37
90,Fail,45,36,0,15,30
90,Fail,50,32,0,13,37
90,Fail,50,39,3,8,42
90,Fail,50,34,0,16,34
90,Fail,44,39,0,14,30
90,Fail,43,37,4,16,27
90,Fail,51,39,0,6,45
90,Fail,43,36,0,17,26
90,Fail,46,38,3,13,33
90,Fail,49,36,0,9,40
90,Fail,39,45,5,11,28
90,Fail,48,37,2,13,35
90,Fail,42,39,0,13,29
90,Fail,48,40,0,7,41
90,Fail,49,32,4,15,34
90,Fail,47,41,4,8,39
90,Fail,49,38,1,12,37
90,Fail,42,39,4,15,27
90,Fail,48,33,0,16,32
90,Fail,43,31,16,10,33
90,Fail,50,33,5,12,38
90,Fail,51,34,0,15,36
90,Fail,48,38,1,13,35
90,Fail,52,38,0,10,42
90,Fail,46,32,0,12,34
90,Fail,45,41,0,11,34
90,Fail,54,36,1,9,45
90,Fail,46,45,2,7,39
90,Fail,44,36,0,15,29
90,Fail,44,39,8,9,35
90,Fail,51,40,2,7,44
90,Fail,46,35,0,13,33
90,Fail,35,48,3,14,21
90,Fail,56,34,0,10,46
90,Fail,41,33,11,15,26
90,Fail,54,34,5,7,47
90,Fail,46,36,8,10,36
90,Fail,44,43,4,9,35
90,Fail,54,33,0,12,42
90,Fail,42,38,8,12,30
90,Fail,41,32,13,14,27
90,Fail,46,39,1,14,32
90,Fail,46,39,0,15,31
90,Fail,45,35,5,15,30
90,Fail,46,36,5,13,33
90,Fail,47,37,0,12,35
90,Fail,48,37,0,13,35
90,Fail,42,42,0,16,26
90,Fail,47,36,5,12,35
90,Fail,43,30,14,13,30
90,Fail,49,31,0,18,31
90,Fail,56,35,0,9,47
90,Fail,51,31,7,11,40
90,Fail,49,34,0,15,34
90,Fail,48,41,0,11,37
90,Fail,50,35,2,13,37
90,Fail,47,39,1,13,34
90,Fail,47,41,0,10,37
90,Fail,39,41,0,17,22
90,Fail,54,36,4,6,48
90,Fail,43,36,0,12,31
90,Fail,49,32,6,13,36
90,Fail,49,40,1,10,39
90,Fail,58,33,0,9,49
90,Fail,48,39,7,6,42
90,Fail,49,33,0,17,32
90,Fail,49,32,10,9,40
90,Fail,46,38,0,12,34
90,Fail,52,31,2,15,37
90,Fail,45,39,2,14,31
90,Fail,53,32,0,14,39
90,Fail,47,35,0,15,32
90,Fail,46,34,6,14,32
90,Fail,53,31,0,14,39
90,Fail,51,32,0,12,39
90,Fail,47,39,0,14,33
90,Fail,46,39,0,15,31
90,Fail,55,40,0,5,50
90,Fail,49,35,0,7,42
90,Fail,45,31,9,15,30
90,Fail,53,33,0,6,47
90,Fail,53,37,2,8,45
90,Fail,41,41,0,14,27
90,Fail,46,36,0,16,30
90,Fail,40,42,7,11,29
90,Fail,46,33,6,15,31
90,Fail,52,26,0,16,36
90,Fail,48,37,1,14,34
90,Fail,38,36,0,17,21
90,Fail,42,41,0,17,25
90,Fail,51,36,3,10,41
90,Fail,45,30,0,17,28
90,Fail,52,31,7,10,42
90,Fail,47,32,6,15,32
90,Fail,47,37,0,14,33
90,Fail,51,34,0,8,43
90,Fail,48,34,1,17,31
90,Fail,46,39,0,14,32
90,Fail,48,30,0,17,31
90,Fail,45,42,0,8,37
90,Fail,49,33,3,15,34
90,Fail,47,35,10,8,39
90,Fail,50,41,0,8,42
90,Fail,51,38,0,9,42
90,Fail,51,35,1,13,38
90,Fail,51,36,0,9,42
90,Fail,52,35,3,10,42
90,Fail,50,37,0,8,42
90,Fail,48,34,0,13,35
90,Fail,44,40,2,14,30
90,Fail,46,34,6,14,32
90,Fail,45,37,0,13,32
90,Fail,43,40,2,15,28
90,Fail,50,34,0,13,37
90,Fail,50,37,0,11,39
90,Fail,54,29,0,17,37
90,Fail,48,38,0,5,43
90,Fail,43,34,5,18,25
90,Fail,51,33,3,13,38
90,Fail,47,38,0,14,33
90,Fail,45,43,0,12,33
90,Fail,44,33,0,12,32
90,Fail,50,40,0,10,40
90,Fail,45,30,4,21,24
90,Fail,50,35,0,13,37
90,Fail,43,38,0,12,31
90,Fail,55,31,0,14,41
90,Fail,44,35,0,15,29
90,Fail,46,33,10,11,35
90,Fail,49,37,0,14,35
90,Fail,40,39,10,11,29
90,Fail,53,29,0,14,39
90,Fail,44,42,1,13,31
90,Fail,51,32,0,13,38
90,Fail,41,36,12,11,30
90,Fail,45,34,8,13,32
90,Fail,49,34,0,13,36
90,Fail,49,40,3,8,41
90,Fail,54,35,4,7,47
90,Fail,53,33,0,14,39
90,Fail,49,38,1,12,37
90,Fail,45,35,0,13,32
90,Fail,49,36,0,13,36
90,Fail,47,40,0,12,35
90,Fail,40,41,12,7,33
90,Fail,45,32,13,10,35
90,Fail,54,34,0,12,42
90,Fail,44,40,2,14,30
90,Fail,45,43,0,10,35
90,Fail,47,40,0,13,34
90,Fail,50,34,0,9,41
90,Fail,44,40,1,15,29
90,Fail,53,34,3,10,43
90,Fail,45,35,0,15,30
90,Fail,53,36,5,6,47
90,Fail,51,33,0,15,36
90,Fail,49,36,0,10,39
90,Fail,51,35,5,9,42
90,Fail,46,39,0,9,37
90,Fail,55,33,1,11,44
90,Fail,47,34,4,15,32
90,Fail,40,33,8,19,21
90,Fail,52,33,5,10,42
90,Fail,41,38,3,18,23
90,Fail,55,28,2,15,40
90,Fail,51,35,0,7,44
90,Fail,47,32,6,15,32
90,Fail,53,31,6,10,43
90,Fail,42,44,0,8,34
90,Fail,47,41,4,8,39
90,Fail,43,40,4,13,30
90,Fail,50,40,0,7,43
90,Fail,43,42,2,13,30
90,Fail,53,34,0,13,40
90,Fail,48,34,2,16,32
90,Fail,52,38,0,10,42
90,Fail,46,37,3,14,32
90,Fail,52,32,1,15,37
90,Fail,42,42,8,8,34
90,Fail,46,25,10,19,27
90,Fail,45,39,0,14,31
90,Fail,49,34,0,8,41
90,Fail,45,39,0,13,32
90,Fail,56,29,0,13,43
90,Fail,47,34,3,16,31
90,Fail,42,35,7,16,26
90,Fail,51,38,0,11,40
90,Fail,42,40,0,13,29
90,Fail,39,38,6,17,22
90,Fail,58,26,0,7,51
90,Fail,46,41,0,12,34
90,Fail,43,44,3,10,33
90,Fail,45,40,0,13,32
90,Fail,52,39,0,9,43
90,Fail,52,33,0,10,42
90,Fail,46,40,0,8,38
90,Fail,50,31,2,17,33
90,Fail,47,38,0,14,33
90,Fail,50,34,0,11,39
90,Fail,51,30,6,13,38
90,Fail,48,40,1,11,37
90,Fail,55,34,3,8,47
90,Fail,47,30,3,20,27
90,Fail,45,41,0,11,34
90,Fail,46,41,0,7,39
90,Fail,48,35,0,13,35
90,Fail,48,37,2,13,35
90,Fail,45,38,0,9,36
90,Fail,41,33,0,17,24
90,Fail,47,39,0,9,38
90,Fail,43,39,0,16,27
90,Fail,53,34,0,13,40
90,Fail,47,36,6,11,36
90,Fail,42,43,0,11,31
90,Fail,45,31,0,17,28
90,Fail,50,35,0,8,42
90,Fail,46,37,2,15,31
90,Fail,46,37,0,12,34
90,Fail,53,38,0,9,44
90,Fail,47,36,4,13,34
90,Fail,40,41,0,17,23
90,Fail,47,36,0,11,36
90,Fail,47,37,4,12,35
90,Fail,45,31,0,13,32
90,Fail,48,32,0,16,32
90,Fail,34,41,8,17,17
90,Fail,49,36,5,10,39
90,Fail,54,32,0,14,40
90,Fail,47,36,0,10,37
90,Fail,49,36,5,10,39
90,Fail,50,35,0,15,35
90,Fail,55,31,0,12,43
90,Fail,50,32,3,15,35
90,Fail,53,25,0,18,35
90,Fail,50,31,2,17,33
90,Fail,45,40,1,14,31
90,Fail,43,38,0,10,33
90,Fail,47,41,0,12,35
90,Fail,49,33,3,15,34
90,Fail,53,28,0,16,37
90,Fail,41,44,4,11,30
90,Fail,51,33,4,12,39
90,Fail,51,32,2,15,36
90,Fail,54,32,3,11,43
90,Fail,53,30,0,13,40
90,Fail,51,31,9,9,42
90,Fail,47,32,9,12,35
90,Fail,47,36,5,12,35
90,Fail,52,28,0,14,38
90,Fail,54,28,8,10,44
90,Fail,50,35,3,12,38
90,Fail,39,38,0,14,25
90,Fail,54,27,0,12,42
90,Fail,42,40,0,17,25
90,Fail,43,36,0,17,26
90,Fail,55,27,1,17,38
90,Fail,52,35,0,11,41
90,Fail,45,37,0,11,34
90,Fail,47,38,0,11,36
90,Fail,52,25,7,16,36
90,Fail,46,41,1,12,34
90,Fail,50,30,0,15,35
90,Fail,43,37,2,18,25
90,Fail,48,30,0,17,31
90,Fail,49,33,0,13,36
90,Fail,46,36,6,12,34
90,Fail,47,40,1,12,35
90,Fail,49,40,3,8,41
90,Fail,59,27,1,13,46
90,Fail,56,36,2,6,50
90,Fail,55,32,0,12,43
90,Fail,48,40,0,9,39
90,Fail,48,35,0,11,37
90,Fail,53,34,0,13,40
90,Fail,52,37,0,11,41
90,Fail,43,41,0,13,30
90,Fail,47,39,0,11,36
90,Fail,51,36,0,11,40
90,Fail,49,35,5,11,38
90,Fail,51,35,4,10,41
90,Fail,56,36,0,5,51
90,Fail,48,39,0,8,40
90,Fail,51,39,1,9,42
90,Fail,44,33,0,11,33
90,Fail,56,36,0,7,49
90,Fail,45,40,4,11,34
90,Fail,46,39,3,12,34
90,Fail,51,29,0,14,37
90,Fail,44,43,3,10,34
90,Fail,52,30,0,18,34
90,Fail,49,29,4,18,31
90,Fail,47,40,2,11,36
90,Fail,53,34,1,12,41
90,Fail,44,35,6,15,29
90,Fail,48,38,0,13,35
90,Fail,43,40,2,15,28
90,Fail,41,30,10,19,22
90,Fail,56,34,0,8,48
90,Fail,44,31,0,13,31
90,Fail,48,38,0,14,34
90,Fail,47,34,7,12,35
90,Fail,45,31,6,18,27
90,Fail,51,41,0,8,43
90,Fail,36,44,5,15,21
90,Fail,53,37,2,8,45
90,Fail,47,38,3,12,35
90,Fail,42,40,0,15,27
90,Fail,42,34,0,15,27
90,Fail,47,41,1,11,36
90,Fail,51,37,2,10,41
90,Fail,51,30,6,13,38
90,Fail,47,39,0,9,38
90,Fail,51,35,0,14,37
90,Fail,54,34,0,9,45
90,Fail,45,34,3,18,27
90,Fail,53,33,2,12,41
90,Fail,52,32,4,12,40
90,Fail,47,36,4,13,34
90,Fail,42,40,0,13,29
90,Fail,55,36,0,6,49
90,Fail,50,36,1,13,37
90,Fail,52,26,10,12,40
90,Fail,52,37,3,8,44
90,Fail,48,38,0,14,34
90,Fail,51,36,2,11,40
90,Fail,47,33,7,13,34
90,Fail,49,39,0,9,40
90,Fail,45,38,6,11,34
90,Fail,44,42,0,14,30
90,Fail,51,36,0,11,40
90,Fail,52,37,0,11,41
90,Fail,47,29,0,22,25
90,Fail,58,26,3,13,45
90,Fail,51,34,0,14,37
90,Fail,46,28,0,18,28
90,Fail,43,39,0,12,31
90,Fail,48,35,1,16,32
90,Fail,45,35,4,16,29
90,Fail,42,42,0,12,30
90,Fail,56,34,0,9,47
90,Fail,54,26,0,11,43
90,Fail,48,35,7,10,38
90,Fail,47,29,4,20,27
90,Fail,46,30,7,17,29
90,Fail,40,38,3,19,21
90,Fail,55,34,0,11,44
90,Fail,44,37,0,17,27
90,Fail,51,30,1,18,33
90,Fail,48,42,0,8,40
90,Fail,51,31,3,15,36
90,Fail,48,34,3,15,33
90,Fail,42,36,0,16,26
90,Fail,44,39,0,15,29
90,Fail,39,39,14,8,31
90,Fail,48,42,0,9,39
90,Fail,43,38,5,14,29
90,Fail,51,37,0,7,44
90,Fail,45,33,9,13,32
90,Fail,47,40,0,7,40
90,Fail,44,31,8,17,27
90,Fail,49,31,1,19,30
90,Fail,54,31,0,14,40
90,Fail,50,32,0,11,39
90,Fail,45,30,6,19,26
90,Fail,50,35,6,9,41
90,Fail,48,42,0,10,38
90,Fail,39,38,0,14,25
90,Fail,49,42,1,8,41
90,Fail,47,40,2,11,36
90,Fail,50,32,0,15,35
90,Fail,47,35,0,13,34
90,Fail,49,33,0,16,33
90,Fail,57,35,0,5,52
90,Fail,45,43,0,10,35
90,Fail,53,34,0,8,45
90,Fail,43,39,1,17,26
90,Fail,38,37,0,12,26
90,Fail,46,36,3,15,31
90,Fail,45,42,0,12,33
90,Fail,41,35,0,18,23
90,Fail,52,42,1,5,47
90,Fail,45,39,0,14,31
90,Fail,51,33,0,15,36
90,Fail,55,36,0,9,46
90,Fail,50,36,0,10,40
90,Fail,47,33,6,14,33
90,Fail,48,34,8,10,38
90,Fail,55,32,3,10,45
90,Fail,51,28,6,15,36
90,Fail,45,36,0,13,32
90,Fail,55,34,0,11,44
90,Fail,47,35,5,13,34
90,Fail,41,36,0,9,32
90,Fail,47,38,4,11,36
90,Fail,45,38,4,13,32
90,Fail,45,36,0,15,30
90,Fail,46,38,0,14,32
90,Fail,52,35,1,12,40
90,Fail,52,30,0,13,39
90,Fail,53,31,0,9,44
90,Fail,48,40,1,11,37
90,Fail,47,33,7,13,34
90,Fail,59,24,4,13,46
90,Fail,50,33,0,17,33
90,Fail,41,36,2,21,20
90,Fail,47,37,0,11,36
90,Fail,48,40,0,10,38
90,Fail,51,40,0,7,44
90,Fail,50,38,0,9,41
90,Fail,52,34,1,13,39
90,Fail,48,39,0,10,38
90,Fail,48,39,0,12,36
90,Fail,49,42,0,8,41
90,Fail,45,37,0,16,29
90,Fail,45,37,0,18,27
90,Fail,47,40,0,12,35
90,Fail,43,38,3,16,27
90,Fail,47,31,3,19,28
90,Fail,49,37,2,12,37
90,Fail,57,29,0,7,50
90,Fail,43,43,2,12,31
90,Fail,53,37,3,7,46
90,Fail,44,38,0,17,27
90,Fail,44,41,2,13,31
90,Fail,43,38,0,15,28
90,Fail,49,37,0,12,37
90,Fail,44,40,5,11,33
90,Fail,38,41,11,10,28
90,Fail,54,35,2,9,45
90,Fail,44,35,8,13,31
90,Fail,47,31,0,13,34
90,Fail,49,36,0,11,38
90,Fail,50,36,2,12,38
90,Fail,43,37,8,12,31
90,Fail,47,38,5,10,37
90,Fail,43,35,0,17,26
90,Fail,59,27,1,13,46
90,Fail,44,37,2,17,27
90,Fail,46,36,5,13,33
90,Fail,47,37,0,14,33
90,Fail,49,36,0,10,39
90,Fail,50,35,0,13,37
90,Fail,38,41,0,14,24
90,Fail,52,31,1,16,36
90,Fail,44,30,0,18,26
90,Fail,46,40,0,14,32
90,Fail,49,33,1,17,32
90,Fail,54,35,1,10,44
90,Fail,48,30,0,17,31
90,Fail,51,34,0,13,38
90,Fail,51,37,6,6,45
90,Fail,53,35,0,11,42
90,Fail,45,35,0,13,32
90,Fail,56,32,1,11,45
90,Fail,46,39,0,9,37
90,Fail,44,40,0,12,32
90,Fail,54,40,0,6,48
90,Fail,44,36,0,19,25
90,Fail,50,31,2,17,33
90,Fail,45,40,9,6,39
90,Fail,45,41,1,13,32
90,Fail,43,39,2,16,27
90,Fail,50,34,0,15,35
90,Fail,52,36,1,11,41
90,Fail,55,34,4,7,48
90,Fail,42,36,0,14,28
90,Fail,52,30,0,14,38
90,Fail,44,40,0,11,33
90,Fail,53,34,3,10,43
90,Fail,52,35,0,9,43
90,Fail,44,43,0,10,34
90,Fail,47,30,14,9,38
90,Fail,42,36,0,18,24
90,Fail,46,35,0,10,36
90,Fail,41,38,11,10,31
90,Fail,43,30,9,18,25
90,Fail,44,37,0,14,30
90,Fail,50,37,1,12,38
90,Fail,48,38,0,9,39
90,Fail,49,27,0,13,36
90,Fail,44,30,11,15,29
90,Fail,50,41,0,9,41
90,Fail,44,41,0,12,32
90,Fail,54,32,0,9,45
90,Fail,47,37,4,12,35
90,Fail,48,38,4,10,38
90,Fail,49,35,2,14,35
90,Fail,47,39,0,11,36
90,Fail,43,38,1,18,25
90,Fail,44,42,0,13,31
90,Fail,46,39,0,15,31
90,Fail,57,28,4,11,46
90,Fail,54,36,0,9,45
90,Fail,48,35,0,12,36
90,Fail,47,36,0,11,36
90,Fail,60,33,0,5,55
90,Fail,50,28,12,10,40
90,Fail,45,30,0,15,30
90,Fail,49,25,9,17,32
90,Fail,41,37,0,14,27
90,Fail,52,32,0,12,40
90,Fail,50,41,0,9,41
90,Fail,51,33,7,9,42
90,Fail,40,42,0,12,28
90,Fail,52,31,0,13,39
90,Fail,52,36,0,11,41
90,Fail,52,35,0,10,42
90,Fail,44,37,0,18,26
90,Fail,35,49,4,12,23
90,Fail,46,37,6,11,35
90,Fail,50,40,0,9,41
90,Fail,45,30,7,18,27
90,Fail,46,39,1,14,32
90,Fail,58,30,0,9,49
90,Fail,44,39,4,13,31
90,Fail,48,31,0,20,28
90,Fail,48,37,5,10,38
90,Fail,51,33,0,16,35
90,Fail,53,30,4,13,40
90,Fail,46,39,2,13,33
90,Fail,57,25,6,12,45
90,Fail,53,28,0,18,35
90,Fail,46,34,0,16,30
90,Fail,47,39,0,14,33
90,Fail,40,31,8,21,19
90,Fail,51,38,0,9,42
90,Fail,49,39,0,11,38
90,Fail,45,43,0,12,33
90,Fail,50,31,0,18,32
90,Fail,49,31,3,17,32
90,Fail,49,37,2,12,37
90,Fail,58,28,0,14,44
90,Fail,56,34,0,8,48
90,Fail,47,37,0,14,33
90,Fail,52,34,0,14,38
90,Fail,44,36,0,14,30
90,Fail,45,35,3,17,28
90,Fail,48,35,0,13,35
90,Fail,49,39,3,9,40
90,Fail,51,29,5,15,36
90,Fail,45,42,0,12,33
90,Fail,43,39,0,14,29
90,Fail,42,32,16,10,32
90,Fail,51,35,1,13,38
90,Fail,51,31,4,14,37
90,Fail,49,36,2,13,36
90,Fail,49,31,0,15,34
90,Fail,52,29,0,12,40
90,Fail,46,41,0,8,38
90,Fail,53,35,0,11,42
90,Fail,43,35,4,18,25
90,Fail,44,38,4,14,30
90,Fail,44,36,0,9,35
90,Fail,45,32,0,15,30
90,Fail,51,32,0,12,39
90,Fail,56,32,2,10,46
90,Fail,47,38,2,13,34
90,Fail,45,42,4,9,36
90,Fail,44,46,1,9,35
90,Fail,46,39,4,11,35
90,Fail,54,32,0,11,43
90,Fail,44,43,0,8,36
90,Fail,46,38,5,11,35
90,Fail,41,37,0,13,28
90,Fail,47,39,0,10,37
90,Fail,55,34,0,9,46
90,Fail,51,42,0,7,44
90,Fail,47,36,0,13,34
90,Fail,51,39,0,10,41
90,Fail,53,24,8,15,38
90,Fail,53,34,0,12,41
90,Fail,53,33,1,13,40
90,Fail,44,36,0,17,27
90,Fail,45,27,0,16,29
90,Fail,42,38,0,17,25
90,Fail,47,29,6,18,29
90,Fail,47,37,0,13,34
90,Fail,48,37,3,12,36
90,Fail,48,38,3,11,37
90,Fail,53,34,1,12,41
90,Fail,56,30,3,11,45
90,Fail,49,37,1,13,36
90,Fail,50,42,1,7,43
90,Fail,44,31,0,14,30
90,Fail,50,37,0,10,40
90,Fail,50,30,0,15,35
90,Fail,48,32,8,12,36
90,Fail,52,35,0,10,42
90,Fail,44,34,7,15,29
90,Fail,42,34,8,16,26
90,Fail,47,42,3,8,39
90,Fail,50,31,0,18,32
90,Fail,46,38,2,14,32
90,Fail,45,36,9,10,35
90,Fail,45,38,0,12,33
90,Fail,44,40,6,10,34
90,Fail,43,36,7,14,29
90,Fail,49,36,0,14,35
90,Fail,50,29,8,13,37
90,Fail,53,31,6,10,43
90,Fail,42,40,3,15,27
90,Fail,51,33,0,12,39
90,Fail,53,30,1,16,37
90,Fail,49,34,6,11,38
90,Fail,46,34,0,19,27
90,Fail,50,31,10,9,41
90,Fail,54,38,2,6,48
90,Fail,42,36,7,15,27
90,Fail,51,34,1,14,37
90,Fail,51,30,7,12,39
90,Fail,41,43,3,13,28
90,Fail,54,32,4,10,44
90,Fail,57,32,0,10,47
90,Fail,45,27,0,13,32
90,Fail,44,36,0,14,30
90,Fail,56,26,3,15,41
90,Fail,53,35,0,7,46
90,Fail,43,41,0,13,30
90,Fail,39,44,1,16,23
90,Fail,50,32,4,14,36
90,Fail,45,40,0,12,33
90,Fail,44,39,8,9,35
90,Fail,57,33,0,8,49
90,Fail,45,38,0,13,32
90,Fail,45,38,8,9,36
90,Fail,48,34,6,12,36
90,Fail,44,36,4,16,28
90,Fail,50,32,0,18,32
90,Fail,50,38,0,12,38
90,Fail,49,33,2,16,33
90,Fail,50,40,0,10,40
90,Fail,47,34,0,17,30
90,Fail,39,36,8,17,22
90,Fail,48,33,8,11,37
90,Fail,49,30,7,14,35
90,Fail,48,31,0,16,32
90,Fail,49,38,1,12,37
90,Fail,43,29,16,12,31
90,Fail,42,39,2,17,25
90,Fail,39,44,9,8,31
90,Fail,48,37,0,14,34
90,Fail,40,41,4,15,25
90,Fail,51,31,4,14,37
90,Fail,47,33,5,15,32
90,Fail,42,41,0,14,28
90,Fail,45,37,4,14,31
90,Fail,52,22,0,16,36
90,Fail,55,29,0,14,41
90,Fail,52,31,0,14,38
90,Fail,49,41,0,9,40
90,Fail,48,34,0,17,31
90,Fail,44,40,0,13,31
90,Fail,44,38,8,10,34
90,Fail,42,34,8,16,26
90,Fail,47,33,0,11,36
90,Fail,48,34,4,14,34
90,Fail,53,37,0,10,43
90,Fail,53,32,0,14,39
90,Fail,50,35,4,11,39
90,Fail,48,38,1,13,35
90,Fail,40,31,0,20,20
90,Fail,44,35,6,15,29
90,Fail,43,37,0,17,26
90,Fail,45,43,2,10,35
90,Fail,43,46,0,11,32
90,Fail,48,37,0,14,34
90,Fail,51,38,3,8,43
90,Fail,44,36,6,14,30
90,Fail,54,35,3,8,46
90,Fail,42,38,0,10,32
90,Fail,52,32,5,11,41
90,Fail,44,43,2,11,33
90,Fail,49,40,0,10,39
90,Fail,50,35,0,12,38
90,Fail,52,38,1,9,43
90,Fail,50,34,0,11,39
90,Fail,39,41,7,13,26
90,Fail,53,39,3,5,48
90,Fail,48,35,5,12,36
90,Fail,51,34,0,9,42
90,Fail,41,39,4,16,25
90,Fail,53,28,1,18,35
90,Fail,48,40,0,7,41
90,Fail,49,39,2,10,39
90,Fail,46,36,1,17,29
90,Fail,51,32,7,10,41
90,Fail,53,34,0,13,40
90,Fail,48,36,5,11,37
90,Fail,50,39,1,10,40
90,Fail,42,31,0,13,29
90,Fail,52,38,2,8,44
90,Fail,51,36,0,13,38
90,Fail,46,38,0,13,33
90,Fail,48,23,14,15,33
90,Fail,45,36,0,18,27
90,Fail,55,26,11,8,47
90,Fail,54,28,0,14,40
90,Fail,48,37,0,13,35
90,Fail,55,32,0,12,43
90,Fail,46,37,1,16,30
90,Fail,42,34,9,15,27
90,Fail,50,32,0,14,36
90,Fail,55,30,5,10,45
90,Fail,45,32,11,12,33
90,Fail,54,36,0,8,46
90,Fail,46,34,0,17,29
90,Fail,48,36,3,13,35
90,Fail,53,30,0,15,38
90,Fail,45,39,0,9,36
90,Fail,58,35,1,6,52
90,Fail,55,24,1,20,35
90,Fail,46,38,6,10,36
90,Fail,52,33,0,10,42
90,Fail,51,39,2,8,43
90,Fail,48,32,0,13,35
90,Fail,50,38,0,10,40
90,Fail,49,31,4,16,33
90,Fail,45,37,9,9,36
90,Fail,43,44,5,8,35
90,Fail,34,48,7,11,23
90,Fail,41,39,0,18,23
90,Fail,52,30,0,12,40
90,Fail,48,39,0,12,36
90,Fail,49,39,1,11,38
90,Fail,51,28,7,14,37
90,Fail,45,38,0,13,32
90,Fail,45,42,0,12,33
90,Fail,45,39,7,9,36
90,Fail,50,31,3,16,34
90,Fail,42,35,0,14,28
90,Fail,42,47,0,7,35
90,Fail,47,45,0,4,43
90,Fail,46,39,0,13,33
90,Fail,49,34,4,13,36
90,Fail,47,31,12,10,37
90,Fail,44,34,5,17,27
90,Fail,51,35,0,10,41
90,Fail,40,41,2,17,23
90,Fail,50,35,0,11,39
90,Fail,54,33,1,12,42
90,Fail,43,33,0,15,28
90,Fail,38,42,10,10,28
90,Fail,35,48,0,11,24
90,Fail,48,32,0,16,32
90,Fail,53,29,0,13,40
90,Fail,45,40,0,13,32
90,Fail,49,34,4,13,36
90,Fail,55,29,3,13,42
90,Fail,41,41,7,11,30
90,Fail,47,35,6,12,35
90,Fail,50,29,0,11,39
90,Fail,50,33,7,10,40
90,Fail,45,41,6,8,37
90,Fail,46,39,1,14,32
90,Fail,45,37,6,12,33
90,Fail,43,40,4,13,30
90,Fail,46,37,0,10,36
90,Fail,54,32,0,9,45
90,Fail,45,35,4,16,29
90,Fail,42,40,10,8,34
90,Fail,56,33,0,10,46
90,Fail,47,32,0,15,32
90,Fail,39,42,2,17,22
90,Fail,36,45,6,13,23
90,Fail,57,36,0,7,50
90,Fail,50,33,2,15,35
90,Fail,50,35,2,13,37
90,Fail,47,46,0,6,41
90,Fail,47,38,0,15,32
90,Fail,46,38,0,14,32
90,Fail,51,39,1,9,42
90,Fail,49,35,0,13,36
90,Fail,47,39,0,11,36
90,Fail,33,43,2,22,11
90,Fail,48,36,0,13,35
90,Fail,45,37,0,14,31
90,Fail,55,33,0,8,47
90,Fail,45,31,0,15,30
90,Fail,51,38,0,10,41
90,Fail,51,34,2,13,38
90,Fail,53,29,0,15,38
90,Fail,48,36,2,14,34
90,Fail,48,39,0,11,37
90,Fail,42,30,9,19,23
90,Fail,44,35,0,14,30
90,Fail,45,41,3,11,34
90,Fail,50,30,8,12,38
90,Fail,51,39,1,9,42
90,Fail,48,32,6,14,34
90,Fail,55,29,0,11,44
90,Fail,42,36,1,21,21
90,Fail,46,37,7,10,36
90,Fail,50,38,0,11,39
90,Fail,45,33,0,16,29
90,Fail,41,41,6,12,29
90,Fail,55,34,1,10,45
90,Fail,50,35,0,14,36
90,Fail,55,27,8,10,45
90,Fail,49,31,0,14,35
90,Fail,43,31,6,20,23
90,Fail,51,36,2,11,40
90,Fail,56,30,0,6,50
90,Fail,53,36,0,9,44
90,Fail,44,44,0,11,33
90,Fail,52,28,0,16,36
90,Fail,50,29,0,13,37
90,Fail,50,35,1,14,36
90,Fail,44,37,4,15,29
90,Fail,44,39,0,16,28
90,Fail,47,38,0,14,33
90,Fail,44,41,0,14,30
90,Fail,49,34,0,17,32
90,Fail,55,33,3,9,46
90,Fail,47,31,6,16,31
90,Fail,45,36,0,13,32
90,Fail,45,36,4,15,30
90,Fail,48,34,4,14,34
90,Fail,46,43,0,11,35
90,Fail,46,38,0,14,32
90,Fail,49,38,5,8,41
90,Fail,42,39,8,11,31
90,Fail,53,34,5,8,45
90,Fail,49,33,8,10,39
90,Fail,46,34,7,13,33
90,Fail,48,32,7,13,35
90,Fail,52,35,0,13,39
90,Fail,51,33,0,12,39
90,Fail,49,31,5,15,34
90,Fail,44,34,0,20,24
90,Fail,52,32,0,13,39
90,Fail,49,42,0,6,43
90,Fail,45,31,6,18,27
90,Fail,45,40,1,14,31
90,Fail,43,45,0,10,33
90,Fail,44,45,0,11,33
90,Fail,51,36,2,11,40
90,Fail,52,37,3,8,44
90,Fail,46,32,6,16,30
90,Fail,46,37,3,14,32
90,Fail,51,36,0,9,42
90,Fail,45,38,0,12,33
90,Fail,49,36,0,11,38
90,Fail,55,32,0,12,43
90,Fail,48,31,0,11,37
90,Fail,45,34,12,9,36
90,Fail,54,33,0,11,43
90,Fail,50,33,6,11,39
90,Fail,46,32,11,11,35
90,Fail,47,41,0,10,37
90,Fail,39,40,4,17,22
90,Fail,49,27,7,17,32
90,Fail,51,37,0,11,40
90,Fail,44,41,0,14,30
90,Fail,50,39,0,11,39
90,Fail,59,29,3,9,50
90,Fail,50,37,4,9,41
90,Fail,46,37,3,14,32
90,Fail,52,34,0,10,42
90,Fail,59,30,0,10,49
90,Fail,49,37,1,13,36
90,Fail,56,36,3,5,51
90,Fail,44,39,0,11,33
90,Fail,56,36,0,8,48
90,Fail,43,37,0,15,28
90,Fail,47,38,3,12,35
90,Fail,49,37,0,8,41
90,Fail,41,36,5,18,23
90,Fail,41,38,3,18,23
90,Fail,42,41,0,12,30
90,Fail,49,37,4,10,39
90,Fail,52,29,0,13,39
90,Fail,54,30,5,11,43
90,Fail,47,27,0,18,29
90,Fail,43,39,4,14,29
90,Fail,44,45,1,10,34
90,Fail,50,33,7,10,40
90,Fail,44,39,0,14,30
90,Fail,57,26,4,13,44
90,Fail,53,35,0,12,41
90,Fail,47,47,0,6,41
90,Fail,55,32,0,11,44
90,Fail,46,39,6,9,37
90,Fail,51,38,3,8,43
90,Fail,48,33,3,16,32
90,Fail,49,32,0,8,41
90,Fail,48,38,6,8,40
90,Fail,48,40,1,11,37
90,Fail,53,28,0,12,41
90,Fail,49,31,0,10,39
90,Fail,50,35,0,15,35
90,Fail,45,39,0,14,31
90,Fail,49,39,0,10,39
90,Fail,44,32,0,21,23
90,Fail,52,29,6,13,39
90,Fail,51,41,1,7,44
90,Fail,53,35,0,8,45
90,Fail,50,26,4,20,30
90,Fail,57,33,0,9,48
90,Fail,50,29,6,15,35
90,Fail,52,34,3,11,41
90,Fail,51,35,0,12,39
90,Fail,42,34,0,12,30
90,Fail,49,38,6,7,42
90,Fail,51,27,0,10,41
90,Fail,41,43,0,15,26
90,Fail,53,33,3,11,42
90,Fail,39,34,14,13,26
90,Fail,45,28,0,24,21
90,Fail,48,39,0,10,38
90,Fail,47,35,4,14,33
90,Fail,43,42,0,11,32
90,Fail,44,32,0,13,31
90,Fail,42,36,0,22,20
90,Fail,47,36,0,12,35
90,Fail,36,36,8,20,16
90,Fail,43,40,1,16,27
90,Fail,49,32,3,16,33
90,Fail,54,27,6,13,41
90,Fail,51,34,0,13,38
90,Fail,44,43,0,11,33
90,Fail,48,33,0,18,30
90,Fail,52,37,0,9,43
90,Fail,41,31,10,18,23
90,Fail,38,43,0,15,23
90,Fail,43,39,9,9,34
90,Fail,53,39,0,8,45
90,Fail,44,35,0,13,31
90,Fail,50,36,0,14,36
90,Fail,43,36,0,19,24
90,Fail,48,34,1,17,31
90,Fail,53,37,0,10,43
90,Fail,42,39,9,10,32
90,Fail,53,32,0,14,39
90,Fail,46,36,7,11,35
90,Fail,49,33,0,16,33
90,Fail,48,31,0,14,34
90,Fail,50,36,0,9,41
90,Fail,49,30,0,19,30
90,Fail,50,31,0,11,39
90,Fail,51,34,0,14,37
90,Fail,48,40,0,12,36
90,Fail,39,46,0,12,27
90,Fail,50,35,0,11,39
90,Fail,47,39,0,12,35
90,Fail,49,30,7,14,35
90,Fail,50,29,3,18,32
90,Fail,49,41,0,8,41
90,Fail,49,36,0,9,40
90,Fail,47,37,0,10,37
90,Fail,43,39,5,13,30
90,Fail,52,33,0,13,39
90,Fail,52,35,0,11,41
90,Fail,51,28,6,15,36
90,Fail,47,32,10,11,36
90,Fail,41,39,0,11,30
90,Fail,46,41,0,13,33
90,Fail,47,34,2,17,30
90,Fail,49,40,0,7,42
90,Fail,50,35,0,14,36
90,Fail,47,32,0,12,35
90,Fail,45,36,3,16,29
90,Fail,59,24,5,12,47
90,Fail,50,30,6,14,36
90,Fail,42,38,5,15,27
90,Fail,42,35,0,18,24
90,Fail,47,35,0,18,29
90,Fail,46,35,7,12,34
90,Fail,45,33,11,11,34
90,Fail,56,34,1,9,47
90,Fail,42,39,6,13,29
90,Fail,52,24,0,12,40
90,Fail,52,34,0,12,40
90,Fail,52,31,0,17,35
90,Fail,47,30,0,12,35
90,Fail,41,41,2,16,25
90,Fail,47,41,0,12,35
90,Fail,52,32,3,13,39
90,Fail,54,31,1,14,40
90,Fail,48,32,0,15,33
90,Fail,44,41,0,11,33
90,Fail,47,33,8,12,35
90,Fail,58,30,0,10,48
90,Fail,40,40,4,16,24
90,Fail,43,37,0,13,30
90,Fail,54,34,0,5,49
90,Fail,49,41,0,10,39
90,Fail,48,37,0,12,36
90,Fail,46,32,0,14,32
90,Fail,45,33,9,13,32
90,Fail,53,25,6,16,37
90,Fail,56,29,0,11,45
90,Fail,47,35,8,10,37
90,Fail,49,37,0,8,41
90,Fail,55,29,0,9,46
90,Fail,48,39,1,12,36
90,Fail,47,40,0,10,37
90,Fail,48,39,0,12,36
90,Fail,45,36,6,13,32
90,Fail,46,39,0,13,33
90,Fail,49,31,8,12,37
90,Fail,47,32,0,13,34
90,Fail,53,34,0,8,45
90,Fail,53,33,3,11,42
90,Fail,51,30,0,17,34
90,Fail,54,33,0,12,42
90,Fail,42,37,0,18,24
90,Fail,52,36,0,10,42
90,Fail,47,36,0,12,35
90,Fail,49,33,6,12,37
90,Fail,46,41,1,12,34
90,Fail,44,42,5,9,35
90,Fail,50,42,0,7,43
90,Fail,41,44,1,14,27
90,Fail,51,26,8,15,36
90,Fail,48,38,2,12,36
90,Fail,45,40,0,14,31
90,Fail,41,46,0,10,31
90,Fail,54,32,1,13,41
90,Fail,47,33,0,16,31
90,Fail,48,36,3,13,35
90,Fail,50,39,0,8,42
90,Fail,53,32,2,13,40
90,Fail,50,30,6,14,36
90,Fail,50,32,5,13,37
90,Fail,55,32,3,10,45
90,Fail,55,32,0,13,42
90,Fail,55,30,0,9,46
90,Fail,51,37,0,9,42
90,Fail,47,38,0,12,35
90,Fail,43,40,5,12,31
90,Fail,43,35,0,15,28
90,Fail,49,37,1,13,36
90,Fail,51,36,0,11,40
90,Fail,53,35,2,10,43
90,Fail,49,32,4,15,34
90,Fail,53,36,2,9,44
90,Fail,47,36,2,15,32
90,Fail,50,37,2,11,39
90,Fail,49,31,8,12,37
90,Fail,44,32,5,19,25
90,Fail,48,31,2,19,29
90,Fail,54,35,0,8,46
90,Fail,48,27,7,18,30
90,Fail,50,29,6,15,35
90,Fail,41,44,0,11,30
90,Fail,37,33,0,22,15
90,Fail,48,42,0,8,40
90,Fail,48,39,0,13,35
90,Fail,53,36,0,8,45
90,Fail,41,44,2,13,28
90,Fail,42,36,0,11,31
90,Fail,52,32,0,13,39
90,Fail,50,35,0,15,35
90,Fail,49,35,0,11,38
90,Fail,46,42,3,9,37
90,Fail,48,39,0,11,37
90,Fail,47,39,1,13,34
90,Fail,46,32,0,16,30
90,Fail,58,34,2,6,52
90,Fail,47,30,0,14,33
90,Fail,49,31,0,10,39
90,Fail,45,35,0,17,28
90,Fail,49,38,4,9,40
90,Fail,50,33,0,9,41
90,Fail,44,37,4,15,29
90,Fail,50,29,8,13,37
90,Fail,48,40,0,8,40
90,Fail,49,32,4,15,34
90,Fail,50,37,0,8,42
90,Fail,52,35,0,11,41
90,Fail,49,42,0,9,40
90,Fail,48,43,0,7,41
90,Fail,51,31,0,13,38
90,Fail,51,35,4,10,41
90,Fail,51,33,7,9,42
90,Fail,42,33,10,15,27
90,Fail,48,36,0,11,37
90,Fail,52,27,0,13,39
90,Fail,46,38,1,15,31
90,Fail,51,38,0,9,42
90,Fail,56,29,0,10,46
90,Fail,46,33,8,13,33
90,Fail,37,31,15,17,20
90,Fail,44,35,2,19,25
90,Fail,49,38,0,8,41
90,Fail,53,32,0,14,39
90,Fail,44,36,0,12,32
90,Fail,50,29,8,13,37
90,Fail,50,39,0,10,40
90,Fail,41,46,0,13,28
90,Fail,44,42,1,13,31
90,Fail,51,22,11,16,35
90,Fail,50,41,0,8,42
90,Fail,47,35,0,12,35
90,Fail,54,29,5,12,42
90,Fail,55,34,4,7,48
90,Fail,47,41,0,11,36
90,Fail,48,37,6,9,39
90,Fail,43,33,0,16,27
90,Fail,44,35,0,13,31
90,Fail,50,39,1,10,40
90,Fail,42,45,1,12,30
90,Fail,60,31,0,9,51
90,Fail,55,29,0,10,45
90,Fail,43,27,0,21,22
90,Fail,43,40,0,11,32
90,Fail,48,41,1,10,38
90,Fail,51,27,12,10,41
90,Fail,49,36,0,10,39
90,Fail,49,36,0,10,39
90,Fail,45,42,0,12,33
90,Fail,50,36,5,9,41
90,Fail,46,35,0,12,34
90,Fail,52,31,6,11,41
90,Fail,43,24,0,20,23
90,Fail,39,44,4,13,26
90,Fail,45,38,4,13,32
90,Fail,53,36,2,9,44
90,Fail,48,29,0,15,33
90,Fail,54,30,3,13,41
90,Fail,49,38,0,12,37
90,Fail,51,36,0,12,39
90,Fail,47,34,0,14,33
90,Fail,53,36,0,7,46
90,Fail,40,41,0,15,25
90,Fail,56,26,2,16,40
90,Fail,52,38,0,10,42
90,Fail,49,39,3,9,40
90,Fail,48,32,0,13,35
90,Fail,50,35,3,12,38
90,Fail,47,39,2,12,35
90,Fail,46,37,3,14,32
90,Fail,46,36,0,15,31
90,Fail,49,30,0,16,33
90,Fail,49,32,0,15,34
90,Fail,42,43,0,10,32
90,Fail,43,34,0,15,28
90,Fail,49,38,0,10,39
90,Fail,46,42,0,10,36
90,Fail,49,35,3,13,36
90,Fail,45,42,4,9,36
90,Fail,49,37,0,13,36
90,Fail,51,25,0,18,33
90,Fail,48,37,0,14,34
90,Fail,49,36,0,11,38
90,Fail,51,34,5,10,41
90,Fail,48,39,0,12,36
90,Fail,54,34,0,12,42
90,Fail,43,32,4,21,22
90,Fail,60,26,1,13,47
90,Fail,42,43,1,14,28
90,Fail,51,35,2,12,39
90,Fail,53,34,3,10,43
90,Fail,46,36,0,14,32
90,Fail,59,28,0,11,48
90,Fail,57,24,0,18,39
90,Fail,47,42,1,10,37
90,Fail,52,36,0,7,45
90,Fail,46,37,0,12,34
90,Fail,57,29,1,13,44
90,Fail,45,32,0,16,29
90,Fail,53,31,3,13,40
90,Fail,46,37,4,13,33
90,Fail,54,38,0,8,46
90,Fail,52,38,0,6,46
90,Fail,52,35,2,11,41
90,Fail,50,38,0,10,40
90,Fail,54,30,4,12,42
90,Fail,46,32,7,15,31
90,Fail,45,36,0,14,31
90,Fail,39,40,0,10,29
90,Fail,49,34,2,15,34
90,Fail,44,35,4,17,27
90,Fail,50,37,0,12,38
90,Fail,37,36,4,23,14
90,Fail,48,33,0,13,35
90,Fail,46,32,0,16,30
90,Fail,51,39,1,9,42
90,Fail,44,35,5,16,28
90,Fail,55,29,8,8,47
90,Fail,52,30,8,10,42
90,Fail,50,30,0,17,33
90,Fail,52,29,2,17,35
90,Fail,50,27,0,17,33
90,Fail,45,39,1,15,30
90,Fail,44,46,0,9,35
90,Fail,53,35,0,12,41
90,Fail,45,33,0,14,31
90,Fail,53,31,4,12,41
90,Fail,46,38,0,9,37
90,Fail,48,39,3,10,38
90,Fail,53,31,0,12,41
90,Fail,49,34,0,11,38
90,Fail,50,32,7,11,39
90,Fail,48,31,2,19,29
90,Fail,42,43,0,6,36
90,Fail,52,27,0,19,33
90,Fail,49,30,4,17,32
90,Fail,49,33,0,14,35
90,Fail,43,45,3,9,34
90,Fail,54,36,0,10,44
90,Fail,43,41,0,13,30
90,Fail,46,39,4,11,35
90,Fail,55,35,0,10,45
90,Fail,50,37,0,13,37
90,Fail,40,39,0,18,22
90,Fail,51,39,2,8,43
90,Fail,50,34,10,6,44
90,Fail,54,30,2,14,40
90,Fail,46,39,2,13,33
90,Fail,45,38,6,11,34
90,Fail,49,29,0,14,35
90,Fail,39,42,0,16,23
90,Fail,49,36,0,13,36
90,Fail,50,32,0,15,35
90,Fail,53,36,0,10,43
90,Fail,47,38,7,8,39
90,Fail,42,38,0,16,26
90,Fail,50,29,5,16,34
90,Fail,47,44,0,7,40
90,Fail,45,37,9,9,36
90,Fail,46,39,0,13,33
90,Fail,50,38,0,8,42
90,Fail,52,40,0,7,45
90,Fail,48,31,0,14,34
90,Fail,45,35,0,15,30
90,Fail,45,37,0,18,27
90,Fail,46,42,4,8,38
90,Fail,52,27,0,18,34
90,Fail,43,33,9,15,28
90,Fail,49,45,1,5,44
90,Fail,41,40,2,17,24
90,Fail,50,34,0,13,37
90,Fail,42,40,0,17,25
90,Fail,38,45,4,13,25
90,Fail,48,30,9,13,35
90,Fail,50,31,5,14,36
90,Fail,48,38,5,9,39
90,Fail,43,36,0,15,28
90,Fail,52,32,0,6,46
90,Fail,46,37,0,9,37
90,Fail,61,31,0,8,53
90,Fail,47,33,0,19,28
90,Fail,39,49,0,9,30
90,Fail,42,44,4,10,32
90,Fail,56,31,0,11,45
90,Fail,39,47,0,9,30
90,Fail,53,28,0,15,38
90,Fail,40,40,0,15,25
90,Fail,44,36,2,18,26
90,Fail,45,34,9,12,33
90,Fail,44,39,5,12,32
90,Fail,47,38,1,14,33
90,Fail,47,38,4,11,36
90,Fail,46,42,1,11,35
90,Fail,54,36,0,10,44
90,Fail,39,47,0,9,30
90,Fail,47,33,9,11,36
90,Fail,58,27,0,13,45
90,Fail,51,38,0,10,41
90,Fail,45,37,3,15,30
90,Fail,46,40,3,11,35
90,Fail,52,34,1,13,39
90,Fail,49,33,0,10,39
90,Fail,50,33,0,14,36
90,Fail,43,40,9,8,35
90,Fail,46,31,9,14,32
90,Fail,49,40,5,6,43
90,Fail,46,31,5,18,28
90,Fail,44,35,2,19,25
90,Fail,57,33,2,8,49
90,Fail,50,33,0,17,33
90,Fail,50,37,0,8,42
90,Fail,55,31,6,8,47
90,Fail,39,40,0,13,26
90,Fail,44,39,1,16,28
90,Fail,43,45,0,12,31
90,Fail,49,42,0,6,43
90,Fail,40,41,0,17,23
90,Fail,51,33,3,13,38
90,Fail,52,26,0,15,37
90,Fail,56,27,4,13,43
90,Fail,48,31,8,13,35
90,Fail,49,34,2,15,34
90,Fail,41,42,8,9,32
90,Fail,55,32,0,11,44
90,Fail,44,33,0,15,29
90,Fail,57,29,0,8,49
90,Fail,46,36,3,15,31
90,Fail,49,37,5,9,40
90,Fail,42,39,0,19,23
90,Fail,41,49,0,7,34
90,Fail,42,35,2,21,21
90,Fail,40,34,0,15,25
90,Fail,52,34,0,11,41
90,Fail,46,30,4,20,26
90,Fail,47,40,4,9,38
90,Fail,46,32,8,14,32
90,Fail,47,32,0,10,37
90,Fail,45,40,0,12,33
90,Fail,42,34,0,14,28
90,Fail,49,36,0,10,39
90,Fail,42,40,8,10,32
90,Fail,42,36,0,14,28
90,Fail,49,30,6,15,34
90,Fail,43,32,8,17,26
90,Fail,47,35,7,11,36
90,Fail,47,36,0,13,34
90,Fail,48,37,0,12,36
90,Fail,48,40,0,12,36
90,Fail,49,38,0,10,39
90,Fail,44,37,7,12,32
90,Fail,49,39,2,10,39
90,Fail,56,26,0,11,45
90,Fail,47,30,11,12,35
90,Fail,45,37,1,17,28
90,Fail,44,34,0,20,24
90,Fail,51,32,0,13,38
90,Fail,44,36,0,12,32
90,Fail,48,39,2,11,37
90,Fail,48,40,0,9,39
90,Fail,42,42,0,11,31
90,Fail,47,26,10,17,30
90,Fail,45,39,3,13,32
90,Fail,48,40,2,10,38
90,Fail,49,27,9,15,34
90,Fail,41,36,0,16,25
90,Fail,48,38,4,10,38
90,Fail,46,42,0,12,34
90,Fail,42,41,0,7,35
90,Fail,57,32,0,10,47
90,Fail,44,37,0,15,29
90,Fail,52,28,7,13,39
90,Fail,49,39,0,10,39
90,Fail,53,36,3,8,45
90,Fail,43,42,0,10,33
90,Fail,43,39,0,13,30
90,Fail,49,35,0,10,39
90,Fail,47,36,8,9,38
90,Fail,42,39,9,10,32
90,Fail,47,41,0,12,35
90,Fail,51,34,0,8,43
90,Fail,50,37,0,12,38
90,Fail,55,37,0,8,47
90,Fail,47,37,0,15,32
90,Fail,46,37,3,14,32
90,Fail,46,34,5,15,31
90,Fail,40,41,0,16,24
90,Fail,52,34,0,8,44
90,Fail,50,33,0,15,35
90,Fail,49,36,0,14,35
90,Fail,48,30,7,15,33
90,Fail,50,40,1,9,41
90,Fail,47,36,0,14,33
90,Fail,42,48,0,9,33
90,Fail,50,34,3,13,37
90,Fail,49,35,2,14,35
90,Fail,42,37,8,13,29
90,Fail,47,38,7,8,39
90,Fail,58,32,0,10,48
90,Fail,48,41,0,8,40
90,Fail,46,34,6,14,32
90,Fail,44,34,0,14,30
90,Fail,60,24,9,7,53
90,Fail,44,37,0,18,26
90,Fail,55,35,1,9,46
90,Fail,53,39,1,7,46
90,Fail,54,30,6,10,44
90,Fail,50,42,0,8,42
90,Fail,48,30,0,18,30
90,Fail,49,31,1,19,30
90,Fail,50,35,0,9,41
90,Fail,44,40,0,16,28
90,Fail,42,43,3,12,30
90,Fail,42,36,0,16,26
90,Fail,41,42,0,15,26
90,Fail,54,37,0,6,48
90,Fail,46,40,3,11,35
90,Fail,48,36,0,12,36
90,Fail,52,36,0,10,42
90,Fail,48,30,0,15,33
90,Fail,53,29,0,15,38
90,Fail,53,33,0,10,43
90,Fail,49,30,7,14,35
90,Fail,43,37,5,15,28
90,Fail,48,34,0,14,34
90,Fail,44,34,6,16,28
90,Fail,54,31,0,14,40
90,Fail,54,25,0,16,38
90,Fail,49,33,0,18,31
90,Fail,46,38,0,12,34
90,Fail,52,29,0,10,42
90,Fail,52,29,7,12,40
90,Fail,54,37,0,9,45
90,Fail,51,33,3,13,38
90,Fail,49,36,3,12,37
90,Fail,42,32,0,17,25
90,Fail,50,38,0,9,41
90,Fail,52,34,0,10,42
90,Fail,52,33,0,15,37
90,Fail,48,35,0,17,31
90,Fail,54,34,2,10,44
90,Fail,54,37,0,5,49
90,Fail,44,32,0,14,30
90,Fail,49,38,1,12,37
90,Fail,41,43,4,12,29
90,Fail,55,28,0,11,44
90,Fail,36,42,8,14,22
90,Fail,42,40,0,15,27
90,Fail,48,45,0,6,42
90,Fail,46,38,0,10,36
90,Fail,44,39,0,13,31
90,Fail,48,31,6,15,33
90,Fail,47,35,7,11,36
90,Fail,55,36,0,9,46
90,Fail,45,36,0,15,30
90,Fail,49,40,0,10,39
90,Fail,45,36,3,16,29
90,Fail,47,32,8,13,34
90,Fail,49,28,0,12,37
90,Fail,51,34,0,9,42
90,Fail,52,35,0,12,40
90,Fail,53,27,0,16,37
90,Fail,59,33,0,8,51
90,Fail,50,34,3,13,37
90,Fail,50,37,0,11,39
90,Fail,51,31,5,13,38
90,Fail,40,44,0,10,30
90,Fail,54,27,5,14,40
90,Fail,45,39,0,15,30
90,Fail,52,35,1,12,40
90,Fail,45,35,3,17,28
90,Fail,52,35,5,8,44
90,Fail,47,30,3,20,27
90,Fail,47,33,0,11,36
90,Fail,46,41,0,6,40
90,Fail,47,40,3,10,37
90,Fail,45,31,12,12,33
90,Fail,57,33,0,10,47
90,Fail,53,33,0,11,42
90,Fail,51,32,6,11,40
90,Fail,48,33,4,15,33
90,Fail,51,25,3,21,30
90,Fail,53,29,0,16,37
90,Fail,54,31,4,11,43
90,Fail,41,35,7,17,24
90,Fail,45,38,7,10,35
90,Fail,38,45,1,16,22
90,Fail,47,40,0,12,35
90,Fail,46,33,4,17,29
90,Fail,51,32,0,17,34
90,Fail,47,40,0,12,35
90,Fail,47,42,2,9,38
90,Fail,41,39,3,17,24
90,Fail,52,32,0,15,37
90,Fail,43,42,6,9,34
90,Fail,52,29,9,10,42
90,Fail,46,45,2,7,39
90,Fail,37,44,4,15,22
90,Fail,42,42,6,10,32
90,Fail,44,38,5,13,31
90,Fail,50,32,5,13,37
90,Fail,57,25,0,15,42
90,Fail,44,38,4,14,30
90,Fail,41,38,0,17,24
90,Fail,57,35,2,6,51
90,Fail,46,38,0,16,30
90,Fail,41,39,7,13,28
90,Fail,38,42,0,12,26
90,Fail,39,40,2,19,20
90,Fail,46,42,0,8,38
90,Fail,45,44,0,9,36
90,Fail,51,23,0,16,35
90,Fail,47,38,1,14,33
90,Fail,47,37,1,15,32
90,Fail,54,34,0,6,48
90,Fail,43,38,5,14,29
90,Fail,48,36,3,13,35
90,Fail,54,32,1,13,41
90,Fail,50,41,1,8,42
90,Fail,56,32,2,10,46
90,Fail,40,44,0,13,27
90,Fail,50,33,1,16,34
90,Fail,52,33,0,12,40
90,Fail,47,43,0,7,40
90,Fail,57,28,2,13,44
90,Fail,49,35,2,14,35
90,Fail,37,42,8,13,24
90,Fail,49,38,0,9,40
90,Fail,51,31,8,10,41
90,Fail,42,34,0,17,25
90,Fail,45,37,4,14,31
90,Fail,46,37,0,10,36
90,Fail,51,34,0,11,40
90,Fail,45,37,5,13,32
90,Fail,50,36,0,13,37
90,Fail,46,39,3,12,34
90,Fail,53,39,0,8,45
90,Fail,47,37,4,12,35
90,Fail,50,34,0,16,34
90,Fail,50,33,0,15,35
90,Fail,45,39,0,13,32
90,Fail,53,36,0,8,45
90,Fail,51,34,3,12,39
90,Fail,47,37,0,9,38
90,Fail,44,36,0,14,30
90,Fail,52,37,1,10,42
90,Fail,35,48,0,9,26
90,Fail,49,30,0,9,40
90,Fail,47,32,0,18,29
90,Fail,45,31,0,17,28
90,Fail,47,33,6,14,33
90,Fail,42,40,0,15,27
90,Fail,52,35,0,11,41
90,Fail,47,39,0,12,35
90,Fail,56,25,7,12,44
90,Fail,54,34,1,11,43
90,Fail,52,39,0,8,44
90,Fail,55,35,0,8,47
90,Fail,46,31,0,21,25
90,Fail,49,37,0,10,39
90,Fail,51,36,2,11,40
90,Fail,54,37,0,9,45
90,Fail,42,43,3,12,30
90,Fail,46,40,5,9,37
90,Fail,50,35,0,14,36
90,Fail,43,38,0,14,29
90,Fail,48,34,9,9,39
90,Fail,43,40,0,17,26
90,Fail,46,39,0,13,33
90,Fail,47,36,0,15,32
90,Fail,47,33,0,14,33
90,Fail,49,41,1,9,40
90,Fail,41,45,1,13,28
90,Fail,49,41,2,8,41
90,Fail,57,34,2,7,50
90,Fail,52,32,1,15,37
90,Fail,50,36,0,11,39
90,Fail,56,32,0,10,46
90,Fail,46,41,0,12,34
90,Fail,50,38,0,10,40
90,Fail,39,38,0,18,21
90,Fail,43,41,5,11,32
90,Fail,44,35,9,12,32
90,Fail,52,34,0,8,44
90,Fail,48,40,0,12,36
90,Fail,48,35,0,14,34
90,Fail,48,43,0,9,39
90,Fail,48,33,0,14,34
90,Fail,57,35,0,5,52
90,Fail,45,38,5,12,33
90,Fail,45,39,0,13,32
90,Fail,48,29,0,15,33
90,Fail,53,28,0,19,34
90,Fail,53,35,0,10,43
90,Fail,53,36,0,9,44
90,Fail,35,40,11,14,21
90,Fail,46,34,0,9,37
90,Fail,51,37,0,12,39
90,Fail,47,33,0,17,30
90,Fail,49,30,5,16,33
90,Fail,45,35,0,14,31
90,Fail,52,29,0,19,33
90,Fail,43,37,6,14,29
90,Fail,49,35,4,12,37
90,Fail,50,32,0,12,38
90,Fail,49,35,0,13,36
90,Fail,52,33,0,9,43
90,Fail,44,41,2,13,31
90,Fail,49,31,7,13,36
90,Fail,54,27,0,13,41
90,Fail,39,43,3,15,24
90,Fail,51,39,0,9,42
90,Fail,53,35,3,9,44
90,Fail,55,26,4,15,40
90,Fail,50,45,0,5,45
90,Fail,48,36,2,14,34
90,Fail,42,36,1,21,21
90,Fail,50,30,5,15,35
90,Fail,44,40,0,9,35
90,Fail,44,42,0,11,33
90,Fail,45,41,0,10,35
90,Fail,39,40,0,16,23
90,Fail,50,35,0,14,36
90,Fail,49,40,0,11,38
90,Fail,55,33,1,11,44
90,Fail,43,41,2,14,29
90,Fail,48,33,6,13,35
90,Fail,42,44,0,9,33
90,Fail,49,36,2,13,36
90,Fail,38,43,2,17,21
90,Fail,49,38,0,11,38
90,Fail,49,37,2,12,37
90,Fail,60,31,2,7,53
90,Fail,47,40,0,8,39
90,Fail,50,39,0,10,40
90,Fail,43,45,0,11,32
90,Fail,48,36,0,10,38
90,Fail,42,39,0,12,30
90,Fail,48,40,3,9,39
90,Fail,49,40,5,6,43
90,Fail,51,36,0,13,38
90,Fail,46,38,2,14,32
90,Fail,55,34,2,9,46
90,Fail,56,35,1,8,48
90,Fail,46,36,2,16,30
90,Fail,48,38,5,9,39
90,Fail,42,38,0,15,27
90,Fail,40,40,0,16,24
90,Fail,44,37,0,13,31
90,Fail,44,40,4,12,32
90,Fail,39,41,0,14,25
90,Fail,49,36,0,13,36
90,Fail,48,39,0,9,39
90,Fail,52,32,0,16,36
90,Fail,43,39,6,12,31
90,Fail,46,30,0,21,25
90,Fail,50,35,2,13,37
90,Fail,52,37,0,11,41
90,Fail,51,30,4,15,36
90,Fail,45,40,4,11,34
90,Fail,58,30,1,11,47
90,Fail,46,35,0,17,29
90,Fail,47,39,3,11,36
90,Fail,48,40,0,7,41
90,Fail,42,41,0,15,27
90,Fail,55,33,2,10,45
90,Fail,47,34,3,16,31
90,Fail,46,35,0,14,32
90,Fail,44,37,3,16,28
90,Fail,43,31,0,12,31
90,Fail,51,34,2,13,38
90,Fail,49,33,0,17,32
90,Fail,47,36,0,14,33
90,Fail,52,37,0,10,42
90,Fail,51,29,0,13,38
90,Fail,42,39,0,13,29
90,Fail,48,36,0,9,39
90,Fail,46,36,9,9,37
90,Fail,45,33,5,17,28
90,Fail,48,37,5,10,38
90,Fail,44,38,0,14,30
90,Fail,49,35,0,12,37
90,Fail,48,37,5,10,38
90,Fail,45,28,14,13,32
90,Fail,45,34,0,20,25
90,Fail,44,41,4,11,33
90,Fail,47,36,4,13,34
90,Fail,38,37,0,21,17
90,Fail,56,34,0,9,47
90,Fail,46,38,0,10,36
90,Fail,55,33,2,10,45
90,Fail,50,32,2,16,34
90,Fail,51,32,0,12,39
90,Fail,46,43,4,7,39
90,Fail,61,33,1,5,56
90,Fail,42,33,12,13,29
90,Fail,41,45,0,13,28
90,Fail,46,43,0,9,37
90,Fail,46,43,3,8,38
90,Fail,59,28,0,13,46
90,Fail,51,35,1,13,38
90,Fail,51,32,0,13,38
90,Fail,48,29,8,15,33
90,Fail,48,27,0,18,30
90,Fail,45,39,0,11,34
90,Fail,41,42,5,12,29
90,Fail,38,43,6,13,25
90,Fail,47,37,0,9,38
90,Fail,50,34,4,12,38
90,Fail,44,40,7,9,35
90,Fail,45,36,2,17,28
90,Fail,56,37,0,6,50
90,Fail,49,37,0,10,39
90,Fail,51,38,0,11,40
90,Fail,40,29,0,19,21
90,Fail,52,37,0,8,44
90,Fail,46,40,0,13,33
90,Fail,48,40,0,9,39
90,Fail,60,28,0,7,53
90,Fail,55,34,0,11,44
90,Fail,52,29,0,14,38
90,Fail,43,35,5,17,26
90,Fail,49,30,5,16,33
90,Fail,36,46,3,15,21
90,Fail,45,33,0,13,32
90,Fail,51,37,0,11,40
90,Fail,45,35,0,16,29
90,Fail,40,47,2,11,29
90,Fail,46,32,7,15,31
90,Fail,44,37,1,18,26
90,Fail,48,24,13,15,33
90,Fail,52,32,0,11,41
90,Fail,49,32,1,18,31
90,Fail,40,35,5,20,20
90,Fail,52,35,4,9,43
90,Fail,56,32,0,9,47
90,Fail,48,36,5,11,37
90,Fail,43,36,11,10,33
90,Fail,43,38,10,9,34
90,Fail,48,32,0,15,33
90,Fail,52,32,0,8,44
90,Fail,48,39,0,9,39
90,Fail,45,42,0,12,33
90,Fail,54,35,0,11,43
90,Fail,48,36,0,10,38
90,Fail,42,40,5,13,29
90,Fail,41,42,0,15,26
90,Fail,45,33,0,17,28
90,Fail,51,33,0,10,41
90,Fail,50,36,3,11,39
90,Fail,46,28,0,13,33
90,Fail,50,38,0,10,40
90,Fail,49,38,0,11,38
90,Fail,43,33,0,20,23
90,Fail,46,36,0,13,33
90,Fail,37,42,2,19,18
90,Fail,44,40,0,12,32
90,Fail,45,39,5,11,34
90,Fail,46,36,0,16,30
90,Fail,52,33,4,11,41
90,Fail,49,41,2,8,41
90,Fail,39,41,0,17,22
90,Fail,49,37,0,13,36
90,Fail,44,36,9,11,33
90,Fail,56,38,0,6,50
90,Fail,44,30,16,10,34
90,Fail,47,32,5,16,31
90,Fail,55,29,0,15,40
90,Fail,47,35,0,10,37
90,Fail,49,36,0,13,36
90,Fail,45,33,0,18,27
90,Fail,54,34,0,11,43
90,Fail,37,43,7,13,24
90,Fail,47,32,8,13,34
90,Fail,43,30,11,16,27
90,Fail,53,32,0,14,39
90,Fail,50,33,6,11,39
90,Fail,50,36,6,8,42
90,Fail,45,40,1,14,31
90,Fail,56,34,0,9,47
90,Fail,48,36,4,12,36
90,Fail,52,31,0,11,41
90,Fail,48,36,5,11,37
90,Fail,42,38,1,19,23
90,Fail,44,38,0,14,30
90,Fail,54,36,0,7,47
90,Fail,52,36,0,12,40
90,Fail,49,32,6,13,36
90,Fail,47,33,7,13,34
90,Fail,56,35,3,6,50
90,Fail,36,38,0,16,20
90,Fail,44,43,3,10,34
90,Fail,38,35,0,21,17
90,Fail,41,38,2,19,22
90,Fail,52,36,2,10,42
90,Fail,45,34,0,16,29
90,Fail,44,39,0,16,28
90,Fail,41,40,0,14,27
90,Fail,51,37,0,11,40
90,Fail,41,46,0,8,33
90,Fail,53,32,5,10,43
90,Fail,46,43,2,9,37
90,Fail,47,34,0,19,28
90,Fail,48,35,5,12,36
90,Fail,44,40,4,12,32
90,Fail,52,29,0,15,37
90,Fail,51,39,2,8,43
90,Fail,49,25,0,15,34
90,Fail,48,40,0,12,36
90,Fail,38,49,0,10,28
90,Fail,50,36,0,14,36
90,Fail,48,37,8,7,41
90,Fail,41,41,6,12,29
90,Fail,44,41,0,11,33
90,Fail,57,33,0,10,47
90,Fail,46,39,3,12,34
90,Fail,44,38,5,13,31
90,Fail,56,34,4,6,50
90,Fail,48,38,1,13,35
90,Fail,47,45,0,8,39
90,Fail,54,32,2,12,42
90,Fail,47,36,0,10,37
90,Fail,47,37,4,12,35
90,Fail,50,30,0,15,35
90,Fail,49,33,2,16,33
90,Fail,52,35,0,11,41
90,Fail,45,42,0,13,32
90,Fail,40,37,8,15,25
90,Fail,50,36,4,10,40
90,Fail,52,36,0,12,40
90,Fail,49,29,13,9,40
90,Fail,40,37,0,9,31
90,Fail,46,34,0,17,29
90,Fail,46,38,0,12,34
90,Fail,40,37,0,19,21
90,Fail,56,30,6,8,48
90,Fail,53,36,0,9,44
90,Fail,52,33,0,12,40
90,Fail,45,46,0,9,36
90,Fail,48,35,1,16,32
90,Fail,54,28,5,13,41
90,Fail,53,41,0,5,48
90,Fail,49,34,3,14,35
90,Fail,49,31,8,12,37
90,Fail,50,28,2,20,30
90,Fail,48,37,2,13,35
90,Fail,45,32,9,14,31
90,Fail,41,46,3,10,31
90,Fail,51,33,0,15,36
90,Fail,43,35,0,16,27
90,Fail,48,37,0,9,39
90,Fail,47,38,0,15,32
90,Fail,48,31,0,12,36
90,Fail,43,39,0,16,27
90,Fail,45,38,0,16,29
90,Fail,41,40,0,19,22
90,Fail,44,35,8,13,31
90,Fail,46,40,2,12,34
90,Fail,48,41,0,9,39
90,Fail,43,32,8,17,26
90,Fail,46,28,11,15,31
90,Fail,44,35,5,16,28
90,Fail,44,30,0,20,24
90,Fail,51,34,3,12,39
90,Fail,49,35,1,15,34
90,Fail,48,37,0,11,37
90,Fail,46,33,13,8,38
90,Fail,47,44,1,8,39
90,Fail,44,40,6,10,34
90,Fail,60,35,0,4,56
90,Fail,39,43,0,11,28
90,Fail,49,41,0,7,42
90,Fail,50,34,4,12,38
90,Fail,52,30,0,16,36
90,Fail,53,39,0,5,48
90,Fail,46,34,0,13,33
90,Fail,40,45,2,13,27
90,Fail,45,28,11,16,29
90,Fail,51,40,0,9,42
90,Fail,40,42,3,15,25
90,Fail,45,31,0,9,36
90,Fail,44,41,3,12,32
90,Fail,51,28,6,15,36
90,Fail,47,35,0,17,30
90,Fail,52,37,0,11,41
90,Fail,53,38,0,6,47
90,Fail,46,30,11,13,33
90,Fail,46,36,0,18,28
90,Fail,47,42,0,10,37
90,Fail,45,39,0,12,33
90,Fail,41,38,6,15,26
90,Fail,47,34,0,16,31
90,Fail,42,39,7,12,30
90,Fail,48,39,0,7,41
90,Fail,47,30,0,12,35
90,Fail,49,35,3,13,36
90,Fail,47,34,0,11,36
90,Fail,48,31,0,14,34
90,Fail,42,43,0,14,28
90,Fail,50,39,2,9,41
90,Fail,47,36,0,17,30
90,Fail,55,37,1,7,48
90,Fail,44,39,0,14,30
90,Fail,47,45,1,7,40
90,Fail,44,35,6,15,29
90,Fail,52,38,0,10,42
90,Fail,46,44,2,8,38
90,Fail,49,35,1,15,34
90,Fail,51,36,1,12,39
90,Fail,45,36,2,17,28
90,Fail,40,47,0,8,32
90,Fail,58,30,0,8,50
90,Fail,60,29,0,11,49
90,Fail,45,31,4,20,25
90,Fail,43,34,8,15,28
90,Fail,41,42,0,16,25
90,Fail,41,30,0,13,28
90,Fail,53,33,0,10,43
90,Fail,53,35,0,10,43
90,Fail,52,36,0,12,40
90,Fail,49,35,3,13,36
90,Fail,45,31,10,14,31
90,Fail,46,38,5,11,35
90,Fail,46,41,0,12,34
90,Fail,42,43,0,13,29
90,Fail,45,32,0,16,29
90,Fail,42,40,9,9,33
90,Fail,50,32,6,12,38
90,Fail,49,41,0,8,41
90,Fail,43,42,0,13,30
90,Fail,46,31,14,9,37
90,Fail,59,26,0,15,44
90,Fail,45,33,0,13,32
90,Fail,46,41,2,11,35
90,Fail,41,43,6,10,31
90,Fail,56,35,0,9,47
90,Fail,47,42,0,11,36
90,Fail,49,39,1,11,38
90,Fail,53,37,0,10,43
90,Fail,48,35,5,12,36
90,Fail,48,33,0,17,31
90,Fail,47,41,2,10,37
90,Fail,59,32,0,8,51
90,Fail,49,32,0,12,37
90,Fail,52,36,4,8,44
90,Fail,49,43,0,8,41
90,Fail,41,43,1,15,26
90,Fail,45,44,0,11,34
90,Fail,48,36,0,14,34
90,Fail,57,27,0,11,46
90,Fail,47,35,6,12,35
90,Fail,42,34,0,19,23
90,Fail,49,38,0,9,40
90,Fail,50,34,3,13,37
90,Fail,50,38,2,10,40
90,Fail,45,38,0,13,32
90,Fail,47,37,0,13,34
90,Fail,48,31,5,16,32
90,Fail,52,35,0,13,39
90,Fail,45,38,0,11,34
90,Fail,62,33,0,5,57
90,Fail,51,28,0,14,37
90,Fail,51,32,2,15,36
90,Fail,51,36,3,10,41
90,Fail,48,37,4,11,37
90,Fail,55,33,1,11,44
90,Fail,51,29,0,17,34
90,Fail,46,33,0,14,32
90,Fail,50,31,6,13,37
90,Fail,47,38,0,13,34
90,Fail,51,31,0,17,34
90,Fail,55,27,5,13,42
90,Fail,52,28,2,18,34
90,Fail,48,34,0,18,30
90,Fail,49,34,2,15,34
90,Fail,45,33,0,15,30
90,Fail,46,31,7,16,30
90,Fail,45,37,0,9,36
90,Fail,47,41,0,7,40
90,Fail,42,36,5,17,25
90,Fail,48,40,0,11,37
90,Fail,53,36,1,10,43
90,Fail,42,47,0,11,31
90,Fail,47,40,1,12,35
90,Fail,48,29,6,17,31
90,Fail,48,39,0,8,40
90,Fail,44,39,0,17,27
90,Fail,49,35,0,13,36
90,Fail,50,37,2,11,39
90,Fail,47,39,7,7,40
90,Fail,45,44,0,10,35
90,Fail,45,38,3,14,31
90,Fail,50,27,1,22,28
90,Fail,53,34,0,11,42
90,Fail,48,34,0,13,35
90,Fail,52,27,0,18,34
90,Fail,49,39,0,10,39
90,Fail,48,36,0,10,38
90,Fail,49,38,0,11,38
90,Fail,43,44,2,11,32
90,Fail,45,41,0,11,34
90,Fail,41,37,0,19,22
90,Fail,49,37,7,7,42
90,Fail,42,43,2,13,29
90,Fail,47,42,0,9,38
90,Fail,48,34,0,10,38
90,Fail,45,33,7,15,30
90,Fail,42,41,0,11,31
90,Fail,46,35,0,12,34
90,Fail,47,39,4,10,37
90,Fail,50,34,0,12,38
90,Fail,53,36,0,11,42
90,Fail,50,35,4,11,39
90,Fail,46,40,0,13,33
90,Fail,48,32,7,13,35
90,Fail,52,31,0,15,37
90,Fail,50,36,0,12,38
90,Fail,53,34,0,10,43
90,Fail,41,42,5,12,29
90,Fail,57,37,0,6,51
90,Fail,45,39,3,13,32
90,Fail,46,39,2,13,33
90,Fail,46,31,0,14,32
90,Fail,44,35,9,12,32
90,Fail,51,35,0,8,43
90,Fail,48,34,0,13,35
90,Fail,45,39,1,15,30
90,Fail,45,37,0,15,30
90,Fail,34,40,0,14,20
90,Fail,48,35,1,16,32
90,Fail,50,33,7,10,40
90,Fail,44,36,6,14,30
90,Fail,58,30,0,11,47
90,Fail,50,31,3,16,34
90,Fail,49,37,0,12,37
90,Fail,46,31,0,13,33
90,Fail,40,31,14,15,25
90,Fail,49,33,0,12,37
90,Fail,49,41,3,7,42
90,Fail,47,39,1,13,34
90,Fail,56,30,0,9,47
90,Fail,55,32,0,10,45
90,Fail,56,35,0,9,47
90,Fail,48,38,5,9,39
90,Fail,53,35,0,10,43
90,Fail,44,37,3,16,28
90,Fail,53,32,5,10,43
90,Fail,46,35,0,15,31
90,Fail,41,45,0,11,30
90,Fail,44,43,0,8,36
90,Fail,56,34,0,7,49
90,Fail,47,38,6,9,38
90,Fail,48,33,7,12,36
90,Fail,44,37,5,14,30
90,Fail,49,35,0,13,36
90,Fail,47,31,8,14,33
90,Fail,46,37,2,15,31
90,Fail,52,35,0,9,43
90,Fail,43,38,0,18,25
90,Fail,47,39,3,11,36
90,Fail,49,35,1,15,34
90,Fail,60,27,4,9,51
90,Fail,41,43,2,14,27
90,Fail,40,41,0,14,26
90,Fail,45,35,5,15,30
90,Fail,43,42,7,8,35
90,Fail,56,34,3,7,49
90,Fail,50,40,0,9,41
90,Fail,43,41,5,11,32
90,Fail,52,39,0,8,44
90,Fail,51,34,0,11,40
90,Fail,58,30,0,8,50
90,Fail,50,41,0,9,41
90,Fail,46,41,5,8,38
90,Fail,47,31,11,11,36
90,Fail,53,32,0,13,40
90,Fail,40,38,0,16,24
90,Fail,54,34,1,11,43
90,Fail,48,30,9,13,35
90,Fail,56,29,0,9,47
90,Fail,47,32,0,14,33
90,Fail,44,38,0,15,29
90,Fail,43,42,2,13,30
90,Fail,50,31,0,12,38
90,Fail,48,38,0,11,37
90,Fail,44,41,3,12,32
90,Fail,53,30,9,8,45
90,Fail,44,37,6,13,31
90,Fail,52,30,0,11,41
90,Fail,58,36,0,6,52
90,Fail,49,32,1,18,31
90,Fail,49,34,0,15,34
90,Fail,47,35,4,14,33
90,Fail,47,40,1,12,35
90,Fail,47,40,0,10,37
90,Fail,52,29,5,14,38
90,Fail,53,42,1,4,49
90,Fail,44,37,0,9,35
90,Fail,50,33,0,8,42
90,Fail,45,37,6,12,33
90,Fail,50,36,0,10,40
90,Fail,50,35,1,14,36
90,Fail,47,43,1,9,38
90,Fail,45,28,7,20,25
90,Fail,46,41,0,12,34
90,Fail,41,29,0,15,26
90,Fail,54,33,4,9,45
90,Fail,45,36,0,15,30
90,Fail,52,32,2,14,38
90,Fail,43,43,0,12,31
90,Fail,48,35,2,15,33
90,Fail,50,41,0,8,42
90,Fail,49,35,0,13,36
90,Fail,44,42,4,10,34
90,Fail,42,37,7,14,28
90,Fail,46,36,3,15,31
90,Fail,46,39,0,15,31
90,Fail,47,35,3,15,32
90,Fail,50,38,0,10,40
90,Fail,49,37,0,13,36
90,Fail,41,40,7,12,29
90,Fail,42,42,1,15,27
90,Fail,58,31,2,9,49
90,Fail,51,35,0,12,39
90,Fail,49,37,4,10,39
90,Fail,39,45,0,12,27
90,Fail,55,37,0,7,48
90,Fail,42,37,0,10,32
90,Fail,47,36,4,13,34
90,Fail,43,37,5,15,28
90,Fail,53,36,0,11,42
90,Fail,50,31,0,12,38
90,Fail,49,40,0,8,41
90,Fail,50,35,6,9,41
90,Fail,39,44,7,10,29
90,Fail,47,34,0,16,31
90,Fail,53,37,1,9,44
90,Fail,48,36,0,14,34
90,Fail,52,29,8,11,41
90,Fail,50,29,3,18,32
90,Fail,50,34,3,13,37
90,Fail,44,40,1,15,29
90,Fail,47,32,0,16,31
90,Fail,53,35,0,12,41
90,Fail,47,39,6,8,39
90,Fail,54,32,6,8,46
90,Fail,50,32,0,13,37
90,Fail,40,37,10,13,27
90,Fail,51,35,2,12,39
90,Fail,48,32,5,15,33
90,Fail,53,33,2,12,41
90,Fail,50,38,0,12,38
90,Fail,47,38,0,13,34
90,Fail,44,40,5,11,33
90,Fail,54,32,5,9,45
90,Fail,52,40,0,7,45
90,Fail,47,36,1,16,31
90,Fail,52,33,3,12,40
90,Fail,55,32,0,12,43
90,Fail,47,38,4,11,36
90,Fail,48,39,0,11,37
90,Fail,48,39,4,9,39
90,Fail,49,34,0,15,34
90,Fail,48,41,1,10,38
90,Fail,47,35,0,12,35
90,Fail,44,37,0,13,31
90,Fail,46,31,0,16,30
90,Fail,53,36,0,9,44
90,Fail,43,41,5,11,32
90,Fail,53,37,2,8,45
90,Fail,44,32,0,18,26
90,Fail,50,35,0,12,38
90,Fail,45,40,4,11,34
90,Fail,43,39,0,14,29
90,Fail,50,40,0,6,44
90,Fail,47,36,2,15,32
90,Fail,48,44,2,6,42
90,Fail,48,42,0,8,40
90,Fail,48,38,0,11,37
90,Fail,49,39,3,9,40
90,Fail,55,30,4,11,44
90,Fail,44,41,0,12,32
90,Fail,47,33,5,15,32
90,Fail,55,33,0,12,43
90,Fail,46,29,12,13,33
90,Fail,51,35,3,11,40
90,Fail,43,31,9,17,26
90,Fail,46,39,6,9,37
90,Fail,54,37,0,7,47
90,Fail,53,37,0,10,43
90,Fail,49,37,0,10,39
90,Fail,44,41,0,14,30
90,Fail,49,37,0,12,37
90,Fail,46,36,0,15,31
90,Fail,46,36,8,10,36
90,Fail,51,37,2,10,41
90,Fail,38,37,0,17,21
90,Fail,51,35,0,11,40
90,Fail,50,37,2,11,39
90,Fail,46,28,0,16,30
90,Fail,45,29,4,22,23
90,Fail,47,40,0,7,40
90,Fail,50,27,3,20,30
90,Fail,43,38,2,17,26
90,Fail,46,35,4,15,31
90,Fail,46,30,10,14,32
90,Fail,54,35,1,10,44
90,Fail,45,36,10,9,36
90,Fail,46,36,4,14,32
90,Fail,49,38,1,12,37
90,Fail,46,40,0,13,33
90,Fail,49,32,0,14,35
90,Fail,43,36,0,13,30
90,Fail,46,36,0,16,30
90,Fail,50,35,2,13,37
90,Fail,46,34,0,13,33
90,Fail,53,33,0,8,45
90,Fail,55,30,0,13,42
90,Fail,45,38,3,14,31
90,Fail,49,32,0,14,35
90,Fail,53,38,0,6,47
90,Fail,45,34,0,16,29
90,Fail,40,39,0,13,27
90,Fail,47,37,4,12,35
90,Fail,43,35,3,19,24
90,Fail,51,34,3,12,39
90,Fail,50,32,0,13,37
90,Fail,54,35,0,8,46
90,Fail,39,42,1,18,21
90,Fail,46,35,6,13,33
90,Fail,43,39,0,16,27
90,Fail,49,36,0,15,34
90,Fail,48,42,0,10,38
90,Fail,52,30,0,11,41
90,Fail,36,45,0,17,19
90,Fail,49,34,0,12,37
90,Fail,49,38,0,10,39
90,Fail,52,28,0,12,40
90,Fail,41,39,2,18,23
90,Fail,50,33,0,12,38
90,Fail,41,41,3,15,26
90,Fail,49,34,0,14,35
90,Fail,49,39,0,10,39
90,Fail,49,35,0,10,39
90,Fail,46,35,5,14,32
90,Fail,47,40,2,11,36
90,Fail,47,40,4,9,38
90,Fail,56,29,0,9,47
90,Fail,50,31,0,13,37
90,Fail,47,34,0,16,31
90,Fail,44,36,2,18,26
90,Fail,49,39,0,11,38
90,Fail,54,32,0,10,44
90,Fail,44,34,0,13,31
90,Fail,57,31,0,8,49
90,Fail,49,31,0,18,31
90,Fail,52,32,2,14,38
90,Fail,43,38,7,12,31
90,Fail,57,27,5,11,46
90,Fail,43,46,3,8,35
90,Fail,49,37,4,10,39
90,Fail,45,41,0,11,34
90,Fail,50,31,8,11,39
90,Fail,49,35,0,9,40
90,Fail,42,43,0,12,30
90,Fail,50,36,0,14,36
90,Fail,50,35,3,12,38
90,Fail,53,41,0,6,47
90,Fail,53,34,3,10,43
90,Fail,49,36,3,12,37
90,Fail,54,34,4,8,46
90,Fail,52,36,0,9,43
90,Fail,43,36,0,18,25
90,Fail,47,33,0,15,32
90,Fail,48,40,2,10,38
90,Fail,55,36,0,6,49
90,Fail,45,31,0,18,27
90,Fail,48,38,1,13,35
90,Fail,52,33,4,11,41
90,Fail,52,36,1,11,41
90,Fail,47,38,0,10,37
90,Fail,49,37,0,11,38
90,Fail,46,36,2,16,30
90,Fail,54,36,0,9,45
90,Fail,59,28,0,11,48
90,Fail,49,32,0,15,34
90,Fail,42,35,6,17,25
90,Fail,45,28,0,11,34
90,Fail,46,43,0,11,35
90,Fail,41,44,0,15,26
90,Fail,47,37,0,16,31
90,Fail,54,30,0,15,39
90,Fail,50,38,2,10,40
90,Fail,49,38,0,11,38
90,Fail,48,43,3,6,42
90,Fail,45,32,0,16,29
90,Fail,46,44,3,7,39
90,Fail,52,25,12,11,41
90,Fail,48,39,0,12,36
90,Fail,51,37,0,9,42
90,Fail,54,34,0,6,48
90,Fail,46,36,0,17,29
90,Fail,52,22,5,21,31
90,Fail,49,32,5,14,35
90,Fail,48,41,0,10,38
90,Fail,51,39,2,8,43
90,Fail,46,38,0,12,34
90,Fail,44,35,4,17,27
90,Fail,48,32,3,17,31
90,Fail,43,32,7,18,25
90,Fail,43,32,11,14,29
90,Fail,40,35,4,21,19
90,Fail,46,30,0,14,32
90,Fail,47,40,0,11,36
90,Fail,51,39,3,7,44
90,Fail,39,32,10,19,20
90,Fail,58,29,0,11,47
90,Fail,50,35,0,13,37
90,Fail,47,35,2,16,31
90,Fail,45,35,2,18,27
90,Fail,46,31,8,15,31
90,Fail,51,35,2,12,39
90,Fail,41,39,0,14,27
90,Fail,46,32,6,16,30
90,Fail,56,27,0,12,44
90,Fail,48,37,0,14,34
90,Fail,49,36,0,14,35
90,Fail,43,39,0,12,31
90,Fail,56,32,0,11,45
90,Fail,45,35,0,16,29
90,Fail,53,37,0,8,45
90,Fail,44,43,1,12,32
90,Fail,44,42,0,11,33
90,Fail,48,33,0,9,39
90,Fail,50,35,2,13,37
90,Fail,51,37,1,11,40
90,Fail,59,28,2,11,48
90,Fail,48,28,4,20,28
90,Fail,43,30,8,19,24
90,Fail,44,40,0,16,28
90,Fail,53,30,0,11,42
90,Fail,50,29,0,15,35
90,Fail,45,34,7,14,31
90,Fail,49,35,0,13,36
90,Fail,51,38,0,9,42
90,Fail,52,28,0,14,38
90,Fail,45,44,0,9,36
90,Fail,46,34,0,13,33
90,Fail,43,32,0,18,25
90,Fail,52,33,3,12,40
90,Fail,44,34,9,13,31
90,Fail,47,37,0,16,31
90,Fail,49,32,0,17,32
90,Fail,44,40,0,13,31
90,Fail,51,36,0,13,38
90,Fail,56,32,0,12,44
90,Fail,56,28,0,13,43
90,Fail,43,38,4,15,28
90,Fail,48,36,0,15,33
90,Fail,51,38,1,10,41
90,Fail,46,35,5,14,32
90,Fail,48,35,0,13,35
90,Fail,40,38,0,14,26
90,Fail,48,38,0,12,36
90,Fail,49,31,5,15,34
90,Fail,54,33,1,12,42
90,Fail,53,38,0,9,44
90,Fail,52,35,1,12,40
90,Fail,42,42,6,10,32
90,Fail,53,24,5,18,35
90,Fail,41,46,0,12,29
90,Fail,52,41,0,6,46
90,Fail,47,42,2,9,38
90,Fail,50,36,5,9,41
90,Fail,51,37,0,8,43
90,Fail,49,39,0,7,42
90,Fail,48,37,0,10,38
90,Fail,51,37,0,10,41
90,Fail,51,38,0,11,40
90,Fail,52,35,0,13,39
90,Fail,49,30,7,14,35
90,Fail,48,38,0,10,38
90,Fail,50,39,1,10,40
90,Fail,51,29,8,12,39
90,Fail,48,34,0,16,32
90,Fail,34,45,0,14,20
90,Fail,52,39,2,7,45
90,Fail,53,30,0,17,36
90,Fail,52,38,0,7,45
90,Fail,50,27,0,21,29
90,Fail,53,29,0,9,44
90,Fail,52,33,0,15,37
90,Fail,46,32,0,20,26
90,Fail,48,38,4,10,38
90,Fail,48,36,0,13,35
90,Fail,43,39,0,18,25
90,Fail,51,38,0,11,40
90,Fail,49,34,0,14,35
90,Fail,47,41,0,9,38
90,Fail,49,30,7,14,35
90,Fail,41,28,15,16,25
90,Fail,51,34,0,14,37
90,Fail,50,41,1,8,42
90,Fail,49,37,0,14,35
90,Fail,46,39,6,9,37
90,Fail,45,34,3,18,27
90,Fail,46,42,1,11,35
90,Fail,56,31,5,8,48
90,Fail,46,32,0,13,33
90,Fail,50,38,0,10,40
90,Fail,44,39,7,10,34
90,Fail,48,35,0,14,34
90,Fail,47,29,0,16,31
90,Fail,47,44,0,8,39
90,Fail,52,35,3,10,42
90,Fail,50,36,2,12,38
90,Fail,49,30,0,16,33
90,Fail,42,32,6,20,22
90,Fail,51,39,2,8,43
90,Fail,58,32,1,9,49
90,Fail,55,26,8,11,44
90,Fail,57,30,4,9,48
90,Fail,39,43,0,14,25
90,Fail,53,37,3,7,46
90,Fail,44,42,6,8,36
90,Fail,52,25,0,18,34
90,Fail,45,36,0,17,28
90,Fail,52,29,0,13,39
90,Fail,40,41,0,12,28
90,Fail,55,30,4,11,44
90,Fail,53,34,2,11,42
90,Fail,45,33,0,15,30
90,Fail,48,37,5,10,38
90,Fail,46,35,11,8,38
90,Fail,49,40,0,8,41
90,Fail,47,40,3,10,37
90,Fail,39,34,0,17,22
90,Fail,48,29,0,12,36
90,Fail,52,38,1,9,43
90,Fail,41,31,13,15,26
90,Fail,45,39,4,12,33
90,Fail,47,31,0,11,36
90,Fail,50,31,4,15,35
90,Fail,41,38,6,15,26
90,Fail,45,36,0,14,31
90,Fail,52,36,0,9,43
90,Fail,47,41,0,12,35
90,Fail,45,43,0,11,34
90,Fail,48,29,12,11,37
90,Fail,53,34,0,9,44
90,Fail,51,34,0,14,37
90,Fail,47,42,3,8,39
90,Fail,53,40,2,5,48
90,Fail,51,40,1,8,43
90,Fail,49,35,2,14,35
90,Fail,41,39,0,18,23
90,Fail,46,43,1,10,36
90,Fail,49,35,0,14,35
90,Fail,49,33,3,15,34
90,Fail,54,35,0,11,43
90,Fail,47,29,0,18,29
90,Fail,54,36,2,8,46
90,Fail,54,31,0,14,40
90,Fail,51,32,3,14,37
90,Fail,43,34,6,17,26
90,Fail,49,39,1,11,38
90,Fail,51,33,2,14,37
90,Fail,36,37,0,19,17
90,Fail,59,26,1,14,45
90,Fail,46,38,0,14,32
90,Fail,53,31,0,14,39
90,Fail,44,36,0,20,24
90,Fail,53,32,4,11,42
90,Fail,51,35,1,13,38
90,Fail,51,37,4,8,43
90,Fail,51,36,2,11,40
90,Fail,52,41,0,7,45
90,Fail,49,26,6,19,30
90,Fail,43,32,11,14,29
90,Fail,54,29,3,14,40
90,Fail,46,39,0,12,34
90,Fail,50,26,8,16,34
90,Fail,45,33,6,16,29
90,Fail,49,31,4,16,33
90,Fail,47,37,0,14,33
90,Fail,51,32,1,16,35
90,Fail,47,34,10,9,38
90,Fail,41,35,0,13,28
90,Fail,47,39,0,14,33
90,Fail,49,39,1,11,38
90,Fail,57,29,0,13,44
90,Fail,55,31,1,13,42
90,Fail,45,38,0,11,34
90,Fail,46,35,0,13,33
90,Fail,55,33,0,12,43
90,Fail,46,34,5,15,31
90,Fail,53,36,0,9,44
90,Fail,42,36,10,12,30
90,Fail,44,37,0,15,29
90,Fail,50,40,2,8,42
90,Fail,49,42,0,7,42
90,Fail,54,35,4,7,47
90,Fail,42,44,0,14,28
90,Fail,50,34,6,10,40
90,Fail,48,28,0,14,34
90,Fail,45,39,0,15,30
90,Fail,41,32,0,9,32
90,Fail,45,33,0,19,26
90,Fail,46,32,0,15,31
90,Fail,40,41,0,10,30
90,Fail,51,29,0,11,40
90,Fail,55,32,7,6,49
90,Fail,40,38,7,15,25
90,Fail,47,32,4,17,30
90,Fail,48,36,8,8,40
90,Fail,56,31,0,12,44
90,Fail,55,32,3,10,45
90,Fail,52,38,1,9,43
90,Fail,48,44,0,8,40
90,Fail,50,34,0,16,34
90,Fail,59,27,0,12,47
90,Fail,49,36,8,7,42
90,Fail,53,31,3,13,40
90,Fail,46,38,4,12,34
90,Fail,52,34,0,11,41
90,Fail,58,34,0,4,54
90,Fail,49,33,0,17,32
90,Fail,52,37,0,10,42
90,Fail,42,39,0,15,27
90,Fail,50,34,0,9,41
90,Fail,51,31,2,16,35
90,Fail,59,27,3,11,48
90,Fail,53,34,0,13,40
90,Fail,50,35,3,12,38
90,Fail,53,36,3,8,45
90,Fail,55,33,0,10,45
90,Fail,54,31,7,8,46
90,Fail,53,34,0,10,43
90,Fail,40,34,9,17,23
90,Fail,45,36,7,12,33
90,Fail,42,42,3,13,29
90,Fail,45,37,0,13,32
90,Fail,51,35,0,11,40
90,Fail,48,34,1,17,31
90,Fail,44,38,0,11,33
90,Fail,48,35,3,14,34
90,Fail,50,37,0,12,38
90,Fail,51,34,4,11,40
90,Fail,44,44,0,12,32
90,Fail,53,35,1,11,42
90,Fail,48,31,0,14,34
90,Fail,52,35,0,10,42
90,Fail,51,35,2,12,39
90,Fail,47,37,0,11,36
90,Fail,53,35,2,10,43
90,Fail,45,34,8,13,32
90,Fail,42,44,2,12,30
90,Fail,51,36,1,12,39
90,Fail,41,42,4,13,28
90,Fail,45,35,4,16,29
90,Fail,56,31,0,10,46
90,Fail,45,40,5,10,35
90,Fail,44,40,0,14,30
90,Fail,52,35,0,11,41
90,Fail,47,37,10,6,41
90,Fail,55,30,2,13,42
90,Fail,41,45,1,13,28
90,Fail,49,40,0,11,38
90,Fail,47,41,0,12,35
90,Fail,49,30,6,15,34
90,Fail,46,36,5,13,33
90,Fail,52,37,2,9,43
90,Fail,52,35,0,10,42
90,Fail,41,32,10,17,24
90,Fail,47,43,1,9,38
90,Fail,50,36,0,11,39
90,Fail,50,38,0,11,39
90,Fail,48,31,0,16,32
90,Fail,46,42,2,10,36
90,Fail,50,37,0,9,41
90,Fail,47,33,7,13,34
90,Fail,48,34,2,16,32
90,Fail,41,45,6,8,33
90,Fail,38,42,6,14,24
90,Fail,43,32,8,17,26
90,Fail,49,41,4,6,43
90,Fail,53,36,0,11,42
90,Fail,46,32,5,17,29
90,Fail,47,44,7,2,45
90,Fail,40,37,0,15,25
90,Fail,40,46,0,7,33
90,Fail,50,36,0,14,36
90,Fail,41,39,3,17,24
90,Fail,48,31,0,16,32
90,Fail,49,40,2,9,40
90,Fail,53,34,3,10,43
90,Fail,53,34,5,8,45
90,Fail,51,37,3,9,42
90,Fail,51,33,5,11,40
90,Fail,47,36,1,16,31
90,Fail,43,39,0,16,27
90,Fail,45,42,1,12,33
90,Fail,44,38,0,12,32
90,Fail,49,33,5,13,36
90,Fail,51,24,13,12,39
90,Fail,49,34,0,16,33
90,Fail,45,39,2,14,31
90,Fail,49,36,0,11,38
90,Fail,43,38,1,18,25
90,Fail,47,42,0,8,39
90,Fail,52,29,0,16,36
90,Fail,52,34,0,12,40
90,Fail,46,35,0,14,32
90,Fail,55,34,0,10,45
90,Fail,41,42,0,17,24
90,Fail,48,36,4,12,36
90,Fail,46,35,0,13,33
90,Fail,47,30,10,13,34
90,Fail,56,33,3,8,48
90,Fail,44,33,0,12,32
90,Fail,49,36,4,11,38
90,Fail,44,41,0,13,31
90,Fail,44,40,0,10,34
90,Fail,51,34,0,14,37
90,Fail,37,41,7,15,22
90,Fail,39,38,0,22,17
90,Fail,46,38,0,14,32
90,Fail,50,33,0,10,40
90,Fail,45,39,5,11,34
90,Fail,59,28,0,10,49
90,Fail,52,33,0,12,40
90,Fail,56,38,0,6,50
90,Fail,44,46,1,9,35
90,Fail,45,43,0,10,35
90,Fail,48,38,4,10,38
90,Fail,40,32,0,21,19
90,Fail,47,31,0,13,34
90,Fail,52,36,1,11,41
90,Fail,45,34,0,13,32
90,Fail,53,33,0,13,40
90,Fail,46,34,0,16,30
90,Fail,48,34,9,9,39
90,Fail,54,32,8,6,48
90,Fail,56,31,0,13,43
90,Fail,52,31,3,14,38
90,Fail,52,33,2,13,39
90,Fail,52,36,3,9,43
90,Fail,44,35,0,18,26
90,Fail,53,33,0,12,41
90,Fail,51,32,6,11,40
90,Fail,46,34,7,13,33
90,Fail,53,34,3,10,43
90,Fail,41,33,4,22,19
90,Fail,42,36,0,19,23
90,Fail,54,35,2,9,45
90,Fail,51,34,0,15,36
90,Fail,45,43,2,10,35
90,Fail,53,34,0,7,46
90,Fail,49,23,12,16,33
90,Fail,44,32,0,15,29
90,Fail,51,35,2,12,39
90,Fail,44,41,0,15,29
90,Fail,46,34,0,14,32
90,Fail,51,37,0,11,40
90,Fail,52,29,3,16,36
90,Fail,43,38,3,16,27
90,Fail,50,33,0,10,40
90,Fail,50,39,0,5,45
90,Fail,51,33,0,12,39
90,Fail,58,25,0,12,46
90,Fail,49,33,0,11,38
90,Fail,55,27,0,11,44
90,Fail,43,42,0,15,28
90,Fail,41,38,5,16,25
90,Fail,49,40,0,9,40
90,Fail,51,27,0,20,31
90,Fail,47,32,14,7,40
90,Fail,53,34,0,12,41
90,Fail,50,43,0,7,43
90,Fail,39,41,0,15,24
90,Fail,54,34,0,10,44
90,Fail,46,28,0,22,24
90,Fail,50,29,5,16,34
90,Fail,42,45,0,12,30
90,Fail,44,37,0,15,29
90,Fail,55,31,0,11,44
90,Fail,49,32,6,13,36
90,Fail,53,34,0,11,42
90,Fail,54,37,0,9,45
90,Fail,46,38,4,12,34
90,Fail,44,34,7,15,29
90,Fail,44,43,1,12,32
90,Fail,49,35,6,10,39
90,Fail,50,33,0,16,34
90,Fail,46,32,0,17,29
90,Fail,49,35,0,12,37
90,Fail,44,36,0,14,30
90,Fail,52,35,1,12,40
90,Fail,47,39,0,12,35
90,Fail,48,32,0,9,39
90,Fail,51,32,8,9,42
90,Fail,42,28,12,18,24
90,Fail,43,29,0,18,25
90,Fail,45,33,7,15,30
90,Fail,55,29,0,13,42
90,Fail,51,36,2,11,40
90,Fail,38,39,9,14,24
90,Fail,47,39,0,11,36
90,Fail,55,29,3,13,42
90,Fail,45,30,0,19,26
90,Fail,40,40,9,11,29
90,Fail,48,39,1,12,36
90,Fail,48,24,0,17,31
90,Fail,49,29,0,12,37
90,Fail,47,38,1,14,33
90,Fail,45,34,12,9,36
90,Fail,43,35,0,13,30
90,Fail,48,28,0,12,36
90,Fail,53,32,8,7,46
90,Fail,45,33,0,12,33
90,Fail,45,42,4,9,36
90,Fail,55,36,0,6,49
90,Fail,54,30,0,14,40
90,Fail,44,45,5,6,38
90,Fail,46,31,12,11,35
90,Fail,52,35,2,11,41
90,Fail,54,34,0,11,43
90,Fail,45,34,0,21,24
90,Fail,48,36,0,12,36
90,Fail,50,35,0,15,35
90,Fail,56,30,4,10,46
90,Fail,52,32,4,12,40
90,Fail,40,38,10,12,28
90,Fail,47,38,0,7,40
90,Fail,47,42,0,10,37
90,Fail,54,25,0,10,44
90,Fail,50,35,0,12,38
90,Fail,54,32,0,11,43
90,Fail,56,34,1,9,47
90,Fail,52,29,6,13,39
90,Fail,44,40,4,12,32
90,Fail,52,34,2,12,40
90,Fail,53,33,2,12,41
90,Fail,52,36,2,10,42
90,Fail,59,27,0,11,48
90,Fail,44,33,0,8,36
90,Fail,50,36,0,13,37
90,Fail,46,44,2,8,38
90,Fail,45,33,5,17,28
90,Fail,47,44,0,8,39
90,Fail,43,26,8,23,20
90,Fail,52,34,0,14,38
90,Fail,47,30,5,18,29
90,Fail,39,38,8,15,24
90,Fail,50,38,4,8,42
90,Fail,52,29,0,12,40
90,Fail,47,36,3,14,33
90,Fail,36,38,0,17,19
90,Fail,48,31,0,16,32
90,Fail,53,34,2,11,42
90,Fail,50,36,5,9,41
90,Fail,53,35,0,12,41
90,Fail,46,33,3,18,28
90,Fail,55,32,0,13,42
90,Fail,45,38,0,16,29
90,Fail,51,36,3,10,41
90,Fail,46,39,1,14,32
90,Fail,48,36,0,12,36
90,Fail,39,40,0,5,34
90,Fail,52,37,3,8,44
90,Fail,42,42,4,12,30
90,Fail,51,37,3,9,42
90,Fail,49,35,0,9,40
90,Fail,51,32,0,15,36
90,Fail,49,40,0,9,40
90,Fail,44,43,1,12,32
90,Fail,45,37,0,12,33
90,Fail,46,35,0,15,31
90,Fail,49,35,0,15,34
90,Fail,51,35,6,8,43
90,Fail,54,31,0,10,44
90,Fail,52,35,0,12,40
90,Fail,52,35,0,13,39
90,Fail,43,38,6,13,30
90,Fail,46,39,0,11,35
90,Fail,43,30,16,11,32
90,Fail,44,36,0,12,32
90,Fail,48,34,7,11,37
90,Fail,49,37,5,9,40
90,Fail,60,25,3,12,48
90,Fail,50,39,0,9,41
90,Fail,50,36,5,9,41
90,Fail,57,35,0,8,49
90,Fail,56,35,4,5,51
90,Fail,43,38,7,12,31
90,Fail,49,34,0,15,34
90,Fail,46,34,0,12,34
90,Fail,45,38,0,17,28
90,Fail,57,31,0,12,45
90,Fail,50,42,0,8,42
90,Fail,52,32,1,15,37
90,Fail,49,35,3,13,36
90,Fail,47,28,8,17,30
90,Fail,51,36,0,12,39
90,Fail,56,33,0,10,46
90,Fail,43,26,0,16,27
90,Fail,41,42,0,12,29
90,Fail,50,35,0,11,39
90,Fail,48,35,3,14,34
90,Fail,53,30,0,14,39
90,Fail,42,37,0,14,28
90,Fail,49,37,2,12,37
90,Fail,45,43,0,6,39
90,Fail,55,34,0,8,47
90,Fail,45,41,0,11,34
90,Fail,48,33,3,16,32
90,Fail,48,31,0,12,36
90,Fail,41,36,6,17,24
90,Fail,41,43,0,12,29
90,Fail,46,36,1,17,29
90,Fail,43,38,4,15,28
90,Fail,43,37,5,15,28
90,Fail,53,29,4,14,39
90,Fail,47,37,8,8,39
90,Fail,54,31,0,10,44
90,Fail,51,31,0,15,36
90,Fail,47,41,0,12,35
90,Fail,52,35,0,7,45
90,Fail,52,33,5,10,42
90,Fail,57,25,0,14,43
90,Fail,52,39,0,8,44
90,Fail,48,42,1,9,39
90,Fail,47,35,8,10,37
90,Fail,48,41,0,10,38
90,Fail,46,37,6,11,35
90,Fail,51,32,0,16,35
90,Fail,49,38,0,12,37
90,Fail,50,34,0,10,40
90,Fail,37,38,0,20,17
90,Fail,47,31,0,19,28
90,Fail,45,39,0,7,38
90,Fail,53,34,0,9,44
90,Fail,46,36,6,12,34
90,Fail,45,32,7,16,29
90,Fail,40,40,9,11,29
90,Fail,41,39,9,11,30
90,Fail,47,37,5,11,36
90,Fail,40,43,1,16,24
90,Fail,51,35,2,12,39
90,Fail,48,36,0,15,33
90,Fail,51,30,0,14,37
90,Fail,49,33,2,16,33
90,Fail,45,36,6,13,32
90,Fail,53,38,2,7,46
90,Fail,45,37,1,17,28
90,Fail,51,33,0,16,35
90,Fail,42,38,0,16,26
90,Fail,49,32,0,13,36
90,Fail,48,36,0,16,32
90,Fail,45,39,0,12,33
90,Fail,49,31,0,9,40
90,Fail,56,34,0,9,47
90,Fail,46,48,0,5,41
90,Fail,36,42,3,19,17
90,Fail,50,33,3,14,36
90,Fail,52,30,2,16,36
90,Fail,50,30,8,12,38
90,Fail,44,38,0,13,31
90,Fail,46,26,6,22,24
90,Fail,48,35,0,15,33
90,Fail,39,46,0,10,29
90,Fail,53,31,0,10,43
90,Fail,42,42,0,15,27
90,Fail,48,40,0,9,39
90,Fail,50,43,2,5,45
90,Fail,49,38,1,12,37
90,Fail,49,36,0,9,40
90,Fail,56,34,0,8,48
90,Fail,50,31,4,15,35
90,Fail,51,35,0,13,38
90,Fail,55,28,0,9,46
90,Fail,58,28,3,11,47
90,Fail,41,44,3,12,29
90,Fail,38,43,0,11,27
90,Fail,53,35,2,10,43
90,Fail,62,23,0,12,50
90,Fail,55,34,2,9,46
90,Fail,49,39,1,11,38
90,Fail,45,47,0,7,38
90,Fail,50,31,0,11,39
90,Fail,44,40,2,14,30
90,Fail,48,34,10,8,40
90,Fail,53,35,1,11,42
90,Fail,46,35,4,15,31
90,Fail,54,33,3,10,44
90,Fail,54,35,2,9,45
90,Fail,50,31,0,13,37
90,Fail,43,42,0,13,30
90,Fail,41,38,0,16,25
90,Fail,45,38,6,11,34
90,Fail,57,32,1,10,47
90,Fail,42,32,8,18,24
90,Fail,46,34,0,14,32
90,Fail,39,34,0,25,14
90,Fail,49,32,0,13,36
90,Fail,49,39,0,12,37
90,Fail,43,34,6,17,26
90,Fail,57,28,0,12,45
90,Fail,41,39,0,11,30
90,Fail,43,35,5,17,26
90,Fail,47,40,0,11,36
90,Fail,49,39,0,11,38
90,Fail,44,33,10,13,31
90,Fail,46,33,4,17,29
90,Fail,47,39,0,14,33
90,Fail,51,29,0,12,39
90,Fail,42,41,0,14,28
90,Fail,46,40,0,7,39
90,Fail,46,37,0,17,29
90,Fail,46,37,3,14,32
90,Fail,50,27,4,19,31
90,Fail,54,29,3,14,40
90,Fail,52,38,1,9,43
90,Fail,44,37,7,12,32
90,Fail,46,32,8,14,32
90,Fail,41,35,3,21,20
90,Fail,44,39,0,10,34
90,Fail,50,33,0,17,33
90,Fail,51,38,7,4,47
90,Fail,39,40,0,13,26
90,Fail,50,33,0,16,34
90,Fail,54,33,3,10,44
90,Fail,45,34,0,14,31
90,Fail,47,38,5,10,37
90,Fail,44,36,6,14,30
90,Fail,49,35,1,15,34
90,Fail,52,30,7,11,41
90,Fail,43,40,5,12,31
90,Fail,39,38,0,12,27
90,Fail,52,30,0,15,37
90,Fail,43,31,0,17,26
90,Fail,54,34,0,11,43
90,Fail,50,28,0,15,35
90,Fail,40,40,0,16,24
90,Fail,51,34,2,13,38
90,Fail,50,34,2,14,36
90,Fail,43,39,0,13,30
90,Fail,51,33,2,14,37
90,Fail,49,30,0,16,33
90,Fail,42,38,5,15,27
90,Fail,55,34,0,11,44
90,Fail,50,34,6,10,40
90,Fail,39,41,4,16,23
90,Fail,46,42,2,10,36
90,Fail,53,34,0,10,43
90,Fail,45,39,6,10,35
90,Fail,50,38,3,9,41
90,Fail,42,33,0,25,17
90,Fail,41,36,6,17,24
90,Fail,59,30,0,11,48
90,Fail,46,38,0,9,37
90,Fail,55,33,0,12,43
90,Fail,54,27,8,11,43
90,Fail,49,40,0,11,38
90,Fail,43,38,5,14,29
90,Fail,44,49,0,7,37
90,Fail,50,35,1,14,36
90,Fail,54,32,2,12,42
90,Fail,44,30,14,12,32
90,Fail,52,36,0,12,40
90,Fail,49,37,0,10,39
90,Fail,55,32,0,9,46
90,Fail,40,46,3,11,29
90,Fail,50,38,3,9,41
90,Fail,43,37,6,14,29
90,Fail,46,39,0,13,33
90,Fail,44,40,1,15,29
90,Fail,46,32,7,15,31
90,Fail,53,31,3,13,40
90,Fail,46,32,0,16,30
90,Fail,50,40,0,10,40
90,Fail,45,33,0,15,30
90,Fail,50,32,0,14,36
90,Fail,45,32,0,23,22
90,Fail,52,23,0,20,32
90,Fail,49,32,1,18,31
90,Fail,54,32,3,11,43
90,Fail,53,34,1,12,41
90,Fail,43,32,0,16,27
90,Fail,57,36,0,6,51
90,Fail,50,35,5,10,40
90,Fail,51,34,0,14,37
90,Fail,45,40,3,12,33
90,Fail,47,34,7,12,35
90,Fail,46,34,0,13,33
90,Fail,48,37,4,11,37
90,Fail,44,41,0,15,29
90,Fail,45,26,0,13,32
90,Fail,52,33,2,13,39
90,Fail,39,42,0,19,20
90,Fail,53,37,4,6,47
90,Fail,51,35,2,12,39
90,Fail,47,39,0,13,34
90,Fail,48,39,0,9,39
90,Fail,45,38,0,12,33
90,Fail,45,37,7,11,34
90,Fail,45,33,9,13,32
90,Fail,45,33,0,16,29
90,Fail,50,40,1,9,41
90,Fail,48,39,0,13,35
90,Fail,50,32,0,13,37
90,Fail,47,32,3,18,29
90,Fail,46,35,0,17,29
90,Fail,43,42,0,14,29
90,Fail,35,43,0,17,18
90,Fail,44,35,5,16,28
90,Fail,38,43,0,13,25
90,Fail,53,31,0,13,40
90,Fail,46,31,6,17,29
90,Fail,45,42,0,13,32
90,Fail,51,34,0,15,36
90,Fail,45,43,3,9,36
90,Fail,47,36,2,15,32
90,Fail,51,36,0,13,38
90,Fail,59,30,6,5,54
90,Fail,48,32,4,16,32
90,Fail,44,40,0,12,32
90,Fail,54,35,1,10,44
90,Fail,53,36,3,8,45
90,Fail,50,34,1,15,35
90,Fail,52,34,3,11,41
90,Fail,46,44,0,8,38
90,Fail,54,32,0,11,43
90,Fail,44,38,1,17,27
90,Fail,43,35,1,21,22
90,Fail,46,41,3,10,36
90,Fail,50,37,0,12,38
90,Fail,45,41,2,12,33
90,Fail,49,31,0,15,34
90,Fail,51,37,2,10,41
90,Fail,42,39,9,10,32
90,Fail,51,30,0,12,39
90,Fail,51,30,0,15,36
90,Fail,44,32,9,15,29
90,Fail,47,37,3,13,34
90,Fail,52,34,0,14,38
90,Fail,48,36,0,15,33
90,Fail,56,29,1,14,42
90,Fail,47,37,0,6,41
90,Fail,49,31,0,19,30
90,Fail,51,31,3,15,36
90,Fail,46,39,3,12,34
90,Fail,50,38,1,11,39
90,Fail,55,32,6,7,48
90,Fail,51,31,8,10,41
90,Fail,39,45,0,11,28
90,Fail,50,30,0,19,31
90,Fail,42,40,0,10,32
90,Fail,43,41,1,15,28
90,Fail,48,36,0,16,32
90,Fail,51,35,0,11,40
90,Fail,53,34,3,10,43
90,Fail,46,44,0,10,36
90,Fail,46,35,0,13,33
90,Fail,45,39,0,14,31
90,Fail,43,39,5,13,30
90,Fail,45,38,1,16,29
90,Fail,54,34,0,12,42
90,Fail,50,34,0,10,40
90,Fail,44,36,0,17,27
90,Fail,45,49,0,6,39
90,Fail,42,38,6,14,28
90,Fail,47,37,0,14,33
90,Fail,56,28,0,16,40
90,Fail,49,31,0,13,36
90,Fail,45,35,0,15,30
90,Fail,44,36,6,14,30
90,Fail,40,33,0,16,24
90,Fail,49,40,0,9,40
90,Fail,45,38,0,15,30
90,Fail,50,34,0,13,37
90,Fail,52,32,6,10,42
90,Fail,53,34,0,12,41
90,Fail,51,32,1,16,35
90,Fail,48,34,3,15,33
90,Fail,54,36,0,7,47
90,Fail,45,41,0,11,34
90,Fail,52,30,0,15,37
90,Fail,49,30,6,15,34
90,Fail,42,47,1,10,32
90,Fail,46,37,0,13,33
90,Fail,53,32,0,13,40
90,Fail,48,37,0,12,36
90,Fail,55,26,0,14,41
90,Fail,57,31,0,8,49
90,Fail,48,34,0,12,36
90,Fail,43,28,0,13,30
90,Fail,49,36,3,12,37
90,Fail,49,33,0,14,35
90,Fail,49,34,0,13,36
90,Fail,52,33,0,13,39
90,Fail,45,39,1,15,30
90,Fail,50,40,0,8,42
90,Fail,41,42,0,15,26
90,Fail,53,30,4,13,40
90,Fail,41,39,0,15,26
90,Fail,53,29,0,11,42
90,Fail,43,33,0,18,25
90,Fail,48,40,2,10,38
90,Fail,39,41,0,12,27
90,Fail,43,35,0,18,25
90,Fail,40,40,4,16,24
90,Fail,41,38,0,13,28
90,Fail,52,31,5,12,40
90,Fail,50,29,6,15,35
90,Fail,45,35,6,14,31
90,Fail,39,38,7,16,23
90,Fail,48,33,0,17,31
90,Fail,50,32,4,14,36
90,Fail,49,36,4,11,38
90,Fail,47,40,0,12,35
90,Fail,44,39,0,10,34
90,Fail,49,36,4,11,38
90,Fail,54,31,2,13,41
90,Fail,51,36,2,11,40
90,Fail,56,35,0,9,47
90,Fail,52,32,0,14,38
90,Fail,44,32,0,19,25
90,Fail,49,36,5,10,39
90,Fail,52,33,0,10,42
90,Fail,43,44,0,8,35
90,Fail,44,41,1,14,30
90,Fail,48,34,0,10,38
90,Fail,44,39,2,15,29
90,Fail,53,31,7,9,44
90,Fail,55,24,0,18,37
90,Fail,39,41,8,12,27
90,Fail,46,29,0,18,28
90,Fail,57,33,0,7,50
90,Fail,47,39,0,12,35
90,Fail,44,34,7,15,29
90,Fail,48,36,0,14,34
90,Fail,49,29,0,12,37
90,Fail,43,34,0,14,29
90,Fail,45,37,0,13,32
90,Fail,50,34,3,13,37
90,Fail,44,33,0,18,26
90,Fail,50,32,0,13,37
90,Fail,45,34,11,10,35
90,Fail,42,37,0,16,26
90,Fail,43,43,3,11,32
90,Fail,47,38,0,15,32
90,Fail,46,38,1,15,31
90,Fail,50,33,0,13,37
90,Fail,50,36,0,10,40
90,Fail,55,30,0,9,46
90,Fail,42,42,1,15,27
90,Fail,45,36,7,12,33
90,Fail,46,40,0,11,35
90,Fail,46,42,0,12,34
90,Fail,48,34,0,18,30
90,Fail,57,32,0,10,47
90,Fail,50,33,3,14,36
90,Fail,49,40,0,10,39
90,Fail,47,31,0,12,35
90,Fail,49,31,0,13,36
90,Fail,50,34,8,8,42
90,Fail,51,38,6,5,46
90,Fail,48,37,0,12,36
90,Fail,40,45,4,11,29
90,Fail,45,37,0,14,31
90,Fail,46,34,0,16,30
90,Fail,45,42,1,12,33
90,Fail,46,34,0,8,38
90,Fail,49,34,0,12,37
90,Fail,45,32,5,18,27
90,Fail,47,35,0,13,34
90,Fail,44,36,4,16,28
90,Fail,48,35,1,16,32
90,Fail,46,37,0,9,37
90,Fail,47,36,0,15,32
90,Fail,48,36,1,15,33
90,Fail,45,36,0,18,27
90,Fail,53,34,3,10,43
90,Fail,43,37,10,10,33
90,Fail,40,38,0,11,29
90,Fail,45,44,0,10,35
90,Fail,56,37,0,7,49
90,Fail,50,37,0,13,37
90,Fail,50,31,8,11,39
90,Fail,51,31,3,15,36
90,Fail,45,33,11,11,34
90,Fail,44,39,0,14,30
90,Fail,43,31,0,14,29
90,Fail,49,43,0,8,41
90,Fail,51,40,0,9,42
90,Fail,58,31,3,8,50
90,Fail,48,40,2,10,38
90,Fail,43,38,0,10,33
90,Fail,51,31,0,17,34
90,Fail,44,43,0,12,32
90,Fail,41,33,7,19,22
90,Fail,54,35,0,9,45
90,Fail,41,41,6,12,29
90,Fail,45,36,5,14,31
90,Fail,51,33,4,12,39
90,Fail,46,42,0,11,35
90,Fail,51,34,0,9,42
90,Fail,44,34,6,16,28
90,Fail,56,33,3,8,48
90,Fail,43,46,0,10,33
90,Fail,56,27,0,15,41
90,Fail,56,32,0,11,45
90,Fail,41,42,0,13,28
90,Fail,48,35,1,16,32
90,Fail,45,33,7,15,30
90,Fail,52,36,0,7,45
90,Fail,50,26,0,12,38
90,Fail,53,34,0,8,45
90,Fail,54,31,8,7,47
90,Fail,51,38,0,11,40
90,Fail,52,29,0,19,33
90,Fail,46,37,2,15,31
90,Fail,52,34,1,13,39
90,Fail,49,36,0,13,36
90,Fail,46,40,2,12,34
90,Fail,53,36,0,11,42
90,Fail,43,37,0,14,29
90,Fail,56,35,2,7,49
90,Fail,47,35,0,16,31
90,Fail,42,37,0,13,29
90,Fail,47,34,2,17,30
90,Fail,48,37,0,11,37
90,Fail,52,34,0,13,39
90,Fail,41,39,6,14,27
90,Fail,41,36,12,11,30
90,Fail,54,36,0,10,44
90,Fail,51,36,0,12,39
90,Fail,52,38,0,10,42
90,Fail,50,40,0,8,42
90,Fail,51,36,0,11,40
90,Fail,54,28,0,12,42
90,Fail,46,39,0,11,35
90,Fail,39,44,0,17,22
90,Fail,45,41,0,11,34
90,Fail,54,34,2,10,44
90,Fail,46,37,0,14,32
90,Fail,43,38,10,9,34
90,Fail,53,31,3,13,40
90,Fail,44,34,7,15,29
90,Fail,42,35,7,16,26
90,Fail,45,35,4,16,29
90,Fail,46,39,3,12,34
90,Fail,38,36,11,15,23
90,Fail,53,31,0,16,37
90,Fail,42,40,0,16,26
90,Fail,56,28,0,14,42
90,Fail,49,38,0,11,38
90,Fail,48,40,0,12,36
90,Fail,44,30,0,14,30
90,Fail,47,37,0,14,33
90,Fail,53,34,2,11,42
90,Fail,41,43,2,14,27
90,Fail,46,37,0,13,33
90,Fail,53,30,3,14,39
90,Fail,51,32,0,11,40
90,Fail,50,33,5,12,38
90,Fail,50,34,3,13,37
90,Fail,53,33,2,12,41
90,Fail,47,36,0,14,33
90,Fail,54,33,0,11,43
90,Fail,52,36,0,11,41
90,Fail,41,41,2,16,25
90,Fail,49,34,0,16,33
90,Fail,48,35,0,12,36
90,Fail,39,39,0,14,25
90,Fail,47,34,7,12,35
90,Fail,38,25,19,18,20
90,Fail,57,30,0,12,45
90,Fail,49,38,0,8,41
90,Fail,42,40,1,17,25
90,Fail,58,30,0,10,48
90,Fail,47,40,2,11,36
90,Fail,53,33,0,9,44
90,Fail,46,38,6,10,36
90,Fail,39,42,5,14,25
90,Fail,41,37,5,17,24
90,Fail,41,39,3,17,24
90,Fail,43,42,0,15,28
90,Fail,58,25,9,8,50
90,Fail,52,29,0,9,43
90,Fail,43,36,2,19,24
90,Fail,50,31,5,14,36
90,Fail,55,30,3,12,43
90,Fail,41,43,0,13,28
90,Fail,47,30,0,19,28
90,Fail,46,39,4,11,35
90,Fail,46,30,0,20,26
90,Fail,40,50,3,7,33
90,Fail,48,35,0,16,32
90,Fail,47,37,0,14,33
90,Fail,52,36,2,10,42
90,Fail,51,40,0,8,43
90,Fail,51,38,0,11,40
90,Fail,47,43,2,8,39
90,Fail,54,31,3,12,42
90,Fail,49,41,0,10,39
90,Fail,51,30,1,18,33
90,Fail,43,33,9,15,28
90,Fail,43,37,0,19,24
90,Fail,37,32,13,18,19
90,Fail,46,40,1,13,33
90,Fail,53,39,0,4,49
90,Fail,47,29,10,14,33
90,Fail,47,42,0,11,36
90,Fail,43,34,6,17,26
90,Fail,48,38,0,10,38
90,Fail,57,35,2,6,51
90,Fail,47,40,1,12,35
90,Fail,42,39,0,15,27
90,Fail,44,31,10,15,29
90,Fail,50,36,2,12,38
90,Fail,44,35,0,13,31
90,Fail,52,34,1,13,39
90,Fail,53,34,4,9,44
90,Fail,44,38,0,13,31
90,Fail,46,40,0,12,34
90,Fail,45,40,0,12,33
90,Fail,52,35,0,10,42
90,Fail,47,36,2,15,32
90,Fail,45,34,4,17,28
90,Fail,51,34,3,12,39
90,Fail,51,39,0,10,41
90,Fail,50,38,0,12,38
90,Fail,52,32,1,15,37
90,Fail,54,31,6,9,45
90,Fail,50,32,0,16,34
90,Fail,44,37,0,11,33
90,Fail,48,39,2,11,37
90,Fail,50,36,0,7,43
90,Fail,43,35,9,13,30
90,Fail,52,27,0,12,40
90,Fail,48,38,3,11,37
90,Fail,43,30,8,19,24
90,Fail,47,35,0,13,34
90,Fail,45,41,0,11,34
90,Fail,47,31,3,19,28
90,Fail,39,38,8,15,24
90,Fail,48,31,6,15,33
90,Fail,46,31,0,16,30
90,Fail,41,36,9,14,27
90,Fail,58,30,2,10,48
90,Fail,49,29,0,14,35
90,Fail,47,37,3,13,34
90,Fail,48,35,0,15,33
90,Fail,45,30,0,25,20
90,Fail,53,31,0,13,40
90,Fail,51,38,5,6,45
90,Fail,49,33,0,17,32
90,Fail,51,36,0,13,38
90,Fail,55,28,4,13,42
90,Fail,42,33,6,19,23
90,Fail,46,35,8,11,35
90,Fail,54,35,2,9,45
90,Fail,47,29,9,15,32
90,Fail,54,28,0,14,40
90,Fail,44,33,8,15,29
90,Fail,56,31,0,12,44
90,Fail,57,25,4,14,43
90,Fail,55,37,0,8,47
90,Fail,54,31,0,13,41
90,Fail,48,33,2,17,31
90,Fail,47,34,0,16,31
90,Fail,43,35,0,14,29
90,Fail,56,25,0,13,43
90,Fail,50,39,3,8,42
90,Fail,51,36,0,13,38
90,Fail,39,43,6,12,27
90,Fail,54,33,0,8,46
90,Fail,56,29,0,11,45
90,Fail,51,32,0,14,37
90,Fail,53,28,0,13,40
90,Fail,44,40,0,10,34
90,Fail,47,36,0,15,32
90,Fail,41,36,10,13,28
90,Fail,46,41,7,6,40
90,Fail,45,40,0,15,30
90,Fail,48,35,0,14,34
90,Fail,49,33,3,15,34
90,Fail,50,32,3,15,35
90,Fail,49,30,4,17,32
90,Fail,48,40,0,9,39
90,Fail,45,42,1,12,33
90,Fail,48,39,0,7,41
90,Fail,51,26,0,16,35
90,Fail,50,34,0,12,38
90,Fail,55,24,0,19,36
90,Fail,47,34,0,11,36
90,Fail,49,37,0,13,36
90,Fail,45,31,0,13,32
90,Fail,43,37,5,15,28
90,Fail,53,32,0,15,38
90,Fail,43,40,2,15,28
90,Fail,50,41,0,6,44
90,Fail,45,29,5,21,24
90,Fail,52,35,0,13,39
90,Fail,53,42,0,5,48
90,Fail,46,31,0,18,28
90,Fail,46,36,0,17,29
90,Fail,56,33,1,10,46
90,Fail,53,34,1,12,41
90,Fail,48,36,0,13,35
90,Fail,43,39,0,10,33
90,Fail,47,34,0,13,34
90,Fail,52,34,0,11,41
90,Fail,39,39,7,15,24
90,Fail,43,31,0,15,28
90,Fail,39,39,0,16,23
90,Fail,46,44,0,9,37
90,Fail,51,30,0,18,33
90,Fail,44,37,6,13,31
90,Fail,51,42,1,6,45
90,Fail,43,37,3,17,26
90,Fail,51,32,0,8,43
90,Fail,48,38,0,11,37
90,Fail,47,40,0,12,35
90,Fail,48,39,0,8,40
90,Fail,50,37,0,10,40
90,Fail,43,38,0,14,29
90,Fail,45,38,0,16,29
90,Fail,51,35,1,13,38
90,Fail,46,37,2,15,31
90,Fail,44,43,5,8,36
90,Fail,52,41,0,7,45
90,Fail,42,41,0,11,31
90,Fail,47,35,0,16,31
90,Fail,51,38,0,8,43
90,Fail,48,31,4,17,31
90,Fail,53,43,0,3,50
90,Fail,47,35,0,15,32
90,Fail,52,33,0,12,40
90,Fail,40,34,0,11,29
90,Fail,56,26,0,11,45
90,Fail,50,37,0,12,38
90,Fail,38,39,0,17,21
90,Fail,47,34,5,14,33
90,Fail,46,36,6,12,34
90,Fail,50,28,0,16,34
90,Fail,51,32,3,14,37
90,Fail,44,40,0,9,35
90,Fail,52,31,0,14,38
90,Fail,37,29,14,20,17
90,Fail,48,36,2,14,34
90,Fail,54,34,1,11,43
90,Fail,48,31,0,17,31
90,Fail,45,38,0,12,33
90,Fail,43,48,0,9,34
90,Fail,48,34,1,17,31
90,Fail,52,37,3,8,44
90,Fail,48,39,0,11,37
90,Fail,44,34,5,17,27
90,Fail,48,33,0,15,33
90,Fail,49,34,0,14,35
90,Fail,48,37,3,12,36
90,Fail,55,30,3,12,43
90,Fail,53,33,2,12,41
90,Fail,52,29,6,13,39
90,Fail,50,38,1,11,39
90,Fail,41,42,0,14,27
90,Fail,49,41,2,8,41
90,Fail,62,30,0,8,54
90,Fail,46,40,1,13,33
90,Fail,49,31,4,16,33
90,Fail,46,37,8,9,37
90,Fail,44,35,0,15,29
90,Fail,47,39,0,11,36
90,Fail,41,39,3,17,24
90,Fail,41,38,1,20,21
90,Fail,41,35,9,15,26
90,Fail,49,32,8,11,38
90,Fail,45,41,3,11,34
90,Fail,39,41,0,13,26
90,Fail,47,34,0,16,31
90,Fail,42,43,3,12,30
90,Fail,54,24,0,16,38
90,Fail,50,39,0,9,41
90,Fail,44,43,6,7,37
90,Fail,42,38,3,17,25
90,Fail,46,35,8,11,35
90,Fail,52,35,0,12,40
90,Fail,46,38,0,13,33
90,Fail,49,39,0,12,37
90,Fail,49,37,1,13,36
90,Fail,45,33,11,11,34
90,Fail,45,39,2,14,31
90,Fail,46,37,5,12,34
90,Fail,48,34,0,13,35
90,Fail,32,46,0,22,10
90,Fail,50,32,3,15,35
90,Fail,48,30,0,16,32
90,Fail,44,36,0,20,24
90,Fail,40,33,0,20,20
90,Fail,48,35,0,17,31
90,Fail,51,36,6,7,44
90,Fail,49,34,0,10,39
90,Fail,52,36,4,8,44
90,Fail,51,33,5,11,40
90,Fail,41,42,0,13,28
90,Fail,52,33,0,11,41
90,Fail,49,34,5,12,37
90,Fail,51,29,3,17,34
90,Fail,47,32,0,20,27
90,Fail,43,38,6,13,30
90,Fail,49,35,3,13,36
90,Fail,40,43,3,14,26
90,Fail,51,34,0,9,42
90,Fail,44,41,0,9,35
90,Fail,51,37,0,11,40
90,Fail,44,38,2,16,28
90,Fail,44,43,1,12,32
90,Fail,46,32,0,18,28
90,Fail,48,37,1,14,34
90,Fail,49,31,0,18,31
90,Fail,42,36,0,10,32
90,Fail,46,41,2,11,35
90,Fail,45,35,3,17,28
90,Fail,43,36,6,15,28
90,Fail,53,35,0,12,41
90,Fail,46,38,0,13,33
90,Fail,44,36,1,19,25
90,Fail,44,42,0,10,34
90,Fail,44,33,0,15,29
90,Fail,40,43,7,10,30
90,Fail,46,35,5,14,32
90,Fail,49,34,0,13,36
90,Fail,50,37,0,9,41
90,Fail,45,30,0,9,36
90,Fail,36,40,0,15,21
90,Fail,45,37,0,16,29
90,Fail,43,39,0,16,27
90,Fail,49,30,4,17,32
90,Fail,48,34,0,12,36
90,Fail,45,31,4,20,25
90,Fail,45,38,5,12,33
90,Fail,43,33,0,15,28
90,Fail,56,30,4,10,46
90,Fail,52,35,3,10,42
90,Fail,44,39,0,15,29
90,Fail,47,40,1,12,35
90,Fail,44,45,0,9,35
90,Fail,48,36,0,13,35
90,Fail,50,37,0,10,40
90,Fail,60,31,0,8,52
90,Fail,42,38,4,16,26
90,Fail,46,40,0,9,37
90,Fail,47,32,7,14,33
90,Fail,40,38,0,14,26
90,Fail,46,41,0,12,34
90,Fail,44,34,0,14,30
90,Fail,45,36,11,8,37
90,Fail,45,30,0,16,29
90,Fail,45,35,0,14,31
90,Fail,55,29,2,14,41
90,Fail,54,28,0,13,41
90,Fail,52,36,1,11,41
90,Fail,55,33,0,11,44
90,Fail,54,34,0,11,43
90,Fail,40,36,9,15,25
90,Fail,50,38,3,9,41
90,Fail,47,39,0,14,33
90,Fail,51,32,4,13,38
90,Fail,35,38,15,12,23
90,Fail,35,46,1,18,17
90,Fail,42,36,4,18,24
90,Fail,43,36,5,16,27
90,Fail,49,31,8,12,37
90,Fail,49,36,0,8,41
90,Fail,51,33,1,15,36
90,Fail,38,43,0,17,21
90,Fail,55,29,1,15,40
90,Fail,54,29,3,14,40
90,Fail,55,33,0,4,51
90,Fail,45,34,0,13,32
90,Fail,46,38,2,14,32
90,Fail,45,35,0,15,30
90,Fail,50,28,8,14,36
90,Fail,48,34,0,12,36
90,Fail,45,30,9,16,29
90,Fail,45,26,0,21,24
90,Fail,49,42,2,7,42
90,Fail,49,34,0,13,36
90,Fail,56,30,0,14,42
90,Fail,47,31,8,14,33
90,Fail,56,33,1,10,46
90,Fail,47,39,2,12,35
90,Fail,48,36,6,10,38
90,Fail,48,40,1,11,37
90,Fail,51,29,3,17,34
90,Fail,55,33,0,11,44
90,Fail,47,31,0,16,31
90,Fail,40,44,0,9,31
90,Fail,41,38,0,18,23
90,Fail,50,40,1,9,41
90,Fail,46,34,7,13,33
90,Fail,45,39,5,11,34
90,Fail,43,38,0,13,30
90,Fail,49,33,6,12,37
90,Fail,48,39,0,12,36
90,Fail,50,37,0,13,37
90,Fail,48,31,0,8,40
90,Fail,51,32,5,12,39
90,Fail,44,42,4,10,34
90,Fail,41,41,4,14,27
90,Fail,44,28,13,15,29
90,Fail,44,31,9,16,28
90,Fail,46,40,0,13,33
90,Fail,40,29,16,15,25
90,Fail,49,42,0,8,41
90,Fail,44,36,5,15,29
90,Fail,45,35,0,19,26
90,Fail,50,30,8,12,38
90,Fail,52,36,5,7,45
90,Fail,49,39,0,11,38
90,Fail,53,28,0,12,41
90,Fail,50,31,5,14,36
90,Fail,47,41,2,10,37
90,Fail,52,31,0,10,42
90,Fail,48,35,6,11,37
90,Fail,59,29,0,11,48
90,Fail,56,30,1,13,43
90,Fail,49,31,0,13,36
90,Fail,50,32,5,13,37
90,Fail,49,32,8,11,38
90,Fail,48,33,0,14,34
90,Fail,47,33,0,15,32
90,Fail,48,37,0,9,39
90,Fail,57,29,3,11,46
90,Fail,40,39,2,19,21
90,Fail,47,39,2,12,35
90,Fail,56,31,0,13,43
90,Fail,44,44,6,6,38
90,Fail,56,31,0,10,46
90,Fail,55,32,0,13,42
90,Fail,51,41,1,7,44
90,Fail,44,36,0,19,25
90,Fail,44,36,0,14,30
90,Fail,48,32,1,19,29
90,Fail,56,32,1,11,45
90,Fail,49,43,3,5,44
90,Fail,51,37,0,9,42
90,Fail,53,31,4,12,41
90,Fail,55,30,0,12,43
90,Fail,46,40,2,12,34
90,Fail,52,35,0,12,40
90,Fail,49,36,4,11,38
90,Fail,47,33,11,9,38
90,Fail,50,35,0,14,36
90,Fail,47,38,3,12,35
90,Fail,47,38,2,13,34
90,Fail,42,34,9,15,27
90,Fail,57,28,0,12,45
90,Fail,48,28,7,17,31
90,Fail,54,27,0,11,43
90,Fail,47,31,11,11,36
90,Fail,52,34,0,10,42
90,Fail,49,31,4,16,33
90,Fail,51,35,6,8,43
90,Fail,45,36,0,13,32
90,Fail,43,35,5,17,26
90,Fail,48,32,5,15,33
90,Fail,41,32,0,17,24
90,Fail,48,34,0,7,41
90,Fail,45,42,0,13,32
90,Fail,55,32,1,12,43
90,Fail,46,40,0,14,32
90,Fail,47,44,0,9,38
90,Fail,43,35,0,12,31
90,Fail,44,33,7,16,28
90,Fail,43,39,0,15,28
90,Fail,45,39,0,15,30
90,Fail,46,29,5,20,26
90,Fail,44,39,4,13,31
90,Fail,52,34,2,12,40
90,Fail,56,34,0,9,47
90,Fail,44,32,7,17,27
90,Fail,41,40,2,17,24
90,Fail,56,35,0,8,48
90,Fail,45,42,0,10,35
90,Fail,49,39,2,10,39
90,Fail,44,38,0,15,29
90,Fail,47,36,4,13,34
90,Fail,41,39,0,8,33
90,Fail,47,42,0,11,36
90,Fail,41,42,1,16,25
90,Fail,49,34,0,16,33
90,Fail,48,33,0,10,38
90,Fail,54,31,3,12,42
90,Fail,48,34,0,13,35
90,Fail,57,31,0,11,46
90,Fail,44,41,5,10,34
90,Fail,48,38,0,11,37
90,Fail,47,40,0,10,37
90,Fail,47,34,0,14,33
90,Fail,50,29,4,17,33
90,Fail,55,34,0,9,46
90,Fail,44,34,0,18,26
90,Fail,55,38,2,5,50
90,Fail,49,35,3,13,36
90,Fail,53,31,0,15,38
90,Fail,46,39,0,11,35
90,Fail,49,35,4,12,37
90,Fail,43,42,0,13,30
90,Fail,47,38,0,14,33
90,Fail,40,41,8,11,29
90,Fail,46,31,0,9,37
90,Fail,52,35,2,11,41
90,Fail,47,39,0,12,35
90,Fail,50,36,2,12,38
90,Fail,41,36,0,14,27
90,Fail,46,43,2,9,37
90,Fail,52,29,0,19,33
90,Fail,46,35,0,13,33
90,Fail,57,26,7,10,47
90,Fail,50,39,0,9,41
90,Fail,54,36,0,8,46
90,Fail,49,34,0,13,36
90,Fail,47,34,3,16,31
90,Fail,44,38,10,8,36
90,Fail,51,37,3,9,42
90,Fail,49,35,4,12,37
90,Fail,54,29,2,15,39
90,Fail,51,37,0,7,44
90,Fail,45,42,0,11,34
90,Fail,54,36,0,10,44
90,Fail,54,33,0,11,43
90,Fail,53,34,0,12,41
90,Fail,52,32,0,14,38
90,Fail,50,33,3,14,36
90,Fail,46,37,1,16,30
90,Fail,49,36,0,10,39
90,Fail,45,40,0,11,34
90,Fail,49,33,0,11,38
90,Fail,42,37,0,14,28
90,Fail,50,35,8,7,43
90,Fail,53,34,0,12,41
90,Fail,47,37,5,11,36
90,Fail,51,35,0,14,37
90,Fail,42,39,0,14,28
90,Fail,42,39,4,15,27
90,Fail,53,35,3,9,44
90,Fail,60,32,0,8,52
90,Fail,40,32,7,21,19
90,Fail,46,32,0,16,30
90,Fail,46,40,0,13,33
90,Fail,43,35,0,17,26
90,Fail,43,30,15,12,31
90,Fail,46,43,1,10,36
90,Fail,45,42,0,13,32
90,Fail,47,40,0,13,34
90,Fail,46,39,5,10,36
90,Fail,50,34,3,13,37
90,Fail,42,44,0,12,30
90,Fail,49,34,0,14,35
90,Fail,53,32,4,11,42
90,Fail,51,33,7,9,42
90,Fail,48,38,4,10,38
90,Fail,52,33,0,9,43
90,Fail,50,36,0,11,39
90,Fail,46,40,0,10,36
90,Fail,48,40,0,12,36
90,Fail,40,42,0,13,27
90,Fail,51,37,0,10,41
90,Fail,55,29,2,14,41
90,Fail,48,39,7,6,42
90,Fail,50,39,0,11,39
90,Fail,43,39,4,14,29
90,Fail,53,34,0,9,44
90,Fail,49,36,3,12,37
90,Fail,48,37,0,14,34
90,Fail,49,36,0,14,35
90,Fail,47,32,6,15,32
90,Fail,45,37,5,13,32
90,Fail,49,37,5,9,40
90,Fail,51,40,2,7,44
90,Fail,51,33,3,13,38
90,Fail,53,33,0,14,39
90,Fail,54,35,2,9,45
90,Fail,47,37,0,14,33
90,Fail,51,33,0,11,40
90,Fail,43,43,0,12,31
90,Fail,47,37,3,13,34
90,Fail,49,38,0,13,36
90,Fail,55,32,0,8,47
90,Fail,55,29,0,10,45
90,Fail,48,33,4,15,33
90,Fail,49,30,0,14,35
90,Fail,50,33,3,14,36
90,Fail,52,35,0,9,43
90,Fail,44,42,0,8,36
90,Fail,50,31,4,15,35
90,Fail,52,27,0,14,38
90,Fail,47,32,0,16,31
90,Fail,55,32,1,12,43
90,Fail,44,35,5,16,28
90,Fail,47,37,0,15,32
90,Fail,49,44,1,6,43
90,Fail,47,36,4,13,34
90,Fail,44,41,0,12,32
90,Fail,48,35,0,10,38
90,Fail,56,34,2,8,48
90,Fail,50,39,2,9,41
90,Fail,47,33,0,12,35
90,Fail,45,38,0,13,32
90,Fail,49,30,0,21,28
90,Fail,53,35,3,9,44
90,Fail,43,45,1,11,32
90,Fail,46,34,5,15,31
90,Fail,52,29,1,18,34
90,Fail,48,34,1,17,31
90,Fail,56,33,0,10,46
90,Fail,50,32,9,9,41
90,Fail,45,36,2,17,28
90,Fail,46,45,0,9,37
90,Fail,52,31,2,15,37
90,Fail,47,33,7,13,34
90,Fail,52,27,0,14,38
90,Fail,48,36,4,12,36
90,Fail,50,33,0,14,36
90,Fail,49,33,0,11,38
90,Fail,41,41,5,13,28
90,Fail,53,38,0,8,45
90,Fail,50,38,0,11,39
90,Fail,40,34,0,12,28
90,Fail,45,34,6,15,30
90,Fail,43,45,0,10,33
90,Fail,53,31,0,14,39
90,Fail,41,40,4,15,26
90,Fail,48,30,0,12,36
90,Fail,53,30,0,13,40
90,Fail,44,42,4,10,34
90,Fail,47,38,0,10,37
90,Fail,48,38,0,12,36
90,Fail,51,33,0,11,40
90,Fail,39,33,9,19,20
90,Fail,40,43,5,12,28
90,Fail,47,35,6,12,35
90,Fail,49,33,0,9,40
90,Fail,41,40,0,15,26
90,Fail,50,34,0,13,37
90,Fail,53,34,2,11,42
90,Fail,50,37,0,11,39
90,Fail,46,40,0,11,35
90,Fail,41,33,10,16,25
90,Fail,46,29,15,10,36
90,Fail,47,33,0,15,32
90,Fail,55,36,3,6,49
90,Fail,52,34,2,12,40
90,Fail,50,38,0,10,40
90,Fail,49,30,0,18,31
90,Fail,47,34,2,17,30
90,Fail,48,36,4,12,36
90,Fail,38,37,0,19,19
90,Fail,52,29,0,17,35
90,Fail,45,42,0,11,34
90,Fail,49,39,0,9,40
90,Fail,50,35,0,11,39
90,Fail,57,31,0,9,48
90,Fail,49,32,5,14,35
90,Fail,48,38,0,11,37
90,Fail,46,33,0,16,30
90,Fail,51,32,0,11,40
90,Fail,41,32,3,24,17
90,Fail,56,33,4,7,49
90,Fail,44,34,0,15,29
90,Fail,46,38,6,10,36
90,Fail,52,33,5,10,42
90,Fail,53,31,1,15,38
90,Fail,50,40,0,7,43
90,Fail,53,33,1,13,40
90,Fail,53,31,0,14,39
90,Fail,46,34,3,17,29
90,Fail,47,36,4,13,34
90,Fail,50,32,2,16,34
90,Fail,47,31,0,13,34
90,Fail,50,42,0,6,44
90,Fail,39,37,7,17,22
90,Fail,47,38,3,12,35
90,Fail,47,36,0,16,31
90,Fail,43,37,0,10,33
90,Fail,47,41,0,11,36
90,Fail,44,37,0,11,33
90,Fail,48,36,2,14,34
90,Fail,44,39,4,13,31
90,Fail,42,42,0,16,26
90,Fail,44,38,0,17,27
90,Fail,43,32,6,19,24
90,Fail,48,42,1,9,39
90,Fail,43,44,1,12,31
90,Fail,45,35,9,11,34
90,Fail,47,36,0,14,33
90,Fail,49,36,3,12,37
90,Fail,45,34,8,13,32
90,Fail,46,37,4,13,33
90,Fail,48,33,7,12,36
90,Fail,53,33,0,14,39
90,Fail,49,34,3,14,35
90,Fail,41,39,1,19,22
90,Fail,51,32,0,12,39
90,Fail,43,40,3,14,29
90,Fail,44,30,0,17,27
90,Fail,54,25,3,18,36
90,Fail,44,31,0,18,26
90,Fail,48,39,0,12,36
90,Fail,51,37,0,10,41
90,Fail,45,37,4,14,31
90,Fail,46,44,4,6,40
90,Fail,58,32,0,10,48
90,Fail,43,45,4,8,35
90,Fail,53,32,0,11,42
90,Fail,47,34,2,17,30
90,Fail,47,42,2,9,38
90,Fail,50,31,6,13,37
90,Fail,56,29,2,13,43
90,Fail,45,30,0,17,28
90,Fail,54,34,0,10,44
90,Fail,57,31,0,10,47
90,Fail,46,35,2,17,29
90,Fail,51,29,10,10,41
90,Fail,46,36,1,17,29
90,Fail,59,31,1,9,50
90,Fail,50,37,0,8,42
90,Fail,48,37,4,11,37
90,Fail,54,35,3,8,46
90,Fail,44,37,5,14,30
90,Fail,50,36,0,13,37
90,Fail,52,31,7,10,42
90,Fail,43,42,0,9,34
90,Fail,51,33,0,10,41
90,Fail,43,42,3,12,31
90,Fail,55,28,0,13,42
90,Fail,55,32,0,10,45
90,Fail,46,37,0,14,32
90,Fail,54,32,0,13,41
90,Fail,52,39,0,7,45
90,Fail,43,43,7,7,36
90,Fail,52,36,1,11,41
90,Fail,42,36,0,16,26
90,Fail,52,32,2,14,38
90,Fail,45,42,0,11,34
90,Fail,45,36,0,19,26
90,Fail,38,40,0,20,18
90,Fail,49,34,5,12,37
90,Fail,46,37,0,14,32
90,Fail,48,39,1,12,36
90,Fail,49,38,5,8,41
90,Fail,53,34,0,11,42
90,Fail,44,30,0,15,29
90,Fail,54,32,5,9,45
90,Fail,58,34,0,7,51
90,Fail,49,32,3,16,33
90,Fail,47,42,0,9,38
90,Fail,52,39,2,7,45
90,Fail,48,36,1,15,33
90,Fail,50,36,0,14,36
90,Fail,53,33,2,12,41
90,Fail,51,38,0,11,40
90,Fail,47,40,2,11,36
90,Fail,46,32,11,11,35
90,Fail,54,32,0,9,45
90,Fail,48,36,0,10,38
90,Fail,51,35,0,13,38
90,Fail,41,34,14,11,30
90,Fail,47,37,1,15,32
90,Fail,42,39,2,17,25
90,Fail,51,33,0,13,38
90,Fail,50,38,0,12,38
90,Fail,52,35,0,12,40
90,Fail,46,32,7,15,31
90,Fail,56,34,0,10,46
90,Fail,59,31,0,6,53
90,Fail,51,28,5,16,35
90,Fail,54,29,5,12,42
90,Fail,45,33,9,13,32
90,Fail,50,35,1,14,36
90,Fail,45,38,0,14,31
90,Fail,50,32,0,11,39
90,Fail,53,35,0,10,43
90,Fail,43,44,3,10,33
90,Fail,38,44,0,15,23
90,Fail,48,36,3,13,35
90,Fail,49,43,2,6,43
90,Fail,46,40,1,13,33
90,Fail,55,36,0,6,49
90,Fail,48,25,10,17,31
90,Fail,41,38,8,13,28
90,Fail,55,35,0,9,46
90,Fail,54,33,0,12,42
90,Fail,54,34,2,10,44
90,Fail,42,39,1,18,24
90,Fail,41,37,0,18,23
90,Fail,48,39,0,12,36
90,Fail,42,44,0,12,30
90,Fail,44,39,4,13,31
90,Fail,45,36,0,9,36
90,Fail,47,34,4,15,32
90,Fail,43,44,0,11,32
90,Fail,59,33,0,8,51
90,Fail,47,35,0,11,36
90,Fail,47,33,0,13,34
90,Fail,54,29,0,16,38
90,Fail,52,34,1,13,39
90,Fail,48,39,4,9,39
90,Fail,54,30,2,14,40
90,Fail,48,32,0,18,30
90,Fail,51,31,0,17,34
90,Fail,45,36,4,15,30
90,Fail,50,42,1,7,43
90,Fail,52,31,7,10,42
90,Fail,45,43,1,11,34
90,Fail,52,36,4,8,44
90,Fail,46,38,6,10,36
90,Fail,40,41,5,14,26
90,Fail,46,35,0,15,31
90,Fail,52,34,3,11,41
90,Fail,54,30,0,9,45
90,Fail,46,40,1,13,33
90,Fail,44,38,0,17,27
90,Fail,40,39,2,19,21
90,Fail,47,33,11,9,38
90,Fail,47,25,4,24,23
90,Fail,49,34,0,12,37
90,Fail,50,41,0,6,44
90,Fail,44,42,0,12,32
90,Fail,44,31,10,15,29
90,Fail,50,37,2,11,39
90,Fail,53,37,0,9,44
90,Fail,49,38,1,12,37
90,Fail,44,37,10,9,35
90,Fail,42,41,0,17,25
90,Fail,56,38,0,6,50
90,Fail,54,35,0,10,44
90,Fail,43,40,0,15,28
90,Fail,43,42,3,12,31
90,Fail,50,37,1,12,38
90,Fail,52,33,0,13,39
90,Fail,51,38,0,11,40
90,Fail,50,38,0,8,42
90,Fail,48,35,4,13,35
90,Fail,49,33,0,12,37
90,Fail,47,32,0,21,26
90,Fail,54,39,0,7,47
90,Fail,53,34,0,9,44
90,Fail,44,41,7,8,36
90,Fail,51,39,0,10,41
90,Fail,47,35,8,10,37
90,Fail,40,41,0,17,23
90,Fail,48,39,0,6,42
90,Fail,47,39,3,11,36
90,Fail,39,40,6,15,24
90,Fail,51,36,0,8,43
90,Fail,45,39,0,10,35
90,Fail,48,38,2,12,36
90,Fail,56,34,2,8,48
90,Fail,49,40,1,10,39
90,Fail,50,36,0,11,39
90,Fail,53,34,2,11,42
90,Fail,50,40,0,8,42
90,Fail,40,43,2,15,25
90,Fail,57,39,0,4,53
90,Fail,52,33,4,11,41
90,Fail,46,39,2,13,33
90,Fail,51,42,0,7,44
90,Fail,52,33,0,10,42
90,Fail,47,35,0,17,30
90,Fail,55,37,2,6,49
90,Fail,59,29,0,10,49
90,Fail,57,28,4,11,46
90,Fail,47,37,0,15,32
90,Fail,46,44,0,10,36
90,Fail,42,35,7,16,26
90,Fail,49,39,0,12,37
90,Fail,45,37,0,14,31
90,Fail,46,41,0,12,34
90,Fail,56,27,2,15,41
90,Fail,44,44,0,11,33
90,Fail,46,34,0,17,29
90,Fail,49,36,0,15,34
90,Fail,47,42,0,9,38
90,Fail,48,28,6,18,30
90,Fail,41,40,0,18,23
90,Fail,45,41,2,12,33
90,Fail,52,34,0,14,38
90,Fail,51,28,11,10,41
90,Fail,47,34,4,15,32
90,Fail,42,38,0,16,26
90,Fail,51,31,2,16,35
90,Fail,48,32,5,15,33
90,Fail,50,35,1,14,36
90,Fail,47,37,4,12,35
90,Fail,45,38,4,13,32
90,Fail,55,36,2,7,48
90,Fail,50,33,0,13,37
90,Fail,57,34,0,9,48
90,Fail,49,35,5,11,38
90,Fail,50,40,2,8,42
90,Fail,54,29,0,14,40
90,Fail,49,30,4,17,32
90,Fail,50,32,2,16,34
90,Fail,49,41,0,8,41
90,Fail,56,30,0,8,48
90,Fail,41,36,8,15,26
90,Fail,45,43,3,9,36
90,Fail,53,35,0,8,45
90,Fail,38,33,0,24,14
90,Fail,46,37,6,11,35
90,Fail,46,40,0,14,32
90,Fail,44,29,7,20,24
90,Fail,49,33,0,14,35
90,Fail,46,39,0,14,32
90,Fail,54,35,0,9,45
90,Fail,48,27,10,15,33
90,Fail,45,42,3,10,35
90,Fail,52,31,0,16,36
90,Fail,49,36,0,13,36
90,Fail,48,34,0,12,36
90,Fail,38,37,0,14,24
90,Fail,43,38,0,18,25
90,Fail,49,37,0,10,39
90,Fail,42,35,0,15,27
90,Fail,51,36,0,10,41
90,Fail,53,37,0,8,45
90,Fail,47,40,0,11,36
90,Fail,53,33,0,14,39
90,Fail,46,38,8,8,38
90,Fail,49,37,5,9,40
90,Fail,48,40,0,10,38
90,Fail,47,32,0,17,30
90,Fail,45,26,14,15,30
90,Fail,42,43,0,15,27
90,Fail,44,27,0,17,27
90,Fail,49,35,0,16,33
90,Fail,40,36,6,18,22
90,Fail,45,37,0,15,30
90,Fail,60,33,0,7,53
90,Fail,48,38,0,7,41
90,Fail,38,35,10,17,21
90,Fail,44,30,8,18,26
90,Fail,46,34,5,15,31
90,Fail,46,31,0,22,24
90,Fail,47,34,3,16,31
90,Fail,47,33,7,13,34
90,Fail,46,35,8,11,35
90,Fail,49,41,0,10,39
90,Fail,49,30,7,14,35
90,Fail,46,37,2,15,31
90,Fail,51,30,9,10,41
90,Fail,53,28,4,15,38
90,Fail,44,39,0,12,32
90,Fail,44,33,9,14,30
90,Fail,53,36,0,6,47
90,Fail,54,28,6,12,42
90,Fail,52,28,7,13,39
90,Fail,48,35,0,13,35
90,Fail,56,26,5,13,43
90,Fail,42,37,0,13,29
90,Fail,47,34,0,16,31
90,Fail,48,37,0,11,37
90,Fail,54,31,2,13,41
90,Fail,46,37,0,7,39
90,Fail,45,33,0,13,32
90,Fail,47,38,2,13,34
90,Fail,51,42,0,7,44
90,Fail,48,32,0,19,29
90,Fail,52,34,5,9,43
90,Fail,52,33,0,10,42
90,Fail,48,37,2,13,35
90,Fail,39,41,0,18,21
90,Fail,50,39,0,11,39
90,Fail,52,32,0,13,39
90,Fail,43,33,0,13,30
90,Fail,47,30,12,11,36
90,Fail,51,28,3,18,33
90,Fail,43,36,0,17,26
90,Fail,52,38,0,10,42
90,Fail,48,35,0,13,35
90,Fail,49,31,0,15,34
90,Fail,47,30,0,16,31
90,Fail,48,41,1,10,38
90,Fail,58,31,1,10,48
90,Fail,56,35,1,8,48
90,Fail,44,40,0,12,32
90,Fail,48,37,0,14,34
90,Fail,46,35,6,13,33
90,Fail,45,38,0,12,33
90,Fail,49,41,2,8,41
90,Fail,47,34,0,14,33
90,Fail,51,30,4,15,36
90,Fail,49,35,7,9,40
90,Fail,57,32,4,7,50
90,Fail,48,32,5,15,33
90,Fail,52,31,4,13,39
90,Fail,45,34,0,14,31
90,Fail,48,38,0,9,39
90,Fail,50,34,0,12,38
90,Fail,46,38,2,14,32
90,Fail,44,38,4,14,30
90,Fail,51,34,3,12,39
90,Fail,43,38,7,12,31
90,Fail,42,44,0,12,30
90,Fail,54,33,0,12,42
90,Fail,44,40,1,15,29
90,Fail,55,31,0,13,42
90,Fail,45,27,12,16,29
90,Fail,54,33,0,10,44
90,Fail,57,31,2,10,47
90,Fail,47,34,0,16,31
90,Fail,56,32,0,8,48
90,Fail,50,39,2,9,41
90,Fail,53,37,0,10,43
90,Fail,49,41,0,8,41
90,Fail,53,32,0,10,43
90,Fail,50,37,0,11,39
90,Fail,45,43,0,10,35
90,Fail,41,37,0,18,23
90,Fail,49,36,0,12,37
90,Fail,55,35,0,10,45
90,Fail,53,33,2,12,41
90,Fail,43,39,5,13,30
90,Fail,48,35,0,11,37
90,Fail,35,48,0,9,26
90,Fail,46,38,0,12,34
90,Fail,43,42,6,9,34
90,Fail,46,26,11,17,29
90,Fail,45,37,3,15,30
90,Fail,50,37,3,10,40
90,Fail,54,30,0,16,38
90,Fail,44,41,0,12,32
90,Fail,48,39,0,13,35
90,Fail,47,41,0,12,35
90,Fail,50,33,0,17,33
90,Fail,57,32,3,8,49
90,Fail,53,37,4,6,47
90,Fail,48,38,1,13,35
90,Fail,46,32,0,14,32
90,Fail,57,30,0,9,48
90,Fail,51,35,0,4,47
90,Fail,50,32,0,15,35
90,Fail,46,37,0,13,33
90,Fail,56,35,2,7,49
90,Fail,45,38,0,12,33
90,Fail,49,39,1,11,38
90,Fail,45,30,8,17,28
90,Fail,41,36,8,15,26
90,Fail,46,39,0,11,35
90,Fail,59,26,0,11,48
90,Fail,48,37,3,12,36
90,Fail,49,42,0,8,41
90,Fail,50,33,0,11,39
90,Fail,47,36,0,11,36
90,Fail,51,34,0,10,41
90,Fail,47,37,5,11,36
90,Fail,49,37,0,10,39
90,Fail,49,38,0,12,37
90,Fail,47,32,0,19,28
90,Fail,50,33,3,14,36
90,Fail,49,33,1,17,32
90,Fail,45,35,1,19,26
90,Fail,53,33,3,11,42
90,Fail,49,40,2,9,40
90,Fail,51,34,0,15,36
90,Fail,52,37,3,8,44
90,Fail,48,38,0,6,42
90,Fail,46,38,6,10,36
90,Fail,46,40,1,13,33
90,Fail,46,41,0,7,39
90,Fail,46,40,0,10,36
90,Fail,41,36,6,17,24
90,Fail,46,33,0,17,29
90,Fail,53,37,1,9,44
90,Fail,53,31,0,14,39
90,Fail,58,24,7,11,47
90,Fail,41,41,0,13,28
90,Fail,50,42,0,7,43
90,Fail,52,32,4,12,40
90,Fail,52,35,0,9,43
90,Fail,43,36,4,17,26
90,Fail,47,41,0,12,35
90,Fail,45,33,0,11,34
90,Fail,43,33,0,12,31
90,Fail,52,35,4,9,43
90,Fail,44,35,5,16,28
90,Fail,41,38,0,18,23
90,Fail,52,37,0,9,43
90,Fail,53,36,0,11,42
90,Fail,46,35,0,16,30
90,Fail,45,43,3,9,36
90,Fail,43,35,0,13,30
90,Fail,48,34,0,16,32
90,Fail,52,36,0,12,40
90,Fail,48,38,0,10,38
90,Fail,46,43,2,9,37
90,Fail,44,41,5,10,34
90,Fail,43,38,5,14,29
90,Fail,43,37,6,14,29
90,Fail,48,32,7,13,35
90,Fail,45,38,0,13,32
90,Fail,46,33,6,15,31
90,Fail,48,40,1,11,37
90,Fail,50,39,1,10,40
90,Fail,54,36,5,5,49
90,Fail,49,34,0,12,37
90,Fail,50,31,7,12,38
90,Fail,46,43,0,11,35
90,Fail,50,34,0,12,38
90,Fail,40,42,7,11,29
90,Fail,55,30,6,9,46
90,Fail,48,35,1,16,32
90,Fail,43,38,0,13,30
90,Fail,42,38,9,11,31
90,Fail,45,43,0,5,40
90,Fail,49,38,5,8,41
90,Fail,47,26,0,19,28
90,Fail,49,24,0,19,30
90,Fail,44,36,4,16,28
90,Fail,51,32,0,12,39
90,Fail,50,35,7,8,42
90,Fail,45,38,6,11,34
90,Fail,48,31,0,16,32
90,Fail,45,31,0,17,28
90,Fail,50,30,0,17,33
90,Fail,49,39,0,10,39
90,Fail,44,41,2,13,31
90,Fail,46,33,2,19,27
90,Fail,54,29,3,14,40
90,Fail,52,36,0,11,41
90,Fail,45,35,4,16,29
90,Fail,50,37,0,10,40
90,Fail,48,37,0,15,33
90,Fail,53,40,1,6,47
90,Fail,53,34,0,10,43
90,Fail,43,41,5,11,32
90,Fail,42,36,5,17,25
90,Fail,41,40,9,10,31
90,Fail,46,36,8,10,36
90,Fail,46,32,0,15,31
90,Fail,47,41,0,12,35
90,Fail,42,39,2,17,25
90,Fail,52,33,5,10,42
90,Fail,46,30,9,15,31
90,Fail,42,36,0,15,27
90,Fail,51,32,4,13,38
90,Fail,48,41,1,10,38
90,Fail,51,39,3,7,44
90,Fail,52,37,0,8,44
90,Fail,42,30,15,13,29
90,Fail,45,27,0,15,30
90,Fail,46,38,0,13,33
90,Fail,48,35,9,8,40
90,Fail,47,30,10,13,34
90,Fail,50,38,3,9,41
90,Fail,43,38,8,11,32
90,Fail,45,40,0,12,33
90,Fail,41,41,10,8,33
90,Fail,49,35,4,12,37
90,Fail,47,39,0,12,35
90,Fail,42,38,0,20,22
90,Fail,45,40,3,12,33
90,Fail,41,38,8,13,28
90,Fail,47,38,3,12,35
90,Fail,45,35,0,15,30
90,Fail,55,35,0,10,45
90,Fail,52,37,0,10,42
90,Fail,46,36,0,14,32
90,Fail,52,35,1,12,40
90,Fail,51,23,3,23,28
90,Fail,54,29,7,10,44
90,Fail,53,36,1,10,43
90,Fail,47,35,0,15,32
90,Fail,36,40,0,12,24
90,Fail,49,35,0,12,37
90,Fail,56,35,1,8,48
90,Fail,53,33,0,10,43
90,Fail,45,44,0,7,38
90,Fail,52,38,2,8,44
90,Fail,49,35,0,10,39
90,Fail,42,41,3,14,28
90,Fail,46,41,0,12,34
90,Fail,46,40,0,13,33
90,Fail,38,37,11,14,24
90,Fail,51,28,0,16,35
90,Fail,48,42,3,7,41
90,Fail,49,34,7,10,39
90,Fail,46,40,0,14,32
90,Fail,49,35,0,13,36
90,Fail,48,33,6,13,35
90,Fail,45,36,6,13,32
90,Fail,50,30,0,10,40
90,Fail,43,30,10,17,26
90,Fail,45,34,4,17,28
90,Fail,49,34,1,16,33
90,Fail,43,37,5,15,28
90,Fail,47,35,2,16,31
90,Fail,49,34,0,10,39
90,Fail,51,35,0,8,43
90,Fail,39,44,0,9,30
90,Fail,50,36,0,13,37
90,Fail,55,33,0,7,48
90,Fail,53,33,0,10,43
90,Fail,50,31,0,13,37
90,Fail,51,34,0,14,37
90,Fail,48,34,0,11,37
90,Fail,50,36,0,8,42
90,Fail,45,43,1,11,34
90,Fail,46,35,5,14,32
90,Fail,43,33,0,15,28
90,Fail,48,32,7,13,35
90,Fail,45,37,0,18,27
90,Fail,43,38,4,15,28
90,Fail,49,40,0,5,44
90,Fail,50,38,0,7,43
90,Fail,42,42,0,7,35
90,Fail,53,34,1,12,41
90,Fail,48,35,2,15,33
90,Fail,52,34,7,7,45
90,Fail,52,34,1,13,39
90,Fail,44,38,3,15,29
90,Fail,55,33,0,10,45
90,Fail,51,34,0,12,39
90,Fail,48,31,4,17,31
90,Fail,44,30,7,19,25
90,Fail,53,32,4,11,42
90,Fail,57,31,0,10,47
90,Fail,55,38,0,6,49
90,Fail,49,38,0,13,36
90,Fail,35,37,0,20,15
90,Fail,55,36,0,9,46
90,Fail,49,43,0,8,41
90,Fail,54,33,0,8,46
90,Fail,44,40,0,16,28
90,Fail,48,36,3,13,35
90,Fail,44,37,5,14,30
90,Fail,45,37,3,15,30
90,Fail,54,33,2,11,43
90,Fail,49,39,0,10,39
90,Fail,49,27,0,20,29
90,Fail,47,40,0,12,35
90,Fail,42,44,2,12,30
90,Fail,45,37,0,12,33
90,Fail,45,40,3,12,33
90,Fail,55,35,1,9,46
90,Fail,54,31,2,13,41
90,Fail,48,36,0,16,32
90,Fail,53,37,0,9,44
90,Fail,53,31,0,14,39
90,Fail,61,32,0,7,54
90,Fail,51,32,3,14,37
90,Fail,47,35,0,14,33
90,Fail,53,37,4,6,47
90,Fail,46,35,0,12,34
90,Fail,48,32,0,16,32
90,Fail,49,34,2,15,34
90,Fail,50,40,5,5,45
90,Fail,51,35,0,14,37
90,Fail,49,34,4,13,36
90,Fail,46,33,6,15,31
90,Fail,45,41,4,10,35
90,Fail,45,32,0,15,30
90,Fail,50,39,3,8,42
90,Fail,47,37,5,11,36
90,Fail,44,49,0,7,37
90,Fail,41,38,0,18,23
90,Fail,48,30,12,10,38
90,Fail,54,30,0,16,38
90,Fail,51,34,0,12,39
90,Fail,46,36,3,15,31
90,Fail,44,39,0,15,29
90,Fail,54,34,0,11,43
90,Fail,44,41,0,11,33
90,Fail,39,37,0,18,21
90,Fail,39,37,0,18,21
90,Fail,41,32,0,14,27
90,Fail,44,34,5,17,27
90,Fail,50,30,3,17,33
90,Fail,52,32,5,11,41
90,Fail,47,33,0,16,31
90,Fail,54,37,0,9,45
90,Fail,50,35,3,12,38
90,Fail,49,32,7,12,37
90,Fail,49,31,11,9,40
90,Fail,55,26,5,14,41
90,Fail,48,27,0,14,34
90,Fail,48,37,0,11,37
90,Fail,41,38,1,20,21
90,Fail,46,31,0,14,32
90,Fail,53,36,0,9,44
90,Fail,55,28,3,14,41
90,Fail,46,36,2,16,30
90,Fail,38,35,13,14,24
90,Fail,43,36,3,18,25
90,Fail,52,35,0,7,45
90,Fail,46,35,0,14,32
90,Fail,55,36,0,9,46
90,Fail,58,33,0,8,50
90,Fail,47,46,1,6,41
90,Fail,42,39,7,12,30
90,Fail,42,38,4,16,26
90,Fail,53,36,0,8,45
90,Fail,52,34,0,14,38
90,Fail,52,36,3,9,43
90,Fail,51,34,1,14,37
90,Fail,50,30,0,16,34
90,Fail,53,30,3,14,39
90,Fail,52,32,6,10,42
90,Fail,55,31,4,10,45
90,Fail,51,38,0,10,41
90,Fail,47,40,0,12,35
90,Fail,47,31,9,13,34
90,Fail,46,36,2,16,30
90,Fail,44,40,1,15,29
90,Fail,45,31,6,18,27
90,Fail,55,32,3,10,45
90,Fail,52,28,5,15,37
90,Fail,47,35,2,16,31
90,Fail,41,43,2,14,27
90,Fail,41,37,0,18,23
90,Fail,50,27,10,13,37
90,Fail,45,44,0,8,37
90,Fail,48,33,3,16,32
90,Fail,45,35,0,17,28
90,Fail,51,35,1,13,38
90,Fail,53,35,1,11,42
90,Fail,46,33,4,17,29
90,Fail,46,37,2,15,31
90,Fail,53,38,0,9,44
90,Fail,38,39,4,19,19
90,Fail,47,37,1,15,32
90,Fail,51,40,0,7,44
90,Fail,48,38,2,12,36
90,Fail,49,36,2,13,36
90,Fail,48,41,0,11,37
90,Fail,52,36,0,11,41
90,Fail,50,35,0,12,38
90,Fail,51,31,7,11,40
90,Fail,51,36,0,10,41
90,Fail,47,33,3,17,30
90,Fail,45,36,0,18,27
90,Fail,54,30,4,12,42
90,Fail,55,36,0,4,51
90,Fail,42,47,0,11,31
90,Fail,45,43,0,12,33
90,Fail,49,30,7,14,35
90,Fail,50,32,5,13,37
90,Fail,51,30,0,6,45
90,Fail,43,38,7,12,31
90,Fail,52,37,0,10,42
90,Fail,52,31,0,11,41
90,Fail,54,27,0,15,39
90,Fail,47,37,4,12,35
90,Fail,49,37,0,10,39
90,Fail,45,32,0,16,29
90,Fail,41,38,0,16,25
90,Fail,44,39,5,12,32
90,Fail,59,27,0,13,46
90,Fail,48,35,0,11,37
90,Fail,42,38,7,13,29
90,Fail,46,38,3,13,33
90,Fail,54,35,0,11,43
90,Fail,46,38,2,14,32
90,Fail,43,43,0,9,34
90,Fail,52,30,3,15,37
90,Fail,52,34,5,9,43
90,Fail,44,33,4,19,25
90,Fail,41,35,0,16,25
90,Fail,49,28,0,15,34
90,Fail,46,41,3,10,36
90,Fail,50,34,0,14,36
90,Fail,45,44,0,10,35
90,Fail,54,32,0,11,43
90,Fail,47,37,0,16,31
90,Fail,53,32,0,10,43
90,Fail,39,46,4,11,28
90,Fail,43,41,2,14,29
90,Fail,51,36,0,11,40
90,Fail,46,37,0,13,33
90,Fail,46,35,7,12,34
90,Fail,57,28,0,13,44
90,Fail,44,37,0,13,31
90,Fail,53,31,1,15,38
90,Fail,51,35,3,11,40
90,Fail,37,41,0,20,17
90,Fail,45,35,0,14,31
90,Fail,48,35,4,13,35
90,Fail,49,37,1,13,36
90,Fail,53,33,3,11,42
90,Fail,53,33,1,13,40
90,Fail,47,30,8,15,32
90,Fail,45,40,4,11,34
90,Fail,45,37,0,15,30
90,Fail,46,31,7,16,30
90,Fail,54,33,0,13,41
90,Fail,52,35,0,11,41
90,Fail,44,37,0,12,32
90,Fail,42,37,0,17,25
90,Fail,34,41,0,15,19
90,Fail,49,35,0,16,33
90,Fail,52,33,4,11,41
90,Fail,40,39,0,16,24
90,Fail,43,35,8,14,29
90,Fail,47,40,0,9,38
90,Fail,58,25,0,16,42
90,Fail,51,31,8,10,41
90,Fail,51,32,1,16,35
90,Fail,45,37,6,12,33
90,Fail,51,37,4,8,43
90,Fail,48,42,3,7,41
90,Fail,53,36,1,10,43
90,Fail,50,33,0,9,41
90,Fail,50,36,2,12,38
90,Fail,51,30,4,15,36
90,Fail,45,36,4,15,30
90,Fail,46,35,8,11,35
90,Fail,53,31,3,13,40
90,Fail,46,35,12,7,39
90,Fail,50,24,12,14,36
90,Fail,45,35,7,13,32
90,Fail,53,37,1,9,44
90,Fail,36,41,9,14,22
90,Fail,49,29,5,17,32
90,Fail,45,41,4,10,35
90,Fail,47,41,0,4,43
90,Fail,58,35,2,5,53
90,Fail,46,35,0,12,34
90,Fail,53,40,1,6,47
90,Fail,51,35,0,10,41
90,Fail,52,39,1,8,44
90,Fail,54,37,0,8,46
90,Fail,53,37,0,10,43
90,Fail,44,39,0,11,33
90,Fail,48,29,0,16,32
90,Fail,44,41,1,14,30
90,Fail,43,46,0,9,34
90,Fail,45,33,0,20,25
90,Fail,47,37,4,12,35
90,Fail,51,33,0,14,37
90,Fail,51,33,0,16,35
90,Fail,49,35,1,15,34
90,Fail,53,32,5,10,43
90,Fail,45,33,0,16,29
90,Fail,44,34,0,17,27
90,Fail,48,30,4,18,30
90,Fail,41,32,0,15,26
90,Fail,41,40,0,17,24
90,Fail,47,30,9,14,33
90,Fail,49,33,0,16,33
90,Fail,48,36,1,15,33
90,Fail,53,35,0,12,41
90,Fail,52,32,0,14,38
90,Fail,48,38,0,8,40
90,Fail,50,29,0,15,35
90,Fail,55,32,0,13,42
90,Fail,53,32,4,11,42
90,Fail,45,36,0,15,30
90,Fail,43,42,5,10,33
90,Fail,43,36,0,16,27
90,Fail,55,31,1,13,42
90,Fail,56,32,0,12,44
90,Fail,47,34,4,15,32
90,Fail,48,33,0,13,35
90,Fail,47,34,0,11,36
90,Fail,54,29,4,13,41
90,Fail,45,37,9,9,36
90,Fail,48,40,0,7,41
90,Fail,45,33,7,15,30
90,Fail,53,31,2,14,39
90,Fail,50,39,0,6,44
90,Fail,46,38,4,12,34
90,Fail,49,40,0,9,40
90,Fail,52,35,2,11,41
90,Fail,53,38,0,8,45
90,Fail,51,36,0,10,41
90,Fail,43,39,7,11,32
90,Fail,44,38,0,16,28
90,Fail,47,37,2,14,33
90,Fail,50,35,0,14,36
90,Fail,42,38,0,17,25
90,Fail,50,35,0,12,38
90,Fail,48,34,0,10,38
90,Fail,50,39,0,9,41
90,Fail,52,29,0,17,35
90,Fail,46,34,0,18,28
90,Fail,52,37,0,7,45
90,Fail,51,35,2,12,39
90,Fail,44,39,0,13,31
90,Fail,46,31,10,13,33
90,Fail,42,44,2,12,30
90,Fail,50,37,0,13,37
90,Fail,50,31,0,17,33
90,Fail,45,35,0,15,30
90,Fail,45,40,4,11,34
90,Fail,48,36,1,15,33
90,Fail,48,38,0,12,36
90,Fail,48,32,4,16,32
90,Fail,48,42,0,5,43
90,Fail,57,33,1,9,48
90,Fail,47,41,0,8,39
90,Fail,45,41,5,9,36
90,Fail,46,38,4,12,34
90,Fail,54,31,0,9,45
90,Fail,46,38,3,13,33
90,Fail,46,39,0,14,32
90,Fail,54,32,3,11,43
90,Fail,57,30,0,10,47
90,Fail,46,34,4,16,30
90,Fail,49,38,0,12,37
90,Fail,46,44,0,8,38
90,Fail,48,35,0,11,37
90,Fail,54,29,2,15,39
90,Fail,37,43,5,15,22
90,Fail,48,39,0,8,40
90,Fail,46,29,0,11,35
90,Fail,51,34,0,12,39
90,Fail,49,43,1,7,42
90,Fail,51,38,3,8,43
90,Fail,54,31,3,12,42
90,Fail,56,30,6,8,48
90,Fail,40,29,0,17,23
90,Fail,48,37,7,8,40
90,Fail,42,43,0,15,27
90,Fail,49,38,3,10,39
90,Fail,59,33,0,8,51
90,Fail,46,37,0,14,32
90,Fail,50,31,0,17,33
90,Fail,50,34,0,14,36
90,Fail,49,34,0,14,35
90,Fail,45,32,0,17,28
90,Fail,50,38,0,12,38
90,Fail,38,35,5,22,16
90,Fail,45,35,0,19,26
90,Fail,49,34,0,14,35
90,Fail,49,32,0,11,38
90,Fail,53,34,0,11,42
90,Fail,55,37,1,7,48
90,Fail,53,37,2,8,45
90,Fail,53,26,1,20,33
90,Fail,48,39,0,10,38
90,Fail,56,24,5,15,41
90,Fail,47,37,0,13,34
90,Fail,46,37,0,14,32
90,Fail,46,36,2,16,30
90,Fail,51,26,0,15,36
90,Fail,43,47,0,8,35
90,Fail,44,35,0,13,31
90,Fail,45,35,6,14,31
90,Fail,46,35,6,13,33
90,Fail,49,34,1,16,33
90,Fail,49,31,5,15,34
90,Fail,48,30,0,16,32
90,Fail,58,32,0,9,49
90,Fail,52,30,0,17,35
90,Fail,45,30,0,15,30
90,Fail,47,41,0,11,36
90,Fail,52,34,0,11,41
90,Fail,47,31,1,21,26
90,Fail,45,33,0,13,32
90,Fail,38,39,0,18,20
90,Fail,52,31,2,15,37
90,Fail,44,40,0,8,36
90,Fail,45,35,0,17,28
90,Fail,47,41,0,12,35
90,Fail,45,35,2,18,27
90,Fail,51,37,0,7,44
90,Fail,48,40,0,12,36
90,Fail,47,38,0,15,32
90,Fail,43,47,3,7,36
90,Fail,44,40,0,9,35
90,Fail,47,41,2,10,37
90,Fail,49,36,6,9,40
90,Fail,54,37,1,8,46
90,Fail,44,43,0,13,31
90,Fail,40,39,0,12,28
90,Fail,43,43,3,11,32
90,Fail,50,31,0,12,38
90,Fail,51,31,4,14,37
90,Fail,52,35,0,13,39
90,Fail,54,29,4,13,41
90,Fail,48,33,0,10,38
90,Fail,50,40,0,10,40
90,Fail,57,32,0,10,47
90,Fail,50,36,5,9,41
90,Fail,57,34,0,7,50
90,Fail,49,36,0,10,39
90,Fail,55,32,3,10,45
90,Fail,51,36,0,11,40
90,Fail,41,31,0,12,29
90,Fail,43,37,6,14,29
90,Fail,49,31,2,18,31
90,Fail,45,35,6,14,31
90,Fail,47,36,5,12,35
90,Fail,46,35,0,14,32
90,Fail,45,40,1,14,31
90,Fail,45,38,3,14,31
90,Fail,52,36,0,12,40
90,Fail,51,32,0,14,37
90,Fail,49,35,0,14,35
90,Fail,57,30,0,8,49
90,Fail,53,28,2,17,36
90,Fail,52,29,1,18,34
90,Fail,43,33,0,21,22
90,Fail,43,34,0,20,23
90,Fail,47,38,0,9,38
90,Fail,50,32,3,15,35
90,Fail,47,36,0,17,30
90,Fail,49,28,0,13,36
90,Fail,53,38,0,9,44
90,Fail,51,38,2,9,42
90,Fail,49,37,0,11,38
90,Fail,53,39,0,6,47
90,Fail,48,38,0,11,37
90,Fail,58,32,0,8,50
90,Fail,46,42,0,12,34
90,Fail,46,37,0,9,37
90,Fail,45,36,1,18,27
90,Fail,47,32,1,20,27
90,Fail,47,33,0,12,35
90,Fail,41,47,0,12,29
90,Fail,50,39,0,10,40
90,Fail,45,41,3,11,34
90,Fail,43,33,0,17,26
90,Fail,44,35,0,15,29
90,Fail,46,33,0,15,31
90,Fail,47,36,0,16,31
90,Fail,50,33,2,15,35
90,Fail,43,37,0,13,30
90,Fail,58,30,0,10,48
90,Fail,49,31,0,18,31
90,Fail,46,41,0,12,34
90,Fail,48,32,0,15,33
90,Fail,44,34,0,16,28
90,Fail,49,29,0,15,34
90,Fail,53,31,3,13,40
90,Fail,38,42,0,18,20
90,Fail,48,41,0,8,40
90,Fail,51,30,0,13,38
90,Fail,58,24,0,14,44
90,Fail,47,40,1,12,35
90,Fail,40,35,9,16,24
90,Fail,56,35,0,8,48
90,Fail,52,38,0,9,43
90,Fail,50,36,1,13,37
90,Fail,49,33,0,18,31
90,Fail,51,40,0,9,42
90,Fail,50,40,3,7,43
90,Fail,50,38,0,12,38
90,Fail,51,35,0,13,38
90,Fail,50,36,0,11,39
90,Fail,42,38,0,17,25
90,Fail,48,37,3,12,36
90,Fail,45,37,3,15,30
90,Fail,43,48,1,8,35
90,Fail,46,36,0,16,30
90,Fail,47,39,1,13,34
90,Fail,47,38,0,12,35
90,Fail,43,50,2,5,38
90,Fail,46,34,7,13,33
90,Fail,53,31,0,9,44
90,Fail,44,42,0,14,30
90,Fail,53,32,8,7,46
90,Fail,50,27,11,12,38
90,Fail,46,36,0,18,28
90,Fail,43,38,4,15,28
90,Fail,51,31,6,12,39
90,Fail,52,36,0,10,42
90,Fail,51,38,0,10,41
90,Fail,48,30,0,16,32
90,Fail,50,34,4,12,38
90,Fail,44,43,0,11,33
90,Fail,35,43,0,18,17
90,Fail,49,36,0,12,37
90,Fail,47,35,5,13,34
90,Fail,49,39,0,11,38
90,Fail,50,36,0,11,39
90,Fail,48,37,0,8,40
90,Fail,44,43,0,9,35
90,Fail,54,32,0,13,41
90,Fail,33,45,0,18,15
90,Fail,55,29,0,13,42
90,Fail,45,37,3,15,30
90,Fail,39,32,0,19,20
90,Fail,48,38,0,13,35
90,Fail,45,38,0,15,30
90,Fail,40,40,0,12,28
90,Fail,52,34,10,4,48
90,Fail,47,33,4,16,31
90,Fail,45,33,5,17,28
90,Fail,45,35,0,19,26
90,Fail,46,38,4,12,34
90,Fail,50,35,0,14,36
90,Fail,40,41,7,12,28
90,Fail,46,38,0,8,38
90,Fail,42,36,0,12,30
90,Fail,42,29,0,11,31
90,Fail,52,38,0,8,44
90,Fail,45,40,7,8,37
90,Fail,41,45,3,11,30
90,Fail,50,37,0,11,39
90,Fail,51,31,0,9,42
90,Fail,44,40,0,10,34
90,Fail,51,34,4,11,40
90,Fail,46,43,1,10,36
90,Fail,38,40,1,21,17
90,Fail,43,36,1,20,23
90,Fail,43,31,9,17,26
90,Fail,45,37,0,11,34
90,Fail,44,35,0,16,28
90,Fail,51,34,1,14,37
90,Fail,52,35,0,9,43
90,Fail,62,31,0,6,56
90,Fail,51,33,1,15,36
90,Fail,50,32,9,9,41
90,Fail,51,36,4,9,42
90,Fail,45,35,8,12,33
90,Fail,45,37,0,8,37
90,Fail,51,35,5,9,42
90,Fail,47,42,0,11,36
90,Fail,48,38,5,9,39
90,Fail,51,38,0,10,41
90,Fail,40,48,4,8,32
90,Fail,53,33,0,11,42
90,Fail,47,36,9,8,39
90,Fail,51,39,0,9,42
90,Fail,47,38,0,10,37
90,Fail,61,25,0,5,56
90,Fail,57,31,0,11,46
90,Fail,40,35,6,19,21
90,Fail,46,40,0,14,32
90,Fail,49,35,0,12,37
90,Fail,49,34,0,13,36
90,Fail,54,31,6,9,45
90,Fail,51,39,0,10,41
90,Fail,51,30,0,18,33
90,Fail,47,34,0,15,32
90,Fail,56,32,4,8,48
90,Fail,50,32,0,10,40
90,Fail,48,37,0,11,37
90,Fail,48,37,0,15,33
90,Fail,47,40,0,8,39
90,Fail,45,36,0,17,28
90,Fail,46,40,0,11,35
90,Fail,51,37,0,9,42
90,Fail,48,39,0,8,40
90,Fail,45,42,0,13,32
90,Fail,47,34,8,11,36
90,Fail,49,39,4,8,41
90,Fail,41,36,0,19,22
90,Fail,37,38,3,22,15
90,Fail,46,37,3,14,32
90,Fail,49,30,0,14,35
90,Fail,43,31,0,17,26
90,Fail,56,31,0,13,43
90,Fail,43,40,0,15,28
90,Fail,40,47,2,11,29
90,Fail,49,36,0,10,39
90,Fail,48,39,5,8,40
90,Fail,54,29,4,13,41
90,Fail,44,33,7,16,28
90,Fail,49,29,0,16,33
90,Fail,53,34,2,11,42
90,Fail,45,38,5,12,33
90,Fail,49,42,2,7,42
90,Fail,43,30,0,17,26
90,Fail,54,29,1,16,38
90,Fail,45,38,5,12,33
90,Fail,49,33,10,8,41
90,Fail,52,35,0,11,41
90,Fail,46,40,1,13,33
90,Fail,47,38,0,13,34
90,Fail,46,36,6,12,34
90,Fail,45,41,0,8,37
90,Fail,55,34,0,10,45
90,Fail,41,38,2,19,22
90,Fail,43,35,0,12,31
90,Fail,53,33,0,13,40
90,Fail,47,35,8,10,37
90,Fail,52,37,0,10,42
90,Fail,52,36,4,8,44
90,Fail,41,35,0,11,30
90,Fail,52,35,0,11,41
90,Fail,46,43,1,10,36
90,Fail,44,37,3,16,28
90,Fail,42,42,0,14,28
90,Fail,44,34,6,16,28
90,Fail,46,39,1,14,32
90,Fail,44,47,0,9,35
90,Fail,42,39,0,14,28
90,Fail,47,36,4,13,34
90,Fail,54,38,1,7,47
90,Fail,50,37,3,10,40
90,Fail,52,37,0,11,41
90,Fail,54,30,0,16,38
90,Fail,55,29,0,13,42
90,Fail,48,31,8,13,35
90,Fail,49,36,0,14,35
90,Fail,49,29,0,14,35
90,Fail,42,35,6,17,25
90,Fail,45,35,5,15,30
90,Fail,41,40,0,13,28
90,Fail,46,35,0,15,31
90,Fail,52,38,0,9,43
90,Fail,46,36,5,13,33
90,Fail,47,38,3,12,35
90,Fail,47,40,0,9,38
90,Fail,48,38,1,13,35
90,Fail,46,34,2,18,28
90,Fail,46,44,0,9,37
90,Fail,55,35,3,7,48
90,Fail,48,31,0,11,37
90,Fail,41,44,0,10,31
90,Fail,50,39,1,10,40
90,Fail,47,40,0,11,36
90,Fail,42,36,6,16,26
90,Fail,45,35,0,10,35
90,Fail,47,37,3,13,34
90,Fail,46,43,0,8,38
90,Fail,48,31,0,17,31
90,Fail,54,32,0,14,40
90,Fail,57,25,0,17,40
90,Fail,50,32,6,12,38
90,Fail,55,30,0,15,40
90,Fail,51,29,5,15,36
90,Fail,35,36,13,16,19
90,Fail,42,43,3,12,30
90,Fail,52,41,0,6,46
90,Fail,57,32,1,10,47
90,Fail,41,39,0,15,26
90,Fail,49,32,0,14,35
90,Fail,52,39,0,9,43
90,Fail,49,27,4,20,29
90,Fail,54,35,0,10,44
90,Fail,41,30,12,17,24
90,Fail,40,44,0,13,27
90,Fail,54,32,0,14,40
90,Fail,41,36,6,17,24
90,Fail,50,32,0,11,39
90,Fail,56,33,1,10,46
90,Fail,39,41,0,13,26
90,Fail,52,32,1,15,37
90,Fail,46,43,0,9,37
90,Fail,49,34,0,13,36
90,Fail,49,34,0,13,36
90,Fail,43,32,8,17,26
90,Fail,40,40,7,13,27
90,Fail,45,35,4,16,29
90,Fail,48,38,0,8,40
90,Fail,42,34,0,13,29
90,Fail,54,39,0,7,47
90,Fail,48,36,1,15,33
90,Fail,55,34,0,11,44
90,Fail,53,33,5,9,44
90,Fail,51,28,0,14,37
90,Fail,48,35,0,11,37
90,Fail,60,32,1,7,53
90,Fail,55,28,0,9,46
90,Fail,48,36,3,13,35
90,Fail,43,40,1,16,27
90,Fail,52,39,0,9,43
90,Fail,42,42,0,12,30
90,Fail,51,35,4,10,41
90,Fail,56,33,0,9,47
90,Fail,56,32,4,8,48
90,Fail,44,46,4,6,38
90,Fail,42,36,8,14,28
90,Fail,45,31,8,16,29
90,Fail,50,33,5,12,38
90,Fail,50,36,2,12,38
90,Fail,45,42,0,11,34
90,Fail,42,36,0,18,24
90,Fail,55,29,3,13,42
90,Fail,54,37,3,6,48
90,Fail,48,34,1,17,31
90,Fail,43,45,0,10,33
90,Fail,57,37,0,6,51
90,Fail,51,30,0,13,38
90,Fail,47,38,0,11,36
90,Fail,49,36,0,14,35
90,Fail,46,38,0,14,32
90,Fail,48,31,0,18,30
90,Fail,55,35,1,9,46
90,Fail,50,27,5,18,32
90,Fail,51,37,0,12,39
90,Fail,46,35,0,13,33
90,Fail,50,37,0,10,40
90,Fail,32,29,0,29,3
90,Fail,43,43,0,9,34
90,Fail,40,43,0,10,30
90,Fail,50,35,1,14,36
90,Fail,45,40,0,14,31
90,Fail,50,35,0,14,36
90,Fail,57,32,1,10,47
90,Fail,52,37,2,9,43
90,Fail,49,33,4,14,35
90,Fail,41,41,0,12,29
90,Fail,45,35,0,11,34
90,Fail,44,35,0,11,33
90,Fail,52,31,0,14,38
90,Fail,53,31,8,8,45
90,Fail,49,35,0,15,34
90,Fail,52,35,5,8,44
90,Fail,44,37,0,13,31
90,Fail,51,33,0,13,38
90,Fail,49,25,9,17,32
90,Fail,51,28,11,10,41
90,Fail,51,31,8,10,41
90,Fail,56,26,0,13,43
90,Fail,50,32,0,13,37
90,Fail,47,38,0,13,34
90,Fail,52,31,4,13,39
90,Fail,51,33,0,13,38
90,Fail,52,34,0,10,42
90,Fail,58,27,0,14,44
90,Fail,56,31,0,8,48
90,Fail,39,35,0,18,21
90,Fail,47,42,0,8,39
90,Fail,43,33,8,16,27
90,Fail,50,38,0,8,42
90,Fail,47,35,3,15,32
90,Fail,44,39,0,13,31
90,Fail,48,32,8,12,36
90,Fail,49,43,0,6,43
90,Fail,50,29,0,21,29
90,Fail,45,37,5,13,32
90,Fail,52,33,3,12,40
90,Fail,56,29,5,10,46
90,Fail,50,31,0,15,35
90,Fail,53,31,8,8,45
90,Fail,57,31,1,11,46
90,Fail,48,37,7,8,40
90,Fail,51,35,5,9,42
90,Fail,51,35,2,12,39
90,Fail,56,33,1,10,46
90,Fail,45,42,5,8,37
90,Fail,45,37,0,11,34
90,Fail,54,30,2,14,40
90,Fail,43,38,0,15,28
90,Fail,43,38,6,13,30
90,Fail,49,34,0,11,38
90,Fail,46,27,8,19,27
90,Fail,47,26,5,22,25
90,Fail,53,31,0,15,38
90,Fail,51,31,2,16,35
90,Fail,51,30,4,15,36
90,Fail,49,39,0,10,39
90,Fail,49,35,0,14,35
90,Fail,52,34,0,7,45
90,Fail,50,33,0,16,34
90,Fail,43,38,0,17,26
90,Fail,42,35,8,15,27
90,Fail,47,37,0,15,32
90,Fail,50,31,3,16,34
90,Fail,48,40,0,10,38
90,Fail,50,31,5,14,36
90,Fail,54,30,0,15,39
90,Fail,50,36,3,11,39
90,Fail,52,36,0,12,40
90,Fail,48,37,4,11,37
90,Fail,56,27,0,17,39
90,Fail,52,34,3,11,41
90,Fail,52,31,0,12,40
90,Fail,49,39,0,12,37
90,Fail,52,33,0,10,42
90,Fail,49,32,0,13,36
90,Fail,42,39,0,16,26
90,Fail,49,29,10,12,37
90,Fail,49,42,1,8,41
90,Fail,42,46,0,12,30
90,Fail,46,37,0,9,37
90,Fail,44,39,3,14,30
90,Fail,49,35,0,10,39
90,Fail,46,39,3,12,34
90,Fail,49,40,0,11,38
90,Fail,42,41,0,17,25
90,Fail,43,32,0,14,29
90,Fail,50,40,0,6,44
90,Fail,50,38,2,10,40
90,Fail,57,34,0,9,48
90,Fail,57,29,0,12,45
90,Fail,45,32,0,17,28
90,Fail,47,37,4,12,35
90,Fail,50,37,0,11,39
90,Fail,43,32,0,13,30
90,Fail,49,40,0,10,39
90,Fail,44,39,0,15,29
90,Fail,45,37,0,12,33
90,Fail,48,35,5,12,36
90,Fail,54,35,0,8,46
90,Fail,51,33,3,13,38
90,Fail,50,34,1,15,35
90,Fail,59,30,0,8,51
90,Fail,45,42,0,11,34
90,Fail,52,28,6,14,38
90,Fail,51,30,10,9,42
90,Fail,41,40,8,11,30
90,Fail,54,29,7,10,44
90,Fail,52,36,1,11,41
90,Fail,45,42,0,12,33
90,Fail,50,37,0,10,40
90,Fail,55,32,4,9,46
90,Fail,53,32,0,13,40
90,Fail,53,32,9,6,47
90,Fail,48,34,6,12,36
90,Fail,47,32,0,11,36
90,Fail,43,44,0,10,33
90,Fail,44,43,6,7,37
90,Fail,45,38,4,13,32
90,Fail,52,36,0,12,40
90,Fail,47,33,0,13,34
90,Fail,48,42,0,9,39
90,Fail,53,26,0,11,42
90,Fail,43,38,7,12,31
90,Fail,44,35,0,13,31
90,Fail,51,35,0,13,38
90,Fail,48,36,0,13,35
90,Fail,49,39,0,9,40
90,Fail,52,33,0,13,39
90,Fail,46,33,12,9,37
90,Fail,41,39,0,11,30
90,Fail,43,40,7,10,33
90,Fail,52,40,0,5,47
90,Fail,44,34,0,14,30
90,Fail,44,36,8,12,32
90,Fail,47,39,1,13,34
90,Fail,44,27,17,12,32
90,Fail,48,31,6,15,33
90,Fail,42,34,0,16,26
90,Fail,51,35,1,13,38
90,Fail,44,38,0,11,33
90,Fail,43,40,0,15,28
90,Fail,44,41,0,15,29
90,Fail,45,41,5,9,36
90,Fail,47,36,3,14,33
90,Fail,49,24,0,15,34
90,Fail,42,35,0,19,23
90,Fail,60,18,0,13,47
90,Fail,44,36,0,10,34
90,Fail,47,34,6,13,34
90,Fail,49,38,3,10,39
90,Fail,44,40,4,12,32
90,Fail,49,34,4,13,36
90,Fail,44,38,7,11,33
90,Fail,43,37,0,10,33
90,Fail,57,34,0,9,48
90,Fail,49,28,7,16,33
90,Fail,48,26,13,13,35
90,Fail,46,32,0,16,30
90,Fail,49,33,3,15,34
90,Fail,49,45,0,4,45
90,Fail,49,35,2,14,35
90,Fail,51,28,8,13,38
90,Fail,39,41,0,12,27
90,Fail,54,33,1,12,42
90,Fail,52,32,0,15,37
90,Fail,43,37,0,18,25
90,Fail,47,37,0,15,32
90,Fail,56,30,0,8,48
90,Fail,47,35,4,14,33
90,Fail,44,38,0,14,30
90,Fail,44,29,8,19,25
90,Fail,45,30,0,18,27
90,Fail,51,31,4,14,37
90,Fail,52,34,1,13,39
90,Fail,55,33,0,8,47
90,Fail,50,36,0,12,38
90,Fail,39,44,0,7,32
90,Fail,46,39,3,12,34
90,Fail,51,33,5,11,40
90,Fail,49,29,0,13,36
90,Fail,49,32,0,17,32
90,Fail,56,25,0,17,39
90,Fail,42,40,0,14,28
90,Fail,53,35,0,8,45
90,Fail,47,36,0,10,37
90,Fail,45,37,1,17,28
90,Fail,53,34,0,10,43
90,Fail,41,37,0,14,27
90,Fail,55,29,0,14,41
90,Fail,51,32,5,12,39
90,Fail,40,38,8,14,26
90,Fail,43,26,0,18,25
90,Fail,48,39,0,8,40
90,Fail,56,33,3,8,48
90,Fail,39,41,5,15,24
90,Fail,52,33,3,12,40
90,Fail,51,37,0,6,45
90,Fail,44,42,4,10,34
90,Fail,50,38,3,9,41
90,Fail,41,37,1,21,20
90,Fail,45,38,0,17,28
90,Fail,51,33,0,11,40
90,Fail,55,24,0,17,38
90,Fail,49,40,1,10,39
90,Fail,51,35,0,13,38
90,Fail,57,27,0,7,50
90,Fail,47,38,0,13,34
90,Fail,50,36,0,12,38
90,Fail,48,37,2,13,35
90,Fail,53,37,0,9,44
90,Fail,48,34,0,18,30
90,Fail,48,32,8,12,36
90,Fail,48,40,0,12,36
90,Fail,46,32,0,17,29
90,Fail,54,33,0,13,41
90,Fail,46,35,2,17,29
90,Fail,57,30,7,6,51
90,Fail,49,39,0,11,38
90,Fail,54,32,3,11,43
90,Fail,49,40,0,11,38
90,Fail,46,33,0,14,32
90,Fail,48,27,0,16,32
90,Fail,51,39,0,10,41
90,Fail,52,29,0,11,41
90,Fail,40,37,0,20,20
90,Fail,49,41,0,8,41
90,Fail,44,48,0,8,36
90,Fail,54,23,0,14,40
90,Fail,49,38,1,12,37
90,Fail,53,30,6,11,42
90,Fail,47,39,4,10,37
90,Fail,56,36,0,6,50
90,Fail,45,36,5,14,31
90,Fail,41,38,0,19,22
90,Fail,53,34,0,13,40
90,Fail,43,39,2,16,27
90,Fail,57,35,2,6,51
90,Fail,55,30,0,13,42
90,Fail,45,39,1,15,30
90,Fail,51,38,0,9,42
90,Fail,46,35,0,15,31
90,Fail,50,40,2,8,42
90,Fail,52,31,0,14,38
90,Fail,42,38,0,13,29
90,Fail,44,39,3,14,30
90,Fail,51,36,2,11,40
90,Fail,40,36,0,19,21
90,Fail,55,37,1,7,48
90,Fail,55,29,0,11,44
90,Fail,47,41,2,10,37
90,Fail,45,38,4,13,32
90,Fail,46,36,0,11,35
90,Fail,59,25,0,14,45
90,Fail,48,34,0,16,32
90,Fail,48,38,0,12,36
90,Fail,50,29,8,13,37
90,Fail,46,34,3,17,29
90,Fail,51,31,0,12,39
90,Fail,49,34,0,15,34
90,Fail,45,41,0,14,31
90,Fail,47,36,0,13,34
90,Fail,60,36,0,4,56
90,Fail,46,34,5,15,31
90,Fail,52,35,3,10,42
90,Fail,49,37,4,10,39
90,Fail,48,30,0,16,32
90,Fail,42,38,0,15,27
90,Fail,47,30,0,12,35
90,Fail,45,41,0,11,34
90,Fail,50,34,0,16,34
90,Fail,51,39,0,10,41
90,Fail,48,36,0,14,34
90,Fail,51,29,2,18,33
90,Fail,41,37,0,16,25
90,Fail,38,45,0,12,26
90,Fail,51,30,10,9,42
90,Fail,45,37,4,14,31
90,Fail,50,39,1,10,40
90,Fail,46,38,0,7,39
90,Fail,43,36,0,17,26
90,Fail,47,33,6,14,33
90,Fail,48,36,4,12,36
90,Fail,53,37,0,10,43
90,Fail,52,36,2,10,42
90,Fail,45,35,0,13,32
90,Fail,53,29,0,15,38
90,Fail,50,41,6,3,47
90,Fail,46,29,0,17,29
90,Fail,47,41,1,11,36
90,Fail,51,27,9,13,38
90,Fail,44,38,2,16,28
90,Fail,47,32,11,10,37
90,Fail,50,41,3,6,44
90,Fail,45,35,0,10,35
90,Fail,53,39,1,7,46
90,Fail,41,37,11,11,30
90,Fail,49,38,1,12,37
90,Fail,53,35,1,11,42
90,Fail,42,27,15,16,26
90,Fail,43,42,0,13,30
90,Fail,52,32,0,13,39
90,Fail,42,39,12,7,35
90,Fail,52,32,0,11,41
90,Fail,58,28,5,9,49
90,Fail,58,34,0,5,53
90,Fail,51,34,0,12,39
90,Fail,45,31,0,15,30
90,Fail,51,27,0,15,36
90,Fail,50,34,0,11,39
90,Fail,47,35,0,13,34
90,Fail,53,31,4,12,41
90,Fail,50,39,0,9,41
90,Fail,46,41,0,13,33
90,Fail,52,31,4,13,39
90,Fail,44,37,0,18,26
90,Fail,56,30,1,13,43
90,Fail,49,39,5,7,42
90,Fail,48,34,3,15,33
90,Fail,56,31,0,13,43
90,Fail,48,35,1,16,32
90,Fail,51,35,0,11,40
90,Fail,48,38,3,11,37
90,Fail,50,40,1,9,41
90,Fail,47,38,0,11,36
90,Fail,50,40,0,10,40
90,Fail,45,31,13,11,34
90,Fail,51,34,5,10,41
90,Fail,48,35,2,15,33
90,Fail,46,33,5,16,30
90,Fail,48,36,0,11,37
90,Fail,42,33,0,20,22
90,Fail,58,37,0,4,54
90,Fail,53,30,4,13,40
90,Fail,42,33,3,22,20
90,Fail,56,26,0,11,45
90,Fail,43,30,12,15,28
90,Fail,58,33,0,9,49
90,Fail,49,33,0,13,36
90,Fail,48,35,0,9,39
90,Fail,48,35,0,15,33
90,Fail,49,36,0,15,34
90,Fail,52,32,0,11,41
90,Fail,44,41,0,7,37
90,Fail,43,43,2,12,31
90,Fail,51,31,0,13,38
90,Fail,45,38,0,17,28
90,Fail,50,31,0,12,38
90,Fail,52,36,0,10,42
90,Fail,48,35,0,12,36
90,Fail,50,26,0,16,34
90,Fail,40,47,0,12,28
90,Fail,51,40,0,8,43
90,Fail,43,42,0,15,28
90,Fail,48,40,1,11,37
90,Fail,52,36,0,11,41
90,Fail,48,37,0,11,37
90,Fail,44,32,6,18,26
90,Fail,44,38,6,12,32
90,Fail,49,36,0,14,35
90,Fail,54,29,3,14,40
90,Fail,55,29,6,10,45
90,Fail,46,45,1,8,38
90,Fail,50,37,0,10,40
90,Fail,52,31,7,10,42
90,Fail,48,44,0,7,41
90,Fail,53,42,0,4,49
90,Fail,45,40,0,14,31
90,Fail,43,34,0,16,27
90,Fail,47,43,4,6,41
90,Fail,48,40,0,12,36
90,Fail,41,36,6,17,24
90,Fail,50,36,4,10,40
90,Fail,44,37,10,9,35
90,Fail,55,31,0,13,42
90,Fail,44,40,4,12,32
90,Fail,57,34,0,9,48
90,Fail,40,39,9,12,28
90,Fail,48,36,4,12,36
90,Fail,47,41,0,6,41
90,Fail,48,38,0,14,34
90,Fail,49,37,1,13,36
90,Fail,54,32,1,13,41
90,Fail,45,39,0,14,31
90,Fail,46,29,0,18,28
90,Fail,51,37,1,11,40
90,Fail,45,38,6,11,34
90,Fail,54,34,0,11,43
90,Fail,55,35,2,8,47
90,Fail,45,36,5,14,31
90,Fail,49,27,8,16,33
90,Fail,53,28,0,16,37
90,Fail,49,38,2,11,38
90,Fail,36,36,9,19,17
90,Fail,53,36,0,8,45
90,Fail,55,38,0,7,48
90,Fail,47,38,0,15,32
90,Fail,46,38,4,12,34
90,Fail,46,37,4,13,33
90,Fail,54,31,0,10,44
90,Fail,58,31,1,10,48
90,Fail,46,37,1,16,30
90,Fail,51,34,4,11,40
90,Fail,45,42,0,12,33
90,Fail,45,40,0,11,34
90,Fail,50,31,0,18,32
90,Fail,52,33,4,11,41
90,Fail,54,38,2,6,48
90,Fail,46,34,0,15,31
90,Fail,45,34,11,10,35
90,Fail,47,34,3,16,31
90,Fail,46,42,0,11,35
90,Fail,51,36,4,9,42
90,Fail,49,35,0,11,38
90,Fail,51,30,6,13,38
90,Fail,45,42,0,11,34
90,Fail,57,28,6,9,48
90,Fail,43,44,0,13,30
90,Fail,56,35,2,7,49
90,Fail,54,26,2,18,36
90,Fail,55,31,4,10,45
90,Fail,47,40,0,13,34
90,Fail,52,37,0,11,41
90,Fail,46,35,0,15,31
90,Fail,44,41,0,11,33
90,Fail,56,23,0,9,47
90,Fail,53,31,0,13,40
90,Fail,50,31,0,15,35
90,Fail,43,39,4,14,29
90,Fail,43,42,1,14,29
90,Fail,60,32,0,8,52
90,Fail,47,39,0,12,35
90,Fail,44,35,0,15,29
90,Fail,47,36,0,17,30
90,Fail,53,39,0,8,45
90,Fail,49,33,0,14,35
90,Fail,45,42,2,11,34
90,Fail,50,35,0,13,37
90,Fail,48,36,0,11,37
90,Fail,52,36,0,10,42
90,Fail,32,38,0,10,22
90,Fail,53,33,6,8,45
90,Fail,50,31,0,18,32
90,Fail,45,38,0,10,35
90,Fail,46,34,0,12,34
90,Fail,56,22,7,15,41
90,Fail,38,37,0,15,23
90,Fail,46,33,0,15,31
90,Fail,44,36,4,16,28
90,Fail,56,32,0,11,45
90,Fail,47,32,0,18,29
90,Fail,45,40,0,10,35
90,Fail,59,30,0,9,50
90,Fail,43,38,6,13,30
90,Fail,50,35,0,12,38
90,Fail,44,32,8,16,28
90,Fail,48,31,6,15,33
90,Fail,49,30,0,15,34
90,Fail,38,48,3,11,27
90,Fail,42,39,0,17,25
90,Fail,54,36,0,10,44
90,Fail,42,34,11,13,29
90,Fail,38,45,0,12,26
90,Fail,47,43,0,7,40
90,Fail,50,40,0,9,41
90,Fail,48,35,0,15,33
90,Fail,42,39,7,12,30
90,Fail,47,38,0,12,35
90,Fail,53,34,0,11,42
90,Fail,53,34,2,11,42
90,Fail,52,35,4,9,43
90,Fail,53,24,3,20,33
90,Fail,40,34,0,19,21
90,Fail,48,35,0,16,32
90,Fail,45,35,0,16,29
90,Fail,44,42,0,13,31
90,Fail,43,31,6,20,23
90,Fail,40,38,10,12,28
90,Fail,44,45,2,9,35
90,Fail,52,31,4,13,39
90,Fail,47,41,1,11,36
90,Fail,49,37,0,13,36
90,Fail,54,35,0,9,45
90,Fail,49,36,0,13,36
90,Fail,47,35,1,17,30
90,Fail,54,30,0,15,39
90,Fail,45,41,0,12,33
90,Fail,45,36,2,17,28
90,Fail,53,39,1,7,46
90,Fail,44,37,4,15,29
90,Fail,47,37,1,15,32
90,Fail,53,28,0,12,41
90,Fail,52,34,3,11,41
90,Fail,49,33,0,17,32
90,Fail,47,34,7,12,35
90,Fail,50,30,7,13,37
90,Fail,51,25,10,14,37
90,Fail,47,29,0,16,31
90,Fail,43,37,4,16,27
90,Fail,47,45,0,8,39
90,Fail,49,34,0,13,36
90,Fail,36,41,8,15,21
90,Fail,52,31,3,14,38
90,Fail,42,39,0,14,28
90,Fail,52,37,4,7,45
90,Fail,48,40,1,11,37
90,Fail,47,33,11,9,38
90,Fail,53,31,2,14,39
90,Fail,46,32,2,20,26
90,Fail,52,38,1,9,43
90,Fail,47,36,4,13,34
90,Fail,42,35,0,11,31
90,Fail,49,43,0,8,41
90,Fail,47,34,0,17,30
90,Fail,48,34,0,17,31
90,Fail,46,37,0,16,30
90,Fail,40,48,0,12,28
90,Fail,45,39,0,9,36
90,Fail,53,32,0,15,38
90,Fail,51,32,4,13,38
90,Fail,51,36,2,11,40
90,Fail,46,38,1,15,31
90,Fail,55,37,0,6,49
90,Fail,43,36,0,19,24
90,Fail,51,33,0,13,38
90,Fail,51,36,0,12,39
90,Fail,53,30,2,15,38
90,Fail,52,34,1,13,39
90,Fail,37,46,0,14,23
90,Fail,48,34,0,13,35
90,Fail,44,41,0,13,31
90,Fail,39,37,0,12,27
90,Fail,47,39,0,13,34
90,Fail,52,33,0,13,39
90,Fail,49,35,3,13,36
90,Fail,46,33,0,20,26
90,Fail,47,41,0,12,35
90,Fail,55,31,1,13,42
90,Fail,44,33,0,16,28
90,Fail,54,38,2,6,48
90,Fail,48,33,0,16,32
90,Fail,50,37,0,13,37
90,Fail,48,33,0,11,37
90,Fail,52,34,0,12,40
90,Fail,41,39,5,15,26
90,Fail,42,41,7,10,32
90,Fail,49,39,0,10,39
90,Fail,56,28,0,16,40
90,Fail,42,36,0,16,26
90,Fail,44,30,0,15,29
90,Fail,36,44,0,15,21
90,Fail,58,23,0,15,43
90,Fail,50,34,2,14,36
90,Fail,42,39,3,16,26
90,Fail,53,33,0,14,39
90,Fail,45,38,0,15,30
90,Fail,44,44,0,11,33
90,Fail,53,36,2,9,44
90,Fail,46,36,5,13,33
90,Fail,57,30,4,9,48
90,Fail,39,38,10,13,26
90,Fail,52,41,1,6,46
90,Fail,49,36,0,12,37
90,Fail,43,37,0,19,24
90,Fail,49,37,3,11,38
90,Fail,54,36,1,9,45
90,Fail,46,42,0,10,36
90,Fail,52,33,5,10,42
90,Fail,45,28,0,14,31
90,Fail,41,33,12,14,27
90,Fail,47,39,2,12,35
90,Fail,48,33,8,11,37
90,Fail,47,38,1,14,33
90,Fail,46,36,8,10,36
90,Fail,41,42,0,15,26
90,Fail,42,38,4,16,26
90,Fail,47,38,0,12,35
90,Fail,43,44,0,12,31
90,Fail,42,36,4,18,24
90,Fail,44,35,8,13,31
90,Fail,46,43,0,6,40
90,Fail,49,41,3,7,42
90,Fail,52,38,2,8,44
90,Fail,52,34,0,12,40
90,Fail,48,35,0,13,35
90,Fail,51,31,9,9,42
90,Fail,54,37,0,8,46
90,Fail,52,26,0,15,37
90,Fail,47,35,3,15,32
90,Fail,46,33,6,15,31
90,Fail,48,37,0,15,33
90,Fail,53,35,3,9,44
90,Fail,40,44,1,15,25
90,Fail,48,36,0,13,35
90,Fail,50,26,11,13,37
90,Fail,54,31,1,14,40
90,Fail,46,37,0,15,31
90,Fail,45,35,0,14,31
90,Fail,48,37,2,13,35
90,Fail,53,30,2,15,38
90,Fail,48,34,0,13,35
90,Fail,44,42,0,11,33
90,Fail,50,35,0,11,39
90,Fail,50,36,5,9,41
90,Fail,49,32,0,16,33
90,Fail,54,30,0,7,47
90,Fail,53,32,0,12,41
90,Fail,48,37,2,13,35
90,Fail,45,34,0,12,33
90,Fail,46,39,4,11,35
90,Fail,53,32,0,13,40
90,Fail,55,29,3,13,42
90,Fail,48,38,0,14,34
90,Fail,36,41,0,14,22
90,Fail,49,30,0,14,35
90,Fail,46,40,3,11,35
90,Fail,42,41,0,11,31
90,Fail,46,32,0,10,36
90,Fail,48,40,1,11,37
90,Fail,52,37,0,9,43
90,Fail,48,32,0,17,31
90,Fail,56,35,1,8,48
90,Fail,50,39,3,8,42
90,Fail,40,31,10,19,21
90,Fail,49,38,0,10,39
90,Fail,47,36,0,16,31
90,Fail,42,35,0,15,27
90,Fail,54,32,4,10,44
90,Fail,49,37,1,13,36
90,Fail,46,36,0,9,37
90,Fail,44,42,0,13,31
90,Fail,47,33,3,17,30
90,Fail,42,38,8,12,30
90,Fail,52,36,0,11,41
90,Fail,51,35,9,5,46
90,Fail,48,40,0,11,37
90,Fail,52,35,0,13,39
90,Fail,48,42,0,7,41
90,Fail,47,41,2,10,37
90,Fail,46,30,6,18,28
90,Fail,48,38,0,12,36
90,Fail,49,33,0,9,40
90,Fail,49,30,6,15,34
90,Fail,41,36,5,18,23
90,Fail,49,37,0,8,41
90,Fail,43,39,0,13,30
90,Fail,56,38,1,5,51
90,Fail,49,30,0,14,35
90,Fail,53,33,0,6,47
90,Fail,50,36,2,12,38
90,Fail,52,34,0,10,42
90,Fail,50,35,0,10,40
90,Fail,45,35,2,18,27
90,Fail,46,35,0,15,31
90,Fail,47,33,0,12,35
90,Fail,46,39,0,13,33
90,Fail,49,29,9,13,36
90,Fail,49,39,0,11,38
90,Fail,55,27,3,15,40
90,Fail,50,34,2,14,36
90,Fail,50,33,1,16,34
90,Fail,51,39,0,10,41
90,Fail,46,36,0,9,37
90,Fail,40,41,6,13,27
90,Fail,60,29,0,8,52
90,Fail,48,40,0,12,36
90,Fail,46,37,8,9,37
90,Fail,45,35,9,11,34
90,Fail,52,33,0,12,40
90,Fail,49,33,11,7,42
90,Fail,56,32,0,7,49
90,Fail,50,27,0,19,31
90,Fail,58,33,0,8,50
90,Fail,65,25,0,9,56
90,Fail,53,25,8,14,39
90,Fail,53,36,5,6,47
90,Fail,51,19,16,14,37
90,Fail,50,39,0,11,39
90,Fail,45,35,0,16,29
90,Fail,47,34,4,15,32
90,Fail,44,43,0,9,35
90,Fail,44,36,5,15,29
90,Fail,44,44,1,11,33
90,Fail,46,32,6,16,30
90,Fail,52,31,0,14,38
90,Fail,50,30,6,14,36
90,Fail,45,34,0,16,29
90,Fail,53,29,0,16,37
90,Fail,45,41,0,11,34
90,Fail,52,34,3,11,41
90,Fail,54,32,0,8,46
90,Fail,46,34,0,16,30
90,Fail,51,33,0,15,36
90,Fail,50,41,0,8,42
90,Fail,51,36,0,13,38
90,Fail,49,38,0,11,38
90,Fail,41,36,6,17,24
90,Fail,45,41,0,14,31
90,Fail,51,35,2,12,39
90,Fail,53,31,0,9,44
90,Fail,50,34,0,9,41
90,Fail,44,39,4,13,31
90,Fail,43,34,0,17,26
90,Fail,47,33,4,16,31
90,Fail,49,38,2,11,38
90,Fail,48,40,0,10,38
90,Fail,43,42,2,13,30
90,Fail,45,37,7,11,34
90,Fail,49,42,0,9,40
90,Fail,54,34,3,9,45
90,Fail,43,28,0,17,26
90,Fail,48,41,0,5,43
90,Fail,45,42,0,11,34
90,Fail,54,29,3,14,40
90,Fail,38,32,10,20,18
90,Fail,51,26,0,16,35
90,Fail,46,32,0,12,34
90,Fail,52,34,0,14,38
90,Fail,37,42,0,13,24
90,Fail,57,27,0,11,46
90,Fail,45,40,0,14,31
90,Fail,47,37,2,14,33
90,Fail,44,28,11,17,27
90,Fail,44,40,0,10,34
90,Fail,50,26,5,19,31
90,Fail,47,27,10,16,31
90,Fail,47,31,11,11,36
90,Fail,50,40,1,9,41
90,Fail,46,32,4,18,28
90,Fail,47,41,5,7,40
90,Fail,47,38,0,12,35
90,Fail,52,35,2,11,41
90,Fail,47,36,0,10,37
90,Fail,49,35,0,14,35
90,Fail,52,31,0,12,40
90,Fail,44,40,3,13,31
90,Fail,39,44,0,16,23
90,Fail,48,34,5,13,35
90,Fail,56,26,0,16,40
90,Fail,42,40,8,10,32
90,Fail,51,31,5,13,38
90,Fail,48,38,1,13,35
90,Fail,48,32,0,15,33
90,Fail,55,34,5,6,49
90,Fail,44,36,0,14,30
90,Fail,46,39,0,12,34
90,Fail,43,33,4,20,23
90,Fail,55,36,0,7,48
90,Fail,42,40,7,11,31
90,Fail,42,35,0,14,28
90,Fail,46,28,0,15,31
90,Fail,52,35,0,13,39
90,Fail,54,33,0,12,42
90,Fail,49,35,0,12,37
90,Fail,41,41,2,16,25
90,Fail,48,41,0,10,38
90,Fail,57,32,1,10,47
90,Fail,47,31,0,16,31
90,Fail,46,42,1,11,35
90,Fail,49,35,4,12,37
90,Fail,47,37,8,8,39
90,Fail,57,30,3,10,47
90,Fail,52,36,1,11,41
90,Fail,37,41,6,16,21
90,Fail,53,37,0,10,43
90,Fail,55,31,6,8,47
90,Fail,44,40,0,16,28
90,Fail,50,36,3,11,39
90,Fail,45,38,5,12,33
90,Fail,48,35,0,15,33
90,Fail,50,37,1,12,38
90,Fail,45,40,0,11,34
90,Fail,52,32,1,15,37
90,Fail,42,33,10,15,27
90,Fail,48,36,7,9,39
90,Fail,54,34,2,10,44
90,Fail,49,38,2,11,38
90,Fail,50,35,3,12,38
90,Fail,44,36,7,13,31
90,Fail,43,37,6,14,29
90,Fail,47,36,0,11,36
90,Fail,45,42,3,10,35
90,Fail,49,33,2,16,33
90,Fail,50,34,0,14,36
90,Fail,50,37,1,12,38
90,Fail,51,38,0,8,43
90,Fail,45,42,0,12,33
90,Fail,50,25,7,18,32
90,Fail,47,38,4,11,36
90,Fail,51,38,0,10,41
90,Fail,49,38,3,10,39
90,Fail,57,34,0,9,48
90,Fail,42,38,0,19,23
90,Fail,50,36,3,11,39
90,Fail,53,37,0,10,43
90,Fail,49,31,0,16,33
90,Fail,52,34,0,13,39
90,Fail,42,37,5,16,26
90,Fail,53,31,0,15,38
90,Fail,41,38,0,14,27
90,Fail,47,44,2,7,40
90,Fail,44,42,0,11,33
90,Fail,49,32,10,9,40
90,Fail,46,35,0,15,31
90,Fail,47,38,0,14,33
90,Fail,47,39,0,11,36
90,Fail,47,31,0,19,28
90,Fail,53,32,0,6,47
90,Fail,49,32,4,15,34
90,Fail,47,35,3,15,32
90,Fail,55,29,2,14,41
90,Fail,58,27,3,12,46
90,Fail,44,34,0,14,30
90,Fail,42,38,4,16,26
90,Fail,49,34,2,15,34
90,Fail,55,31,0,12,43
90,Fail,53,36,0,11,42
90,Fail,43,35,0,16,27
90,Fail,44,38,0,16,28
90,Fail,45,33,0,19,26
90,Fail,52,25,9,14,38
90,Fail,44,36,7,13,31
90,Fail,48,33,0,19,29
90,Fail,44,37,0,13,31
90,Fail,40,32,8,20,20
90,Fail,44,39,5,12,32
90,Fail,49,30,3,18,31
90,Fail,51,34,7,8,43
90,Fail,49,30,0,12,37
90,Fail,55,35,0,7,48
90,Fail,56,32,0,9,47
90,Fail,46,32,11,11,35
90,Fail,44,33,0,18,26
90,Fail,42,40,8,10,32
90,Fail,54,30,0,15,39
90,Fail,54,30,0,13,41
90,Fail,45,36,0,14,31
90,Fail,61,23,3,13,48
90,Fail,60,25,0,10,50
90,Fail,44,34,8,14,30
90,Fail,51,35,8,6,45
90,Fail,45,40,0,9,36
90,Fail,47,35,0,18,29
90,Fail,50,36,5,9,41
90,Fail,51,35,0,11,40
90,Fail,49,42,0,8,41
90,Fail,57,32,1,10,47
90,Fail,51,39,2,8,43
90,Fail,51,33,5,11,40
90,Fail,49,33,0,13,36
90,Fail,41,30,12,17,24
90,Fail,47,44,0,9,38
90,Fail,49,32,0,17,32
90,Fail,46,34,7,13,33
90,Fail,57,32,1,10,47
90,Fail,53,28,3,16,37
90,Fail,48,32,6,14,34
90,Fail,46,35,0,18,28
90,Fail,43,38,0,14,29
90,Fail,55,28,0,14,41
90,Fail,51,34,1,14,37
90,Fail,49,35,0,8,41
90,Fail,47,33,0,18,29
90,Fail,46,37,0,15,31
90,Fail,43,40,2,15,28
90,Fail,45,36,0,19,26
90,Fail,49,40,0,10,39
90,Fail,62,25,3,10,52
90,Fail,44,37,4,15,29
90,Fail,49,40,5,6,43
90,Fail,45,39,1,15,30
90,Fail,42,42,5,11,31
90,Fail,52,31,0,17,35
90,Fail,44,42,0,8,36
90,Fail,55,34,2,9,46
90,Fail,43,36,5,16,27
90,Fail,45,34,0,16,29
90,Fail,41,43,0,14,27
90,Fail,43,42,0,10,33
90,Fail,46,38,0,13,33
90,Fail,52,38,0,9,43
90,Fail,43,33,3,21,22
90,Fail,48,30,7,15,33
90,Fail,54,35,2,9,45
90,Fail,49,32,7,12,37
90,Fail,44,35,5,16,28
90,Fail,42,40,6,12,30
90,Fail,51,34,6,9,42
90,Fail,45,40,2,13,32
90,Fail,40,47,1,12,28
90,Fail,42,34,0,12,30
90,Fail,44,41,1,14,30
90,Fail,40,40,7,13,27
90,Fail,45,39,3,13,32
90,Fail,51,31,2,16,35
90,Fail,47,31,10,12,35
90,Fail,56,33,0,10,46
90,Fail,51,38,5,6,45
90,Fail,45,34,6,15,30
90,Fail,48,35,4,13,35
90,Fail,43,37,0,15,28
90,Fail,44,40,2,14,30
90,Fail,43,34,9,14,29
90,Fail,48,42,0,10,38
90,Fail,55,30,2,13,42
90,Fail,47,32,7,14,33
90,Fail,50,40,0,8,42
90,Fail,49,30,4,17,32
90,Fail,40,33,0,12,28
90,Fail,43,38,0,9,34
90,Fail,47,42,0,9,38
90,Fail,51,30,0,17,34
90,Fail,55,27,3,15,40
90,Fail,50,30,9,11,39
90,Fail,46,35,0,13,33
90,Fail,53,33,0,11,42
90,Fail,49,35,0,14,35
90,Fail,51,34,4,11,40
90,Fail,47,38,3,12,35
90,Fail,48,32,0,14,34
90,Fail,47,36,0,14,33
90,Fail,48,34,0,12,36
90,Fail,46,31,8,15,31
90,Fail,50,37,0,11,39
90,Fail,53,29,3,15,38
90,Fail,52,35,1,12,40
90,Fail,50,36,3,11,39
90,Fail,46,41,0,9,37
90,Fail,43,39,0,15,28
90,Fail,55,31,0,14,41
90,Fail,47,31,3,19,28
90,Fail,50,31,2,17,33
90,Fail,45,37,7,11,34
90,Fail,41,43,4,12,29
90,Fail,48,33,0,19,29
90,Fail,50,35,1,14,36
90,Fail,48,39,1,12,36
90,Fail,52,27,6,15,37
90,Fail,45,38,1,16,29
90,Fail,50,33,3,14,36
90,Fail,46,37,0,16,30
90,Fail,45,35,3,17,28
90,Fail,53,32,2,13,40
90,Fail,37,35,9,19,18
90,Fail,44,33,10,13,31
90,Fail,52,35,0,12,40
90,Fail,43,39,5,13,30
90,Fail,44,34,3,19,25
90,Fail,53,36,0,11,42
90,Fail,46,36,2,16,30
90,Fail,50,33,6,11,39
90,Fail,44,37,3,16,28
90,Fail,46,35,0,13,33
90,Fail,54,30,0,10,44
90,Fail,52,31,0,17,35
90,Fail,48,37,0,8,40
90,Fail,45,42,0,13,32
90,Fail,40,47,0,13,27
90,Fail,55,33,0,10,45
90,Fail,47,37,0,12,35
90,Fail,46,37,0,13,33
90,Fail,49,38,3,10,39
90,Fail,44,40,2,14,30
90,Fail,45,31,0,17,28
90,Fail,48,35,0,15,33
90,Fail,46,40,0,10,36
90,Fail,50,37,0,9,41
90,Fail,46,36,0,17,29
90,Fail,44,38,0,17,27
90,Fail,46,34,13,7,39
90,Fail,46,39,0,12,34
90,Fail,54,33,0,13,41
90,Fail,45,38,0,11,34
90,Fail,55,29,0,10,45
90,Fail,50,38,0,11,39
90,Fail,37,44,3,16,21
90,Fail,43,33,0,22,21
90,Fail,48,38,0,10,38
90,Fail,49,42,2,7,42
90,Fail,42,41,0,16,26
90,Fail,55,33,3,9,46
90,Fail,40,40,0,14,26
90,Fail,55,36,0,9,46
90,Fail,47,30,0,19,28
90,Fail,47,36,3,14,33
90,Fail,47,39,0,14,33
90,Fail,47,36,3,14,33
90,Fail,44,35,0,17,27
90,Fail,43,43,5,9,34
90,Fail,58,26,6,10,48
90,Fail,44,34,7,15,29
90,Fail,47,44,1,8,39
90,Fail,47,37,0,13,34
90,Fail,39,45,0,11,28
90,Fail,55,29,0,13,42
90,Fail,46,35,0,11,35
90,Fail,44,39,8,9,35
90,Fail,49,33,8,10,39
90,Fail,50,37,0,11,39
90,Fail,46,39,4,11,35
90,Fail,36,43,0,16,20
90,Fail,53,35,0,12,41
90,Fail,50,34,4,12,38
90,Fail,48,29,0,18,30
90,Fail,54,32,1,13,41
90,Fail,49,38,3,10,39
90,Fail,44,39,0,15,29
90,Fail,51,39,2,8,43
90,Fail,45,39,1,15,30
90,Fail,48,35,0,15,33
90,Fail,38,42,8,12,26
90,Fail,41,39,5,15,26
90,Fail,54,28,0,13,41
90,Fail,48,39,1,12,36
90,Fail,44,30,15,11,33
90,Fail,44,37,9,10,34
90,Fail,51,29,0,12,39
90,Fail,44,38,5,13,31
90,Fail,51,42,0,6,45
90,Fail,51,33,3,13,38
90,Fail,50,37,0,12,38
90,Fail,46,43,0,9,37
90,Fail,41,37,10,12,29
90,Fail,51,34,3,12,39
90,Fail,48,36,3,13,35
90,Fail,54,38,0,8,46
90,Fail,49,30,0,16,33
90,Fail,50,34,0,13,37
90,Fail,49,38,0,10,39
90,Fail,50,29,0,14,36
90,Fail,44,34,0,19,25
90,Fail,45,28,13,14,31
90,Fail,41,44,1,14,27
90,Fail,46,37,0,14,32
90,Fail,45,36,9,10,35
90,Fail,59,34,0,6,53
90,Fail,47,36,0,17,30
90,Fail,48,37,0,14,34
90,Fail,43,35,0,21,22
90,Fail,50,37,0,13,37
90,Fail,38,44,6,12,26
90,Fail,55,35,0,9,46
90,Fail,50,26,0,17,33
90,Fail,52,31,0,17,35
90,Fail,49,39,0,12,37
90,Fail,42,41,0,11,31
90,Fail,47,41,0,10,37
90,Fail,47,34,3,16,31
90,Fail,52,37,2,9,43
90,Fail,44,31,12,13,31
90,Fail,45,36,0,19,26
90,Fail,53,37,1,9,44
90,Fail,50,35,4,11,39
90,Fail,44,39,0,15,29
90,Fail,55,35,0,8,47
90,Fail,44,34,10,12,32
90,Fail,42,33,12,13,29
90,Fail,41,37,2,20,21
90,Fail,38,40,3,19,19
90,Fail,45,38,8,9,36
90,Fail,46,40,5,9,37
90,Fail,53,32,0,11,42
90,Fail,45,36,2,17,28
90,Fail,45,41,1,13,32
90,Fail,51,32,2,15,36
90,Fail,50,31,0,6,44
90,Fail,48,36,0,14,34
90,Fail,47,39,4,10,37
90,Fail,46,34,5,15,31
90,Fail,52,31,0,14,38
90,Fail,44,44,0,10,34
90,Fail,54,36,0,9,45
90,Fail,45,45,0,8,37
90,Fail,38,36,0,18,20
90,Fail,50,33,0,13,37
90,Fail,50,31,0,16,34
90,Fail,43,34,10,13,30
90,Fail,44,36,7,13,31
90,Fail,48,33,1,18,30
90,Fail,44,43,4,9,35
90,Fail,49,30,0,13,36
90,Fail,57,32,3,8,49
90,Fail,43,40,9,8,35
90,Fail,44,38,0,12,32
90,Fail,41,40,0,15,26
90,Fail,44,41,0,11,33
90,Fail,45,36,6,13,32
90,Fail,50,34,0,11,39
90,Fail,47,35,5,13,34
90,Fail,44,37,7,12,32
90,Fail,50,36,1,13,37
90,Fail,52,32,0,13,39
90,Fail,50,36,0,12,38
90,Fail,48,37,6,9,39
90,Fail,46,41,0,7,39
90,Fail,53,28,0,14,39
90,Fail,45,40,4,11,34
90,Fail,44,40,3,13,31
90,Fail,47,35,0,11,36
90,Fail,39,42,0,7,32
90,Fail,51,32,0,13,38
90,Fail,53,34,0,12,41
90,Fail,39,36,0,15,24
90,Fail,45,39,3,13,32
90,Fail,56,32,2,10,46
90,Fail,43,44,0,12,31
90,Fail,44,34,9,13,31
90,Fail,50,30,0,13,37
90,Fail,55,27,0,13,42
90,Fail,46,35,0,14,32
90,Fail,51,37,0,8,43
90,Fail,53,30,1,16,37
90,Fail,51,32,0,13,38
90,Fail,50,36,0,14,36
90,Fail,55,35,2,8,47
90,Fail,41,39,7,13,28
90,Fail,52,25,0,19,33
90,Fail,49,30,2,19,30
90,Fail,48,37,0,11,37
90,Fail,47,39,0,9,38
90,Fail,41,40,5,14,27
90,Fail,48,30,0,16,32
90,Fail,45,34,4,17,28
90,Fail,44,44,2,10,34
90,Fail,51,36,0,10,41
90,Fail,45,42,1,12,33
90,Fail,52,32,6,10,42
90,Fail,47,30,0,16,31
90,Fail,47,39,0,10,37
90,Fail,51,28,1,20,31
90,Fail,58,29,0,13,45
90,Fail,49,39,0,11,38
90,Fail,45,33,0,15,30
90,Fail,41,40,0,14,27
90,Fail,49,31,7,13,36
90,Fail,44,38,0,13,31
90,Fail,47,32,0,17,30
90,Fail,53,32,0,12,41
90,Fail,55,33,1,11,44
90,Fail,52,29,0,17,35
90,Fail,49,32,0,18,31
90,Fail,48,34,0,15,33
90,Fail,51,35,1,13,38
90,Fail,45,37,0,13,32
90,Fail,50,33,0,13,37
90,Fail,49,30,0,10,39
90,Fail,42,36,0,17,25
90,Fail,54,28,4,14,40
90,Fail,45,44,0,8,37
90,Fail,61,29,3,7,54
90,Fail,42,48,1,9,33
90,Fail,40,40,0,16,24
90,Fail,49,36,0,8,41
90,Fail,51,34,6,9,42
90,Fail,46,31,0,14,32
90,Fail,47,36,1,16,31
90,Fail,47,37,0,13,34
90,Fail,47,37,0,13,34
90,Fail,45,37,0,16,29
90,Fail,55,31,0,11,44
90,Fail,50,31,0,5,45
90,Fail,48,40,0,9,39
90,Fail,43,36,0,16,27
90,Fail,56,31,1,12,44
90,Fail,48,35,0,16,32
90,Fail,55,33,2,10,45
90,Fail,48,32,0,18,30
90,Fail,58,34,0,8,50
90,Fail,50,35,6,9,41
90,Fail,53,33,0,12,41
90,Fail,55,34,0,8,47
90,Fail,46,30,0,18,28
90,Fail,40,37,3,20,20
90,Fail,46,32,9,13,33
90,Fail,50,30,0,16,34
90,Fail,50,32,0,16,34
90,Fail,40,37,4,19,21
90,Fail,52,34,4,10,42
90,Fail,47,35,4,14,33
90,Fail,49,38,2,11,38
90,Fail,45,32,2,21,24
90,Fail,46,38,3,13,33
90,Fail,48,33,0,8,40
90,Fail,48,31,0,13,35
90,Fail,48,32,0,15,33
90,Fail,41,42,0,14,27
90,Fail,45,34,4,17,28
90,Fail,46,35,5,14,32
90,Fail,48,31,8,13,35
90,Fail,48,39,4,9,39
90,Fail,49,31,0,15,34
90,Fail,49,37,2,12,37
90,Fail,52,34,0,13,39
90,Fail,45,42,0,13,32
90,Fail,40,35,8,17,23
90,Fail,39,43,0,10,29
90,Fail,39,42,3,16,23
90,Fail,52,32,1,15,37
90,Fail,53,29,6,12,41
90,Fail,50,36,1,13,37
90,Fail,52,32,0,13,39
90,Fail,51,34,0,15,36
90,Fail,43,39,0,17,26
90,Fail,56,33,1,10,46
90,Fail,49,38,0,11,38
90,Fail,45,33,5,17,28
90,Fail,55,35,0,8,47
90,Fail,46,30,3,21,25
90,Fail,44,30,0,16,28
90,Fail,49,28,0,18,31
90,Fail,47,29,13,11,36
90,Fail,42,28,13,17,25
90,Fail,47,30,0,17,30
90,Fail,47,34,3,16,31
90,Fail,46,36,0,15,31
90,Fail,51,36,0,11,40
90,Fail,50,31,4,15,35
90,Fail,54,34,0,11,43
90,Fail,48,35,1,16,32
90,Fail,48,37,4,11,37
90,Fail,48,35,0,17,31
90,Fail,59,28,0,13,46
90,Fail,45,37,7,11,34
90,Fail,53,35,0,11,42
90,Fail,53,35,2,10,43
90,Fail,48,36,0,11,37
90,Fail,47,34,2,17,30
90,Fail,46,38,0,14,32
90,Fail,43,33,6,18,25
90,Fail,44,42,0,13,31
90,Fail,42,37,8,13,29
90,Fail,56,33,0,9,47
90,Fail,49,36,0,14,35
90,Fail,58,31,0,11,47
90,Fail,49,33,0,13,36
90,Fail,43,36,0,21,22
90,Fail,50,38,0,8,42
90,Fail,44,38,2,16,28
90,Fail,52,32,0,14,38
90,Fail,45,45,2,8,37
90,Fail,46,36,0,14,32
90,Fail,57,34,1,8,49
90,Fail,49,39,0,12,37
90,Fail,52,36,1,11,41
90,Fail,53,26,0,13,40
90,Fail,44,37,9,10,34
90,Fail,48,37,0,12,36
90,Fail,49,32,8,11,38
90,Fail,48,26,0,18,30
90,Fail,48,32,0,16,32
90,Fail,44,36,0,10,34
90,Fail,46,34,3,17,29
90,Fail,46,33,10,11,35
90,Fail,39,32,10,19,20
90,Fail,53,30,0,16,37
90,Fail,55,29,1,15,40
90,Fail,50,42,0,8,42
90,Fail,35,44,6,15,20
90,Fail,58,31,0,10,48
90,Fail,56,32,1,11,45
90,Fail,56,35,0,8,48
90,Fail,51,37,4,8,43
90,Fail,55,34,2,9,46
90,Fail,42,34,7,17,25
90,Fail,53,36,1,10,43
90,Fail,57,31,0,10,47
90,Fail,47,38,4,11,36
90,Fail,53,34,6,7,46
90,Fail,43,37,0,10,33
90,Fail,42,37,0,18,24
90,Fail,48,38,5,9,39
90,Fail,50,32,3,15,35
90,Fail,44,30,13,13,31
90,Fail,45,40,0,9,36
90,Fail,51,36,0,8,43
90,Fail,51,36,3,10,41
90,Fail,46,32,9,13,33
90,Fail,49,41,0,5,44
90,Fail,42,32,14,12,30
90,Fail,50,30,0,19,31
90,Fail,49,39,4,8,41
90,Fail,48,34,0,14,34
90,Fail,43,32,0,21,22
90,Fail,42,37,0,15,27
90,Fail,39,46,0,10,29
90,Fail,55,33,1,11,44
90,Fail,52,36,3,9,43
90,Fail,53,30,0,14,39
90,Fail,48,31,2,19,29
90,Fail,46,43,3,8,38
90,Fail,50,33,1,16,34
90,Fail,51,40,0,8,43
90,Fail,53,29,0,17,36
90,Fail,46,34,7,13,33
90,Fail,46,35,0,17,29
90,Fail,53,35,0,8,45
90,Fail,56,36,1,7,49
90,Fail,46,40,0,13,33
90,Fail,48,36,4,12,36
90,Fail,45,32,0,19,26
90,Fail,45,37,0,15,30
90,Fail,38,36,3,23,15
90,Fail,43,41,5,11,32
90,Fail,42,42,0,12,30
90,Fail,39,39,4,18,21
90,Fail,46,34,9,11,35
90,Fail,47,39,3,11,36
90,Fail,39,42,3,16,23
90,Fail,57,30,3,10,47
90,Fail,47,31,0,18,29
90,Fail,54,36,1,9,45
90,Fail,48,41,2,9,39
90,Fail,45,31,0,15,30
90,Fail,45,33,9,13,32
90,Fail,43,28,0,22,21
90,Fail,45,34,0,13,32
90,Fail,51,36,5,8,43
90,Fail,51,34,0,14,37
90,Fail,52,33,1,14,38
90,Fail,43,42,2,13,30
90,Fail,47,35,7,11,36
90,Fail,48,34,0,16,32
90,Fail,53,34,3,10,43
90,Fail,51,31,6,12,39
90,Fail,45,37,9,9,36
90,Fail,48,39,4,9,39
90,Fail,56,34,0,9,47
90,Fail,41,37,3,19,22
90,Fail,51,34,4,11,40
90,Fail,53,29,0,16,37
90,Fail,57,33,0,8,49
90,Fail,49,30,12,9,40
90,Fail,44,38,0,16,28
90,Fail,46,42,0,10,36
90,Fail,49,29,0,16,33
90,Fail,38,42,6,14,24
90,Fail,54,33,0,10,44
90,Fail,52,35,0,10,42
90,Fail,53,37,0,9,44
90,Fail,46,32,0,12,34
90,Fail,47,40,0,11,36
90,Fail,46,36,3,15,31
90,Fail,48,30,0,15,33
90,Fail,48,34,3,15,33
90,Fail,46,39,5,10,36
90,Fail,55,34,0,10,45
90,Fail,43,38,2,17,26
90,Fail,42,38,6,14,28
90,Fail,47,35,5,13,34
90,Fail,53,34,1,12,41
90,Fail,48,38,0,14,34
90,Fail,48,38,0,14,34
90,Fail,42,37,0,12,30
90,Fail,44,41,0,15,29
90,Fail,63,30,0,7,56
90,Fail,50,32,0,13,37
90,Fail,56,31,0,9,47
90,Fail,42,33,8,17,25
90,Fail,47,36,1,16,31
90,Fail,53,31,0,11,42
90,Fail,45,36,5,14,31
90,Fail,45,42,0,12,33
90,Fail,48,38,5,9,39
90,Fail,52,27,0,13,39
90,Fail,50,31,0,13,37
90,Fail,48,39,7,6,42
90,Fail,46,40,0,11,35
90,Fail,55,29,0,16,39
90,Fail,46,36,0,14,32
90,Fail,41,43,0,11,30
90,Fail,42,37,11,10,32
90,Fail,44,30,9,17,27
90,Fail,46,34,2,18,28
90,Fail,51,32,0,12,39
90,Fail,56,32,1,11,45
90,Fail,46,39,0,8,38
90,Fail,51,35,3,11,40
90,Fail,47,39,1,13,34
90,Fail,56,30,1,13,43
90,Fail,56,36,0,8,48
90,Fail,53,24,0,14,39
90,Fail,46,37,0,17,29
90,Fail,43,44,2,11,32
90,Fail,42,38,0,13,29
90,Fail,48,32,0,15,33
90,Fail,43,44,0,12,31
90,Fail,47,40,0,13,34
90,Fail,49,37,5,9,40
90,Fail,36,42,4,18,18
90,Fail,52,31,3,14,38
90,Fail,42,37,4,17,25
90,Fail,47,33,4,16,31
90,Fail,43,39,0,15,28
90,Fail,47,42,0,9,38
90,Fail,48,44,0,8,40
90,Fail,51,33,2,14,37
90,Fail,49,32,0,19,30
90,Fail,54,38,0,7,47
90,Fail,42,30,11,17,25
90,Fail,45,42,2,11,34
90,Fail,46,41,1,12,34
90,Fail,44,33,0,15,29
90,Fail,55,37,2,6,49
90,Fail,49,36,0,8,41
90,Fail,54,34,0,10,44
90,Fail,45,44,0,11,34
90,Fail,56,36,2,6,50
90,Fail,46,35,0,16,30
90,Fail,54,34,0,11,43
90,Fail,47,36,6,11,36
90,Fail,53,36,2,9,44
90,Fail,52,34,0,8,44
90,Fail,54,30,1,15,39
90,Fail,41,41,2,16,25
90,Fail,49,39,0,12,37
90,Fail,47,32,4,17,30
90,Fail,56,33,0,11,45
90,Fail,40,33,0,18,22
90,Fail,45,41,0,10,35
90,Fail,57,34,0,7,50
90,Fail,45,31,9,15,30
90,Fail,42,41,8,9,33
90,Fail,41,45,3,11,30
90,Fail,42,31,14,13,29
90,Fail,51,34,8,7,44
90,Fail,47,38,0,14,33
90,Fail,55,29,0,12,43
90,Fail,47,39,0,8,39
90,Fail,48,38,0,10,38
90,Fail,47,33,0,5,42
90,Fail,51,30,0,12,39
90,Fail,47,34,2,17,30
90,Fail,58,26,0,11,47
90,Fail,45,37,0,7,38
90,Fail,42,36,0,21,21
90,Fail,40,37,0,15,25
90,Fail,50,39,1,10,40
90,Fail,51,38,2,9,42
90,Fail,52,33,1,14,38
90,Fail,50,40,3,7,43
90,Fail,50,38,1,11,39
90,Fail,43,36,9,12,31
90,Fail,56,30,0,10,46
90,Fail,44,39,0,17,27
90,Fail,51,34,0,15,36
90,Fail,49,38,1,12,37
90,Fail,43,36,3,18,25
90,Fail,50,31,1,18,32
90,Fail,50,38,1,11,39
90,Fail,48,40,0,9,39
90,Fail,46,31,0,20,26
90,Fail,43,42,2,13,30
90,Fail,44,37,0,13,31
90,Fail,48,39,0,12,36
90,Fail,44,35,0,18,26
90,Fail,43,32,11,14,29
90,Fail,38,47,0,11,27
90,Fail,52,33,3,12,40
90,Fail,44,36,4,16,28
90,Fail,46,32,0,17,29
90,Fail,49,35,6,10,39
90,Fail,52,31,2,15,37
90,Fail,53,33,2,12,41
90,Fail,51,34,0,12,39
90,Fail,44,43,2,11,33
90,Fail,41,33,15,11,30
90,Fail,46,41,0,13,33
90,Fail,41,36,0,18,23
90,Fail,56,36,2,6,50
90,Fail,49,32,1,18,31
90,Fail,48,38,0,14,34
90,Fail,45,40,1,14,31
90,Fail,51,36,0,11,40
90,Fail,34,43,4,19,15
90,Fail,50,31,0,13,37
90,Fail,52,33,0,13,39
90,Fail,41,39,11,9,32
90,Fail,53,34,0,13,40
90,Fail,40,46,0,9,31
90,Fail,52,37,0,9,43
90,Fail,52,30,0,12,40
90,Fail,52,34,2,12,40
90,Fail,49,37,2,12,37
90,Fail,51,30,0,14,37
90,Fail,53,30,0,11,42
90,Fail,53,32,4,11,42
90,Fail,51,36,2,11,40
90,Fail,50,33,2,15,35
90,Fail,48,37,3,12,36
90,Fail,42,41,6,11,31
90,Fail,46,42,2,10,36
90,Fail,43,31,0,12,31
90,Fail,40,41,0,14,26
90,Fail,57,35,1,7,50
90,Fail,55,33,2,10,45
90,Fail,42,36,7,15,27
90,Fail,56,24,5,15,41
90,Fail,47,34,5,14,33
90,Fail,47,33,4,16,31
90,Fail,43,33,4,20,23
90,Fail,54,35,1,10,44
90,Fail,41,41,4,14,27
90,Fail,44,39,0,15,29
90,Fail,55,34,4,7,48
90,Fail,49,37,0,8,41
90,Fail,47,36,0,10,37
90,Fail,43,43,0,12,31
90,Fail,46,31,9,14,32
90,Fail,42,37,4,17,25
90,Fail,46,43,1,10,36
90,Fail,54,34,0,8,46
90,Fail,36,44,0,12,24
90,Fail,50,33,3,14,36
90,Fail,57,31,0,10,47
90,Fail,46,36,3,15,31
90,Fail,49,41,0,7,42
90,Fail,48,37,4,11,37
90,Fail,48,41,0,6,42
90,Fail,48,38,0,14,34
90,Fail,46,39,0,10,36
90,Fail,47,38,4,11,36
90,Fail,44,40,1,15,29
90,Fail,45,35,0,18,27
90,Fail,46,39,0,11,35
90,Fail,50,29,0,20,30
90,Fail,52,34,0,9,43
90,Fail,47,39,0,12,35
90,Fail,42,36,4,18,24
90,Fail,47,35,3,15,32
90,Fail,49,30,0,15,34
90,Fail,47,36,5,12,35
90,Fail,50,33,0,12,38
90,Fail,41,45,0,9,32
90,Fail,42,39,0,17,25
90,Fail,43,40,0,12,31
90,Fail,52,34,3,11,41
90,Fail,46,36,0,16,30
90,Fail,39,45,5,11,28
90,Fail,49,29,12,10,39
90,Fail,49,35,0,14,35
90,Fail,43,40,0,11,32
90,Fail,49,37,0,8,41
90,Fail,49,31,0,19,30
90,Fail,56,33,0,10,46
90,Fail,48,38,2,12,36
90,Fail,45,40,0,15,30
90,Fail,51,33,0,16,35
90,Fail,52,41,1,6,46
90,Fail,50,28,0,15,35
90,Fail,48,36,9,7,41
90,Fail,44,33,10,13,31
90,Fail,53,36,0,10,43
90,Fail,45,40,0,12,33
90,Fail,54,28,3,15,39
90,Fail,47,33,5,15,32
90,Fail,52,37,0,10,42
90,Fail,48,42,0,8,40
90,Fail,50,26,9,15,35
90,Fail,59,26,0,13,46
90,Fail,45,37,6,12,33
90,Fail,53,36,2,9,44
90,Fail,43,45,0,12,31
90,Fail,52,31,3,14,38
90,Fail,46,40,0,13,33
90,Fail,41,41,0,11,30
90,Fail,52,33,6,9,43
90,Fail,42,35,0,18,24
90,Fail,37,36,6,21,16
90,Fail,50,39,0,11,39
90,Fail,48,38,2,12,36
90,Fail,44,28,9,19,25
90,Fail,51,31,4,14,37
90,Fail,45,41,1,13,32
90,Fail,47,36,0,15,32
90,Fail,44,38,0,13,31
90,Fail,44,38,0,12,32
90,Fail,56,30,5,9,47
90,Fail,45,41,0,12,33
90,Fail,46,39,0,13,33
90,Fail,52,39,1,8,44
90,Fail,54,35,2,9,45
90,Fail,47,31,0,15,32
90,Fail,53,25,3,19,34
90,Fail,43,39,1,17,26
90,Fail,48,35,0,12,36
90,Fail,48,32,0,12,36
90,Fail,42,43,1,14,28
90,Fail,47,32,0,14,33
90,Fail,47,38,6,9,38
90,Fail,50,42,1,7,43
90,Fail,44,34,0,14,30
90,Fail,41,42,0,15,26
90,Fail,54,35,6,5,49
90,Fail,51,38,0,9,42
90,Fail,54,30,2,14,40
90,Fail,39,34,0,17,22
90,Fail,48,38,1,13,35
90,Fail,49,33,0,13,36
90,Fail,45,38,9,8,37
90,Fail,53,29,5,13,40
90,Fail,40,37,5,18,22
90,Fail,45,34,0,15,30
90,Fail,54,32,6,8,46
90,Fail,51,29,5,15,36
90,Fail,53,32,0,9,44
90,Fail,47,34,0,13,34
90,Fail,51,32,0,14,37
90,Fail,54,28,10,8,46
90,Fail,50,30,0,10,40
90,Fail,41,35,10,14,27
90,Fail,55,26,0,16,39
90,Fail,40,30,0,20,20
90,Fail,45,40,0,14,31
90,Fail,41,38,0,12,29
90,Fail,47,41,0,9,38
90,Fail,44,40,3,13,31
90,Fail,53,35,2,10,43
90,Fail,49,38,0,12,37
90,Fail,51,34,1,14,37
90,Fail,53,35,0,12,41
90,Fail,48,44,1,7,41
90,Fail,38,45,0,13,25
90,Fail,51,33,9,7,44
90,Fail,43,35,5,17,26
90,Fail,56,30,0,9,47
90,Fail,43,37,0,14,29
90,Fail,45,36,0,13,32
90,Fail,49,35,4,12,37
90,Fail,53,37,3,7,46
90,Fail,54,31,0,13,41
90,Fail,48,33,4,15,33
90,Fail,48,34,0,12,36
90,Fail,50,30,6,14,36
90,Fail,49,33,0,10,39
90,Fail,43,38,1,18,25
90,Fail,45,42,0,8,37
90,Fail,51,35,6,8,43
90,Fail,52,35,0,12,40
90,Fail,46,40,0,13,33
90,Fail,48,44,0,6,42
90,Fail,51,27,0,16,35
90,Fail,45,40,6,9,36
90,Fail,46,34,6,14,32
90,Fail,56,33,0,10,46
90,Fail,41,41,0,13,28
90,Fail,47,36,7,10,37
90,Fail,55,32,4,9,46
90,Fail,42,42,0,14,28
90,Fail,47,40,2,11,36
90,Fail,57,29,7,7,50
90,Fail,48,34,3,15,33
90,Fail,50,34,0,13,37
90,Fail,38,42,5,15,23
90,Fail,46,35,0,12,34
90,Fail,39,43,0,13,26
90,Fail,44,42,0,14,30
90,Fail,48,28,0,13,35
90,Fail,51,37,0,12,39
90,Fail,34,34,11,21,13
90,Fail,42,39,7,12,30
90,Fail,48,35,0,13,35
90,Fail,46,36,5,13,33
90,Fail,46,38,6,10,36
90,Fail,52,33,0,14,38
90,Fail,44,38,3,15,29
90,Fail,45,36,0,17,28
90,Fail,52,33,4,11,41
90,Fail,47,38,0,15,32
90,Fail,49,31,0,13,36
90,Fail,52,34,2,12,40
90,Fail,49,30,8,13,36
90,Fail,57,29,0,13,44
90,Fail,53,29,0,14,39
90,Fail,43,43,0,13,30
90,Fail,51,30,0,15,36
90,Fail,49,31,0,14,35
90,Fail,51,30,0,13,38
90,Fail,46,44,0,8,38
90,Fail,45,35,0,15,30
90,Fail,43,42,0,9,34
90,Fail,43,38,8,11,32
90,Fail,49,36,0,10,39
90,Fail,49,33,8,10,39
90,Fail,48,28,7,17,31
90,Fail,50,33,0,13,37
90,Fail,44,45,0,9,35
90,Fail,46,41,0,10,36
90,Fail,45,30,0,18,27
90,Fail,49,35,3,13,36
90,Fail,47,39,1,13,34
90,Fail,55,33,1,11,44
90,Fail,52,28,0,13,39
90,Fail,45,35,7,13,32
90,Fail,43,27,0,13,30
90,Fail,42,36,0,17,25
90,Fail,49,36,0,12,37
90,Fail,47,39,0,10,37
90,Fail,44,41,0,12,32
90,Fail,42,40,0,10,32
90,Fail,47,38,0,12,35
90,Fail,39,34,6,21,18
90,Fail,49,32,0,18,31
90,Fail,49,37,0,13,36
90,Fail,40,43,5,12,28
90,Fail,45,40,0,14,31
90,Fail,47,41,2,10,37
90,Fail,44,39,2,15,29
90,Fail,45,37,8,10,35
90,Fail,42,42,0,15,27
90,Fail,45,33,8,14,31
90,Fail,46,37,0,17,29
90,Fail,50,36,2,12,38
90,Fail,50,31,0,17,33
90,Fail,48,28,7,17,31
90,Fail,50,39,0,11,39
90,Fail,47,34,0,15,32
90,Fail,48,32,0,16,32
90,Fail,54,34,0,12,42
90,Fail,52,39,0,9,43
90,Fail,45,37,3,15,30
90,Fail,48,34,0,17,31
90,Fail,49,34,0,17,32
90,Fail,42,45,0,10,32
90,Fail,48,39,0,12,36
90,Fail,47,39,0,14,33
90,Fail,36,48,4,12,24
90,Fail,55,30,0,12,43
90,Fail,44,33,0,15,29
90,Fail,48,35,0,10,38
90,Fail,44,38,0,15,29
90,Fail,53,40,1,6,47
90,Fail,44,39,0,15,29
90,Fail,51,29,0,10,41
90,Fail,49,40,0,10,39
90,Fail,48,35,3,14,34
90,Fail,47,42,5,6,41
90,Fail,51,37,3,9,42
90,Fail,45,41,1,13,32
90,Fail,54,32,1,13,41
90,Fail,48,36,4,12,36
90,Fail,52,30,3,15,37
90,Fail,54,29,0,13,41
90,Fail,49,36,0,10,39
90,Fail,47,30,0,19,28
90,Fail,43,48,2,7,36
90,Fail,51,26,0,9,42
90,Fail,50,31,4,15,35
90,Fail,51,35,0,12,39
90,Fail,45,24,0,17,28
90,Fail,43,38,0,17,26
90,Fail,49,43,0,7,42
90,Fail,47,40,0,10,37
90,Fail,46,34,4,16,30
90,Fail,58,33,1,8,50
90,Fail,51,36,3,10,41
90,Fail,41,40,3,16,25
90,Fail,56,30,0,11,45
90,Fail,47,31,7,15,32
90,Fail,53,33,3,11,42
90,Fail,49,38,0,9,40
90,Fail,53,30,3,14,39
90,Fail,41,36,13,10,31
90,Fail,41,34,0,14,27
90,Fail,50,34,3,13,37
90,Fail,49,36,0,14,35
90,Fail,44,35,4,17,27
90,Fail,53,23,0,16,37
90,Fail,49,38,1,12,37
90,Fail,44,37,3,16,28
90,Fail,53,34,0,10,43
90,Fail,48,34,0,11,37
90,Fail,45,43,0,11,34
90,Fail,50,33,0,15,35
90,Fail,58,32,0,9,49
90,Fail,47,39,0,12,35
90,Fail,40,44,5,11,29
90,Fail,43,39,7,11,32
90,Fail,55,32,3,10,45
90,Fail,46,38,4,12,34
90,Fail,45,37,4,14,31
90,Fail,40,35,0,17,23
90,Fail,37,40,8,15,22
90,Fail,50,36,0,10,40
90,Fail,45,34,0,10,35
90,Fail,49,35,1,15,34
90,Fail,49,38,0,13,36
90,Fail,48,34,0,13,35
90,Fail,45,39,7,9,36
90,Fail,44,43,3,10,34
90,Fail,44,33,0,19,25
90,Fail,39,41,6,14,25
90,Fail,57,33,0,10,47
90,Fail,39,42,0,13,26
90,Fail,52,28,0,16,36
90,Fail,34,40,13,13,21
90,Fail,50,37,3,10,40
90,Fail,56,33,2,9,47
90,Fail,44,42,0,10,34
90,Fail,52,29,0,17,35
90,Fail,49,37,0,11,38
90,Fail,53,30,0,16,37
90,Fail,47,32,0,15,32
90,Fail,52,33,1,14,38
90,Fail,55,32,1,12,43
90,Fail,44,35,0,15,29
90,Fail,45,37,1,17,28
90,Fail,33,44,3,20,13
90,Fail,49,35,0,11,38
90,Fail,44,40,0,12,32
90,Fail,51,38,0,10,41
90,Fail,48,40,1,11,37
90,Fail,43,31,0,21,22
90,Fail,43,37,7,13,30
90,Fail,49,35,3,13,36
90,Fail,53,37,0,9,44
90,Fail,58,28,1,13,45
90,Fail,53,35,1,11,42
90,Fail,49,25,10,16,33
90,Fail,49,34,0,12,37
90,Fail,39,41,0,13,26
90,Fail,52,33,5,10,42
90,Fail,59,30,0,11,48
90,Fail,46,36,6,12,34
90,Fail,42,45,2,11,31
90,Fail,49,29,4,18,31
90,Fail,34,31,18,17,17
90,Fail,50,35,4,11,39
90,Fail,40,41,1,18,22
90,Fail,52,27,0,11,41
90,Fail,49,42,0,7,42
90,Fail,55,36,0,8,47
90,Fail,48,38,0,13,35
90,Fail,56,39,0,5,51
90,Fail,50,32,0,12,38
90,Fail,50,37,0,10,40
90,Fail,59,32,2,7,52
90,Fail,55,33,0,10,45
90,Fail,56,34,0,8,48
90,Fail,47,26,0,12,35
90,Fail,46,39,0,14,32
90,Fail,44,33,0,12,32
90,Fail,52,33,0,10,42
90,Fail,45,37,0,14,31
90,Fail,52,37,0,11,41
90,Fail,48,40,0,6,42
90,Fail,43,36,0,11,32
90,Fail,43,43,0,14,29
90,Fail,45,37,0,15,30
90,Fail,44,30,0,14,30
90,Fail,56,32,2,10,46
90,Fail,53,33,4,10,43
90,Fail,43,36,0,10,33
90,Fail,48,37,3,12,36
90,Fail,45,43,0,10,35
90,Fail,44,42,0,13,31
90,Fail,41,41,11,7,34
90,Fail,52,36,4,8,44
90,Fail,44,25,0,17,27
90,Fail,50,40,0,6,44
90,Fail,37,37,0,10,27
90,Fail,52,33,0,13,39
90,Fail,46,33,0,21,25
90,Fail,48,29,2,21,27
90,Fail,47,31,0,12,35
90,Fail,57,29,2,12,45
90,Fail,46,42,0,8,38
90,Fail,45,32,0,16,29
90,Fail,47,36,0,14,33
90,Fail,42,38,0,13,29
90,Fail,44,44,2,10,34
90,Fail,49,31,0,17,32
90,Fail,54,31,0,13,41
90,Fail,52,29,2,17,35
90,Fail,56,34,1,9,47
90,Fail,44,32,8,16,28
90,Fail,46,42,0,12,34
90,Fail,43,36,7,14,29
90,Fail,47,36,0,17,30
90,Fail,47,31,0,19,28
90,Fail,41,46,0,11,30
90,Fail,48,31,0,14,34
90,Fail,55,34,0,8,47
90,Fail,43,46,4,7,36
90,Fail,44,39,0,10,34
90,Fail,45,40,2,13,32
90,Fail,48,40,0,12,36
90,Fail,52,36,5,7,45
90,Fail,46,43,0,8,38
90,Fail,46,33,7,14,32
90,Fail,45,34,5,16,29
90,Fail,51,39,0,9,42
90,Fail,55,28,2,15,40
90,Fail,43,35,3,19,24
90,Fail,41,38,0,17,24
90,Fail,55,30,2,13,42
90,Fail,50,32,0,14,36
90,Fail,44,34,0,12,32
90,Fail,56,31,0,13,43
90,Fail,47,37,0,14,33
90,Fail,46,33,0,17,29
90,Fail,49,35,0,13,36
90,Fail,52,35,1,12,40
90,Fail,48,40,6,6,42
90,Fail,48,29,5,18,30
90,Fail,48,33,0,14,34
90,Fail,49,31,0,12,37
90,Fail,43,44,2,11,32
90,Fail,51,28,0,19,32
90,Fail,57,30,0,12,45
90,Fail,45,39,0,12,33
90,Fail,49,34,2,15,34
90,Fail,49,34,0,11,38
90,Fail,46,36,0,18,28
90,Fail,49,35,0,14,35
90,Fail,50,36,0,13,37
90,Fail,55,35,0,8,47
90,Fail,45,33,5,17,28
90,Fail,51,32,2,15,36
90,Fail,43,39,13,5,38
90,Fail,45,31,9,15,30
90,Fail,57,33,1,9,48
90,Fail,47,43,0,9,38
90,Fail,48,37,5,10,38
90,Fail,44,37,7,12,32
90,Fail,46,40,1,13,33
90,Fail,42,40,4,14,28
90,Fail,56,29,1,14,42
90,Fail,45,36,0,11,34
90,Fail,44,35,0,20,24
90,Fail,51,33,0,14,37
90,Fail,45,38,2,15,30
90,Fail,50,40,0,7,43
90,Fail,41,42,0,17,24
90,Fail,56,30,2,12,44
90,Fail,49,35,0,13,36
90,Fail,50,36,0,12,38
90,Fail,44,41,0,12,32
90,Fail,51,27,0,14,37
90,Fail,41,38,0,16,25
90,Fail,52,33,0,9,43
90,Fail,47,40,1,12,35
90,Fail,50,38,0,11,39
90,Fail,49,32,0,15,34
90,Fail,37,39,8,16,21
90,Fail,45,33,5,17,28
90,Fail,48,38,0,13,35
90,Fail,49,40,0,11,38
90,Fail,51,40,0,8,43
90,Fail,41,39,7,13,28
90,Fail,48,33,0,15,33
90,Fail,57,34,2,7,50
90,Fail,39,44,7,10,29
90,Fail,45,40,0,8,37
90,Fail,51,36,0,12,39
90,Fail,44,32,10,14,30
90,Fail,47,37,0,13,34
90,Fail,47,37,0,14,33
90,Fail,43,44,0,11,32
90,Fail,44,29,11,16,28
90,Fail,46,37,6,11,35
90,Fail,47,40,3,10,37
90,Fail,43,39,0,18,25
90,Fail,49,39,0,10,39
90,Fail,48,41,0,10,38
90,Fail,51,36,0,13,38
90,Fail,44,36,4,16,28
90,Fail,47,35,0,17,30
90,Fail,51,38,3,8,43
90,Fail,51,37,0,9,42
90,Fail,48,35,4,13,35
90,Fail,51,30,0,14,37
90,Fail,59,31,1,9,50
90,Fail,46,42,4,8,38
90,Fail,44,37,0,14,30
90,Fail,45,37,5,13,32
90,Fail,48,35,0,17,31
90,Fail,51,27,3,19,32
90,Fail,42,38,8,12,30
90,Fail,46,40,0,9,37
90,Fail,48,38,0,13,35
90,Fail,49,36,4,11,38
90,Fail,48,36,0,15,33
90,Fail,41,39,7,13,28
90,Fail,48,27,15,10,38
90,Fail,53,36,0,8,45
90,Fail,46,38,0,11,35
90,Fail,53,31,1,15,38
90,Fail,43,38,0,18,25
90,Fail,49,33,4,14,35
90,Fail,50,36,0,12,38
90,Fail,53,33,0,8,45
90,Fail,55,28,1,16,39
90,Fail,50,33,0,14,36
90,Fail,48,30,12,10,38
90,Fail,47,39,3,11,36
90,Fail,46,34,0,11,35
90,Fail,45,36,0,11,34
90,Fail,48,37,3,12,36
90,Fail,48,35,1,16,32
90,Fail,49,31,5,15,34
90,Fail,49,42,0,7,42
90,Fail,43,37,7,13,30
90,Fail,54,31,3,12,42
90,Fail,45,38,0,10,35
90,Fail,53,35,0,12,41
90,Fail,43,42,3,12,31
90,Fail,53,35,0,12,41
90,Fail,43,37,0,18,25
90,Fail,51,35,3,11,40
90,Fail,44,37,0,15,29
90,Fail,52,33,2,13,39
90,Fail,49,38,0,11,38
90,Fail,53,26,0,11,42
90,Fail,45,41,0,11,34
90,Fail,51,35,6,8,43
90,Fail,46,38,2,14,32
90,Fail,49,32,0,13,36
90,Fail,46,38,4,12,34
90,Fail,45,42,0,10,35
90,Fail,44,41,0,11,33
90,Fail,48,34,7,11,37
90,Fail,46,35,0,15,31
90,Fail,55,32,4,9,46
90,Fail,49,35,4,12,37
90,Fail,50,33,0,14,36
90,Fail,56,28,0,10,46
90,Fail,44,33,10,13,31
90,Fail,52,33,0,14,38
90,Fail,49,36,0,10,39
90,Fail,58,32,0,8,50
90,Fail,52,34,6,8,44
90,Fail,47,37,4,12,35
90,Fail,45,40,4,11,34
90,Fail,53,31,3,13,40
90,Fail,53,31,4,12,41
90,Fail,50,31,5,14,36
90,Fail,52,30,0,12,40
90,Fail,58,25,4,13,45
90,Fail,45,43,0,9,36
90,Fail,44,37,0,16,28
90,Fail,38,37,4,21,17
90,Fail,51,36,1,12,39
90,Fail,50,34,4,12,38
90,Fail,49,34,3,14,35
90,Fail,48,33,5,14,34
90,Fail,53,35,0,11,42
90,Fail,39,33,9,19,20
90,Fail,52,32,3,13,39
90,Fail,53,32,3,12,41
90,Fail,49,39,0,10,39
90,Fail,51,31,0,16,35
90,Fail,40,47,2,11,29
90,Fail,60,33,1,6,54
90,Fail,39,33,8,20,19
90,Fail,42,40,0,14,28
90,Fail,44,34,6,16,28
90,Fail,46,40,4,10,36
90,Fail,48,35,3,14,34
90,Fail,42,44,2,12,30
90,Fail,53,31,0,11,42
90,Fail,48,38,0,10,38
90,Fail,49,36,2,13,36
90,Fail,48,34,2,16,32
90,Fail,42,39,6,13,29
90,Fail,47,38,0,10,37
90,Fail,50,30,0,13,37
90,Fail,44,32,0,18,26
90,Fail,46,34,0,13,33
90,Fail,43,44,0,13,30
90,Fail,50,39,3,8,42
90,Fail,43,27,12,18,25
90,Fail,46,30,11,13,33
90,Fail,48,37,2,13,35
90,Fail,45,39,2,14,31
90,Fail,56,28,0,13,43
90,Fail,54,34,1,11,43
90,Fail,52,34,1,13,39
90,Fail,49,36,0,12,37
90,Fail,43,38,4,15,28
90,Fail,47,36,0,16,31
90,Fail,54,29,4,13,41
90,Fail,46,37,2,15,31
90,Fail,46,29,7,18,28
90,Fail,41,46,2,11,30
90,Fail,40,40,3,17,23
90,Fail,48,40,0,10,38
90,Fail,49,38,0,13,36
90,Fail,52,31,0,17,35
90,Fail,45,44,0,7,38
90,Fail,48,37,0,11,37
90,Fail,49,32,0,16,33
90,Fail,51,35,5,9,42
90,Fail,43,36,7,14,29
90,Fail,51,36,4,9,42
90,Fail,50,35,0,14,36
90,Fail,40,46,0,6,34
90,Fail,56,33,0,8,48
90,Fail,42,37,0,16,26
90,Fail,47,40,0,12,35
90,Fail,47,35,7,11,36
90,Fail,49,36,0,13,36
90,Fail,52,29,5,14,38
90,Fail,41,38,7,14,27
90,Fail,52,29,0,17,35
90,Fail,46,41,3,10,36
90,Fail,54,35,0,10,44
90,Fail,46,34,7,13,33
90,Fail,47,43,3,7,40
90,Fail,45,38,0,16,29
90,Fail,51,31,0,11,40
90,Fail,53,32,0,13,40
90,Fail,49,34,6,11,38
90,Fail,48,38,3,11,37
90,Fail,50,35,2,13,37
90,Fail,47,42,0,11,36
90,Fail,45,31,10,14,31
90,Fail,41,37,0,17,24
90,Fail,53,33,0,10,43
90,Fail,48,37,0,10,38
90,Fail,53,38,0,9,44
90,Fail,45,38,2,15,30
90,Fail,47,36,4,13,34
90,Fail,48,33,2,17,31
90,Fail,49,37,3,11,38
90,Fail,39,43,3,15,24
90,Fail,52,33,3,12,40
90,Fail,46,34,0,8,38
90,Fail,49,34,0,13,36
90,Fail,56,34,0,7,49
90,Fail,43,36,0,16,27
90,Fail,44,47,0,6,38
90,Fail,39,36,0,21,18
90,Fail,41,44,2,13,28
90,Fail,44,42,0,14,30
90,Fail,44,46,0,10,34
90,Fail,48,31,0,21,27
90,Fail,49,39,0,11,38
90,Fail,40,38,1,21,19
90,Fail,53,32,0,7,46
90,Fail,45,38,0,16,29
90,Fail,55,36,0,6,49
90,Fail,39,35,3,23,16
90,Fail,36,34,0,19,17
90,Fail,44,40,0,14,30
90,Fail,44,37,0,9,35
90,Fail,56,29,0,15,41
90,Fail,51,33,0,15,36
90,Fail,51,36,2,11,40
90,Fail,45,38,1,16,29
90,Fail,44,39,3,14,30
90,Fail,47,36,3,14,33
90,Fail,52,31,3,14,38
90,Fail,50,31,0,18,32
90,Fail,54,25,0,16,38
90,Fail,46,40,1,13,33
90,Fail,46,34,0,20,26
90,Fail,41,36,0,17,24
90,Fail,42,40,0,14,28
90,Fail,53,38,0,8,45
90,Fail,45,38,0,12,33
90,Fail,42,39,0,14,28
90,Fail,56,26,0,9,47
90,Fail,44,38,0,15,29
90,Fail,59,31,0,9,50
90,Fail,48,33,0,15,33
90,Fail,39,36,0,18,21
90,Fail,51,38,0,10,41
90,Fail,53,32,6,9,44
90,Fail,46,45,1,8,38
90,Fail,39,37,0,15,24
90,Fail,49,38,0,10,39
90,Fail,53,34,0,10,43
90,Fail,42,35,0,11,31
90,Fail,51,37,3,9,42
90,Fail,56,30,0,12,44
90,Fail,45,34,0,14,31
90,Fail,52,38,1,9,43
90,Fail,52,33,5,10,42
90,Fail,49,37,2,12,37
90,Fail,46,36,4,14,32
90,Fail,52,39,0,9,43
90,Fail,46,34,0,13,33
90,Fail,37,44,6,13,24
90,Fail,42,31,10,17,25
90,Fail,55,35,3,7,48
90,Fail,53,36,0,9,44
90,Fail,44,42,3,11,33
90,Fail,52,28,5,15,37
90,Fail,52,34,1,13,39
90,Fail,49,38,4,9,40
90,Fail,51,37,0,11,40
90,Fail,52,36,3,9,43
90,Fail,45,39,0,10,35
90,Fail,51,29,5,15,36
90,Fail,46,43,0,11,35
90,Fail,41,37,0,16,25
90,Fail,51,33,0,13,38
90,Fail,50,27,0,17,33
90,Fail,44,38,0,10,34
90,Fail,46,37,7,10,36
90,Fail,54,32,2,12,42
90,Fail,43,36,0,18,25
90,Fail,41,35,0,16,25
90,Fail,44,36,7,13,31
90,Fail,47,32,0,14,33
90,Fail,44,38,4,14,30
90,Fail,52,32,0,14,38
90,Fail,52,28,6,14,38
90,Fail,44,35,9,12,32
90,Fail,54,38,0,7,47
90,Fail,49,38,0,10,39
90,Fail,47,35,0,17,30
90,Fail,54,37,0,9,45
90,Fail,38,44,0,11,27
90,Fail,54,32,2,12,42
90,Fail,52,29,0,15,37
90,Fail,50,38,0,11,39
90,Fail,53,32,0,7,46
90,Fail,48,35,0,16,32
90,Fail,47,41,1,11,36
90,Fail,41,32,7,20,21
90,Fail,42,27,15,16,26
90,Fail,53,31,0,14,39
90,Fail,47,38,0,12,35
90,Fail,56,28,5,11,45
90,Fail,48,45,0,6,42
90,Fail,44,29,0,23,21
90,Fail,50,32,6,12,38
90,Fail,49,32,0,8,41
90,Fail,45,41,4,10,35
90,Fail,46,38,2,14,32
90,Fail,46,32,8,14,32
90,Fail,50,41,1,8,42
90,Fail,43,41,0,11,32
90,Fail,48,37,0,13,35
90,Fail,48,34,6,12,36
90,Fail,55,35,0,7,48
90,Fail,54,29,0,16,38
90,Fail,60,32,1,7,53
90,Fail,50,40,0,9,41
90,Fail,49,30,7,14,35
90,Fail,52,34,2,12,40
90,Fail,46,41,0,11,35
90,Fail,51,36,1,12,39
90,Fail,46,40,1,13,33
90,Fail,49,31,7,13,36
90,Fail,50,41,1,8,42
90,Fail,45,37,1,17,28
90,Fail,53,39,0,7,46
90,Fail,52,35,0,13,39
90,Fail,50,27,3,20,30
90,Fail,42,39,0,17,25
90,Fail,49,37,0,13,36
90,Fail,50,38,0,11,39
90,Fail,46,41,0,13,33
90,Fail,41,44,0,12,29
90,Fail,53,34,0,12,41
90,Fail,57,34,3,6,51
90,Fail,57,27,3,13,44
90,Fail,45,44,0,11,34
90,Fail,48,36,2,14,34
90,Fail,59,30,2,9,50
90,Fail,54,31,1,14,40
90,Fail,50,35,0,8,42
90,Fail,42,38,11,9,33
90,Fail,50,34,0,9,41
90,Fail,42,40,0,13,29
90,Fail,46,42,0,8,38
90,Fail,36,42,6,16,20
90,Fail,51,28,0,9,42
90,Fail,55,34,0,10,45
90,Fail,57,33,2,8,49
90,Fail,51,30,2,17,34
90,Fail,50,42,0,4,46
90,Fail,43,34,12,11,32
90,Fail,46,37,0,13,33
90,Fail,49,36,2,13,36
90,Fail,42,33,0,20,22
90,Fail,52,28,0,16,36
90,Fail,50,36,2,12,38
90,Fail,51,34,0,11,40
90,Fail,39,42,1,18,21
90,Fail,42,38,3,17,25
90,Fail,47,36,0,15,32
90,Fail,44,37,4,15,29
90,Fail,51,37,0,10,41
90,Fail,52,33,3,12,40
90,Fail,48,33,5,14,34
90,Fail,45,38,0,15,30
90,Fail,51,33,3,13,38
90,Fail,48,38,0,10,38
90,Fail,51,38,2,9,42
90,Fail,55,31,0,10,45
90,Fail,42,41,4,13,29
90,Fail,55,32,0,12,43
90,Fail,51,32,0,12,39
90,Fail,46,44,0,10,36
90,Fail,44,37,1,18,26
90,Fail,53,27,4,16,37
90,Fail,59,33,1,7,52
90,Fail,44,39,8,9,35
90,Fail,45,33,7,15,30
90,Fail,44,40,2,14,30
90,Fail,43,39,5,13,30
90,Fail,39,33,0,14,25
90,Fail,45,38,2,15,30
90,Fail,51,30,0,18,33
90,Fail,46,33,0,15,31
90,Fail,61,31,1,7,54
90,Fail,47,33,7,13,34
90,Fail,41,40,7,12,29
90,Fail,51,36,0,12,39
90,Fail,46,25,0,22,24
90,Fail,41,40,0,15,26
90,Fail,52,42,0,6,46
90,Fail,50,35,0,11,39
90,Fail,49,35,0,15,34
90,Fail,48,37,0,11,37
90,Fail,47,30,11,12,35
90,Fail,48,41,2,9,39
90,Fail,52,32,1,15,37
90,Fail,44,38,0,15,29
90,Fail,51,36,0,12,39
90,Fail,48,25,7,20,28
90,Fail,44,39,5,12,32
90,Fail,47,39,0,10,37
90,Fail,52,38,2,8,44
90,Fail,51,34,0,15,36
90,Fail,50,34,0,12,38
90,Fail,52,32,3,13,39
90,Fail,57,26,0,12,45
90,Fail,39,44,6,11,28
90,Fail,46,29,0,16,30
90,Fail,45,37,0,13,32
90,Fail,52,37,0,10,42
90,Fail,50,34,7,9,41
90,Fail,46,34,0,14,32
90,Fail,48,39,0,13,35
90,Fail,36,32,13,19,17
90,Fail,56,32,0,12,44
90,Fail,47,35,0,17,30
90,Fail,46,27,0,15,31
90,Fail,56,29,0,6,50
90,Fail,41,35,7,17,24
90,Fail,53,41,0,5,48
90,Fail,49,32,0,16,33
90,Fail,52,40,0,8,44
90,Fail,36,34,12,18,18
90,Fail,46,37,0,15,31
90,Fail,46,37,0,12,34
90,Fail,43,37,10,10,33
90,Fail,45,36,0,17,28
90,Fail,45,30,0,19,26
90,Fail,51,37,1,11,40
90,Fail,51,37,1,11,40
90,Fail,47,27,6,20,27
90,Fail,48,32,0,10,38
90,Fail,44,32,8,16,28
90,Fail,41,42,0,8,33
90,Fail,45,36,11,8,37
90,Fail,40,43,0,16,24
90,Fail,51,32,5,12,39
90,Fail,41,37,9,13,28
90,Fail,55,37,0,5,50
90,Fail,56,33,2,9,47
90,Fail,50,35,0,11,39
90,Fail,48,35,7,10,38
90,Fail,50,33,5,12,38
90,Fail,45,37,0,12,33
90,Fail,50,34,0,14,36
90,Fail,45,36,4,15,30
90,Fail,49,33,0,17,32
90,Fail,47,33,8,12,35
90,Fail,50,28,0,9,41
90,Fail,50,36,2,12,38
90,Fail,51,36,0,12,39
90,Fail,42,46,0,12,30
90,Fail,49,38,0,8,41
90,Fail,49,37,0,13,36
90,Fail,49,36,2,13,36
90,Fail,47,37,0,12,35
90,Fail,52,32,0,13,39
90,Fail,53,38,0,9,44
90,Fail,45,41,1,13,32
90,Fail,46,41,1,12,34
90,Fail,60,31,0,9,51
90,Fail,52,29,6,13,39
90,Fail,50,43,0,6,44
90,Fail,57,32,0,11,46
90,Fail,40,35,3,22,18
90,Fail,43,32,0,14,29
90,Fail,47,34,0,13,34
90,Fail,58,34,0,8,50
90,Fail,45,37,5,13,32
90,Fail,53,36,4,7,46
90,Fail,37,42,0,12,25
90,Fail,54,31,1,14,40
90,Fail,35,43,12,10,25
90,Fail,42,39,0,18,24
90,Fail,47,42,2,9,38
90,Fail,52,37,0,8,44
90,Fail,40,45,0,13,27
90,Fail,46,40,0,14,32
90,Fail,51,33,1,15,36
90,Fail,49,34,0,16,33
90,Fail,49,31,5,15,34
90,Fail,49,34,0,15,34
90,Fail,43,34,0,13,30
90,Fail,50,33,0,11,39
90,Fail,46,37,6,11,35
90,Fail,50,38,0,11,39
90,Fail,41,39,0,14,27
90,Fail,45,39,2,14,31
90,Fail,46,37,10,7,39
90,Fail,47,36,7,10,37
90,Fail,50,33,0,11,39
90,Fail,47,33,5,15,32
90,Fail,45,41,0,13,32
90,Fail,45,25,4,26,19
90,Fail,54,32,0,14,40
90,Fail,48,36,0,16,32
90,Fail,47,32,8,13,34
90,Fail,42,44,0,10,32
90,Fail,43,34,0,18,25
90,Fail,56,34,0,6,50
90,Fail,59,30,0,9,50
90,Fail,43,34,4,19,24
90,Fail,48,42,2,8,40
90,Fail,49,37,4,10,39
90,Fail,45,36,0,17,28
90,Fail,48,37,2,13,35
90,Fail,48,41,1,10,38
90,Fail,44,45,0,11,33
90,Fail,50,32,0,15,35
90,Fail,47,36,0,14,33
90,Fail,48,37,0,13,35
90,Fail,46,38,1,15,31
90,Fail,40,39,0,13,27
90,Fail,54,38,0,8,46
90,Fail,49,37,1,13,36
90,Fail,45,31,7,17,28
90,Fail,45,35,0,20,25
90,Fail,50,35,1,14,36
90,Fail,51,27,9,13,38
90,Fail,50,34,2,14,36
90,Fail,53,34,4,9,44
90,Fail,53,35,0,11,42
90,Fail,45,41,4,10,35
90,Fail,48,38,4,10,38
90,Fail,49,37,0,14,35
90,Fail,47,29,7,17,30
90,Fail,45,41,0,13,32
90,Fail,49,36,2,13,36
90,Fail,52,36,0,12,40
90,Fail,50,30,3,17,33
90,Fail,50,32,2,16,34
90,Fail,41,36,8,15,26
90,Fail,45,41,4,10,35
90,Fail,51,38,0,9,42
90,Fail,53,34,1,12,41
90,Fail,51,33,2,14,37
90,Fail,50,34,5,11,39
90,Fail,50,33,0,14,36
90,Fail,47,39,0,9,38
90,Fail,48,34,6,12,36
90,Fail,45,44,1,10,35
90,Fail,52,40,2,6,46
90,Fail,46,40,0,14,32
90,Fail,51,35,2,12,39
90,Fail,46,34,0,13,33
90,Fail,48,34,0,17,31
90,Fail,40,34,0,16,24
90,Fail,41,33,9,17,24
90,Fail,43,37,6,14,29
90,Fail,45,38,2,15,30
90,Fail,55,32,5,8,47
90,Fail,46,40,1,13,33
90,Fail,43,36,6,15,28
90,Fail,50,33,3,14,36
90,Fail,54,35,2,9,45
90,Fail,36,38,0,17,19
90,Fail,46,28,11,15,31
90,Fail,43,29,0,18,25
90,Fail,48,33,1,18,30
90,Fail,47,33,0,20,27
90,Fail,45,43,0,11,34
90,Fail,55,35,2,8,47
90,Fail,47,31,0,14,33
90,Fail,49,34,0,17,32
90,Fail,47,38,2,13,34
90,Fail,46,38,0,13,33
90,Fail,47,41,3,9,38
90,Fail,43,42,0,12,31
90,Fail,47,40,0,13,34
90,Fail,46,39,0,13,33
90,Fail,55,40,0,5,50
90,Fail,43,38,0,14,29
90,Fail,48,38,0,10,38
90,Fail,46,43,0,10,36
90,Fail,44,30,10,16,28
90,Fail,47,37,9,7,40
90,Fail,50,39,0,8,42
90,Fail,52,34,0,9,43
90,Fail,52,31,0,15,37
90,Fail,48,36,0,12,36
90,Fail,49,36,1,14,35
90,Fail,56,31,1,12,44
90,Fail,45,37,8,10,35
90,Fail,47,29,0,19,28
90,Fail,51,33,0,10,41
90,Fail,47,38,5,10,37
90,Fail,52,34,2,12,40
90,Fail,45,41,0,14,31
90,Fail,42,38,0,12,30
90,Fail,52,35,2,11,41
90,Fail,52,35,1,12,40
90,Fail,49,33,7,11,38
90,Fail,51,36,0,12,39
90,Fail,55,33,0,11,44
90,Fail,47,33,0,16,31
90,Fail,57,29,0,13,44
90,Fail,42,40,2,16,26
90,Fail,50,39,0,7,43
90,Fail,52,28,7,13,39
90,Fail,37,44,8,11,26
90,Fail,50,37,0,10,40
90,Fail,52,33,0,14,38
90,Fail,41,42,3,14,27
90,Fail,51,31,0,13,38
90,Fail,47,36,0,13,34
90,Fail,51,35,0,11,40
90,Fail,53,35,1,11,42
90,Fail,42,43,3,12,30
90,Fail,60,27,1,12,48
90,Fail,51,32,0,12,39
90,Fail,48,37,0,13,35
90,Fail,54,24,0,14,40
90,Fail,48,35,4,13,35
90,Fail,50,34,0,16,34
90,Fail,54,34,0,11,43
90,Fail,46,35,0,15,31
90,Fail,42,35,6,17,25
90,Fail,46,39,4,11,35
90,Fail,41,38,0,19,22
90,Fail,42,43,0,13,29
90,Fail,52,38,0,8,44
90,Fail,43,34,0,14,29
90,Fail,53,31,0,11,42
90,Fail,46,41,1,12,34
90,Fail,38,40,0,16,22
90,Fail,51,36,2,11,40
90,Fail,53,37,0,10,43
90,Fail,46,39,0,13,33
90,Fail,41,41,7,11,30
90,Fail,52,35,0,13,39
90,Fail,47,39,1,13,34
90,Fail,51,27,0,13,38
90,Fail,47,39,4,10,37
90,Fail,60,31,0,9,51
90,Fail,48,37,5,10,38
90,Fail,54,35,1,10,44
90,Fail,38,47,3,12,26
90,Fail,51,30,0,11,40
90,Fail,38,36,9,17,21
90,Fail,47,34,0,15,32
90,Fail,50,34,3,13,37
90,Fail,42,42,1,15,27
90,Fail,53,34,1,12,41
90,Fail,42,38,7,13,29
90,Fail,53,36,0,9,44
90,Fail,43,35,5,17,26
90,Fail,47,35,0,15,32
90,Fail,50,42,1,7,43
90,Fail,43,42,3,12,31
90,Fail,52,36,1,11,41
90,Fail,52,34,2,12,40
90,Fail,46,28,9,17,29
90,Fail,44,42,0,11,33
90,Fail,45,37,0,16,29
90,Fail,44,37,0,17,27
90,Fail,45,38,3,14,31
90,Fail,49,40,1,10,39
90,Fail,46,38,0,12,34
90,Fail,43,40,1,16,27
90,Fail,43,42,0,9,34
90,Fail,50,32,0,15,35
90,Fail,55,28,2,15,40
90,Fail,55,30,2,13,42
90,Fail,39,43,6,12,27
90,Fail,50,37,2,11,39
90,Fail,54,35,0,10,44
90,Fail,49,32,0,17,32
90,Fail,48,36,4,12,36
90,Fail,54,33,0,9,45
90,Fail,56,32,1,11,45
90,Fail,50,32,2,16,34
90,Fail,51,39,2,8,43
90,Fail,54,26,8,12,42
90,Fail,44,34,6,16,28
90,Fail,51,32,0,16,35
90,Fail,42,34,8,16,26
90,Fail,48,31,0,15,33
90,Fail,50,32,0,15,35
90,Fail,45,40,0,10,35
90,Fail,47,34,5,14,33
90,Fail,54,37,0,6,48
90,Fail,50,29,10,11,39
90,Fail,49,36,6,9,40
90,Fail,57,35,0,8,49
90,Fail,46,31,0,13,33
90,Fail,45,31,8,16,29
90,Fail,48,40,0,8,40
90,Fail,42,36,5,17,25
90,Fail,44,36,0,15,29
90,Fail,51,36,3,10,41
90,Fail,52,38,4,6,46
90,Fail,49,38,2,11,38
90,Fail,46,37,0,14,32
90,Fail,50,39,0,10,40
90,Fail,51,35,3,11,40
90,Fail,46,29,0,10,36
90,Fail,50,31,6,13,37
90,Fail,44,38,0,15,29
90,Fail,54,30,0,12,42
90,Fail,35,48,0,13,22
90,Fail,49,35,4,12,37
90,Fail,38,43,0,14,24
90,Fail,43,36,4,17,26
90,Fail,45,44,0,11,34
90,Fail,51,27,6,16,35
90,Fail,49,30,0,11,38
90,Fail,51,39,0,5,46
90,Fail,54,31,3,12,42
90,Fail,43,37,0,20,23
90,Fail,37,35,0,16,21
90,Fail,40,44,0,16,24
90,Fail,38,35,0,16,22
90,Fail,51,36,0,12,39
90,Fail,39,40,3,18,21
90,Fail,55,34,0,11,44
90,Fail,53,27,0,12,41
90,Fail,44,42,0,11,33
90,Fail,49,39,1,11,38
90,Fail,44,36,0,17,27
90,Fail,44,34,8,14,30
90,Fail,53,32,2,13,40
90,Fail,50,30,0,11,39
90,Fail,48,37,0,14,34
90,Fail,52,35,1,12,40
90,Fail,52,35,0,9,43
90,Fail,48,29,7,16,32
90,Fail,49,32,0,15,34
90,Fail,56,32,1,11,45
90,Fail,53,30,6,11,42
90,Fail,50,35,0,14,36
90,Fail,42,35,9,14,28
90,Fail,47,33,0,13,34
90,Fail,46,31,11,12,34
90,Fail,51,33,5,11,40
90,Fail,50,37,0,9,41
90,Fail,43,27,0,13,30
90,Fail,52,34,1,13,39
90,Fail,48,41,0,9,39
90,Fail,50,32,6,12,38
90,Fail,49,42,1,8,41
90,Fail,41,42,0,11,30
90,Fail,43,38,0,16,27
90,Fail,49,39,1,11,38
90,Fail,41,41,6,12,29
90,Fail,51,32,0,9,42
90,Fail,42,44,2,12,30
90,Fail,37,37,0,15,22
90,Fail,49,39,3,9,40
90,Fail,49,29,7,15,34
90,Fail,51,33,7,9,42
90,Fail,47,30,5,18,29
90,Fail,46,37,1,16,30
90,Fail,49,34,0,15,34
90,Fail,55,34,0,11,44
90,Fail,46,37,0,12,34
90,Fail,47,36,0,10,37
90,Fail,51,41,0,8,43
90,Fail,54,25,0,15,39
90,Fail,43,33,0,17,26
90,Fail,49,36,3,12,37
90,Fail,49,31,0,12,37
90,Fail,42,40,5,13,29
90,Fail,55,31,3,11,44
90,Fail,38,41,2,19,19
90,Fail,56,30,3,11,45
90,Fail,52,33,0,12,40
90,Fail,47,40,0,11,36
90,Fail,46,34,0,19,27
90,Fail,39,38,0,16,23
90,Fail,48,38,7,7,41
90,Fail,44,36,4,16,28
90,Fail,40,44,0,15,25
90,Fail,54,37,0,9,45
90,Fail,46,32,6,16,30
90,Fail,51,36,2,11,40
90,Fail,47,44,0,6,41
90,Fail,54,36,0,10,44
90,Fail,49,36,0,10,39
90,Fail,44,41,7,8,36
90,Fail,49,39,1,11,38
90,Fail,40,36,0,23,17
90,Fail,49,33,0,18,31
90,Fail,56,34,0,9,47
90,Fail,45,38,1,16,29
90,Fail,49,38,1,12,37
90,Fail,43,41,0,16,27
90,Fail,45,38,5,12,33
90,Fail,41,40,0,12,29
90,Fail,51,34,0,13,38
90,Fail,44,40,0,12,32
90,Fail,52,35,1,12,40
90,Fail,45,39,0,14,31
90,Fail,46,38,5,11,35
90,Fail,49,38,7,6,43
90,Fail,49,36,2,13,36
90,Fail,42,43,0,15,27
90,Fail,49,34,0,16,33
90,Fail,55,37,2,6,49
90,Fail,49,37,4,10,39
90,Fail,53,30,0,13,40
90,Fail,49,34,0,16,33
90,Fail,43,35,9,13,30
90,Fail,48,39,2,11,37
90,Fail,48,37,0,12,36
90,Fail,45,37,4,14,31
90,Fail,44,36,7,13,31
90,Fail,45,31,12,12,33
90,Fail,54,32,8,6,48
90,Fail,54,28,0,13,41
90,Fail,54,36,0,7,47
90,Fail,46,41,1,12,34
90,Fail,55,32,3,10,45
90,Fail,48,31,0,15,33
90,Fail,45,35,0,14,31
90,Fail,45,37,0,14,31
90,Fail,51,38,0,11,40
90,Fail,51,30,3,16,35
90,Fail,49,36,6,9,40
90,Fail,49,38,4,9,40
90,Fail,47,30,2,21,26
90,Fail,51,41,0,8,43
90,Fail,45,40,2,13,32
90,Fail,51,31,3,15,36
90,Fail,52,26,1,21,31
90,Fail,49,33,0,14,35
90,Fail,46,38,0,15,31
90,Fail,45,37,0,13,32
90,Fail,59,30,0,9,50
90,Fail,52,35,0,11,41
90,Fail,47,36,4,13,34
90,Fail,52,31,5,12,40
90,Fail,53,33,1,13,40
90,Fail,46,35,6,13,33
90,Fail,46,38,2,14,32
90,Fail,43,35,6,16,27
90,Fail,54,36,0,9,45
90,Fail,52,34,1,13,39
90,Fail,45,40,9,6,39
90,Fail,48,36,0,14,34
90,Fail,50,44,3,3,47
90,Fail,51,38,0,7,44
90,Fail,42,37,5,16,26
90,Fail,48,39,3,10,38
90,Fail,49,33,5,13,36
90,Fail,46,35,0,11,35
90,Fail,45,35,0,9,36
90,Fail,48,30,2,20,28
90,Fail,50,32,3,15,35
90,Fail,51,32,0,11,40
90,Fail,45,39,0,14,31
90,Fail,54,36,0,9,45
90,Fail,47,39,0,11,36
90,Fail,45,34,0,15,30
90,Fail,49,27,8,16,33
90,Fail,46,38,7,9,37
90,Fail,45,42,0,11,34
90,Fail,52,34,0,14,38
90,Fail,42,36,11,11,31
90,Fail,48,29,0,12,36
90,Fail,47,42,2,9,38
90,Fail,48,36,0,15,33
90,Fail,45,31,6,18,27
90,Fail,41,37,0,15,26
90,Fail,46,40,0,12,34
90,Fail,55,37,0,8,47
90,Fail,44,38,6,12,32
90,Fail,44,34,8,14,30
90,Fail,43,42,0,15,28
90,Fail,47,37,1,15,32
90,Fail,51,37,2,10,41
90,Fail,49,34,0,11,38
90,Fail,46,36,0,13,33
90,Fail,40,42,0,13,27
90,Fail,49,38,0,12,37
90,Fail,49,40,4,7,42
90,Fail,44,37,3,16,28
90,Fail,55,31,3,11,44
90,Fail,59,30,3,8,51
90,Fail,43,39,6,12,31
90,Fail,52,29,5,14,38
90,Fail,52,35,1,12,40
90,Fail,47,37,6,10,37
90,Fail,48,41,0,10,38
90,Fail,55,36,0,9,46
90,Fail,47,39,1,13,34
90,Fail,42,36,0,18,24
90,Fail,55,37,0,8,47
90,Fail,54,33,0,9,45
90,Fail,51,32,0,16,35
90,Fail,49,34,2,15,34
90,Fail,43,40,1,16,27
90,Fail,48,37,2,13,35
90,Fail,47,36,6,11,36
90,Fail,48,44,1,7,41
90,Fail,52,30,0,18,34
90,Fail,44,35,3,18,26
90,Fail,47,32,0,17,30
90,Fail,39,39,3,19,20
90,Fail,47,37,2,14,33
90,Fail,50,32,5,13,37
90,Fail,61,29,2,8,53
90,Fail,63,22,0,14,49
90,Fail,50,38,0,11,39
90,Fail,46,31,6,17,29
90,Fail,46,37,0,17,29
90,Fail,51,34,3,12,39
90,Fail,49,32,0,11,38
90,Fail,51,30,5,14,37
90,Fail,57,34,1,8,49
90,Fail,48,36,0,13,35
90,Fail,52,33,0,14,38
90,Fail,53,34,0,8,45
90,Fail,49,36,0,14,35
90,Fail,51,37,0,10,41
90,Fail,46,36,0,16,30
90,Fail,51,34,1,14,37
90,Fail,48,38,1,13,35
90,Fail,46,36,0,13,33
90,Fail,51,33,0,15,36
90,Fail,48,32,6,14,34
90,Fail,48,32,0,20,28
90,Fail,44,34,0,15,29
90,Fail,46,29,0,19,27
90,Fail,48,35,4,13,35
90,Fail,43,35,7,15,28
90,Fail,51,32,0,12,39
90,Fail,43,39,10,8,35
90,Fail,45,41,0,12,33
90,Fail,54,30,0,16,38
90,Fail,45,31,0,17,28
90,Fail,51,32,0,16,35
90,Fail,51,36,0,12,39
90,Fail,50,35,0,15,35
90,Fail,47,36,0,15,32
90,Fail,56,31,0,12,44
90,Fail,55,31,1,13,42
90,Fail,50,39,0,10,40
90,Fail,55,27,4,14,41
90,Fail,42,42,0,16,26
90,Fail,54,29,0,13,41
90,Fail,53,36,1,10,43
90,Fail,42,41,5,12,30
90,Fail,49,38,0,10,39
90,Fail,48,30,0,15,33
90,Fail,35,43,0,16,19
90,Fail,45,43,1,11,34
90,Fail,47,40,2,11,36
90,Fail,49,33,7,11,38
90,Fail,48,32,11,9,39
90,Fail,57,29,2,12,45
90,Fail,51,34,2,13,38
90,Fail,52,37,0,11,41
90,Fail,46,41,5,8,38
90,Fail,54,39,0,6,48
90,Fail,49,39,1,11,38
90,Fail,43,39,1,17,26
90,Fail,46,34,6,14,32
90,Fail,51,31,0,12,39
90,Fail,51,36,0,13,38
90,Fail,48,36,5,11,37
90,Fail,41,39,4,16,25
90,Fail,47,37,6,10,37
90,Fail,48,30,9,13,35
90,Fail,43,42,3,12,31
90,Fail,49,32,5,14,35
90,Fail,47,37,2,14,33
90,Fail,42,50,0,8,34
90,Fail,53,34,3,10,43
90,Fail,46,40,2,12,34
90,Fail,44,39,4,13,31
90,Fail,49,36,8,7,42
90,Fail,49,34,6,11,38
90,Fail,47,34,9,10,37
90,Fail,44,42,1,13,31
90,Fail,44,36,9,11,33
90,Fail,48,36,3,13,35
90,Fail,47,31,12,10,37
90,Fail,51,36,1,12,39
90,Fail,48,38,0,10,38
90,Fail,47,41,0,10,37
90,Fail,48,40,0,9,39
90,Fail,41,45,3,11,30
90,Fail,32,39,0,15,17
90,Fail,38,49,4,9,29
90,Fail,50,39,0,11,39
90,Fail,48,33,5,14,34
90,Fail,58,33,1,8,50
90,Fail,42,37,7,14,28
90,Fail,48,38,1,13,35
90,Fail,43,33,0,19,24
90,Fail,48,39,2,11,37
90,Fail,55,28,2,15,40
90,Fail,44,40,0,13,31
90,Fail,53,32,0,12,41
90,Fail,54,33,0,7,47
90,Fail,41,39,6,14,27
90,Fail,49,34,4,13,36
90,Fail,44,33,10,13,31
90,Fail,57,33,3,7,50
90,Fail,56,31,0,12,44
90,Fail,45,37,0,16,29
90,Fail,52,28,6,14,38
90,Fail,55,34,0,10,45
90,Fail,51,31,0,11,40
90,Fail,46,33,0,17,29
90,Fail,42,46,2,10,32
90,Fail,42,41,3,14,28
90,Fail,47,37,0,15,32
90,Fail,43,33,9,15,28
90,Fail,42,42,1,15,27
90,Fail,49,38,3,10,39
90,Fail,51,35,7,7,44
90,Fail,52,36,1,11,41
90,Fail,49,33,0,14,35
90,Fail,52,36,2,10,42
90,Fail,56,32,0,10,46
90,Fail,54,26,11,9,45
90,Fail,50,38,0,11,39
90,Fail,51,32,3,14,37
90,Fail,44,29,5,22,22
90,Fail,47,31,9,13,34
90,Fail,47,36,5,12,35
90,Fail,48,40,0,12,36
90,Fail,52,34,0,13,39
90,Fail,45,39,8,8,37
90,Fail,53,30,0,14,39
90,Fail,48,36,3,13,35
90,Fail,51,34,0,11,40
90,Fail,56,32,0,10,46
90,Fail,52,35,0,11,41
90,Fail,51,36,0,12,39
90,Fail,53,38,0,6,47
90,Fail,46,37,7,10,36
90,Fail,52,37,1,10,42
90,Fail,52,37,3,8,44
90,Fail,45,42,0,12,33
90,Fail,51,35,5,9,42
90,Fail,49,38,0,12,37
90,Fail,45,36,12,7,38
90,Fail,53,34,0,12,41
90,Fail,53,36,1,10,43
90,Fail,43,41,0,9,34
90,Fail,49,34,8,9,40
90,Fail,43,43,2,12,31
90,Fail,48,35,0,14,34
90,Fail,48,36,4,12,36
90,Fail,45,44,0,11,34
90,Fail,54,29,6,11,43
90,Fail,50,38,1,11,39
90,Fail,44,40,2,14,30
90,Fail,43,33,0,22,21
90,Fail,49,33,3,15,34
90,Fail,48,27,9,16,32
90,Fail,45,40,0,13,32
90,Fail,44,42,0,7,37
90,Fail,53,29,0,12,41
90,Fail,63,29,0,8,55
90,Fail,46,36,6,12,34
90,Fail,54,39,0,7,47
90,Fail,47,38,1,14,33
90,Fail,46,37,0,15,31
90,Fail,54,30,0,14,40
90,Fail,50,30,8,12,38
90,Fail,52,34,1,13,39
90,Fail,45,36,0,8,37
90,Fail,56,33,3,8,48
90,Fail,44,36,8,12,32
90,Fail,50,38,0,12,38
90,Fail,50,37,0,11,39
90,Fail,45,43,0,9,36
90,Fail,58,34,0,8,50
90,Fail,41,39,0,17,24
90,Fail,43,32,0,12,31
90,Fail,35,41,2,22,13
90,Fail,46,42,0,10,36
90,Fail,47,40,2,11,36
90,Fail,44,27,8,21,23
90,Fail,41,38,0,13,28
90,Fail,49,41,0,9,40
90,Fail,50,39,0,10,40
90,Fail,45,35,0,15,30
90,Fail,51,40,0,9,42
90,Fail,47,32,0,13,34
90,Fail,49,40,1,10,39
90,Fail,58,28,1,13,45
90,Fail,52,36,0,12,40
90,Fail,47,35,0,15,32
90,Fail,49,38,0,10,39
90,Fail,51,35,0,12,39
90,Fail,48,34,0,12,36
90,Fail,43,35,0,21,22
90,Fail,50,38,4,8,42
90,Fail,44,36,0,15,29
90,Fail,54,38,2,6,48
90,Fail,48,33,0,16,32
90,Fail,50,31,0,18,32
90,Fail,50,38,0,12,38
90,Fail,54,30,3,13,41
90,Fail,46,43,0,10,36
90,Fail,45,34,2,19,26
90,Fail,45,37,0,15,30
90,Fail,54,30,5,11,43
90,Fail,57,32,0,11,46
90,Fail,43,37,6,14,29
90,Fail,47,33,0,14,33
90,Fail,48,26,13,13,35
90,Fail,54,34,0,8,46
90,Fail,49,42,3,6,43
90,Fail,41,37,7,15,26
90,Fail,51,33,0,16,35
90,Fail,45,40,0,12,33
90,Fail,39,45,5,11,28
90,Fail,50,43,0,2,48
90,Fail,49,37,3,11,38
90,Fail,36,38,0,21,15
90,Fail,47,34,7,12,35
90,Fail,56,33,1,10,46
90,Fail,55,30,0,12,43
90,Fail,55,27,5,13,42
90,Fail,48,36,0,11,37
90,Fail,52,33,2,13,39
90,Fail,58,30,0,10,48
90,Fail,44,35,7,14,30
90,Fail,50,37,0,9,41
90,Fail,47,37,0,15,32
90,Fail,46,39,2,13,33
90,Fail,52,27,5,16,36
90,Fail,50,37,2,11,39
90,Fail,55,30,0,8,47
90,Fail,37,31,0,19,18
90,Fail,55,32,3,10,45
90,Fail,55,29,3,13,42
90,Fail,42,42,0,16,26
90,Fail,47,33,6,14,33
90,Fail,42,42,0,11,31
90,Fail,43,39,0,16,27
90,Fail,52,36,3,9,43
90,Fail,45,40,0,14,31
90,Fail,53,26,7,14,39
90,Fail,45,34,7,14,31
90,Fail,41,44,0,14,27
90,Fail,47,38,0,11,36
90,Fail,44,43,4,9,35
90,Fail,47,36,9,8,39
90,Fail,49,32,4,15,34
90,Fail,44,39,0,15,29
90,Fail,50,34,0,11,39
90,Fail,49,33,2,16,33
90,Fail,41,40,1,18,23
90,Fail,46,34,0,12,34
90,Fail,49,37,0,9,40
90,Fail,43,36,0,14,29
90,Fail,51,33,4,12,39
90,Fail,47,32,0,10,37
90,Fail,53,38,1,8,45
90,Fail,44,28,0,18,26
90,Fail,48,41,5,6,42
90,Fail,48,31,0,13,35
90,Fail,56,32,4,8,48
90,Fail,50,35,0,14,36
90,Fail,47,38,3,12,35
90,Fail,52,36,2,10,42
90,Fail,49,33,0,12,37
90,Fail,52,38,0,9,43
90,Fail,55,37,0,8,47
90,Fail,49,35,4,12,37
90,Fail,51,31,3,15,36
90,Fail,48,29,0,13,35
90,Fail,49,34,3,14,35
90,Fail,46,36,1,17,29
90,Fail,52,30,5,13,39
90,Fail,47,36,4,13,34
90,Fail,52,38,2,8,44
90,Fail,50,33,1,16,34
90,Fail,48,35,2,15,33
90,Fail,43,37,8,12,31
90,Fail,46,35,7,12,34
90,Fail,55,28,8,9,46
90,Fail,47,31,6,16,31
90,Fail,46,38,0,15,31
90,Fail,47,36,0,15,32
90,Fail,39,36,8,17,22
90,Fail,47,37,1,15,32
90,Fail,42,32,11,15,27
90,Fail,52,39,0,9,43
90,Fail,51,35,0,5,46
90,Fail,41,42,2,15,26
90,Fail,43,41,2,14,29
90,Fail,47,32,0,14,33
90,Fail,43,39,3,15,28
90,Fail,51,40,0,8,43
90,Fail,45,41,1,13,32
90,Fail,45,38,2,15,30
90,Fail,38,45,2,15,23
90,Fail,46,33,0,16,30
90,Fail,46,31,9,14,32
90,Fail,50,30,0,15,35
90,Fail,51,35,4,10,41
90,Fail,54,37,0,8,46
90,Fail,50,37,3,10,40
90,Fail,58,31,0,9,49
90,Fail,47,37,5,11,36
90,Fail,50,30,5,15,35
90,Fail,48,30,0,15,33
90,Fail,53,32,4,11,42
90,Fail,57,30,2,11,46
90,Fail,52,36,0,12,40
90,Fail,51,33,5,11,40
90,Fail,48,28,9,15,33
90,Fail,49,36,3,12,37
90,Fail,44,37,6,13,31
90,Fail,47,33,0,19,28
90,Fail,46,34,0,11,35
90,Fail,56,28,0,15,41
90,Fail,42,33,10,15,27
90,Fail,50,37,0,13,37
90,Fail,43,34,0,21,22
90,Fail,49,33,0,17,32
90,Fail,54,34,0,12,42
90,Fail,50,36,0,13,37
90,Fail,50,32,0,12,38
90,Fail,50,32,5,13,37
90,Fail,51,33,0,11,40
90,Fail,49,41,0,10,39
90,Fail,46,37,0,11,35
90,Fail,49,36,4,11,38
90,Fail,41,40,8,11,30
90,Fail,54,33,0,12,42
90,Fail,54,33,0,12,42
90,Fail,44,36,0,17,27
90,Fail,46,40,0,13,33
90,Fail,44,37,0,16,28
90,Fail,49,31,4,16,33
90,Fail,55,32,0,8,47
90,Fail,45,32,0,9,36
90,Fail,46,37,1,16,30
90,Fail,45,40,0,14,31
90,Fail,40,33,0,14,26
90,Fail,51,38,1,10,41
90,Fail,50,40,0,9,41
90,Fail,37,44,0,18,19
90,Fail,40,47,0,13,27
90,Fail,46,43,0,10,36
90,Fail,48,35,1,16,32
90,Fail,43,43,0,10,33
90,Fail,40,37,0,14,26
90,Fail,50,40,2,8,42
90,Fail,57,33,1,9,48
90,Fail,47,34,6,13,34
90,Fail,44,37,2,17,27
90,Fail,46,40,1,13,33
90,Fail,49,35,0,15,34
90,Fail,47,34,2,17,30
90,Fail,57,25,0,13,44
90,Fail,53,38,0,7,46
90,Fail,44,36,2,18,26
90,Fail,43,42,0,13,30
90,Fail,52,27,0,15,37
90,Fail,49,36,0,14,35
90,Fail,55,36,0,9,46
90,Fail,49,36,0,15,34
90,Fail,52,29,0,17,35
90,Fail,47,39,2,12,35
90,Fail,45,36,3,16,29
90,Fail,44,31,0,18,26
90,Fail,52,35,1,12,40
90,Fail,47,32,0,14,33
90,Fail,49,35,0,11,38
90,Fail,45,41,2,12,33
90,Fail,52,36,0,9,43
90,Fail,52,38,0,9,43
90,Fail,48,36,1,15,33
90,Fail,51,37,0,12,39
90,Fail,55,28,0,11,44
90,Fail,54,33,0,11,43
90,Fail,50,35,0,11,39
90,Fail,56,33,1,10,46
90,Fail,54,34,0,11,43
90,Fail,55,33,0,11,44
90,Fail,47,34,0,18,29
90,Fail,50,28,3,19,31
90,Fail,44,34,1,21,23
90,Fail,49,36,0,9,40
90,Fail,52,33,0,14,38
90,Fail,53,35,0,12,41
90,Fail,48,37,0,13,35
90,Fail,39,41,3,17,22
90,Fail,45,36,2,17,28
90,Fail,48,35,5,12,36
90,Fail,48,38,5,9,39
90,Fail,51,28,10,11,40
90,Fail,50,39,0,10,40
90,Fail,41,45,0,11,30
90,Fail,48,33,1,18,30
90,Fail,53,33,2,12,41
90,Fail,54,37,0,8,46
90,Fail,52,34,0,13,39
90,Fail,53,39,0,8,45
90,Fail,51,37,0,12,39
90,Fail,52,35,0,13,39
90,Fail,44,37,6,13,31
90,Fail,47,35,4,14,33
90,Fail,49,32,0,15,34
90,Fail,56,33,3,8,48
90,Fail,45,38,0,12,33
90,Fail,50,34,3,13,37
90,Fail,53,37,1,9,44
90,Fail,48,35,0,15,33
90,Fail,43,40,1,16,27
90,Fail,46,35,8,11,35
90,Fail,40,46,0,13,27
90,Fail,53,30,2,15,38
90,Fail,45,36,0,14,31
90,Fail,42,35,0,19,23
90,Fail,54,36,0,9,45
90,Fail,49,39,4,8,41
90,Fail,47,32,6,15,32
90,Fail,51,32,0,11,40
90,Fail,51,36,4,9,42
90,Fail,49,35,0,9,40
90,Fail,51,29,6,14,37
90,Fail,56,32,3,9,47
90,Fail,48,39,4,9,39
90,Fail,48,33,4,15,33
90,Fail,46,34,0,14,32
90,Fail,61,27,0,8,53
90,Fail,47,40,0,10,37
90,Fail,47,43,0,7,40
90,Fail,49,38,0,10,39
90,Fail,53,35,0,11,42
90,Fail,43,38,5,14,29
90,Fail,51,40,1,8,43
90,Fail,46,31,11,12,34
90,Fail,51,36,4,9,42
90,Fail,51,36,0,9,42
90,Fail,49,36,2,13,36
90,Fail,49,35,0,11,38
90,Fail,39,41,5,15,24
90,Fail,48,32,0,12,36
90,Fail,50,36,1,13,37
90,Fail,45,38,0,13,32
90,Fail,48,37,3,12,36
90,Fail,46,34,8,12,34
90,Fail,47,40,1,12,35
90,Fail,45,38,3,14,31
90,Fail,44,38,0,17,27
90,Fail,48,32,0,16,32
90,Fail,52,35,4,9,43
90,Fail,51,40,1,8,43
90,Fail,37,41,0,15,22
90,Fail,52,25,0,16,36
90,Fail,43,43,0,13,30
90,Fail,53,34,0,11,42
90,Fail,54,29,0,15,39
90,Fail,49,35,4,12,37
90,Fail,45,32,9,14,31
90,Fail,50,37,0,7,43
90,Fail,51,35,0,13,38
90,Fail,49,32,0,15,34
90,Fail,46,32,0,10,36
90,Fail,43,32,8,17,26
90,Fail,49,43,0,8,41
90,Fail,42,37,0,19,23
90,Fail,52,40,1,7,45
90,Fail,49,28,0,15,34
90,Fail,50,36,4,10,40
90,Fail,46,40,0,7,39
90,Fail,44,38,1,17,27
90,Fail,48,38,5,9,39
90,Fail,50,31,6,13,37
90,Fail,49,36,4,11,38
90,Fail,50,34,0,8,42
90,Fail,52,36,2,10,42
90,Fail,44,27,0,24,20
90,Fail,46,36,10,8,38
90,Fail,42,47,0,10,32
90,Fail,47,30,0,17,30
90,Fail,45,34,7,14,31
90,Fail,50,34,3,13,37
90,Fail,45,37,0,10,35
90,Fail,50,39,0,6,44
90,Fail,43,32,8,17,26
90,Fail,39,35,10,16,23
90,Fail,50,30,5,15,35
90,Fail,55,35,0,9,46
90,Fail,47,42,1,10,37
90,Fail,46,31,0,14,32
90,Fail,43,38,0,13,30
90,Fail,52,31,3,14,38
90,Fail,44,42,5,9,35
90,Fail,41,34,8,17,24
90,Fail,50,35,2,13,37
90,Fail,47,33,0,17,30
90,Fail,50,34,0,11,39
90,Fail,49,34,2,15,34
90,Fail,46,33,0,13,33
90,Fail,49,34,2,15,34
90,Fail,45,34,0,12,33
90,Fail,49,39,0,12,37
90,Fail,50,31,7,12,38
90,Fail,48,40,1,11,37
90,Fail,47,34,0,14,33
90,Fail,37,51,0,8,29
90,Fail,41,43,0,16,25
90,Fail,37,38,0,10,27
90,Fail,47,39,2,12,35
90,Fail,49,34,0,14,35
90,Fail,47,41,0,11,36
90,Fail,49,34,2,15,34
90,Fail,56,32,4,8,48
90,Fail,46,36,4,14,32
90,Fail,51,36,1,12,39
90,Fail,49,26,6,19,30
90,Fail,57,29,3,11,46
90,Fail,47,37,0,11,36
90,Fail,51,32,0,12,39
90,Fail,47,34,0,11,36
90,Fail,56,31,0,11,45
90,Fail,48,37,3,12,36
90,Fail,44,35,0,21,23
90,Fail,44,38,7,11,33
90,Fail,51,29,0,16,35
90,Fail,49,34,6,11,38
90,Fail,51,35,3,11,40
90,Fail,46,38,0,15,31
90,Fail,54,30,0,13,41
90,Fail,45,44,0,8,37
90,Fail,45,42,0,13,32
90,Fail,45,36,3,16,29
90,Fail,55,33,0,9,46
90,Fail,46,37,3,14,32
90,Fail,48,41,0,8,40
90,Fail,48,38,0,14,34
90,Fail,51,30,7,12,39
90,Fail,51,31,6,12,39
90,Fail,46,43,0,9,37
90,Fail,48,35,0,14,34
90,Fail,43,44,2,11,32
90,Fail,53,29,0,13,40
90,Fail,50,35,7,8,42
90,Fail,47,39,0,12,35
90,Fail,41,42,5,12,29
90,Fail,45,41,0,14,31
90,Fail,46,31,7,16,30
90,Fail,48,34,4,14,34
90,Fail,54,35,0,8,46
90,Fail,54,29,0,16,38
90,Fail,48,33,4,15,33
90,Fail,52,32,0,16,36
90,Fail,52,34,0,11,41
90,Fail,46,38,0,16,30
90,Fail,49,35,3,13,36
90,Fail,55,33,0,11,44
90,Fail,53,35,0,12,41
90,Fail,45,28,0,11,34
90,Fail,35,34,11,20,15
90,Fail,48,36,0,13,35
90,Fail,38,38,12,12,26
90,Fail,42,32,0,15,27
90,Fail,42,33,5,20,22
90,Fail,52,31,0,9,43
90,Fail,57,27,0,10,47
90,Fail,51,34,0,12,39
90,Fail,43,33,0,16,27
90,Fail,56,33,2,9,47
90,Fail,45,42,0,10,35
90,Fail,35,37,0,17,18
90,Fail,40,39,3,18,22
90,Fail,44,34,5,17,27
90,Fail,49,37,0,11,38
90,Fail,50,32,0,14,36
90,Fail,48,33,0,13,35
90,Fail,43,32,7,18,25
90,Fail,51,35,0,13,38
90,Fail,49,40,1,10,39
90,Fail,47,39,0,10,37
90,Fail,54,29,1,16,38
90,Fail,52,25,0,13,39
90,Fail,48,40,0,11,37
90,Fail,44,33,8,15,29
90,Fail,48,28,9,15,33
90,Fail,55,31,0,10,45
90,Fail,57,30,4,9,48
90,Fail,49,35,0,12,37
90,Fail,48,33,0,14,34
90,Fail,52,28,11,9,43
90,Fail,45,38,6,11,34
90,Fail,47,30,0,16,31
90,Fail,49,37,0,10,39
90,Fail,55,34,0,11,44
90,Fail,47,34,0,13,34
90,Fail,47,34,3,16,31
90,Fail,54,36,0,10,44
90,Fail,46,32,0,16,30
90,Fail,44,38,0,8,36
90,Fail,47,37,0,15,32
90,Fail,52,32,0,9,43
90,Fail,54,36,0,10,44
90,Fail,54,28,2,16,38
90,Fail,52,32,0,12,40
90,Fail,49,32,9,10,39
90,Fail,50,27,0,16,34
90,Fail,53,38,0,9,44
90,Fail,39,46,0,14,25
90,Fail,50,28,8,14,36
90,Fail,57,33,1,9,48
90,Fail,48,34,4,14,34
90,Fail,40,39,8,13,27
90,Fail,51,32,6,11,40
90,Fail,47,42,1,10,37
90,Fail,52,34,1,13,39
90,Fail,43,39,5,13,30
90,Fail,50,34,2,14,36
90,Fail,47,39,0,8,39
90,Fail,54,26,0,9,45
90,Fail,51,38,0,11,40
90,Fail,58,28,0,10,48
90,Fail,42,30,7,21,21
90,Fail,47,28,9,16,31
90,Fail,47,39,2,12,35
90,Fail,39,39,2,20,19
90,Fail,51,33,3,13,38
90,Fail,47,32,4,17,30
90,Fail,53,32,0,13,40
90,Fail,50,31,5,14,36
90,Fail,43,37,0,17,26
90,Fail,43,46,1,10,33
90,Fail,47,38,0,11,36
90,Fail,48,39,2,11,37
90,Fail,42,43,7,8,34
90,Fail,41,36,0,20,21
90,Fail,41,41,4,14,27
90,Fail,46,35,3,16,30
90,Fail,53,30,0,12,41
90,Fail,49,32,7,12,37
90,Fail,47,42,0,11,36
90,Fail,49,39,0,12,37
90,Fail,46,37,9,8,38
90,Fail,50,30,8,12,38
90,Fail,45,41,2,12,33
90,Fail,55,30,1,14,41
90,Fail,57,28,0,15,42
90,Fail,48,30,0,16,32
90,Fail,41,42,0,16,25
90,Fail,39,38,0,18,21
90,Fail,47,29,9,15,32
90,Fail,54,35,0,11,43
90,Fail,50,43,0,6,44
90,Fail,49,34,0,14,35
90,Fail,53,35,0,10,43
90,Fail,52,31,0,13,39
90,Fail,46,37,1,16,30
90,Fail,49,29,5,17,32
90,Fail,52,30,0,13,39
90,Fail,42,44,3,11,31
90,Fail,44,40,4,12,32
90,Fail,50,36,0,14,36
90,Fail,46,33,6,15,31
90,Fail,51,36,0,11,40
90,Fail,50,36,0,10,40
90,Fail,36,42,0,9,27
90,Fail,45,40,0,11,34
90,Fail,56,30,0,13,43
90,Fail,53,31,0,13,40
90,Fail,52,33,0,12,40
90,Fail,53,39,1,7,46
90,Fail,51,39,2,8,43
90,Fail,43,31,0,14,29
90,Fail,47,36,8,9,38
90,Fail,49,35,0,16,33
90,Fail,50,37,0,13,37
90,Fail,54,42,0,3,51
90,Fail,48,30,0,17,31
90,Fail,51,35,1,13,38
90,Fail,46,31,0,15,31
90,Fail,48,32,7,13,35
90,Fail,49,36,8,7,42
90,Fail,52,32,2,14,38
90,Fail,43,35,7,15,28
90,Fail,48,36,5,11,37
90,Fail,50,36,0,12,38
90,Fail,54,35,1,10,44
90,Fail,50,28,0,13,37
90,Fail,44,40,0,15,29
90,Fail,49,32,8,11,38
90,Fail,42,39,0,13,29
90,Fail,47,32,0,15,32
90,Fail,51,34,0,12,39
90,Fail,50,34,0,14,36
90,Fail,51,32,0,14,37
90,Fail,41,40,3,16,25
90,Fail,49,32,0,13,36
90,Fail,57,30,1,12,45
90,Fail,47,45,0,6,41
90,Fail,49,39,0,12,37
90,Fail,43,43,0,13,30
90,Fail,46,39,3,12,34
90,Fail,57,29,0,14,43
90,Fail,48,35,0,17,31
90,Fail,49,38,0,12,37
90,Fail,51,30,10,9,42
90,Fail,40,45,0,11,29
90,Fail,51,27,6,16,35
90,Fail,44,34,6,16,28
90,Fail,47,42,3,8,39
90,Fail,42,34,8,16,26
90,Fail,54,35,0,3,51
90,Fail,48,40,0,12,36
90,Fail,48,34,0,17,31
90,Fail,49,29,9,13,36
90,Fail,47,33,3,17,30
90,Fail,52,38,0,10,42
90,Fail,46,40,1,13,33
90,Fail,50,38,0,9,41
90,Fail,51,36,0,11,40
90,Fail,49,32,4,15,34
90,Fail,51,33,0,13,38
90,Fail,43,36,4,17,26
90,Fail,46,35,0,13,33
90,Fail,56,30,0,13,43
90,Fail,47,38,3,12,35
90,Fail,39,30,0,21,18
90,Fail,44,40,0,16,28
90,Fail,54,35,0,8,46
90,Fail,50,32,0,10,40
90,Fail,49,33,5,13,36
90,Fail,47,40,0,12,35
90,Fail,48,37,7,8,40
90,Fail,52,32,0,14,38
90,Fail,43,40,6,11,32
90,Fail,46,38,2,14,32
90,Fail,46,40,0,11,35
90,Fail,40,41,5,14,26
90,Fail,53,34,2,11,42
90,Fail,52,37,0,9,43
90,Fail,54,32,0,8,46
90,Fail,49,40,2,9,40
90,Fail,47,34,0,9,38
90,Fail,43,41,0,14,29
90,Fail,46,39,1,14,32
90,Fail,52,35,2,11,41
90,Fail,48,33,0,12,36
90,Fail,46,38,5,11,35
90,Fail,49,33,0,16,33
90,Fail,43,36,0,10,33
90,Fail,51,35,0,14,37
90,Fail,48,38,0,12,36
90,Fail,52,30,5,13,39
90,Fail,51,37,0,9,42
90,Fail,49,37,3,11,38
90,Fail,37,39,0,12,25
90,Fail,54,31,0,12,42
90,Fail,46,35,0,11,35
90,Fail,50,34,0,10,40
90,Fail,51,33,3,13,38
90,Fail,51,33,2,14,37
90,Fail,40,40,11,9,31
90,Fail,46,32,0,17,29
90,Fail,47,42,1,10,37
90,Fail,52,32,4,12,40
90,Fail,47,32,8,13,34
90,Fail,52,39,0,8,44
90,Fail,47,34,0,10,37
90,Fail,49,33,0,12,37
90,Fail,47,36,0,13,34
90,Fail,42,32,0,19,23
90,Fail,44,42,2,12,32
90,Fail,57,27,2,14,43
90,Fail,54,34,5,7,47
90,Fail,40,39,4,17,23
90,Fail,46,34,0,14,32
90,Fail,58,31,1,10,48
90,Fail,54,31,6,9,45
90,Fail,48,38,0,13,35
90,Fail,43,42,0,15,28
90,Fail,38,38,11,13,25
90,Fail,49,41,2,8,41
90,Fail,42,43,0,13,29
90,Fail,46,35,0,14,32
90,Fail,50,37,1,12,38
90,Fail,55,28,5,12,43
90,Fail,44,38,0,12,32
90,Fail,41,41,0,12,29
90,Fail,50,37,2,11,39
90,Fail,52,32,0,16,36
90,Fail,48,36,0,13,35
90,Fail,49,36,0,15,34
90,Fail,43,38,0,17,26
90,Fail,43,37,0,17,26
90,Fail,46,30,10,14,32
90,Fail,45,35,0,14,31
90,Fail,46,34,4,16,30
90,Fail,50,33,0,14,36
90,Fail,50,37,0,9,41
90,Fail,37,36,10,17,20
90,Fail,50,34,0,12,38
90,Fail,50,38,1,11,39
90,Fail,61,29,1,9,52
90,Fail,61,31,1,7,54
90,Fail,57,31,0,10,47
90,Fail,47,35,2,16,31
90,Fail,50,37,0,9,41
90,Fail,53,34,0,10,43
90,Fail,51,36,0,10,41
90,Fail,47,41,0,7,40
90,Fail,50,33,8,9,41
90,Fail,44,34,0,14,30
90,Fail,49,29,2,20,29
90,Fail,51,28,0,19,32
90,Fail,50,38,0,11,39
90,Fail,48,44,0,8,40
90,Fail,51,37,0,10,41
90,Fail,44,40,3,13,31
90,Fail,40,43,9,8,32
90,Fail,54,32,0,12,42
90,Fail,48,36,0,15,33
90,Fail,49,36,8,7,42
90,Fail,48,30,5,17,31
90,Fail,39,39,9,13,26
90,Fail,51,36,3,10,41
90,Fail,46,34,0,15,31
90,Fail,49,39,3,9,40
90,Fail,45,44,0,10,35
90,Fail,55,34,0,8,47
90,Fail,46,36,0,12,34
90,Fail,47,34,2,17,30
90,Fail,46,45,2,7,39
90,Fail,56,22,6,16,40
90,Fail,42,37,1,20,22
90,Fail,43,33,9,15,28
90,Fail,50,37,0,12,38
90,Fail,53,37,5,5,48
90,Fail,45,30,9,16,29
90,Fail,59,34,0,7,52
90,Fail,46,31,0,19,27
90,Fail,52,35,1,12,40
90,Fail,52,37,0,8,44
90,Fail,50,32,0,17,33
90,Fail,41,32,0,17,24
90,Fail,42,40,3,15,27
90,Fail,46,40,1,13,33
90,Fail,47,32,6,15,32
90,Fail,46,31,0,17,29
90,Fail,45,37,0,16,29
90,Fail,41,38,0,12,29
90,Fail,51,35,0,10,41
90,Fail,49,34,0,13,36
90,Fail,54,31,0,10,44
90,Fail,48,41,0,9,39
90,Fail,43,46,0,10,33
90,Fail,54,38,1,7,47
90,Fail,57,28,1,14,43
90,Fail,44,34,1,21,23
90,Fail,46,37,4,13,33
90,Fail,50,32,0,11,39
90,Fail,52,29,0,17,35
90,Fail,46,36,3,15,31
90,Fail,50,40,0,8,42
90,Fail,48,40,0,9,39
90,Fail,47,36,0,7,40
90,Fail,47,37,3,13,34
90,Fail,45,44,1,10,35
90,Fail,43,38,9,10,33
90,Fail,56,29,0,10,46
90,Fail,50,37,3,10,40
90,Fail,54,34,0,12,42
90,Fail,53,37,3,7,46
90,Fail,41,44,1,14,27
90,Fail,49,37,6,8,41
90,Fail,51,33,5,11,40
90,Fail,46,40,0,13,33
90,Fail,56,35,0,9,47
90,Fail,47,37,2,14,33
90,Fail,56,30,0,14,42
90,Fail,48,35,1,16,32
90,Fail,51,36,1,12,39
90,Fail,61,26,0,13,48
90,Fail,50,35,2,13,37
90,Fail,48,42,2,8,40
90,Fail,61,24,2,13,48
90,Fail,46,39,7,8,38
90,Fail,52,30,0,13,39
90,Fail,46,28,0,20,26
90,Fail,48,31,1,20,28
90,Fail,49,31,3,17,32
90,Fail,58,34,0,6,52
90,Fail,39,40,0,16,23
90,Fail,49,42,1,8,41
90,Fail,52,35,3,10,42
90,Fail,46,38,1,15,31
90,Fail,60,31,2,7,53
90,Fail,51,35,2,12,39
90,Fail,52,31,0,8,44
90,Fail,54,38,0,6,48
90,Fail,49,38,1,12,37
90,Fail,49,38,2,11,38
90,Fail,42,39,0,14,28
90,Fail,44,40,6,10,34
90,Fail,55,33,1,11,44
90,Fail,48,33,0,15,33
90,Fail,49,28,0,16,33
90,Fail,43,36,0,15,28
90,Fail,38,36,0,17,21
90,Fail,58,26,1,15,43
90,Fail,37,34,10,19,18
90,Fail,38,42,0,18,20
90,Fail,48,38,2,12,36
90,Fail,43,41,4,12,31
90,Fail,40,41,0,11,29
90,Fail,55,32,4,9,46
90,Fail,48,34,7,11,37
90,Fail,50,33,4,13,37
90,Fail,52,33,3,12,40
90,Fail,60,32,1,7,53
90,Fail,53,28,0,14,39
90,Fail,47,36,0,17,30
90,Fail,46,41,0,8,38
90,Fail,44,31,11,14,30
90,Fail,49,30,7,14,35
90,Fail,47,36,7,10,37
90,Fail,47,34,4,15,32
90,Fail,45,35,3,17,28
90,Fail,46,36,0,12,34
90,Fail,51,37,2,10,41
90,Fail,51,38,2,9,42
90,Fail,44,35,6,15,29
90,Fail,52,41,1,6,46
90,Fail,42,39,4,15,27
90,Fail,54,31,0,10,44
90,Fail,54,33,5,8,46
90,Fail,58,25,2,15,43
90,Fail,45,41,0,10,35
90,Fail,49,36,3,12,37
90,Fail,53,34,0,10,43
90,Fail,51,34,2,13,38
90,Fail,44,38,3,15,29
90,Fail,51,37,1,11,40
90,Fail,48,40,0,9,39
90,Fail,56,27,8,9,47
90,Fail,53,32,3,12,41
90,Fail,56,34,2,8,48
90,Fail,40,35,0,17,23
90,Fail,52,34,0,14,38
90,Fail,53,33,3,11,42
90,Fail,37,35,0,18,19
90,Fail,50,33,0,16,34
90,Fail,48,39,3,10,38
90,Fail,46,43,2,9,37
90,Fail,50,32,3,15,35
90,Fail,61,25,0,12,49
90,Fail,44,37,2,17,27
90,Fail,49,37,0,13,36
90,Fail,47,35,6,12,35
90,Fail,44,41,0,14,30
90,Fail,41,35,7,17,24
90,Fail,56,31,0,12,44
90,Fail,53,32,5,10,43
90,Fail,45,39,0,12,33
90,Fail,41,36,8,15,26
90,Fail,50,41,0,9,41
90,Fail,54,33,0,11,43
90,Fail,51,37,5,7,44
90,Fail,52,30,0,18,34
90,Fail,41,44,1,14,27
90,Fail,50,36,1,13,37
90,Fail,47,32,0,18,29
90,Fail,56,30,0,9,47
90,Fail,54,32,1,13,41
90,Fail,56,37,0,7,49
90,Fail,44,43,2,11,33
90,Fail,47,36,0,10,37
90,Fail,44,40,0,13,31
90,Fail,35,41,6,18,17
90,Fail,42,35,10,13,29
90,Fail,49,31,0,15,34
90,Fail,50,29,4,17,33
90,Fail,57,29,0,8,49
90,Fail,51,29,0,13,38
90,Fail,52,35,3,10,42
90,Fail,44,26,0,17,27
90,Fail,50,37,0,11,39
90,Fail,42,41,0,16,26
90,Fail,37,44,0,13,24
90,Fail,51,34,0,12,39
90,Fail,55,30,0,15,40
90,Fail,44,36,5,15,29
90,Fail,49,31,5,15,34
90,Fail,51,34,0,14,37
90,Fail,40,40,5,15,25
90,Fail,47,28,0,24,23
90,Fail,44,39,1,16,28
90,Fail,46,26,13,15,31
90,Fail,50,41,3,6,44
90,Fail,52,30,2,16,36
90,Fail,55,29,4,12,43
90,Fail,43,40,0,16,27
90,Fail,52,34,0,12,40
90,Fail,42,34,0,21,21
90,Fail,40,40,6,14,26
90,Fail,39,37,7,17,22
90,Fail,51,40,0,8,43
90,Fail,49,32,0,10,39
90,Fail,52,34,2,12,40
90,Fail,50,34,0,15,35
90,Fail,45,33,0,16,29
90,Fail,50,34,7,9,41
90,Fail,44,46,0,9,35
90,Fail,47,36,9,8,39
90,Fail,51,28,0,15,36
90,Fail,46,36,0,15,31
90,Fail,46,35,5,14,32
90,Fail,45,39,0,14,31
90,Fail,48,38,5,9,39
90,Fail,46,40,1,13,33
90,Fail,47,39,0,14,33
90,Fail,48,36,2,14,34
90,Fail,50,33,0,14,36
90,Fail,47,34,0,13,34
90,Fail,39,43,5,13,26
90,Fail,56,32,0,9,47
90,Fail,46,36,3,15,31
90,Fail,53,36,2,9,44
90,Fail,50,35,1,14,36
90,Fail,46,37,0,13,33
90,Fail,45,35,0,17,28
90,Fail,43,39,0,17,26
90,Fail,47,37,4,12,35
90,Fail,44,40,3,13,31
90,Fail,52,37,5,6,46
90,Fail,41,47,0,12,29
90,Fail,53,38,0,9,44
90,Fail,55,28,0,13,42
90,Fail,41,30,0,17,24
90,Fail,42,37,10,11,31
90,Fail,44,41,4,11,33
90,Fail,50,34,0,14,36
90,Fail,44,40,0,16,28
90,Fail,47,38,0,13,34
90,Fail,51,36,5,8,43
90,Fail,43,36,6,15,28
90,Fail,50,36,2,12,38
90,Fail,48,34,5,13,35
90,Fail,55,29,3,13,42
90,Fail,53,35,0,12,41
90,Fail,45,37,6,12,33
90,Fail,46,32,8,14,32
90,Fail,54,34,2,10,44
90,Fail,50,34,0,10,40
90,Fail,47,34,1,18,29
90,Fail,48,40,1,11,37
90,Fail,50,31,0,10,40
90,Fail,50,33,0,17,33
90,Fail,51,28,0,15,36
90,Fail,50,39,0,9,41
90,Fail,40,39,0,13,27
90,Fail,54,33,2,11,43
90,Fail,46,36,3,15,31
90,Fail,49,38,7,6,43
90,Fail,44,33,5,18,26
90,Fail,50,30,2,18,32
90,Fail,47,34,0,14,33
90,Fail,45,31,0,19,26
90,Fail,49,27,3,21,28
90,Fail,51,33,6,10,41
90,Fail,42,34,0,14,28
90,Fail,45,40,0,7,38
90,Fail,50,30,0,14,36
90,Fail,50,35,3,12,38
90,Fail,53,34,1,12,41
90,Fail,49,37,0,12,37
90,Fail,49,27,0,17,32
90,Fail,52,33,2,13,39
90,Fail,51,33,1,15,36
90,Fail,46,35,3,16,30
90,Fail,44,35,5,16,28
90,Fail,48,35,0,11,37
90,Fail,45,39,7,9,36
90,Fail,44,47,0,9,35
90,Fail,41,39,0,19,22
90,Fail,44,40,3,13,31
90,Fail,52,33,6,9,43
90,Fail,42,35,0,16,26
90,Fail,53,31,2,14,39
90,Fail,49,35,0,10,39
90,Fail,52,27,12,9,43
90,Fail,42,29,0,16,26
90,Fail,50,31,6,13,37
90,Fail,51,31,0,13,38
90,Fail,60,29,0,10,50
90,Fail,55,36,0,7,48
90,Fail,48,35,2,15,33
90,Fail,48,34,5,13,35
90,Fail,53,36,0,11,42
90,Fail,43,42,4,11,32
90,Fail,48,42,1,9,39
90,Fail,52,35,4,9,43
90,Fail,49,31,7,13,36
90,Fail,43,37,6,14,29
90,Fail,46,41,0,12,34
90,Fail,44,35,0,17,27
90,Fail,53,33,0,11,42
90,Fail,55,36,3,6,49
90,Fail,51,29,11,9,42
90,Fail,46,35,0,15,31
90,Fail,55,34,0,8,47
90,Fail,54,35,3,8,46
90,Fail,50,36,0,12,38
90,Fail,45,41,2,12,33
90,Fail,51,33,5,11,40
90,Fail,50,30,7,13,37
90,Fail,48,33,0,15,33
90,Fail,47,33,6,14,33
90,Fail,44,35,8,13,31
90,Fail,44,36,0,15,29
90,Fail,50,32,6,12,38
90,Fail,42,40,0,14,28
90,Fail,53,37,0,9,44
90,Fail,53,25,11,11,42
90,Fail,49,31,6,14,35
90,Fail,54,34,3,9,45
90,Fail,46,33,0,14,32
90,Fail,42,41,0,12,30
90,Fail,43,44,3,10,33
90,Fail,59,28,0,9,50
90,Fail,38,41,1,20,18
90,Fail,53,34,0,9,44
90,Fail,42,32,0,24,18
90,Fail,51,34,4,11,40
90,Fail,47,31,5,17,30
90,Fail,52,33,0,12,40
90,Fail,48,39,0,10,38
90,Fail,48,34,0,15,33
90,Fail,56,36,4,4,52
90,Fail,52,37,1,10,42
90,Fail,50,34,0,11,39
90,Fail,49,26,0,14,35
90,Fail,54,36,0,8,46
90,Fail,42,40,3,15,27
90,Fail,45,37,0,13,32
90,Fail,49,38,1,12,37
90,Fail,51,33,0,10,41
90,Fail,44,37,5,14,30
90,Fail,51,40,2,7,44
90,Fail,52,28,9,11,41
90,Fail,49,36,2,13,36
90,Fail,50,37,3,10,40
90,Fail,40,46,1,13,27
90,Fail,46,40,0,12,34
90,Fail,55,30,4,11,44
90,Fail,41,31,0,13,28
90,Fail,49,32,0,14,35
90,Fail,44,37,0,19,25
90,Fail,49,37,0,11,38
90,Fail,57,31,7,5,52
90,Fail,56,25,5,14,42
90,Fail,46,28,0,13,33
90,Fail,51,25,11,13,38
90,Fail,46,38,0,13,33
90,Fail,50,36,0,14,36
90,Fail,39,39,0,14,25
90,Fail,52,31,4,13,39
90,Fail,47,38,0,8,39
90,Fail,50,34,3,13,37
90,Fail,57,36,1,6,51
90,Fail,38,42,1,19,19
90,Fail,47,40,0,12,35
90,Fail,43,29,0,19,24
90,Fail,50,30,0,13,37
90,Fail,46,38,0,14,32
90,Fail,46,40,6,8,38
90,Fail,47,38,2,13,34
90,Fail,48,33,0,14,34
90,Fail,40,45,2,13,27
90,Fail,51,35,0,13,38
90,Fail,49,37,2,12,37
90,Fail,53,30,0,17,36
90,Fail,48,39,2,11,37
90,Fail,52,34,0,12,40
90,Fail,46,45,1,8,38
90,Fail,52,31,0,16,36
90,Fail,55,27,1,17,38
90,Fail,51,33,0,15,36
90,Fail,51,38,0,11,40
90,Fail,41,43,0,14,27
90,Fail,54,30,0,8,46
90,Fail,56,33,2,9,47
90,Fail,52,33,2,13,39
90,Fail,45,35,8,12,33
90,Fail,62,26,0,7,55
90,Fail,53,32,5,10,43
90,Fail,38,40,0,13,25
90,Fail,50,38,0,12,38
90,Fail,40,34,0,14,26
90,Fail,48,37,0,15,33
90,Fail,54,30,0,13,41
90,Fail,49,40,1,10,39
90,Fail,46,42,0,11,35
90,Fail,44,33,3,20,24
90,Fail,41,42,0,10,31
90,Fail,44,37,5,14,30
90,Fail,43,35,0,13,30
90,Fail,50,39,1,10,40
90,Fail,57,25,0,17,40
90,Fail,46,42,0,10,36
90,Fail,47,39,3,11,36
90,Fail,52,29,0,19,33
90,Fail,49,39,0,9,40
90,Fail,46,41,0,13,33
90,Fail,43,35,0,16,27
90,Fail,49,38,0,9,40
90,Fail,49,38,3,10,39
90,Fail,54,39,0,7,47
90,Fail,48,31,0,14,34
90,Fail,50,34,2,14,36
90,Fail,47,32,0,16,31
90,Fail,49,30,0,20,29
90,Fail,49,31,3,17,32
90,Fail,48,35,0,14,34
90,Fail,51,34,0,12,39
90,Fail,57,37,0,6,51
90,Fail,51,39,0,10,41
90,Fail,47,37,0,12,35
90,Fail,44,37,5,14,30
90,Fail,46,37,5,12,34
90,Fail,51,37,0,11,40
90,Fail,47,33,0,20,27
90,Fail,50,40,1,9,41
90,Fail,52,30,5,13,39
90,Fail,49,38,1,12,37
90,Fail,49,34,1,16,33
90,Fail,47,35,0,11,36
90,Fail,46,37,0,16,30
90,Fail,48,36,0,14,34
90,Fail,50,35,0,12,38
90,Fail,45,41,1,13,32
90,Fail,50,40,1,9,41
90,Fail,54,33,2,11,43
90,Fail,47,31,0,11,36
90,Fail,47,30,0,15,32
90,Fail,47,35,0,13,34
90,Fail,47,43,1,9,38
90,Fail,45,38,0,14,31
90,Fail,53,39,3,5,48
90,Fail,42,32,0,9,33
90,Fail,45,40,1,14,31
90,Fail,47,39,6,8,39
90,Fail,42,43,2,13,29
90,Fail,46,40,1,13,33
90,Fail,44,40,0,16,28
90,Fail,47,38,0,10,37
90,Fail,48,30,8,14,34
90,Fail,44,37,4,15,29
90,Fail,49,28,0,10,39
90,Fail,47,31,0,13,34
90,Fail,50,31,0,15,35
90,Fail,46,37,0,17,29
90,Fail,47,30,0,14,33
90,Fail,50,37,0,13,37
90,Fail,51,27,0,12,39
90,Fail,44,36,0,16,28
90,Fail,51,33,2,14,37
90,Fail,42,37,5,16,26
90,Fail,52,33,0,15,37
90,Fail,53,39,2,6,47
90,Fail,42,40,5,13,29
90,Fail,47,35,6,12,35
90,Fail,51,27,7,15,36
90,Fail,47,42,0,11,36
90,Fail,49,37,4,10,39
90,Fail,47,41,2,10,37
90,Fail,43,36,0,17,26
90,Fail,49,38,0,12,37
90,Fail,49,40,0,7,42
90,Fail,47,41,1,11,36
90,Fail,46,38,0,16,30
90,Fail,44,40,0,10,34
90,Fail,51,37,0,10,41
90,Fail,43,33,3,21,22
90,Fail,43,36,0,10,33
90,Fail,55,35,3,7,48
90,Fail,51,38,0,9,42
90,Fail,40,40,0,13,27
90,Fail,54,32,4,10,44
90,Fail,49,30,6,15,34
90,Fail,59,29,0,11,48
90,Fail,47,32,0,15,32
90,Fail,54,38,2,6,48
90,Fail,45,41,1,13,32
90,Fail,54,35,0,10,44
90,Fail,44,39,6,11,33
90,Fail,42,42,3,13,29
90,Fail,42,36,8,14,28
90,Fail,53,29,0,9,44
90,Fail,47,37,0,16,31
90,Fail,52,34,0,8,44
90,Fail,52,32,0,14,38
90,Fail,47,37,0,12,35
90,Fail,46,37,10,7,39
90,Fail,50,35,0,13,37
90,Fail,45,36,4,15,30
90,Fail,54,36,3,7,47
90,Fail,42,40,0,9,33
90,Fail,48,33,0,17,31
90,Fail,51,36,1,12,39
90,Fail,51,33,0,11,40
90,Fail,50,42,2,6,44
90,Fail,43,36,0,12,31
90,Fail,46,39,2,13,33
90,Fail,55,26,0,9,46
90,Fail,40,46,3,11,29
90,Fail,44,32,8,16,28
90,Fail,51,31,0,11,40
90,Fail,49,36,0,15,34
90,Fail,48,34,0,16,32
90,Fail,53,32,0,10,43
90,Fail,38,41,0,15,23
90,Fail,49,27,0,14,35
90,Fail,48,35,0,9,39
90,Fail,44,30,8,18,26
90,Fail,47,43,0,8,39
90,Fail,39,29,11,21,18
90,Fail,47,34,0,19,28
90,Fail,48,34,7,11,37
90,Fail,44,31,0,18,26
90,Fail,48,37,0,12,36
90,Fail,54,34,3,9,45
90,Fail,52,31,2,15,37
90,Fail,49,40,0,6,43
90,Fail,52,32,0,16,36
90,Fail,43,38,0,10,33
90,Fail,46,35,0,16,30
90,Fail,46,42,0,11,35
90,Fail,53,33,0,13,40
90,Fail,52,36,0,10,42
90,Fail,54,35,0,3,51
90,Fail,52,39,0,8,44
90,Fail,57,28,0,15,42
90,Fail,48,34,0,16,32
90,Fail,49,38,0,12,37
90,Fail,50,34,0,12,38
90,Fail,46,36,5,13,33
90,Fail,44,32,13,11,33
90,Fail,43,37,5,15,28
90,Fail,48,39,0,8,40
90,Fail,50,39,0,8,42
90,Fail,48,37,5,10,38
90,Fail,43,34,0,12,31
90,Fail,48,32,2,18,30
90,Fail,38,36,6,20,18
90,Fail,46,35,0,13,33
90,Fail,45,38,0,17,28
90,Fail,47,35,5,13,34
90,Fail,49,33,2,16,33
90,Fail,42,38,2,18,24
90,Fail,50,35,0,10,40
90,Fail,46,41,0,9,37
90,Fail,47,36,2,15,32
90,Fail,45,35,6,14,31
90,Fail,52,34,1,13,39
90,Fail,49,32,2,17,32
90,Fail,46,39,2,13,33
90,Fail,56,33,3,8,48
90,Fail,44,42,0,11,33
90,Fail,49,33,0,16,33
90,Fail,42,35,12,11,31
90,Fail,48,36,0,10,38
90,Fail,47,32,0,16,31
90,Fail,46,32,7,15,31
90,Fail,39,36,10,15,24
90,Fail,44,43,2,11,33
90,Fail,46,35,0,13,33
90,Fail,42,38,0,13,29
90,Fail,52,31,0,8,44
90,Fail,40,41,3,16,24
90,Fail,48,40,1,11,37
90,Fail,46,40,1,13,33
90,Fail,47,33,0,15,32
90,Fail,50,39,1,10,40
90,Fail,45,42,1,12,33
90,Fail,38,36,14,12,26
90,Fail,49,33,0,16,33
90,Fail,54,32,0,11,43
90,Fail,39,40,8,13,26
90,Fail,47,30,10,13,34
90,Fail,52,32,7,9,43
90,Fail,47,30,0,16,31
90,Fail,51,34,0,14,37
90,Fail,56,30,2,12,44
90,Fail,47,36,0,14,33
90,Fail,46,38,0,15,31
90,Fail,47,37,0,11,36
90,Fail,50,35,1,14,36
90,Fail,39,42,0,17,22
90,Fail,49,30,3,18,31
90,Fail,47,29,11,13,34
90,Fail,48,40,0,9,39
90,Fail,42,38,0,18,24
90,Fail,48,35,0,16,32
90,Fail,50,31,0,18,32
90,Fail,46,35,0,10,36
90,Fail,55,33,0,10,45
90,Fail,49,27,4,20,29
90,Fail,50,30,0,17,33
90,Fail,52,33,2,13,39
90,Fail,44,32,0,15,29
90,Fail,51,37,0,11,40
90,Fail,45,41,0,12,33
90,Fail,45,35,0,19,26
90,Fail,51,37,1,11,40
90,Fail,55,30,5,10,45
90,Fail,42,33,12,13,29
90,Fail,49,36,1,14,35
90,Fail,54,32,0,10,44
90,Fail,43,36,0,10,33
90,Fail,51,38,0,9,42
90,Fail,38,38,0,12,26
90,Fail,48,29,8,15,33
90,Fail,42,30,0,14,28
90,Fail,52,30,2,16,36
90,Fail,50,31,0,15,35
90,Fail,42,47,6,5,37
90,Fail,46,36,3,15,31
90,Fail,48,33,7,12,36
90,Fail,46,42,0,9,37
90,Fail,46,40,3,11,35
90,Fail,50,35,0,14,36
90,Fail,51,31,0,14,37
90,Fail,51,31,4,14,37
90,Fail,49,32,3,16,33
90,Fail,48,39,0,13,35
90,Fail,44,36,3,17,27
90,Fail,53,29,0,15,38
90,Fail,44,35,5,16,28
90,Fail,44,37,0,13,31
90,Fail,50,33,0,13,37
90,Fail,48,35,5,12,36
90,Fail,45,36,0,14,31
90,Fail,44,40,0,11,33
90,Fail,53,29,0,11,42
90,Fail,43,31,0,17,26
90,Fail,45,36,6,13,32
90,Fail,49,34,0,16,33
90,Fail,45,34,1,20,25
90,Fail,51,40,1,8,43
90,Fail,45,33,0,16,29
90,Fail,55,32,0,11,44
90,Fail,40,44,0,14,26
90,Fail,46,40,3,11,35
90,Fail,44,35,2,19,25
90,Fail,49,40,1,10,39
90,Fail,52,28,8,12,40
90,Fail,47,34,6,13,34
90,Fail,45,34,0,15,30
90,Fail,52,39,0,8,44
90,Fail,45,42,0,13,32
90,Fail,52,31,0,14,38
90,Fail,43,42,0,8,35
90,Fail,53,32,0,14,39
90,Fail,49,38,0,10,39
90,Fail,40,43,0,11,29
90,Fail,53,35,0,12,41
90,Fail,42,44,3,11,31
90,Fail,46,44,1,9,37
90,Fail,49,38,2,11,38
90,Fail,43,35,0,14,29
90,Fail,45,36,5,14,31
90,Fail,47,41,0,9,38
90,Fail,44,43,1,12,32
90,Fail,52,37,2,9,43
90,Fail,40,28,13,19,21
90,Fail,54,36,0,10,44
90,Fail,57,37,0,6,51
90,Fail,51,38,0,11,40
90,Fail,37,40,4,19,18
90,Fail,48,34,0,13,35
90,Fail,48,40,3,9,39
90,Fail,56,26,0,13,43
90,Fail,38,40,3,19,19
90,Fail,54,31,1,14,40
90,Fail,52,38,0,9,43
90,Fail,51,33,0,12,39
90,Fail,42,37,4,17,25
90,Fail,58,32,2,8,50
90,Fail,55,29,0,15,40
90,Fail,49,38,0,13,36
90,Fail,45,34,5,16,29
90,Fail,53,33,1,13,40
90,Fail,54,38,0,6,48
90,Fail,47,34,0,6,41
90,Fail,50,30,3,17,33
90,Fail,53,32,0,12,41
90,Fail,43,38,3,16,27
90,Fail,39,39,0,18,21
90,Fail,46,40,2,12,34
90,Fail,49,36,4,11,38
90,Fail,41,32,0,24,17
90,Fail,47,32,0,11,36
90,Fail,47,33,8,12,35
90,Fail,55,30,5,10,45
90,Fail,46,35,0,13,33
90,Fail,48,34,0,16,32
90,Fail,39,43,0,11,28
90,Fail,42,40,3,15,27
90,Fail,53,32,0,12,41
90,Fail,52,39,0,8,44
90,Fail,37,50,3,10,27
90,Fail,47,34,6,13,34
90,Fail,50,39,2,9,41
90,Fail,60,27,0,13,47
90,Fail,47,29,6,18,29
90,Fail,48,38,3,11,37
90,Fail,54,30,0,14,40
90,Fail,53,29,0,9,44
90,Fail,53,33,0,10,43
90,Fail,55,34,0,10,45
90,Fail,49,31,0,9,40
90,Fail,51,31,4,14,37
90,Fail,50,38,0,9,41
90,Fail,47,32,8,13,34
90,Fail,46,42,0,10,36
90,Fail,39,41,0,9,30
90,Fail,50,32,0,15,35
90,Fail,53,25,0,17,36
90,Fail,39,39,0,15,24
90,Fail,56,30,0,9,47
90,Fail,50,32,5,13,37
90,Fail,57,27,5,11,46
90,Fail,50,39,2,9,41
90,Fail,44,39,6,11,33
90,Fail,40,42,1,17,23
90,Fail,48,41,0,11,37
90,Fail,53,29,0,15,38
90,Fail,48,35,0,14,34
90,Fail,46,36,0,14,32
90,Fail,42,42,0,14,28
90,Fail,51,38,0,9,42
90,Fail,55,34,2,9,46
90,Fail,48,37,0,13,35
90,Fail,38,36,11,15,23
90,Fail,45,35,0,18,27
90,Fail,53,34,8,5,48
90,Fail,45,42,4,9,36
90,Fail,49,39,5,7,42
90,Fail,60,29,0,9,51
90,Fail,48,36,0,11,37
90,Fail,50,39,2,9,41
90,Fail,47,35,0,16,31
90,Fail,47,43,2,8,39
90,Fail,45,42,1,12,33
90,Fail,44,36,7,13,31
90,Fail,47,36,0,17,30
90,Fail,45,42,1,12,33
90,Fail,48,38,0,11,37
90,Fail,41,31,8,20,21
90,Fail,46,39,0,12,34
90,Fail,47,30,12,11,36
90,Fail,53,33,1,13,40
90,Fail,45,41,4,10,35
90,Fail,53,32,0,12,41
90,Fail,46,37,2,15,31
90,Fail,53,28,0,9,44
90,Fail,47,40,1,12,35
90,Fail,38,39,2,21,17
90,Fail,53,36,0,8,45
90,Fail,45,45,0,9,36
90,Fail,47,41,0,12,35
90,Fail,50,32,0,17,33
90,Fail,50,41,0,8,42
90,Fail,50,36,0,9,41
90,Fail,55,31,8,6,49
90,Fail,48,33,0,12,36
90,Fail,48,36,0,16,32
90,Fail,51,34,0,15,36
90,Fail,47,39,1,13,34
90,Fail,52,34,0,9,43
90,Fail,34,34,0,20,14
90,Fail,48,39,2,11,37
90,Fail,46,39,0,13,33
90,Fail,42,38,0,17,25
90,Fail,46,37,0,13,33
90,Fail,52,36,0,12,40
90,Fail,45,39,6,10,35
90,Fail,46,44,0,9,37
90,Fail,42,45,0,10,32
90,Fail,50,34,2,14,36
90,Fail,47,42,0,9,38
90,Fail,41,42,9,8,33
90,Fail,52,36,0,9,43
90,Fail,41,43,4,12,29
90,Fail,50,34,0,8,42
90,Fail,52,28,2,18,34
90,Fail,45,38,0,14,31
90,Fail,49,38,0,9,40
90,Fail,48,29,0,17,31
90,Fail,51,34,0,14,37
90,Fail,45,37,0,10,35
90,Fail,41,42,8,9,32
90,Fail,47,32,8,13,34
90,Fail,52,37,0,11,41
90,Fail,47,38,0,15,32
90,Fail,46,43,0,10,36
90,Fail,46,40,0,13,33
90,Fail,56,36,0,8,48
90,Fail,47,36,4,13,34
90,Fail,51,29,0,17,34
90,Fail,44,38,0,12,32
90,Fail,56,32,2,10,46
90,Fail,48,30,0,13,35
90,Fail,45,35,0,11,34
90,Fail,47,29,0,14,33
90,Fail,39,38,11,12,27
90,Fail,52,34,0,11,41
90,Fail,49,35,2,14,35
90,Fail,58,31,2,9,49
90,Fail,49,40,0,10,39
90,Fail,47,38,0,9,38
90,Fail,60,24,0,14,46
90,Fail,45,38,0,14,31
90,Fail,42,38,7,13,29
90,Fail,57,24,0,9,48
90,Fail,47,32,2,19,28
90,Fail,49,35,0,12,37
90,Fail,46,39,5,10,36
90,Fail,48,36,2,14,34
90,Fail,51,25,0,12,39
90,Fail,45,33,2,20,25
90,Fail,51,38,0,9,42
90,Fail,46,38,2,14,32
90,Fail,54,33,1,12,42
90,Fail,53,30,4,13,40
90,Fail,50,30,8,12,38
90,Fail,55,32,0,8,47
90,Fail,41,46,0,11,30
90,Fail,41,42,8,9,32
90,Fail,43,36,0,18,25
90,Fail,53,35,4,8,45
90,Fail,48,39,4,9,39
90,Fail,45,40,0,12,33
90,Fail,51,36,0,12,39
90,Fail,55,26,6,13,42
90,Fail,41,45,0,11,30
90,Fail,43,44,2,11,32
90,Fail,49,35,0,12,37
90,Fail,42,37,3,18,24
90,Fail,50,33,8,9,41
90,Fail,44,42,1,13,31
90,Fail,48,37,0,11,37
90,Fail,46,31,10,13,33
90,Fail,42,37,4,17,25
90,Fail,42,46,0,9,33
90,Fail,46,44,0,6,40
90,Fail,49,30,0,16,33
90,Fail,43,41,4,12,31
90,Fail,41,35,11,13,28
90,Fail,54,30,3,13,41
90,Fail,47,33,7,13,34
90,Fail,47,40,5,8,39
90,Fail,46,35,1,18,28
90,Fail,47,36,0,13,34
90,Fail,49,41,0,8,41
90,Fail,40,36,0,19,21
90,Fail,53,29,0,11,42
90,Fail,50,36,3,11,39
90,Fail,55,29,2,14,41
90,Fail,47,43,1,9,38
90,Fail,50,31,0,15,35
90,Fail,44,35,11,10,34
90,Fail,42,40,0,13,29
90,Fail,48,37,5,10,38
90,Fail,46,42,0,12,34
90,Fail,48,43,0,9,39
90,Fail,44,32,0,17,27
90,Fail,51,36,1,12,39
90,Fail,47,37,3,13,34
90,Fail,44,39,6,11,33
90,Fail,45,30,8,17,28
90,Fail,50,32,2,16,34
90,Fail,45,35,11,9,36
90,Fail,47,43,0,5,42
90,Fail,47,36,4,13,34
90,Fail,44,44,0,11,33
90,Fail,45,33,0,20,25
90,Fail,42,36,0,15,27
90,Fail,52,32,2,14,38
90,Fail,49,26,5,20,29
90,Fail,51,25,0,16,35
90,Fail,45,39,0,15,30
90,Fail,42,46,0,11,31
90,Fail,49,38,0,11,38
90,Fail,49,32,0,15,34
90,Fail,46,30,0,17,29
90,Fail,49,37,0,14,35
90,Fail,55,24,0,16,39
90,Fail,40,39,0,15,25
90,Fail,44,38,6,12,32
90,Fail,43,50,0,6,37
90,Fail,51,33,0,11,40
90,Fail,53,36,0,11,42
90,Fail,44,41,0,13,31
90,Fail,37,40,0,19,18
90,Fail,52,37,0,9,43
90,Fail,51,32,0,13,38
90,Fail,48,37,3,12,36
90,Fail,49,40,0,10,39
90,Fail,47,38,3,12,35
90,Fail,51,38,0,11,40
90,Fail,53,33,0,14,39
90,Fail,47,38,1,14,33
90,Fail,44,41,0,14,30
90,Fail,51,33,0,16,35
90,Fail,40,43,0,15,25
90,Fail,55,35,4,6,49
90,Fail,49,34,0,14,35
90,Fail,53,33,0,9,44
90,Fail,47,29,6,18,29
90,Fail,46,37,0,14,32
90,Fail,47,39,0,10,37
90,Fail,44,35,0,13,31
90,Fail,52,29,7,12,40
90,Fail,47,43,0,9,38
90,Fail,54,36,0,9,45
90,Fail,47,41,1,11,36
90,Fail,56,34,0,6,50
90,Fail,53,33,0,12,41
90,Fail,49,30,0,16,33
90,Fail,48,40,0,10,38
90,Fail,47,32,0,18,29
90,Fail,49,37,3,11,38
90,Fail,52,33,0,13,39
90,Fail,48,29,0,20,28
90,Fail,47,43,0,10,37
90,Fail,45,39,0,13,32
90,Fail,46,35,2,17,29
90,Fail,51,32,0,14,37
90,Fail,48,35,0,16,32
90,Fail,52,30,5,13,39
90,Fail,48,39,0,13,35
90,Fail,46,38,0,13,33
90,Fail,53,33,0,14,39
90,Fail,54,32,0,12,42
90,Fail,36,43,0,11,25
90,Fail,53,35,2,10,43
90,Fail,38,41,0,16,22
90,Fail,52,35,1,12,40
90,Fail,45,38,3,14,31
90,Fail,43,38,4,15,28
90,Fail,47,36,4,13,34
90,Fail,46,49,0,5,41
90,Fail,47,36,0,17,30
90,Fail,48,31,0,17,31
90,Fail,53,39,1,7,46
90,Fail,46,30,9,15,31
90,Fail,48,37,0,7,41
90,Fail,42,39,8,11,31
90,Fail,49,37,1,13,36
90,Fail,50,33,0,14,36
90,Fail,42,46,0,8,34
90,Fail,47,34,0,16,31
90,Fail,51,37,4,8,43
90,Fail,52,29,0,19,33
90,Fail,46,33,0,21,25
90,Fail,48,36,0,14,34
90,Fail,45,39,0,11,34
90,Fail,45,36,2,17,28
90,Fail,50,36,0,11,39
90,Fail,53,30,0,14,39
90,Fail,46,36,4,14,32
90,Fail,49,33,4,14,35
90,Fail,41,41,0,12,29
90,Fail,49,37,0,8,41
90,Fail,43,43,0,11,32
90,Fail,43,47,2,8,35
90,Fail,39,35,11,15,24
90,Fail,45,41,0,9,36
90,Fail,47,33,3,17,30
90,Fail,39,40,0,17,22
90,Fail,44,38,8,10,34
90,Fail,53,29,0,14,39
90,Fail,46,43,0,10,36
90,Fail,51,35,0,11,40
90,Fail,45,38,3,14,31
90,Fail,53,32,0,14,39
90,Fail,50,35,5,10,40
90,Fail,46,34,0,12,34
90,Fail,47,40,4,9,38
90,Fail,47,39,0,11,36
90,Fail,49,35,4,12,37
90,Fail,48,33,0,16,32
90,Fail,48,34,8,10,38
90,Fail,48,34,5,13,35
90,Fail,43,37,8,12,31
90,Fail,39,38,0,16,23
90,Fail,49,28,10,13,36
90,Fail,46,29,4,21,25
90,Fail,51,35,0,8,43
90,Fail,47,40,0,12,35
90,Fail,51,38,0,8,43
90,Fail,51,41,2,6,45
90,Fail,48,40,8,4,44
90,Fail,44,34,6,16,28
90,Fail,45,37,7,11,34
90,Fail,39,38,0,15,24
90,Fail,54,31,7,8,46
90,Fail,53,35,2,10,43
90,Fail,45,43,0,9,36
90,Fail,48,39,0,10,38
90,Fail,55,31,0,14,41
90,Fail,50,38,0,10,40
90,Fail,50,37,4,9,41
90,Fail,55,33,0,11,44
90,Fail,53,35,0,11,42
90,Fail,52,40,0,8,44
90,Fail,52,34,0,10,42
90,Fail,49,38,0,9,40
90,Fail,47,27,8,18,29
90,Fail,53,32,5,10,43
90,Fail,49,37,5,9,40
90,Fail,49,34,0,8,41
90,Fail,44,37,5,14,30
90,Fail,44,37,0,12,32
90,Fail,47,33,0,12,35
90,Fail,46,33,0,17,29
90,Fail,50,35,0,10,40
90,Fail,45,29,9,17,28
90,Fail,47,33,0,11,36
90,Fail,54,35,0,10,44
90,Fail,48,29,0,12,36
90,Fail,41,38,2,19,22
90,Fail,52,34,0,9,43
90,Fail,43,41,5,11,32
90,Fail,49,30,0,13,36
90,Fail,46,35,0,14,32
90,Fail,48,39,2,11,37
90,Fail,39,44,0,15,24
90,Fail,41,45,4,10,31
90,Fail,52,38,0,9,43
90,Fail,44,41,3,12,32
90,Fail,47,43,0,10,37
90,Fail,44,30,6,20,24
90,Fail,51,29,0,14,37
90,Fail,53,37,0,9,44
90,Fail,47,34,0,16,31
90,Fail,55,33,3,9,46
90,Fail,46,28,0,23,23
90,Fail,53,34,0,12,41
90,Fail,47,40,0,10,37
90,Fail,48,34,0,14,34
90,Fail,49,39,0,12,37
90,Fail,53,31,2,14,39
90,Fail,50,32,0,17,33
90,Fail,44,38,6,12,32
90,Fail,45,46,0,9,36
90,Fail,39,36,5,20,19
90,Fail,39,45,0,7,32
90,Fail,50,34,0,12,38
90,Fail,49,38,1,12,37
90,Fail,44,39,0,10,34
90,Fail,52,35,3,10,42
90,Fail,54,36,0,9,45
90,Fail,52,35,3,10,42
90,Fail,47,34,4,15,32
90,Fail,47,35,0,18,29
90,Fail,45,36,0,13,32
90,Fail,50,29,0,11,39
90,Fail,46,35,5,14,32
90,Fail,50,30,8,12,38
90,Fail,59,34,0,7,52
90,Fail,44,46,0,8,36
90,Fail,52,27,8,13,39
90,Fail,46,41,1,12,34
90,Fail,43,29,0,18,25
90,Fail,52,35,2,11,41
90,Fail,50,35,0,10,40
90,Fail,43,42,0,7,36
90,Fail,46,39,0,13,33
90,Fail,49,34,1,16,33
90,Fail,50,32,0,11,39
90,Fail,54,36,0,10,44
90,Fail,40,34,0,17,23
90,Fail,44,41,0,12,32
90,Fail,56,34,0,9,47
90,Fail,46,30,14,10,36
90,Fail,45,38,7,10,35
90,Fail,49,39,0,7,42
90,Fail,47,39,0,9,38
90,Fail,53,41,1,5,48
90,Fail,51,37,0,10,41
90,Fail,47,35,0,15,32
90,Fail,54,31,3,12,42
90,Fail,41,47,0,11,30
90,Fail,46,39,3,12,34
90,Fail,45,39,0,11,34
90,Fail,53,35,0,10,43
90,Fail,48,37,1,14,34
90,Fail,58,30,0,10,48
90,Fail,53,37,0,7,46
90,Fail,50,24,11,15,35
90,Fail,47,33,0,7,40
90,Fail,46,43,0,9,37
90,Fail,51,38,2,9,42
90,Fail,47,40,4,9,38
90,Fail,39,41,0,13,26
90,Fail,48,38,4,10,38
90,Fail,34,44,9,13,21
90,Fail,47,42,1,10,37
90,Fail,47,33,0,14,33
90,Fail,49,32,0,17,32
90,Fail,41,37,0,17,24
100,Fail,42,36,9,13,29
100,Fail,49,36,3,12,37
100,Fail,46,41,0,13,33
100,Fail,46,26,0,17,29
100,Fail,49,31,0,13,36
100,Fail,49,36,3,12,37
100,Fail,50,28,0,15,35
100,Fail,51,37,0,12,39
100,Fail,46,39,0,14,32
100,Fail,53,32,0,14,39
100,Fail,49,35,1,15,34
100,Fail,43,30,13,14,29
100,Fail,48,30,7,15,33
100,Fail,41,33,7,19,22
100,Fail,51,33,3,13,38
100,Fail,51,39,0,10,41
100,Fail,44,34,8,14,30
100,Fail,48,29,0,15,33
100,Fail,48,34,0,14,34
100,Fail,53,38,0,9,44
100,Fail,49,30,7,14,35
100,Fail,52,34,0,14,38
100,Fail,41,36,0,12,29
100,Fail,53,33,0,14,39
100,Fail,47,33,5,15,32
100,Fail,39,30,12,19,20
100,Fail,49,38,0,10,39
100,Fail,51,33,0,9,42
100,Fail,50,38,0,12,38
100,Fail,43,37,5,15,28
100,Fail,42,37,0,11,31
100,Fail,48,40,2,10,38
100,Fail,43,47,0,10,33
100,Fail,47,38,0,14,33
100,Fail,45,38,2,15,30
100,Fail,53,34,0,12,41
100,Fail,53,37,0,9,44
100,Fail,51,39,0,10,41
100,Fail,42,39,0,15,27
100,Fail,57,31,0,11,46
100,Fail,52,32,4,12,40
100,Fail,59,30,5,6,53
100,Fail,47,43,0,5,42
100,Fail,43,40,8,9,34
100,Fail,53,28,3,16,37
100,Fail,48,38,0,8,40
100,Fail,38,39,0,17,21
100,Fail,50,32,0,9,41
100,Fail,46,31,0,17,29
100,Fail,50,33,0,17,33
100,Fail,47,32,0,15,32
100,Fail,38,37,0,18,20
100,Fail,41,34,0,15,26
100,Fail,60,30,0,9,51
100,Fail,45,41,0,13,32
100,Fail,43,43,0,11,32
100,Fail,52,38,0,9,43
100,Fail,44,38,0,13,31
100,Fail,51,35,1,13,38
100,Fail,41,39,8,12,29
100,Fail,55,36,1,8,47
100,Fail,45,41,0,13,32
100,Fail,50,39,0,11,39
100,Fail,43,36,3,18,25
100,Fail,42,42,2,14,28
100,Fail,48,35,0,14,34
100,Fail,50,31,4,15,35
100,Fail,53,29,0,18,35
100,Fail,51,35,1,13,38
100,Fail,41,45,3,11,30
100,Fail,42,35,0,18,24
100,Fail,55,32,3,10,45
100,Fail,46,40,0,14,32
100,Fail,42,36,0,13,29
100,Fail,51,41,1,7,44
100,Fail,46,44,0,10,36
100,Fail,49,42,1,8,41
100,Fail,49,33,0,13,36
100,Fail,51,28,8,13,38
100,Fail,47,39,0,10,37
100,Fail,47,37,0,15,32
100,Fail,33,43,9,15,18
100,Fail,51,37,0,12,39
100,Fail,47,32,0,13,34
100,Fail,45,37,4,14,31
100,Fail,47,35,5,13,34
100,Fail,35,42,0,18,17
100,Fail,54,29,2,15,39
100,Fail,45,37,0,11,34
100,Fail,53,32,2,13,40
100,Fail,55,31,0,9,46
100,Fail,56,33,2,9,47
100,Fail,55,33,0,9,46
100,Fail,47,39,2,12,35
100,Fail,47,41,0,11,36
100,Fail,48,36,4,12,36
100,Fail,44,41,0,15,29
100,Fail,47,40,1,12,35
100,Fail,51,41,0,6,45
100,Fail,52,39,4,5,47
100,Fail,52,34,0,10,42
100,Fail,43,37,2,18,25
100,Fail,49,37,0,13,36
100,Fail,52,29,0,13,39
100,Fail,48,29,5,18,30
100,Fail,50,42,0,6,44
100,Fail,48,37,6,9,39
100,Fail,50,28,5,17,33
100,Fail,50,34,0,15,35
100,Fail,56,36,0,8,48
100,Fail,54,32,0,12,42
100,Fail,51,34,0,12,39
100,Fail,52,28,0,19,33
100,Fail,47,37,8,8,39
100,Fail,54,31,0,10,44
100,Fail,41,38,0,17,24
100,Fail,50,34,11,5,45
100,Fail,54,36,0,10,44
100,Fail,46,31,0,21,25
100,Fail,51,35,0,14,37
100,Fail,41,44,5,10,31
100,Fail,43,37,4,16,27
100,Fail,49,32,0,17,32
100,Fail,49,38,3,10,39
100,Fail,42,44,1,13,29
100,Fail,47,37,5,11,36
100,Fail,50,35,0,11,39
100,Fail,43,36,4,17,26
100,Fail,46,36,5,13,33
100,Fail,43,29,8,20,23
100,Fail,53,35,0,12,41
100,Fail,38,43,8,11,27
100,Fail,51,36,0,10,41
100,Fail,48,37,0,12,36
100,Fail,48,31,0,17,31
100,Fail,51,32,1,16,35
100,Fail,47,40,0,12,35
100,Fail,54,26,0,12,42
100,Fail,44,34,0,15,29
100,Fail,47,38,0,15,32
100,Fail,46,38,0,14,32
100,Fail,42,40,3,15,27
100,Fail,49,34,0,15,34
100,Fail,41,39,6,14,27
100,Fail,50,35,0,9,41
100,Fail,49,41,2,8,41
100,Fail,57,33,0,10,47
100,Fail,44,37,5,14,30
100,Fail,57,29,0,11,46
100,Fail,52,38,4,6,46
100,Fail,45,35,12,8,37
100,Fail,46,38,0,14,32
100,Fail,46,38,4,12,34
100,Fail,50,33,0,11,39
100,Fail,37,40,0,8,29
100,Fail,49,37,0,11,38
100,Fail,50,32,0,9,41
100,Fail,52,30,2,16,36
100,Fail,47,42,1,10,37
100,Fail,47,38,0,13,34
100,Fail,40,35,0,17,23
100,Fail,48,38,0,14,34
100,Fail,47,40,1,12,35
100,Fail,43,37,6,14,29
100,Fail,47,32,7,14,33
100,Fail,46,37,4,13,33
100,Fail,46,38,1,15,31
100,Fail,44,33,0,17,27
100,Fail,44,47,0,8,36
100,Fail,54,35,0,11,43
100,Fail,52,32,0,12,40
100,Fail,50,34,0,10,40
100,Fail,38,45,0,7,31
100,Fail,46,38,2,14,32
100,Fail,51,33,0,15,36
100,Fail,48,35,0,16,32
100,Fail,45,37,4,14,31
100,Fail,49,34,7,10,39
100,Fail,44,38,2,16,28
100,Fail,52,29,0,11,41
100,Fail,49,33,7,11,38
100,Fail,42,40,5,13,29
100,Fail,42,36,0,20,22
100,Fail,53,31,2,14,39
100,Fail,53,31,0,8,45
100,Fail,51,32,0,12,39
100,Fail,57,26,0,14,43
100,Fail,47,33,0,12,35
100,Fail,52,34,0,12,40
100,Fail,33,42,0,12,21
100,Fail,43,34,0,14,29
100,Fail,55,37,0,8,47
100,Fail,46,40,2,12,34
100,Fail,49,31,5,15,34
100,Fail,46,34,3,17,29
100,Fail,50,36,0,12,38
100,Fail,49,38,0,10,39
100,Fail,56,35,0,9,47
100,Fail,44,33,9,14,30
100,Fail,47,41,1,11,36
100,Fail,50,41,0,9,41
100,Fail,56,31,0,10,46
100,Fail,48,39,2,11,37
100,Fail,45,35,3,17,28
100,Fail,47,39,6,8,39
100,Fail,41,37,6,16,25
100,Fail,38,45,0,10,28
100,Fail,48,39,1,12,36
100,Fail,50,35,4,11,39
100,Fail,46,35,0,17,29
100,Fail,40,42,0,13,27
100,Fail,50,31,1,18,32
100,Fail,60,30,1,9,51
100,Fail,43,47,1,9,34
100,Fail,49,37,0,10,39
100,Fail,50,29,9,12,38
100,Fail,42,38,4,16,26
100,Fail,49,35,6,10,39
100,Fail,51,29,0,13,38
100,Fail,51,34,7,8,43
100,Fail,47,37,2,14,33
100,Fail,45,43,5,7,38
100,Fail,41,38,7,14,27
100,Fail,47,37,0,10,37
100,Fail,51,35,4,10,41
100,Fail,48,39,0,13,35
100,Fail,53,33,0,7,46
100,Fail,51,35,0,14,37
100,Fail,45,33,6,16,29
100,Fail,45,36,1,18,27
100,Fail,52,38,0,10,42
100,Fail,41,37,8,14,27
100,Fail,52,34,0,13,39
100,Fail,53,32,0,9,44
100,Fail,55,29,3,13,42
100,Fail,49,32,0,13,36
100,Fail,44,36,0,20,24
100,Fail,52,26,1,21,31
100,Fail,47,39,0,11,36
100,Fail,53,34,0,11,42
100,Fail,43,35,0,14,29
100,Fail,44,42,2,12,32
100,Fail,45,36,0,12,33
100,Fail,51,35,0,13,38
100,Fail,46,44,0,9,37
100,Fail,57,32,0,8,49
100,Fail,51,31,0,10,41
100,Fail,47,36,0,14,33
100,Fail,53,36,0,11,42
100,Fail,47,39,0,13,34
100,Fail,49,29,0,14,35
100,Fail,50,33,0,16,34
100,Fail,53,35,0,11,42
100,Fail,44,35,0,16,28
100,Fail,42,37,0,14,28
100,Fail,50,40,0,9,41
100,Fail,51,33,6,10,41
100,Fail,49,31,0,12,37
100,Fail,51,33,0,15,36
100,Fail,53,35,0,12,41
100,Fail,48,28,0,13,35
100,Fail,52,31,8,9,43
100,Fail,51,31,0,11,40
100,Fail,48,35,0,12,36
100,Fail,52,34,6,8,44
100,Fail,43,34,0,12,31
100,Fail,51,37,0,9,42
100,Fail,51,32,0,17,34
100,Fail,48,33,0,15,33
100,Fail,39,47,0,13,26
100,Fail,37,39,0,16,21
100,Fail,52,33,5,10,42
100,Fail,49,35,0,15,34
100,Fail,53,34,2,11,42
100,Fail,46,33,7,14,32
100,Fail,43,29,8,20,23
100,Fail,45,45,0,7,38
100,Fail,48,34,2,16,32
100,Fail,48,41,6,5,43
100,Fail,37,48,2,13,24
100,Fail,55,28,0,13,42
100,Fail,51,36,4,9,42
100,Fail,51,33,3,13,38
100,Fail,42,39,1,18,24
100,Fail,51,30,5,14,37
100,Fail,48,37,6,9,39
100,Fail,50,36,1,13,37
100,Fail,41,37,10,12,29
100,Fail,48,41,0,10,38
100,Fail,39,40,5,16,23
100,Fail,48,41,0,9,39
100,Fail,52,31,0,14,38
100,Fail,44,39,0,14,30
100,Fail,54,34,3,9,45
100,Fail,48,44,1,7,41
100,Fail,51,35,3,11,40
100,Fail,53,32,3,12,41
100,Fail,51,36,0,10,41
100,Fail,50,33,0,13,37
100,Fail,44,41,3,12,32
100,Fail,49,34,0,16,33
100,Fail,47,35,3,15,32
100,Fail,46,38,0,13,33
100,Fail,44,36,9,11,33
100,Fail,47,38,2,13,34
100,Fail,40,35,9,16,24
100,Fail,47,40,2,11,36
100,Fail,45,36,0,17,28
100,Fail,52,32,3,13,39
100,Fail,46,32,4,18,28
100,Fail,51,31,0,11,40
100,Fail,49,35,0,14,35
100,Fail,44,40,4,12,32
100,Fail,47,40,2,11,36
100,Fail,47,30,8,15,32
100,Fail,42,44,4,10,32
100,Fail,45,39,0,15,30
100,Fail,51,40,2,7,44
100,Fail,51,35,2,12,39
100,Fail,48,44,0,7,41
100,Fail,52,32,0,13,39
100,Fail,50,39,1,10,40
100,Fail,47,36,3,14,33
100,Fail,44,40,5,11,33
100,Fail,48,35,6,11,37
100,Fail,50,34,1,15,35
100,Fail,48,35,6,11,37
100,Fail,52,36,0,8,44
100,Fail,48,39,3,10,38
100,Fail,52,42,0,5,47
100,Fail,45,33,9,13,32
100,Fail,49,40,0,8,41
100,Fail,48,42,0,10,38
100,Fail,52,31,0,13,39
100,Fail,48,41,2,9,39
100,Fail,49,37,6,8,41
100,Fail,50,31,0,14,36
100,Fail,46,41,6,7,39
100,Fail,51,34,1,14,37
100,Fail,46,34,8,12,34
100,Fail,41,35,0,17,24
100,Fail,52,30,1,17,35
100,Fail,55,35,0,10,45
100,Fail,45,35,0,19,26
100,Fail,47,38,0,12,35
100,Fail,43,47,2,8,35
100,Fail,50,30,2,18,32
100,Fail,46,37,2,15,31
100,Fail,48,40,2,10,38
100,Fail,49,36,1,14,35
100,Fail,41,42,6,11,30
100,Fail,50,39,0,9,41
100,Fail,48,36,3,13,35
100,Fail,43,42,1,14,29
100,Fail,52,30,0,8,44
100,Fail,51,36,0,11,40
100,Fail,53,31,7,9,44
100,Fail,51,37,0,10,41
100,Fail,47,39,0,14,33
100,Fail,48,36,8,8,40
100,Fail,45,39,0,12,33
100,Fail,49,37,0,13,36
100,Fail,49,33,3,15,34
100,Fail,48,31,0,13,35
100,Fail,51,37,2,10,41
100,Fail,49,30,11,10,39
100,Fail,54,34,0,12,42
100,Fail,48,40,0,12,36
100,Fail,48,36,4,12,36
100,Fail,51,36,0,12,39
100,Fail,47,38,0,15,32
100,Fail,55,29,0,16,39
100,Fail,39,34,0,20,19
100,Fail,48,31,0,18,30
100,Fail,51,26,7,16,35
100,Fail,52,26,8,14,38
100,Fail,52,28,0,17,35
100,Fail,52,32,6,10,42
100,Fail,46,37,5,12,34
100,Fail,48,39,5,8,40
100,Fail,42,34,11,13,29
100,Fail,46,32,0,12,34
100,Fail,46,42,0,9,37
100,Fail,52,29,8,11,41
100,Fail,45,34,0,14,31
100,Fail,51,31,4,14,37
100,Fail,50,35,0,8,42
100,Fail,41,44,0,14,27
100,Fail,52,35,0,10,42
100,Fail,45,34,0,15,30
100,Fail,50,34,0,13,37
100,Fail,48,31,2,19,29
100,Fail,47,35,0,15,32
100,Fail,47,33,0,20,27
100,Fail,56,26,4,14,42
100,Fail,42,38,0,16,26
100,Fail,56,28,4,12,44
100,Fail,43,40,4,13,30
100,Fail,54,29,2,15,39
100,Fail,46,35,3,16,30
100,Fail,54,34,0,12,42
100,Fail,54,34,0,10,44
100,Fail,49,32,8,11,38
100,Fail,46,40,0,13,33
100,Fail,53,35,1,11,42
100,Fail,47,35,1,17,30
100,Fail,41,44,0,15,26
100,Fail,51,38,0,10,41
100,Fail,55,28,0,11,44
100,Fail,50,40,3,7,43
100,Fail,47,29,10,14,33
100,Fail,48,36,0,16,32
100,Fail,47,32,0,16,31
100,Fail,51,34,3,12,39
100,Fail,54,31,0,12,42
100,Fail,49,35,5,11,38
100,Fail,44,37,7,12,32
100,Fail,47,35,0,15,32
100,Fail,48,37,3,12,36
100,Fail,48,37,4,11,37
100,Fail,50,37,0,13,37
100,Fail,44,33,5,18,26
100,Fail,39,32,9,20,19
100,Fail,52,30,0,16,36
100,Fail,51,35,0,12,39
100,Fail,51,37,0,12,39
100,Fail,48,35,0,15,33
100,Fail,43,35,0,12,31
100,Fail,43,41,6,10,33
100,Fail,52,36,1,11,41
100,Fail,46,41,0,10,36
100,Fail,51,38,4,7,44
100,Fail,50,30,10,10,40
100,Fail,45,35,0,19,26
100,Fail,47,43,2,8,39
100,Fail,51,33,2,14,37
100,Fail,53,34,0,13,40
100,Fail,44,36,6,14,30
100,Fail,41,40,5,14,27
100,Fail,49,35,0,13,36
100,Fail,47,32,0,11,36
100,Fail,47,43,0,10,37
100,Fail,36,45,0,18,18
100,Fail,46,41,0,13,33
100,Fail,52,30,3,15,37
100,Fail,47,39,0,12,35
100,Fail,46,37,0,9,37
100,Fail,54,30,0,12,42
100,Fail,57,26,0,15,42
100,Fail,36,44,0,18,18
100,Fail,49,38,0,11,38
100,Fail,45,33,2,20,25
100,Fail,39,40,8,13,26
100,Fail,57,29,0,11,46
100,Fail,44,35,0,17,27
100,Fail,39,41,0,10,29
100,Fail,50,39,0,9,41
100,Fail,55,34,2,9,46
100,Fail,45,36,6,13,32
100,Fail,53,31,0,13,40
100,Fail,47,35,6,12,35
100,Fail,51,35,0,11,40
100,Fail,51,36,0,10,41
100,Fail,50,38,0,12,38
100,Fail,55,39,0,6,49
100,Fail,43,37,1,19,24
100,Fail,46,38,0,12,34
100,Fail,42,39,6,13,29
100,Fail,49,27,0,13,36
100,Fail,47,31,0,14,33
100,Fail,55,32,3,10,45
100,Fail,46,32,0,19,27
100,Fail,46,36,0,13,33
100,Fail,59,26,0,13,46
100,Fail,46,36,4,14,32
100,Fail,51,40,2,7,44
100,Fail,46,35,0,11,35
100,Fail,50,30,4,16,34
100,Fail,42,39,1,18,24
100,Fail,53,35,1,11,42
100,Fail,49,38,4,9,40
100,Fail,41,36,0,14,27
100,Fail,52,29,0,13,39
100,Fail,50,35,4,11,39
100,Fail,43,36,0,20,23
100,Fail,53,33,0,13,40
100,Fail,51,40,0,9,42
100,Fail,54,35,0,8,46
100,Fail,48,35,4,13,35
100,Fail,45,43,1,11,34
100,Fail,53,38,0,9,44
100,Fail,48,35,0,16,32
100,Fail,44,38,0,12,32
100,Fail,48,32,4,16,32
100,Fail,52,34,0,12,40
100,Fail,57,32,2,9,48
100,Fail,54,36,6,4,50
100,Fail,52,37,0,8,44
100,Fail,52,26,5,17,35
100,Fail,40,41,0,16,24
100,Fail,45,40,0,11,34
100,Fail,41,43,3,13,28
100,Fail,49,35,1,15,34
100,Fail,47,32,9,12,35
100,Fail,47,38,4,11,36
100,Fail,52,28,0,16,36
100,Fail,43,32,14,11,32
100,Fail,51,42,0,7,44
100,Fail,44,47,0,5,39
100,Fail,46,44,0,9,37
100,Fail,45,33,1,21,24
100,Fail,46,35,5,14,32
100,Fail,51,34,5,10,41
100,Fail,50,35,3,12,38
100,Fail,55,36,1,8,47
100,Fail,52,32,1,15,37
100,Fail,43,37,0,10,33
100,Fail,50,32,3,15,35
100,Fail,43,29,0,14,29
100,Fail,56,32,1,11,45
100,Fail,51,37,0,12,39
100,Fail,46,28,0,13,33
100,Fail,51,33,6,10,41
100,Fail,44,38,0,15,29
100,Fail,54,34,0,12,42
100,Fail,51,28,3,18,33
100,Fail,49,38,1,12,37
100,Fail,51,36,0,13,38
100,Fail,50,28,9,13,37
100,Fail,52,31,4,13,39
100,Fail,52,33,2,13,39
100,Fail,50,36,0,14,36
100,Fail,49,34,1,16,33
100,Fail,53,35,4,8,45
100,Fail,49,31,4,16,33
100,Fail,41,38,0,15,26
100,Fail,46,42,0,11,35
100,Fail,51,35,7,7,44
100,Fail,49,35,7,9,40
100,Fail,49,37,3,11,38
100,Fail,49,36,0,10,39
100,Fail,50,36,3,11,39
100,Fail,53,36,0,11,42
100,Fail,54,30,0,10,44
100,Fail,50,36,1,13,37
100,Fail,54,29,0,13,41
100,Fail,50,39,0,8,42
100,Fail,50,31,0,15,35
100,Fail,48,34,0,13,35
100,Fail,50,34,0,14,36
100,Fail,52,29,4,15,37
100,Fail,46,42,1,11,35
100,Fail,53,34,3,10,43
100,Fail,47,33,3,17,30
100,Fail,51,36,0,9,42
100,Fail,46,34,0,10,36
100,Fail,45,33,0,17,28
100,Fail,50,34,0,15,35
100,Fail,52,35,5,8,44
100,Fail,46,33,7,14,32
100,Fail,49,34,4,13,36
100,Fail,53,35,0,9,44
100,Fail,45,37,0,16,29
100,Fail,45,41,6,8,37
100,Fail,48,41,0,7,41
100,Fail,41,34,15,10,31
100,Fail,49,32,0,15,34
100,Fail,48,40,0,11,37
100,Fail,39,33,9,19,20
100,Fail,44,38,0,11,33
100,Fail,49,31,0,16,33
100,Fail,56,29,0,10,46
100,Fail,44,34,8,14,30
100,Fail,48,39,2,11,37
100,Fail,46,35,7,12,34
100,Fail,53,25,0,13,40
100,Fail,50,42,0,4,46
100,Fail,50,39,0,10,40
100,Fail,45,40,0,11,34
100,Fail,49,35,0,16,33
100,Fail,51,36,0,8,43
100,Fail,46,43,0,9,37
100,Fail,45,46,3,6,39
100,Fail,41,35,9,15,26
100,Fail,51,31,0,13,38
100,Fail,47,40,5,8,39
100,Fail,51,27,0,17,34
100,Fail,40,36,0,13,27
100,Fail,51,26,6,17,34
100,Fail,47,37,0,12,35
100,Fail,44,37,5,14,30
100,Fail,41,43,0,11,30
100,Fail,44,39,6,11,33
100,Fail,51,40,1,8,43
100,Fail,51,37,0,7,44
100,Fail,52,34,0,12,40
100,Fail,50,31,0,13,37
100,Fail,48,27,8,17,31
100,Fail,57,26,1,16,41
100,Fail,53,38,1,8,45
100,Fail,48,38,0,8,40
100,Fail,42,35,5,18,24
100,Fail,53,37,0,10,43
100,Fail,43,38,0,18,25
100,Fail,47,37,2,14,33
100,Fail,38,48,4,10,28
100,Fail,41,37,0,14,27
100,Fail,46,40,0,9,37
100,Fail,51,39,4,6,45
100,Fail,53,36,3,8,45
100,Fail,46,38,0,13,33
100,Fail,46,43,0,11,35
100,Fail,49,37,6,8,41
100,Fail,46,40,0,7,39
100,Fail,48,36,6,10,38
100,Fail,48,35,3,14,34
100,Fail,45,44,0,9,36
100,Fail,50,39,1,10,40
100,Fail,39,39,7,15,24
100,Fail,43,35,0,14,29
100,Fail,53,33,5,9,44
100,Fail,51,37,0,9,42
100,Fail,50,38,1,11,39
100,Fail,45,39,0,12,33
100,Fail,56,33,1,10,46
100,Fail,46,30,0,14,32
100,Fail,52,35,0,11,41
100,Fail,50,35,0,15,35
100,Fail,34,44,0,17,17
100,Fail,45,41,0,12,33
100,Fail,44,35,0,19,25
100,Fail,52,32,7,9,43
100,Fail,50,33,7,10,40
100,Fail,57,33,1,9,48
100,Fail,48,35,0,14,34
100,Fail,45,45,0,10,35
100,Fail,34,42,8,16,18
100,Fail,48,34,5,13,35
100,Fail,53,30,0,16,37
100,Fail,47,33,2,18,29
100,Fail,41,43,0,12,29
100,Fail,54,33,0,12,42
100,Fail,48,38,3,11,37
100,Fail,51,36,0,11,40
100,Fail,51,35,0,12,39
100,Fail,52,33,5,10,42
100,Fail,52,36,0,10,42
100,Fail,54,30,0,10,44
100,Fail,44,38,0,17,27
100,Fail,44,37,12,7,37
100,Fail,46,44,0,10,36
100,Fail,47,41,2,10,37
100,Fail,46,39,0,14,32
100,Fail,51,27,0,18,33
100,Fail,52,38,0,7,45
100,Fail,46,41,1,12,34
100,Fail,40,37,5,18,22
100,Fail,47,34,0,16,31
100,Fail,41,37,0,16,25
100,Fail,55,33,0,10,45
100,Fail,55,35,0,10,45
100,Fail,54,34,0,12,42
100,Fail,46,38,0,14,32
100,Fail,45,43,0,12,33
100,Fail,42,33,0,16,26
100,Fail,51,39,0,10,41
100,Fail,48,39,5,8,40
100,Fail,55,38,0,7,48
100,Fail,46,40,1,13,33
100,Fail,46,41,5,8,38
100,Fail,53,39,1,7,46
100,Fail,49,34,4,13,36
100,Fail,44,38,1,17,27
100,Fail,47,37,1,15,32
100,Fail,48,43,1,8,40
100,Fail,47,42,0,11,36
100,Fail,49,27,7,17,32
100,Fail,47,31,0,19,28
100,Fail,56,28,0,9,47
100,Fail,49,30,5,16,33
100,Fail,44,33,0,11,33
100,Fail,44,43,0,9,35
100,Fail,44,30,0,16,28
100,Fail,51,34,0,12,39
100,Fail,50,32,0,16,34
100,Fail,50,35,1,14,36
100,Fail,39,42,7,12,27
100,Fail,54,33,0,13,41
100,Fail,43,30,9,18,25
100,Fail,52,37,3,8,44
100,Fail,49,37,5,9,40
100,Fail,52,30,0,9,43
100,Fail,46,29,0,14,32
100,Fail,49,38,0,11,38
100,Fail,52,37,1,10,42
100,Fail,45,34,9,12,33
100,Fail,56,33,2,9,47
100,Fail,55,33,4,8,47
100,Fail,46,35,0,14,32
100,Fail,40,47,6,7,33
100,Fail,50,36,4,10,40
100,Fail,43,33,7,17,26
100,Fail,41,35,9,15,26
100,Fail,45,41,1,13,32
100,Fail,48,27,13,12,36
100,Fail,49,37,0,13,36
100,Fail,45,31,8,16,29
100,Fail,52,33,1,14,38
100,Fail,33,37,0,21,12
100,Fail,47,36,0,11,36
100,Fail,54,31,0,10,44
100,Fail,44,38,7,11,33
100,Fail,44,35,4,17,27
100,Fail,45,38,2,15,30
100,Fail,47,37,1,15,32
100,Fail,52,34,3,11,41
100,Fail,50,37,0,13,37
100,Fail,51,40,1,8,43
100,Fail,46,32,10,12,34
100,Fail,46,41,0,9,37
100,Fail,48,40,0,9,39
100,Fail,51,39,0,10,41
100,Fail,58,32,0,10,48
100,Fail,46,38,3,13,33
100,Fail,54,31,7,8,46
100,Fail,42,37,7,14,28
100,Fail,42,42,2,14,28
100,Fail,46,35,0,16,30
100,Fail,40,34,12,14,26
100,Fail,49,31,0,18,31
100,Fail,44,31,12,13,31
100,Fail,52,40,2,6,46
100,Fail,44,40,1,15,29
100,Fail,55,37,0,8,47
100,Fail,54,36,1,9,45
100,Fail,48,36,0,16,32
100,Fail,50,28,0,12,38
100,Fail,53,34,3,10,43
100,Fail,47,31,0,15,32
100,Fail,48,37,0,13,35
100,Fail,54,36,4,6,48
100,Fail,52,28,0,19,33
100,Fail,48,34,7,11,37
100,Fail,47,33,0,14,33
100,Fail,40,45,0,14,26
100,Fail,50,38,2,10,40
100,Fail,49,35,1,15,34
100,Fail,50,38,0,12,38
100,Fail,50,34,4,12,38
100,Fail,49,34,4,13,36
100,Fail,48,28,11,13,35
100,Fail,51,35,4,10,41
100,Fail,52,37,1,10,42
100,Fail,48,40,0,12,36
100,Fail,54,30,5,11,43
100,Fail,48,41,0,11,37
100,Fail,55,26,0,12,43
100,Fail,48,41,0,10,38
100,Fail,52,38,0,7,45
100,Fail,53,36,0,8,45
100,Fail,49,42,0,5,44
100,Fail,43,35,0,10,33
100,Fail,49,35,0,10,39
100,Fail,55,33,4,8,47
100,Fail,49,37,1,13,36
100,Fail,51,32,4,13,38
100,Fail,50,35,0,14,36
100,Fail,52,31,7,10,42
100,Fail,47,39,2,12,35
100,Fail,42,39,0,17,25
100,Fail,46,36,3,15,31
100,Fail,49,31,0,12,37
100,Fail,60,29,0,7,53
100,Fail,39,28,12,21,18
100,Fail,54,34,1,11,43
100,Fail,46,44,1,9,37
100,Fail,53,32,0,10,43
100,Fail,50,38,0,8,42
100,Fail,47,34,0,15,32
100,Fail,46,39,2,13,33
100,Fail,42,38,0,10,32
100,Fail,41,37,6,16,25
100,Fail,57,33,0,10,47
100,Fail,49,36,2,13,36
100,Fail,50,36,3,11,39
100,Fail,52,37,3,8,44
100,Fail,52,38,4,6,46
100,Fail,53,31,2,14,39
100,Fail,56,28,0,14,42
100,Fail,45,36,0,17,28
100,Fail,48,32,0,12,36
100,Fail,44,35,5,16,28
100,Fail,52,38,0,7,45
100,Fail,39,40,0,21,18
100,Fail,45,37,0,12,33
100,Fail,45,45,0,9,36
100,Fail,45,44,0,10,35
100,Fail,41,44,0,8,33
100,Fail,53,37,2,8,45
100,Fail,41,40,0,14,27
100,Fail,46,30,9,15,31
100,Fail,47,36,0,16,31
100,Fail,46,30,0,10,36
100,Fail,51,29,6,14,37
100,Fail,46,39,4,11,35
100,Fail,57,28,3,12,45
100,Fail,61,24,2,13,48
100,Fail,47,40,1,12,35
100,Fail,43,41,7,9,34
100,Fail,53,38,3,6,47
100,Fail,51,31,9,9,42
100,Fail,42,46,3,9,33
100,Fail,50,37,4,9,41
100,Fail,47,38,2,13,34
100,Fail,52,32,0,12,40
100,Fail,45,39,5,11,34
100,Fail,48,36,2,14,34
100,Fail,49,44,0,7,42
100,Fail,41,43,4,12,29
100,Fail,52,35,0,12,40
100,Fail,46,35,0,16,30
100,Fail,53,37,0,10,43
100,Fail,49,28,0,18,31
100,Fail,45,42,0,10,35
100,Fail,54,31,0,10,44
100,Fail,31,39,12,18,13
100,Fail,47,34,1,18,29
100,Fail,53,26,7,14,39
100,Fail,49,29,0,20,29
100,Fail,55,31,5,9,46
100,Fail,55,30,3,12,43
100,Fail,49,32,0,19,30
100,Fail,49,39,2,10,39
100,Fail,49,31,0,20,29
100,Fail,51,33,0,10,41
100,Fail,48,36,4,12,36
100,Fail,46,37,1,16,30
100,Fail,47,38,0,15,32
100,Fail,44,30,0,19,25
100,Fail,51,33,0,10,41
100,Fail,47,39,2,12,35
100,Fail,54,32,0,12,42
100,Fail,52,26,0,14,38
100,Fail,50,36,0,12,38
100,Fail,39,31,15,15,24
100,Fail,50,32,0,16,34
100,Fail,51,30,5,14,37
100,Fail,40,43,1,16,24
100,Fail,48,24,0,17,31
100,Fail,46,34,12,8,38
100,Fail,50,36,2,12,38
100,Fail,49,33,3,15,34
100,Fail,51,33,0,15,36
100,Fail,51,34,0,10,41
100,Fail,56,29,0,11,45
100,Fail,45,39,4,12,33
100,Fail,45,37,6,12,33
100,Fail,52,27,0,19,33
100,Fail,42,43,5,10,32
100,Fail,45,41,1,13,32
100,Fail,49,40,0,9,40
100,Fail,46,38,4,12,34
100,Fail,49,39,3,9,40
100,Fail,51,41,0,8,43
100,Fail,45,34,9,12,33
100,Fail,47,37,0,9,38
100,Fail,52,28,0,15,37
100,Fail,49,37,0,11,38
100,Fail,45,40,2,13,32
100,Fail,53,33,8,6,47
100,Fail,50,35,0,11,39
100,Fail,50,31,0,16,34
100,Fail,39,46,2,13,26
100,Fail,51,38,1,10,41
100,Fail,47,29,0,12,35
100,Fail,38,40,0,13,25
100,Fail,43,42,0,9,34
100,Fail,46,39,0,9,37
100,Fail,45,41,0,12,33
100,Fail,50,43,0,7,43
100,Fail,53,34,0,9,44
100,Fail,42,40,0,17,25
100,Fail,45,38,0,13,32
100,Fail,50,25,3,22,28
100,Fail,50,39,3,8,42
100,Fail,47,38,0,13,34
100,Fail,50,41,0,9,41
100,Fail,49,42,0,8,41
100,Fail,57,22,0,15,42
100,Fail,53,34,0,13,40
100,Fail,46,38,0,16,30
100,Fail,53,35,0,8,45
100,Fail,44,41,1,14,30
100,Fail,51,42,1,6,45
100,Fail,43,41,0,9,34
100,Fail,49,35,2,14,35
100,Fail,52,38,0,8,44
100,Fail,46,36,0,10,36
100,Fail,47,42,0,10,37
100,Fail,45,31,2,22,23
100,Fail,49,39,2,10,39
100,Fail,53,32,0,13,40
100,Fail,47,37,0,16,31
100,Fail,46,35,6,13,33
100,Fail,42,38,6,14,28
100,Fail,50,27,9,14,36
100,Fail,53,31,2,14,39
100,Fail,42,41,0,14,28
100,Fail,48,38,3,11,37
100,Fail,51,33,0,16,35
100,Fail,43,37,0,16,27
100,Fail,45,32,0,19,26
100,Fail,47,24,0,17,30
100,Fail,48,37,0,12,36
100,Fail,42,44,3,11,31
100,Fail,48,31,0,15,33
100,Fail,53,33,0,9,44
100,Fail,48,36,4,12,36
100,Fail,42,39,7,12,30
100,Fail,42,37,3,18,24
100,Fail,41,40,0,15,26
100,Fail,45,34,0,13,32
100,Fail,45,38,8,9,36
100,Fail,44,37,0,17,27
100,Fail,49,38,4,9,40
100,Fail,60,28,1,11,49
100,Fail,46,35,0,14,32
100,Fail,45,42,0,11,34
100,Fail,39,48,0,12,27
100,Fail,52,38,0,10,42
100,Fail,40,38,0,11,29
100,Fail,47,37,0,9,38
100,Fail,45,39,3,13,32
100,Fail,49,39,0,9,40
100,Fail,48,29,0,23,25
100,Fail,49,41,0,9,40
100,Fail,46,39,0,13,33
100,Fail,45,42,0,13,32
100,Fail,57,36,0,6,51
100,Fail,46,41,0,10,36
100,Fail,56,32,0,3,53
100,Fail,58,30,0,6,52
100,Fail,48,33,4,15,33
100,Fail,45,42,0,13,32
100,Fail,40,36,0,13,27
100,Fail,47,35,0,16,31
100,Fail,37,43,0,9,28
100,Fail,49,34,3,14,35
100,Fail,44,38,0,14,30
100,Fail,44,42,6,8,36
100,Fail,51,37,2,10,41
100,Fail,42,37,13,8,34
100,Fail,49,35,3,13,36
100,Fail,44,41,0,14,30
100,Fail,52,32,0,12,40
100,Fail,48,40,0,9,39
100,Fail,52,32,2,14,38
100,Fail,55,35,0,10,45
100,Fail,47,35,9,9,38
100,Fail,51,35,0,13,38
100,Fail,51,33,0,16,35
100,Fail,44,39,0,13,31
100,Fail,42,30,0,18,24
100,Fail,48,34,3,15,33
100,Fail,39,53,0,8,31
100,Fail,40,45,4,11,29
100,Fail,55,32,0,13,42
100,Fail,53,30,0,17,36
100,Fail,47,29,0,10,37
100,Fail,58,29,3,10,48
100,Fail,52,37,1,10,42
100,Fail,51,39,1,9,42
100,Fail,45,22,0,10,35
100,Fail,53,37,0,9,44
100,Fail,43,34,8,15,28
100,Fail,54,35,1,10,44
100,Fail,41,34,0,20,21
100,Fail,52,34,0,13,39
100,Fail,38,47,2,13,25
100,Fail,48,34,1,17,31
100,Fail,48,43,0,8,40
100,Fail,49,34,0,8,41
100,Fail,49,34,4,13,36
100,Fail,48,34,0,16,32
100,Fail,43,40,4,13,30
100,Fail,39,49,0,11,28
100,Fail,54,30,3,13,41
100,Fail,51,35,0,7,44
100,Fail,47,38,0,12,35
100,Fail,53,28,0,9,44
100,Fail,50,33,7,10,40
100,Fail,46,34,0,17,29
100,Fail,52,36,0,10,42
100,Fail,46,38,0,12,34
100,Fail,57,30,2,11,46
100,Fail,38,37,0,16,22
100,Fail,48,36,5,11,37
100,Fail,47,36,0,12,35
100,Fail,42,43,5,10,32
100,Fail,42,37,11,10,32
100,Fail,57,35,0,8,49
100,Fail,39,41,4,16,23
100,Fail,50,29,0,17,33
100,Fail,52,35,0,13,39
100,Fail,47,41,0,8,39
100,Fail,42,43,0,14,28
100,Fail,55,32,0,13,42
100,Fail,43,39,0,14,29
100,Fail,53,33,7,7,46
100,Fail,52,33,0,11,41
100,Fail,42,42,7,9,33
100,Fail,48,32,0,15,33
100,Fail,46,38,2,14,32
100,Fail,51,31,0,14,37
100,Fail,50,39,0,10,40
100,Fail,44,33,13,10,34
100,Fail,37,40,0,17,20
100,Fail,45,37,2,16,29
100,Fail,48,37,2,13,35
100,Fail,47,30,0,14,33
100,Fail,52,33,0,14,38
100,Fail,38,36,0,15,23
100,Fail,52,38,2,8,44
100,Fail,54,37,2,7,47
100,Fail,46,35,10,9,37
100,Fail,49,30,0,13,36
100,Fail,44,35,3,18,26
100,Fail,53,34,0,12,41
100,Fail,41,29,7,23,18
100,Fail,55,32,0,9,46
100,Fail,44,38,0,15,29
100,Fail,52,33,0,15,37
100,Fail,53,33,1,13,40
100,Fail,40,40,0,16,24
100,Fail,48,32,0,17,31
100,Fail,43,41,0,11,32
100,Fail,41,29,0,17,24
100,Fail,56,32,0,8,48
100,Fail,46,41,6,7,39
100,Fail,43,44,7,6,37
100,Fail,50,37,1,12,38
100,Fail,37,45,2,16,21
100,Fail,45,30,0,20,25
100,Fail,51,33,0,10,41
100,Fail,46,30,8,16,30
100,Fail,50,36,0,13,37
100,Fail,46,35,0,13,33
100,Fail,45,37,0,16,29
100,Fail,50,36,2,12,38
100,Fail,48,38,0,12,36
100,Fail,41,40,0,19,22
100,Fail,37,39,0,19,18
100,Fail,46,34,9,11,35
100,Fail,49,40,0,11,38
100,Fail,50,37,1,12,38
100,Fail,52,36,0,12,40
100,Fail,49,34,3,14,35
100,Fail,45,38,3,14,31
100,Fail,46,37,4,13,33
100,Fail,52,36,0,12,40
100,Fail,51,32,0,17,34
100,Fail,47,29,0,22,25
100,Fail,56,34,0,8,48
100,Fail,44,35,0,19,25
100,Fail,60,30,0,10,50
100,Fail,48,38,0,14,34
100,Fail,50,36,0,13,37
100,Fail,46,43,0,9,37
100,Fail,43,37,5,15,28
100,Fail,42,45,7,6,36
100,Fail,50,30,0,18,32
100,Fail,55,31,0,9,46
100,Fail,45,33,0,12,33
100,Fail,55,31,1,13,42
100,Fail,56,29,0,14,42
100,Fail,40,46,0,10,30
100,Fail,48,40,0,10,38
100,Fail,45,41,0,14,31
100,Fail,38,42,0,20,18
100,Fail,48,27,6,19,29
100,Fail,50,33,7,10,40
100,Fail,40,38,0,15,25
100,Fail,40,35,0,17,23
100,Fail,50,33,0,14,36
100,Fail,50,34,3,13,37
100,Fail,45,35,0,19,26
100,Fail,43,38,0,17,26
100,Fail,44,40,2,14,30
100,Fail,50,33,4,13,37
100,Fail,50,39,4,7,43
100,Fail,53,34,0,13,40
100,Fail,51,39,0,10,41
100,Fail,45,31,0,12,33
100,Fail,43,46,1,10,33
100,Fail,41,32,0,18,23
100,Fail,50,32,8,10,40
100,Fail,47,42,0,9,38
100,Fail,53,34,0,10,43
100,Fail,59,30,0,9,50
100,Fail,52,34,1,13,39
100,Fail,43,36,7,14,29
100,Fail,48,42,0,10,38
100,Fail,46,41,1,12,34
100,Fail,51,36,0,13,38
100,Fail,48,32,0,10,38
100,Fail,46,37,6,11,35
100,Fail,49,35,9,7,42
100,Fail,39,41,0,18,21
100,Fail,41,44,1,14,27
100,Fail,45,36,3,16,29
100,Fail,47,39,0,14,33
100,Fail,57,30,0,12,45
100,Fail,47,40,0,8,39
100,Fail,55,34,2,9,46
100,Fail,48,40,1,11,37
100,Fail,50,34,0,13,37
100,Fail,43,31,9,17,26
100,Fail,45,36,0,17,28
100,Fail,41,34,0,15,26
100,Fail,54,28,5,13,41
100,Fail,54,33,0,7,47
100,Fail,53,37,0,10,43
100,Fail,53,30,6,11,42
100,Fail,42,43,0,13,29
100,Fail,48,36,7,9,39
100,Fail,35,41,8,16,19
100,Fail,51,38,0,10,41
100,Fail,49,38,0,12,37
100,Fail,52,32,0,10,42
100,Fail,50,28,2,20,30
100,Fail,50,36,5,9,41
100,Fail,43,39,0,15,28
100,Fail,53,32,1,14,39
100,Fail,46,43,0,10,36
100,Fail,49,34,0,15,34
100,Fail,49,33,0,11,38
100,Fail,37,45,0,11,26
100,Fail,43,34,9,14,29
100,Fail,41,36,0,18,23
100,Fail,55,26,7,12,43
100,Fail,48,32,5,15,33
100,Fail,48,36,0,9,39
100,Fail,46,31,10,13,33
100,Fail,54,33,1,12,42
100,Fail,48,40,6,6,42
100,Fail,55,38,0,7,48
100,Fail,49,32,0,12,37
100,Fail,43,32,7,18,25
100,Fail,51,36,0,11,40
100,Fail,50,39,0,11,39
100,Fail,62,27,4,7,55
100,Fail,44,43,6,7,37
100,Fail,49,32,0,13,36
100,Fail,52,35,7,6,46
100,Fail,48,42,1,9,39
100,Fail,37,39,9,15,22
100,Fail,39,44,3,14,25
100,Fail,54,38,0,8,46
100,Fail,48,30,8,14,34
100,Fail,48,36,2,14,34
100,Fail,47,36,0,11,36
100,Fail,43,37,4,16,27
100,Fail,44,34,0,14,30
100,Fail,46,35,2,17,29
100,Fail,50,37,2,11,39
100,Fail,40,37,0,13,27
100,Fail,48,38,2,12,36
100,Fail,45,35,0,13,32
100,Fail,47,31,0,14,33
100,Fail,47,38,7,8,39
100,Fail,52,22,0,18,34
100,Fail,47,38,0,11,36
100,Fail,46,38,2,14,32
100,Fail,45,35,0,12,33
100,Fail,41,38,0,18,23
100,Fail,52,38,0,9,43
100,Fail,47,35,0,14,33
100,Fail,42,40,6,12,30
100,Fail,46,36,0,10,36
100,Fail,49,33,2,16,33
100,Fail,51,35,0,10,41
100,Fail,51,40,0,6,45
100,Fail,57,29,5,9,48
100,Fail,49,36,2,13,36
100,Fail,41,31,10,18,23
100,Fail,48,32,3,17,31
100,Fail,46,40,4,10,36
100,Fail,49,41,2,8,41
100,Fail,51,36,1,12,39
100,Fail,44,32,0,18,26
100,Fail,47,37,2,14,33
100,Fail,46,32,6,16,30
100,Fail,56,33,2,9,47
100,Fail,47,36,5,12,35
100,Fail,47,33,0,7,40
100,Fail,44,42,0,14,30
100,Fail,53,33,0,11,42
100,Fail,47,40,0,11,36
100,Fail,45,43,0,12,33
100,Fail,48,33,0,12,36
100,Fail,50,36,3,11,39
100,Fail,49,37,2,12,37
100,Fail,45,30,8,17,28
100,Fail,53,33,1,13,40
100,Fail,47,35,0,15,32
100,Fail,45,43,0,12,33
100,Fail,40,37,11,12,28
100,Fail,53,37,1,9,44
100,Fail,47,32,0,15,32
100,Fail,45,39,2,14,31
100,Fail,34,46,4,16,18
100,Fail,35,43,8,14,21
100,Fail,46,37,2,15,31
100,Fail,46,36,0,12,34
100,Fail,55,36,1,8,47
100,Fail,54,34,0,12,42
100,Fail,42,42,1,15,27
100,Fail,42,47,0,10,32
100,Fail,40,44,0,12,28
100,Fail,47,34,5,14,33
100,Fail,41,41,0,16,25
100,Fail,45,43,0,9,36
100,Fail,50,44,0,6,44
100,Fail,49,36,6,9,40
100,Fail,52,33,5,10,42
100,Fail,50,34,4,12,38
100,Fail,46,35,5,14,32
100,Fail,54,37,0,9,45
100,Fail,48,40,2,10,38
100,Fail,50,32,4,14,36
100,Fail,50,28,0,18,32
100,Fail,50,28,12,10,40
100,Fail,48,28,0,15,33
100,Fail,50,38,1,11,39
100,Fail,42,39,0,16,26
100,Fail,47,35,0,13,34
100,Fail,46,40,2,12,34
100,Fail,52,31,9,8,44
100,Fail,40,38,5,17,23
100,Fail,41,38,0,16,25
100,Fail,45,34,7,14,31
100,Fail,48,40,3,9,39
100,Fail,51,35,0,10,41
100,Fail,45,38,5,12,33
100,Fail,48,40,0,9,39
100,Fail,48,35,0,10,38
100,Fail,55,34,0,11,44
100,Fail,43,44,0,12,31
100,Fail,45,36,0,14,31
100,Fail,45,34,0,14,31
100,Fail,49,39,5,7,42
100,Fail,57,35,0,7,50
100,Fail,55,31,0,13,42
100,Fail,47,37,0,16,31
100,Fail,52,38,0,9,43
100,Fail,49,28,7,16,33
100,Fail,47,29,7,17,30
100,Fail,48,32,0,17,31
100,Fail,49,33,6,12,37
100,Fail,44,35,6,15,29
100,Fail,50,35,0,11,39
100,Fail,52,39,1,8,44
100,Fail,53,35,2,10,43
100,Fail,48,30,10,12,36
100,Fail,43,39,0,16,27
100,Fail,44,31,0,16,28
100,Fail,48,32,0,20,28
100,Fail,46,35,0,14,32
100,Fail,49,36,0,11,38
100,Fail,48,39,0,11,37
100,Fail,44,32,0,14,30
100,Fail,46,38,2,14,32
100,Fail,48,37,3,12,36
100,Fail,48,37,4,11,37
100,Fail,50,36,0,14,36
100,Fail,49,40,3,8,41
100,Fail,50,30,10,10,40
100,Fail,48,40,1,11,37
100,Fail,42,40,5,13,29
100,Fail,51,36,1,12,39
100,Fail,44,40,3,13,31
100,Fail,46,41,0,13,33
100,Fail,41,40,6,13,28
100,Fail,51,32,10,7,44
100,Fail,53,29,5,13,40
100,Fail,50,32,0,17,33
100,Fail,38,41,5,16,22
100,Fail,46,42,0,11,35
100,Fail,52,32,0,16,36
100,Fail,46,38,5,11,35
100,Fail,59,34,3,4,55
100,Fail,44,33,0,14,30
100,Fail,49,36,5,10,39
100,Fail,48,32,2,18,30
100,Fail,57,32,0,10,47
100,Fail,40,43,3,14,26
100,Fail,44,30,5,21,23
100,Fail,46,37,0,11,35
100,Fail,45,39,4,12,33
100,Fail,51,37,0,12,39
100,Fail,45,36,0,11,34
100,Fail,52,38,0,10,42
100,Fail,44,40,4,12,32
100,Fail,52,39,0,9,43
100,Fail,48,39,2,11,37
100,Fail,50,35,2,13,37
100,Fail,52,30,3,15,37
100,Fail,44,34,7,15,29
100,Fail,48,34,5,13,35
100,Fail,47,36,0,13,34
100,Fail,51,35,0,12,39
100,Fail,48,31,0,16,32
100,Fail,48,37,1,14,34
100,Fail,42,44,0,14,28
100,Fail,54,36,2,8,46
100,Fail,47,40,0,12,35
100,Fail,47,24,0,18,29
100,Fail,46,40,0,14,32
100,Fail,47,28,0,16,31
100,Fail,45,43,0,12,33
100,Fail,49,38,0,11,38
100,Fail,48,33,5,14,34
100,Fail,60,27,0,12,48
100,Fail,46,29,11,14,32
100,Fail,40,44,0,13,27
100,Fail,49,31,4,16,33
100,Fail,36,39,6,19,17
100,Fail,44,29,12,15,29
100,Fail,54,34,0,9,45
100,Fail,50,30,7,13,37
100,Fail,44,41,1,14,30
100,Fail,50,30,0,15,35
100,Fail,49,32,0,17,32
100,Fail,50,36,5,9,41
100,Fail,53,27,0,16,37
100,Fail,49,35,2,14,35
100,Fail,45,44,0,11,34
100,Fail,50,28,0,10,40
100,Fail,51,31,3,15,36
100,Fail,52,38,0,7,45
100,Fail,45,31,5,19,26
100,Fail,50,34,0,16,34
100,Fail,48,30,8,14,34
100,Fail,49,31,3,17,32
100,Fail,48,30,0,18,30
100,Fail,45,33,9,13,32
100,Fail,50,26,0,20,30
100,Fail,51,39,0,10,41
100,Fail,48,24,0,21,27
100,Fail,53,33,2,12,41
100,Fail,50,36,5,9,41
100,Fail,53,31,4,12,41
100,Fail,53,31,0,14,39
100,Fail,49,41,2,8,41
100,Fail,55,35,0,7,48
100,Fail,54,32,1,13,41
100,Fail,52,36,0,10,42
100,Fail,49,32,0,16,33
100,Fail,42,43,5,10,32
100,Fail,48,30,0,15,33
100,Fail,48,33,0,14,34
100,Fail,47,35,0,16,31
100,Fail,50,34,1,15,35
100,Fail,46,33,0,20,26
100,Fail,45,44,0,9,36
100,Fail,53,33,1,13,40
100,Fail,48,37,2,13,35
100,Fail,46,33,0,13,33
100,Fail,50,34,4,12,38
100,Fail,40,39,5,16,24
100,Fail,47,36,3,14,33
100,Fail,46,37,6,11,35
100,Fail,51,36,0,10,41
100,Fail,39,33,7,21,18
100,Fail,52,35,2,11,41
100,Fail,54,32,2,12,42
100,Fail,47,33,13,7,40
100,Fail,46,41,0,12,34
100,Fail,52,36,3,9,43
100,Fail,44,42,0,14,30
100,Fail,48,37,0,12,36
100,Fail,60,30,0,9,51
100,Fail,46,33,0,13,33
100,Fail,50,36,0,14,36
100,Fail,56,26,0,18,38
100,Fail,50,38,1,11,39
100,Fail,45,38,0,16,29
100,Fail,47,42,0,10,37
100,Fail,56,32,0,10,46
100,Fail,53,30,0,12,41
100,Fail,47,40,0,13,34
100,Fail,42,48,0,10,32
100,Fail,40,45,0,15,25
100,Fail,43,36,5,16,27
100,Fail,44,28,0,19,25
100,Fail,41,41,9,9,32
100,Fail,57,33,0,10,47
100,Fail,50,32,2,16,34
100,Fail,50,36,0,12,38
100,Fail,43,29,17,11,32
100,Fail,44,36,0,12,32
100,Fail,48,34,0,14,34
100,Fail,44,45,4,7,37
100,Fail,58,34,0,6,52
100,Fail,45,40,0,13,32
100,Fail,47,31,7,15,32
100,Fail,57,29,0,11,46
100,Fail,45,39,3,13,32
100,Fail,50,32,2,16,34
100,Fail,45,36,0,16,29
100,Fail,52,35,3,10,42
100,Fail,49,33,0,14,35
100,Fail,44,35,10,11,33
100,Fail,48,36,0,10,38
100,Fail,46,36,11,7,39
100,Fail,49,30,0,18,31
100,Fail,42,34,1,23,19
100,Fail,49,31,0,15,34
100,Fail,52,33,0,13,39
100,Fail,49,38,0,10,39
100,Fail,45,26,11,18,27
100,Fail,48,41,1,10,38
100,Fail,49,41,0,9,40
100,Fail,46,36,3,15,31
100,Fail,50,32,9,9,41
100,Fail,46,39,9,6,40
100,Fail,51,31,0,14,37
100,Fail,45,35,0,12,33
100,Fail,41,40,3,16,25
100,Fail,50,29,0,17,33
100,Fail,50,35,0,13,37
100,Fail,48,30,3,19,29
100,Fail,53,32,1,14,39
100,Fail,44,31,0,12,32
100,Fail,44,33,8,15,29
100,Fail,52,31,4,13,39
100,Fail,49,36,5,10,39
100,Fail,48,40,3,9,39
100,Fail,48,36,0,14,34
100,Fail,53,33,0,9,44
100,Fail,47,32,0,19,28
100,Fail,49,36,0,12,37
100,Fail,49,34,0,16,33
100,Fail,50,36,5,9,41
100,Fail,45,43,0,12,33
100,Fail,54,32,0,6,48
100,Fail,47,37,0,12,35
100,Fail,45,40,0,15,30
100,Fail,44,32,0,19,25
100,Fail,53,31,3,13,40
100,Fail,45,41,0,13,32
100,Fail,51,35,0,14,37
100,Fail,43,43,2,12,31
100,Fail,48,32,0,15,33
100,Fail,49,36,4,11,38
100,Fail,45,37,3,15,30
100,Fail,46,37,1,16,30
100,Fail,45,35,2,18,27
100,Fail,48,34,0,12,36
100,Fail,41,40,3,16,25
100,Fail,45,44,0,9,36
100,Fail,46,37,3,14,32
100,Fail,47,34,0,14,33
100,Fail,51,32,0,14,37
100,Fail,52,35,0,9,43
100,Fail,44,34,0,15,29
100,Fail,55,29,0,14,41
100,Fail,51,34,3,12,39
100,Fail,54,30,0,11,43
100,Fail,44,42,0,10,34
100,Fail,44,41,0,15,29
100,Fail,48,37,0,14,34
100,Fail,44,41,0,12,32
100,Fail,47,37,0,14,33
100,Fail,43,37,0,15,28
100,Fail,46,38,0,14,32
100,Fail,53,32,0,10,43
100,Fail,42,38,5,15,27
100,Fail,46,36,8,10,36
100,Fail,49,38,4,9,40
100,Fail,48,31,0,10,38
100,Fail,53,29,5,13,40
100,Fail,54,32,0,14,40
100,Fail,48,31,0,12,36
100,Fail,47,30,1,22,25
100,Fail,39,35,0,19,20
100,Fail,55,30,4,11,44
100,Fail,46,30,0,13,33
100,Fail,56,30,2,12,44
100,Fail,52,32,1,15,37
100,Fail,48,38,1,13,35
100,Fail,48,40,0,9,39
100,Fail,43,45,0,8,35
100,Fail,47,31,0,16,31
100,Fail,45,38,0,11,34
100,Fail,46,37,0,15,31
100,Fail,47,39,2,12,35
100,Fail,43,41,5,11,32
100,Fail,52,33,1,14,38
100,Fail,44,36,0,11,33
100,Fail,42,45,0,13,29
100,Fail,48,29,0,19,29
100,Fail,51,29,10,10,41
100,Fail,42,42,4,12,30
100,Fail,40,40,0,16,24
100,Fail,49,42,3,6,43
100,Fail,44,41,0,13,31
100,Fail,56,32,3,9,47
100,Fail,42,39,6,13,29
100,Fail,56,31,0,13,43
100,Fail,53,28,0,17,36
100,Fail,50,37,0,12,38
100,Fail,44,38,0,15,29
100,Fail,45,39,0,13,32
100,Fail,47,31,0,14,33
100,Fail,46,40,0,10,36
100,Fail,44,34,6,16,28
100,Fail,43,40,8,9,34
100,Fail,41,40,0,14,27
100,Fail,46,32,0,17,29
100,Fail,43,42,2,13,30
100,Fail,56,34,0,9,47
100,Fail,46,35,6,13,33
100,Fail,49,33,3,15,34
100,Fail,46,27,12,15,31
100,Fail,47,34,0,12,35
100,Fail,51,36,2,11,40
100,Fail,43,41,5,11,32
100,Fail,52,35,0,12,40
100,Fail,44,30,16,10,34
100,Fail,48,39,0,11,37
100,Fail,54,35,1,10,44
100,Fail,47,35,2,16,31
100,Fail,44,42,0,7,37
100,Fail,47,30,4,19,28
100,Fail,49,33,3,15,34
100,Fail,45,41,3,11,34
100,Fail,47,40,0,12,35
100,Fail,43,27,10,20,23
100,Fail,55,37,0,7,48
100,Fail,54,32,0,13,41
100,Fail,44,33,0,16,28
100,Fail,45,40,0,15,30
100,Fail,52,32,0,10,42
100,Fail,48,29,4,19,29
100,Fail,39,45,0,13,26
100,Fail,39,36,10,15,24
100,Fail,50,35,10,5,45
100,Fail,50,37,1,12,38
100,Fail,59,29,1,11,48
100,Fail,49,31,0,13,36
100,Fail,55,31,4,10,45
100,Fail,48,32,0,16,32
100,Fail,41,44,0,10,31
100,Fail,52,35,0,11,41
100,Fail,34,39,12,15,19
100,Fail,43,38,0,11,32
100,Fail,47,40,1,12,35
100,Fail,48,37,0,12,36
100,Fail,40,38,0,11,29
100,Fail,50,35,0,12,38
100,Fail,47,28,8,17,30
100,Fail,57,33,0,7,50
100,Fail,45,41,2,12,33
100,Fail,39,39,0,12,27
100,Fail,51,42,0,7,44
100,Fail,42,41,6,11,31
100,Fail,57,34,0,8,49
100,Fail,51,37,1,11,40
100,Fail,43,36,8,13,30
100,Fail,49,33,0,17,32
100,Fail,41,39,0,11,30
100,Fail,47,37,5,11,36
100,Fail,54,34,0,10,44
100,Fail,49,42,4,5,44
100,Fail,49,37,4,10,39
100,Fail,51,37,1,11,40
100,Fail,43,37,6,14,29
100,Fail,55,33,0,11,44
100,Fail,46,36,4,14,32
100,Fail,50,37,0,13,37
100,Fail,49,38,0,8,41
100,Fail,45,35,0,18,27
100,Fail,54,34,2,10,44
100,Fail,54,31,0,11,43
100,Fail,49,33,0,16,33
100,Fail,40,47,3,10,30
100,Fail,54,38,2,6,48
100,Fail,47,37,0,12,35
100,Fail,46,29,13,12,34
100,Fail,42,33,10,15,27
100,Fail,50,33,0,16,34
100,Fail,43,41,3,13,30
100,Fail,56,33,0,9,47
100,Fail,44,42,2,12,32
100,Fail,57,36,2,5,52
100,Fail,40,38,9,13,27
100,Fail,51,38,0,7,44
100,Fail,46,42,0,10,36
100,Fail,43,39,0,18,25
100,Fail,50,34,6,10,40
100,Fail,46,38,0,13,33
100,Fail,47,42,1,10,37
100,Fail,48,39,3,10,38
100,Fail,48,36,0,11,37
100,Fail,46,35,2,17,29
100,Fail,48,37,0,14,34
100,Fail,44,37,7,12,32
100,Fail,50,38,0,12,38
100,Fail,51,30,0,13,38
100,Fail,49,42,0,8,41
100,Fail,43,46,0,11,32
100,Fail,47,35,6,12,35
100,Fail,48,40,0,12,36
100,Fail,52,34,5,9,43
100,Fail,43,35,0,15,28
100,Fail,49,39,3,9,40
100,Fail,48,39,0,11,37
100,Fail,54,30,0,13,41
100,Fail,52,30,3,15,37
100,Fail,54,29,7,10,44
100,Fail,40,35,8,17,23
100,Fail,48,41,3,8,40
100,Fail,44,36,4,16,28
100,Fail,42,38,0,18,24
100,Fail,55,34,0,10,45
100,Fail,47,36,4,13,34
100,Fail,44,37,4,15,29
100,Fail,53,38,0,9,44
100,Fail,46,31,0,22,24
100,Fail,54,37,2,7,47
100,Fail,49,40,0,9,40
100,Fail,46,28,0,17,29
100,Fail,49,38,3,10,39
100,Fail,48,37,3,12,36
100,Fail,45,36,10,9,36
100,Fail,50,37,3,10,40
100,Fail,44,34,0,14,30
100,Fail,47,29,0,15,32
100,Fail,46,42,0,7,39
100,Fail,45,34,0,20,25
100,Fail,42,38,0,14,28
100,Fail,50,35,0,13,37
100,Fail,44,36,0,20,24
100,Fail,44,37,6,13,31
100,Fail,59,36,2,3,56
100,Fail,44,37,0,18,26
100,Fail,50,38,4,8,42
100,Fail,55,29,0,9,46
100,Fail,44,42,0,12,32
100,Fail,43,35,7,15,28
100,Fail,51,31,4,14,37
100,Fail,45,40,0,13,32
100,Fail,46,34,11,9,37
100,Fail,49,41,5,5,44
100,Fail,51,33,0,10,41
100,Fail,55,27,0,18,37
100,Fail,40,31,12,17,23
100,Fail,45,40,0,14,31
100,Fail,51,25,11,13,38
100,Fail,43,38,2,17,26
100,Fail,46,31,0,11,35
100,Fail,45,29,0,18,27
100,Fail,50,28,0,17,33
100,Fail,41,43,0,15,26
100,Fail,52,29,5,14,38
100,Fail,46,41,0,13,33
100,Fail,49,25,10,16,33
100,Fail,51,36,0,10,41
100,Fail,58,28,1,13,45
100,Fail,54,30,0,7,47
100,Fail,51,26,7,16,35
100,Fail,42,37,0,18,24
100,Fail,44,37,6,13,31
100,Fail,49,36,2,13,36
100,Fail,37,37,14,12,25
100,Fail,47,30,0,15,32
100,Fail,47,31,11,11,36
100,Fail,48,34,0,16,32
100,Fail,49,29,0,15,34
100,Fail,50,36,0,7,43
100,Fail,50,29,4,17,33
100,Fail,38,41,6,15,23
100,Fail,50,38,0,12,38
100,Fail,53,33,0,12,41
100,Fail,45,36,5,14,31
100,Fail,49,36,0,10,39
100,Fail,54,32,2,12,42
100,Fail,55,30,5,10,45
100,Fail,46,36,0,8,38
100,Fail,47,43,1,9,38
100,Fail,48,32,9,11,37
100,Fail,55,34,1,10,45
100,Fail,44,45,0,7,37
100,Fail,51,36,3,10,41
100,Fail,48,36,0,8,40
100,Fail,42,35,0,20,22
100,Fail,53,24,4,19,34
100,Fail,50,40,0,10,40
100,Fail,44,41,0,15,29
100,Fail,43,44,4,9,34
100,Fail,51,30,5,14,37
100,Fail,54,30,0,13,41
100,Fail,47,40,3,10,37
100,Fail,46,36,2,16,30
100,Fail,47,31,3,19,28
100,Fail,60,24,3,13,47
100,Fail,47,38,3,12,35
100,Fail,48,30,0,12,36
100,Fail,47,30,7,16,31
100,Fail,47,38,3,12,35
100,Fail,44,37,0,10,34
100,Fail,45,36,0,11,34
100,Fail,54,37,0,7,47
100,Fail,50,38,2,10,40
100,Fail,48,35,0,9,39
100,Fail,49,32,0,16,33
100,Fail,46,37,9,8,38
100,Fail,56,31,1,12,44
100,Fail,47,37,0,10,37
100,Fail,48,41,0,10,38
100,Fail,48,36,1,15,33
100,Fail,51,37,2,10,41
100,Fail,47,36,0,16,31
100,Fail,46,35,0,15,31
100,Fail,50,36,0,9,41
100,Fail,43,44,2,11,32
100,Fail,47,33,0,13,34
100,Fail,44,39,4,13,31
100,Fail,53,32,3,12,41
100,Fail,54,27,13,6,48
100,Fail,43,40,1,16,27
100,Fail,40,40,1,19,21
100,Fail,50,34,4,12,38
100,Fail,48,40,1,11,37
100,Fail,54,33,1,12,42
100,Fail,50,36,0,11,39
100,Fail,52,29,0,12,40
100,Fail,43,35,0,14,29
100,Fail,36,38,0,18,18
100,Fail,54,36,1,9,45
100,Fail,42,45,3,10,32
100,Fail,50,33,6,11,39
100,Fail,51,40,5,4,47
100,Fail,47,32,4,17,30
100,Fail,50,29,0,20,30
100,Fail,47,36,1,16,31
100,Fail,45,30,0,18,27
100,Fail,53,29,0,12,41
100,Fail,48,37,0,15,33
100,Fail,47,40,6,7,40
100,Fail,47,38,6,9,38
100,Fail,37,33,0,13,24
100,Fail,50,35,0,12,38
100,Fail,46,31,0,16,30
100,Fail,50,35,0,13,37
100,Fail,45,40,7,8,37
100,Fail,54,30,0,10,44
100,Fail,45,32,9,14,31
100,Fail,43,40,3,14,29
100,Fail,48,38,0,13,35
100,Fail,55,33,0,8,47
100,Fail,52,33,0,14,38
100,Fail,47,38,6,9,38
100,Fail,52,31,0,12,40
100,Fail,36,39,0,16,20
100,Fail,44,36,6,14,30
100,Fail,53,33,0,9,44
100,Fail,52,39,1,8,44
100,Fail,42,39,5,14,28
100,Fail,45,43,1,11,34
100,Fail,53,39,0,7,46
100,Fail,50,36,0,14,36
100,Fail,46,39,0,8,38
100,Fail,43,35,10,12,31
100,Fail,45,44,0,11,34
100,Fail,45,44,0,11,34
100,Fail,46,36,3,15,31
100,Fail,47,37,0,12,35
100,Fail,44,37,0,16,28
100,Fail,51,32,5,12,39
100,Fail,43,43,0,10,33
100,Fail,51,34,0,14,37
100,Fail,43,38,10,9,34
100,Fail,40,42,3,15,25
100,Fail,49,34,0,10,39
100,Fail,38,38,0,14,24
100,Fail,52,34,0,14,38
100,Fail,50,35,0,15,35
100,Fail,48,36,0,9,39
100,Fail,55,35,0,10,45
100,Fail,47,34,8,11,36
100,Fail,40,42,1,17,23
100,Fail,41,44,3,12,29
100,Fail,51,35,0,11,40
100,Fail,43,40,2,15,28
100,Fail,50,31,3,16,34
100,Fail,52,37,0,10,42
100,Fail,42,43,0,10,32
100,Fail,48,29,6,17,31
100,Fail,48,38,0,14,34
100,Fail,41,34,8,17,24
100,Fail,47,46,0,7,40
100,Fail,48,32,0,13,35
100,Fail,43,33,5,19,24
100,Fail,49,39,2,10,39
100,Fail,54,32,0,13,41
100,Fail,46,40,0,12,34
100,Fail,42,45,0,13,29
100,Fail,47,40,4,9,38
100,Fail,52,33,0,14,38
100,Fail,46,38,0,16,30
100,Fail,49,37,0,13,36
100,Fail,42,34,7,17,25
100,Fail,46,35,7,12,34
100,Fail,43,40,7,10,33
100,Fail,49,38,0,10,39
100,Fail,52,27,7,14,38
100,Fail,45,37,9,9,36
100,Fail,52,32,0,15,37
100,Fail,46,36,4,14,32
100,Fail,52,33,0,10,42
100,Fail,50,42,3,5,45
100,Fail,52,40,2,6,46
100,Fail,53,29,4,14,39
100,Fail,47,35,1,17,30
100,Fail,51,32,0,12,39
100,Fail,41,42,0,13,28
100,Fail,48,34,1,17,31
100,Fail,47,32,0,16,31
100,Fail,45,42,0,10,35
100,Fail,58,24,4,14,44
100,Fail,50,40,0,9,41
100,Fail,48,40,0,10,38
100,Fail,49,37,0,13,36
100,Fail,44,38,0,10,34
100,Fail,55,27,5,13,42
100,Fail,46,40,1,13,33
100,Fail,43,39,0,11,32
100,Fail,46,36,0,15,31
100,Fail,47,36,2,15,32
100,Fail,48,38,0,10,38
100,Fail,38,44,4,14,24
100,Fail,45,33,0,12,33
100,Fail,44,37,5,14,30
100,Fail,39,40,0,19,20
100,Fail,53,28,0,13,40
100,Fail,50,33,0,13,37
100,Fail,48,39,1,12,36
100,Fail,45,37,0,14,31
100,Fail,50,38,0,6,44
100,Fail,47,37,0,13,34
100,Fail,45,38,0,16,29
100,Fail,44,26,0,21,23
100,Fail,39,38,5,18,21
100,Fail,48,37,0,10,38
100,Fail,43,46,0,9,34
100,Fail,50,34,2,14,36
100,Fail,54,30,5,11,43
100,Fail,47,34,3,16,31
100,Fail,55,30,0,12,43
100,Fail,44,30,0,17,27
100,Fail,49,41,0,7,42
100,Fail,50,32,5,13,37
100,Fail,38,48,3,11,27
100,Fail,44,40,1,15,29
100,Fail,44,33,8,15,29
100,Fail,52,34,5,9,43
100,Fail,50,32,4,14,36
100,Fail,58,33,1,8,50
100,Fail,54,37,3,6,48
100,Fail,43,46,1,10,33
100,Fail,43,31,9,17,26
100,Fail,51,36,2,11,40
100,Fail,45,34,0,17,28
100,Fail,47,30,8,15,32
100,Fail,50,35,3,12,38
100,Fail,47,38,1,14,33
100,Fail,48,38,5,9,39
100,Fail,42,45,1,12,30
100,Fail,42,36,8,14,28
100,Fail,41,40,0,18,23
100,Fail,51,37,2,10,41
100,Fail,49,41,0,9,40
100,Fail,51,36,0,13,38
100,Fail,46,36,6,12,34
100,Fail,56,31,3,10,46
100,Fail,51,38,0,9,42
100,Fail,49,31,0,12,37
100,Fail,53,31,0,11,42
100,Fail,46,32,0,16,30
100,Fail,48,30,5,17,31
100,Fail,50,36,0,12,38
100,Fail,44,35,5,16,28
100,Fail,55,29,6,10,45
100,Fail,39,33,0,23,16
100,Fail,47,34,8,11,36
100,Fail,50,37,0,12,38
100,Fail,50,39,0,10,40
100,Fail,49,23,5,23,26
100,Fail,43,44,0,12,31
100,Fail,49,37,2,12,37
100,Fail,51,36,0,7,44
100,Fail,49,38,0,11,38
100,Fail,50,32,0,9,41
100,Fail,49,30,4,17,32
100,Fail,45,34,0,16,29
100,Fail,47,38,7,8,39
100,Fail,42,42,3,13,29
100,Fail,56,32,0,5,51
100,Fail,54,30,3,13,41
100,Fail,31,44,13,12,19
100,Fail,38,39,0,11,27
100,Fail,47,39,0,12,35
100,Fail,53,35,0,11,42
100,Fail,53,30,0,16,37
100,Fail,49,36,1,14,35
100,Fail,43,41,0,14,29
100,Fail,53,42,0,5,48
100,Fail,47,29,9,15,32
100,Fail,61,34,0,4,57
100,Fail,49,31,0,16,33
100,Fail,47,35,0,17,30
100,Fail,47,46,0,5,42
100,Fail,47,40,0,11,36
100,Fail,49,34,2,15,34
100,Fail,47,39,2,12,35
100,Fail,41,39,0,18,23
100,Fail,48,35,0,15,33
100,Fail,47,35,7,11,36
100,Fail,40,40,0,19,21
100,Fail,44,37,0,17,27
100,Fail,41,43,0,13,28
100,Fail,46,29,0,11,35
100,Fail,35,37,15,13,22
100,Fail,48,37,0,14,34
100,Fail,49,32,0,16,33
100,Fail,49,29,12,10,39
100,Fail,45,37,0,15,30
100,Fail,45,38,0,13,32
100,Fail,49,39,0,11,38
100,Fail,44,34,7,15,29
100,Fail,46,40,0,14,32
100,Fail,49,33,3,15,34
100,Fail,57,32,1,10,47
100,Fail,44,40,0,11,33
100,Fail,35,41,0,20,15
100,Fail,53,36,3,8,45
100,Fail,50,32,0,17,33
100,Fail,41,34,0,18,23
100,Fail,49,37,0,11,38
100,Fail,45,35,3,17,28
100,Fail,43,41,0,10,33
100,Fail,50,35,0,10,40
100,Fail,50,34,0,16,34
100,Fail,51,36,4,9,42
100,Fail,41,34,9,16,25
100,Fail,48,35,0,12,36
100,Fail,47,40,0,10,37
100,Fail,45,28,0,18,27
100,Fail,45,37,7,11,34
100,Fail,51,34,1,14,37
100,Fail,49,39,0,11,38
100,Fail,50,34,0,13,37
100,Fail,49,37,0,14,35
100,Fail,45,34,0,16,29
100,Fail,54,24,11,11,43
100,Fail,47,44,2,7,40
100,Fail,50,36,0,12,38
100,Fail,49,33,0,16,33
100,Fail,47,37,0,13,34
100,Fail,52,40,0,8,44
100,Fail,48,39,1,12,36
100,Fail,45,41,2,12,33
100,Fail,46,42,0,12,34
100,Fail,51,34,0,12,39
100,Fail,58,28,4,10,48
100,Fail,48,36,5,11,37
100,Fail,45,28,0,17,28
100,Fail,48,40,0,11,37
100,Fail,45,32,0,16,29
100,Fail,52,31,3,14,38
100,Fail,48,43,0,7,41
100,Fail,47,25,13,15,32
100,Fail,54,36,0,10,44
100,Fail,45,38,0,11,34
100,Fail,47,39,0,11,36
100,Fail,49,29,9,13,36
100,Fail,49,41,0,10,39
100,Fail,55,31,4,10,45
100,Fail,54,33,0,11,43
100,Fail,47,35,5,13,34
100,Fail,46,35,2,17,29
100,Fail,42,31,0,10,32
100,Fail,48,35,0,14,34
100,Fail,42,44,0,14,28
100,Fail,48,34,4,14,34
100,Fail,53,32,0,13,40
100,Fail,44,38,7,11,33
100,Fail,40,38,10,12,28
100,Fail,50,24,9,17,33
100,Fail,43,40,0,17,26
100,Fail,42,39,7,12,30
100,Fail,53,37,0,9,44
100,Fail,42,33,10,15,27
100,Fail,45,40,1,14,31
100,Fail,53,33,0,10,43
100,Fail,51,31,5,13,38
100,Fail,51,34,0,14,37
100,Fail,51,37,0,12,39
100,Fail,49,36,1,14,35
100,Fail,46,35,0,16,30
100,Fail,51,32,0,12,39
100,Fail,43,42,0,10,33
100,Fail,51,35,0,9,42
100,Fail,47,31,0,17,30
100,Fail,56,33,0,11,45
100,Fail,50,35,0,15,35
100,Fail,46,39,0,12,34
100,Fail,45,40,1,14,31
100,Fail,36,42,4,18,18
100,Fail,51,38,1,10,41
100,Fail,45,36,0,17,28
100,Fail,48,30,0,15,33
100,Fail,46,41,0,12,34
100,Fail,54,29,0,17,37
100,Fail,44,38,0,13,31
100,Fail,48,34,0,18,30
100,Fail,46,40,0,11,35
100,Fail,49,34,0,9,40
100,Fail,38,42,3,17,21
100,Fail,49,38,1,12,37
100,Fail,49,32,0,13,36
100,Fail,46,37,7,10,36
100,Fail,46,31,0,19,27
100,Fail,50,34,0,13,37
100,Fail,48,36,0,14,34
100,Fail,47,35,0,14,33
100,Fail,54,32,2,12,42
100,Fail,40,38,0,17,23
100,Fail,49,32,4,15,34
100,Fail,57,26,1,16,41
100,Fail,47,32,0,18,29
100,Fail,46,37,4,13,33
100,Fail,47,39,0,12,35
100,Fail,42,38,6,14,28
100,Fail,52,32,0,13,39
100,Fail,50,32,0,16,34
100,Fail,48,35,2,15,33
100,Fail,43,35,0,11,32
100,Fail,40,45,0,12,28
100,Fail,50,34,6,10,40
100,Fail,40,46,0,11,29
100,Fail,46,34,0,14,32
100,Fail,51,32,0,12,39
100,Fail,46,41,0,11,35
100,Fail,50,32,4,14,36
100,Fail,53,37,0,9,44
100,Fail,47,34,2,17,30
100,Fail,56,29,0,10,46
100,Fail,47,38,4,11,36
100,Fail,52,32,5,11,41
100,Fail,53,25,10,12,41
100,Fail,46,38,4,12,34
100,Fail,47,37,0,14,33
100,Fail,40,39,7,14,26
100,Fail,45,37,2,16,29
100,Fail,48,33,0,14,34
100,Fail,38,36,0,16,22
100,Fail,44,38,8,10,34
100,Fail,52,30,0,13,39
100,Fail,57,35,0,7,50
100,Fail,44,47,0,8,36
100,Fail,45,32,13,10,35
100,Fail,49,39,0,10,39
100,Fail,39,36,11,14,25
100,Fail,49,34,0,16,33
100,Fail,48,34,0,11,37
100,Fail,52,37,2,9,43
100,Fail,47,38,0,14,33
100,Fail,47,37,6,10,37
100,Fail,48,39,0,11,37
100,Fail,45,34,4,17,28
100,Fail,49,35,0,11,38
100,Fail,44,39,3,14,30
100,Fail,52,31,0,14,38
100,Fail,47,43,0,7,40
100,Fail,55,31,2,12,43
100,Fail,51,33,0,14,37
100,Fail,44,39,0,13,31
100,Fail,54,33,2,11,43
100,Fail,48,41,0,10,38
100,Fail,50,29,6,15,35
100,Fail,47,40,0,11,36
100,Fail,46,36,3,15,31
100,Fail,48,34,0,16,32
100,Fail,50,36,3,11,39
100,Fail,46,36,0,16,30
100,Fail,46,38,4,12,34
100,Fail,45,37,5,13,32
100,Fail,48,35,0,13,35
100,Fail,52,38,0,9,43
100,Fail,44,43,1,12,32
100,Fail,51,35,0,13,38
100,Fail,45,46,0,9,36
100,Fail,50,35,2,13,37
100,Fail,44,35,10,11,33
100,Fail,47,38,5,10,37
100,Fail,44,38,6,12,32
100,Fail,47,30,9,14,33
100,Fail,46,38,0,10,36
100,Fail,39,39,8,14,25
100,Fail,54,38,1,7,47
100,Fail,49,38,0,13,36
100,Fail,40,43,0,15,25
100,Fail,39,40,0,18,21
100,Fail,47,44,3,6,41
100,Fail,53,30,4,13,40
100,Fail,34,46,0,16,18
100,Fail,56,32,0,10,46
100,Fail,43,38,11,8,35
100,Fail,48,35,4,13,35
100,Fail,53,40,0,7,46
100,Fail,52,24,0,17,35
100,Fail,46,33,2,19,27
100,Fail,46,38,2,14,32
100,Fail,46,33,1,20,26
100,Fail,42,46,2,10,32
100,Fail,39,44,3,14,25
100,Fail,43,44,3,10,33
100,Fail,44,38,0,18,26
100,Fail,52,35,0,11,41
100,Fail,51,28,4,17,34
100,Fail,45,33,9,13,32
100,Fail,56,34,0,9,47
100,Fail,56,28,0,15,41
100,Fail,56,33,0,11,45
100,Fail,52,33,0,11,41
100,Fail,49,41,1,9,40
100,Fail,48,35,1,16,32
100,Fail,41,40,0,14,27
100,Fail,47,28,6,19,28
100,Fail,51,30,3,16,35
100,Fail,43,33,8,16,27
100,Fail,52,33,0,12,40
100,Fail,50,33,4,13,37
100,Fail,54,34,0,9,45
100,Fail,49,30,0,14,35
100,Fail,49,33,6,12,37
100,Fail,46,32,0,21,25
100,Fail,47,36,0,15,32
100,Fail,40,41,0,15,25
100,Fail,44,34,0,16,28
100,Fail,45,37,0,9,36
100,Fail,49,36,2,13,36
100,Fail,54,34,3,9,45
100,Fail,54,39,2,5,49
100,Fail,59,26,6,9,50
100,Fail,44,36,5,15,29
100,Fail,48,40,0,10,38
100,Fail,40,41,1,18,22
100,Fail,46,41,1,12,34
100,Fail,51,28,6,15,36
100,Fail,46,40,0,12,34
100,Fail,43,39,0,13,30
100,Fail,42,39,8,11,31
100,Fail,47,31,8,14,33
100,Fail,47,37,6,10,37
100,Fail,49,34,0,15,34
100,Fail,51,39,1,9,42
100,Fail,47,39,3,11,36
100,Fail,51,34,0,15,36
100,Fail,43,36,3,18,25
100,Fail,48,40,6,6,42
100,Fail,45,37,0,16,29
100,Fail,41,44,4,11,30
100,Fail,43,33,10,14,29
100,Fail,53,29,5,13,40
100,Fail,39,43,0,12,27
100,Fail,48,38,6,8,40
100,Fail,48,45,0,6,42
100,Fail,50,31,0,13,37
100,Fail,42,38,11,9,33
100,Fail,35,47,6,12,23
100,Fail,44,39,0,12,32
100,Fail,52,35,0,12,40
100,Fail,44,43,2,11,33
100,Fail,44,32,0,17,27
100,Fail,42,38,4,16,26
100,Fail,40,42,1,17,23
100,Fail,52,31,0,14,38
100,Fail,49,38,3,10,39
100,Fail,43,43,2,12,31
100,Fail,49,38,1,12,37
100,Fail,51,30,7,12,39
100,Fail,52,32,0,12,40
100,Fail,46,35,0,16,30
100,Fail,54,34,3,9,45
100,Fail,45,42,0,12,33
100,Fail,56,24,0,15,41
100,Fail,55,34,0,9,46
100,Fail,45,37,6,12,33
100,Fail,50,35,3,12,38
100,Fail,43,36,0,16,27
100,Fail,55,34,2,9,46
100,Fail,53,36,0,9,44
100,Fail,47,35,0,17,30
100,Fail,40,44,0,15,25
100,Fail,46,34,4,16,30
100,Fail,42,38,5,15,27
100,Fail,52,32,3,13,39
100,Fail,53,32,3,12,41
100,Fail,48,38,0,9,39
100,Fail,39,41,8,12,27
100,Fail,47,32,0,16,31
100,Fail,43,45,0,8,35
100,Fail,52,37,0,10,42
100,Fail,51,29,0,15,36
100,Fail,46,35,4,15,31
100,Fail,45,31,4,20,25
100,Fail,57,34,0,9,48
100,Fail,53,33,2,12,41
100,Fail,48,37,1,14,34
100,Fail,55,31,1,13,42
100,Fail,53,32,0,7,46
100,Fail,45,34,0,17,28
100,Fail,43,39,3,15,28
100,Fail,50,26,8,16,34
100,Fail,46,32,3,19,27
100,Fail,46,36,3,15,31
100,Fail,38,43,5,14,24
100,Fail,56,29,0,13,43
100,Fail,53,36,0,10,43
100,Fail,44,25,0,19,25
100,Fail,47,35,0,13,34
100,Fail,49,35,3,13,36
100,Fail,48,29,9,14,34
100,Fail,51,32,0,14,37
100,Fail,47,39,1,13,34
100,Fail,50,32,0,11,39
100,Fail,55,39,0,5,50
100,Fail,51,28,7,14,37
100,Fail,47,41,0,10,37
100,Fail,51,35,0,14,37
100,Fail,44,32,0,19,25
100,Fail,47,37,0,13,34
100,Fail,47,37,0,14,33
100,Fail,55,33,0,9,46
100,Fail,53,36,0,8,45
100,Fail,49,32,0,16,33
100,Fail,48,35,0,12,36
100,Fail,44,38,1,17,27
100,Fail,51,39,1,9,42
100,Fail,49,31,0,14,35
100,Fail,47,41,0,12,35
100,Fail,49,35,1,15,34
100,Fail,54,35,2,9,45
100,Fail,47,32,0,15,32
100,Fail,52,35,0,8,44
100,Fail,47,33,0,20,27
100,Fail,49,36,2,13,36
100,Fail,42,42,0,11,31
100,Fail,55,33,1,11,44
100,Fail,46,38,0,14,32
100,Fail,40,37,5,18,22
100,Fail,52,27,7,14,38
100,Fail,51,33,3,13,38
100,Fail,53,33,0,14,39
100,Fail,41,40,7,12,29
100,Fail,49,39,7,5,44
100,Fail,52,37,2,9,43
100,Fail,52,29,0,15,37
100,Fail,55,30,4,11,44
100,Fail,43,34,10,13,30
100,Fail,48,35,0,12,36
100,Fail,53,35,0,12,41
100,Fail,53,38,0,5,48
100,Fail,45,43,0,12,33
100,Fail,45,34,5,16,29
100,Fail,48,39,2,11,37
100,Fail,50,38,1,11,39
100,Fail,47,40,0,10,37
100,Fail,46,37,2,15,31
100,Fail,45,43,0,12,33
100,Fail,47,28,0,19,28
100,Fail,54,28,7,11,43
100,Fail,51,37,3,9,42
100,Fail,36,50,0,14,22
100,Fail,46,28,0,12,34
100,Fail,55,36,0,6,49
100,Fail,46,31,0,12,34
100,Fail,47,40,0,11,36
100,Fail,47,33,0,10,37
100,Fail,45,36,0,17,28
100,Fail,47,42,0,11,36
100,Fail,47,33,0,13,34
100,Fail,45,43,0,12,33
100,Fail,50,33,0,11,39
100,Fail,54,28,1,17,37
100,Fail,44,39,2,15,29
100,Fail,45,37,9,9,36
100,Fail,46,40,3,11,35
100,Fail,47,32,0,13,34
100,Fail,49,39,4,8,41
100,Fail,51,33,1,15,36
100,Fail,47,37,0,16,31
100,Fail,44,36,0,17,27
100,Fail,43,34,0,16,27
100,Fail,51,35,7,7,44
100,Fail,53,31,5,11,42
100,Fail,56,38,1,5,51
100,Fail,55,34,0,7,48
100,Fail,54,35,2,9,45
100,Fail,57,34,1,8,49
100,Fail,51,36,1,12,39
100,Fail,48,36,0,11,37
100,Fail,54,38,0,8,46
100,Fail,49,37,0,14,35
100,Fail,46,36,4,14,32
100,Fail,55,28,0,13,42
100,Fail,46,39,0,10,36
100,Fail,43,37,4,16,27
100,Fail,43,34,0,15,28
100,Fail,47,34,3,16,31
100,Fail,50,36,0,14,36
100,Fail,53,32,0,10,43
100,Fail,53,32,2,13,40
100,Fail,48,39,0,10,38
100,Fail,47,39,3,11,36
100,Fail,53,39,0,8,45
100,Fail,56,31,0,8,48
100,Fail,50,41,0,8,42
100,Fail,54,34,0,10,44
100,Fail,46,37,3,14,32
100,Fail,41,35,5,19,22
100,Fail,45,32,0,17,28
100,Fail,44,37,5,14,30
100,Fail,52,36,1,11,41
100,Fail,47,35,7,11,36
100,Fail,48,32,0,20,28
100,Fail,48,34,0,16,32
100,Fail,47,39,0,14,33
100,Fail,46,32,0,14,32
100,Fail,48,39,0,11,37
100,Fail,46,34,0,19,27
100,Fail,46,38,0,14,32
100,Fail,51,38,5,6,45
100,Fail,53,35,0,11,42
100,Fail,48,30,7,15,33
100,Fail,44,41,0,14,30
100,Fail,43,42,2,13,30
100,Fail,48,31,11,10,38
100,Fail,52,39,0,6,46
100,Fail,53,33,0,14,39
100,Fail,56,34,0,8,48
100,Fail,44,39,0,11,33
100,Fail,41,30,8,21,20
100,Fail,43,39,0,16,27
100,Fail,43,38,1,18,25
100,Fail,45,35,9,11,34
100,Fail,45,39,0,7,38
100,Fail,45,39,0,15,30
100,Fail,47,38,1,14,33
100,Fail,47,34,0,8,39
100,Fail,46,38,0,13,33
100,Fail,54,28,0,18,36
100,Fail,48,37,0,15,33
100,Fail,51,33,0,10,41
100,Fail,47,35,0,14,33
100,Fail,40,34,6,20,20
100,Fail,47,36,0,14,33
100,Fail,46,33,0,17,29
100,Fail,50,36,0,8,42
100,Fail,53,31,0,12,41
100,Fail,52,29,0,13,39
100,Fail,52,32,0,14,38
100,Fail,49,34,5,12,37
100,Fail,55,33,0,12,43
100,Fail,51,34,0,6,45
100,Fail,46,38,4,12,34
100,Fail,49,36,4,11,38
100,Fail,53,33,0,11,42
100,Fail,47,31,0,16,31
100,Fail,45,27,10,18,27
100,Fail,47,38,8,7,40
100,Fail,47,39,6,8,39
100,Fail,52,37,0,9,43
100,Fail,51,30,3,16,35
100,Fail,52,33,0,15,37
100,Fail,52,33,0,14,38
100,Fail,52,27,5,16,36
100,Fail,45,36,2,17,28
100,Fail,34,40,0,14,20
100,Fail,52,32,1,15,37
100,Fail,50,37,0,11,39
100,Fail,49,34,0,12,37
100,Fail,51,35,7,7,44
100,Fail,48,38,2,12,36
100,Fail,42,37,10,11,31
100,Fail,49,30,5,16,33
100,Fail,53,31,0,13,40
100,Fail,45,31,7,17,28
100,Fail,48,32,0,15,33
100,Fail,48,34,0,17,31
100,Fail,46,40,1,13,33
100,Fail,43,39,0,12,31
100,Fail,47,38,0,14,33
100,Fail,46,36,9,9,37
100,Fail,52,32,3,13,39
100,Fail,36,45,0,17,19
100,Fail,52,34,0,10,42
100,Fail,53,37,0,10,43
100,Fail,51,29,0,20,31
100,Fail,42,35,4,19,23
100,Fail,49,27,10,14,35
100,Fail,53,31,0,12,41
100,Fail,54,38,0,7,47
100,Fail,45,42,0,12,33
100,Fail,46,41,4,9,37
100,Fail,47,31,0,12,35
100,Fail,48,33,0,15,33
100,Fail,52,33,0,10,42
100,Fail,51,39,2,8,43
100,Fail,53,33,2,12,41
100,Fail,48,37,0,13,35
100,Fail,52,34,1,13,39
100,Fail,42,35,9,14,28
100,Fail,51,35,1,13,38
100,Fail,46,41,2,11,35
100,Fail,42,37,8,13,29
100,Fail,44,42,3,11,33
100,Fail,46,36,3,15,31
100,Fail,50,36,0,10,40
100,Fail,52,35,0,11,41
100,Fail,50,39,0,9,41
100,Fail,46,27,7,20,26
100,Fail,51,41,0,7,44
100,Fail,54,38,0,7,47
100,Fail,51,34,3,12,39
100,Fail,47,35,0,13,34
100,Fail,43,34,0,17,26
100,Fail,50,42,0,5,45
100,Fail,50,29,0,15,35
100,Fail,53,37,0,8,45
100,Fail,47,37,0,14,33
100,Fail,42,41,4,13,29
100,Fail,56,34,0,9,47
100,Fail,53,33,0,14,39
100,Fail,50,26,12,12,38
100,Fail,51,36,1,12,39
100,Fail,44,32,9,15,29
100,Fail,59,30,0,10,49
100,Fail,49,40,0,9,40
100,Fail,49,28,8,15,34
100,Fail,44,32,11,13,31
100,Fail,43,33,0,12,31
100,Fail,44,41,10,5,39
100,Fail,47,32,0,17,30
100,Fail,51,33,0,13,38
100,Fail,40,36,0,18,22
100,Fail,50,39,0,7,43
100,Fail,58,25,4,13,45
100,Fail,53,27,0,14,39
100,Fail,56,28,0,12,44
100,Fail,47,37,0,16,31
100,Fail,51,41,1,7,44
100,Fail,46,37,0,12,34
100,Fail,43,36,0,16,27
100,Fail,47,35,5,13,34
100,Fail,54,34,0,9,45
100,Fail,45,36,10,9,36
100,Fail,46,24,0,24,22
100,Fail,50,31,0,18,32
100,Fail,47,39,0,12,35
100,Fail,47,31,0,16,31
100,Fail,49,30,0,13,36
100,Fail,47,30,0,15,32
100,Fail,49,42,1,8,41
100,Fail,48,38,0,10,38
100,Fail,52,34,0,13,39
100,Fail,48,34,0,12,36
100,Fail,50,32,0,15,35
100,Fail,46,28,4,22,24
100,Fail,50,32,0,13,37
100,Fail,44,30,0,18,26
100,Fail,54,32,2,12,42
100,Fail,48,39,3,10,38
100,Fail,56,33,3,8,48
100,Fail,47,42,0,11,36
100,Fail,52,33,1,14,38
100,Fail,48,39,0,7,41
100,Fail,47,37,4,12,35
100,Fail,51,33,0,11,40
100,Fail,50,37,0,9,41
100,Fail,35,35,0,21,14
100,Fail,34,40,15,11,23
100,Fail,56,33,4,7,49
100,Fail,48,36,4,12,36
100,Fail,46,28,9,17,29
100,Fail,49,38,3,10,39
100,Fail,54,36,0,6,48
100,Fail,47,37,1,15,32
100,Fail,51,32,0,13,38
100,Fail,50,40,0,9,41
100,Fail,45,40,0,12,33
100,Fail,50,41,1,8,42
100,Fail,42,39,5,14,28
100,Fail,49,30,0,15,34
100,Fail,49,37,4,10,39
100,Fail,52,40,1,7,45
100,Fail,38,45,0,11,27
100,Fail,51,39,1,9,42
100,Fail,46,40,3,11,35
100,Fail,51,34,0,11,40
100,Fail,46,32,7,15,31
100,Fail,41,40,3,16,25
100,Fail,40,35,0,21,19
100,Fail,49,34,3,14,35
100,Fail,50,34,4,12,38
100,Fail,47,38,1,14,33
100,Fail,56,34,0,8,48
100,Fail,51,37,2,10,41
100,Fail,50,38,0,12,38
100,Fail,46,38,1,15,31
100,Fail,43,35,0,10,33
100,Fail,44,36,8,12,32
100,Fail,40,38,4,18,22
100,Fail,50,37,0,10,40
100,Fail,42,42,6,10,32
100,Fail,39,46,1,14,25
100,Fail,49,28,0,22,27
100,Fail,44,34,13,9,35
100,Fail,48,34,5,13,35
100,Fail,49,40,0,10,39
100,Fail,43,32,0,18,25
100,Fail,49,36,0,13,36
100,Fail,47,36,0,12,35
100,Fail,46,36,0,14,32
100,Fail,51,33,4,12,39
100,Fail,49,37,2,12,37
100,Fail,46,39,0,14,32
100,Fail,61,23,1,15,46
100,Fail,46,31,5,18,28
100,Fail,48,29,6,17,31
100,Fail,48,34,3,15,33
100,Fail,48,30,0,14,34
100,Fail,47,39,6,8,39
100,Fail,51,33,8,8,43
100,Fail,47,33,0,18,29
100,Fail,49,35,0,15,34
100,Fail,51,27,0,17,34
100,Fail,43,36,9,12,31
100,Fail,50,29,1,20,30
100,Fail,47,37,4,12,35
100,Fail,48,39,0,12,36
100,Fail,49,36,6,9,40
100,Fail,50,30,0,15,35
100,Fail,45,33,5,17,28
100,Fail,46,39,0,13,33
100,Fail,56,31,0,11,45
100,Fail,48,38,4,10,38
100,Fail,46,36,3,15,31
100,Fail,42,35,0,14,28
100,Fail,50,33,5,12,38
100,Fail,46,33,0,10,36
100,Fail,48,33,0,15,33
100,Fail,53,36,0,11,42
100,Fail,45,32,0,18,27
100,Fail,47,36,1,16,31
100,Fail,43,38,5,14,29
100,Fail,58,26,1,15,43
100,Fail,55,33,1,11,44
100,Fail,47,36,0,12,35
100,Fail,46,38,2,14,32
100,Fail,43,43,3,11,32
100,Fail,42,33,9,16,26
100,Fail,48,31,0,11,37
100,Fail,56,34,1,9,47
100,Fail,53,37,2,8,45
100,Fail,49,40,0,9,40
100,Fail,43,36,0,14,29
100,Fail,43,34,10,13,30
100,Fail,47,31,0,16,31
100,Fail,49,37,6,8,41
100,Fail,50,39,1,10,40
100,Fail,41,39,1,19,22
100,Fail,52,26,5,17,35
100,Fail,54,35,0,11,43
100,Fail,47,37,0,15,32
100,Fail,46,35,0,12,34
100,Fail,48,27,12,13,35
100,Fail,50,35,3,12,38
100,Fail,38,40,11,11,27
100,Fail,49,34,3,14,35
100,Fail,49,40,0,9,40
100,Fail,45,39,1,15,30
100,Fail,53,37,1,9,44
100,Fail,46,33,3,18,28
100,Fail,49,33,7,11,38
100,Fail,41,40,5,14,27
100,Fail,41,39,0,16,25
100,Fail,48,29,7,16,32
100,Fail,45,32,15,8,37
100,Fail,48,41,0,11,37
100,Fail,50,37,1,12,38
100,Fail,48,35,0,17,31
100,Fail,43,33,0,15,28
100,Fail,54,30,0,14,40
100,Fail,54,29,4,13,41
100,Fail,51,32,0,17,34
100,Fail,53,32,0,12,41
100,Fail,53,32,0,14,39
100,Fail,45,40,0,15,30
100,Fail,44,33,0,19,25
100,Fail,53,32,3,12,41
100,Fail,38,42,8,12,26
100,Fail,49,33,4,14,35
100,Fail,53,32,0,14,39
100,Fail,56,37,0,7,49
100,Fail,46,37,0,16,30
100,Fail,48,37,0,10,38
100,Fail,50,35,5,10,40
100,Fail,44,37,0,16,28
100,Fail,54,34,0,12,42
100,Fail,51,39,1,9,42
100,Fail,50,32,0,10,40
100,Fail,43,31,6,20,23
100,Fail,49,37,0,12,37
100,Fail,41,38,0,19,22
100,Fail,45,30,0,14,31
100,Fail,52,31,0,12,40
100,Fail,42,33,0,24,18
100,Fail,41,35,5,19,22
100,Fail,45,43,1,11,34
100,Fail,49,40,0,7,42
100,Fail,52,30,8,10,42
100,Fail,54,26,7,13,41
100,Fail,44,44,0,10,34
100,Fail,46,43,0,9,37
100,Fail,46,38,3,13,33
100,Fail,47,34,0,16,31
100,Fail,49,37,0,10,39
100,Fail,54,35,0,11,43
100,Fail,45,43,0,8,37
100,Fail,48,39,0,8,40
100,Fail,50,40,0,10,40
100,Fail,46,38,0,14,32
100,Fail,48,39,2,11,37
100,Fail,46,21,0,20,26
100,Fail,44,42,0,10,34
100,Fail,49,37,0,11,38
100,Fail,48,35,0,14,34
100,Fail,48,36,3,13,35
100,Fail,46,41,1,12,34
100,Fail,50,38,2,10,40
100,Fail,45,38,0,9,36
100,Fail,52,26,5,17,35
100,Fail,49,32,0,17,32
100,Fail,44,33,4,19,25
100,Fail,42,36,5,17,25
100,Fail,46,39,0,12,34
100,Fail,44,39,0,13,31
100,Fail,45,40,3,12,33
100,Fail,47,38,0,14,33
100,Fail,50,33,1,16,34
100,Fail,39,40,0,18,21
100,Fail,48,35,0,13,35
100,Fail,54,35,2,9,45
100,Fail,49,38,2,11,38
100,Fail,50,32,8,10,40
100,Fail,53,27,3,17,36
100,Fail,47,37,3,13,34
100,Fail,49,38,0,5,44
100,Fail,45,37,1,17,28
100,Fail,44,37,2,17,27
100,Fail,53,37,0,7,46
100,Fail,50,33,0,15,35
100,Fail,62,24,0,13,49
100,Fail,51,32,0,17,34
100,Fail,41,42,0,16,25
100,Fail,50,41,3,6,44
100,Fail,49,40,0,11,38
100,Fail,50,35,1,14,36
100,Fail,50,36,0,13,37
100,Fail,49,37,0,11,38
100,Fail,48,37,0,12,36
100,Fail,47,36,0,17,30
100,Fail,45,41,3,11,34
100,Fail,49,37,2,12,37
100,Fail,50,26,10,14,36
100,Fail,53,34,3,10,43
100,Fail,55,32,7,6,49
100,Fail,46,36,0,18,28
100,Fail,53,34,3,10,43
100,Fail,45,40,0,13,32
100,Fail,47,34,0,17,30
100,Fail,44,40,0,16,28
100,Fail,48,35,2,15,33
100,Fail,47,34,0,13,34
100,Fail,56,28,0,14,42
100,Fail,52,30,0,14,38
100,Fail,52,33,0,13,39
100,Fail,49,36,0,13,36
100,Fail,54,35,3,8,46
100,Fail,38,36,0,16,22
100,Fail,55,28,4,13,42
100,Fail,59,30,5,6,53
100,Fail,46,38,4,12,34
100,Fail,43,43,0,11,32
100,Fail,45,37,5,13,32
100,Fail,52,38,0,10,42
100,Fail,57,28,0,8,49
100,Fail,48,41,0,10,38
100,Fail,54,33,5,8,46
100,Fail,39,39,6,16,23
100,Fail,52,24,8,16,36
100,Fail,44,41,5,10,34
100,Fail,49,34,0,14,35
100,Fail,49,35,9,7,42
100,Fail,42,33,6,19,23
100,Fail,42,36,0,15,27
100,Fail,44,30,13,13,31
100,Fail,49,37,0,10,39
100,Fail,49,34,0,13,36
100,Fail,49,39,4,8,41
100,Fail,45,34,5,16,29
100,Fail,41,41,2,16,25
100,Fail,51,37,1,11,40
100,Fail,51,36,0,9,42
100,Fail,45,35,0,14,31
100,Fail,54,27,0,17,37
100,Fail,54,37,0,9,45
100,Fail,50,32,2,16,34
100,Fail,49,36,2,13,36
100,Fail,52,29,0,11,41
100,Fail,49,35,0,13,36
100,Fail,49,35,3,13,36
100,Fail,53,38,0,9,44
100,Fail,44,40,3,13,31
100,Fail,51,32,4,13,38
100,Fail,39,40,0,7,32
100,Fail,53,38,0,9,44
100,Fail,60,29,1,10,50
100,Fail,47,32,11,10,37
100,Fail,52,31,0,11,41
100,Fail,55,38,0,7,48
100,Fail,54,34,0,11,43
100,Fail,54,33,3,10,44
100,Fail,49,35,2,14,35
100,Fail,46,36,2,16,30
100,Fail,51,40,0,9,42
100,Fail,47,35,6,12,35
100,Fail,50,30,0,11,39
100,Fail,50,40,1,9,41
100,Fail,50,35,5,10,40
100,Fail,52,35,0,7,45
100,Fail,49,30,3,18,31
100,Fail,52,34,0,10,42
100,Fail,51,31,0,12,39
100,Fail,52,38,0,9,43
100,Fail,46,34,9,11,35
100,Fail,42,35,0,15,27
100,Fail,46,39,0,13,33
100,Fail,45,40,3,12,33
100,Fail,46,39,0,13,33
100,Fail,47,29,0,17,30
100,Fail,50,29,9,12,38
100,Fail,49,39,0,10,39
100,Fail,47,41,0,9,38
100,Fail,49,31,0,14,35
100,Fail,49,40,2,9,40
100,Fail,48,38,0,9,39
100,Fail,41,38,0,13,28
100,Fail,45,32,0,17,28
100,Fail,36,41,7,16,20
100,Fail,50,33,2,15,35
100,Fail,46,23,0,21,25
100,Fail,38,40,3,19,19
100,Fail,40,43,6,11,29
100,Fail,51,35,0,11,40
100,Fail,53,33,0,13,40
100,Fail,46,37,6,11,35
100,Fail,51,36,0,10,41
100,Fail,48,32,0,14,34
100,Fail,48,36,0,10,38
100,Fail,39,36,12,13,26
100,Fail,55,31,0,11,44
100,Fail,50,36,8,6,44
100,Fail,54,34,0,12,42
100,Fail,42,43,0,11,31
100,Fail,39,35,0,22,17
100,Fail,50,38,0,12,38
100,Fail,48,39,3,10,38
100,Fail,40,36,7,17,23
100,Fail,41,45,0,14,27
100,Fail,53,33,1,13,40
100,Fail,49,32,0,12,37
100,Fail,51,32,0,13,38
100,Fail,46,36,5,13,33
100,Fail,44,40,0,11,33
100,Fail,39,39,5,17,22
100,Fail,43,36,5,16,27
100,Fail,42,44,2,12,30
100,Fail,46,41,3,10,36
100,Fail,49,29,0,17,32
100,Fail,43,40,4,13,30
100,Fail,46,29,0,20,26
100,Fail,49,37,0,14,35
100,Fail,47,32,0,13,34
100,Fail,55,34,2,9,46
100,Fail,50,34,0,12,38
100,Fail,41,42,0,10,31
100,Fail,54,31,6,9,45
100,Fail,46,37,0,11,35
100,Fail,45,41,0,13,32
100,Fail,49,35,9,7,42
100,Fail,50,29,8,13,37
100,Fail,53,25,0,19,34
100,Fail,43,30,0,13,30
100,Fail,48,32,0,14,34
100,Fail,50,33,7,10,40
100,Fail,52,33,3,12,40
100,Fail,48,35,0,12,36
100,Fail,52,36,0,12,40
100,Fail,53,31,0,14,39
100,Fail,44,38,0,14,30
100,Fail,48,36,3,13,35
100,Fail,46,40,0,14,32
100,Fail,43,33,0,17,26
100,Fail,48,30,6,16,32
100,Fail,56,31,2,11,45
100,Fail,50,32,8,10,40
100,Fail,40,41,0,18,22
100,Fail,46,46,3,5,41
100,Fail,48,37,9,6,42
100,Fail,51,39,1,9,42
100,Fail,50,39,3,8,42
100,Fail,47,36,0,11,36
100,Fail,52,35,0,13,39
100,Fail,55,32,4,9,46
100,Fail,54,31,5,10,44
100,Fail,43,37,1,19,24
100,Fail,50,31,4,15,35
100,Fail,58,28,0,12,46
100,Fail,45,44,0,7,38
100,Fail,49,36,3,12,37
100,Fail,45,38,3,14,31
100,Fail,49,37,2,12,37
100,Fail,50,35,0,14,36
100,Fail,39,38,6,17,22
100,Fail,55,36,3,6,49
100,Fail,45,46,0,9,36
100,Fail,46,45,1,8,38
100,Fail,44,40,0,11,33
100,Fail,53,25,7,15,38
100,Fail,52,31,2,15,37
100,Fail,49,42,0,9,40
100,Fail,44,35,0,16,28
100,Fail,50,33,3,14,36
100,Fail,41,48,1,10,31
100,Fail,50,27,0,16,34
100,Fail,50,41,0,8,42
100,Fail,55,36,0,8,47
100,Fail,45,38,4,13,32
100,Fail,47,32,0,14,33
100,Fail,42,44,0,14,28
100,Fail,46,36,11,7,39
100,Fail,55,28,8,9,46
100,Fail,46,35,0,12,34
100,Fail,44,41,6,9,35
100,Fail,47,35,6,12,35
100,Fail,45,38,5,12,33
100,Fail,40,45,0,12,28
100,Fail,47,32,0,13,34
100,Fail,41,45,0,12,29
100,Fail,47,36,0,13,34
100,Fail,48,34,0,8,40
100,Fail,48,34,0,13,35
100,Fail,40,44,0,16,24
100,Fail,52,34,1,13,39
100,Fail,51,34,3,12,39
100,Fail,47,31,10,12,35
100,Fail,51,35,4,10,41
100,Fail,49,35,0,12,37
100,Fail,46,35,2,17,29
100,Fail,37,42,6,15,22
100,Fail,48,34,0,9,39
100,Fail,53,37,0,7,46
100,Fail,44,42,0,9,35
100,Fail,47,37,0,14,33
100,Fail,52,35,0,12,40
100,Fail,51,32,0,13,38
100,Fail,41,46,4,9,32
100,Fail,41,34,2,23,18
100,Fail,49,30,0,13,36
100,Fail,51,40,0,9,42
100,Fail,41,30,0,17,24
100,Fail,45,39,0,10,35
100,Fail,43,34,0,15,28
100,Fail,59,28,1,12,47
100,Fail,54,33,0,8,46
100,Fail,51,40,0,7,44
100,Fail,48,34,4,14,34
100,Fail,44,37,7,12,32
100,Fail,48,37,0,13,35
100,Fail,39,38,9,14,25
100,Fail,42,42,6,10,32
100,Fail,43,37,2,18,25
100,Fail,50,36,2,12,38
100,Fail,58,25,7,10,48
100,Fail,51,35,1,13,38
100,Fail,48,36,0,15,33
100,Fail,48,33,0,13,35
100,Fail,49,26,0,15,34
100,Fail,46,36,0,16,30
100,Fail,46,37,3,14,32
100,Fail,45,35,6,14,31
100,Fail,53,33,0,8,45
100,Fail,50,38,1,11,39
100,Fail,54,36,1,9,45
100,Fail,42,35,8,15,27
100,Fail,49,35,0,13,36
100,Fail,46,33,7,14,32
100,Fail,39,29,13,19,20
100,Fail,41,42,6,11,30
100,Fail,47,42,0,11,36
100,Fail,47,37,6,10,37
100,Fail,48,34,7,11,37
100,Fail,48,33,0,13,35
100,Fail,47,35,0,13,34
100,Fail,40,43,2,15,25
100,Fail,50,38,0,12,38
100,Fail,48,35,0,13,35
100,Fail,55,31,5,9,46
100,Fail,48,35,0,17,31
100,Fail,59,32,0,7,52
100,Fail,53,33,0,14,39
100,Fail,51,30,3,16,35
100,Fail,54,33,1,12,42
100,Fail,49,31,0,12,37
100,Fail,51,37,0,12,39
100,Fail,50,26,10,14,36
100,Fail,43,32,0,22,21
100,Fail,50,34,3,13,37
100,Fail,56,31,0,13,43
100,Fail,52,27,0,11,41
100,Fail,39,38,10,13,26
100,Fail,41,44,0,14,27
100,Fail,47,39,1,13,34
100,Fail,43,36,1,20,23
100,Fail,46,40,0,8,38
100,Fail,48,31,4,17,31
100,Fail,46,42,1,11,35
100,Fail,46,40,2,12,34
100,Fail,59,31,0,10,49
100,Fail,44,42,0,13,31
100,Fail,44,39,0,13,31
100,Fail,48,39,0,12,36
100,Fail,47,39,2,12,35
100,Fail,48,38,2,12,36
100,Fail,47,37,0,16,31
100,Fail,52,32,6,10,42
100,Fail,41,39,0,16,25
100,Fail,59,33,2,6,53
100,Fail,47,32,5,16,31
100,Fail,47,32,0,19,28
100,Fail,54,32,0,14,40
100,Fail,47,41,1,11,36
100,Fail,51,32,1,16,35
100,Fail,50,37,3,10,40
100,Fail,47,30,0,19,28
100,Fail,47,25,15,13,34
100,Fail,51,39,0,9,42
100,Fail,50,30,0,16,34
100,Fail,43,33,0,24,19
100,Fail,53,28,0,11,42
100,Fail,52,32,1,15,37
100,Fail,54,28,0,9,45
100,Fail,44,39,4,13,31
100,Fail,56,33,3,8,48
100,Fail,57,28,8,7,50
100,Fail,52,35,0,11,41
100,Fail,45,34,0,17,28
100,Fail,48,36,6,10,38
100,Fail,45,40,1,14,31
100,Fail,46,36,0,16,30
100,Fail,53,34,0,13,40
100,Fail,48,39,0,11,37
100,Fail,52,31,0,15,37
100,Fail,56,32,3,9,47
100,Fail,55,36,1,8,47
100,Fail,58,30,2,10,48
100,Fail,36,41,0,11,25
100,Fail,45,36,0,15,30
100,Fail,53,32,0,10,43
100,Fail,45,37,6,12,33
100,Fail,43,35,0,19,24
100,Fail,45,33,0,13,32
100,Fail,49,37,6,8,41
100,Fail,51,35,0,10,41
100,Fail,41,38,0,14,27
100,Fail,57,32,0,9,48
100,Fail,42,42,4,12,30
100,Fail,45,40,2,13,32
100,Fail,55,30,0,11,44
100,Fail,51,41,1,7,44
100,Fail,44,41,0,9,35
100,Fail,50,35,1,14,36
100,Fail,55,31,0,11,44
100,Fail,48,40,0,9,39
100,Fail,54,32,0,9,45
100,Fail,42,28,0,15,27
100,Fail,48,37,6,9,39
100,Fail,44,34,13,9,35
100,Fail,47,35,5,13,34
100,Fail,44,33,7,16,28
100,Fail,49,35,4,12,37
100,Fail,51,42,1,6,45
100,Fail,53,36,2,9,44
100,Fail,46,38,0,13,33
100,Fail,52,40,0,8,44
100,Fail,45,40,2,13,32
100,Fail,43,41,5,11,32
100,Fail,43,45,2,10,33
100,Fail,50,36,0,10,40
100,Fail,47,30,5,18,29
100,Fail,47,39,0,13,34
100,Fail,48,33,0,10,38
100,Fail,52,37,0,11,41
100,Fail,52,36,0,11,41
100,Fail,54,28,0,11,43
100,Fail,51,36,0,12,39
100,Fail,48,36,5,11,37
100,Fail,48,36,6,10,38
100,Fail,53,35,0,12,41
100,Fail,54,36,0,6,48
100,Fail,44,40,0,13,31
100,Fail,49,27,8,16,33
100,Fail,43,39,0,13,30
100,Fail,52,31,3,14,38
100,Fail,54,36,3,7,47
100,Fail,52,36,1,11,41
100,Fail,42,34,0,16,26
100,Fail,47,43,0,10,37
100,Fail,53,34,1,12,41
100,Fail,50,36,1,13,37
100,Fail,49,45,0,6,43
100,Fail,57,30,0,7,50
100,Fail,52,33,6,9,43
100,Fail,51,29,4,16,35
100,Fail,47,42,1,10,37
100,Fail,51,28,0,13,38
100,Fail,48,42,0,10,38
100,Fail,44,39,0,15,29
100,Fail,45,37,5,13,32
100,Fail,51,32,2,15,36
100,Fail,41,40,0,15,26
100,Fail,48,41,0,11,37
100,Fail,41,35,2,22,19
100,Fail,40,37,0,23,17
100,Fail,50,31,3,16,34
100,Fail,46,31,0,20,26
100,Fail,44,35,0,12,32
100,Fail,44,39,6,11,33
100,Fail,50,36,2,12,38
100,Fail,50,39,5,6,44
100,Fail,39,40,8,13,26
100,Fail,53,30,9,8,45
100,Fail,46,36,0,17,29
100,Fail,47,34,0,11,36
100,Fail,50,37,0,9,41
100,Fail,39,36,0,21,18
100,Fail,52,33,4,11,41
100,Fail,35,47,0,14,21
100,Fail,39,40,6,15,24
100,Fail,52,29,0,11,41
100,Fail,46,39,4,11,35
100,Fail,52,34,4,10,42
100,Fail,41,33,0,19,22
100,Fail,51,28,0,15,36
100,Fail,52,43,0,5,47
100,Fail,48,36,4,12,36
100,Fail,49,41,2,8,41
100,Fail,47,36,0,13,34
100,Fail,43,39,0,18,25
100,Fail,51,32,8,9,42
100,Fail,46,33,0,13,33
100,Fail,52,34,3,11,41
100,Fail,40,36,0,13,27
100,Fail,47,37,1,15,32
100,Fail,48,43,0,8,40
100,Fail,48,33,0,11,37
100,Fail,44,43,1,12,32
100,Fail,55,32,0,9,46
100,Fail,46,42,2,10,36
100,Fail,52,35,0,8,44
100,Fail,56,31,4,9,47
100,Fail,48,34,3,15,33
100,Fail,54,34,0,12,42
100,Fail,46,40,1,13,33
100,Fail,55,32,0,10,45
100,Fail,51,28,0,19,32
100,Fail,47,38,0,14,33
100,Fail,42,42,0,12,30
100,Fail,46,42,1,11,35
100,Fail,45,40,0,15,30
100,Fail,38,41,5,16,22
100,Fail,51,34,0,15,36
100,Fail,45,28,0,18,27
100,Fail,46,39,0,14,32
100,Fail,57,31,0,11,46
100,Fail,47,39,0,9,38
100,Fail,45,39,0,13,32
100,Fail,42,39,0,13,29
100,Fail,48,40,0,9,39
100,Fail,54,34,2,10,44
100,Fail,45,40,0,12,33
100,Fail,52,32,0,12,40
100,Fail,53,31,4,12,41
100,Fail,47,38,4,11,36
100,Fail,47,36,0,10,37
100,Fail,48,25,12,15,33
100,Fail,47,42,0,10,37
100,Fail,47,36,0,14,33
100,Fail,55,35,0,10,45
100,Fail,52,38,2,8,44
100,Fail,46,38,0,13,33
100,Fail,51,33,3,13,38
100,Fail,47,37,5,11,36
100,Fail,48,37,0,10,38
100,Fail,42,43,0,13,29
100,Fail,48,37,0,13,35
100,Fail,43,35,15,7,36
100,Fail,49,37,5,9,40
100,Fail,52,36,4,8,44
100,Fail,42,38,6,14,28
100,Fail,45,34,0,19,26
100,Fail,48,38,0,11,37
100,Fail,46,36,0,18,28
100,Fail,43,33,0,16,27
100,Fail,51,35,1,13,38
100,Fail,52,36,0,9,43
100,Fail,56,26,1,17,39
100,Fail,42,42,0,15,27
100,Fail,46,41,0,7,39
100,Fail,48,40,0,8,40
100,Fail,43,33,0,14,29
100,Fail,42,36,3,19,23
100,Fail,49,36,6,9,40
100,Fail,44,40,0,11,33
100,Fail,50,37,1,12,38
100,Fail,50,34,4,12,38
100,Fail,51,35,2,12,39
100,Fail,49,31,0,13,36
100,Fail,46,38,4,12,34
100,Fail,47,39,1,13,34
100,Fail,46,37,0,15,31
100,Fail,51,35,0,10,41
100,Fail,50,32,2,16,34
100,Fail,60,30,0,9,51
100,Fail,48,34,2,16,32
100,Fail,48,38,0,12,36
100,Fail,45,31,8,16,29
100,Fail,46,37,7,10,36
100,Fail,53,32,0,13,40
100,Fail,44,37,0,15,29
100,Fail,51,34,0,15,36
100,Fail,49,37,5,9,40
100,Fail,53,29,3,15,38
100,Fail,50,34,1,15,35
100,Fail,49,36,1,14,35
100,Fail,49,40,0,9,40
100,Fail,56,33,0,10,46
100,Fail,55,26,3,16,39
100,Fail,48,33,0,14,34
100,Fail,46,32,7,15,31
100,Fail,52,37,0,11,41
100,Fail,48,31,0,17,31
100,Fail,43,37,0,15,28
100,Fail,41,37,10,12,29
100,Fail,44,35,8,13,31
100,Fail,50,39,2,9,41
100,Fail,49,35,0,14,35
100,Fail,44,37,5,14,30
100,Fail,44,35,0,15,29
100,Fail,36,43,8,13,23
100,Fail,41,43,0,13,28
100,Fail,52,32,2,14,38
100,Fail,46,41,1,12,34
100,Fail,45,45,1,9,36
100,Fail,45,32,9,14,31
100,Fail,42,37,6,15,27
100,Fail,44,41,3,12,32
100,Fail,48,31,8,13,35
100,Fail,59,36,0,5,54
100,Fail,43,42,0,8,35
100,Fail,45,44,0,9,36
100,Fail,47,39,0,12,35
100,Fail,43,37,0,14,29
100,Fail,49,32,0,12,37
100,Fail,50,32,6,12,38
100,Fail,48,35,7,10,38
100,Fail,48,39,3,10,38
100,Fail,44,41,1,14,30
100,Fail,53,35,0,7,46
100,Fail,47,36,0,10,37
100,Fail,50,32,0,13,37
100,Fail,50,36,0,12,38
100,Fail,45,36,6,13,32
100,Fail,53,33,0,14,39
100,Fail,50,30,0,14,36
100,Fail,45,39,1,15,30
100,Fail,54,31,8,7,47
100,Fail,47,33,8,12,35
100,Fail,47,38,0,10,37
100,Fail,47,31,2,20,27
100,Fail,44,37,0,18,26
100,Fail,49,28,7,16,33
100,Fail,44,37,2,17,27
100,Fail,46,34,1,19,27
100,Fail,49,38,0,8,41
100,Fail,39,32,0,15,24
100,Fail,53,30,0,15,38
100,Fail,47,39,2,12,35
100,Fail,44,41,1,14,30
100,Fail,47,43,0,10,37
100,Fail,44,38,0,14,30
100,Fail,47,39,0,13,34
100,Fail,47,40,2,11,36
100,Fail,52,32,0,15,37
100,Fail,52,27,13,8,44
100,Fail,53,34,3,10,43
100,Fail,43,33,10,14,29
100,Fail,51,35,3,11,40
100,Fail,53,37,0,8,45
100,Fail,43,36,0,12,31
100,Fail,44,37,7,12,32
100,Fail,46,32,3,19,27
100,Fail,47,32,0,17,30
100,Fail,44,30,8,18,26
100,Fail,42,39,0,16,26
100,Fail,47,37,5,11,36
100,Fail,48,37,2,13,35
100,Fail,58,30,0,12,46
100,Fail,48,35,0,14,34
100,Fail,47,36,4,13,34
100,Fail,45,34,6,15,30
100,Fail,44,40,0,10,34
100,Fail,47,34,0,16,31
100,Fail,45,41,7,7,38
100,Fail,48,39,1,12,36
100,Fail,47,29,4,20,27
100,Fail,53,30,2,15,38
100,Fail,42,37,7,14,28
100,Fail,51,30,0,15,36
100,Fail,46,35,6,13,33
100,Fail,52,29,0,15,37
100,Fail,55,36,0,9,46
100,Fail,50,34,5,11,39
100,Fail,47,36,0,16,31
100,Fail,52,32,1,15,37
100,Fail,53,38,2,7,46
100,Fail,48,41,0,11,37
100,Fail,47,40,1,12,35
100,Fail,43,42,0,10,33
100,Fail,58,29,5,8,50
100,Fail,44,38,0,12,32
100,Fail,48,31,0,17,31
100,Fail,48,37,3,12,36
100,Fail,46,38,0,14,32
100,Fail,52,34,0,12,40
100,Fail,40,46,0,11,29
100,Fail,44,40,0,14,30
100,Fail,55,37,0,6,49
100,Fail,51,35,0,14,37
100,Fail,49,36,0,10,39
100,Fail,47,37,3,13,34
100,Fail,46,30,7,17,29
100,Fail,50,34,0,15,35
100,Fail,49,33,0,15,34
100,Fail,43,39,0,12,31
100,Fail,39,30,0,20,19
100,Fail,37,41,0,21,16
100,Fail,48,30,0,13,35
100,Fail,47,34,3,16,31
100,Fail,53,39,1,7,46
100,Fail,40,42,8,10,30
100,Fail,45,42,1,12,33
100,Fail,49,35,0,15,34
100,Fail,48,34,3,15,33
100,Fail,54,34,0,7,47
100,Fail,51,42,0,7,44
100,Fail,54,30,0,12,42
100,Fail,48,32,0,13,35
100,Fail,47,40,0,10,37
100,Fail,50,36,0,10,40
100,Fail,48,34,7,11,37
100,Fail,46,36,5,13,33
100,Fail,44,34,0,12,32
100,Fail,50,38,0,11,39
100,Fail,51,28,0,19,32
100,Fail,38,40,9,13,25
100,Fail,52,40,0,7,45
100,Fail,46,39,5,10,36
100,Fail,54,32,0,14,40
100,Fail,42,34,0,17,25
100,Fail,50,37,0,11,39
100,Fail,48,29,0,13,35
100,Fail,56,33,0,11,45
100,Fail,52,38,0,10,42
100,Fail,57,31,1,11,46
100,Fail,46,40,0,12,34
100,Fail,48,39,0,13,35
100,Fail,45,37,0,14,31
100,Fail,47,42,0,7,40
100,Fail,56,33,0,8,48
100,Fail,40,40,0,16,24
100,Fail,47,29,10,14,33
100,Fail,52,34,0,11,41
100,Fail,47,35,7,11,36
100,Fail,49,35,0,16,33
100,Fail,44,42,5,9,35
100,Fail,50,34,3,13,37
100,Fail,43,32,3,22,21
100,Fail,52,39,1,8,44
100,Fail,48,41,4,7,41
100,Fail,48,38,1,13,35
100,Fail,31,38,19,12,19
100,Fail,48,36,0,12,36
100,Fail,48,40,0,11,37
100,Fail,44,40,4,12,32
100,Fail,50,36,0,14,36
100,Fail,49,28,0,14,35
100,Fail,45,41,0,13,32
100,Fail,47,36,1,16,31
100,Fail,46,36,2,16,30
100,Fail,48,39,0,13,35
100,Fail,44,34,0,14,30
100,Fail,53,31,4,12,41
100,Fail,50,38,0,5,45
100,Fail,51,34,0,12,39
100,Fail,39,45,4,12,27
100,Fail,43,32,0,17,26
100,Fail,43,37,0,15,28
100,Fail,47,36,4,13,34
100,Fail,44,39,0,11,33
100,Fail,46,34,0,16,30
100,Fail,37,39,0,16,21
100,Fail,45,31,8,16,29
100,Fail,47,34,0,10,37
100,Fail,49,33,0,12,37
100,Fail,38,45,5,12,26
100,Fail,49,41,0,9,40
100,Fail,44,43,0,8,36
100,Fail,57,28,2,13,44
100,Fail,38,39,11,12,26
100,Fail,41,36,0,13,28
100,Fail,51,31,0,16,35
100,Fail,55,29,4,12,43
100,Fail,41,41,4,14,27
100,Fail,42,37,14,7,35
100,Fail,51,36,0,11,40
100,Fail,53,35,0,8,45
100,Fail,41,37,6,16,25
100,Fail,48,43,2,7,41
100,Fail,43,42,0,14,29
100,Fail,58,28,0,12,46
100,Fail,53,33,1,13,40
100,Fail,54,30,4,12,42
100,Fail,49,36,6,9,40
100,Fail,50,39,0,9,41
100,Fail,50,38,1,11,39
100,Fail,49,36,0,9,40
100,Fail,45,36,0,17,28
100,Fail,51,37,1,11,40
100,Fail,48,33,2,17,31
100,Fail,52,32,4,12,40
100,Fail,54,33,0,11,43
100,Fail,46,36,4,14,32
100,Fail,53,30,0,15,38
100,Fail,54,29,7,10,44
100,Fail,53,33,1,13,40
100,Fail,45,36,0,17,28
100,Fail,53,30,5,12,41
100,Fail,41,36,7,16,25
100,Fail,47,39,5,9,38
100,Fail,39,42,0,18,21
100,Fail,36,36,14,14,22
100,Fail,47,37,0,10,37
100,Fail,42,33,8,17,25
100,Fail,50,33,1,16,34
100,Fail,48,41,1,10,38
100,Fail,40,31,0,17,23
100,Fail,42,43,3,12,30
100,Fail,51,38,0,11,40
100,Fail,43,38,0,14,29
100,Fail,52,34,0,11,41
100,Fail,41,35,0,22,19
100,Fail,45,36,9,10,35
100,Fail,45,39,6,10,35
100,Fail,48,35,0,15,33
100,Fail,41,32,0,21,20
100,Fail,53,37,0,8,45
100,Fail,49,33,5,13,36
100,Fail,47,34,5,14,33
100,Fail,49,43,0,8,41
100,Fail,57,30,0,11,46
100,Fail,47,30,8,15,32
100,Fail,41,39,2,18,23
100,Fail,48,33,0,14,34
100,Fail,46,36,2,16,30
100,Fail,49,41,0,9,40
100,Fail,50,33,2,15,35
100,Fail,46,34,0,16,30
100,Fail,54,32,2,12,42
100,Fail,38,42,0,11,27
100,Fail,51,35,0,11,40
100,Fail,50,39,0,11,39
100,Fail,54,36,0,10,44
100,Fail,40,36,7,17,23
100,Fail,56,29,0,14,42
100,Fail,51,37,0,10,41
100,Fail,47,30,7,16,31
100,Fail,52,37,2,9,43
100,Fail,49,37,4,10,39
100,Fail,51,34,0,12,39
100,Fail,54,32,0,7,47
100,Fail,47,41,0,9,38
100,Fail,50,34,0,9,41
100,Fail,48,36,0,13,35
100,Fail,51,32,10,7,44
100,Fail,48,40,0,8,40
100,Fail,41,42,3,14,27
100,Fail,44,37,0,15,29
100,Fail,51,30,4,15,36
100,Fail,44,36,0,10,34
100,Fail,43,35,4,18,25
100,Fail,42,32,0,15,27
100,Fail,46,28,11,15,31
100,Fail,51,36,0,13,38
100,Fail,47,41,0,11,36
100,Fail,44,36,7,13,31
100,Fail,42,39,0,18,24
100,Fail,49,41,2,8,41
100,Fail,49,36,4,11,38
100,Fail,45,48,0,7,38
100,Fail,40,38,2,20,20
100,Fail,49,36,0,13,36
100,Fail,43,36,9,12,31
100,Fail,52,28,7,13,39
100,Fail,37,39,2,22,15
100,Fail,51,40,0,6,45
100,Fail,52,36,0,11,41
100,Fail,49,41,0,9,40
100,Fail,43,38,2,17,26
100,Fail,45,36,3,16,29
100,Fail,45,43,1,11,34
100,Fail,42,44,4,10,32
100,Fail,49,37,3,11,38
100,Fail,45,35,3,17,28
100,Fail,53,23,8,16,37
100,Fail,49,35,0,9,40
100,Fail,46,33,0,21,25
100,Fail,50,34,2,14,36
100,Fail,44,33,0,18,26
100,Fail,46,43,4,7,39
100,Fail,39,40,0,17,22
100,Fail,47,34,0,15,32
100,Fail,39,38,0,13,26
100,Fail,48,34,0,17,31
100,Fail,51,29,0,17,34
100,Fail,56,24,6,14,42
100,Fail,43,41,0,12,31
100,Fail,50,36,3,11,39
100,Fail,45,41,0,10,35
100,Fail,44,29,5,22,22
100,Fail,45,36,1,18,27
100,Fail,55,30,6,9,46
100,Fail,41,34,10,15,26
100,Fail,44,38,0,11,33
100,Fail,45,37,7,11,34
100,Fail,48,37,0,8,40
100,Fail,48,37,0,15,33
100,Fail,48,38,4,10,38
100,Fail,45,36,0,14,31
100,Fail,36,49,4,11,25
100,Fail,34,46,2,18,16
100,Fail,44,42,0,14,30
100,Fail,48,42,0,9,39
100,Fail,39,43,2,16,23
100,Fail,48,31,4,17,31
100,Fail,44,40,8,8,36
100,Fail,49,37,2,12,37
100,Fail,56,25,0,15,41
100,Fail,44,34,8,14,30
100,Fail,49,38,3,10,39
100,Fail,43,41,0,14,29
100,Fail,51,38,0,11,40
100,Fail,51,31,0,12,39
100,Fail,47,34,2,17,30
100,Fail,46,32,9,13,33
100,Fail,44,42,0,11,33
100,Fail,41,37,0,17,24
100,Fail,53,33,0,9,44
100,Fail,47,37,0,12,35
100,Fail,50,37,0,12,38
100,Fail,46,37,3,14,32
100,Fail,46,35,6,13,33
100,Fail,50,35,0,12,38
100,Fail,39,42,6,13,26
100,Fail,48,29,0,14,34
100,Fail,51,30,1,18,33
100,Fail,48,33,0,16,32
100,Fail,56,34,2,8,48
100,Fail,42,43,0,11,31
100,Fail,42,38,4,16,26
100,Fail,43,35,0,17,26
100,Fail,43,39,0,14,29
100,Fail,55,30,4,11,44
100,Fail,55,32,0,8,47
100,Fail,37,45,0,18,19
100,Fail,43,36,0,19,24
100,Fail,52,33,0,11,41
100,Fail,57,28,0,15,42
100,Fail,47,37,4,12,35
100,Fail,52,30,4,14,38
100,Fail,52,35,0,12,40
100,Fail,48,37,0,14,34
100,Fail,47,35,0,12,35
100,Fail,55,34,5,6,49
100,Fail,45,39,4,12,33
100,Fail,48,36,0,11,37
100,Fail,46,38,0,12,34
100,Fail,41,41,3,15,26
100,Fail,44,40,0,15,29
100,Fail,53,32,0,13,40
100,Fail,50,28,0,16,34
100,Fail,52,33,7,8,44
100,Fail,40,36,7,17,23
100,Fail,42,35,0,21,21
100,Fail,45,35,4,16,29
100,Fail,53,26,9,12,41
100,Fail,53,38,0,9,44
100,Fail,35,45,7,13,22
100,Fail,43,37,0,13,30
100,Fail,52,30,1,17,35
100,Fail,55,34,0,10,45
100,Fail,49,39,1,11,38
100,Fail,44,35,11,10,34
100,Fail,44,30,9,17,27
100,Fail,53,25,0,16,37
100,Fail,52,30,0,14,38
100,Fail,49,35,0,6,43
100,Fail,44,40,0,13,31
100,Fail,45,40,1,14,31
100,Fail,47,36,0,14,33
100,Fail,53,33,1,13,40
100,Fail,45,33,2,20,25
100,Fail,41,40,2,17,24
100,Fail,50,32,9,9,41
100,Fail,40,44,0,16,24
100,Fail,45,38,3,14,31
100,Fail,42,39,0,15,27
100,Fail,44,39,4,13,31
100,Fail,48,38,0,14,34
100,Fail,48,38,1,13,35
100,Fail,54,33,0,8,46
100,Fail,50,34,0,9,41
100,Fail,48,34,0,12,36
100,Fail,46,32,8,14,32
100,Fail,50,41,2,7,43
100,Fail,47,38,5,10,37
100,Fail,55,28,7,10,45
100,Fail,38,35,0,17,21
100,Fail,44,37,0,16,28
100,Fail,40,45,3,12,28
100,Fail,49,45,0,6,43
100,Fail,55,37,0,7,48
100,Fail,47,37,4,12,35
100,Fail,48,39,0,11,37
100,Fail,49,38,0,13,36
100,Fail,41,36,0,17,24
100,Fail,47,46,1,6,41
100,Fail,47,31,0,13,34
100,Fail,40,39,0,14,26
100,Fail,56,32,6,6,50
100,Fail,58,28,1,13,45
100,Fail,47,38,0,13,34
100,Fail,48,37,1,14,34
100,Fail,49,31,0,15,34
100,Fail,42,40,5,13,29
100,Fail,53,32,0,13,40
100,Fail,51,35,0,13,38
100,Fail,52,37,0,10,42
100,Fail,48,33,2,17,31
100,Fail,54,30,0,13,41
100,Fail,51,30,0,14,37
100,Fail,45,38,0,13,32
100,Fail,48,31,6,15,33
100,Fail,46,41,0,9,37
100,Fail,58,29,3,10,48
100,Fail,48,33,0,14,34
100,Fail,53,30,5,12,41
100,Fail,49,37,7,7,42
100,Fail,41,44,0,12,29
100,Fail,47,35,7,11,36
100,Fail,51,36,0,12,39
100,Fail,48,31,4,17,31
100,Fail,51,35,0,11,40
100,Fail,43,32,0,13,30
100,Fail,49,33,0,11,38
100,Fail,41,39,3,17,24
100,Fail,48,36,0,11,37
100,Fail,50,36,3,11,39
100,Fail,41,39,8,12,29
100,Fail,52,32,0,11,41
100,Fail,45,44,2,9,36
100,Fail,45,37,0,13,32
100,Fail,48,32,0,9,39
100,Fail,55,29,0,11,44
100,Fail,48,44,0,7,41
100,Fail,53,35,3,9,44
100,Fail,52,33,3,12,40
100,Fail,44,40,0,9,35
100,Fail,59,28,0,9,50
100,Fail,50,36,0,14,36
100,Fail,43,34,0,20,23
100,Fail,50,33,2,15,35
100,Fail,49,42,0,9,40
100,Fail,48,37,1,14,34
100,Fail,41,35,10,14,27
100,Fail,55,28,0,15,40
100,Fail,47,38,3,12,35
100,Fail,49,38,0,13,36
100,Fail,50,33,3,14,36
100,Fail,45,36,0,18,27
100,Fail,48,36,0,12,36
100,Fail,44,40,0,11,33
100,Fail,42,41,0,9,33
100,Fail,50,34,0,14,36
100,Fail,49,26,0,22,27
100,Fail,42,41,0,14,28
100,Fail,55,31,0,14,41
100,Fail,59,28,0,11,48
100,Fail,51,30,2,17,34
100,Fail,38,45,0,16,22
100,Fail,49,28,9,14,35
100,Fail,58,31,2,9,49
100,Fail,46,30,0,14,32
100,Fail,44,33,0,19,25
100,Fail,52,36,2,10,42
100,Fail,49,37,4,10,39
100,Fail,46,38,0,10,36
100,Fail,52,32,3,13,39
100,Fail,46,32,0,13,33
100,Fail,47,38,6,9,38
100,Fail,43,35,11,11,32
100,Fail,44,41,0,12,32
100,Fail,46,36,9,9,37
100,Fail,42,36,4,18,24
100,Fail,44,38,6,12,32
100,Fail,46,46,3,5,41
100,Fail,49,38,0,8,41
100,Fail,38,39,6,17,21
100,Fail,49,40,1,10,39
100,Fail,42,29,0,25,17
100,Fail,57,28,4,11,46
100,Fail,48,30,0,17,31
100,Fail,48,31,6,15,33
100,Fail,43,40,7,10,33
100,Fail,46,33,0,14,32
100,Fail,45,41,0,11,34
100,Fail,49,31,3,17,32
100,Fail,46,38,0,15,31
100,Fail,40,40,0,14,26
100,Fail,48,35,0,12,36
100,Fail,49,38,0,11,38
100,Fail,48,32,7,13,35
100,Fail,42,39,7,12,30
100,Fail,45,35,9,11,34
100,Fail,47,38,2,13,34
100,Fail,50,34,0,15,35
100,Fail,49,38,2,11,38
100,Fail,52,35,0,10,42
100,Fail,52,36,1,11,41
100,Fail,42,36,5,17,25
100,Fail,52,37,2,9,43
100,Fail,38,45,3,14,24
100,Fail,43,39,0,13,30
100,Fail,46,36,0,11,35
100,Fail,52,30,7,11,41
100,Fail,46,37,0,13,33
100,Fail,50,39,1,10,40
100,Fail,55,32,1,12,43
100,Fail,48,37,3,12,36
100,Fail,49,38,0,12,37
100,Fail,49,29,0,17,32
100,Fail,52,38,1,9,43
100,Fail,47,36,1,16,31
100,Fail,44,40,0,14,30
100,Fail,47,37,4,12,35
100,Fail,51,35,0,12,39
100,Fail,48,26,0,14,34
100,Fail,51,33,0,13,38
100,Fail,56,32,0,9,47
100,Fail,48,32,11,9,39
100,Fail,48,32,0,18,30
100,Fail,51,34,0,12,39
100,Fail,56,31,0,13,43
100,Fail,46,36,0,13,33
100,Fail,45,37,0,17,28
100,Fail,41,39,0,13,28
100,Fail,47,36,0,14,33
100,Fail,47,39,6,8,39
100,Fail,55,34,0,8,47
100,Fail,47,27,12,14,33
100,Fail,49,38,0,7,42
100,Fail,37,47,7,9,28
100,Fail,45,36,0,16,29
100,Fail,52,28,0,13,39
100,Fail,42,40,0,17,25
100,Fail,52,36,5,7,45
100,Fail,52,37,0,10,42
100,Fail,44,44,1,11,33
100,Fail,44,32,11,13,31
100,Fail,52,37,0,7,45
100,Fail,57,31,1,11,46
100,Fail,49,35,0,11,38
100,Fail,51,34,0,11,40
100,Fail,47,43,0,9,38
100,Fail,47,35,4,14,33
100,Fail,43,38,0,11,32
100,Fail,55,32,2,11,44
100,Fail,41,36,10,13,28
100,Fail,51,38,2,9,42
100,Fail,45,45,0,10,35
100,Fail,52,37,2,9,43
100,Fail,54,34,3,9,45
100,Fail,52,35,2,11,41
100,Fail,53,36,0,10,43
100,Fail,46,39,1,14,32
100,Fail,44,37,0,17,27
100,Fail,48,29,0,16,32
100,Fail,56,27,4,13,43
100,Fail,52,39,0,7,45
100,Fail,46,38,0,11,35
100,Fail,53,29,0,17,36
100,Fail,50,32,0,18,32
100,Fail,43,39,6,12,31
100,Fail,37,47,0,16,21
100,Fail,48,40,0,9,39
100,Fail,44,41,1,14,30
100,Fail,39,40,0,15,24
100,Fail,51,37,2,10,41
100,Fail,40,32,0,18,22
100,Fail,50,37,2,11,39
100,Fail,53,34,0,13,40
100,Fail,46,36,4,14,32
100,Fail,37,38,9,16,21
100,Fail,51,41,0,7,44
100,Fail,51,36,1,12,39
100,Fail,46,38,0,12,34
100,Fail,47,32,5,16,31
100,Fail,48,36,0,13,35
100,Fail,45,38,0,10,35
100,Fail,48,35,4,13,35
100,Fail,50,31,3,16,34
100,Fail,55,34,0,11,44
100,Fail,46,36,0,13,33
100,Fail,51,34,2,13,38
100,Fail,52,32,0,14,38
100,Fail,50,34,7,9,41
100,Fail,48,35,0,16,32
100,Fail,46,37,0,15,31
100,Fail,47,32,0,14,33
100,Fail,50,32,3,15,35
100,Fail,50,31,1,18,32
100,Fail,46,32,0,13,33
100,Fail,46,43,3,8,38
100,Fail,53,34,0,13,40
100,Fail,46,38,7,9,37
100,Fail,51,39,0,10,41
100,Fail,49,37,3,11,38
100,Fail,59,25,9,7,52
100,Fail,53,33,0,14,39
100,Fail,55,31,5,9,46
100,Fail,45,42,2,11,34
100,Fail,52,37,0,10,42
100,Fail,44,34,0,15,29
100,Fail,52,32,2,14,38
100,Fail,45,34,11,10,35
100,Fail,51,33,0,14,37
100,Fail,39,39,7,15,24
100,Fail,51,33,1,15,36
100,Fail,50,34,0,16,34
100,Fail,55,34,0,9,46
100,Fail,42,38,0,18,24
100,Fail,50,29,6,15,35
100,Fail,46,33,0,17,29
100,Fail,42,31,0,12,30
100,Fail,54,30,0,14,40
100,Fail,44,42,1,13,31
100,Fail,47,42,0,11,36
100,Fail,43,36,0,18,25
100,Fail,51,31,6,12,39
100,Fail,48,35,0,14,34
100,Fail,43,36,7,14,29
100,Fail,48,32,0,14,34
100,Fail,45,42,3,10,35
100,Fail,41,40,7,12,29
100,Fail,48,34,5,13,35
100,Fail,38,43,0,12,26
100,Fail,54,35,4,7,47
100,Fail,46,37,5,12,34
100,Fail,50,41,0,9,41
100,Fail,50,36,1,13,37
100,Fail,44,33,0,12,32
100,Fail,48,33,0,16,32
100,Fail,47,31,7,15,32
100,Fail,49,34,0,14,35
100,Fail,46,30,0,13,33
100,Fail,46,41,0,12,34
100,Fail,42,39,0,12,30
100,Fail,57,33,0,7,50
100,Fail,52,35,6,7,45
100,Fail,46,38,0,11,35
100,Fail,56,36,2,6,50
100,Fail,56,38,0,5,51
100,Fail,47,38,3,12,35
100,Fail,43,37,0,15,28
100,Fail,49,36,2,13,36
100,Fail,49,41,0,8,41
100,Fail,42,34,0,18,24
100,Fail,58,32,0,10,48
100,Fail,42,36,0,13,29
100,Fail,51,34,3,12,39
100,Fail,41,37,7,15,26
100,Fail,46,38,0,13,33
100,Fail,48,39,0,10,38
100,Fail,48,35,0,10,38
100,Fail,53,38,0,8,45
100,Fail,48,35,6,11,37
100,Fail,43,32,0,20,23
100,Fail,49,35,1,15,34
100,Fail,52,36,0,11,41
100,Fail,53,36,1,10,43
100,Fail,56,31,4,9,47
100,Fail,48,42,0,10,38
100,Fail,54,31,0,11,43
100,Fail,47,42,0,9,38
100,Fail,50,38,0,9,41
100,Fail,44,34,0,14,30
100,Fail,38,38,12,12,26
100,Fail,43,41,0,14,29
100,Fail,49,38,0,13,36
100,Fail,55,35,0,10,45
100,Fail,49,39,0,12,37
100,Fail,52,30,0,11,41
100,Fail,47,36,0,17,30
100,Fail,49,37,1,13,36
100,Fail,43,34,4,19,24
100,Fail,51,33,2,14,37
100,Fail,52,32,1,15,37
100,Fail,44,35,2,19,25
100,Fail,45,40,3,12,33
100,Fail,50,40,2,8,42
100,Fail,45,36,0,10,35
100,Fail,52,34,0,13,39
100,Fail,53,28,9,10,43
100,Fail,46,35,6,13,33
100,Fail,46,31,0,20,26
100,Fail,46,38,1,15,31
100,Fail,48,45,0,7,41
100,Fail,61,31,0,6,55
100,Fail,45,35,0,13,32
100,Fail,43,33,5,19,24
100,Fail,45,29,12,14,31
100,Fail,53,29,0,15,38
100,Fail,56,32,2,10,46
100,Fail,40,40,0,17,23
100,Fail,52,31,0,14,38
100,Fail,57,30,0,13,44
100,Fail,50,36,8,6,44
100,Fail,42,40,6,12,30
100,Fail,43,39,0,15,28
100,Fail,50,34,0,13,37
100,Fail,50,33,0,17,33
100,Fail,42,40,6,12,30
100,Fail,57,31,5,7,50
100,Fail,40,41,0,16,24
100,Fail,41,43,4,12,29
100,Fail,49,39,0,11,38
100,Fail,46,29,7,18,28
100,Fail,43,37,0,15,28
100,Fail,47,39,0,11,36
100,Fail,57,34,6,3,54
100,Fail,47,43,0,10,37
100,Fail,53,39,0,6,47
100,Fail,44,36,0,8,36
100,Fail,50,36,0,10,40
100,Fail,50,32,0,15,35
100,Fail,52,35,2,11,41
100,Fail,46,37,3,14,32
100,Fail,50,38,0,12,38
100,Fail,46,43,0,9,37
100,Fail,41,47,1,11,30
100,Fail,45,39,0,15,30
100,Fail,51,31,1,17,34
100,Fail,43,34,4,19,24
100,Fail,50,30,5,15,35
100,Fail,50,38,0,11,39
100,Fail,52,29,3,16,36
100,Fail,44,36,0,18,26
100,Fail,45,38,5,12,33
100,Fail,49,35,0,11,38
100,Fail,51,37,3,9,42
100,Fail,44,42,0,12,32
100,Fail,49,28,11,12,37
100,Fail,43,42,1,14,29
100,Fail,43,38,0,19,24
100,Fail,52,32,6,10,42
100,Fail,45,41,0,11,34
100,Fail,41,44,3,12,29
100,Fail,44,38,6,12,32
100,Fail,51,35,0,12,39
100,Fail,53,37,0,8,45
100,Fail,55,26,0,12,43
100,Fail,49,35,2,14,35
100,Fail,37,34,0,17,20
100,Fail,44,39,3,14,30
100,Fail,50,34,0,13,37
100,Fail,47,38,0,8,39
100,Fail,56,33,0,11,45
100,Fail,49,39,0,12,37
100,Fail,46,34,7,13,33
100,Fail,45,32,0,10,35
100,Fail,45,44,1,10,35
100,Fail,38,39,1,22,16
100,Fail,56,32,0,8,48
100,Fail,45,34,4,17,28
100,Fail,55,34,0,8,47
100,Fail,50,31,0,10,40
100,Fail,43,38,6,13,30
100,Fail,46,37,3,14,32
100,Fail,48,26,0,21,27
100,Fail,46,41,2,11,35
100,Fail,48,29,8,15,33
100,Fail,44,29,6,21,23
100,Fail,45,41,0,8,37
100,Fail,47,29,0,20,27
100,Fail,51,29,0,11,40
100,Fail,49,31,0,16,33
100,Fail,49,33,11,7,42
100,Fail,47,36,1,16,31
100,Fail,41,37,7,15,26
100,Fail,47,30,6,17,30
100,Fail,44,37,5,14,30
100,Fail,51,34,5,10,41
100,Fail,55,31,3,11,44
100,Fail,52,35,0,12,40
100,Fail,44,43,2,11,33
100,Fail,57,32,0,5,52
100,Fail,46,35,0,16,30
100,Fail,45,42,0,13,32
100,Fail,49,42,0,8,41
100,Fail,45,36,8,11,34
100,Fail,32,37,0,17,15
100,Fail,51,36,4,9,42
100,Fail,53,34,0,11,42
100,Fail,55,29,0,11,44
100,Fail,48,40,2,10,38
100,Fail,49,26,0,14,35
100,Fail,49,27,8,16,33
100,Fail,51,35,2,12,39
100,Fail,44,45,0,9,35
100,Fail,49,33,0,9,40
100,Fail,54,35,3,8,46
100,Fail,53,36,0,11,42
100,Fail,53,29,0,14,39
100,Fail,52,34,0,10,42
100,Fail,52,38,2,8,44
100,Fail,47,39,0,12,35
100,Fail,49,35,0,15,34
100,Fail,40,39,0,10,30
100,Fail,49,30,7,14,35
100,Fail,57,32,0,10,47
100,Fail,53,39,0,6,47
100,Fail,44,37,0,12,32
100,Fail,49,36,0,14,35
100,Fail,46,35,0,12,34
100,Fail,44,35,6,15,29
100,Fail,58,32,3,7,51
100,Fail,49,37,0,13,36
100,Fail,62,28,0,10,52
100,Fail,49,33,0,14,35
100,Fail,44,33,7,16,28
100,Fail,44,44,0,12,32
100,Fail,45,41,4,10,35
100,Fail,50,32,5,13,37
100,Fail,48,37,1,14,34
100,Fail,40,39,10,11,29
100,Fail,51,32,0,12,39
100,Fail,46,37,2,15,31
100,Fail,43,41,2,14,29
100,Fail,41,42,0,13,28
100,Fail,53,35,0,11,42
100,Fail,51,33,5,11,40
100,Fail,45,41,1,13,32
100,Fail,49,36,5,10,39
100,Fail,38,38,0,16,22
100,Fail,43,46,0,10,33
100,Fail,41,38,5,16,25
100,Fail,50,32,8,10,40
100,Fail,41,39,6,14,27
100,Fail,49,29,11,11,38
100,Fail,45,35,0,20,25
100,Fail,42,37,1,20,22
100,Fail,51,30,5,14,37
100,Fail,56,32,0,12,44
100,Fail,56,33,1,10,46
100,Fail,46,33,0,13,33
100,Fail,46,38,0,14,32
100,Fail,50,40,0,10,40
100,Fail,52,33,1,14,38
100,Fail,47,38,0,9,38
100,Fail,55,40,1,4,51
100,Fail,51,27,0,12,39
100,Fail,52,32,1,15,37
100,Fail,52,33,2,13,39
100,Fail,43,32,0,17,26
100,Fail,44,36,5,15,29
100,Fail,41,34,0,12,29
100,Fail,47,35,7,11,36
100,Fail,55,30,0,10,45
100,Fail,49,30,9,12,37
100,Fail,43,31,0,14,29
100,Fail,51,40,1,8,43
100,Fail,45,28,0,15,30
100,Fail,40,35,16,9,31
100,Fail,45,45,0,10,35
100,Fail,44,41,4,11,33
100,Fail,44,30,10,16,28
100,Fail,46,40,3,11,35
100,Fail,39,41,0,20,19
100,Fail,55,32,0,10,45
100,Fail,45,34,6,15,30
100,Fail,43,42,5,10,33
100,Fail,44,35,0,19,25
100,Fail,56,25,0,16,40
100,Fail,55,34,2,9,46
100,Fail,55,34,1,10,45
100,Fail,50,38,0,12,38
100,Fail,47,35,4,14,33
100,Fail,47,44,2,7,40
100,Fail,49,34,0,11,38
100,Fail,47,36,0,13,34
100,Fail,49,32,0,17,32
100,Fail,50,25,0,16,34
100,Fail,52,29,0,12,40
100,Fail,50,36,2,12,38
100,Fail,53,35,6,6,47
100,Fail,47,33,0,14,33
100,Fail,47,35,7,11,36
100,Fail,40,48,0,7,33
100,Fail,44,40,0,12,32
100,Fail,53,30,1,16,37
100,Fail,50,27,7,16,34
100,Fail,35,44,0,19,16
100,Fail,46,31,0,18,28
100,Fail,43,34,0,11,32
100,Fail,53,30,4,13,40
100,Fail,51,34,2,13,38
100,Fail,48,32,9,11,37
100,Fail,55,36,1,8,47
100,Fail,51,31,4,14,37
100,Fail,48,37,1,14,34
100,Fail,57,35,0,7,50
100,Fail,46,40,1,13,33
100,Fail,51,41,0,7,44
100,Fail,44,36,0,11,33
100,Fail,49,40,0,9,40
100,Fail,47,36,0,16,31
100,Fail,47,39,5,9,38
100,Fail,56,33,2,9,47
100,Fail,42,40,1,17,25
100,Fail,56,31,0,11,45
100,Fail,43,41,3,13,30
100,Fail,47,31,0,11,36
100,Fail,48,38,4,10,38
100,Fail,56,35,2,7,49
100,Fail,46,29,10,15,31
100,Fail,54,34,2,10,44
100,Fail,54,34,0,11,43
100,Fail,49,41,0,9,40
100,Fail,56,35,0,8,48
100,Fail,51,36,0,9,42
100,Fail,55,32,0,12,43
100,Fail,54,35,0,10,44
100,Fail,48,33,4,15,33
100,Fail,51,36,2,11,40
100,Fail,52,28,2,18,34
100,Fail,50,38,2,10,40
100,Fail,42,40,0,15,27
100,Fail,47,35,5,13,34
100,Fail,46,35,0,9,37
100,Fail,42,44,0,14,28
100,Fail,46,40,0,11,35
100,Fail,50,35,5,10,40
100,Fail,51,26,0,14,37
100,Fail,47,39,0,11,36
100,Fail,48,33,4,15,33
100,Fail,52,33,3,12,40
100,Fail,43,34,7,16,27
100,Fail,49,29,7,15,34
100,Fail,42,46,2,10,32
100,Fail,49,37,2,12,37
100,Fail,55,36,2,7,48
100,Fail,47,25,13,15,32
100,Fail,58,33,0,7,51
100,Fail,50,35,0,14,36
100,Fail,45,38,5,12,33
100,Fail,52,33,0,14,38
100,Fail,51,34,0,12,39
100,Fail,49,37,0,12,37
100,Fail,55,31,0,14,41
100,Fail,53,35,2,10,43
100,Fail,46,37,0,17,29
100,Fail,53,38,4,5,48
100,Fail,45,39,0,15,30
100,Fail,54,34,0,8,46
100,Fail,53,32,0,12,41
100,Fail,49,33,0,17,32
100,Fail,36,40,7,17,19
100,Fail,53,30,0,11,42
100,Fail,46,39,3,12,34
100,Fail,44,37,0,11,33
100,Fail,50,33,1,16,34
100,Fail,47,35,0,15,32
100,Fail,52,32,1,15,37
100,Fail,57,30,7,6,51
100,Fail,45,37,5,13,32
100,Fail,53,34,0,11,42
100,Fail,51,35,4,10,41
100,Fail,53,35,0,11,42
100,Fail,50,32,1,17,33
100,Fail,44,35,2,19,25
100,Fail,51,36,0,9,42
100,Fail,49,32,6,13,36
100,Fail,55,35,0,10,45
100,Fail,46,36,5,13,33
100,Fail,48,30,0,16,32
100,Fail,50,34,4,12,38
100,Fail,49,30,1,20,29
100,Fail,53,23,0,17,36
100,Fail,47,35,3,15,32
100,Fail,39,42,0,15,24
100,Fail,51,35,4,10,41
100,Fail,51,41,0,8,43
100,Fail,50,34,2,14,36
100,Fail,51,36,1,12,39
100,Fail,48,35,0,15,33
100,Fail,45,29,15,11,34
100,Fail,48,42,0,10,38
100,Fail,43,34,6,17,26
100,Fail,48,34,0,15,33
100,Fail,47,30,3,20,27
100,Fail,47,37,2,14,33
100,Fail,40,43,0,9,31
100,Fail,45,39,6,10,35
100,Fail,47,41,0,10,37
100,Fail,48,36,0,14,34
100,Fail,53,34,3,10,43
100,Fail,49,35,6,10,39
100,Fail,41,33,13,13,28
100,Fail,48,32,4,16,32
100,Fail,50,29,3,18,32
100,Fail,40,37,0,14,26
100,Fail,46,37,1,16,30
100,Fail,42,33,0,14,28
100,Fail,50,35,5,10,40
100,Fail,44,39,0,14,30
100,Fail,59,30,0,11,48
100,Fail,42,43,0,12,30
100,Fail,52,35,0,13,39
100,Fail,40,44,0,14,26
100,Fail,54,33,5,8,46
100,Fail,53,34,5,8,45
100,Fail,42,37,0,17,25
100,Fail,44,35,5,16,28
100,Fail,59,31,0,7,52
100,Fail,47,43,0,10,37
100,Fail,44,38,1,17,27
100,Fail,46,40,4,10,36
100,Fail,52,36,0,11,41
100,Fail,53,33,0,13,40
100,Fail,54,35,2,9,45
100,Fail,53,29,7,11,42
100,Fail,41,42,0,14,27
100,Fail,45,44,1,10,35
100,Fail,48,35,1,16,32
100,Fail,53,29,5,13,40
100,Fail,57,32,0,9,48
100,Fail,40,35,0,15,25
100,Fail,53,29,5,13,40
100,Fail,51,35,0,12,39
100,Fail,52,29,3,16,36
100,Fail,41,32,12,15,26
100,Fail,43,39,2,16,27
100,Fail,40,41,9,10,30
100,Fail,50,34,0,14,36
100,Fail,49,38,0,10,39
100,Fail,55,33,1,11,44
100,Fail,54,36,1,9,45
100,Fail,51,30,0,17,34
100,Fail,52,32,0,10,42
100,Fail,54,30,0,9,45
100,Fail,47,43,0,9,38
100,Fail,49,35,0,13,36
100,Fail,46,42,0,10,36
100,Fail,48,37,0,11,37
100,Fail,41,38,0,18,23
100,Fail,52,33,1,14,38
100,Fail,39,44,6,11,28
100,Fail,49,37,0,14,35
100,Fail,51,34,4,11,40
100,Fail,42,37,4,17,25
100,Fail,47,42,3,8,39
100,Fail,52,32,0,12,40
100,Fail,44,37,0,15,29
100,Fail,42,40,5,13,29
100,Fail,48,34,0,10,38
100,Fail,49,37,0,11,38
100,Fail,41,49,0,10,31
100,Fail,48,31,0,15,33
100,Fail,42,36,7,15,27
100,Fail,48,34,9,9,39
100,Fail,44,42,1,13,31
100,Fail,50,26,12,12,38
100,Fail,51,37,0,11,40
100,Fail,45,30,0,16,29
100,Fail,53,34,0,5,48
100,Fail,52,29,5,14,38
100,Fail,50,36,2,12,38
100,Fail,44,32,5,19,25
100,Fail,38,41,0,18,20
100,Fail,50,34,4,12,38
100,Fail,47,37,1,15,32
100,Fail,46,28,7,19,27
100,Fail,50,38,0,8,42
100,Fail,48,36,2,14,34
100,Fail,47,39,0,12,35
100,Fail,48,39,3,10,38
100,Fail,50,29,0,10,40
100,Fail,47,33,0,14,33
100,Fail,40,42,4,14,26
100,Fail,49,30,2,19,30
100,Fail,46,41,1,12,34
100,Fail,50,37,0,10,40
100,Fail,41,45,0,9,32
100,Fail,47,27,10,16,31
100,Fail,53,31,0,16,37
100,Fail,49,27,6,18,31
100,Fail,38,42,0,15,23
100,Fail,50,37,2,11,39
100,Fail,48,31,2,19,29
100,Fail,51,33,4,12,39
100,Fail,48,40,0,9,39
100,Fail,51,30,4,15,36
100,Fail,44,40,7,9,35
100,Fail,44,34,0,18,26
100,Fail,41,45,0,13,28
100,Fail,40,41,0,16,24
100,Fail,42,38,0,16,26
100,Fail,50,39,1,10,40
100,Fail,53,37,1,9,44
100,Fail,50,39,4,7,43
100,Fail,32,42,0,13,19
100,Fail,51,36,0,13,38
100,Fail,61,29,0,10,51
100,Fail,48,37,0,14,34
100,Fail,50,35,1,14,36
100,Fail,45,38,0,15,30
100,Fail,39,41,5,15,24
100,Fail,39,46,0,10,29
100,Fail,49,40,0,8,41
100,Fail,53,34,1,12,41
100,Fail,49,29,0,19,30
100,Fail,55,30,0,13,42
100,Fail,52,36,2,10,42
100,Fail,47,31,10,12,35
100,Fail,51,32,0,12,39
100,Fail,57,34,0,8,49
100,Fail,47,38,2,13,34
100,Fail,46,42,9,3,43
100,Fail,37,40,4,19,18
100,Fail,47,36,0,11,36
100,Fail,47,35,0,11,36
100,Fail,51,28,4,17,34
100,Fail,49,38,0,10,39
100,Fail,43,41,3,13,30
100,Fail,46,29,5,20,26
100,Fail,53,36,0,9,44
100,Fail,55,35,1,9,46
100,Fail,44,39,0,15,29
100,Fail,52,37,0,10,42
100,Fail,46,37,6,11,35
100,Fail,53,37,0,10,43
100,Fail,41,35,0,18,23
100,Fail,39,41,11,9,30
100,Fail,47,35,1,17,30
100,Fail,56,29,3,12,44
100,Fail,56,32,0,12,44
100,Fail,50,40,0,6,44
100,Fail,47,38,0,15,32
100,Fail,43,37,8,12,31
100,Fail,56,31,0,8,48
100,Fail,48,27,0,18,30
100,Fail,51,36,5,8,43
100,Fail,44,33,12,11,33
100,Fail,46,36,0,13,33
100,Fail,43,44,1,12,31
100,Fail,48,27,0,14,34
100,Fail,51,35,0,10,41
100,Fail,52,38,0,5,47
100,Fail,50,38,0,10,40
100,Fail,55,28,0,12,43
100,Fail,50,41,0,9,41
100,Fail,47,44,3,6,41
100,Fail,51,32,0,11,40
100,Fail,49,31,0,14,35
100,Fail,49,40,0,11,38
100,Fail,46,31,0,13,33
100,Fail,52,31,5,12,40
100,Fail,48,41,0,11,37
100,Fail,47,39,0,13,34
100,Fail,34,45,0,14,20
100,Fail,46,37,1,16,30
100,Fail,43,46,0,11,32
100,Fail,45,39,3,13,32
100,Fail,47,31,0,18,29
100,Fail,55,29,0,13,42
100,Fail,52,30,8,10,42
100,Fail,48,40,5,7,41
100,Fail,43,39,0,12,31
100,Fail,49,33,6,12,37
100,Fail,51,36,7,6,45
100,Fail,59,32,2,7,52
100,Fail,45,38,0,10,35
100,Fail,47,29,0,22,25
100,Fail,47,40,2,11,36
100,Fail,50,28,6,16,34
100,Fail,52,30,0,15,37
100,Fail,43,30,14,13,30
100,Fail,45,43,0,10,35
100,Fail,43,33,5,19,24
100,Fail,54,33,1,12,42
100,Fail,46,34,5,15,31
100,Fail,44,37,10,9,35
100,Fail,40,45,0,10,30
100,Fail,54,33,0,10,44
100,Fail,50,33,3,14,36
100,Fail,48,38,0,14,34
100,Fail,57,25,0,12,45
100,Fail,51,33,0,13,38
100,Fail,56,23,0,17,39
100,Fail,50,31,0,12,38
100,Fail,52,35,3,10,42
100,Fail,46,40,0,12,34
100,Fail,53,32,0,11,42
100,Fail,42,36,5,17,25
100,Fail,44,37,0,10,34
100,Fail,47,36,5,12,35
100,Fail,44,35,0,16,28
100,Fail,44,38,0,13,31
100,Fail,48,42,0,9,39
100,Fail,48,37,0,8,40
100,Fail,46,27,0,18,28
100,Fail,45,32,3,20,25
100,Fail,47,39,1,13,34
100,Fail,57,30,0,13,44
100,Fail,43,38,9,10,33
100,Fail,54,33,2,11,43
100,Fail,56,27,0,14,42
100,Fail,50,36,0,13,37
100,Fail,49,36,0,13,36
100,Fail,50,33,0,17,33
100,Fail,42,41,0,14,28
100,Fail,48,38,3,11,37
100,Fail,47,36,1,16,31
100,Fail,46,39,1,14,32
100,Fail,48,31,0,15,33
100,Fail,49,35,2,14,35
100,Fail,47,35,13,5,42
100,Fail,45,43,0,12,33
100,Fail,45,36,6,13,32
100,Fail,49,37,4,10,39
100,Fail,56,28,2,14,42
100,Fail,52,35,1,12,40
100,Fail,59,30,3,8,51
100,Fail,53,31,0,9,44
100,Fail,48,39,0,11,37
100,Fail,45,40,3,12,33
100,Fail,45,33,0,14,31
100,Fail,43,35,5,17,26
100,Fail,56,32,2,10,46
100,Fail,48,37,0,15,33
100,Fail,49,38,2,11,38
100,Fail,55,25,0,16,39
100,Fail,48,36,0,14,34
100,Fail,46,35,0,14,32
100,Fail,42,36,9,13,29
100,Fail,53,38,0,8,45
100,Fail,46,37,0,12,34
100,Fail,43,48,0,9,34
100,Fail,50,33,3,14,36
100,Fail,59,22,0,14,45
100,Fail,46,38,0,13,33
100,Fail,39,40,0,18,21
100,Fail,47,38,3,12,35
100,Fail,44,34,8,14,30
100,Fail,50,34,1,15,35
100,Fail,49,35,1,15,34
100,Fail,49,32,0,16,33
100,Fail,46,28,0,12,34
100,Fail,50,34,3,13,37
100,Fail,50,36,0,9,41
100,Fail,48,34,0,15,33
100,Fail,43,36,8,13,30
100,Fail,51,36,0,7,44
100,Fail,50,30,3,17,33
100,Fail,46,39,2,13,33
100,Fail,44,36,8,12,32
100,Fail,51,34,6,9,42
100,Fail,51,34,4,11,40
100,Fail,40,40,0,16,24
100,Fail,40,44,2,14,26
100,Fail,47,41,0,12,35
100,Fail,48,36,3,13,35
100,Fail,48,33,5,14,34
100,Fail,52,31,2,15,37
100,Fail,52,32,4,12,40
100,Fail,46,31,0,13,33
100,Fail,48,39,0,13,35
100,Fail,44,44,0,11,33
100,Fail,42,45,0,11,31
100,Fail,50,36,3,11,39
100,Fail,45,36,0,13,32
100,Fail,42,33,0,23,19
100,Fail,50,36,7,7,43
100,Fail,47,37,0,11,36
100,Fail,49,35,0,14,35
100,Fail,42,41,0,12,30
100,Fail,50,39,3,8,42
100,Fail,54,28,0,10,44
100,Fail,55,33,0,12,43
100,Fail,54,33,0,12,42
100,Fail,49,40,2,9,40
100,Fail,46,43,0,10,36
100,Fail,50,29,6,15,35
100,Fail,47,32,3,18,29
100,Fail,50,30,8,12,38
100,Fail,48,38,4,10,38
100,Fail,40,37,0,13,27
100,Fail,39,41,5,15,24
100,Fail,50,41,0,9,41
100,Fail,50,31,2,17,33
100,Fail,51,33,0,12,39
100,Fail,52,37,8,3,49
100,Fail,50,34,1,15,35
100,Fail,39,44,0,17,22
100,Fail,48,37,0,13,35
100,Fail,57,34,0,9,48
100,Fail,47,33,4,16,31
100,Fail,48,32,1,19,29
100,Fail,49,35,1,15,34
100,Fail,49,39,0,11,38
100,Fail,51,31,0,11,40
100,Fail,38,43,0,14,24
100,Fail,38,41,0,13,25
100,Fail,51,32,0,12,39
100,Fail,42,37,4,17,25
100,Fail,47,35,0,16,31
100,Fail,47,37,0,13,34
100,Fail,45,37,0,15,30
100,Fail,44,42,1,13,31
100,Fail,46,40,3,11,35
100,Fail,44,40,2,14,30
100,Fail,55,36,0,9,46
100,Fail,47,33,0,20,27
100,Fail,52,28,0,13,39
100,Fail,49,36,0,14,35
100,Fail,48,25,0,17,31
100,Fail,40,42,5,13,27
100,Fail,44,35,8,13,31
100,Fail,55,39,1,5,50
100,Fail,42,33,0,22,20
100,Fail,46,44,0,9,37
100,Fail,47,41,0,9,38
100,Fail,48,45,0,7,41
100,Fail,45,44,0,9,36
100,Fail,47,41,0,11,36
100,Fail,45,35,0,13,32
100,Fail,38,36,0,24,14
100,Fail,45,41,0,13,32
100,Fail,55,35,0,9,46
100,Fail,51,36,0,8,43
100,Fail,55,32,0,11,44
100,Fail,53,34,0,13,40
100,Fail,53,36,0,10,43
100,Fail,47,36,0,13,34
100,Fail,51,34,3,12,39
100,Fail,50,36,2,12,38
100,Fail,44,41,1,14,30
100,Fail,56,29,0,14,42
100,Fail,52,34,0,14,38
100,Fail,48,41,0,11,37
100,Fail,48,32,0,18,30
100,Fail,58,29,2,11,47
100,Fail,46,40,0,13,33
100,Fail,45,41,0,10,35
100,Fail,50,33,5,12,38
100,Fail,52,36,0,8,44
100,Fail,39,32,16,13,26
100,Fail,53,24,6,17,36
100,Fail,48,44,0,6,42
100,Fail,52,37,1,10,42
100,Fail,47,38,1,14,33
100,Fail,40,31,7,22,18
100,Fail,48,33,9,10,38
100,Fail,43,42,0,12,31
100,Fail,55,28,4,13,42
100,Fail,47,32,4,17,30
100,Fail,60,31,0,9,51
100,Fail,52,37,0,10,42
100,Fail,56,29,0,12,44
100,Fail,47,33,4,16,31
100,Fail,43,32,0,17,26
100,Fail,43,41,4,12,31
100,Fail,47,34,8,11,36
100,Fail,49,36,0,11,38
100,Fail,43,37,5,15,28
100,Fail,48,34,0,9,39
100,Fail,55,33,0,8,47
100,Fail,45,36,0,17,28
100,Fail,46,39,1,14,32
100,Fail,45,37,0,17,28
100,Fail,45,43,0,9,36
100,Fail,49,37,0,13,36
100,Fail,50,34,0,11,39
100,Fail,50,33,4,13,37
100,Fail,44,37,0,19,25
100,Fail,46,45,3,6,40
100,Fail,44,44,1,11,33
100,Fail,47,31,10,12,35
100,Fail,56,30,4,10,46
100,Fail,56,34,1,9,47
100,Fail,45,39,2,14,31
100,Fail,45,41,3,11,34
100,Fail,45,38,3,14,31
100,Fail,47,34,0,14,33
100,Fail,49,36,3,12,37
100,Fail,51,38,0,11,40
100,Fail,50,38,0,9,41
100,Fail,55,29,0,16,39
100,Fail,35,39,12,14,21
100,Fail,52,34,0,12,40
100,Fail,54,34,2,10,44
100,Fail,48,42,1,9,39
100,Fail,35,48,0,13,22
100,Fail,51,35,0,14,37
100,Fail,52,27,0,18,34
100,Fail,47,28,0,19,28
100,Fail,53,31,0,14,39
100,Fail,40,43,5,12,28
100,Fail,51,35,4,10,41
100,Fail,38,44,0,16,22
100,Fail,50,24,8,18,32
100,Fail,50,41,0,9,41
100,Fail,46,25,13,16,30
100,Fail,53,33,0,13,40
100,Fail,48,41,1,10,38
100,Fail,57,34,0,6,51
100,Fail,51,32,3,14,37
100,Fail,52,29,0,9,43
100,Fail,43,40,2,15,28
100,Fail,46,29,9,16,30
100,Fail,42,39,2,17,25
100,Fail,43,35,8,14,29
100,Fail,51,38,0,11,40
100,Fail,51,37,0,10,41
100,Fail,51,31,0,13,38
100,Fail,58,26,0,12,46
100,Fail,46,30,0,20,26
100,Fail,40,35,12,13,27
100,Fail,46,44,0,10,36
100,Fail,45,36,0,17,28
100,Fail,55,24,5,16,39
100,Fail,48,31,0,21,27
100,Fail,41,38,9,12,29
100,Fail,53,26,0,14,39
100,Fail,45,41,0,11,34
100,Fail,48,32,0,13,35
100,Fail,48,39,1,12,36
100,Fail,47,43,0,8,39
100,Fail,51,30,4,15,36
100,Fail,49,31,0,13,36
100,Fail,45,33,0,20,25
100,Fail,52,31,1,16,36
100,Fail,43,38,0,15,28
100,Fail,49,35,0,11,38
100,Fail,57,31,0,9,48
100,Fail,49,38,5,8,41
100,Fail,50,39,0,10,40
100,Fail,41,29,14,16,25
100,Fail,48,38,3,11,37
100,Fail,44,34,8,14,30
100,Fail,48,37,0,12,36
100,Fail,50,33,0,17,33
100,Fail,45,37,4,14,31
100,Fail,52,38,1,9,43
100,Fail,41,39,0,12,29
100,Fail,46,40,6,8,38
100,Fail,41,31,0,16,25
100,Fail,49,42,1,8,41
100,Fail,51,37,0,8,43
100,Fail,52,41,0,5,47
100,Fail,44,48,1,7,37
100,Fail,53,35,0,10,43
100,Fail,50,34,6,10,40
100,Fail,48,38,5,9,39
100,Fail,51,26,6,17,34
100,Fail,49,34,0,11,38
100,Fail,46,36,7,11,35
100,Fail,47,43,0,10,37
100,Fail,51,39,0,10,41
100,Fail,57,29,0,13,44
100,Fail,50,39,0,9,41
100,Fail,43,39,0,12,31
100,Fail,45,36,0,15,30
100,Fail,48,39,0,13,35
100,Fail,50,27,7,16,34
100,Fail,45,32,3,20,25
100,Fail,46,35,6,13,33
100,Fail,47,41,0,12,35
100,Fail,50,35,0,13,37
100,Fail,45,39,4,12,33
100,Fail,53,37,0,8,45
100,Fail,52,38,1,9,43
100,Fail,54,29,0,15,39
100,Fail,44,34,0,14,30
100,Fail,48,27,0,16,32
100,Fail,47,35,0,10,37
100,Fail,53,34,0,13,40
100,Fail,45,35,4,16,29
100,Fail,50,41,0,8,42
100,Fail,49,33,4,14,35
100,Fail,50,32,4,14,36
100,Fail,42,40,0,10,32
100,Fail,49,39,0,10,39
100,Fail,40,48,1,11,29
100,Fail,50,37,1,12,38
100,Fail,46,38,0,12,34
100,Fail,51,31,4,14,37
100,Fail,53,36,2,9,44
100,Fail,44,38,0,12,32
100,Fail,55,29,0,16,39
100,Fail,43,41,0,10,33
100,Fail,55,33,0,12,43
100,Fail,51,38,0,11,40
100,Fail,51,37,0,9,42
100,Fail,46,35,2,17,29
100,Fail,39,40,7,14,25
100,Fail,45,40,3,12,33
100,Fail,51,33,3,13,38
100,Fail,41,33,0,11,30
100,Fail,46,35,8,11,35
100,Fail,40,35,8,17,23
100,Fail,47,35,5,13,34
100,Fail,55,24,8,13,42
100,Fail,50,32,0,14,36
100,Fail,56,29,9,6,50
100,Fail,47,38,3,12,35
100,Fail,40,34,0,18,22
100,Fail,45,42,0,9,36
100,Fail,48,34,0,15,33
100,Fail,48,36,0,14,34
100,Fail,49,33,0,14,35
100,Fail,46,28,0,18,28
100,Fail,43,42,0,8,35
100,Fail,47,32,10,11,36
100,Fail,51,31,3,15,36
100,Fail,52,36,0,9,43
100,Fail,50,33,0,15,35
100,Fail,53,34,0,13,40
100,Fail,52,27,6,15,37
100,Fail,49,35,3,13,36
100,Fail,44,44,3,9,35
100,Fail,40,37,0,12,28
100,Fail,50,38,1,11,39
100,Fail,49,40,0,9,40
100,Fail,48,27,0,14,34
100,Fail,47,41,0,12,35
100,Fail,42,39,0,17,25
100,Fail,52,37,1,10,42
100,Fail,50,32,4,14,36
100,Fail,51,36,1,12,39
100,Fail,54,36,0,10,44
100,Fail,52,39,0,6,46
100,Fail,49,33,9,9,40
100,Fail,48,29,0,15,33
100,Fail,55,29,3,13,42
100,Fail,49,33,0,15,34
100,Fail,43,33,7,17,26
100,Fail,49,40,2,9,40
100,Fail,59,27,0,10,49
100,Fail,49,30,0,20,29
100,Fail,46,34,8,12,34
100,Fail,53,38,1,8,45
100,Fail,54,32,2,12,42
100,Fail,40,35,7,18,22
100,Fail,55,35,0,6,49
100,Fail,55,33,0,11,44
100,Fail,52,31,2,15,37
100,Fail,36,42,0,13,23
100,Fail,49,33,8,10,39
100,Fail,43,43,1,13,30
100,Fail,56,30,0,11,45
100,Fail,42,42,0,14,28
100,Fail,47,34,9,10,37
100,Fail,41,39,0,18,23
100,Fail,52,35,0,12,40
100,Fail,48,38,0,12,36
100,Fail,44,34,11,11,33
100,Fail,46,30,7,17,29
100,Fail,47,33,0,14,33
100,Fail,52,37,0,10,42
100,Fail,49,35,0,15,34
100,Fail,46,38,0,14,32
100,Fail,43,31,5,21,22
100,Fail,48,36,1,15,33
100,Fail,44,32,0,17,27
100,Fail,45,42,5,8,37
100,Fail,54,29,3,14,40
100,Fail,47,32,9,12,35
100,Fail,53,32,1,14,39
100,Fail,54,29,0,11,43
100,Fail,47,41,1,11,36
100,Fail,42,35,5,18,24
100,Fail,40,35,11,14,26
100,Fail,46,42,0,10,36
100,Fail,42,35,6,17,25
100,Fail,49,34,6,11,38
100,Fail,44,40,0,15,29
100,Fail,52,28,0,11,41
100,Fail,40,33,0,19,21
100,Fail,44,46,0,9,35
100,Fail,45,39,0,16,29
100,Fail,45,29,0,20,25
100,Fail,43,33,0,17,26
100,Fail,43,40,7,10,33
100,Fail,50,34,3,13,37
100,Fail,50,31,0,17,33
100,Fail,48,34,0,16,32
100,Fail,48,37,0,14,34
100,Fail,42,38,0,13,29
100,Fail,40,31,0,17,23
100,Fail,48,40,1,11,37
100,Fail,48,26,0,19,29
100,Fail,56,32,3,9,47
100,Fail,52,34,2,12,40
100,Fail,46,36,0,13,33
100,Fail,43,45,0,9,34
100,Fail,38,39,7,16,22
100,Fail,49,31,8,12,37
100,Fail,51,31,6,12,39
100,Fail,47,31,8,14,33
100,Fail,50,36,0,14,36
100,Fail,45,45,1,9,36
100,Fail,43,31,8,18,25
100,Fail,45,41,0,11,34
100,Fail,45,31,0,17,28
100,Fail,49,36,0,13,36
100,Fail,40,43,6,11,29
100,Fail,46,39,0,8,38
100,Fail,54,31,1,14,40
100,Fail,50,35,7,8,42
100,Fail,39,46,4,11,28
100,Fail,43,31,11,15,28
100,Fail,39,29,0,20,19
100,Fail,40,35,8,17,23
100,Fail,50,37,0,12,38
100,Fail,51,35,0,9,42
100,Fail,42,36,0,15,27
100,Fail,44,36,7,13,31
100,Fail,46,36,0,15,31
100,Fail,47,36,6,11,36
100,Fail,56,29,0,7,49
100,Fail,49,36,0,15,34
100,Fail,46,41,2,11,35
100,Fail,46,37,0,17,29
100,Fail,51,32,4,13,38
100,Fail,45,35,5,15,30
100,Fail,46,40,2,12,34
100,Fail,49,31,0,16,33
100,Fail,60,29,0,11,49
100,Fail,55,36,0,8,47
100,Fail,47,45,0,8,39
100,Fail,48,30,10,12,36
100,Fail,50,34,3,13,37
100,Fail,44,30,6,20,24
100,Fail,49,37,5,9,40
100,Fail,55,25,3,17,38
100,Fail,51,33,4,12,39
100,Fail,45,41,5,9,36
100,Fail,45,37,5,13,32
100,Fail,45,35,0,13,32
100,Fail,46,40,0,13,33
100,Fail,46,36,9,9,37
100,Fail,46,41,4,9,37
100,Fail,49,41,0,8,41
100,Fail,57,31,1,11,46
100,Fail,47,38,6,9,38
100,Fail,41,38,4,17,24
100,Fail,46,33,0,15,31
100,Fail,48,31,6,15,33
100,Fail,48,33,0,17,31
100,Fail,50,36,0,8,42
100,Fail,43,40,0,12,31
100,Fail,47,37,0,11,36
100,Fail,50,31,6,13,37
100,Fail,43,42,0,9,34
100,Fail,44,42,0,12,32
100,Fail,49,38,1,12,37
100,Fail,48,36,0,15,33
100,Fail,47,33,5,15,32
100,Fail,53,32,0,14,39
100,Fail,57,30,0,8,49
100,Fail,43,38,0,9,34
100,Fail,53,26,4,17,36
100,Fail,54,30,0,15,39
100,Fail,43,34,13,10,33
100,Fail,48,42,0,7,41
100,Fail,57,30,2,11,46
100,Fail,56,28,0,16,40
100,Fail,43,42,0,11,32
100,Fail,45,38,2,15,30
100,Fail,46,35,0,14,32
100,Fail,47,29,14,10,37
100,Fail,42,34,0,13,29
100,Fail,39,36,8,17,22
100,Fail,47,33,8,12,35
100,Fail,48,36,0,12,36
100,Fail,46,42,2,10,36
100,Fail,53,31,0,12,41
100,Fail,50,34,0,13,37
100,Fail,51,32,1,16,35
100,Fail,49,36,0,14,35
100,Fail,45,35,0,15,30
100,Fail,52,34,3,11,41
100,Fail,55,35,2,8,47
100,Fail,52,35,0,11,41
100,Fail,34,44,7,15,19
100,Fail,47,40,2,11,36
100,Fail,45,37,0,15,30
100,Fail,46,40,3,11,35
100,Fail,50,40,0,8,42
100,Fail,54,34,0,9,45
100,Fail,50,32,4,14,36
100,Fail,50,36,0,11,39
100,Fail,52,33,3,12,40
100,Fail,50,38,0,10,40
100,Fail,43,35,6,16,27
100,Fail,48,37,0,15,33
100,Fail,51,39,4,6,45
100,Fail,50,32,0,18,32
100,Fail,47,37,0,13,34
100,Fail,44,40,8,8,36
100,Fail,44,36,0,15,29
100,Fail,47,38,5,10,37
100,Fail,56,36,0,8,48
100,Fail,45,41,0,9,36
100,Fail,49,42,0,8,41
100,Fail,44,29,12,15,29
100,Fail,49,38,1,12,37
100,Fail,49,34,3,14,35
100,Fail,40,38,0,18,22
100,Fail,46,37,0,12,34
100,Fail,50,36,0,13,37
100,Fail,54,34,2,10,44
100,Fail,50,35,1,14,36
100,Fail,49,39,0,12,37
100,Fail,53,30,4,13,40
100,Fail,57,28,0,14,43
100,Fail,43,37,0,11,32
100,Fail,51,33,0,10,41
100,Fail,45,36,5,14,31
100,Fail,57,35,0,6,51
100,Fail,53,36,0,10,43
100,Fail,45,38,4,13,32
100,Fail,47,26,0,19,28
100,Fail,48,41,4,7,41
100,Fail,44,41,2,13,31
100,Fail,47,38,1,14,33
100,Fail,49,38,0,8,41
100,Fail,52,36,2,10,42
100,Fail,46,29,0,17,29
100,Fail,46,34,0,16,30
100,Fail,56,32,0,8,48
100,Fail,53,37,3,7,46
100,Fail,49,35,0,16,33
100,Fail,49,33,7,11,38
100,Fail,51,38,1,10,41
100,Fail,41,40,0,13,28
100,Fail,50,40,0,10,40
100,Fail,51,26,5,18,33
100,Fail,47,35,0,11,36
100,Fail,44,37,0,11,33
100,Fail,48,40,2,10,38
100,Fail,42,35,0,16,26
100,Fail,46,27,0,17,29
100,Fail,48,34,0,14,34
100,Fail,50,37,2,11,39
100,Fail,45,33,6,16,29
100,Fail,46,36,5,13,33
100,Fail,57,29,0,6,51
100,Fail,52,38,0,8,44
100,Fail,46,36,2,16,30
100,Fail,37,38,0,18,19
100,Fail,44,41,1,14,30
100,Fail,47,39,0,13,34
100,Fail,40,38,0,13,27
100,Fail,44,35,0,11,33
100,Fail,50,39,0,9,41
100,Fail,53,33,6,8,45
100,Fail,47,34,2,17,30
100,Fail,42,38,7,13,29
100,Fail,51,35,0,12,39
100,Fail,46,43,0,11,35
100,Fail,50,35,6,9,41
100,Fail,52,31,0,17,35
100,Fail,54,32,3,11,43
100,Fail,44,38,8,10,34
100,Fail,49,30,0,17,32
100,Fail,51,37,2,10,41
100,Fail,52,34,0,10,42
100,Fail,45,37,0,15,30
100,Fail,52,29,0,13,39
100,Fail,41,43,0,15,26
100,Fail,42,42,5,11,31
100,Fail,49,40,0,11,38
100,Fail,52,37,2,9,43
100,Fail,47,42,0,11,36
100,Fail,54,37,0,8,46
100,Fail,46,33,0,14,32
100,Fail,50,34,0,9,41
100,Fail,41,37,9,13,28
100,Fail,42,36,10,12,30
100,Fail,48,34,0,9,39
100,Fail,47,35,4,14,33
100,Fail,47,39,2,12,35
100,Fail,48,34,0,16,32
100,Fail,50,35,1,14,36
100,Fail,55,31,0,13,42
100,Fail,46,33,0,11,35
100,Fail,46,38,0,12,34
100,Fail,47,40,1,12,35
100,Fail,50,32,0,15,35
100,Fail,49,38,0,12,37
100,Fail,49,41,1,9,40
100,Fail,50,32,0,8,42
100,Fail,44,40,4,12,32
100,Fail,51,27,0,14,37
100,Fail,48,42,1,9,39
100,Fail,48,39,0,13,35
100,Fail,46,31,5,18,28
100,Fail,49,31,0,11,38
100,Fail,51,33,2,14,37
100,Fail,52,30,3,15,37
100,Fail,43,43,1,13,30
100,Fail,53,40,0,6,47
100,Fail,51,30,8,11,40
100,Fail,47,44,0,8,39
100,Fail,48,37,0,13,35
100,Fail,44,31,7,18,26
100,Fail,32,40,0,21,11
100,Fail,50,36,0,10,40
100,Fail,46,40,3,11,35
100,Fail,43,41,0,12,31
100,Fail,46,36,3,15,31
100,Fail,45,39,3,13,32
100,Fail,57,29,0,13,44
100,Fail,58,25,3,14,44
100,Fail,41,39,0,15,26
100,Fail,52,34,1,13,39
100,Fail,46,26,0,21,25
100,Fail,46,33,10,11,35
100,Fail,54,32,5,9,45
100,Fail,46,38,1,15,31
100,Fail,48,31,0,13,35
100,Fail,57,33,0,9,48
100,Fail,48,40,0,8,40
100,Fail,46,36,0,17,29
100,Fail,52,30,2,16,36
100,Fail,40,40,11,9,31
100,Fail,51,31,0,11,40
100,Fail,47,37,0,12,35
100,Fail,53,37,3,7,46
100,Fail,48,37,0,13,35
100,Fail,50,33,4,13,37
100,Fail,48,35,0,14,34
100,Fail,37,43,0,17,20
100,Fail,48,34,0,13,35
100,Fail,46,40,0,12,34
100,Fail,44,37,6,13,31
100,Fail,52,34,0,11,41
100,Fail,45,35,2,18,27
100,Fail,53,38,1,8,45
100,Fail,61,25,3,11,50
100,Fail,53,30,0,13,40
100,Fail,45,40,0,9,36
100,Fail,48,38,1,13,35
100,Fail,39,38,0,13,26
100,Fail,55,30,4,11,44
100,Fail,44,36,0,16,28
100,Fail,35,33,11,21,14
100,Fail,42,41,1,16,26
100,Fail,48,26,10,16,32
100,Fail,46,39,0,15,31
100,Fail,55,29,0,11,44
100,Fail,47,43,0,8,39
100,Fail,47,38,1,14,33
100,Fail,46,37,1,16,30
100,Fail,42,36,6,16,26
100,Fail,50,33,0,8,42
100,Fail,47,33,0,15,32
100,Fail,44,42,0,13,31
100,Fail,50,31,3,16,34
100,Fail,51,35,0,14,37
100,Fail,43,42,0,10,33
100,Fail,37,42,0,19,18
100,Fail,50,35,0,15,35
100,Fail,43,39,7,11,32
100,Fail,47,38,6,9,38
100,Fail,51,37,0,11,40
100,Fail,37,43,4,16,21
100,Fail,48,34,1,17,31
100,Fail,44,41,7,8,36
100,Fail,45,41,1,13,32
100,Fail,45,34,0,16,29
100,Fail,43,42,1,14,29
100,Fail,51,26,0,19,32
100,Fail,49,35,0,15,34
100,Fail,48,38,3,11,37
100,Fail,44,31,0,19,25
100,Fail,50,31,0,12,38
100,Fail,47,36,0,11,36
100,Fail,57,32,2,9,48
100,Fail,46,39,1,14,32
100,Fail,46,35,0,9,37
100,Fail,56,33,4,7,49
100,Fail,51,33,6,10,41
100,Fail,56,31,2,11,45
100,Fail,45,35,3,17,28
100,Fail,53,34,0,13,40
100,Fail,51,33,0,11,40
100,Fail,54,35,0,11,43
100,Fail,37,35,11,17,20
100,Fail,51,35,3,11,40
100,Fail,38,46,0,13,25
100,Fail,48,39,3,10,38
100,Fail,46,36,0,15,31
100,Fail,53,33,0,9,44
100,Fail,48,29,9,14,34
100,Fail,45,32,0,16,29
100,Fail,55,36,1,8,47
100,Fail,45,29,0,14,31
100,Fail,56,31,0,10,46
100,Fail,46,37,0,13,33
100,Fail,44,42,0,11,33
100,Fail,43,40,0,13,30
100,Fail,54,36,0,8,46
100,Fail,48,38,8,6,42
100,Fail,49,36,0,14,35
100,Fail,47,36,2,15,32
100,Fail,43,35,3,19,24
100,Fail,43,47,5,5,38
100,Fail,42,33,13,12,30
100,Fail,48,40,0,11,37
100,Fail,46,42,1,11,35
100,Fail,38,50,0,5,33
100,Fail,37,43,0,14,23
100,Fail,47,35,4,14,33
100,Fail,48,34,5,13,35
100,Fail,51,29,0,15,36
100,Fail,47,41,5,7,40
100,Fail,44,41,0,9,35
100,Fail,50,33,3,14,36
100,Fail,56,32,0,9,47
100,Fail,39,37,14,10,29
100,Fail,45,41,7,7,38
100,Fail,38,39,6,17,21
100,Fail,49,37,0,11,38
100,Fail,52,31,4,13,39
100,Fail,46,42,0,11,35
100,Fail,42,34,6,18,24
100,Fail,52,37,0,11,41
100,Fail,46,44,4,6,40
100,Fail,38,41,10,11,27
100,Fail,43,42,1,14,29
100,Fail,44,42,0,12,32
100,Fail,41,38,8,13,28
100,Fail,43,40,0,13,30
100,Fail,50,34,2,14,36
100,Fail,52,35,1,12,40
100,Fail,51,36,0,8,43
100,Fail,48,37,9,6,42
100,Fail,49,39,0,8,41
100,Fail,42,36,0,15,27
100,Fail,45,44,0,9,36
100,Fail,41,32,10,17,24
100,Fail,47,35,0,17,30
100,Fail,47,35,9,9,38
100,Fail,42,39,0,15,27
100,Fail,48,36,6,10,38
100,Fail,53,33,2,12,41
100,Fail,56,31,0,9,47
100,Fail,44,36,2,18,26
100,Fail,45,33,8,14,31
100,Fail,53,26,5,16,37
100,Fail,45,36,0,17,28
100,Fail,41,44,1,14,27
100,Fail,41,40,4,15,26
100,Fail,49,34,0,11,38
100,Fail,42,45,0,11,31
100,Fail,43,37,7,13,30
100,Fail,49,32,0,19,30
100,Fail,49,34,0,14,35
100,Fail,45,34,7,14,31
100,Fail,49,39,0,11,38
100,Fail,40,35,10,15,25
100,Fail,46,39,0,9,37
100,Fail,45,42,1,12,33
100,Fail,51,33,6,10,41
100,Fail,41,41,7,11,30
100,Fail,36,38,0,17,19
100,Fail,51,42,0,7,44
100,Fail,36,45,0,17,19
100,Fail,51,29,3,17,34
100,Fail,42,31,0,16,26
100,Fail,52,28,5,15,37
100,Fail,47,36,3,14,33
100,Fail,47,37,3,13,34
100,Fail,49,40,2,9,40
100,Fail,55,37,0,6,49
100,Fail,50,34,0,12,38
100,Fail,44,39,0,11,33
100,Fail,41,38,0,15,26
100,Fail,42,39,2,17,25
100,Fail,52,38,0,8,44
100,Fail,52,35,0,12,40
100,Fail,54,36,0,10,44
100,Fail,46,39,0,13,33
100,Fail,50,33,4,13,37
100,Fail,51,35,1,13,38
100,Fail,53,34,1,12,41
100,Fail,46,38,3,13,33
100,Fail,54,32,0,8,46
100,Fail,46,35,0,17,29
100,Fail,51,34,0,12,39
100,Fail,44,32,4,20,24
100,Fail,45,38,0,15,30
100,Fail,48,33,0,18,30
100,Fail,48,32,2,18,30
100,Fail,40,34,0,23,17
100,Fail,43,39,3,15,28
100,Fail,52,34,2,12,40
100,Fail,47,30,9,14,33
100,Fail,45,36,2,17,28
100,Fail,44,43,0,8,36
100,Fail,46,37,4,13,33
100,Fail,51,40,2,7,44
100,Fail,49,39,0,10,39
100,Fail,57,28,3,12,45
100,Fail,51,35,0,13,38
100,Fail,51,38,0,11,40
100,Fail,45,38,3,14,31
100,Fail,53,31,0,8,45
100,Fail,50,35,4,11,39
100,Fail,58,31,0,9,49
100,Fail,47,30,3,20,27
100,Fail,46,35,6,13,33
100,Fail,60,25,0,8,52
100,Fail,49,39,3,9,40
100,Fail,51,32,0,13,38
100,Fail,48,42,0,10,38
100,Fail,49,41,0,9,40
100,Fail,41,36,6,17,24
100,Fail,47,39,2,12,35
100,Fail,46,37,6,11,35
100,Fail,47,33,10,10,37
100,Fail,48,39,2,11,37
100,Fail,50,35,0,8,42
100,Fail,45,35,8,12,33
100,Fail,49,40,0,11,38
100,Fail,47,36,0,16,31
100,Fail,45,34,8,13,32
100,Fail,40,45,4,11,29
100,Fail,47,36,0,9,38
100,Fail,46,36,3,15,31
100,Fail,51,29,8,12,39
100,Fail,49,37,0,12,37
100,Fail,46,28,5,21,25
100,Fail,45,43,1,11,34
100,Fail,55,34,0,11,44
100,Fail,44,38,6,12,32
100,Fail,44,43,0,11,33
100,Fail,50,37,0,11,39
100,Fail,48,39,1,12,36
100,Fail,42,31,0,14,28
100,Fail,44,39,3,14,30
100,Fail,43,39,7,11,32
100,Fail,50,37,0,13,37
100,Fail,45,38,0,17,28
100,Fail,49,30,0,13,36
100,Fail,45,42,0,13,32
100,Fail,50,29,5,16,34
100,Fail,48,32,0,13,35
100,Fail,61,25,0,9,52
100,Fail,44,35,4,17,27
100,Fail,52,42,3,3,49
100,Fail,46,35,8,11,35
100,Fail,49,29,0,18,31
100,Fail,47,34,7,12,35
100,Fail,40,46,3,11,29
100,Fail,47,36,7,10,37
100,Fail,44,33,0,10,34
100,Fail,42,44,3,11,31
100,Fail,49,39,0,8,41
100,Fail,53,33,1,13,40
100,Fail,47,25,0,20,27
100,Fail,47,39,0,9,38
100,Fail,40,36,0,17,23
100,Fail,45,30,0,17,28
100,Fail,43,32,14,11,32
100,Fail,57,32,2,9,48
100,Fail,44,37,5,14,30
100,Fail,44,38,3,15,29
100,Fail,53,34,2,11,42
100,Fail,47,36,0,9,38
100,Fail,57,30,4,9,48
100,Fail,42,39,0,16,26
100,Fail,53,32,1,14,39
100,Fail,43,43,0,10,33
100,Fail,40,33,11,16,24
100,Fail,56,35,0,8,48
100,Fail,60,30,0,8,52
100,Fail,52,35,0,11,41
100,Fail,47,38,5,10,37
100,Fail,42,43,0,10,32
100,Fail,49,34,0,16,33
100,Fail,43,35,9,13,30
100,Fail,48,33,4,15,33
100,Fail,47,35,0,13,34
100,Fail,51,34,0,13,38
100,Fail,41,36,9,14,27
100,Fail,48,39,0,12,36
100,Fail,47,40,0,11,36
100,Fail,41,34,0,13,28
100,Fail,55,31,4,10,45
100,Fail,51,34,0,14,37
100,Fail,51,29,5,15,36
100,Fail,44,31,0,16,28
100,Fail,47,34,6,13,34
100,Fail,38,33,7,22,16
100,Fail,43,46,1,10,33
100,Fail,52,34,4,10,42
100,Fail,41,39,0,17,24
100,Fail,45,37,0,16,29
100,Fail,52,28,7,13,39
100,Fail,49,32,0,16,33
100,Fail,42,40,0,15,27
100,Fail,42,44,5,9,33
100,Fail,40,48,0,11,29
100,Fail,49,36,0,11,38
100,Fail,47,31,7,15,32
100,Fail,50,40,0,10,40
100,Fail,48,36,0,14,34
100,Fail,47,35,0,15,32
100,Fail,47,41,1,11,36
100,Fail,45,43,2,10,35
100,Fail,54,35,0,8,46
100,Fail,57,33,3,7,50
100,Fail,55,35,0,9,46
100,Fail,43,36,0,18,25
100,Fail,53,36,1,10,43
100,Fail,47,36,6,11,36
100,Fail,41,34,0,10,31
100,Fail,46,35,8,11,35
100,Fail,53,32,0,12,41
100,Fail,48,36,2,14,34
100,Fail,49,35,5,11,38
100,Fail,43,38,5,14,29
100,Fail,55,31,0,13,42
100,Fail,41,39,2,18,23
100,Fail,43,38,4,15,28
100,Fail,43,35,0,13,30
100,Fail,41,47,1,11,30
100,Fail,49,41,2,8,41
100,Fail,44,39,1,16,28
100,Fail,45,35,0,17,28
100,Fail,44,43,0,13,31
100,Fail,49,34,0,11,38
100,Fail,49,29,4,18,31
100,Fail,45,35,7,13,32
100,Fail,52,34,0,14,38
100,Fail,49,34,2,15,34
100,Fail,49,37,0,14,35
100,Fail,47,35,0,18,29
100,Fail,45,39,4,12,33
100,Fail,51,34,0,10,41
100,Fail,48,35,0,12,36
100,Fail,50,33,5,12,38
100,Fail,44,35,11,10,34
100,Fail,53,40,0,6,47
100,Fail,52,32,4,12,40
100,Fail,43,44,0,11,32
100,Fail,52,31,0,14,38
100,Fail,40,35,12,13,27
100,Fail,53,36,0,10,43
100,Fail,53,32,0,10,43
100,Fail,44,39,0,17,27
100,Fail,43,35,9,13,30
100,Fail,53,33,2,12,41
100,Fail,46,41,0,11,35
100,Fail,47,36,1,16,31
100,Fail,37,39,0,17,20
100,Fail,41,41,3,15,26
100,Fail,50,36,2,12,38
100,Fail,52,36,0,9,43
100,Fail,46,31,6,17,29
100,Fail,51,31,5,13,38
100,Fail,41,39,0,9,32
100,Fail,46,44,0,10,36
100,Fail,48,33,0,16,32
100,Fail,50,31,3,16,34
100,Fail,48,35,0,14,34
100,Fail,37,50,3,10,27
100,Fail,48,30,0,13,35
100,Fail,50,38,3,9,41
100,Fail,48,36,0,11,37
100,Fail,50,39,0,11,39
100,Fail,56,31,0,10,46
100,Fail,48,32,0,14,34
100,Fail,48,36,2,14,34
100,Fail,48,34,0,14,34
100,Fail,48,34,10,8,40
100,Fail,51,39,2,8,43
100,Fail,41,40,0,15,26
100,Fail,53,34,0,10,43
100,Fail,50,36,3,11,39
100,Fail,48,33,0,10,38
100,Fail,50,37,0,9,41
100,Fail,53,35,1,11,42
100,Fail,48,32,3,17,31
100,Fail,46,35,3,16,30
100,Fail,44,36,0,11,33
100,Fail,49,32,0,16,33
100,Fail,48,36,4,12,36
100,Fail,54,30,0,11,43
100,Fail,49,32,0,16,33
100,Fail,46,34,0,11,35
100,Fail,44,40,0,16,28
100,Fail,48,41,2,9,39
100,Fail,45,35,0,16,29
100,Fail,46,34,5,15,31
100,Fail,43,39,9,9,34
100,Fail,48,36,5,11,37
100,Fail,52,31,0,11,41
100,Fail,43,37,0,20,23
100,Fail,53,33,0,14,39
100,Fail,49,32,0,11,38
100,Fail,51,32,0,13,38
100,Fail,43,41,0,15,28
100,Fail,40,41,6,13,27
100,Fail,47,40,0,9,38
100,Fail,49,42,0,5,44
100,Fail,52,37,3,8,44
100,Fail,46,31,8,15,31
100,Fail,46,44,1,9,37
100,Fail,38,31,0,16,22
100,Fail,54,35,1,10,44
100,Fail,44,42,4,10,34
100,Fail,50,37,1,12,38
100,Fail,37,43,0,14,23
100,Fail,58,31,0,9,49
100,Fail,49,35,0,11,38
100,Fail,45,37,5,13,32
100,Fail,44,33,9,14,30
100,Fail,42,33,0,13,29
100,Fail,53,37,0,9,44
100,Fail,48,35,6,11,37
100,Fail,50,28,0,15,35
100,Fail,57,31,0,12,45
100,Fail,45,37,0,16,29
100,Fail,43,34,9,14,29
100,Fail,45,39,0,14,31
100,Fail,50,40,0,9,41
100,Fail,44,30,0,11,33
100,Fail,55,37,0,7,48
100,Fail,46,41,0,12,34
100,Fail,52,30,0,16,36
100,Fail,46,38,0,13,33
100,Fail,48,33,6,13,35
100,Fail,47,31,8,14,33
100,Fail,44,40,0,10,34
100,Fail,44,41,2,13,31
100,Fail,46,31,0,13,33
100,Fail,51,33,6,10,41
100,Fail,39,41,3,17,22
100,Fail,52,32,2,14,38
100,Fail,52,34,0,10,42
100,Fail,49,38,0,12,37
100,Fail,42,32,0,18,24
100,Fail,51,40,0,9,42
100,Fail,36,49,3,12,24
100,Fail,41,35,0,18,23
100,Fail,56,31,0,12,44
100,Fail,46,33,0,13,33
100,Fail,46,33,0,12,34
100,Fail,51,36,5,8,43
100,Fail,59,29,0,10,49
100,Fail,43,37,0,10,33
100,Fail,50,38,0,10,40
100,Fail,46,40,0,13,33
100,Fail,45,37,5,13,32
100,Fail,48,33,0,17,31
100,Fail,50,34,5,11,39
100,Fail,51,35,0,14,37
100,Fail,49,36,0,10,39
100,Fail,53,28,8,11,42
100,Fail,45,45,0,6,39
100,Fail,43,42,7,8,35
100,Fail,50,36,4,10,40
100,Fail,41,41,3,15,26
100,Fail,53,31,3,13,40
100,Fail,54,25,7,14,40
100,Fail,51,38,0,9,42
100,Fail,54,37,0,8,46
100,Fail,50,34,3,13,37
100,Fail,44,42,0,13,31
100,Fail,54,33,0,12,42
100,Fail,45,42,0,12,33
100,Fail,45,38,0,13,32
100,Fail,52,34,3,11,41
100,Fail,43,37,0,19,24
100,Fail,45,40,3,12,33
100,Fail,45,38,5,12,33
100,Fail,49,40,3,8,41
100,Fail,47,34,8,11,36
100,Fail,54,28,0,12,42
100,Fail,46,39,0,10,36
100,Fail,49,41,0,10,39
100,Fail,51,36,2,11,40
100,Fail,39,38,13,10,29
100,Fail,53,36,0,11,42
100,Fail,47,41,0,11,36
100,Fail,52,39,0,6,46
100,Fail,42,32,4,22,20
100,Fail,50,38,0,10,40
100,Fail,51,28,8,13,38
100,Fail,42,36,0,18,24
100,Fail,43,41,0,15,28
100,Fail,42,39,0,12,30
100,Fail,43,40,2,15,28
100,Fail,43,43,0,10,33
100,Fail,44,45,3,8,36
100,Fail,45,37,0,14,31
100,Fail,42,34,10,14,28
100,Fail,48,34,8,10,38
100,Fail,46,43,0,8,38
100,Fail,51,34,0,13,38
100,Fail,53,34,0,9,44
100,Fail,40,48,0,9,31
100,Fail,54,33,3,10,44
100,Fail,50,30,0,14,36
100,Fail,49,32,0,10,39
100,Fail,43,36,6,15,28
100,Fail,50,30,6,14,36
100,Fail,42,26,0,19,23
100,Fail,53,34,0,12,41
100,Fail,42,42,2,14,28
100,Fail,52,35,3,10,42
100,Fail,48,37,0,13,35
100,Fail,50,32,6,12,38
100,Fail,45,35,6,14,31
100,Fail,55,32,2,11,44
100,Fail,45,41,0,10,35
100,Fail,44,34,6,16,28
100,Fail,56,34,0,9,47
100,Fail,58,29,0,13,45
100,Fail,49,32,9,10,39
100,Fail,53,33,0,11,42
100,Fail,46,38,4,12,34
100,Fail,45,32,0,15,30
100,Fail,51,34,4,11,40
100,Fail,44,37,5,14,30
100,Fail,49,42,0,9,40
100,Fail,48,29,0,18,30
100,Fail,42,32,0,15,27
100,Fail,56,28,0,16,40
100,Fail,48,31,0,12,36
100,Fail,46,33,5,16,30
100,Fail,42,37,0,19,23
100,Fail,46,40,0,14,32
100,Fail,53,30,0,15,38
100,Fail,51,29,0,17,34
100,Fail,51,32,3,14,37
100,Fail,49,34,0,10,39
100,Fail,49,31,0,16,33
100,Fail,44,39,7,10,34
100,Fail,51,39,0,10,41
100,Fail,50,32,6,12,38
100,Fail,52,35,0,7,45
100,Fail,49,35,6,10,39
100,Fail,48,38,0,14,34
100,Fail,47,31,11,11,36
100,Fail,45,34,6,15,30
100,Fail,55,33,0,6,49
100,Fail,45,41,0,13,32
100,Fail,54,32,3,11,43
100,Fail,43,40,7,10,33
100,Fail,47,39,0,8,39
100,Fail,44,33,0,11,33
100,Fail,49,32,3,16,33
100,Fail,52,32,3,13,39
100,Fail,51,33,1,15,36
100,Fail,54,32,0,12,42
100,Fail,40,42,0,14,26
100,Fail,51,35,0,13,38
100,Fail,49,32,7,12,37
100,Fail,51,39,3,7,44
100,Fail,48,36,8,8,40
100,Fail,53,36,0,9,44
100,Fail,48,39,0,9,39
100,Fail,44,41,5,10,34
100,Fail,51,33,4,12,39
100,Fail,44,36,4,16,28
100,Fail,42,37,14,7,35
100,Fail,45,34,3,18,27
100,Fail,49,37,6,8,41
100,Fail,55,32,0,12,43
100,Fail,52,33,3,12,40
100,Fail,50,39,0,11,39
100,Fail,43,39,5,13,30
100,Fail,47,41,0,11,36
100,Fail,46,39,7,8,38
100,Fail,43,39,0,12,31
100,Fail,44,39,0,13,31
100,Fail,48,34,0,11,37
100,Fail,44,34,8,14,30
100,Fail,52,37,2,9,43
100,Fail,51,29,8,12,39
100,Fail,42,38,9,11,31
100,Fail,53,32,2,13,40
100,Fail,46,43,0,11,35
100,Fail,44,40,0,14,30
100,Fail,55,21,0,12,43
100,Fail,49,39,0,10,39
100,Fail,43,41,0,8,35
100,Fail,45,39,0,16,29
100,Fail,42,36,8,14,28
100,Fail,41,39,0,18,23
100,Fail,44,38,0,8,36
100,Fail,49,29,0,16,33
100,Fail,40,36,9,15,25
100,Fail,50,41,2,7,43
100,Fail,50,37,0,13,37
100,Fail,52,33,1,14,38
100,Fail,45,41,0,12,33
100,Fail,53,32,4,11,42
100,Fail,48,33,8,11,37
100,Fail,51,35,4,10,41
100,Fail,51,34,0,15,36
100,Fail,50,32,0,14,36
100,Fail,53,31,0,11,42
100,Fail,45,36,0,15,30
100,Fail,42,37,5,16,26
100,Fail,47,41,0,11,36
100,Fail,48,40,1,11,37
100,Fail,45,32,0,16,29
100,Fail,47,31,4,18,29
100,Fail,58,31,0,10,48
100,Fail,49,26,9,16,33
100,Fail,52,33,0,10,42
100,Fail,44,29,0,12,32
100,Fail,44,35,8,13,31
100,Fail,45,33,6,16,29
100,Fail,42,33,7,18,24
100,Fail,55,32,1,12,43
100,Fail,44,33,11,12,32
100,Fail,52,32,0,11,41
100,Fail,49,40,2,9,40
100,Fail,49,33,0,17,32
100,Fail,50,34,0,13,37
100,Fail,54,34,0,10,44
100,Fail,45,36,0,15,30
100,Fail,51,37,0,9,42
100,Fail,49,39,0,11,38
100,Fail,49,30,4,17,32
100,Fail,51,32,3,14,37
100,Fail,54,33,5,8,46
100,Fail,43,31,11,15,28
100,Fail,45,40,0,12,33
100,Fail,47,39,1,13,34
100,Fail,49,29,11,11,38
100,Fail,43,34,0,16,27
100,Fail,48,37,0,14,34
100,Fail,48,33,0,17,31
100,Fail,50,37,4,9,41
100,Fail,50,38,0,6,44
100,Fail,44,42,0,13,31
100,Fail,48,32,0,17,31
100,Fail,46,38,0,9,37
100,Fail,44,39,3,14,30
100,Fail,47,42,1,10,37
100,Fail,51,34,2,13,38
100,Fail,49,34,0,15,34
100,Fail,44,38,5,13,31
100,Fail,50,38,0,12,38
100,Fail,38,41,0,12,26
100,Fail,58,29,4,9,49
100,Fail,50,33,0,8,42
100,Fail,58,32,3,7,51
100,Fail,46,34,2,18,28
100,Fail,53,34,2,11,42
100,Fail,42,33,10,15,27
100,Fail,49,32,0,11,38
100,Fail,47,41,2,10,37
100,Fail,53,39,0,7,46
100,Fail,45,39,0,13,32
100,Fail,38,37,0,19,19
100,Fail,39,42,0,17,22
100,Fail,42,45,0,10,32
100,Fail,53,38,0,9,44
100,Fail,44,40,2,14,30
100,Fail,52,34,5,9,43
100,Fail,49,41,0,9,40
100,Fail,50,28,5,17,33
100,Fail,55,28,4,13,42
100,Fail,54,35,0,8,46
100,Fail,45,39,5,11,34
100,Fail,46,32,7,15,31
100,Fail,38,47,2,13,25
100,Fail,35,40,0,12,23
100,Fail,44,43,2,11,33
100,Fail,48,34,6,12,36
100,Fail,50,33,3,14,36
100,Fail,45,34,6,15,30
100,Fail,57,33,0,10,47
100,Fail,56,29,1,14,42
100,Fail,54,33,1,12,42
100,Fail,45,32,0,15,30
100,Fail,45,35,0,15,30
100,Fail,52,35,0,13,39
100,Fail,49,40,0,10,39
100,Fail,46,30,5,19,27
100,Fail,48,35,1,16,32
100,Fail,48,39,2,11,37
100,Fail,50,30,0,10,40
100,Fail,45,39,4,12,33
100,Fail,53,36,1,10,43
100,Fail,49,38,1,12,37
100,Fail,48,35,0,13,35
100,Fail,45,34,0,16,29
100,Fail,41,38,0,15,26
100,Fail,56,35,0,7,49
100,Fail,48,36,6,10,38
100,Fail,46,35,1,18,28
100,Fail,51,36,0,5,46
100,Fail,44,34,0,18,26
100,Fail,43,46,2,9,34
100,Fail,53,36,0,11,42
100,Fail,53,29,0,11,42
100,Fail,44,42,3,11,33
100,Fail,46,40,0,12,34
100,Fail,48,29,5,18,30
100,Fail,50,32,10,8,42
100,Fail,52,29,3,16,36
100,Fail,43,41,8,8,35
100,Fail,45,44,0,11,34
100,Fail,55,31,0,11,44
100,Fail,50,35,2,13,37
100,Fail,49,36,0,14,35
100,Fail,45,41,0,13,32
100,Fail,44,42,0,14,30
100,Fail,38,36,0,18,20
100,Fail,41,54,0,4,37
100,Fail,52,40,0,8,44
100,Fail,38,37,0,18,20
100,Fail,43,46,0,9,34
100,Fail,52,35,0,12,40
100,Fail,49,30,7,14,35
100,Fail,40,42,7,11,29
100,Fail,53,33,0,13,40
100,Fail,46,43,0,9,37
100,Fail,56,33,0,10,46
100,Fail,54,31,3,12,42
100,Fail,42,41,2,15,27
100,Fail,56,32,1,11,45
100,Fail,42,45,0,13,29
100,Fail,50,34,4,12,38
100,Fail,42,33,11,14,28
100,Fail,41,36,6,17,24
100,Fail,51,37,0,11,40
100,Fail,42,41,0,17,25
100,Fail,43,36,0,14,29
100,Fail,46,37,0,8,38
100,Fail,55,31,0,9,46
100,Fail,50,37,0,7,43
100,Fail,51,29,5,15,36
100,Fail,50,32,2,16,34
100,Fail,47,40,1,12,35
100,Fail,50,40,1,9,41
100,Fail,47,38,0,14,33
100,Fail,55,34,0,9,46
100,Fail,50,37,0,11,39
100,Fail,46,42,0,10,36
100,Fail,44,34,7,15,29
100,Fail,48,36,2,14,34
100,Fail,48,37,0,11,37
100,Fail,45,38,0,16,29
100,Fail,43,39,0,16,27
100,Fail,45,39,0,13,32
100,Fail,46,35,0,18,28
100,Fail,57,31,1,11,46
100,Fail,48,41,3,8,40
100,Fail,45,31,0,14,31
100,Fail,48,38,0,11,37
100,Fail,41,35,5,19,22
100,Fail,57,26,0,17,40
100,Fail,48,38,0,8,40
100,Fail,47,31,8,14,33
100,Fail,49,36,0,14,35
100,Fail,49,41,2,8,41
100,Fail,47,28,7,18,29
100,Fail,52,30,4,14,38
100,Fail,46,38,0,15,31
100,Fail,47,37,5,11,36
100,Fail,41,44,0,14,27
100,Fail,54,28,6,12,42
100,Fail,42,30,10,18,24
100,Fail,48,37,0,11,37
100,Fail,45,37,0,14,31
100,Fail,51,33,0,13,38
100,Fail,52,35,0,7,45
100,Fail,52,35,0,11,41
100,Fail,52,35,0,11,41
100,Fail,50,30,3,17,33
100,Fail,46,34,0,17,29
100,Fail,50,38,1,11,39
100,Fail,55,27,0,18,37
100,Fail,52,34,6,8,44
100,Fail,46,31,7,16,30
100,Fail,43,40,6,11,32
100,Fail,58,31,0,6,52
100,Fail,46,36,3,15,31
100,Fail,52,37,0,10,42
100,Fail,40,43,0,14,26
100,Fail,55,29,7,9,46
100,Fail,53,39,0,8,45
100,Fail,42,40,0,15,27
100,Fail,52,29,8,11,41
100,Fail,37,37,7,19,18
100,Fail,41,28,11,20,21
100,Fail,41,43,0,8,33
100,Fail,46,38,3,13,33
100,Fail,49,42,0,6,43
100,Fail,42,35,11,12,30
100,Fail,58,33,0,9,49
100,Fail,45,35,5,15,30
100,Fail,50,30,0,13,37
100,Fail,44,37,7,12,32
100,Fail,49,38,0,13,36
100,Fail,49,37,0,12,37
100,Fail,59,33,0,8,51
100,Fail,45,41,0,12,33
100,Fail,53,36,0,7,46
100,Fail,48,33,0,16,32
100,Fail,50,32,0,13,37
100,Fail,40,47,2,11,29
100,Fail,40,40,0,14,26
100,Fail,49,33,0,15,34
100,Fail,44,34,0,14,30
100,Fail,46,40,0,11,35
100,Fail,49,34,0,12,37
100,Fail,49,34,0,10,39
100,Fail,47,31,1,21,26
100,Fail,53,31,0,14,39
100,Fail,47,37,2,14,33
100,Fail,45,44,0,9,36
100,Fail,50,28,9,13,37
100,Fail,52,31,9,8,44
100,Fail,56,31,0,12,44
100,Fail,50,33,0,17,33
100,Fail,50,31,4,15,35
100,Fail,52,37,7,4,48
100,Fail,42,41,4,13,29
100,Fail,55,37,1,7,48
100,Fail,50,27,8,15,35
100,Fail,52,31,0,8,44
100,Fail,49,31,0,13,36
100,Fail,55,33,0,10,45
100,Fail,48,37,3,12,36
100,Fail,53,32,2,13,40
100,Fail,40,36,5,19,21
100,Fail,49,32,0,13,36
100,Fail,53,35,3,9,44
100,Fail,49,36,2,13,36
100,Fail,43,42,0,14,29
100,Fail,50,33,0,13,37
100,Fail,43,41,1,15,28
100,Fail,41,41,10,8,33
100,Fail,45,39,0,12,33
100,Fail,52,36,1,11,41
100,Fail,44,37,0,11,33
100,Fail,50,36,0,10,40
100,Fail,51,36,0,13,38
100,Fail,46,34,0,15,31
100,Fail,51,28,8,13,38
100,Fail,41,29,0,17,24
100,Fail,47,42,3,8,39
100,Fail,48,33,0,13,35
100,Fail,51,36,0,10,41
100,Fail,48,32,3,17,31
100,Fail,49,38,0,12,37
100,Fail,47,37,0,12,35
100,Fail,49,30,5,16,33
100,Fail,47,35,0,15,32
100,Fail,50,30,7,13,37
100,Fail,45,36,1,18,27
100,Fail,49,42,0,9,40
100,Fail,50,35,0,13,37
100,Fail,45,38,1,16,29
100,Fail,54,37,1,8,46
100,Fail,50,35,0,11,39
100,Fail,56,37,1,6,50
100,Fail,51,27,11,11,40
100,Fail,46,42,0,9,37
100,Fail,49,37,0,11,38
100,Fail,40,46,0,13,27
100,Fail,39,35,10,16,23
100,Fail,52,34,1,13,39
100,Fail,52,36,1,11,41
100,Fail,48,34,0,12,36
100,Fail,41,46,1,12,29
100,Fail,48,36,0,11,37
100,Fail,43,34,4,19,24
100,Fail,48,38,0,13,35
100,Fail,51,37,3,9,42
100,Fail,48,38,1,13,35
100,Fail,44,43,4,9,35
100,Fail,47,39,1,13,34
100,Fail,41,35,0,17,24
100,Fail,53,41,0,5,48
100,Fail,46,39,0,14,32
100,Fail,46,36,0,11,35
100,Fail,49,35,0,16,33
100,Fail,49,35,0,11,38
100,Fail,46,34,8,12,34
100,Fail,53,32,3,12,41
100,Fail,48,30,0,12,36
100,Fail,42,40,4,14,28
100,Fail,56,32,1,11,45
100,Fail,47,35,0,16,31
100,Fail,38,46,1,15,23
100,Fail,50,39,0,10,40
100,Fail,48,40,0,11,37
100,Fail,51,33,7,9,42
100,Fail,54,34,2,10,44
100,Fail,51,35,1,13,38
100,Fail,47,33,0,13,34
100,Fail,42,36,8,14,28
100,Fail,49,39,0,11,38
100,Fail,49,35,5,11,38
100,Fail,51,30,0,13,38
100,Fail,51,37,0,11,40
100,Fail,50,40,4,6,44
100,Fail,54,33,5,8,46
100,Fail,50,34,0,11,39
100,Fail,54,36,0,7,47
100,Fail,56,31,0,12,44
100,Fail,46,36,8,10,36
100,Fail,50,36,0,10,40
100,Fail,49,35,0,11,38
100,Fail,52,31,0,9,43
100,Fail,48,43,0,9,39
100,Fail,52,33,0,11,41
100,Fail,54,33,4,9,45
100,Fail,52,34,0,12,40
100,Fail,40,42,8,10,30
100,Fail,50,35,0,15,35
100,Fail,50,33,0,14,36
100,Fail,40,42,0,16,24
100,Fail,49,36,0,11,38
100,Fail,47,36,2,15,32
100,Fail,51,36,0,12,39
100,Fail,56,27,3,14,42
100,Fail,36,45,8,11,25
100,Fail,50,37,0,10,40
100,Fail,46,30,0,18,28
100,Fail,50,30,3,17,33
100,Fail,44,35,0,16,28
100,Fail,42,41,0,14,28
100,Fail,45,35,0,18,27
100,Fail,53,39,0,5,48
100,Fail,44,43,0,10,34
100,Fail,49,36,0,14,35
100,Fail,50,38,0,12,38
100,Fail,49,33,0,15,34
100,Fail,61,27,1,11,50
100,Fail,46,42,2,10,36
100,Fail,51,37,2,10,41
100,Fail,55,19,12,14,41
100,Fail,44,41,1,14,30
100,Fail,45,38,5,12,33
100,Fail,48,31,8,13,35
100,Fail,45,31,0,14,31
100,Fail,46,34,0,16,30
100,Fail,46,41,3,10,36
100,Fail,53,31,1,15,38
100,Fail,48,42,0,10,38
100,Fail,54,34,0,11,43
100,Fail,47,32,7,14,33
100,Fail,50,31,6,13,37
100,Fail,51,29,0,16,35
100,Fail,50,36,0,9,41
100,Fail,50,36,2,12,38
100,Fail,44,31,0,17,27
100,Fail,39,40,0,15,24
100,Fail,49,40,2,9,40
100,Fail,54,36,1,9,45
100,Fail,51,36,0,11,40
100,Fail,51,34,2,13,38
100,Fail,53,36,0,5,48
100,Fail,48,38,6,8,40
100,Fail,50,33,4,13,37
100,Fail,47,36,0,10,37
100,Fail,52,32,9,7,45
100,Fail,40,41,0,14,26
100,Fail,51,30,2,17,34
100,Fail,48,30,7,15,33
100,Fail,47,40,0,11,36
100,Fail,42,33,0,19,23
100,Fail,50,38,0,8,42
100,Fail,46,24,11,19,27
100,Fail,41,37,9,13,28
100,Fail,44,34,14,8,36
100,Fail,53,39,1,7,46
100,Fail,45,40,0,14,31
100,Fail,46,36,0,14,32
100,Fail,45,40,4,11,34
100,Fail,51,35,0,10,41
100,Fail,42,44,0,14,28
100,Fail,53,41,0,5,48
100,Fail,40,37,0,17,23
100,Fail,49,36,1,14,35
100,Fail,50,37,0,11,39
100,Fail,44,41,3,12,32
100,Fail,53,31,1,15,38
100,Fail,54,32,1,13,41
100,Fail,47,37,0,9,38
100,Fail,41,37,0,18,23
100,Fail,52,30,0,8,44
100,Fail,52,39,2,7,45
100,Fail,44,35,5,16,28
100,Fail,44,37,0,15,29
100,Fail,45,41,0,9,36
100,Fail,46,40,4,10,36
100,Fail,53,31,0,13,40
100,Fail,53,33,0,10,43
100,Fail,46,40,0,13,33
100,Fail,50,36,0,10,40
100,Fail,59,35,3,3,56
100,Fail,43,38,0,14,29
100,Fail,42,37,0,12,30
100,Fail,46,32,0,12,34
100,Fail,45,40,2,13,32
100,Fail,48,37,2,13,35
100,Fail,55,32,1,12,43
100,Fail,48,35,4,13,35
100,Fail,46,33,6,15,31
100,Fail,50,35,0,12,38
100,Fail,57,26,2,15,42
100,Fail,44,40,2,14,30
100,Fail,51,35,5,9,42
100,Fail,47,38,2,13,34
100,Fail,55,35,1,9,46
100,Fail,49,32,0,10,39
100,Fail,38,39,0,11,27
100,Fail,43,31,7,19,24
100,Fail,47,33,0,14,33
100,Fail,42,33,5,20,22
100,Fail,49,30,3,18,31
100,Fail,49,33,0,13,36
100,Fail,49,38,4,9,40
100,Fail,44,41,8,7,37
100,Fail,53,33,0,9,44
100,Fail,45,37,0,13,32
100,Fail,50,37,0,11,39
100,Fail,53,30,0,14,39
100,Fail,42,37,0,13,29
100,Fail,49,32,6,13,36
100,Fail,43,43,0,14,29
100,Fail,48,36,0,14,34
100,Fail,44,39,0,15,29
100,Fail,45,36,0,13,32
100,Fail,45,38,6,11,34
100,Fail,36,41,5,18,18
100,Fail,50,34,0,10,40
100,Fail,47,32,0,15,32
100,Fail,50,25,14,11,39
100,Fail,49,36,2,13,36
100,Fail,44,35,0,12,32
100,Fail,60,30,0,10,50
100,Fail,42,37,5,16,26
100,Fail,48,28,8,16,32
100,Fail,49,38,0,11,38
100,Fail,51,35,0,11,40
100,Fail,41,34,0,18,23
100,Fail,42,31,0,21,21
100,Fail,49,35,0,13,36
100,Fail,56,33,2,9,47
100,Fail,51,33,6,10,41
100,Fail,40,43,0,14,26
100,Fail,49,41,0,8,41
100,Fail,56,32,2,10,46
100,Fail,53,29,0,14,39
100,Fail,51,34,0,8,43
100,Fail,50,34,4,12,38
100,Fail,55,33,2,10,45
100,Fail,53,35,0,11,42
100,Fail,55,36,0,8,47
100,Fail,52,33,0,14,38
100,Fail,51,40,1,8,43
100,Fail,49,33,5,13,36
100,Fail,53,32,0,8,45
100,Fail,51,35,0,12,39
100,Fail,43,35,2,20,23
100,Fail,52,33,0,11,41
100,Fail,49,30,6,15,34
100,Fail,45,36,1,18,27
100,Fail,42,42,1,15,27
100,Fail,48,36,0,13,35
100,Fail,48,33,0,11,37
100,Fail,44,31,10,15,29
100,Fail,47,38,0,14,33
100,Fail,53,35,4,8,45
100,Fail,47,33,0,13,34
100,Fail,49,30,0,18,31
100,Fail,52,32,3,13,39
100,Fail,40,38,9,13,27
100,Fail,46,36,0,13,33
100,Fail,37,43,7,13,24
100,Fail,49,36,0,10,39
100,Fail,55,34,0,11,44
100,Fail,50,37,4,9,41
100,Fail,45,40,0,14,31
100,Fail,50,38,1,11,39
100,Fail,40,40,3,17,23
100,Fail,50,33,4,13,37
100,Fail,43,41,8,8,35
100,Fail,53,26,9,12,41
100,Fail,49,35,4,12,37
100,Fail,46,31,5,18,28
100,Fail,46,36,3,15,31
100,Fail,54,36,0,6,48
100,Fail,45,34,11,10,35
100,Fail,55,30,5,10,45
100,Fail,48,42,1,9,39
100,Fail,45,38,10,7,38
100,Fail,52,34,0,12,40
100,Fail,50,27,0,11,39
100,Fail,42,33,0,21,21
100,Fail,55,32,2,11,44
100,Fail,44,38,5,13,31
100,Fail,52,25,0,11,41
100,Fail,50,32,0,14,36
100,Fail,50,36,1,13,37
100,Fail,40,40,0,15,25
100,Fail,47,38,0,14,33
100,Fail,51,37,1,11,40
100,Fail,47,36,7,10,37
100,Fail,49,35,1,15,34
100,Fail,51,36,3,10,41
100,Fail,47,33,1,19,28
100,Fail,51,33,0,16,35
100,Fail,55,30,0,11,44
100,Fail,43,39,4,14,29
100,Fail,46,37,0,16,30
100,Fail,42,43,5,10,32
100,Fail,46,40,2,12,34
100,Fail,55,34,3,8,47
100,Fail,44,40,5,11,33
100,Fail,39,34,0,17,22
100,Fail,46,35,0,13,33
100,Fail,52,39,1,8,44
100,Fail,48,36,0,16,32
100,Fail,49,34,5,12,37
100,Fail,41,48,0,10,31
100,Fail,41,33,4,22,19
100,Fail,46,33,0,18,28
100,Fail,36,35,0,21,15
100,Fail,48,41,2,9,39
100,Fail,55,33,0,10,45
100,Fail,49,34,6,11,38
100,Fail,51,33,0,14,37
100,Fail,52,33,0,8,44
100,Fail,56,31,3,10,46
100,Fail,48,32,2,18,30
100,Fail,47,38,1,14,33
100,Fail,59,32,3,6,53
100,Fail,43,38,0,16,27
100,Fail,44,43,0,13,31
100,Fail,47,33,8,12,35
100,Fail,41,41,0,11,30
100,Fail,47,31,12,10,37
100,Fail,51,37,0,8,43
100,Fail,45,42,0,10,35
100,Fail,42,37,8,13,29
100,Fail,47,41,4,8,39
100,Fail,50,33,0,16,34
100,Fail,52,36,2,10,42
100,Fail,49,31,5,15,34
100,Fail,40,39,5,16,24
100,Fail,50,35,4,11,39
100,Fail,43,34,0,7,36
100,Fail,39,41,7,13,26
100,Fail,53,33,2,12,41
100,Fail,47,36,0,11,36
100,Fail,48,35,0,15,33
100,Fail,39,46,0,13,26
100,Fail,43,41,8,8,35
100,Fail,50,41,3,6,44
100,Fail,42,39,2,17,25
100,Fail,47,40,4,9,38
100,Fail,51,28,11,10,41
100,Fail,49,31,0,18,31
100,Fail,41,41,0,15,26
100,Fail,48,42,0,10,38
100,Fail,46,36,0,9,37
100,Fail,40,41,4,15,25
100,Fail,49,32,9,10,39
100,Fail,52,35,5,8,44
100,Fail,47,30,0,16,31
100,Fail,49,39,2,10,39
100,Fail,47,27,8,18,29
100,Fail,45,39,0,15,30
100,Fail,45,35,0,10,35
100,Fail,54,34,0,11,43
100,Fail,49,36,3,12,37
100,Fail,47,35,1,17,30
100,Fail,53,37,0,6,47
100,Fail,47,43,0,9,38
100,Fail,50,35,0,8,42
100,Fail,39,36,0,21,18
100,Fail,52,32,3,13,39
100,Fail,44,38,1,17,27
100,Fail,50,35,2,13,37
100,Fail,44,41,0,10,34
100,Fail,45,31,0,16,29
100,Fail,39,36,4,21,18
100,Fail,50,41,2,7,43
100,Fail,45,36,0,15,30
100,Fail,41,31,12,16,25
100,Fail,42,43,3,12,30
100,Fail,45,32,0,14,31
100,Fail,47,30,0,14,33
100,Fail,57,24,8,11,46
100,Fail,53,35,0,9,44
100,Fail,51,36,6,7,44
100,Fail,38,35,12,15,23
100,Fail,49,34,3,14,35
100,Fail,48,40,0,9,39
100,Fail,54,37,0,8,46
100,Fail,47,35,0,10,37
100,Fail,48,34,5,13,35
100,Fail,44,29,0,8,36
100,Fail,43,45,2,10,33
100,Fail,55,32,0,12,43
100,Fail,57,31,0,9,48
100,Fail,51,29,6,14,37
100,Fail,46,31,5,18,28
100,Fail,47,38,2,13,34
100,Fail,50,34,3,13,37
100,Fail,48,32,2,18,30
100,Fail,47,37,1,15,32
100,Fail,55,30,0,12,43
100,Fail,56,31,0,11,45
100,Fail,50,38,4,8,42
100,Fail,44,36,0,15,29
100,Fail,37,40,9,14,23
100,Fail,47,33,0,10,37
100,Fail,47,38,5,10,37
100,Fail,44,33,8,15,29
100,Fail,54,33,4,9,45
100,Fail,45,39,7,9,36
100,Fail,51,30,8,11,40
100,Fail,43,39,8,10,33
100,Fail,45,39,0,10,35
100,Fail,51,31,0,11,40
100,Fail,47,33,0,11,36
100,Fail,38,45,3,14,24
100,Fail,49,32,0,13,36
100,Fail,45,41,1,13,32
100,Fail,43,38,0,12,31
100,Fail,45,40,3,12,33
100,Fail,45,37,4,14,31
100,Fail,51,36,0,9,42
100,Fail,52,35,2,11,41
100,Fail,48,40,0,12,36
100,Fail,45,41,1,13,32
100,Fail,42,40,0,10,32
100,Fail,51,34,2,13,38
100,Fail,56,30,0,13,43
100,Fail,54,32,2,12,42
100,Fail,53,33,0,11,42
100,Fail,51,33,0,12,39
100,Fail,43,37,7,13,30
100,Fail,48,34,0,15,33
100,Fail,45,43,0,12,33
100,Fail,53,36,2,9,44
100,Fail,41,35,0,14,27
100,Fail,47,34,6,13,34
100,Fail,52,36,3,9,43
100,Fail,44,37,14,5,39
100,Fail,46,41,0,7,39
100,Fail,42,34,0,23,19
100,Fail,45,34,0,12,33
100,Fail,41,39,7,13,28
100,Fail,55,31,0,13,42
100,Fail,44,39,0,14,30
100,Fail,48,31,4,17,31
100,Fail,59,35,1,5,54
100,Fail,45,39,6,10,35
100,Fail,42,46,0,12,30
100,Fail,42,36,0,18,24
100,Fail,43,40,0,15,28
100,Fail,44,43,0,12,32
100,Fail,43,41,4,12,31
100,Fail,43,43,0,10,33
100,Fail,50,36,0,12,38
100,Fail,38,47,0,12,26
100,Fail,52,31,0,13,39
100,Fail,50,38,5,7,43
100,Fail,42,41,5,12,30
100,Fail,46,41,0,12,34
100,Fail,39,47,2,12,27
100,Fail,43,36,7,14,29
100,Fail,54,29,2,15,39
100,Fail,36,38,13,13,23
100,Fail,44,37,0,11,33
100,Fail,53,35,0,7,46
100,Fail,46,40,0,11,35
100,Fail,43,35,0,20,23
100,Fail,52,34,4,10,42
100,Fail,49,42,3,6,43
100,Fail,49,39,1,11,38
100,Fail,51,30,0,11,40
100,Fail,47,37,0,14,33
100,Fail,47,33,0,17,30
100,Fail,50,32,0,14,36
100,Fail,47,35,5,13,34
100,Fail,51,37,5,7,44
100,Fail,51,32,2,15,36
100,Fail,49,36,1,14,35
100,Fail,42,41,0,17,25
100,Fail,37,40,11,12,25
100,Fail,49,37,3,11,38
100,Fail,52,38,1,9,43
100,Fail,45,39,6,10,35
100,Fail,50,36,0,13,37
100,Fail,50,30,0,11,39
100,Fail,50,37,1,12,38
100,Fail,50,35,0,13,37
100,Fail,44,40,0,16,28
100,Fail,45,37,0,13,32
100,Fail,47,37,0,8,39
100,Fail,49,32,8,11,38
100,Fail,46,38,0,11,35
100,Fail,50,39,0,11,39
100,Fail,55,36,0,7,48
100,Fail,49,35,0,14,35
100,Fail,50,39,2,9,41
100,Fail,41,46,0,11,30
100,Fail,51,37,2,10,41
100,Fail,42,38,0,19,23
100,Fail,39,35,0,14,25
100,Fail,45,27,13,15,30
100,Fail,49,34,0,13,36
100,Fail,45,45,0,8,37
100,Fail,42,44,0,11,31
100,Fail,47,29,8,16,31
100,Fail,44,35,0,12,32
100,Fail,51,37,1,11,40
100,Fail,48,37,0,12,36
100,Fail,44,41,3,12,32
100,Fail,48,31,5,16,32
100,Fail,53,33,0,10,43
100,Fail,41,39,0,13,28
100,Fail,44,33,0,19,25
100,Fail,53,31,5,11,42
100,Fail,45,33,0,14,31
100,Fail,46,41,2,11,35
100,Fail,46,37,0,11,35
100,Fail,45,40,0,13,32
100,Fail,44,36,7,13,31
100,Fail,47,37,3,13,34
100,Fail,49,40,4,7,42
100,Fail,52,32,1,15,37
100,Fail,38,46,4,12,26
100,Fail,48,30,6,16,32
100,Fail,47,31,0,16,31
100,Fail,44,38,3,15,29
100,Fail,53,30,0,13,40
100,Fail,44,33,0,18,26
100,Fail,37,43,7,13,24
100,Fail,46,41,2,11,35
100,Fail,49,31,7,13,36
100,Fail,41,44,0,15,26
100,Fail,45,37,6,12,33
100,Fail,48,32,0,19,29
100,Fail,50,33,2,15,35
100,Fail,48,32,0,11,37
100,Fail,53,34,1,12,41
100,Fail,45,34,6,15,30
100,Fail,44,41,1,14,30
100,Fail,51,42,2,5,46
100,Fail,45,34,11,10,35
100,Fail,46,37,0,10,36
100,Fail,50,33,0,13,37
100,Fail,51,31,2,16,35
100,Fail,45,35,7,13,32
100,Fail,60,27,0,8,52
100,Fail,52,32,2,14,38
100,Fail,46,35,0,12,34
100,Fail,46,37,0,17,29
100,Fail,40,38,0,17,23
100,Fail,53,36,0,11,42
100,Fail,43,38,2,17,26
100,Fail,46,36,3,15,31
100,Fail,42,41,8,9,33
100,Fail,50,40,0,9,41
100,Fail,50,37,0,7,43
100,Fail,41,35,11,13,28
100,Fail,47,43,2,8,39
100,Fail,47,31,5,17,30
100,Fail,49,35,5,11,38
100,Fail,50,29,0,18,32
100,Fail,47,37,0,9,38
100,Fail,50,38,1,11,39
100,Fail,54,27,0,13,41
100,Fail,45,36,0,11,34
100,Fail,52,32,0,15,37
100,Fail,45,43,1,11,34
100,Fail,54,34,0,6,48
100,Fail,43,34,4,19,24
100,Fail,52,39,1,8,44
100,Fail,48,39,0,8,40
100,Fail,51,32,0,15,36
100,Fail,49,35,1,15,34
100,Fail,43,38,0,18,25
100,Fail,48,25,6,21,27
100,Fail,49,31,0,10,39
100,Fail,45,34,7,14,31
100,Fail,40,36,10,14,26
100,Fail,54,26,3,17,37
100,Fail,45,39,4,12,33
100,Fail,46,41,0,11,35
100,Fail,52,35,0,12,40
100,Fail,54,25,7,14,40
100,Fail,56,32,0,9,47
100,Fail,55,31,0,10,45
100,Fail,51,35,4,10,41
100,Fail,55,27,9,9,46
100,Fail,44,38,1,17,27
100,Fail,46,37,0,11,35
100,Fail,50,42,0,8,42
100,Fail,46,35,0,17,29
100,Fail,42,31,0,18,24
100,Fail,50,37,5,8,42
100,Fail,46,45,0,7,39
100,Fail,48,41,0,10,38
100,Fail,49,32,8,11,38
100,Fail,49,33,7,11,38
100,Fail,58,31,0,8,50
100,Fail,41,39,0,18,23
100,Fail,48,31,9,12,36
100,Fail,41,33,0,13,28
100,Fail,43,39,0,14,29
100,Fail,61,28,1,10,51
100,Fail,44,37,0,14,30
100,Fail,44,40,2,14,30
100,Fail,45,36,6,13,32
100,Fail,39,40,0,16,23
100,Fail,47,37,5,11,36
100,Fail,45,44,0,11,34
100,Fail,45,28,0,24,21
100,Fail,47,37,4,12,35
100,Fail,46,39,0,10,36
100,Fail,49,35,0,13,36
100,Fail,52,33,0,12,40
100,Fail,50,33,9,8,42
100,Fail,52,30,0,8,44
100,Fail,46,36,4,14,32
100,Fail,46,39,0,11,35
100,Fail,51,37,0,8,43
100,Fail,41,37,4,18,23
100,Fail,50,39,1,10,40
100,Fail,47,35,2,16,31
100,Fail,54,31,3,12,42
100,Fail,52,27,5,16,36
100,Fail,54,34,0,9,45
100,Fail,53,38,0,9,44
100,Fail,47,33,0,13,34
100,Fail,47,43,0,8,39
100,Fail,46,33,7,14,32
100,Fail,50,30,0,20,30
100,Fail,42,30,10,18,24
100,Fail,52,33,0,14,38
100,Fail,43,38,5,14,29
100,Fail,38,38,0,18,20
100,Fail,52,27,4,17,35
100,Fail,40,37,9,14,26
100,Fail,48,34,8,10,38
100,Fail,46,42,1,11,35
100,Fail,46,35,2,17,29
100,Fail,48,34,3,15,33
100,Fail,48,41,0,11,37
100,Fail,42,43,0,13,29
100,Fail,53,32,0,13,40
100,Fail,44,42,1,13,31
100,Fail,44,37,0,9,35
100,Fail,47,37,0,11,36
100,Fail,48,34,0,16,32
100,Fail,52,37,0,11,41
100,Fail,49,41,0,8,41
100,Fail,50,32,3,15,35
100,Fail,47,27,13,13,34
100,Fail,45,34,0,14,31
100,Fail,46,38,5,11,35
100,Fail,48,33,0,18,30
100,Fail,52,35,0,11,41
100,Fail,53,33,5,9,44
100,Fail,46,34,0,19,27
100,Fail,52,29,4,15,37
100,Fail,46,30,0,14,32
100,Fail,54,28,0,16,38
100,Fail,47,37,0,11,36
100,Fail,44,38,0,17,27
100,Fail,50,29,0,16,34
100,Fail,51,29,0,16,35
100,Fail,41,33,0,18,23
100,Fail,52,31,0,10,42
100,Fail,47,36,0,16,31
100,Fail,45,40,0,15,30
100,Fail,41,40,0,13,28
100,Fail,49,36,2,13,36
100,Fail,49,37,0,13,36
100,Fail,46,38,0,10,36
100,Fail,48,34,5,13,35
100,Fail,53,33,0,10,43
100,Fail,48,46,0,6,42
100,Fail,47,37,4,12,35
100,Fail,47,43,0,9,38
100,Fail,46,39,0,14,32
100,Fail,50,34,0,14,36
100,Fail,52,36,2,10,42
100,Fail,51,37,0,12,39
100,Fail,54,34,4,8,46
100,Fail,40,36,12,12,28
100,Fail,46,32,0,20,26
100,Fail,50,38,0,10,40
100,Fail,46,36,6,12,34
100,Fail,46,31,0,12,34
100,Fail,41,41,4,14,27
100,Fail,54,35,0,10,44
100,Fail,47,38,0,11,36
100,Fail,46,40,3,11,35
100,Fail,49,38,0,8,41
100,Fail,48,34,1,17,31
100,Fail,45,38,0,11,34
100,Fail,55,30,0,11,44
100,Fail,56,28,0,12,44
100,Fail,44,37,6,13,31
100,Fail,41,30,0,17,24
100,Fail,53,36,0,9,44
100,Fail,46,36,0,15,31
100,Fail,52,28,7,13,39
100,Fail,51,36,1,12,39
100,Fail,50,36,6,8,42
100,Fail,46,32,0,22,24
100,Fail,40,39,11,10,30
100,Fail,44,32,6,18,26
100,Fail,53,39,2,6,47
100,Fail,56,28,0,16,40
100,Fail,52,36,1,11,41
100,Fail,54,29,7,10,44
100,Fail,48,31,0,19,29
100,Fail,49,33,0,15,34
100,Fail,41,33,10,16,25
100,Fail,47,31,8,14,33
100,Fail,60,30,3,7,53
100,Fail,49,31,0,17,32
100,Fail,48,45,0,7,41
100,Fail,46,35,0,14,32
100,Fail,54,26,0,15,39
100,Fail,48,35,0,16,32
100,Fail,43,34,0,17,26
100,Fail,44,36,0,15,29
100,Fail,47,39,0,14,33
100,Fail,54,30,7,9,45
100,Fail,50,33,4,13,37
100,Fail,49,40,0,10,39
100,Fail,49,35,0,14,35
100,Fail,41,39,0,19,22
100,Fail,45,26,0,16,29
100,Fail,47,33,3,17,30
100,Fail,52,34,0,13,39
100,Fail,41,39,0,16,25
100,Fail,44,33,5,18,26
100,Fail,54,32,5,9,45
100,Fail,46,36,0,9,37
100,Fail,52,38,0,10,42
100,Fail,43,44,0,10,33
100,Fail,51,35,1,13,38
100,Fail,50,31,2,17,33
100,Fail,51,32,6,11,40
100,Fail,42,36,7,15,27
100,Fail,51,33,0,12,39
100,Fail,51,38,0,9,42
100,Fail,48,28,8,16,32
100,Fail,48,32,0,18,30
100,Fail,48,33,0,17,31
100,Fail,55,28,0,13,42
100,Fail,47,37,0,13,34
100,Fail,43,39,3,15,28
100,Fail,47,35,3,15,32
100,Fail,50,37,0,13,37
100,Fail,49,36,0,15,34
100,Fail,58,32,4,6,52
100,Fail,47,34,0,11,36
100,Fail,47,39,2,12,35
100,Fail,51,35,0,13,38
100,Fail,48,23,18,11,37
100,Fail,51,29,0,19,32
100,Fail,48,28,9,15,33
100,Fail,52,31,1,16,36
100,Fail,52,38,0,9,43
100,Fail,41,41,5,13,28
100,Fail,44,37,0,19,25
100,Fail,47,32,3,18,29
100,Fail,51,33,0,8,43
100,Fail,44,35,5,16,28
100,Fail,56,33,0,8,48
100,Fail,50,35,0,13,37
100,Fail,44,44,0,10,34
100,Fail,48,40,0,12,36
100,Fail,52,28,1,19,33
100,Fail,48,40,6,6,42
100,Fail,47,32,5,16,31
100,Fail,49,36,5,10,39
100,Fail,47,33,0,18,29
100,Fail,44,45,1,10,34
100,Fail,48,31,0,9,39
100,Fail,53,37,2,8,45
100,Fail,43,39,0,15,28
100,Fail,49,33,4,14,35
100,Fail,49,34,0,11,38
100,Fail,51,36,0,11,40
100,Fail,46,40,0,12,34
100,Fail,47,37,0,10,37
100,Fail,48,39,0,11,37
100,Fail,56,29,0,15,41
100,Fail,42,28,13,17,25
100,Fail,45,34,1,20,25
100,Fail,49,41,1,9,40
100,Fail,53,34,0,13,40
100,Fail,49,35,0,10,39
100,Fail,44,33,0,14,30
100,Fail,45,38,0,12,33
100,Fail,49,35,6,10,39
100,Fail,45,33,4,18,27
100,Fail,46,34,2,18,28
100,Fail,53,34,0,13,40
100,Fail,48,38,0,10,38
100,Fail,48,31,7,14,34
100,Fail,50,33,6,11,39
100,Fail,50,35,3,12,38
100,Fail,47,40,4,9,38
100,Fail,42,36,5,17,25
100,Fail,48,37,7,8,40
100,Fail,38,33,0,19,19
100,Fail,52,33,4,11,41
100,Fail,45,37,3,15,30
100,Fail,44,39,5,12,32
100,Fail,50,36,3,11,39
100,Fail,49,37,0,13,36
100,Fail,56,39,0,5,51
100,Fail,50,34,1,15,35
100,Fail,47,40,2,11,36
100,Fail,48,29,0,11,37
100,Fail,49,36,2,13,36
100,Fail,51,40,0,8,43
100,Fail,43,32,10,15,28
100,Fail,54,32,0,10,44
100,Fail,53,32,0,11,42
100,Fail,49,30,0,10,39
100,Fail,42,34,0,8,34
100,Fail,48,38,0,13,35
100,Fail,44,41,0,9,35
100,Fail,47,37,2,14,33
100,Fail,49,31,1,19,30
100,Fail,54,35,2,9,45
100,Fail,54,33,4,9,45
100,Fail,57,31,0,8,49
100,Fail,50,38,2,10,40
100,Fail,48,36,0,8,40
100,Fail,51,30,0,19,32
100,Fail,44,34,0,14,30
100,Fail,45,45,5,5,40
100,Fail,49,20,14,17,32
100,Fail,48,38,1,13,35
100,Fail,46,34,5,15,31
100,Fail,48,38,0,11,37
100,Fail,52,34,5,9,43
100,Fail,42,43,2,13,29
100,Fail,50,35,4,11,39
100,Fail,40,36,5,19,21
100,Fail,40,37,0,13,27
100,Fail,43,40,9,8,35
100,Fail,48,37,2,13,35
100,Fail,48,33,1,18,30
100,Fail,46,37,0,14,32
100,Fail,50,30,0,19,31
100,Fail,44,35,0,16,28
100,Fail,45,30,0,18,27
100,Fail,50,37,4,9,41
100,Fail,55,32,0,8,47
100,Fail,45,33,7,15,30
100,Fail,45,42,2,11,34
100,Fail,51,32,0,16,35
100,Fail,46,44,1,9,37
100,Fail,55,32,5,8,47
100,Fail,59,28,1,12,47
100,Fail,40,38,0,15,25
100,Fail,47,27,0,15,32
100,Fail,51,32,5,12,39
100,Fail,44,37,0,15,29
100,Fail,43,44,6,7,36
100,Fail,50,38,0,9,41
100,Fail,53,24,0,16,37
100,Fail,46,32,3,19,27
100,Fail,50,31,0,17,33
100,Fail,46,40,2,12,34
100,Fail,51,36,0,9,42
100,Fail,49,35,4,12,37
100,Fail,45,39,0,12,33
100,Fail,51,23,0,23,28
100,Fail,48,39,0,13,35
100,Fail,50,33,7,10,40
100,Fail,60,23,0,16,44
100,Fail,54,27,12,7,47
100,Fail,42,45,0,7,35
100,Fail,49,33,0,15,34
100,Fail,48,36,0,13,35
100,Fail,43,41,0,11,32
100,Fail,52,36,2,10,42
100,Fail,43,37,0,17,26
100,Fail,56,29,4,11,45
100,Fail,46,44,0,6,40
100,Fail,44,33,12,11,33
100,Fail,46,42,5,7,39
100,Fail,48,33,0,16,32
100,Fail,43,42,0,13,30
100,Fail,49,38,2,11,38
100,Fail,44,33,4,19,25
100,Fail,50,35,0,12,38
100,Fail,45,35,4,16,29
100,Fail,49,37,2,12,37
100,Fail,56,27,1,16,40
100,Fail,47,42,4,7,40
100,Fail,53,29,6,12,41
100,Fail,51,36,0,6,45
100,Fail,43,34,0,19,24
100,Fail,43,43,5,9,34
100,Fail,50,40,0,10,40
100,Fail,45,37,0,14,31
100,Fail,52,37,0,7,45
100,Fail,49,33,0,17,32
100,Fail,45,38,0,13,32
100,Fail,44,38,0,16,28
100,Fail,45,43,0,9,36
100,Fail,53,34,2,11,42
100,Fail,52,25,2,21,31
100,Fail,48,29,5,18,30
100,Fail,52,34,0,11,41
100,Fail,54,33,5,8,46
100,Fail,55,31,0,8,47
100,Fail,49,38,0,11,38
100,Fail,48,40,0,10,38
100,Fail,55,33,0,10,45
100,Fail,44,39,0,10,34
100,Fail,53,31,7,9,44
100,Fail,52,35,0,12,40
100,Fail,49,37,3,11,38
100,Fail,49,36,0,11,38
100,Fail,49,33,10,8,41
100,Fail,51,29,0,11,40
100,Fail,43,42,1,14,29
100,Fail,50,36,3,11,39
100,Fail,52,32,4,12,40
100,Fail,56,31,0,12,44
100,Fail,44,40,0,16,28
100,Fail,46,38,0,13,33
100,Fail,49,36,3,12,37
100,Fail,49,35,0,14,35
100,Fail,50,38,3,9,41
100,Fail,52,34,4,10,42
100,Fail,46,40,4,10,36
100,Fail,51,21,6,22,29
100,Fail,50,33,0,11,39
100,Fail,48,38,0,10,38
100,Fail,43,44,0,12,31
100,Fail,48,37,0,12,36
100,Fail,45,28,0,18,27
100,Fail,54,28,0,18,36
100,Fail,49,36,2,13,36
100,Fail,44,40,4,12,32
100,Fail,46,38,3,13,33
100,Fail,46,39,4,11,35
100,Fail,40,34,9,17,23
100,Fail,46,38,0,16,30
100,Fail,44,35,4,17,27
100,Fail,47,35,5,13,34
100,Fail,49,33,1,17,32
100,Fail,43,44,0,10,33
100,Fail,37,43,0,15,22
100,Fail,43,43,0,14,29
100,Fail,49,40,0,9,40
100,Fail,47,38,0,13,34
100,Fail,60,27,5,8,52
100,Fail,46,39,0,15,31
100,Fail,47,38,1,14,33
100,Fail,53,30,1,16,37
100,Fail,43,43,0,11,32
100,Fail,54,29,0,17,37
100,Fail,53,38,0,9,44
100,Fail,48,31,4,17,31
100,Fail,49,34,0,17,32
100,Fail,47,30,10,13,34
100,Fail,39,45,0,11,28
100,Fail,46,38,0,12,34
100,Fail,45,35,0,17,28
100,Fail,47,35,3,15,32
100,Fail,54,34,2,10,44
100,Fail,48,41,0,10,38
100,Fail,51,36,5,8,43
100,Fail,47,44,0,8,39
100,Fail,44,40,3,13,31
100,Fail,49,33,5,13,36
100,Fail,50,38,0,7,43
100,Fail,49,36,0,13,36
100,Fail,43,39,0,15,28
100,Fail,46,29,7,18,28
100,Fail,58,31,1,10,48
100,Fail,45,35,0,18,27
100,Fail,46,40,0,14,32
100,Fail,44,40,0,14,30
100,Fail,57,30,2,11,46
100,Fail,55,30,0,11,44
100,Fail,49,35,0,13,36
100,Fail,47,33,4,16,31
100,Fail,44,41,0,13,31
100,Fail,53,25,4,18,35
100,Fail,52,36,0,12,40
100,Fail,44,37,7,12,32
100,Fail,43,35,4,18,25
100,Fail,47,36,8,9,38
100,Fail,46,42,3,9,37
100,Fail,39,38,0,13,26
100,Fail,47,37,6,10,37
100,Fail,50,40,0,10,40
100,Fail,47,32,2,19,28
100,Fail,44,42,4,10,34
100,Fail,50,38,3,9,41
100,Fail,45,41,4,10,35
100,Fail,52,30,0,17,35
100,Fail,52,31,0,12,40
100,Fail,45,33,0,20,25
100,Fail,42,38,4,16,26
100,Fail,53,33,0,7,46
100,Fail,49,35,0,13,36
100,Fail,48,32,6,14,34
100,Fail,36,37,0,18,18
100,Fail,53,31,1,15,38
100,Fail,57,28,0,10,47
100,Fail,45,39,4,12,33
100,Fail,51,36,1,12,39
100,Fail,39,37,0,18,21
100,Fail,48,40,1,11,37
100,Fail,52,32,5,11,41
100,Fail,51,34,3,12,39
100,Fail,56,30,0,11,45
100,Fail,44,42,0,10,34
100,Fail,53,34,2,11,42
100,Fail,47,29,0,13,34
100,Fail,55,36,3,6,49
100,Fail,50,30,4,16,34
100,Fail,56,33,2,9,47
100,Fail,48,34,0,15,33
100,Fail,47,37,5,11,36
100,Fail,43,38,2,17,26
100,Fail,45,40,2,13,32
100,Fail,44,39,2,15,29
100,Fail,49,35,0,7,42
100,Fail,41,37,0,19,22
100,Fail,50,35,0,14,36
100,Fail,50,33,4,13,37
100,Fail,43,39,0,14,29
100,Fail,44,42,1,13,31
100,Fail,45,39,0,12,33
100,Fail,49,31,1,19,30
100,Fail,46,36,10,8,38
100,Fail,45,33,0,19,26
100,Fail,49,38,2,11,38
100,Fail,48,38,4,10,38
100,Fail,40,28,0,21,19
100,Fail,50,35,0,11,39
100,Fail,48,40,2,10,38
100,Fail,57,32,0,10,47
100,Fail,47,37,0,13,34
100,Fail,40,35,4,21,19
100,Fail,43,38,0,14,29
100,Fail,45,41,0,13,32
100,Fail,46,38,7,9,37
100,Fail,51,33,2,14,37
100,Fail,45,36,6,13,32
100,Fail,50,33,0,14,36
100,Fail,50,39,5,6,44
100,Fail,39,34,0,20,19
100,Fail,47,35,0,17,30
100,Fail,49,39,0,11,38
100,Fail,49,34,6,11,38
100,Fail,38,41,0,12,26
100,Fail,55,37,3,5,50
100,Fail,46,36,0,16,30
100,Fail,49,34,0,12,37
100,Fail,48,31,11,10,38
100,Fail,46,40,6,8,38
100,Fail,45,37,0,14,31
100,Fail,43,36,0,14,29
100,Fail,50,39,2,9,41
100,Fail,50,34,0,15,35
100,Fail,47,31,0,19,28
100,Fail,49,26,5,20,29
100,Fail,53,34,0,12,41
100,Fail,51,37,8,4,47
100,Fail,52,35,1,12,40
100,Fail,39,35,0,14,25
100,Fail,48,31,0,18,30
100,Fail,53,28,0,11,42
100,Fail,48,37,0,13,35
100,Fail,48,36,0,12,36
100,Fail,50,35,0,13,37
100,Fail,50,35,0,15,35
100,Fail,45,32,6,17,28
100,Fail,52,27,0,14,38
100,Fail,51,39,0,9,42
100,Fail,47,40,0,5,42
100,Fail,57,29,0,12,45
100,Fail,47,39,4,10,37
100,Fail,44,33,4,19,25
100,Fail,47,31,11,11,36
100,Fail,50,35,0,13,37
100,Fail,47,39,0,9,38
100,Fail,47,38,0,15,32
100,Fail,57,33,0,8,49
100,Fail,49,40,0,10,39
100,Fail,52,34,2,12,40
100,Fail,48,40,0,11,37
100,Fail,42,40,2,16,26
100,Fail,47,35,0,10,37
100,Fail,45,39,0,13,32
100,Fail,59,27,3,11,48
100,Fail,48,36,2,14,34
100,Fail,42,41,7,10,32
100,Fail,46,40,0,13,33
100,Fail,53,36,1,10,43
100,Fail,43,33,0,15,28
100,Fail,51,30,0,16,35
100,Fail,49,37,0,13,36
100,Fail,44,38,3,15,29
100,Fail,48,40,1,11,37
100,Fail,51,34,0,11,40
100,Fail,46,41,2,11,35
100,Fail,51,31,0,15,36
100,Fail,50,32,0,18,32
100,Fail,45,38,3,14,31
100,Fail,43,40,5,12,31
100,Fail,55,34,0,8,47
100,Fail,48,35,3,14,34
100,Fail,47,37,6,10,37
100,Fail,53,30,6,11,42
100,Fail,46,34,0,16,30
100,Fail,43,42,5,10,33
100,Fail,46,35,0,12,34
100,Fail,55,32,5,8,47
100,Fail,44,34,0,17,27
100,Fail,49,36,1,14,35
100,Fail,54,31,0,11,43
100,Fail,55,35,0,7,48
100,Fail,48,30,7,15,33
100,Fail,56,35,0,9,47
100,Fail,50,30,0,11,39
100,Fail,52,33,0,12,40
100,Fail,43,42,0,10,33
100,Fail,46,36,0,16,30
100,Fail,56,34,3,7,49
100,Fail,53,36,2,9,44
100,Fail,48,37,1,14,34
100,Fail,45,46,0,9,36
100,Fail,55,25,7,13,42
100,Fail,53,27,0,12,41
100,Fail,56,33,1,10,46
100,Fail,49,34,0,8,41
100,Fail,50,34,0,16,34
100,Fail,36,40,0,13,23
100,Fail,49,38,0,10,39
100,Fail,48,37,0,14,34
100,Fail,47,32,7,14,33
100,Fail,45,43,0,12,33
100,Fail,45,37,0,14,31
100,Fail,44,43,3,10,34
100,Fail,51,40,2,7,44
100,Fail,44,39,1,16,28
100,Fail,48,34,0,15,33
100,Fail,47,35,3,15,32
100,Fail,44,39,4,13,31
100,Fail,59,27,0,13,46
100,Fail,52,36,0,11,41
100,Fail,56,34,2,8,48
100,Fail,55,32,0,12,43
100,Fail,53,32,0,12,41
100,Fail,47,35,0,12,35
100,Fail,49,29,0,13,36
100,Fail,43,40,0,17,26
100,Fail,51,37,0,11,40
100,Fail,44,33,0,21,23
100,Fail,51,36,0,11,40
100,Fail,53,38,2,7,46
100,Fail,46,31,0,16,30
100,Fail,47,34,3,16,31
100,Fail,49,34,6,11,38
100,Fail,55,34,0,8,47
100,Fail,53,38,3,6,47
100,Fail,40,41,0,11,29
100,Fail,44,40,0,9,35
100,Fail,45,35,0,17,28
100,Fail,50,27,7,16,34
100,Fail,52,24,2,22,30
100,Fail,52,33,0,8,44
100,Fail,43,34,9,14,29
100,Fail,43,40,1,16,27
100,Fail,46,37,0,14,32
100,Fail,55,32,0,10,45
100,Fail,42,36,0,13,29
100,Fail,48,44,0,8,40
100,Fail,53,34,1,12,41
100,Fail,44,43,0,13,31
100,Fail,49,36,0,13,36
100,Fail,54,30,1,15,39
100,Fail,43,35,8,14,29
100,Fail,53,38,0,8,45
100,Fail,49,38,2,11,38
100,Fail,52,32,0,12,40
100,Fail,47,34,2,17,30
100,Fail,49,36,0,7,42
100,Fail,43,31,0,22,21
100,Fail,54,36,0,10,44
100,Fail,48,41,3,8,40
100,Fail,48,40,0,12,36
100,Fail,45,40,6,9,36
100,Fail,44,33,0,21,23
100,Fail,45,43,6,6,39
100,Fail,48,30,6,16,32
100,Fail,40,38,0,13,27
100,Fail,50,38,0,10,40
100,Fail,47,32,0,12,35
100,Fail,48,35,2,15,33
100,Fail,44,41,3,12,32
100,Fail,53,35,1,11,42
100,Fail,43,39,0,10,33
100,Fail,55,30,0,13,42
100,Fail,39,39,6,16,23
100,Fail,45,42,0,11,34
100,Fail,48,30,12,10,38
100,Fail,40,32,2,26,14
100,Fail,42,34,7,17,25
100,Fail,46,34,0,17,29
100,Fail,46,41,2,11,35
100,Fail,46,36,6,12,34
100,Fail,45,39,0,16,29
100,Fail,47,30,2,21,26
100,Fail,40,39,6,15,25
100,Fail,40,35,0,17,23
100,Fail,41,39,4,16,25
100,Fail,43,40,0,11,32
100,Fail,52,32,1,15,37
100,Fail,53,35,0,10,43
100,Fail,49,35,0,15,34
100,Fail,46,36,0,15,31
100,Fail,45,35,8,12,33
100,Fail,56,33,1,10,46
100,Fail,48,34,0,17,31
100,Fail,44,38,0,16,28
100,Fail,44,36,0,14,30
100,Fail,50,40,1,9,41
100,Fail,47,35,2,16,31
100,Fail,44,37,7,12,32
100,Fail,51,33,0,14,37
100,Fail,52,35,0,8,44
100,Fail,46,37,1,16,30
100,Fail,47,37,0,15,32
100,Fail,53,30,0,13,40
100,Fail,58,35,0,5,53
100,Fail,50,31,7,12,38
100,Fail,38,37,0,13,25
100,Fail,56,30,0,12,44
100,Fail,40,38,0,19,21
100,Fail,56,30,0,12,44
100,Fail,51,33,0,15,36
100,Fail,54,32,0,10,44
100,Fail,50,34,4,12,38
100,Fail,51,34,0,11,40
100,Fail,44,35,4,17,27
100,Fail,44,39,0,16,28
100,Fail,45,34,0,14,31
100,Fail,47,31,0,15,32
100,Fail,45,37,0,12,33
100,Fail,50,37,0,12,38
100,Fail,46,37,5,12,34
100,Fail,47,38,0,13,34
100,Fail,51,37,3,9,42
100,Fail,50,36,0,12,38
100,Fail,57,29,0,11,46
100,Fail,56,29,4,11,45
100,Fail,46,44,1,9,37
100,Fail,41,43,0,14,27
100,Fail,51,31,4,14,37
100,Fail,47,35,0,12,35
100,Fail,54,32,0,11,43
100,Fail,52,31,4,13,39
100,Fail,53,37,0,9,44
100,Fail,40,35,11,14,26
100,Fail,53,37,2,8,45
100,Fail,43,39,0,11,32
100,Fail,54,38,1,7,47
100,Fail,50,37,3,10,40
100,Fail,50,34,0,16,34
100,Fail,54,35,1,10,44
100,Fail,43,43,1,13,30
100,Fail,39,34,0,12,27
100,Fail,38,40,0,20,18
100,Fail,44,42,0,13,31
100,Fail,51,36,3,10,41
100,Fail,55,36,0,9,46
100,Fail,54,29,0,10,44
100,Fail,39,34,0,16,23
100,Fail,44,35,0,20,24
100,Fail,47,42,4,7,40
100,Fail,52,37,0,10,42
100,Fail,43,42,1,14,29
100,Fail,41,39,0,15,26
100,Fail,43,40,6,11,32
100,Fail,51,33,0,14,37
100,Fail,36,36,0,13,23
100,Fail,51,33,0,14,37
100,Fail,45,34,5,16,29
100,Fail,51,31,0,14,37
100,Fail,48,43,1,8,40
100,Fail,45,40,3,12,33
100,Fail,50,30,7,13,37
100,Fail,56,32,0,11,45
100,Fail,45,39,0,11,34
100,Fail,41,36,8,15,26
100,Fail,49,33,0,12,37
100,Fail,47,39,5,9,38
100,Fail,43,29,13,15,28
100,Fail,46,34,0,19,27
100,Fail,50,36,9,5,45
100,Fail,50,33,0,16,34
100,Fail,48,33,5,14,34
100,Fail,50,36,3,11,39
100,Fail,46,36,0,11,35
100,Fail,47,33,0,16,31
100,Fail,44,37,0,16,28
100,Fail,46,30,0,20,26
100,Fail,46,39,0,13,33
100,Fail,46,37,6,11,35
100,Fail,48,33,4,15,33
100,Fail,49,38,0,6,43
100,Fail,48,32,8,12,36
100,Fail,41,34,0,15,26
100,Fail,50,35,0,15,35
100,Fail,42,45,0,13,29
100,Fail,45,40,0,10,35
100,Fail,53,37,0,7,46
100,Fail,48,27,2,23,25
100,Fail,45,40,5,10,35
100,Fail,46,35,0,10,36
100,Fail,46,34,0,15,31
100,Fail,43,43,1,13,30
100,Fail,50,35,4,11,39
100,Fail,45,40,5,10,35
100,Fail,45,37,2,16,29
100,Fail,47,35,4,14,33
100,Fail,54,32,3,11,43
100,Fail,43,39,5,13,30
100,Fail,46,42,2,10,36
100,Fail,58,34,0,8,50
100,Fail,48,30,3,19,29
100,Fail,48,26,4,22,26
100,Fail,47,42,0,9,38
100,Fail,54,34,0,11,43
100,Fail,49,40,0,10,39
100,Fail,47,40,0,12,35
100,Fail,52,34,2,12,40
100,Fail,47,34,4,15,32
100,Fail,50,40,0,7,43
100,Fail,48,39,0,13,35
100,Fail,43,43,0,10,33
100,Fail,48,32,0,18,30
100,Fail,43,38,6,13,30
100,Fail,51,36,0,13,38
100,Fail,47,32,0,18,29
100,Fail,48,37,0,9,39
100,Fail,54,33,3,10,44
100,Fail,50,39,0,11,39
100,Fail,47,38,0,11,36
100,Fail,31,43,0,21,10
100,Fail,60,25,0,12,48
100,Fail,46,40,3,11,35
100,Fail,47,41,0,11,36
100,Fail,35,42,8,15,20
100,Fail,49,33,0,18,31
100,Fail,57,37,0,6,51
100,Fail,42,41,0,9,33
100,Fail,49,34,0,11,38
100,Fail,58,31,2,9,49
100,Fail,51,33,0,14,37
100,Fail,50,31,0,14,36
100,Fail,49,30,0,18,31
100,Fail,45,36,0,16,29
100,Fail,48,34,0,6,42
100,Fail,40,41,0,14,26
100,Fail,50,40,0,9,41
100,Fail,50,32,5,13,37
100,Fail,46,32,0,15,31
100,Fail,51,35,0,11,40
100,Fail,44,37,0,12,32
100,Fail,51,33,7,9,42
100,Fail,46,36,0,16,30
100,Fail,44,35,8,13,31
100,Fail,43,36,0,14,29
100,Fail,43,33,0,12,31
100,Fail,55,31,0,6,49
100,Fail,42,38,0,11,31
100,Fail,48,39,0,13,35
100,Fail,50,39,0,11,39
100,Fail,47,41,0,7,40
100,Fail,44,31,0,12,32
100,Fail,49,38,0,12,37
100,Fail,40,39,9,12,28
100,Fail,45,37,0,14,31
100,Fail,47,38,2,13,34
100,Fail,53,28,6,13,40
100,Fail,47,28,0,19,28
100,Fail,52,33,4,11,41
100,Fail,41,34,3,22,19
100,Fail,55,35,2,8,47
100,Fail,49,35,0,14,35
100,Fail,47,36,1,16,31
100,Fail,42,34,4,20,22
100,Fail,51,33,7,9,42
100,Fail,48,37,0,8,40
100,Fail,45,36,0,18,27
100,Fail,46,42,2,10,36
100,Fail,53,33,2,12,41
100,Fail,42,39,1,18,24
100,Fail,42,35,0,21,21
100,Fail,39,31,7,23,16
100,Fail,48,28,0,19,29
100,Fail,45,29,0,19,26
100,Fail,50,35,3,12,38
100,Fail,48,37,0,13,35
100,Fail,47,25,12,16,31
100,Fail,49,36,1,14,35
100,Fail,47,40,0,13,34
100,Fail,54,36,1,9,45
100,Fail,40,36,11,13,27
100,Fail,36,44,0,11,25
100,Fail,42,36,6,16,26
100,Fail,35,48,0,9,26
100,Fail,54,37,0,8,46
100,Fail,48,41,0,9,39
100,Fail,42,40,0,17,25
100,Fail,49,39,0,9,40
100,Fail,58,27,3,12,46
100,Fail,49,34,1,16,33
100,Fail,50,34,0,8,42
100,Fail,51,36,0,11,40
100,Fail,50,40,0,7,43
100,Fail,41,39,0,16,25
100,Fail,49,41,0,9,40
100,Fail,49,40,0,10,39
100,Fail,54,36,0,9,45
100,Fail,50,31,9,10,40
100,Fail,46,45,0,7,39
100,Fail,55,32,0,12,43
100,Fail,46,38,1,15,31
100,Fail,49,37,0,10,39
100,Fail,49,41,0,10,39
100,Fail,44,42,0,13,31
100,Fail,48,38,0,8,40
100,Fail,43,42,0,10,33
100,Fail,44,39,3,14,30
100,Fail,41,38,0,15,26
100,Fail,51,27,9,13,38
100,Fail,48,32,0,11,37
100,Fail,45,34,10,11,34
100,Fail,57,30,0,12,45
100,Fail,52,34,0,11,41
100,Fail,45,37,4,14,31
100,Fail,44,39,0,12,32
100,Fail,47,44,1,8,39
100,Fail,49,32,0,12,37
100,Fail,48,39,0,10,38
100,Fail,48,39,0,9,39
100,Fail,56,28,6,10,46
100,Fail,47,36,0,8,39
100,Fail,44,38,5,13,31
100,Fail,49,38,1,12,37
100,Fail,50,37,0,11,39
100,Fail,43,37,0,11,32
100,Fail,55,36,0,9,46
100,Fail,50,37,0,10,40
100,Fail,48,36,0,16,32
100,Fail,51,35,1,13,38
100,Fail,41,42,0,10,31
100,Fail,45,37,2,16,29
100,Fail,44,36,0,12,32
100,Fail,44,33,6,17,27
100,Fail,46,34,0,13,33
100,Fail,48,37,3,12,36
100,Fail,35,46,13,6,29
100,Fail,51,32,0,12,39
100,Fail,48,35,1,16,32
100,Fail,42,42,3,13,29
100,Fail,44,32,0,17,27
100,Fail,49,34,0,14,35
100,Fail,46,39,7,8,38
100,Fail,48,35,0,15,33
100,Fail,44,41,0,10,34
100,Fail,46,36,3,15,31
100,Fail,43,40,4,13,30
100,Fail,45,38,0,16,29
100,Fail,55,37,0,5,50
100,Fail,54,35,0,10,44
100,Fail,49,36,8,7,42
100,Fail,52,35,0,7,45
100,Fail,43,36,4,17,26
100,Fail,54,35,1,10,44
100,Fail,49,27,11,13,36
100,Fail,46,40,8,6,40
100,Fail,50,28,4,18,32
100,Fail,50,33,3,14,36
100,Fail,53,33,4,10,43
100,Fail,46,34,0,10,36
100,Fail,48,31,0,15,33
100,Fail,52,28,8,12,40
100,Fail,50,34,7,9,41
100,Fail,54,31,2,13,41
100,Fail,50,38,0,12,38
100,Fail,49,33,4,14,35
100,Fail,48,37,3,12,36
100,Fail,41,42,5,12,29
100,Fail,53,40,0,7,46
100,Fail,42,41,5,12,30
100,Fail,54,35,1,10,44
100,Fail,50,30,9,11,39
100,Fail,48,41,2,9,39
100,Fail,47,36,4,13,34
100,Fail,53,32,0,9,44
100,Fail,44,36,6,14,30
100,Fail,51,36,0,10,41
100,Fail,46,35,0,15,31
100,Fail,44,40,3,13,31
100,Fail,53,39,0,8,45
100,Fail,51,33,5,11,40
100,Fail,38,38,0,24,14
100,Fail,44,32,10,14,30
100,Fail,47,40,5,8,39
100,Fail,50,37,0,8,42
100,Fail,45,33,0,12,33
100,Fail,56,28,0,11,45
100,Fail,47,33,0,11,36
100,Fail,46,38,0,12,34
100,Fail,44,37,0,14,30
100,Fail,51,30,6,13,38
100,Fail,51,26,0,16,35
100,Fail,46,38,0,12,34
100,Fail,46,39,0,11,35
100,Fail,52,34,2,12,40
100,Fail,48,38,0,11,37
100,Fail,48,39,0,13,35
100,Fail,41,42,6,11,30
100,Fail,52,34,4,10,42
100,Fail,43,36,3,18,25
100,Fail,52,35,1,12,40
100,Fail,52,36,0,12,40
100,Fail,42,37,6,15,27
100,Fail,48,33,0,16,32
100,Fail,54,33,2,11,43
100,Fail,49,40,0,11,38
100,Fail,39,41,0,15,24
100,Fail,40,43,0,16,24
100,Fail,51,37,2,10,41
100,Fail,50,31,7,12,38
100,Fail,48,37,5,10,38
100,Fail,54,29,0,16,38
100,Fail,51,34,5,10,41
100,Fail,43,41,1,15,28
100,Fail,58,31,1,10,48
100,Fail,48,37,0,11,37
100,Fail,49,42,1,8,41
100,Fail,50,40,0,9,41
100,Fail,51,33,3,13,38
100,Fail,47,35,8,10,37
100,Fail,53,36,0,8,45
100,Fail,56,32,2,10,46
100,Fail,44,39,2,15,29
100,Fail,46,41,0,7,39
100,Fail,52,25,8,15,37
100,Fail,48,43,2,7,41
100,Fail,43,36,0,14,29
100,Fail,47,33,0,15,32
100,Fail,46,35,0,15,31
100,Fail,48,34,0,13,35
100,Fail,41,42,2,15,26
100,Fail,42,40,6,12,30
100,Fail,53,29,0,16,37
100,Fail,41,43,8,8,33
100,Fail,54,31,0,11,43
100,Fail,45,36,0,15,30
100,Fail,48,39,4,9,39
100,Fail,48,42,0,8,40
100,Fail,56,35,1,8,48
100,Fail,52,29,0,11,41
100,Fail,44,37,0,15,29
100,Fail,49,27,7,17,32
100,Fail,50,35,5,10,40
100,Fail,42,42,0,14,28
100,Fail,43,43,4,10,33
100,Fail,41,40,0,15,26
100,Fail,52,38,0,10,42
100,Fail,48,30,0,17,31
100,Fail,44,35,10,11,33
100,Fail,46,36,0,11,35
100,Fail,52,36,2,10,42
100,Fail,52,32,2,14,38
100,Fail,43,34,0,13,30
100,Fail,44,36,4,16,28
100,Fail,51,31,1,17,34
100,Fail,45,32,6,17,28
100,Fail,52,36,1,11,41
100,Fail,50,37,4,9,41
100,Fail,42,39,6,13,29
100,Fail,50,33,8,9,41
100,Fail,50,39,5,6,44
100,Fail,44,38,0,15,29
100,Fail,50,30,8,12,38
100,Fail,52,34,2,12,40
100,Fail,43,32,0,14,29
100,Fail,52,34,1,13,39
100,Fail,44,34,11,11,33
100,Fail,51,31,0,15,36
100,Fail,47,36,0,15,32
100,Fail,47,34,2,17,30
100,Fail,41,42,1,16,25
100,Fail,55,33,1,11,44
100,Fail,57,27,3,13,44
100,Fail,49,31,0,18,31
100,Fail,46,39,0,13,33
100,Fail,52,34,3,11,41
100,Fail,51,31,0,13,38
100,Fail,45,31,0,12,33
100,Fail,48,29,0,20,28
100,Fail,45,31,0,13,32
100,Fail,48,31,0,16,32
100,Fail,45,32,0,13,32
100,Fail,37,35,0,14,23
100,Fail,52,26,0,11,41
100,Fail,51,33,1,15,36
100,Fail,47,40,0,10,37
100,Fail,54,27,0,15,39
100,Fail,57,28,4,11,46
100,Fail,54,33,0,10,44
100,Fail,48,34,2,16,32
100,Fail,44,45,0,8,36
100,Fail,54,38,1,7,47
100,Fail,51,39,4,6,45
100,Fail,56,33,2,9,47
100,Fail,41,37,0,14,27
100,Fail,41,42,0,16,25
100,Fail,45,40,3,12,33
100,Fail,47,29,8,16,31
100,Fail,45,32,12,11,34
100,Fail,44,36,0,16,28
100,Fail,52,34,0,14,38
100,Fail,46,30,13,11,35
100,Fail,45,40,5,10,35
100,Fail,44,25,7,24,20
100,Fail,47,37,0,16,31
100,Fail,52,34,0,13,39
100,Fail,48,37,0,14,34
100,Fail,50,39,4,7,43
100,Fail,47,39,0,6,41
100,Fail,46,36,6,12,34
100,Fail,43,43,3,11,32
100,Fail,48,43,0,7,41
100,Fail,48,36,8,8,40
100,Fail,51,29,8,12,39
100,Fail,49,34,0,9,40
100,Fail,52,26,8,14,38
100,Fail,55,26,0,16,39
100,Fail,44,30,14,12,32
100,Fail,48,32,6,14,34
100,Fail,49,36,1,14,35
100,Fail,46,41,0,13,33
100,Fail,45,37,0,13,32
100,Fail,46,41,0,8,38
100,Fail,47,39,4,10,37
100,Fail,49,37,0,11,38
100,Fail,53,35,2,10,43
100,Fail,52,25,5,18,34
100,Fail,46,32,9,13,33
100,Fail,44,39,0,14,30
100,Fail,43,41,0,15,28
100,Fail,53,33,4,10,43
100,Fail,49,29,0,22,27
100,Fail,50,28,0,21,29
100,Fail,38,38,7,17,21
100,Fail,43,46,4,7,36
100,Fail,63,29,2,6,57
100,Fail,48,31,7,14,34
100,Fail,45,32,9,14,31
100,Fail,55,36,0,9,46
100,Fail,51,33,0,9,42
100,Fail,57,34,2,7,50
100,Fail,43,37,0,13,30
100,Fail,45,30,0,13,32
100,Fail,46,30,6,18,28
100,Fail,50,24,0,17,33
100,Fail,53,38,2,7,46
100,Fail,47,34,4,15,32
100,Fail,46,35,9,10,36
100,Fail,52,41,1,6,46
100,Fail,49,34,0,16,33
100,Fail,53,35,0,11,42
100,Fail,44,36,0,14,30
100,Fail,43,41,4,12,31
100,Fail,47,35,0,18,29
100,Fail,55,36,1,8,47
100,Fail,59,31,0,10,49
100,Fail,46,39,5,10,36
100,Fail,50,28,11,11,39
100,Fail,60,30,0,10,50
100,Fail,49,36,0,15,34
100,Fail,45,37,0,13,32
100,Fail,48,42,0,6,42
100,Fail,47,38,0,8,39
100,Fail,43,44,0,11,32
100,Fail,53,33,0,10,43
100,Fail,53,33,0,14,39
100,Fail,45,35,0,17,28
100,Fail,43,32,6,19,24
100,Fail,44,39,1,16,28
100,Fail,44,37,0,16,28
100,Fail,44,38,0,12,32
100,Fail,49,36,3,12,37
100,Fail,46,38,0,13,33
100,Fail,48,33,9,10,38
100,Fail,52,29,0,17,35
100,Fail,43,34,13,10,33
100,Fail,47,35,0,13,34
100,Fail,52,33,0,10,42
100,Fail,47,31,8,14,33
100,Fail,54,34,0,10,44
100,Fail,53,38,0,9,44
100,Fail,49,32,3,16,33
100,Fail,46,41,0,9,37
100,Fail,47,36,3,14,33
100,Fail,49,27,9,15,34
100,Fail,52,34,0,11,41
100,Fail,48,42,0,8,40
100,Fail,57,31,0,11,46
100,Fail,46,40,2,12,34
100,Fail,51,30,0,15,36
100,Fail,39,34,0,21,18
100,Fail,54,28,9,9,45
100,Fail,49,38,0,13,36
100,Fail,50,32,3,15,35
100,Fail,46,36,5,13,33
100,Fail,51,31,0,12,39
100,Fail,48,37,2,13,35
100,Fail,52,34,5,9,43
100,Fail,51,30,6,13,38
100,Fail,43,46,0,10,33
100,Fail,49,42,1,8,41
100,Fail,44,27,11,18,26
100,Fail,41,33,9,17,24
100,Fail,51,36,4,9,42
100,Fail,45,42,0,10,35
100,Fail,36,43,0,21,15
100,Fail,44,38,0,13,31
100,Fail,55,32,0,9,46
100,Fail,45,38,3,14,31
100,Fail,45,31,13,11,34
100,Fail,50,32,3,15,35
100,Fail,49,43,0,8,41
100,Fail,52,37,0,10,42
100,Fail,45,46,0,7,38
100,Fail,55,26,5,14,41
100,Fail,50,33,1,16,34
100,Fail,54,30,4,12,42
100,Fail,49,37,0,14,35
100,Fail,48,38,5,9,39
100,Fail,53,29,3,15,38
100,Fail,50,31,0,13,37
100,Fail,46,41,0,11,35
100,Fail,48,39,2,11,37
100,Fail,51,26,8,15,36
100,Fail,35,42,0,16,19
100,Fail,54,32,0,13,41
100,Fail,49,37,0,13,36
100,Fail,44,40,2,14,30
100,Fail,48,42,0,10,38
100,Fail,51,33,0,14,37
100,Fail,47,30,0,16,31
100,Fail,47,34,0,18,29
100,Fail,40,44,0,8,32
100,Fail,50,42,3,5,45
100,Fail,48,35,0,13,35
100,Fail,44,37,2,17,27
100,Fail,52,34,0,11,41
100,Fail,45,42,2,11,34
100,Fail,54,38,1,7,47
100,Fail,53,37,0,9,44
100,Fail,52,36,0,11,41
100,Fail,47,36,2,15,32
100,Fail,51,37,0,10,41
100,Fail,56,28,3,13,43
100,Fail,46,39,0,12,34
100,Fail,41,40,3,16,25
100,Fail,44,40,0,14,30
100,Fail,46,38,0,15,31
100,Fail,45,32,7,16,29
100,Fail,44,39,0,15,29
100,Fail,49,38,0,12,37
100,Fail,49,34,0,17,32
100,Fail,53,33,0,11,42
100,Fail,47,36,0,10,37
100,Fail,48,39,0,9,39
100,Fail,48,35,6,11,37
100,Fail,49,37,0,12,37
100,Fail,57,31,3,9,48
100,Fail,33,41,11,15,18
100,Fail,49,41,4,6,43
100,Fail,49,30,7,14,35
100,Fail,55,30,0,10,45
100,Fail,45,31,0,22,23
100,Fail,42,46,0,11,31
100,Fail,51,31,3,15,36
100,Fail,47,34,3,16,31
100,Fail,57,33,0,7,50
100,Fail,43,41,0,11,32
100,Fail,46,38,0,16,30
100,Fail,49,38,0,8,41
100,Fail,53,31,7,9,44
100,Fail,50,28,7,15,35
100,Fail,49,35,3,13,36
100,Fail,49,39,3,9,40
100,Fail,53,38,0,9,44
100,Fail,56,27,0,13,43
100,Fail,50,35,1,14,36
100,Fail,52,36,3,9,43
100,Fail,52,32,3,13,39
100,Fail,44,30,11,15,29
100,Fail,46,36,3,15,31
100,Fail,55,30,2,13,42
100,Fail,49,38,3,10,39
100,Fail,49,34,3,14,35
100,Fail,50,33,1,16,34
100,Fail,50,34,0,13,37
100,Fail,50,31,0,11,39
100,Fail,52,37,1,10,42
100,Fail,42,41,1,16,26
100,Fail,43,38,0,14,29
100,Fail,46,38,1,15,31
100,Fail,49,36,0,13,36
100,Fail,49,37,3,11,38
100,Fail,55,30,0,13,42
100,Fail,46,37,0,16,30
100,Fail,55,30,1,14,41
100,Fail,53,38,1,8,45
100,Fail,51,35,0,12,39
100,Fail,39,34,8,19,20
100,Fail,58,24,0,14,44
100,Fail,51,32,2,15,36
100,Fail,52,33,5,10,42
100,Fail,56,28,1,15,41
100,Fail,52,37,0,10,42
100,Fail,47,40,2,11,36
100,Fail,44,39,7,10,34
100,Fail,38,44,5,13,25
100,Fail,45,37,0,13,32
100,Fail,54,35,0,10,44
100,Fail,46,34,6,14,32
100,Fail,49,40,0,11,38
100,Fail,51,37,0,10,41
100,Fail,48,39,0,10,38
100,Fail,43,35,0,17,26
100,Fail,56,25,5,14,42
100,Fail,48,35,0,14,34
100,Fail,53,33,0,10,43
100,Fail,46,31,9,14,32
100,Fail,48,35,10,7,41
100,Fail,47,42,0,8,39
100,Fail,53,38,0,5,48
100,Fail,46,33,8,13,33
100,Fail,43,36,0,18,25
100,Fail,49,30,6,15,34
100,Fail,54,31,0,12,42
100,Fail,52,33,5,10,42
100,Fail,53,26,0,11,42
100,Fail,48,34,2,16,32
100,Fail,42,41,0,12,30
100,Fail,47,38,0,9,38
100,Fail,40,36,5,19,21
100,Fail,48,36,0,16,32
100,Fail,49,39,1,11,38
100,Fail,42,32,0,18,24
100,Fail,41,37,0,16,25
100,Fail,43,41,0,11,32
100,Fail,54,36,0,9,45
100,Fail,51,34,1,14,37
100,Fail,53,33,1,13,40
100,Fail,49,42,0,8,41
100,Fail,46,31,0,13,33
100,Fail,50,37,6,7,43
100,Fail,55,31,0,8,47
100,Fail,49,31,0,14,35
100,Fail,48,33,0,16,32
100,Fail,42,38,12,8,34
100,Fail,44,41,0,12,32
100,Fail,52,41,1,6,46
100,Fail,57,34,0,9,48
100,Fail,41,41,7,11,30
100,Fail,45,34,9,12,33
100,Fail,55,32,0,11,44
100,Fail,40,44,2,14,26
100,Fail,47,29,10,14,33
100,Fail,46,32,6,16,30
100,Fail,55,30,0,15,40
100,Fail,41,32,11,16,25
100,Fail,48,38,4,10,38
100,Fail,49,29,3,19,30
100,Fail,41,33,0,16,25
100,Fail,42,37,0,15,27
100,Fail,43,38,0,16,27
100,Fail,43,43,4,10,33
100,Fail,53,34,3,10,43
100,Fail,50,37,2,11,39
100,Fail,46,30,0,16,30
100,Fail,41,39,8,12,29
100,Fail,45,42,2,11,34
100,Fail,43,30,0,18,25
100,Fail,48,36,1,15,33
100,Fail,50,38,2,10,40
100,Fail,50,30,0,20,30
100,Fail,42,32,0,20,22
100,Fail,45,32,10,13,32
100,Fail,50,36,0,10,40
100,Fail,48,43,2,7,41
100,Fail,42,31,12,15,27
100,Fail,51,35,1,13,38
100,Fail,47,27,8,18,29
100,Fail,49,35,3,13,36
100,Fail,47,35,0,14,33
100,Fail,46,38,6,10,36
100,Fail,36,40,8,16,20
100,Fail,37,41,0,15,22
100,Fail,46,35,8,11,35
100,Fail,47,27,11,15,32
100,Fail,48,38,0,9,39
100,Fail,43,34,0,17,26
100,Fail,53,35,0,9,44
100,Fail,41,43,1,15,26
100,Fail,49,32,0,11,38
100,Fail,39,41,10,10,29
100,Fail,40,40,0,11,29
100,Fail,53,34,0,11,42
100,Fail,52,32,0,16,36
100,Fail,53,34,0,12,41
100,Fail,52,36,1,11,41
100,Fail,41,36,0,19,22
100,Fail,43,37,0,16,27
100,Fail,51,30,6,13,38
100,Fail,50,30,5,15,35
100,Fail,36,46,9,9,27
100,Fail,51,40,0,8,43
100,Fail,36,40,9,15,21
100,Fail,49,31,0,14,35
100,Fail,45,30,5,20,25
100,Fail,51,31,3,15,36
100,Fail,39,43,1,17,22
100,Fail,53,36,3,8,45
100,Fail,49,33,4,14,35
100,Fail,48,38,2,12,36
100,Fail,48,34,11,7,41
100,Fail,45,41,3,11,34
100,Fail,45,28,8,19,26
100,Fail,52,30,0,11,41
100,Fail,55,29,0,14,41
100,Fail,47,30,0,14,33
100,Fail,45,38,0,16,29
100,Fail,45,32,10,13,32
100,Fail,54,36,1,9,45
100,Fail,44,34,0,18,26
100,Fail,48,37,0,15,33
100,Fail,47,34,7,12,35
100,Fail,43,37,0,12,31
100,Fail,52,34,0,10,42
100,Fail,55,31,0,13,42
100,Fail,49,36,0,14,35
100,Fail,49,31,0,19,30
100,Fail,43,28,0,21,22
100,Fail,50,32,7,11,39
100,Fail,51,31,0,8,43
100,Fail,43,30,13,14,29
100,Fail,44,42,0,9,35
100,Fail,52,39,0,9,43
100,Fail,52,37,0,11,41
100,Fail,48,40,0,11,37
100,Fail,49,37,0,10,39
100,Fail,46,41,0,13,33
100,Fail,42,37,0,15,27
100,Fail,47,42,1,10,37
100,Fail,47,43,3,7,40
100,Fail,57,34,0,9,48
100,Fail,53,32,4,11,42
100,Fail,49,34,0,14,35
100,Fail,48,36,5,11,37
100,Fail,48,37,5,10,38
100,Fail,50,37,2,11,39
100,Fail,47,41,0,9,38
100,Fail,50,34,1,15,35
100,Fail,37,34,14,15,22
100,Fail,48,36,3,13,35
100,Fail,44,33,0,13,31
100,Fail,50,35,4,11,39
100,Fail,41,39,0,16,25
100,Fail,44,42,4,10,34
100,Fail,46,33,7,14,32
100,Fail,58,27,3,12,46
100,Fail,51,39,1,9,42
100,Fail,48,35,0,14,34
100,Fail,48,37,4,11,37
100,Fail,46,34,0,15,31
100,Fail,53,30,2,15,38
100,Fail,54,33,0,11,43
100,Fail,51,31,0,9,42
100,Fail,43,36,10,11,32
100,Fail,43,36,5,16,27
100,Fail,49,34,0,10,39
100,Fail,47,43,0,7,40
100,Fail,50,33,0,15,35
100,Fail,50,36,2,12,38
100,Fail,48,31,0,17,31
100,Fail,48,42,0,10,38
100,Fail,52,34,0,6,46
100,Fail,48,35,2,15,33
100,Fail,49,38,0,13,36
100,Fail,48,38,3,11,37
100,Fail,46,35,0,14,32
100,Fail,43,33,0,16,27
100,Fail,44,37,7,12,32
100,Fail,52,39,1,8,44
100,Fail,48,36,3,13,35
100,Fail,52,36,2,10,42
100,Fail,48,42,1,9,39
100,Fail,49,32,0,18,31
100,Fail,50,33,7,10,40
100,Fail,46,38,4,12,34
100,Fail,41,39,7,13,28
100,Fail,53,33,0,9,44
100,Fail,42,38,0,12,30
100,Fail,51,39,0,8,43
100,Fail,47,35,2,16,31
100,Fail,40,35,5,20,20
100,Fail,46,34,0,14,32
100,Fail,43,37,4,16,27
100,Fail,50,33,2,15,35
100,Fail,55,30,1,14,41
100,Fail,45,40,0,14,31
100,Fail,51,39,2,8,43
100,Fail,44,34,5,17,27
100,Fail,45,44,0,7,38
100,Fail,49,36,0,12,37
100,Fail,44,35,3,18,26
100,Fail,45,42,0,4,41
100,Fail,52,31,0,12,40
100,Fail,59,32,0,9,50
100,Fail,47,33,7,13,34
100,Fail,50,35,0,14,36
100,Fail,46,37,7,10,36
100,Fail,45,38,0,12,33
100,Fail,42,40,7,11,31
100,Fail,48,34,4,14,34
100,Fail,51,37,4,8,43
100,Fail,49,37,0,10,39
100,Fail,42,36,3,19,23
100,Fail,53,23,0,17,36
100,Fail,48,36,6,10,38
100,Fail,37,45,0,10,27
100,Fail,52,34,7,7,45
100,Fail,51,28,0,14,37
100,Fail,48,36,0,12,36
100,Fail,45,30,0,16,29
100,Fail,48,39,0,12,36
100,Fail,46,33,0,17,29
100,Fail,40,41,5,14,26
100,Fail,43,39,4,14,29
100,Fail,44,33,9,14,30
100,Fail,49,37,1,13,36
100,Fail,51,31,3,15,36
100,Fail,51,33,0,14,37
100,Fail,47,38,3,12,35
100,Fail,44,35,0,13,31
100,Fail,57,34,0,9,48
100,Fail,51,33,0,16,35
100,Fail,52,37,2,9,43
100,Fail,48,39,0,7,41
100,Fail,54,33,0,11,43
100,Fail,45,36,4,15,30
100,Fail,46,45,0,9,37
100,Fail,54,37,0,9,45
100,Fail,44,40,0,11,33
100,Fail,58,22,0,15,43
100,Fail,48,40,3,9,39
100,Fail,48,36,3,13,35
100,Fail,43,42,0,13,30
100,Fail,48,34,4,14,34
100,Fail,48,39,3,10,38
100,Fail,46,41,3,10,36
100,Fail,49,41,0,8,41
100,Fail,57,26,2,15,42
100,Fail,44,45,0,11,33
100,Fail,54,33,0,11,43
100,Fail,48,33,0,13,35
100,Fail,39,45,0,10,29
100,Fail,44,34,0,19,25
100,Fail,49,37,0,10,39
100,Fail,43,38,2,17,26
100,Fail,47,32,6,15,32
100,Fail,44,32,5,19,25
100,Fail,45,40,5,10,35
100,Fail,47,28,0,11,36
100,Fail,45,39,3,13,32
100,Fail,50,30,3,17,33
100,Fail,45,35,0,15,30
100,Fail,49,36,0,15,34
100,Fail,33,42,0,18,15
100,Fail,44,38,0,17,27
100,Fail,50,34,0,14,36
100,Fail,52,30,2,16,36
100,Fail,46,38,0,14,32
100,Fail,50,28,0,16,34
100,Fail,45,38,0,16,29
100,Fail,52,37,0,10,42
100,Fail,48,38,2,12,36
100,Fail,54,29,6,11,43
100,Fail,45,36,6,13,32
100,Fail,53,39,0,8,45
100,Fail,48,39,1,12,36
100,Fail,46,42,0,10,36
100,Fail,49,29,2,20,29
100,Fail,44,35,0,13,31
100,Fail,52,34,2,12,40
100,Fail,50,32,6,12,38
100,Fail,50,38,2,10,40
100,Fail,48,35,2,15,33
100,Fail,54,26,5,15,39
100,Fail,51,31,8,10,41
100,Fail,48,40,5,7,41
100,Fail,47,27,8,18,29
100,Fail,50,37,0,9,41
100,Fail,47,38,1,14,33
100,Fail,46,33,0,17,29
100,Fail,38,41,0,13,25
100,Fail,49,29,0,15,34
100,Fail,54,25,2,19,35
100,Fail,48,37,5,10,38
100,Fail,38,31,0,23,15
100,Fail,57,24,0,15,42
100,Fail,50,36,0,5,45
100,Fail,47,33,0,16,31
100,Fail,51,37,6,6,45
100,Fail,54,31,3,12,42
100,Fail,48,39,2,11,37
100,Fail,49,36,6,9,40
100,Fail,48,38,0,10,38
100,Fail,52,34,0,13,39
100,Fail,41,38,11,10,31
100,Fail,46,29,5,20,26
100,Fail,45,36,4,15,30
100,Fail,47,37,4,12,35
100,Fail,53,36,0,8,45
100,Fail,45,41,4,10,35
100,Fail,39,31,0,21,18
100,Fail,52,37,2,9,43
100,Fail,44,41,0,14,30
100,Fail,43,36,6,15,28
100,Fail,50,30,3,17,33
100,Fail,45,40,0,8,37
100,Fail,44,36,0,17,27
100,Fail,51,36,0,10,41
100,Fail,50,33,0,16,34
100,Fail,53,29,0,15,38
100,Fail,54,37,1,8,46
100,Fail,50,33,0,14,36
100,Fail,42,40,1,17,25
100,Fail,55,31,0,14,41
100,Fail,45,36,1,18,27
100,Fail,58,27,0,11,47
100,Fail,51,29,0,10,41
100,Fail,48,32,0,20,28
100,Fail,52,30,0,15,37
100,Fail,44,42,0,14,30
100,Fail,51,34,7,8,43
100,Fail,53,38,0,9,44
100,Fail,49,31,0,14,35
100,Fail,44,37,0,19,25
100,Fail,49,35,0,14,35
100,Fail,36,37,7,20,16
100,Fail,49,35,0,14,35
100,Fail,53,34,0,11,42
100,Fail,52,35,0,13,39
100,Fail,46,33,9,12,34
100,Fail,50,32,0,16,34
100,Fail,55,32,0,13,42
100,Fail,46,39,0,12,34
100,Fail,51,36,0,6,45
100,Fail,48,41,0,9,39
100,Fail,46,38,0,13,33
100,Fail,51,41,0,8,43
100,Fail,46,40,3,11,35
100,Fail,41,40,0,15,26
100,Fail,50,33,0,15,35
100,Fail,46,40,0,11,35
100,Fail,40,47,0,8,32
100,Fail,53,34,5,8,45
100,Fail,52,30,0,17,35
100,Fail,51,40,2,7,44
100,Fail,47,35,2,16,31
100,Fail,44,39,0,15,29
100,Fail,44,42,4,10,34
100,Fail,50,34,0,11,39
100,Fail,40,38,9,13,27
100,Fail,50,34,0,11,39
100,Fail,52,37,0,7,45
100,Fail,44,26,0,20,24
100,Fail,46,34,0,15,31
100,Fail,43,34,0,16,27
100,Fail,44,36,0,10,34
100,Fail,43,37,0,11,32
100,Fail,47,33,7,13,34
100,Fail,45,35,6,14,31
100,Fail,48,37,0,13,35
100,Fail,56,31,1,12,44
100,Fail,45,39,0,10,35
100,Fail,49,34,0,12,37
100,Fail,54,35,1,10,44
100,Fail,53,37,0,7,46
100,Fail,43,39,0,17,26
100,Fail,46,41,1,12,34
100,Fail,44,38,0,16,28
100,Fail,46,39,1,14,32
100,Fail,49,35,4,12,37
100,Fail,54,30,0,16,38
100,Fail,43,37,4,16,27
100,Fail,49,35,0,16,33
100,Fail,48,35,3,14,34
100,Fail,48,30,0,14,34
100,Fail,50,33,0,16,34
100,Fail,50,38,0,9,41
100,Fail,45,42,1,12,33
100,Fail,46,36,6,12,34
100,Fail,38,47,0,12,26
100,Fail,53,34,0,13,40
100,Fail,46,41,3,10,36
100,Fail,33,37,6,24,9
100,Fail,46,36,6,12,34
100,Fail,53,35,0,12,41
100,Fail,41,40,0,14,27
100,Fail,58,32,1,9,49
100,Fail,45,36,5,14,31
100,Fail,48,36,6,10,38
100,Fail,56,33,0,10,46
100,Fail,49,36,1,14,35
100,Fail,44,40,1,15,29
100,Fail,46,39,0,15,31
100,Fail,45,35,5,15,30
100,Fail,47,29,0,17,30
100,Fail,39,41,3,17,22
100,Fail,52,37,2,9,43
100,Fail,52,36,0,9,43
100,Fail,42,44,0,13,29
100,Fail,39,39,0,13,26
100,Fail,62,30,2,6,56
100,Fail,43,45,0,12,31
100,Fail,44,40,8,8,36
100,Fail,53,34,0,12,41
100,Fail,51,31,0,9,42
100,Fail,46,36,0,12,34
100,Fail,45,45,0,9,36
100,Fail,50,34,0,9,41
100,Fail,52,39,0,6,46
100,Fail,51,35,5,9,42
100,Fail,44,35,6,15,29
100,Fail,51,33,0,12,39
100,Fail,47,36,5,12,35
100,Fail,46,35,0,17,29
100,Fail,46,34,3,17,29
100,Fail,53,38,1,8,45
100,Fail,51,37,0,12,39
100,Fail,48,32,0,18,30
100,Fail,50,38,0,10,40
100,Fail,50,43,1,6,44
100,Fail,50,36,4,10,40
100,Fail,51,37,0,12,39
100,Fail,46,36,0,13,33
100,Fail,54,30,3,13,41
100,Fail,52,37,0,10,42
100,Fail,50,34,0,10,40
100,Fail,51,36,0,12,39
100,Fail,53,35,3,9,44
100,Fail,53,30,5,12,41
100,Fail,53,39,1,7,46
100,Fail,45,37,0,16,29
100,Fail,42,32,5,21,21
100,Fail,41,40,3,16,25
100,Fail,46,39,1,14,32
100,Fail,54,28,0,12,42
100,Fail,50,33,3,14,36
100,Fail,47,28,8,17,30
100,Fail,47,38,0,13,34
100,Fail,46,43,0,10,36
100,Fail,55,36,0,9,46
100,Fail,52,33,4,11,41
100,Fail,49,28,9,14,35
100,Fail,51,30,6,13,38
100,Fail,42,38,7,13,29
100,Fail,45,35,0,9,36
100,Fail,56,37,0,7,49
100,Fail,56,29,0,13,43
100,Fail,42,27,16,15,27
100,Fail,51,35,0,12,39
100,Fail,51,35,0,13,38
100,Fail,45,43,2,10,35
100,Fail,54,33,2,11,43
100,Fail,56,36,3,5,51
100,Fail,50,36,5,9,41
100,Fail,49,37,0,11,38
100,Fail,49,35,0,10,39
100,Fail,47,35,4,14,33
100,Fail,42,44,0,14,28
100,Fail,44,34,6,16,28
100,Fail,53,30,0,13,40
100,Fail,47,30,0,16,31
100,Fail,40,41,2,17,23
100,Fail,45,29,0,14,31
100,Fail,37,35,7,21,16
100,Fail,57,33,0,10,47
100,Fail,40,43,0,12,28
100,Fail,45,44,0,10,35
100,Fail,46,41,2,11,35
100,Fail,46,42,2,10,36
100,Fail,46,34,9,11,35
100,Fail,46,33,0,19,27
100,Fail,43,39,0,15,28
100,Fail,53,34,0,11,42
100,Fail,46,35,3,16,30
100,Fail,52,31,0,12,40
100,Fail,48,32,0,12,36
100,Fail,46,38,3,13,33
100,Fail,53,34,0,11,42
100,Fail,45,34,2,19,26
100,Fail,49,38,0,9,40
100,Fail,56,38,1,5,51
100,Fail,40,41,4,15,25
100,Fail,39,34,0,16,23
100,Fail,41,37,8,14,27
100,Fail,61,34,1,4,57
100,Fail,41,32,0,18,23
100,Fail,54,26,4,16,38
100,Fail,48,32,8,12,36
100,Fail,45,40,0,12,33
100,Fail,48,37,5,10,38
100,Fail,50,28,0,17,33
100,Fail,43,32,0,16,27
100,Fail,54,37,0,9,45
100,Fail,53,32,0,14,39
100,Fail,46,36,10,8,38
100,Fail,46,31,0,13,33
100,Fail,44,38,0,17,27
100,Fail,48,39,1,12,36
100,Fail,53,34,0,9,44
100,Fail,44,38,8,10,34
100,Fail,45,35,0,12,33
100,Fail,57,25,0,14,43
100,Fail,52,37,3,8,44
100,Fail,51,33,0,13,38
100,Fail,48,33,0,15,33
100,Fail,49,37,0,14,35
100,Fail,47,42,0,10,37
100,Fail,43,33,4,20,23
100,Fail,52,32,0,15,37
100,Fail,51,35,0,10,41
100,Fail,45,36,4,15,30
100,Fail,50,38,0,11,39
100,Fail,56,28,0,12,44
100,Fail,38,44,0,14,24
100,Fail,48,38,0,10,38
100,Fail,48,33,0,10,38
100,Fail,50,41,1,8,42
100,Fail,49,33,2,16,33
100,Fail,51,33,0,16,35
100,Fail,48,35,8,9,39
100,Fail,48,34,5,13,35
100,Fail,53,35,0,9,44
100,Fail,43,38,3,16,27
100,Fail,58,33,0,7,51
100,Fail,40,38,8,14,26
100,Fail,48,40,0,11,37
100,Fail,60,31,5,4,56
100,Fail,45,39,0,13,32
100,Fail,56,33,0,10,46
100,Fail,46,37,2,15,31
100,Fail,55,31,0,13,42
100,Fail,43,34,8,15,28
100,Fail,55,38,0,5,50
100,Fail,46,40,0,11,35
100,Fail,45,45,0,7,38
100,Fail,44,37,6,13,31
100,Fail,47,38,2,13,34
100,Fail,47,37,0,10,37
100,Fail,49,31,1,19,30
100,Fail,48,37,1,14,34
100,Fail,50,38,0,9,41
100,Fail,45,36,6,13,32
100,Fail,54,37,0,8,46
100,Fail,51,36,0,12,39
100,Fail,53,32,0,12,41
100,Fail,37,34,0,21,16
100,Fail,47,40,5,8,39
100,Fail,46,31,0,20,26
100,Fail,52,37,5,6,46
100,Fail,46,29,0,22,24
100,Fail,52,37,1,10,42
100,Fail,51,37,3,9,42
100,Fail,50,36,5,9,41
100,Fail,50,41,0,7,43
100,Fail,52,28,2,18,34
100,Fail,42,40,6,12,30
100,Fail,44,35,0,10,34
100,Fail,47,39,0,14,33
100,Fail,39,35,8,18,21
100,Fail,49,34,1,16,33
100,Fail,46,36,0,18,28
100,Fail,48,32,0,14,34
100,Fail,53,35,0,11,42
100,Fail,51,31,6,12,39
100,Fail,53,30,0,10,43
100,Fail,50,37,3,10,40
100,Fail,48,37,0,13,35
100,Fail,45,30,0,19,26
100,Fail,42,39,3,16,26
100,Fail,55,34,5,6,49
100,Fail,54,34,0,10,44
100,Fail,54,30,5,11,43
100,Fail,47,38,0,9,38
100,Fail,43,33,5,19,24
100,Fail,46,46,0,8,38
100,Fail,47,40,0,13,34
100,Fail,53,34,0,7,46
100,Fail,47,37,0,14,33
100,Fail,46,31,0,15,31
100,Fail,45,34,0,15,30
100,Fail,55,35,0,10,45
100,Fail,46,43,5,6,40
100,Fail,46,37,0,15,31
100,Fail,48,36,0,15,33
100,Fail,44,42,2,12,32
100,Fail,51,29,0,14,37
100,Fail,46,41,0,11,35
100,Fail,45,41,7,7,38
100,Fail,56,30,1,13,43
100,Fail,45,40,1,14,31
100,Fail,40,32,14,14,26
100,Fail,45,38,5,12,33
100,Fail,52,39,1,8,44
100,Fail,45,34,0,8,37
100,Fail,45,34,8,13,32
100,Fail,48,39,4,9,39
100,Fail,48,33,0,14,34
100,Fail,51,30,0,18,33
100,Fail,52,33,0,11,41
100,Fail,45,38,0,15,30
100,Fail,51,30,8,11,40
100,Fail,55,38,0,5,50
100,Fail,50,40,1,9,41
100,Fail,42,31,9,18,24
100,Fail,53,33,2,12,41
100,Fail,51,38,2,9,42
100,Fail,53,39,0,8,45
100,Fail,56,30,3,11,45
100,Fail,53,28,7,12,41
100,Fail,48,32,0,13,35
100,Fail,52,33,3,12,40
100,Fail,45,38,7,10,35
100,Fail,46,42,1,11,35
100,Fail,51,37,1,11,40
100,Fail,37,41,0,13,24
100,Fail,50,31,5,14,36
100,Fail,47,31,0,15,32
100,Fail,38,37,0,15,23
100,Fail,56,27,5,12,44
100,Fail,49,35,0,11,38
100,Fail,41,38,0,15,26
100,Fail,50,38,0,2,48
100,Fail,45,35,6,14,31
100,Fail,45,43,0,8,37
100,Fail,41,41,3,15,26
100,Fail,41,42,2,15,26
100,Fail,47,37,0,13,34
100,Fail,50,36,1,13,37
100,Fail,53,31,0,12,41
100,Fail,42,37,0,16,26
100,Fail,48,38,0,12,36
100,Fail,49,32,0,13,36
100,Fail,45,32,0,14,31
100,Fail,54,32,4,10,44
100,Fail,49,33,0,14,35
100,Fail,51,26,0,19,32
100,Fail,51,35,0,13,38
100,Fail,49,40,0,10,39
100,Fail,47,38,4,11,36
100,Fail,40,47,0,13,27
100,Fail,53,40,0,5,48
100,Fail,45,36,0,14,31
100,Fail,50,35,7,8,42
100,Fail,48,31,0,15,33
100,Fail,47,37,0,13,34
100,Fail,48,42,2,8,40
100,Fail,45,32,0,13,32
100,Fail,53,32,0,12,41
100,Fail,40,42,0,13,27
100,Fail,51,34,0,14,37
100,Fail,42,44,0,12,30
100,Fail,51,36,0,12,39
100,Fail,48,41,2,9,39
100,Fail,47,35,6,12,35
100,Fail,47,33,9,11,36
100,Fail,48,37,0,9,39
100,Fail,53,32,5,10,43
100,Fail,44,37,1,18,26
100,Fail,51,28,0,16,35
100,Fail,48,41,0,11,37
100,Fail,51,29,0,18,33
100,Fail,42,39,0,9,33
100,Fail,47,34,0,13,34
100,Fail,53,26,4,17,36
100,Fail,43,40,1,16,27
100,Fail,49,32,6,13,36
100,Fail,44,30,0,22,22
100,Fail,51,32,0,13,38
100,Fail,45,38,6,11,34
100,Fail,50,31,0,14,36
100,Fail,49,36,0,13,36
100,Fail,49,35,0,13,36
100,Fail,55,32,1,12,43
100,Fail,45,31,0,15,30
100,Fail,54,30,5,11,43
100,Fail,56,25,0,13,43
100,Fail,54,30,1,15,39
100,Fail,45,38,0,14,31
100,Fail,52,35,0,13,39
100,Fail,43,40,0,16,27
100,Fail,47,36,0,15,32
100,Fail,46,35,0,11,35
100,Fail,47,35,6,12,35
100,Fail,40,46,0,14,26
100,Fail,40,41,6,13,27
100,Fail,45,38,6,11,34
100,Fail,54,32,0,13,41
100,Fail,42,24,11,23,19
100,Fail,57,24,0,12,45
100,Fail,42,36,0,17,25
100,Fail,51,34,0,11,40
100,Fail,47,31,7,15,32
100,Fail,51,33,1,15,36
100,Fail,54,34,1,11,43
100,Fail,63,27,0,10,53
100,Fail,39,38,4,19,20
100,Fail,49,37,0,12,37
100,Fail,57,36,2,5,52
100,Fail,50,38,0,12,38
100,Fail,47,37,4,12,35
100,Fail,54,28,2,16,38
100,Fail,53,33,0,14,39
100,Fail,54,32,1,13,41
100,Fail,50,31,3,16,34
100,Fail,46,34,0,12,34
100,Fail,47,33,0,18,29
100,Fail,45,38,0,14,31
100,Fail,48,37,3,12,36
100,Fail,54,35,0,11,43
100,Fail,46,46,1,7,39
100,Fail,49,30,6,15,34
100,Fail,50,40,1,9,41
100,Fail,53,34,1,12,41
100,Fail,39,38,8,15,24
100,Fail,41,35,11,13,28
100,Fail,51,38,0,11,40
100,Fail,49,36,2,13,36
100,Fail,48,35,4,13,35
100,Fail,53,29,0,12,41
100,Fail,45,39,0,9,36
100,Fail,44,43,2,11,33
100,Fail,46,33,0,17,29
100,Fail,49,34,0,13,36
100,Fail,44,41,1,14,30
100,Fail,46,38,0,13,33
100,Fail,47,27,0,10,37
100,Fail,49,37,0,10,39
100,Fail,57,30,0,13,44
100,Fail,41,36,7,16,25
100,Fail,57,39,0,4,53
100,Fail,46,34,2,18,28
100,Fail,47,30,9,14,33
100,Fail,48,40,0,12,36
100,Fail,49,29,5,17,32
100,Fail,53,33,4,10,43
100,Fail,34,42,0,12,22
100,Fail,48,36,2,14,34
100,Fail,56,30,0,9,47
100,Fail,50,33,0,15,35
100,Fail,48,39,0,13,35
100,Fail,50,36,5,9,41
100,Fail,50,33,2,15,35
100,Fail,40,40,4,16,24
100,Fail,50,30,0,9,41
100,Fail,51,32,0,17,34
100,Fail,55,36,0,8,47
100,Fail,46,34,5,15,31
100,Fail,53,35,3,9,44
100,Fail,47,31,5,17,30
100,Fail,48,38,1,13,35
100,Fail,45,42,0,7,38
100,Fail,49,38,0,9,40
100,Fail,44,39,2,15,29
100,Fail,41,40,4,15,26
100,Fail,44,34,0,19,25
100,Fail,46,36,0,12,34
100,Fail,46,40,2,12,34
100,Fail,51,32,5,12,39
100,Fail,51,37,0,11,40
100,Fail,39,38,8,15,24
100,Fail,48,40,0,11,37
100,Fail,54,35,0,8,46
100,Fail,48,36,0,14,34
100,Fail,55,31,0,13,42
100,Fail,45,35,5,15,30
100,Fail,41,32,0,18,23
100,Fail,48,39,0,11,37
100,Fail,42,42,0,13,29
100,Fail,53,30,0,16,37
100,Fail,47,33,0,19,28
100,Fail,48,36,1,15,33
100,Fail,43,37,0,15,28
100,Fail,52,36,0,12,40
100,Fail,51,28,11,10,41
100,Fail,36,40,8,16,20
100,Fail,55,34,0,10,45
100,Fail,52,33,5,10,42
100,Fail,49,30,0,12,37
100,Fail,48,41,2,9,39
100,Fail,45,33,0,17,28
100,Fail,44,41,0,8,36
100,Fail,47,36,0,17,30
100,Fail,44,42,3,11,33
100,Fail,45,39,0,13,32
100,Fail,46,43,1,10,36
100,Fail,51,35,0,8,43
100,Fail,53,39,0,8,45
100,Fail,51,33,0,15,36
100,Fail,39,45,4,12,27
100,Fail,47,27,0,16,31
100,Fail,48,30,3,19,29
100,Fail,42,33,0,16,26
100,Fail,41,33,0,16,25
100,Fail,50,28,3,19,31
100,Fail,46,29,0,14,32
100,Fail,44,33,0,10,34
100,Fail,44,35,10,11,33
100,Fail,60,28,2,10,50
100,Fail,50,35,0,10,40
100,Fail,54,33,0,9,45
100,Fail,53,35,0,8,45
100,Fail,37,48,0,10,27
100,Fail,50,36,1,13,37
100,Fail,49,34,3,14,35
100,Fail,45,36,11,8,37
100,Fail,45,40,2,13,32
100,Fail,43,41,0,15,28
100,Fail,44,39,6,11,33
100,Fail,42,43,5,10,32
100,Fail,52,39,2,7,45
100,Fail,51,35,0,14,37
100,Fail,48,34,6,12,36
100,Fail,42,32,0,20,22
100,Fail,52,32,9,7,45
100,Fail,62,26,0,11,51
100,Fail,47,39,0,10,37
100,Fail,46,40,0,9,37
100,Fail,55,32,0,13,42
100,Fail,44,35,0,14,30
100,Fail,52,37,0,8,44
100,Fail,45,39,0,10,35
100,Fail,44,37,0,13,31
100,Fail,47,36,0,15,32
100,Fail,55,32,0,13,42
100,Fail,43,36,0,15,28
100,Fail,50,33,0,10,40
100,Fail,49,36,0,14,35
100,Fail,56,31,0,12,44
100,Fail,49,39,0,12,37
100,Fail,49,35,3,13,36
100,Fail,38,33,0,24,14
100,Fail,51,29,0,12,39
100,Fail,47,34,0,13,34
100,Fail,43,35,0,16,27
100,Fail,40,42,5,13,27
100,Fail,51,32,2,15,36
100,Fail,54,28,9,9,45
100,Fail,54,39,0,7,47
100,Fail,51,42,0,6,45
100,Fail,43,39,0,17,26
100,Fail,46,31,7,16,30
100,Fail,44,44,0,11,33
100,Fail,51,40,0,9,42
100,Fail,50,37,0,13,37
100,Fail,54,35,0,10,44
100,Fail,48,37,0,15,33
100,Fail,44,39,0,14,30
100,Fail,45,39,5,11,34
100,Fail,38,39,0,22,16
100,Fail,51,41,0,8,43
100,Fail,55,31,4,10,45
100,Fail,50,38,0,12,38
100,Fail,48,41,2,9,39
100,Fail,53,38,0,7,46
100,Fail,53,34,0,13,40
100,Fail,52,33,0,10,42
100,Fail,47,38,4,11,36
100,Fail,48,34,2,16,32
100,Fail,45,41,0,9,36
100,Fail,48,32,0,7,41
100,Fail,48,28,0,14,34
100,Fail,47,33,7,13,34
100,Fail,50,37,0,11,39
100,Fail,41,40,0,19,22
100,Fail,52,33,0,11,41
100,Fail,44,37,1,18,26
100,Fail,51,26,0,20,31
100,Fail,42,34,10,14,28
100,Fail,44,43,0,12,32
100,Fail,49,35,0,16,33
100,Fail,47,41,1,11,36
100,Fail,49,34,0,12,37
100,Fail,50,34,1,15,35
100,Fail,48,32,4,16,32
100,Fail,49,32,3,16,33
100,Fail,50,29,5,16,34
100,Fail,40,41,7,12,28
100,Fail,51,30,0,17,34
100,Fail,57,31,0,9,48
100,Fail,50,36,1,13,37
100,Fail,52,36,0,8,44
100,Fail,52,28,0,20,32
100,Fail,53,30,3,14,39
100,Fail,56,36,2,6,50
100,Fail,51,32,2,15,36
100,Fail,48,32,0,13,35
100,Fail,47,30,0,15,32
100,Fail,53,33,6,8,45
100,Fail,53,30,0,11,42
100,Fail,49,39,0,8,41
100,Fail,46,33,5,16,30
100,Fail,48,35,0,12,36
100,Fail,43,39,9,9,34
100,Fail,49,31,0,14,35
100,Fail,45,37,8,10,35
100,Fail,45,36,8,11,34
100,Fail,50,38,0,9,41
100,Fail,46,38,0,14,32
100,Fail,43,28,8,21,22
100,Fail,50,31,2,17,33
100,Fail,49,41,0,10,39
100,Fail,54,35,1,10,44
100,Fail,47,31,0,11,36
100,Fail,48,33,0,14,34
100,Fail,49,33,0,14,35
100,Fail,41,36,8,15,26
100,Fail,55,30,4,11,44
100,Fail,46,36,0,15,31
100,Fail,45,38,0,11,34
100,Fail,46,33,0,15,31
100,Fail,50,34,1,15,35
100,Fail,41,31,0,16,25
100,Fail,51,33,4,12,39
100,Fail,52,29,0,15,37
100,Fail,57,34,0,9,48
100,Fail,46,38,0,15,31
100,Fail,50,29,10,11,39
100,Fail,48,37,1,14,34
100,Fail,51,31,0,17,34
100,Fail,50,40,0,10,40
100,Fail,48,31,3,18,30
100,Fail,40,35,7,18,22
100,Fail,50,32,0,15,35
100,Fail,45,34,5,16,29
100,Fail,51,35,3,11,40
100,Fail,40,41,5,14,26
100,Fail,51,32,6,11,40
100,Fail,44,39,3,14,30
100,Fail,46,32,0,11,35
100,Fail,56,34,0,10,46
100,Fail,33,41,13,13,20
100,Fail,49,34,0,15,34
100,Fail,45,40,0,13,32
100,Fail,46,35,0,13,33
100,Fail,43,47,0,7,36
100,Fail,49,38,1,12,37
100,Fail,48,39,1,12,36
100,Fail,42,29,14,15,27
100,Fail,61,29,0,10,51
100,Fail,55,37,0,8,47
100,Fail,48,37,5,10,38
100,Fail,50,35,0,12,38
100,Fail,55,32,2,11,44
100,Fail,50,31,0,16,34
100,Fail,48,40,0,12,36
100,Fail,49,37,4,10,39
100,Fail,44,45,0,10,34
100,Fail,52,33,0,9,43
100,Fail,49,42,1,8,41
100,Fail,46,34,0,12,34
100,Fail,59,33,2,6,53
100,Fail,54,30,0,15,39
100,Fail,46,40,0,12,34
100,Fail,48,33,0,17,31
100,Fail,51,28,4,17,34
100,Fail,48,36,0,11,37
100,Fail,45,34,0,14,31
100,Fail,51,37,0,11,40
100,Fail,46,36,2,16,30
100,Fail,46,39,0,15,31
100,Fail,49,34,1,16,33
100,Fail,48,39,0,13,35
100,Fail,50,39,0,11,39
100,Fail,47,43,2,8,39
100,Fail,47,40,1,12,35
100,Fail,57,31,3,9,48
100,Fail,51,32,3,14,37
100,Fail,47,40,0,12,35
100,Fail,41,36,0,15,26
100,Fail,45,35,10,10,35
100,Fail,50,36,0,10,40
100,Fail,50,39,0,7,43
100,Fail,53,30,0,16,37
100,Fail,50,31,6,13,37
100,Fail,57,32,3,8,49
100,Fail,51,43,0,6,45
100,Fail,45,37,0,16,29
100,Fail,51,33,2,14,37
100,Fail,51,32,7,10,41
100,Fail,50,37,1,12,38
100,Fail,39,39,0,14,25
100,Fail,53,36,0,10,43
100,Fail,53,32,0,11,42
100,Fail,42,39,1,18,24
100,Fail,42,42,0,15,27
100,Fail,44,35,6,15,29
100,Fail,49,33,0,11,38
100,Fail,57,33,0,10,47
100,Fail,56,32,2,10,46
100,Fail,46,44,1,9,37
100,Fail,48,35,0,14,34
100,Fail,54,32,2,12,42
100,Fail,36,44,0,18,18
100,Fail,52,35,0,9,43
100,Fail,51,32,3,14,37
100,Fail,53,31,3,13,40
100,Fail,47,32,1,20,27
100,Fail,48,32,0,16,32
100,Fail,53,33,5,9,44
100,Fail,51,38,2,9,42
100,Fail,44,37,6,13,31
100,Fail,42,39,0,16,26
100,Fail,47,36,0,17,30
100,Fail,39,36,0,19,20
100,Fail,44,44,0,11,33
100,Fail,51,38,0,10,41
100,Fail,57,29,0,14,43
100,Fail,55,31,0,6,49
100,Fail,50,36,0,10,40
100,Fail,45,36,1,18,27
100,Fail,47,34,0,15,32
100,Fail,56,34,0,9,47
100,Fail,52,31,2,15,37
100,Fail,49,33,4,14,35
100,Fail,45,36,0,16,29
100,Fail,52,30,2,16,36
100,Fail,54,32,0,14,40
100,Fail,49,40,0,11,38
100,Fail,41,46,0,8,33
100,Fail,49,37,1,13,36
100,Fail,49,40,0,11,38
100,Fail,50,34,5,11,39
100,Fail,49,31,7,13,36
100,Fail,51,33,1,15,36
100,Fail,45,43,4,8,37
100,Fail,51,36,5,8,43
100,Fail,42,41,5,12,30
100,Fail,47,38,0,11,36
100,Fail,45,33,0,18,27
100,Fail,50,32,0,11,39
100,Fail,47,31,6,16,31
100,Fail,44,38,2,16,28
100,Fail,43,38,9,10,33
100,Fail,52,28,0,19,33
100,Fail,41,41,0,18,23
100,Fail,44,36,0,19,25
100,Fail,48,30,0,14,34
100,Fail,50,42,1,7,43
100,Fail,53,37,2,8,45
100,Fail,52,37,0,7,45
100,Fail,47,42,0,10,37
100,Fail,57,33,0,9,48
100,Fail,52,33,7,8,44
100,Fail,43,37,0,12,31
100,Fail,41,37,9,13,28
100,Fail,52,33,6,9,43
100,Fail,54,37,0,8,46
100,Fail,51,39,0,10,41
100,Fail,46,33,0,13,33
100,Fail,39,34,4,23,16
100,Fail,46,32,0,14,32
100,Fail,50,34,0,9,41
100,Fail,47,40,0,12,35
100,Fail,42,45,0,13,29
100,Fail,46,38,4,12,34
100,Fail,47,34,5,14,33
100,Fail,49,36,0,14,35
100,Fail,37,41,0,14,23
100,Fail,43,31,0,15,28
100,Fail,48,38,2,12,36
100,Fail,50,38,0,12,38
100,Fail,45,40,0,11,34
100,Fail,44,37,5,14,30
100,Fail,47,38,2,13,34
100,Fail,43,36,0,11,32
100,Fail,49,32,4,15,34
100,Fail,43,29,11,17,26
100,Fail,50,34,5,11,39
100,Fail,47,33,0,19,28
100,Fail,40,32,0,19,21
100,Fail,40,46,0,6,34
100,Fail,40,41,0,17,23
100,Fail,53,34,0,9,44
100,Fail,49,31,4,16,33
100,Fail,47,37,0,15,32
100,Fail,40,33,0,17,23
100,Fail,42,40,0,12,30
100,Fail,43,47,3,7,36
100,Fail,48,31,7,14,34
100,Fail,56,31,0,13,43
100,Fail,59,28,0,12,47
100,Fail,44,34,0,17,27
100,Fail,50,31,8,11,39
100,Fail,41,44,3,12,29
100,Fail,56,27,0,12,44
100,Fail,50,29,0,12,38
100,Fail,49,32,0,19,30
100,Fail,51,35,0,12,39
100,Fail,46,38,4,12,34
100,Fail,49,37,1,13,36
100,Fail,53,33,6,8,45
100,Fail,51,36,0,11,40
100,Fail,53,31,8,8,45
100,Fail,50,30,2,18,32
100,Fail,42,39,1,18,24
100,Fail,46,32,0,15,31
100,Fail,45,42,4,9,36
100,Fail,46,37,0,16,30
100,Fail,52,32,0,8,44
100,Fail,46,39,0,12,34
100,Fail,45,37,3,15,30
100,Fail,52,31,3,14,38
100,Fail,49,36,3,12,37
100,Fail,53,24,11,12,41
100,Fail,48,37,3,12,36
100,Fail,49,39,0,7,42
100,Fail,48,34,0,18,30
100,Fail,44,37,0,19,25
100,Fail,51,38,4,7,44
100,Fail,43,37,2,18,25
100,Fail,46,35,4,15,31
100,Fail,46,36,0,18,28
100,Fail,52,31,4,13,39
100,Fail,44,37,0,16,28
100,Fail,45,41,0,9,36
100,Fail,54,35,1,10,44
100,Fail,52,30,0,7,45
100,Fail,42,44,0,9,33
100,Fail,49,43,0,6,43
100,Fail,52,40,0,8,44
100,Fail,46,39,0,10,36
100,Fail,50,30,6,14,36
100,Fail,52,37,0,11,41
100,Fail,41,47,2,10,31
100,Fail,46,36,6,12,34
100,Fail,49,32,0,11,38
100,Fail,55,24,5,16,39
100,Fail,47,37,5,11,36
100,Fail,47,39,5,9,38
100,Fail,50,34,3,13,37
100,Fail,42,37,0,16,26
100,Fail,49,32,0,7,42
100,Fail,48,34,0,15,33
100,Fail,47,41,0,12,35
100,Fail,52,37,3,8,44
100,Fail,44,31,0,19,25
100,Fail,52,34,0,13,39
100,Fail,50,35,5,10,40
100,Fail,43,29,0,20,23
100,Fail,51,27,0,20,31
100,Fail,53,28,0,11,42
100,Fail,41,47,0,8,33
100,Fail,48,30,7,15,33
100,Fail,45,36,6,13,32
100,Fail,48,25,0,14,34
100,Fail,49,36,0,13,36
100,Fail,53,36,0,11,42
100,Fail,46,34,11,9,37
100,Fail,45,34,0,16,29
100,Fail,46,39,0,12,34
100,Fail,44,38,7,11,33
100,Fail,40,44,4,12,28
100,Fail,49,36,3,12,37
100,Fail,46,45,0,5,41
100,Fail,49,26,0,19,30
100,Fail,56,30,2,12,44
100,Fail,52,31,7,10,42
100,Fail,45,37,0,10,35
100,Fail,51,36,1,12,39
100,Fail,47,37,0,11,36
100,Fail,41,42,0,17,24
100,Fail,45,38,3,14,31
100,Fail,51,33,9,7,44
100,Fail,41,34,0,19,22
100,Fail,54,37,1,8,46
100,Fail,55,32,0,11,44
100,Fail,46,40,0,13,33
100,Fail,50,35,4,11,39
100,Fail,55,36,0,9,46
100,Fail,55,29,4,12,43
100,Fail,40,30,0,16,24
100,Fail,45,36,2,17,28
100,Fail,43,34,11,12,31
100,Fail,48,38,0,14,34
100,Fail,45,41,1,13,32
100,Fail,54,34,0,12,42
100,Fail,43,38,6,13,30
100,Fail,55,24,0,13,42
100,Fail,43,38,6,13,30
100,Fail,55,31,0,11,44
100,Fail,48,32,0,15,33
100,Fail,48,38,1,13,35
100,Fail,42,31,6,21,21
100,Fail,51,34,1,14,37
100,Fail,45,36,0,18,27
100,Fail,47,36,0,12,35
100,Fail,44,39,3,14,30
100,Fail,37,38,7,18,19
100,Fail,47,33,0,15,32
100,Fail,44,34,0,12,32
100,Fail,44,39,0,17,27
100,Fail,48,36,2,14,34
100,Fail,47,37,0,14,33
100,Fail,51,31,0,16,35
100,Fail,49,37,2,12,37
100,Fail,48,32,3,17,31
100,Fail,51,36,1,12,39
100,Fail,53,27,0,13,40
100,Fail,40,37,7,16,24
100,Fail,45,44,0,11,34
100,Fail,62,26,2,10,52
100,Fail,51,32,0,13,38
100,Fail,54,38,0,8,46
100,Fail,49,29,0,19,30
100,Fail,50,30,0,16,34
100,Fail,53,32,3,12,41
100,Fail,58,27,0,11,47
100,Fail,46,35,8,11,35
100,Fail,52,34,0,11,41
100,Fail,48,35,5,12,36
100,Fail,44,31,0,13,31
100,Fail,49,28,0,13,36
100,Fail,46,37,3,14,32
100,Fail,53,29,0,12,41
100,Fail,55,31,0,14,41
100,Fail,45,44,3,8,37
100,Fail,48,31,7,14,34
100,Fail,50,34,0,15,35
100,Fail,43,41,0,13,30
100,Fail,43,38,0,10,33
100,Fail,46,38,0,13,33
100,Fail,51,34,0,13,38
100,Fail,51,35,0,13,38
100,Fail,45,31,0,18,27
100,Fail,48,41,5,6,42
100,Fail,54,33,2,11,43
100,Fail,49,36,0,10,39
100,Fail,50,38,0,9,41
100,Fail,38,41,8,13,25
100,Fail,44,26,0,18,26
100,Fail,53,34,3,10,43
100,Fail,55,34,0,11,44
100,Fail,48,38,0,11,37
100,Fail,48,35,7,10,38
100,Fail,42,39,0,18,24
100,Fail,47,33,6,14,33
100,Fail,40,33,0,25,15
100,Fail,48,27,0,13,35
100,Fail,43,34,0,16,27
100,Fail,43,36,0,19,24
100,Fail,52,34,5,9,43
100,Fail,54,29,0,17,37
100,Fail,51,35,2,12,39
100,Fail,47,36,0,12,35
100,Fail,43,39,0,16,27
100,Fail,56,36,0,8,48
100,Fail,52,31,0,15,37
100,Fail,55,32,1,12,43
100,Fail,60,28,3,9,51
100,Fail,44,32,0,16,28
100,Fail,54,35,2,9,45
100,Fail,49,39,4,8,41
100,Fail,45,34,0,17,28
100,Fail,45,35,0,15,30
100,Fail,50,38,3,9,41
100,Fail,44,39,9,8,36
100,Fail,48,36,6,10,38
100,Fail,52,34,4,10,42
100,Fail,51,37,2,10,41
100,Fail,42,43,0,14,28
100,Fail,45,32,8,15,30
100,Fail,45,38,0,15,30
100,Fail,57,34,3,6,51
100,Fail,47,36,2,15,32
100,Fail,45,40,2,13,32
100,Fail,58,31,0,9,49
100,Fail,44,33,0,17,27
100,Fail,46,42,0,11,35
100,Fail,50,34,5,11,39
100,Fail,43,27,0,18,25
100,Fail,42,41,0,12,30
100,Fail,44,39,0,16,28
100,Fail,49,38,5,8,41
100,Fail,45,36,3,16,29
100,Fail,47,34,0,16,31
100,Fail,47,36,0,16,31
100,Fail,49,39,2,10,39
100,Fail,45,34,0,17,28
100,Fail,42,41,4,13,29
100,Fail,46,42,0,11,35
100,Fail,58,33,0,9,49
100,Fail,48,40,1,11,37
100,Fail,54,35,2,9,45
100,Fail,43,38,7,12,31
100,Fail,40,41,0,10,30
100,Fail,53,38,1,8,45
100,Fail,53,32,3,12,41
100,Fail,44,32,5,19,25
100,Fail,48,38,7,7,41
100,Fail,61,25,0,12,49
100,Fail,48,35,0,15,33
100,Fail,41,38,11,10,31
100,Fail,49,37,3,11,38
100,Fail,51,33,0,13,38
100,Fail,43,39,0,14,29
100,Fail,52,29,0,9,43
100,Fail,51,33,0,16,35
100,Fail,52,36,2,10,42
100,Fail,47,39,3,11,36
100,Fail,51,33,0,12,39
100,Fail,50,34,4,12,38
100,Fail,40,37,3,20,20
100,Fail,48,31,0,10,38
100,Fail,48,37,6,9,39
100,Fail,45,36,4,15,30
100,Fail,51,33,2,14,37
100,Fail,48,35,7,10,38
100,Fail,38,40,5,17,21
100,Fail,48,35,2,15,33
100,Fail,44,34,0,12,32
100,Fail,43,27,12,18,25
100,Fail,42,47,0,10,32
100,Fail,48,42,0,8,40
100,Fail,52,40,2,6,46
100,Fail,52,26,12,10,42
100,Fail,51,35,0,11,40
100,Fail,44,39,0,16,28
100,Fail,46,34,0,18,28
100,Fail,47,39,1,13,34
100,Fail,49,27,0,20,29
100,Fail,37,47,0,15,22
100,Fail,43,38,9,10,33
100,Fail,47,37,6,10,37
100,Fail,54,33,0,9,45
100,Fail,44,40,1,15,29
100,Fail,41,34,0,18,23
100,Fail,48,37,2,13,35
100,Fail,44,42,0,11,33
100,Fail,39,43,5,13,26
100,Fail,51,36,6,7,44
100,Fail,45,36,4,15,30
100,Fail,51,35,0,13,38
100,Fail,44,36,5,15,29
100,Fail,45,43,1,11,34
100,Fail,49,41,0,8,41
100,Fail,44,34,0,19,25
100,Fail,45,37,3,15,30
100,Fail,45,26,11,18,27
100,Fail,43,39,0,15,28
100,Fail,53,36,0,7,46
100,Fail,51,38,3,8,43
100,Fail,44,34,0,11,33
100,Fail,45,41,3,11,34
100,Fail,58,32,0,9,49
100,Fail,50,33,0,11,39
100,Fail,42,33,0,12,30
100,Fail,49,36,0,7,42
100,Fail,46,35,0,13,33
100,Fail,48,40,3,9,39
100,Fail,49,40,4,7,42
100,Fail,55,34,1,10,45
100,Fail,50,37,0,8,42
100,Fail,44,38,0,10,34
100,Fail,50,35,6,9,41
100,Fail,51,35,0,13,38
100,Fail,46,40,1,13,33
100,Fail,46,39,0,11,35
100,Fail,46,40,0,9,37
100,Fail,44,36,0,19,25
100,Fail,52,37,1,10,42
100,Fail,45,45,1,9,36
100,Fail,44,35,7,14,30
100,Fail,52,36,0,12,40
100,Fail,43,34,0,13,30
100,Fail,53,30,0,12,41
100,Fail,46,35,0,16,30
100,Fail,47,32,2,19,28
100,Fail,48,35,0,12,36
100,Fail,39,38,0,9,30
100,Fail,42,43,2,13,29
100,Fail,45,34,0,17,28
100,Fail,51,32,2,15,36
100,Fail,45,35,0,10,35
100,Fail,49,37,0,11,38
100,Fail,51,32,5,12,39
100,Fail,50,39,0,10,40
100,Fail,48,35,0,14,34
100,Fail,50,33,0,14,36
100,Fail,46,41,0,13,33
100,Fail,48,40,0,10,38
100,Fail,51,34,1,14,37
100,Fail,52,36,0,12,40
100,Fail,48,35,1,16,32
100,Fail,55,28,2,15,40
100,Fail,47,43,0,10,37
100,Fail,48,37,0,12,36
100,Fail,50,39,0,10,40
100,Fail,53,35,0,9,44
100,Fail,54,31,0,14,40
100,Fail,53,39,0,6,47
100,Fail,43,45,4,8,35
100,Fail,38,44,7,11,27
100,Fail,46,32,4,18,28
100,Fail,41,36,0,15,26
100,Fail,49,36,5,10,39
100,Fail,54,25,11,10,44
100,Fail,46,31,11,12,34
100,Fail,43,44,0,13,30
100,Fail,45,36,0,12,33
100,Fail,45,33,0,15,30
100,Fail,51,35,3,11,40
100,Fail,45,43,0,11,34
100,Fail,41,39,0,14,27
100,Fail,45,38,8,9,36
100,Fail,48,36,8,8,40
100,Fail,57,29,1,13,44
100,Fail,50,28,0,15,35
100,Fail,55,29,0,9,46
100,Fail,53,26,6,15,38
100,Fail,45,41,2,12,33
100,Fail,48,34,0,12,36
100,Fail,53,33,2,12,41
100,Fail,47,38,0,11,36
100,Fail,46,35,0,17,29
100,Fail,47,30,0,15,32
100,Fail,44,31,0,21,23
100,Fail,45,36,0,13,32
100,Fail,50,37,0,12,38
100,Fail,48,41,1,10,38
100,Fail,52,35,2,11,41
100,Fail,43,38,6,13,30
100,Fail,52,33,4,11,41
100,Fail,45,44,2,9,36
100,Fail,53,34,5,8,45
100,Fail,49,36,0,13,36
100,Fail,47,38,0,8,39
100,Fail,47,35,0,11,36
100,Fail,51,36,2,11,40
100,Fail,46,39,2,13,33
100,Fail,50,25,0,15,35
100,Fail,50,31,5,14,36
100,Fail,42,47,0,11,31
100,Fail,49,38,4,9,40
100,Fail,50,40,0,10,40
100,Fail,47,35,5,13,34
100,Fail,55,30,0,15,40
100,Fail,48,36,2,14,34
100,Fail,48,33,0,15,33
100,Fail,50,33,0,13,37
100,Fail,47,34,0,13,34
100,Fail,46,33,0,13,33
100,Fail,40,46,1,13,27
100,Fail,51,35,0,10,41
100,Fail,48,43,0,8,40
100,Fail,56,29,0,11,45
100,Fail,51,33,0,15,36
100,Fail,55,32,4,9,46
100,Fail,37,37,11,15,22
100,Fail,54,30,0,16,38
100,Fail,39,48,1,12,27
100,Fail,49,34,0,14,35
100,Fail,51,28,2,19,32
100,Fail,49,39,0,10,39
100,Fail,55,31,5,9,46
100,Fail,47,41,1,11,36
100,Fail,48,33,0,15,33
100,Fail,52,36,0,9,43
100,Fail,42,37,3,18,24
100,Fail,42,41,0,14,28
100,Fail,46,36,0,16,30
100,Fail,45,38,0,15,30
100,Fail,53,35,0,12,41
100,Fail,47,40,2,11,36
100,Fail,53,34,1,12,41
100,Fail,49,35,0,15,34
100,Fail,45,30,0,17,28
100,Fail,56,36,2,6,50
100,Fail,40,41,0,19,21
100,Fail,49,35,2,14,35
100,Fail,49,27,0,19,30
100,Fail,52,37,0,10,42
100,Fail,49,27,0,23,26
100,Fail,51,40,0,9,42
100,Fail,57,35,0,5,52
100,Fail,44,36,0,17,27
100,Fail,44,34,0,10,34
100,Fail,49,29,0,19,30
100,Fail,48,32,1,19,29
100,Fail,51,38,0,9,42
100,Fail,46,43,0,10,36
100,Fail,42,44,0,14,28
100,Fail,53,36,0,11,42
100,Fail,41,38,0,13,28
100,Fail,46,32,5,17,29
100,Fail,43,34,0,17,26
100,Fail,48,41,0,10,38
100,Fail,56,32,1,11,45
100,Fail,45,35,3,17,28
100,Fail,53,31,1,15,38
100,Fail,50,31,0,13,37
100,Fail,47,31,0,19,28
100,Fail,53,36,0,8,45
100,Fail,44,37,0,13,31
100,Fail,49,35,0,13,36
100,Fail,52,40,0,6,46
100,Fail,44,38,0,13,31
100,Fail,50,33,1,16,34
100,Fail,30,56,1,13,17
100,Fail,46,36,5,13,33
100,Fail,45,37,3,15,30
100,Fail,46,40,0,14,32
100,Fail,47,31,0,14,33
100,Fail,58,24,0,10,48
100,Fail,43,38,0,17,26
100,Fail,43,39,1,17,26
100,Fail,53,33,0,14,39
100,Fail,44,38,0,13,31
100,Fail,51,34,0,12,39
100,Fail,50,35,0,15,35
100,Fail,52,35,0,8,44
100,Fail,60,29,0,8,52
100,Fail,49,35,4,12,37
100,Fail,52,33,2,13,39
100,Fail,48,39,2,11,37
100,Fail,53,30,0,16,37
100,Fail,55,32,0,11,44
100,Fail,53,36,3,8,45
100,Fail,40,42,7,11,29
100,Fail,53,33,1,13,40
100,Fail,52,33,3,12,40
100,Fail,37,45,8,10,27
100,Fail,44,40,4,12,32
100,Fail,53,36,0,10,43
100,Fail,43,36,7,14,29
100,Fail,45,34,0,14,31
100,Fail,45,45,1,9,36
100,Fail,43,37,5,15,28
100,Fail,43,41,1,15,28
100,Fail,54,37,2,7,47
100,Fail,42,42,1,15,27
100,Fail,53,30,0,13,40
100,Fail,53,33,1,13,40
100,Fail,57,29,2,12,45
100,Fail,52,33,0,13,39
100,Fail,47,26,0,12,35
100,Fail,41,36,5,18,23
100,Fail,38,35,6,21,17
100,Fail,53,25,2,20,33
100,Fail,49,39,2,10,39
100,Fail,50,38,1,11,39
100,Fail,47,40,0,12,35
100,Fail,48,37,0,12,36
100,Fail,49,36,4,11,38
100,Fail,55,28,0,16,39
100,Fail,47,35,3,15,32
100,Fail,42,48,0,9,33
100,Fail,53,38,0,8,45
100,Fail,58,26,3,13,45
100,Fail,56,32,0,10,46
100,Fail,51,35,3,11,40
100,Fail,45,40,5,10,35
100,Fail,54,33,0,13,41
100,Fail,47,36,0,12,35
100,Fail,38,45,0,15,23
100,Fail,50,38,0,10,40
100,Fail,49,34,8,9,40
100,Fail,40,43,0,13,27
100,Fail,47,35,0,11,36
100,Fail,46,38,0,11,35
100,Fail,46,39,0,9,37
100,Fail,52,35,0,10,42
100,Fail,49,29,10,12,37
100,Fail,39,41,0,12,27
100,Fail,44,47,1,8,36
100,Fail,43,31,0,13,30
100,Fail,47,41,0,12,35
100,Fail,51,36,2,11,40
100,Fail,52,38,1,9,43
100,Fail,51,35,0,11,40
100,Fail,41,39,2,18,23
100,Fail,45,30,0,16,29
100,Fail,49,38,0,13,36
100,Fail,52,33,0,13,39
100,Fail,37,42,8,13,24
100,Fail,51,43,0,6,45
100,Fail,50,38,1,11,39
100,Fail,39,38,0,16,23
100,Fail,52,29,8,11,41
100,Fail,48,33,0,15,33
100,Fail,39,39,7,15,24
100,Fail,50,34,1,15,35
100,Fail,48,36,4,12,36
100,Fail,46,40,0,12,34
100,Fail,53,32,0,15,38
100,Fail,48,32,7,13,35
100,Fail,46,37,1,16,30
100,Fail,50,34,0,13,37
100,Fail,46,34,0,14,32
100,Fail,44,38,0,9,35
100,Fail,52,33,3,12,40
100,Fail,47,33,7,13,34
100,Fail,53,28,0,11,42
100,Fail,53,35,1,11,42
100,Fail,51,33,0,14,37
100,Fail,51,37,0,9,42
100,Fail,44,37,0,15,29
100,Fail,48,39,2,11,37
100,Fail,50,36,0,14,36
100,Fail,48,31,5,16,32
100,Fail,51,35,0,12,39
100,Fail,52,35,0,13,39
100,Fail,44,38,0,11,33
100,Fail,53,28,0,7,46
100,Fail,43,40,0,13,30
100,Fail,49,29,0,15,34
100,Fail,46,31,9,14,32
100,Fail,50,36,0,14,36
100,Fail,43,48,4,5,38
100,Fail,47,33,0,16,31
100,Fail,53,31,0,13,40
100,Fail,48,35,0,11,37
100,Fail,42,41,10,7,35
100,Fail,50,40,0,10,40
100,Fail,44,39,0,11,33
100,Fail,47,37,5,11,36
100,Fail,55,30,0,15,40
100,Fail,47,36,0,11,36
100,Fail,44,32,0,12,32
100,Fail,54,35,0,7,47
100,Fail,49,37,0,10,39
100,Fail,48,36,2,14,34
100,Fail,50,33,0,16,34
100,Fail,47,39,2,12,35
100,Fail,51,35,0,13,38
100,Fail,53,33,0,11,42
100,Fail,46,42,0,12,34
100,Fail,42,39,0,10,32
100,Fail,48,33,6,13,35
100,Fail,46,35,0,11,35
100,Fail,48,39,0,12,36
100,Fail,44,39,4,13,31
100,Fail,50,32,6,12,38
100,Fail,55,36,2,7,48
100,Fail,52,37,0,10,42
100,Fail,45,34,6,15,30
100,Fail,44,37,3,16,28
100,Fail,55,29,0,13,42
100,Fail,48,36,0,15,33
100,Fail,46,38,0,15,31
100,Fail,42,32,11,15,27
100,Fail,47,34,0,14,33
100,Fail,49,31,6,14,35
100,Fail,49,35,0,15,34
100,Fail,51,31,0,12,39
100,Fail,45,41,0,11,34
100,Fail,45,35,10,10,35
100,Fail,47,40,5,8,39
100,Fail,50,37,3,10,40
100,Fail,52,29,3,16,36
100,Fail,46,35,3,16,30
100,Fail,51,30,0,15,36
100,Fail,42,46,0,11,31
100,Fail,49,35,3,13,36
100,Fail,47,33,0,13,34
100,Fail,58,26,0,10,48
100,Fail,45,33,0,13,32
100,Fail,42,31,0,12,30
100,Fail,51,36,1,12,39
100,Fail,43,38,0,12,31
100,Fail,50,35,0,9,41
100,Fail,47,41,0,11,36
100,Fail,52,33,2,13,39
100,Fail,54,34,0,11,43
100,Fail,53,28,11,8,45
100,Fail,43,43,4,10,33
100,Fail,48,40,0,9,39
100,Fail,43,45,0,12,31
100,Fail,50,29,0,16,34
100,Fail,45,37,0,15,30
100,Fail,40,49,0,9,31
100,Fail,51,43,0,6,45
100,Fail,45,34,0,17,28
100,Fail,45,40,4,11,34
100,Fail,47,36,0,17,30
100,Fail,49,31,0,14,35
100,Fail,49,38,3,10,39
100,Fail,50,33,0,12,38
100,Fail,48,33,0,15,33
100,Fail,47,39,0,14,33
100,Fail,47,33,1,19,28
100,Fail,55,35,0,10,45
100,Fail,45,35,1,19,26
100,Fail,43,38,0,16,27
100,Fail,45,44,4,7,38
100,Fail,46,38,2,14,32
100,Fail,42,39,4,15,27
100,Fail,42,37,5,16,26
100,Fail,42,39,0,15,27
100,Fail,47,36,0,13,34
100,Fail,46,38,0,11,35
100,Fail,56,27,6,11,45
100,Fail,51,36,0,13,38
100,Fail,46,28,7,19,27
100,Fail,46,40,3,11,35
100,Fail,48,32,0,18,30
100,Fail,52,28,0,10,42
100,Fail,47,34,3,16,31
100,Fail,45,34,3,18,27
100,Fail,48,29,0,19,29
100,Fail,48,36,0,13,35
100,Fail,53,32,0,14,39
100,Fail,48,32,8,12,36
100,Fail,54,32,0,14,40
100,Fail,45,42,0,13,32
100,Fail,46,32,10,12,34
100,Fail,41,36,0,17,24
100,Fail,42,36,0,14,28
100,Fail,50,37,0,13,37
100,Fail,44,35,7,14,30
100,Fail,51,29,0,18,33
100,Fail,47,40,0,13,34
100,Fail,54,33,0,8,46
100,Fail,44,39,0,10,34
100,Fail,49,35,0,11,38
100,Fail,49,35,0,16,33
100,Fail,51,36,1,12,39
100,Fail,54,29,0,16,38
100,Fail,43,42,5,10,33
100,Fail,51,36,1,12,39
100,Fail,45,35,5,15,30
100,Fail,46,38,0,13,33
100,Fail,42,35,9,14,28
100,Fail,45,34,0,15,30
100,Fail,51,37,3,9,42
100,Fail,43,46,0,7,36
100,Fail,54,38,1,7,47
100,Fail,42,41,6,11,31
100,Fail,50,30,8,12,38
100,Fail,48,38,0,14,34
100,Fail,55,33,0,9,46
100,Fail,48,31,0,18,30
100,Fail,51,26,0,14,37
100,Fail,49,37,0,11,38
100,Fail,46,38,1,15,31
100,Fail,40,39,0,9,31
100,Fail,48,43,2,7,41
100,Fail,45,30,7,18,27
100,Fail,57,31,2,10,47
100,Fail,57,31,0,11,46
100,Fail,45,37,4,14,31
100,Fail,53,34,0,12,41
100,Fail,44,38,4,14,30
100,Fail,44,39,5,12,32
100,Fail,52,35,3,10,42
100,Fail,47,40,5,8,39
100,Fail,43,31,0,20,23
100,Fail,44,39,3,14,30
100,Fail,50,26,0,19,31
100,Fail,50,35,2,13,37
100,Fail,46,41,1,12,34
100,Fail,59,30,0,11,48
100,Fail,56,30,0,14,42
100,Fail,49,28,0,10,39
100,Fail,56,34,0,10,46
100,Fail,51,31,0,13,38
100,Fail,43,34,7,16,27
100,Fail,43,32,6,19,24
100,Fail,44,39,0,17,27
100,Fail,48,38,0,14,34
100,Fail,50,25,0,14,36
100,Fail,50,33,0,10,40
100,Fail,45,47,0,7,38
100,Fail,45,35,5,15,30
100,Fail,48,33,3,16,32
100,Fail,48,35,3,14,34
100,Fail,51,30,0,18,33
100,Fail,54,34,0,8,46
100,Fail,50,34,0,16,34
100,Fail,57,29,0,10,47
100,Fail,51,37,0,11,40
100,Fail,44,41,0,11,33
100,Fail,45,31,7,17,28
100,Fail,56,30,9,5,51
100,Fail,56,32,4,8,48
100,Fail,47,39,0,12,35
100,Fail,45,34,2,19,26
100,Fail,52,34,0,12,40
100,Fail,42,36,0,14,28
100,Fail,48,33,4,15,33
100,Fail,37,43,7,13,24
100,Fail,49,36,0,13,36
100,Fail,53,40,2,5,48
100,Fail,47,38,0,15,32
100,Fail,46,37,0,13,33
100,Fail,54,34,0,8,46
100,Fail,43,44,1,12,31
100,Fail,54,37,1,8,46
100,Fail,52,33,4,11,41
100,Fail,36,44,0,14,22
100,Fail,47,35,3,15,32
100,Fail,50,33,5,12,38
100,Fail,43,43,3,11,32
100,Fail,46,46,0,8,38
100,Fail,48,40,0,8,40
100,Fail,44,37,0,15,29
100,Fail,54,28,4,14,40
100,Fail,45,37,8,10,35
100,Fail,56,32,0,10,46
100,Fail,51,34,2,13,38
100,Fail,49,27,0,20,29
100,Fail,45,40,0,12,33
100,Fail,46,37,1,16,30
100,Fail,40,34,13,13,27
100,Fail,47,38,0,12,35
100,Fail,50,33,7,10,40
100,Fail,48,31,9,12,36
100,Fail,40,27,16,17,23
100,Fail,51,33,5,11,40
100,Fail,53,40,0,7,46
100,Fail,49,39,2,10,39
100,Fail,39,40,7,14,25
100,Fail,51,37,1,11,40
100,Fail,49,35,3,13,36
100,Fail,44,34,0,14,30
100,Fail,49,36,5,10,39
100,Fail,45,36,7,12,33
100,Fail,57,33,3,7,50
100,Fail,41,39,3,17,24
100,Fail,52,29,0,17,35
100,Fail,48,37,0,11,37
100,Fail,52,31,0,15,37
100,Fail,43,39,6,12,31
100,Fail,45,38,0,11,34
100,Fail,53,27,0,13,40
100,Fail,48,38,4,10,38
100,Fail,47,32,0,18,29
100,Fail,46,31,9,14,32
100,Fail,43,40,0,7,36
100,Fail,50,34,2,14,36
100,Fail,56,32,0,7,49
100,Fail,44,39,1,16,28
100,Fail,49,29,8,14,35
100,Fail,57,35,0,7,50
100,Fail,60,34,0,4,56
100,Fail,49,35,6,10,39
100,Fail,44,33,5,18,26
100,Fail,51,32,1,16,35
100,Fail,51,34,0,15,36
100,Fail,47,38,0,14,33
100,Fail,44,43,1,12,32
100,Fail,45,39,0,11,34
100,Fail,46,37,0,14,32
100,Fail,45,37,1,17,28
100,Fail,35,36,0,23,12
100,Fail,44,44,0,9,35
100,Fail,47,30,12,11,36
100,Fail,45,44,0,11,34
100,Fail,48,39,4,9,39
100,Fail,52,32,0,11,41
100,Fail,56,32,0,8,48
100,Fail,46,44,0,10,36
100,Fail,49,35,5,11,38
100,Fail,45,31,5,19,26
100,Fail,43,40,0,10,33
100,Fail,53,33,5,9,44
100,Fail,51,34,0,12,39
100,Fail,47,38,0,11,36
100,Fail,55,30,7,8,47
100,Fail,48,31,9,12,36
100,Fail,43,38,0,15,28
100,Fail,51,31,0,15,36
100,Fail,54,33,0,13,41
100,Fail,45,32,7,16,29
100,Fail,47,38,2,13,34
100,Fail,55,35,1,9,46
100,Fail,44,32,6,18,26
100,Fail,51,36,2,11,40
100,Fail,50,28,0,11,39
100,Fail,46,33,3,18,28
100,Fail,47,33,0,13,34
100,Fail,48,40,1,11,37
100,Fail,54,29,5,12,42
100,Fail,50,34,6,10,40
100,Fail,44,39,0,10,34
100,Fail,52,29,8,11,41
100,Fail,53,32,0,15,38
100,Fail,53,35,0,11,42
100,Fail,52,35,2,11,41
100,Fail,49,36,0,12,37
100,Fail,51,34,0,13,38
100,Fail,48,35,0,12,36
100,Fail,49,29,0,17,32
100,Fail,49,27,0,12,37
100,Fail,46,43,1,10,36
100,Fail,40,34,9,17,23
100,Fail,50,38,0,12,38
100,Fail,44,41,0,9,35
100,Fail,47,33,0,11,36
100,Fail,48,34,7,11,37
100,Fail,42,36,0,13,29
100,Fail,41,39,2,18,23
100,Fail,41,35,10,14,27
100,Fail,48,32,2,18,30
100,Fail,47,35,6,12,35
100,Fail,48,31,1,20,28
100,Fail,52,31,0,13,39
100,Fail,51,31,5,13,38
100,Fail,48,38,5,9,39
100,Fail,47,34,0,12,35
100,Fail,53,38,4,5,48
100,Fail,38,27,17,18,20
100,Fail,45,33,8,14,31
100,Fail,44,44,0,8,36
100,Fail,50,38,3,9,41
100,Fail,47,38,4,11,36
100,Fail,54,28,0,14,40
100,Fail,49,36,0,14,35
100,Fail,47,41,0,12,35
100,Fail,48,38,0,11,37
100,Fail,38,43,4,15,23
100,Fail,46,35,0,16,30
100,Fail,50,33,4,13,37
100,Fail,54,33,0,12,42
100,Fail,44,40,1,15,29
100,Fail,44,29,4,23,21
100,Fail,44,42,0,12,32
100,Fail,55,26,0,18,37
100,Fail,49,30,5,16,33
100,Fail,44,38,0,16,28
100,Fail,48,39,0,11,37
100,Fail,42,39,0,17,25
100,Fail,48,33,0,13,35
100,Fail,48,39,0,11,37
100,Fail,42,48,1,9,33
100,Fail,45,33,11,11,34
100,Fail,48,35,5,12,36
100,Fail,46,38,0,12,34
100,Fail,50,39,0,10,40
100,Fail,41,39,0,16,25
100,Fail,53,34,3,10,43
100,Fail,50,39,0,11,39
100,Fail,46,35,0,15,31
100,Fail,46,37,10,7,39
100,Fail,53,33,0,10,43
100,Fail,47,37,0,9,38
100,Fail,52,40,0,8,44
100,Fail,51,38,3,8,43
100,Fail,44,37,10,9,35
100,Fail,46,35,0,16,30
100,Fail,47,39,1,13,34
100,Fail,44,38,4,14,30
100,Fail,50,37,0,13,37
100,Fail,46,41,2,11,35
100,Fail,52,30,0,16,36
100,Fail,47,34,3,16,31
100,Fail,53,36,4,7,46
100,Fail,56,27,0,11,45
100,Fail,45,38,0,12,33
100,Fail,49,35,3,13,36
100,Fail,51,38,0,7,44
100,Fail,45,37,0,11,34
100,Fail,42,41,0,17,25
100,Fail,48,38,0,9,39
100,Fail,50,32,9,9,41
100,Fail,50,29,5,16,34
100,Fail,50,36,7,7,43
100,Fail,44,48,0,7,37
100,Fail,42,40,3,15,27
100,Fail,59,25,0,15,44
100,Fail,49,37,4,10,39
100,Fail,53,35,2,10,43
100,Fail,44,46,0,10,34
100,Fail,39,47,0,10,29
100,Fail,49,41,0,9,40
100,Fail,40,32,10,18,22
100,Fail,48,34,7,11,37
100,Fail,47,45,0,6,41
100,Fail,55,31,0,9,46
100,Fail,45,36,1,18,27
100,Fail,50,37,0,8,42
100,Fail,51,30,0,19,32
100,Fail,47,30,0,17,30
100,Fail,51,31,8,10,41
100,Fail,51,37,0,12,39
100,Fail,50,40,0,9,41
100,Fail,53,34,0,9,44
100,Fail,44,39,0,17,27
100,Fail,41,37,5,17,24
100,Fail,53,33,0,13,40
100,Fail,54,38,2,6,48
100,Fail,53,33,3,11,42
100,Fail,41,38,6,15,26
100,Fail,42,39,3,16,26
100,Fail,47,41,0,12,35
100,Fail,50,41,0,8,42
100,Fail,47,32,0,14,33
100,Fail,45,36,4,15,30
100,Fail,48,37,0,8,40
100,Fail,48,38,4,10,38
100,Fail,56,35,2,7,49
100,Fail,40,40,7,13,27
100,Fail,54,28,4,14,40
100,Fail,41,31,5,23,18
100,Fail,46,33,7,14,32
100,Fail,41,36,0,22,19
100,Fail,53,23,6,18,35
100,Fail,54,30,0,14,40
100,Fail,40,36,0,13,27
100,Fail,47,29,9,15,32
100,Fail,51,24,10,15,36
100,Fail,51,39,2,8,43
100,Fail,44,38,0,16,28
100,Fail,49,37,7,7,42
100,Fail,45,34,10,11,34
100,Fail,49,33,0,14,35
100,Fail,52,30,1,17,35
100,Fail,40,41,0,17,23
100,Fail,41,38,5,16,25
100,Fail,48,33,0,13,35
100,Fail,43,40,4,13,30
100,Fail,49,35,0,13,36
100,Fail,40,36,0,16,24
100,Fail,50,29,9,12,38
100,Fail,36,42,4,18,18
100,Fail,43,34,0,17,26
100,Fail,44,42,0,9,35
100,Fail,52,32,4,12,40
100,Fail,43,42,0,8,35
100,Fail,42,38,6,14,28
100,Fail,45,34,7,14,31
100,Fail,52,42,0,5,47
100,Fail,52,31,4,13,39
100,Fail,45,41,0,11,34
100,Fail,49,38,0,11,38
100,Fail,55,35,0,10,45
100,Fail,51,34,0,13,38
100,Fail,45,30,0,17,28
100,Fail,51,40,0,9,42
100,Fail,47,35,0,16,31
100,Fail,43,36,3,18,25
100,Fail,48,34,8,10,38
100,Fail,48,36,0,13,35
100,Fail,44,39,4,13,31
100,Fail,54,33,1,12,42
100,Fail,47,36,3,14,33
100,Fail,48,36,0,11,37
100,Fail,51,37,0,9,42
100,Fail,55,32,1,12,43
100,Fail,49,33,7,11,38
100,Fail,53,35,0,12,41
100,Fail,52,34,0,14,38
100,Fail,43,35,0,22,21
100,Fail,50,33,0,14,36
100,Fail,54,28,3,15,39
100,Fail,41,42,2,15,26
100,Fail,44,41,5,10,34
100,Fail,45,36,0,19,26
100,Fail,44,39,6,11,33
100,Fail,46,34,0,13,33
100,Fail,47,38,0,15,32
100,Fail,51,33,1,15,36
100,Fail,44,30,0,16,28
100,Fail,53,36,0,11,42
100,Fail,49,27,9,15,34
100,Fail,55,33,3,9,46
100,Fail,50,30,5,15,35
100,Fail,46,41,0,12,34
100,Fail,55,26,3,16,39
100,Fail,52,39,1,8,44
100,Fail,51,34,0,13,38
100,Fail,47,45,0,7,40
100,Fail,45,41,0,8,37
100,Fail,52,35,0,13,39
100,Fail,50,33,0,17,33
100,Fail,48,37,0,11,37
100,Fail,60,33,1,6,54
100,Fail,51,39,2,8,43
100,Fail,53,28,0,15,38
100,Fail,51,32,6,11,40
100,Fail,52,36,0,8,44
100,Fail,40,37,0,16,24
100,Fail,47,30,3,20,27
100,Fail,49,34,0,9,40
100,Fail,51,36,2,11,40
100,Fail,55,30,0,11,44
100,Fail,53,29,0,13,40
100,Fail,51,36,3,10,41
100,Fail,55,34,3,8,47
100,Fail,52,30,0,18,34
100,Fail,46,31,0,21,25
100,Fail,56,32,0,10,46
100,Fail,52,37,0,9,43
100,Fail,44,37,0,14,30
100,Fail,42,31,0,17,25
100,Fail,49,35,0,15,34
100,Fail,47,43,1,9,38
100,Fail,50,34,2,14,36
100,Fail,41,31,0,18,23
100,Fail,55,31,3,11,44
100,Fail,46,31,7,16,30
100,Fail,43,42,0,14,29
100,Fail,43,40,0,14,29
100,Fail,50,30,0,11,39
100,Fail,57,27,0,15,42
100,Fail,47,40,2,11,36
100,Fail,55,34,1,10,45
100,Fail,45,48,1,6,39
100,Fail,54,34,0,7,47
100,Fail,50,37,3,10,40
100,Fail,52,36,4,8,44
100,Fail,52,33,5,10,42
100,Fail,47,35,4,14,33
100,Fail,39,48,2,11,28
100,Fail,42,32,0,18,24
100,Fail,56,33,0,7,49
100,Fail,41,35,7,17,24
100,Fail,48,31,3,18,30
100,Fail,47,35,0,16,31
100,Fail,55,30,3,12,43
100,Fail,49,34,0,14,35
100,Fail,52,33,0,11,41
100,Fail,56,26,12,6,50
100,Fail,53,38,1,8,45
100,Fail,49,37,2,12,37
100,Fail,52,33,2,13,39
100,Fail,48,38,1,13,35
100,Fail,38,40,0,16,22
100,Fail,43,36,0,19,24
100,Fail,47,32,0,17,30
100,Fail,46,34,0,11,35
100,Fail,51,33,6,10,41
100,Fail,48,37,0,14,34
100,Fail,47,43,0,10,37
100,Fail,55,32,0,11,44
100,Fail,47,39,1,13,34
100,Fail,48,40,0,6,42
100,Fail,51,32,0,11,40
100,Fail,49,35,2,14,35
100,Fail,50,35,0,8,42
100,Fail,44,33,5,18,26
100,Fail,56,33,1,10,46
100,Fail,48,36,4,12,36
100,Fail,49,36,0,12,37
100,Fail,44,37,6,13,31
100,Fail,48,33,0,16,32
100,Fail,52,31,0,14,38
100,Fail,53,36,0,11,42
100,Fail,57,24,0,13,44
100,Fail,50,41,2,7,43
100,Fail,40,41,4,15,25
100,Fail,47,41,2,10,37
100,Fail,45,40,0,15,30
100,Fail,49,38,0,10,39
100,Fail,53,36,2,9,44
100,Fail,46,35,2,17,29
100,Fail,48,38,3,11,37
100,Fail,49,38,0,12,37
100,Fail,51,38,1,10,41
100,Fail,43,36,5,16,27
100,Fail,51,34,0,11,40
100,Fail,47,39,0,14,33
100,Fail,50,34,2,14,36
100,Fail,54,34,0,12,42
100,Fail,50,35,4,11,39
100,Fail,53,29,1,17,36
100,Fail,49,38,0,8,41
100,Fail,52,35,1,12,40
100,Fail,56,32,2,10,46
100,Fail,58,29,7,6,52
100,Fail,40,37,0,17,23
100,Fail,46,37,0,11,35
100,Fail,49,36,0,7,42
100,Fail,48,29,0,11,37
100,Fail,47,39,0,11,36
100,Fail,48,39,0,8,40
100,Fail,48,35,0,12,36
100,Fail,49,32,0,16,33
100,Fail,52,38,0,7,45
100,Fail,42,37,0,13,29
100,Fail,47,37,0,11,36
100,Fail,47,30,0,16,31
100,Fail,47,40,0,13,34
100,Fail,45,36,2,17,28
100,Fail,54,32,0,13,41
100,Fail,42,34,7,17,25
100,Fail,45,35,5,15,30
100,Fail,43,35,5,17,26
100,Fail,54,33,2,11,43
100,Fail,53,32,3,12,41
100,Fail,43,27,0,15,28
100,Fail,50,34,0,9,41
100,Fail,49,29,8,14,35
100,Fail,45,40,0,13,32
100,Fail,43,36,0,18,25
100,Fail,45,33,0,12,33
100,Fail,54,39,0,7,47
100,Fail,43,39,0,17,26
100,Fail,45,38,4,13,32
100,Fail,43,37,1,19,24
100,Fail,50,38,2,10,40
100,Fail,47,41,0,12,35
100,Fail,48,38,0,12,36
100,Fail,41,41,0,15,26
100,Fail,45,33,6,16,29
100,Fail,46,29,0,14,32
100,Fail,53,33,0,10,43
100,Fail,47,34,4,15,32
100,Fail,47,28,0,18,29
100,Fail,46,36,0,12,34
100,Fail,46,34,0,14,32
100,Fail,43,40,0,15,28
100,Fail,52,37,0,11,41
100,Fail,38,42,0,13,25
100,Fail,52,32,0,16,36
100,Fail,44,40,1,15,29
100,Fail,47,35,4,14,33
100,Fail,45,34,0,15,30
100,Fail,42,36,4,18,24
100,Fail,45,44,2,9,36
100,Fail,52,35,0,11,41
100,Fail,40,30,15,15,25
100,Fail,49,34,0,15,34
100,Fail,48,39,2,11,37
100,Fail,35,45,6,14,21
100,Fail,47,31,7,15,32
100,Fail,46,32,0,19,27
100,Fail,49,37,3,11,38
100,Fail,47,33,7,13,34
100,Fail,46,40,2,12,34
100,Fail,53,26,10,11,42
100,Fail,48,37,6,9,39
100,Fail,49,34,4,13,36
100,Fail,45,35,3,17,28
100,Fail,52,35,0,11,41
100,Fail,44,35,0,18,26
100,Fail,41,41,9,9,32
100,Fail,48,34,0,13,35
100,Fail,49,38,0,13,36
100,Fail,51,38,0,6,45
100,Fail,41,42,0,10,31
100,Fail,48,31,0,21,27
100,Fail,43,35,0,16,27
100,Fail,52,32,3,13,39
100,Fail,48,37,0,10,38
100,Fail,52,35,1,12,40
100,Fail,46,38,0,13,33
100,Fail,42,42,1,15,27
100,Fail,39,37,0,19,20
100,Fail,55,35,0,10,45
100,Fail,44,32,4,20,24
100,Fail,52,36,4,8,44
100,Fail,43,37,0,12,31
100,Fail,39,46,6,9,30
100,Fail,44,36,0,13,31
100,Fail,62,27,0,10,52
100,Fail,55,36,4,5,50
100,Fail,52,33,0,15,37
100,Fail,38,44,8,10,28
100,Fail,45,33,0,14,31
100,Fail,48,28,0,15,33
100,Fail,51,36,1,12,39
100,Fail,40,38,0,16,24
100,Fail,44,33,0,12,32
100,Fail,49,23,12,16,33
100,Fail,48,34,2,16,32
100,Fail,52,30,0,12,40
100,Fail,46,38,0,16,30
100,Fail,48,40,0,11,37
100,Fail,49,34,0,11,38
100,Fail,50,37,0,9,41
100,Fail,44,33,0,20,24
100,Fail,44,38,5,13,31
100,Fail,48,39,2,11,37
100,Fail,58,35,0,5,53
100,Fail,36,43,7,14,22
100,Fail,54,21,15,10,44
100,Fail,54,32,0,11,43
100,Fail,37,42,9,12,25
100,Fail,45,32,7,16,29
100,Fail,51,35,4,10,41
100,Fail,46,28,12,14,32
100,Fail,41,40,1,18,23
100,Fail,47,36,0,12,35
100,Fail,50,28,4,18,32
100,Fail,53,28,0,14,39
100,Fail,48,32,0,8,40
100,Fail,45,38,0,16,29
100,Fail,52,32,1,15,37
100,Fail,48,36,2,14,34
100,Fail,45,40,6,9,36
100,Fail,46,38,6,10,36
100,Fail,49,31,1,19,30
100,Fail,44,32,0,8,36
100,Fail,51,33,3,13,38
100,Fail,46,38,3,13,33
100,Fail,43,38,0,14,29
100,Fail,48,35,0,16,32
100,Fail,38,39,11,12,26
100,Fail,48,38,1,13,35
100,Fail,46,35,1,18,28
100,Fail,48,39,3,10,38
100,Fail,50,30,0,16,34
100,Fail,52,32,0,14,38
100,Fail,52,32,3,13,39
100,Fail,47,32,4,17,30
100,Fail,43,37,0,14,29
100,Fail,44,39,5,12,32
100,Fail,51,29,0,15,36
100,Fail,48,35,6,11,37
100,Fail,46,33,2,19,27
100,Fail,45,36,2,17,28
100,Fail,43,37,0,11,32
100,Fail,38,36,0,18,20
100,Fail,45,37,3,15,30
100,Fail,47,41,0,11,36
100,Fail,45,40,4,11,34
100,Fail,44,39,0,12,32
100,Fail,48,37,0,15,33
100,Fail,53,31,0,13,40
100,Fail,48,34,5,13,35
100,Fail,41,46,0,11,30
100,Fail,52,32,3,13,39
100,Fail,50,25,0,19,31
100,Fail,43,30,8,19,24
100,Fail,46,36,5,13,33
100,Fail,53,34,0,11,42
100,Fail,44,31,8,17,27
100,Fail,40,42,1,17,23
100,Fail,51,30,0,16,35
100,Fail,50,33,0,13,37
100,Fail,43,39,4,14,29
100,Fail,58,32,2,8,50
100,Fail,52,35,0,12,40
100,Fail,45,37,0,9,36
100,Fail,57,36,0,7,50
100,Fail,51,41,0,7,44
100,Fail,54,33,1,12,42
100,Fail,55,32,5,8,47
100,Fail,44,43,1,12,32
100,Fail,43,39,5,13,30
100,Fail,50,31,6,13,37
100,Fail,50,35,2,13,37
100,Fail,42,35,5,18,24
100,Fail,50,37,3,10,40
100,Fail,44,35,7,14,30
100,Fail,51,31,5,13,38
100,Fail,47,30,3,20,27
100,Fail,40,37,3,20,20
100,Fail,53,39,0,4,49
100,Fail,47,28,0,16,31
100,Fail,47,33,0,15,32
100,Fail,52,38,5,5,47
100,Fail,51,31,4,14,37
100,Fail,49,30,0,13,36
100,Fail,53,26,9,12,41
100,Fail,45,45,0,8,37
100,Fail,57,34,0,9,48
100,Fail,45,36,0,13,32
100,Fail,49,37,0,10,39
100,Fail,51,38,0,10,41
100,Fail,47,41,0,9,38
100,Fail,48,36,3,13,35
100,Fail,53,33,0,11,42
100,Fail,48,31,0,14,34
100,Fail,55,38,0,7,48
100,Fail,41,39,0,14,27
100,Fail,52,36,1,11,41
100,Fail,59,31,0,9,50
100,Fail,51,31,3,15,36
100,Fail,51,30,0,14,37
100,Fail,58,24,3,15,43